CommitID,NMF,TotalAddLines,TotalDeleteLines,LC,FileAdd,FileDelete,NAD,NDEV,NUC,AGE,NS,ND,Entropy,LT,EXP,REXP,CommitComplexity,LastCommitComplexity,CFC,CommitTokenCount,LastCommitTokenCount,NCC,CommitMethodNum,LastCommitMethodNum,NMC,a2a
8e940693817a08d064e90352e2130effe3fd2c4c,0,0,0,0,0,0,0,0,0,0,0,0,0,0,1,1,0,0,0,0,0,0,0,0,0,100
acf57c062f4b3323dcc029ddba2756edb7838714,256,17378,0,17378,128,0,128,1,1,0,4,90,6.500002938,11069,2,2,4508,768,3740,162099,35072,127027,2334,768,1566,23.70225269
64b79914345122f19719ee0c6811eb64f041f560,128,0,15283,15283,0,0,0,1,2,0,4,45,6.360495716,11069,3,3,0,2254,2254,0,80358,80358,0,1167,1167,68.37865055
b524cebfca12dbf3a662695cce2843f66bdb5883,3,3,5,8,0,0,0,2,2,6,1,2,1.5,105,0,0,5,5,0,784,784,0,4,4,0,100
ef57501f6830245359e3ca290021fedf42a18b44,3,4,5,9,0,0,0,1,2,21,1,3,1.392147224,463,4,4,118,118,0,3253,3253,0,52,52,0,100
fe6f6007b43eb78386bd152a6c48098e0cee3cda,5,4,5,9,0,0,0,2,3,18,1,3,2.281036113,460,1,1,94,94,0,3321,3332,11,58,58,0,100
8867d0605aa01e02ed0e971cc63536353f0990a0,4,235,22,257,0,0,0,2,4,66,1,1,1.640444458,228,5,0,33,27,6,2474,1982,492,24,19,5,100
4207ddd67b427e308d75cdef250c1a28237125e9,7,103,40,143,1,0,1,1,2,66,1,7,2.146960029,565,6,1,125,116,9,4349,4167,182,81,77,4,96.70846395
6b79e8f43b6b934ed3902b005b179595dfea0814,0,0,0,0,0,0,0,0,0,0,0,0,0,0,7,2,0,0,0,0,0,0,0,0,0,100
4a831be2bfc1df53311885acdf58bf2be03f304f,3,31,3,34,0,0,0,1,2,108,1,3,1.364594389,146,8,3,22,16,6,1203,1098,105,13,12,1,100
9d16d94ca210eb1a5fafb1f37a3ecb063bd6310e,9,815,5,820,6,0,6,1,5,22,3,4,2.440422224,883,9,1,298,167,131,10559,6493,4066,124,49,75,90.43478261
17e681ce2af93052f01cd6a0a014d7c4d326711c,0,0,0,0,0,0,0,0,0,0,0,0,0,0,10,2,0,0,0,0,0,0,0,0,0,100
4638c444368a8f028437018533fd38ca024403af,0,0,0,0,0,0,0,0,0,0,0,0,0,0,0,0,0,0,0,0,0,0,0,0,0,100
cdacd2965c86067fb37a4e335d0663c9b5f769b4,2,79,13,92,1,0,1,1,3,96,1,1,0.615253891,86,1,0,14,10,4,972,728,244,9,6,3,98.06094183
a1b2d53c8bc5e6dd9d12604f98e442c9adf11ae7,0,0,0,0,0,0,0,0,0,0,0,0,0,0,2,0,0,0,0,0,0,0,0,0,0,100
41e87e0737b4fba8791de2b1656019c9f7891c02,0,0,0,0,0,0,0,0,0,0,0,0,0,0,3,1,0,0,0,0,0,0,0,0,0,100
abc97fedb0093a2d899d685451a75bcf56c9b967,4,100,25,125,1,0,1,2,5,139,1,1,1.638327192,182,4,2,35,26,9,1754,1429,325,26,21,5,99.27536232
7736a7b31dfbf8a306d7cf9520f82340044f491f,0,0,0,0,0,0,0,0,0,0,0,0,0,0,5,3,0,0,0,0,0,0,0,0,0,100
db7a73f3f69b617efb41bfe303f03d6133edf5d6,0,0,0,0,0,0,0,0,0,0,0,0,0,0,6,4,0,0,0,0,0,0,0,0,0,100
2214b2e4d9c8c0041b920527fbfeec92a4b3104c,1,0,45,45,0,0,0,2,3,334,1,1,0,20,2,0,0,2,2,0,179,179,0,2,2,99.71014493
74046a2fcdafad5a90e20a68ad4718f308156762,2,4,6,10,0,0,0,2,2,446,1,1,0.881290899,566,0,0,128,129,1,4570,4588,18,38,38,0,100
9edc6f8f065603c28d41245667eab9bc3dba8be7,0,0,0,0,0,0,0,0,0,0,0,0,0,0,7,0,0,0,0,0,0,0,0,0,0,100
810bc5c0de5afa10327aa84c9d57be0ac612542e,0,0,0,0,0,0,0,0,0,0,0,0,0,0,8,1,0,0,0,0,0,0,0,0,0,100
61b4a9e8a6182e0ca15ec9a8389935dd93fc31f3,0,0,0,0,0,0,0,0,0,0,0,0,0,0,9,2,0,0,0,0,0,0,0,0,0,100
33c02eb016e2902e639b11a3774b622f30fa6a8c,0,0,0,0,0,0,0,0,0,0,0,0,0,0,0,0,0,0,0,0,0,0,0,0,0,100
ee60cf08b83e24acd35831152fe5959743df8f89,0,0,0,0,0,0,0,0,0,0,0,0,0,0,1,1,0,0,0,0,0,0,0,0,0,100
67274381ce1a821155a610c78a2e40471834e259,0,0,0,0,0,0,0,0,0,0,0,0,0,0,2,2,0,0,0,0,0,0,0,0,0,100
e682197aad5cf40bc37cedbf2d98251ca6e01b5a,11,136,181,317,0,0,0,2,3,692,3,5,2.92936013,337,10,0,12,12,0,2454,2655,201,7,7,0,100
de89793edd1118490a40a81ba81d9570971cc08d,1,10,8,18,0,0,0,2,2,764,1,1,0,377,11,0,113,113,0,3083,3060,23,19,19,0,100
4af433e99366e9458301013bcbe9a5da4277c606,1,1,1,2,0,0,0,2,2,771,1,1,0,50,3,0,10,10,0,297,294,3,9,9,0,100
65ace1086680d680ab81fce7c725437db9996dfe,0,0,0,0,0,0,0,0,0,0,0,0,0,0,4,1,0,0,0,0,0,0,0,0,0,100
cb2b38dd7ee1a0406fc5ebb17761a1d9223b8dd1,0,0,0,0,0,0,0,0,0,0,0,0,0,0,5,2,0,0,0,0,0,0,0,0,0,100
7ceae1b5d52a24a23e74accb345ff535ca391b34,0,0,0,0,0,0,0,0,0,0,0,0,0,0,6,3,0,0,0,0,0,0,0,0,0,100
e1842847b31f1c802f7c32fe7135096e063899bd,0,0,0,0,0,0,0,0,0,0,0,0,0,0,7,4,0,0,0,0,0,0,0,0,0,100
3743da48981761d6b653d80b1cee9bcaa54c7011,23,1093,1690,2783,6,0,6,3,3,567,2,4,3.875372745,1340,0,0,162,236,74,7244,9807,2563,75,110,35,88.80484115
9928332b3f375041bad2824ed723f7f279b903f7,11,181,1,182,1,0,1,2,3,0,1,2,3.321166002,828,1,1,149,149,0,6730,6730,0,67,67,0,99.6835443
bdfc5bb48e24463b3b9362e0c3dc6fbb584504d4,0,0,0,0,0,0,0,0,0,0,0,0,0,0,0,0,0,0,0,0,0,0,0,0,0,100
17a7112d2c9091e87a511d753fa40e1767f38f0c,0,0,0,0,0,0,0,0,0,0,0,0,0,0,8,0,0,0,0,0,0,0,0,0,0,100
189b92e40747dee516eb060723606b2573b6df8a,19,92,59,151,0,0,0,2,6,840,3,16,3.618889687,2175,9,1,372,369,3,17466,17093,373,201,200,1,100
7fc5067426717dadcdb875f6d0d3758fbbeed25c,0,0,0,0,0,0,0,0,0,0,0,0,0,0,10,2,0,0,0,0,0,0,0,0,0,100
8cda8a401d28a02338fab466f8641976c9ea5e0f,2,24,3,27,0,0,0,2,4,649,1,2,0.605186577,577,11,3,82,82,0,5283,5259,24,35,35,0,100
18d2fc2cce689f2ca3af70dd7a43959121ac4413,0,0,0,0,0,0,0,0,0,0,0,0,0,0,12,4,0,0,0,0,0,0,0,0,0,100
3abd4220efcaf0e89a1c266279a08f80000f0782,0,0,0,0,0,0,0,0,0,0,0,0,0,0,13,5,0,0,0,0,0,0,0,0,0,100
f374c70b9a184e8e4f694c8d57a5652571c24c73,0,0,0,0,0,0,0,0,0,0,0,0,0,0,14,5,0,0,0,0,0,0,0,0,0,100
682e27ad01798aed227777fb04941e01400058b2,1,23,4,27,0,0,0,2,4,214,1,1,0,256,2,0,60,58,2,2131,2071,60,17,17,0,100
5d3e49ea36a52f1c26f0ed687b448c325cb46351,0,0,0,0,0,0,0,0,0,0,0,0,0,0,15,1,0,0,0,0,0,0,0,0,0,100
3d2484c70fd2f93b63be8eb8ffefcb5ec2e9323e,0,0,0,0,0,0,0,0,0,0,0,0,0,0,1,0,0,0,0,0,0,0,0,0,0,100
ebbabd4d958c0234e379e764e137dadf483b8cc3,0,0,0,0,0,0,0,0,0,0,0,0,0,0,0,0,0,0,0,0,0,0,0,0,0,100
7158877fd653febff775bbe2e0a2aadb8f6c5222,0,0,0,0,0,0,0,0,0,0,0,0,0,0,1,1,0,0,0,0,0,0,0,0,0,100
7ed697bb7c6d4c57d70993963c3996e112eac296,1,1,1,2,0,0,0,4,4,131,1,1,0,492,2,2,108,108,0,4011,4009,2,28,28,0,100
9e353e6d37ca805179c2abd3a9a94ff43a12739a,1,0,1,1,0,0,0,4,5,15,1,1,0,492,3,3,108,108,0,4011,4011,0,28,28,0,100
5b939b021c92a1398450a8417b7fe63f8d07ac9a,1,1,0,1,0,0,0,4,6,2,1,1,0,492,4,4,108,108,0,4011,4011,0,28,28,0,100
1be4d216dc9f2e93348e3f44417628cb9471f223,4,384,90,474,1,0,1,1,7,502,1,1,1.532731903,608,5,0,174,139,35,6126,4815,1311,77,44,33,97.12556732
89c8319064d79cc9ef3684ff30774242957aa7e1,1,1,1,2,0,0,0,4,8,0,1,1,0,492,6,1,106,106,0,3998,3998,0,28,28,0,100
74cbfb0caa264382f0d0dad444daadd8c192349c,0,0,0,0,0,0,0,0,0,0,0,0,0,0,7,2,0,0,0,0,0,0,0,0,0,100
fbfbb8c3fcf27ba786c5dc7d4c64a0b876a6024d,0,0,0,0,0,0,0,0,0,0,0,0,0,0,8,3,0,0,0,0,0,0,0,0,0,100
a919af24d181f8bc70c1e64d7d9537f8cd2ac205,0,0,0,0,0,0,0,0,0,0,0,0,0,0,9,4,0,0,0,0,0,0,0,0,0,100
968b228f5106292d28c98e5bb19826dc55c7477c,1,18,0,18,0,0,0,3,4,558,1,1,0,32,10,1,0,0,0,229,229,0,0,0,0,100
11eed24317f70066800174d2e9ab0f33a4a8e90d,0,0,0,0,0,0,0,0,0,0,0,0,0,0,11,2,0,0,0,0,0,0,0,0,0,100
9a9d906dc3fd402bff6b147b7bd6ced5ecc75bbb,0,0,0,0,0,0,0,0,0,0,0,0,0,0,12,3,0,0,0,0,0,0,0,0,0,100
eaef7cbca52a7198e172f6aa00bd08e7ad114680,0,0,0,0,0,0,0,0,0,0,0,0,0,0,2,0,0,0,0,0,0,0,0,0,0,100
83d2fa86627d587ac4f2520813680672940bfb2b,1,3,2,5,0,0,0,2,2,1289,1,1,0,71,3,1,11,11,0,472,429,43,7,7,0,100
e2a90e7304d536057c10dfd34718131545fb5f66,0,0,0,0,0,0,0,0,0,0,0,0,0,0,13,3,0,0,0,0,0,0,0,0,0,100
5d3df3a55fe60ecd85e0dd4fe8f27edf68296735,0,0,0,0,0,0,0,0,0,0,0,0,0,0,4,2,0,0,0,0,0,0,0,0,0,100
6214f5432d220de5f3294d7b66e18a7bf24a809a,0,0,0,0,0,0,0,0,0,0,0,0,0,0,5,3,0,0,0,0,0,0,0,0,0,100
f772803a9cb1fd9720492a641175d1a5762312d1,0,0,0,0,0,0,0,0,0,0,0,0,0,0,6,4,0,0,0,0,0,0,0,0,0,100
7b6bfdd31f7fd5d4e4cc447131606b90bdb1dd40,0,0,0,0,0,0,0,0,0,0,0,0,0,0,7,5,0,0,0,0,0,0,0,0,0,100
c0e2f8a7ea62890daf38b0d936a7b507f8fe7abd,2,17,25,42,0,0,0,1,1,0,1,1,0.998363673,80,8,6,8,5,3,516,282,234,8,5,3,93.06784661
88c3c054cdc95a973ae33adcab158a4a052b81c4,1,0,1,1,0,0,0,2,2,1311,1,1,0,269,9,7,47,47,0,1633,1638,5,40,40,0,100
deab9d45777ba7c4aa302d2983b9595b95d1481a,1,21,2,23,0,0,0,3,3,305,1,1,0,89,10,8,12,9,3,810,777,33,12,9,3,100
13ced4472812ed97f652974f77705744ee4f522f,0,0,0,0,0,0,0,0,0,0,0,0,0,0,14,1,0,0,0,0,0,0,0,0,0,100
76294f7cdbdd7e00b294d009d8f5e0b3a1218c76,9,83,14,97,1,0,1,2,4,804,2,7,1.921062621,1851,11,2,383,372,11,13760,13490,270,162,158,4,99.6996997
c4c1b4c3f30df3836d79ca857229f29bc0c74a67,0,0,0,0,0,0,0,0,0,0,0,0,0,0,15,1,0,0,0,0,0,0,0,0,0,100
db864f74704aa772622bd689ed981bb228aa1404,0,0,0,0,0,0,0,0,0,0,0,0,0,0,16,2,0,0,0,0,0,0,0,0,0,100
f355e0141993c41a56d2a395b31b5e3668ab9b0d,1,6,1,7,0,0,0,3,3,355,1,1,0,533,17,3,82,82,0,4859,4847,12,35,35,0,100
6e9227d2976f8f2c45c2923da5e844a5d60d9f4f,0,0,0,0,0,0,0,0,0,0,0,0,0,0,0,0,0,0,0,0,0,0,0,0,0,100
28cf29a99cfaebcd86af04ee1183cb00d776e580,0,0,0,0,0,0,0,0,0,0,0,0,0,0,0,0,0,0,0,0,0,0,0,0,0,100
8a0a59a0b2432ff57b53a9c288c80a4504c27366,1,3,3,6,0,0,0,2,3,551,1,1,0,156,18,1,24,24,0,1571,1580,9,11,11,0,100
05c57b29f713b35f984a1b9810e357d9d9a76757,0,0,0,0,0,0,0,0,0,0,0,0,0,0,18,1,0,0,0,0,0,0,0,0,0,100
0aef8cfefcecbf1145eb3781c1bdff042da7d7a7,1,1,1,2,0,0,0,3,4,38,1,1,0,535,19,2,82,82,0,4859,4859,0,35,35,0,100
39eec62caeb9f41b1f616bbee34fdd6a80539cce,0,0,0,0,0,0,0,0,0,0,0,0,0,0,19,2,0,0,0,0,0,0,0,0,0,100
8d65f6141486b765443b820aa907d1f1761fa76b,0,0,0,0,0,0,0,0,0,0,0,0,0,0,12,0,0,0,0,0,0,0,0,0,0,100
2d5ca013cb24ca2cdf2ced6019df115737f977d5,0,0,0,0,0,0,0,0,0,0,0,0,0,0,12,0,0,0,0,0,0,0,0,0,0,100
4bbe6600c948ab7a6ae902d6aacf051c560fdf2b,0,0,0,0,0,0,0,0,0,0,0,0,0,0,13,1,0,0,0,0,0,0,0,0,0,100
1eb7a24413002255b5caa9e72945b137b9fa08b7,0,0,0,0,0,0,0,0,0,0,0,0,0,0,13,1,0,0,0,0,0,0,0,0,0,100
4e6d272f42263c7590e5db9f247d7ef3584254d1,1,1,1,2,0,0,0,2,4,13,1,1,0,156,20,2,24,24,0,1573,1571,2,11,11,0,100
872d65fb885e2998e3f64d0cbb83ec77023777cf,0,0,0,0,0,0,0,0,0,0,0,0,0,0,20,2,0,0,0,0,0,0,0,0,0,100
383baeffcd3bea28260eb209d060117bdf208a44,0,0,0,0,0,0,0,0,0,0,0,0,0,0,0,0,0,0,0,0,0,0,0,0,0,100
d7d0bbc0eef9a3ab59702d7eaf155a8de3bc5bd8,0,0,0,0,0,0,0,0,0,0,0,0,0,0,0,0,0,0,0,0,0,0,0,0,0,100
946bc11201972c71824372254131ca07ac611db3,0,0,0,0,0,0,0,0,0,0,0,0,0,0,21,3,0,0,0,0,0,0,0,0,0,100
9f0c279388cd5f9269b890cf5f5d97ca77f6775e,0,0,0,0,0,0,0,0,0,0,0,0,0,0,21,3,0,0,0,0,0,0,0,0,0,100
3b0c49b95344109f9ce4a75137a235c3b1c233d6,0,0,0,0,0,0,0,0,0,0,0,0,0,0,22,4,0,0,0,0,0,0,0,0,0,100
42a854b9d028b9b7dbb504144089aabc6e05a7eb,0,0,0,0,0,0,0,0,0,0,0,0,0,0,22,4,0,0,0,0,0,0,0,0,0,100
3a49abe0011f5dd0e32947028e3e4d0dcb4e2585,0,0,0,0,0,0,0,0,0,0,0,0,0,0,14,2,0,0,0,0,0,0,0,0,0,100
885811d7f7d071b2ee9cccfc6af8e64c0de42c1e,0,0,0,0,0,0,0,0,0,0,0,0,0,0,14,2,0,0,0,0,0,0,0,0,0,100
accc74956bcd2e5cd3d73dcc869b70732e3b6f40,0,0,0,0,0,0,0,0,0,0,0,0,0,0,23,5,0,0,0,0,0,0,0,0,0,100
20aaac5c58740f29811d7965d13de9cad02a7022,0,0,0,0,0,0,0,0,0,0,0,0,0,0,23,5,0,0,0,0,0,0,0,0,0,100
586017e7cb4592c89c087d3d2ca37f7ae1bf7d72,0,0,0,0,0,0,0,0,0,0,0,0,0,0,24,4,0,0,0,0,0,0,0,0,0,100
bf90c77365e671bd45c809df444f6db9c2a80ee3,0,0,0,0,0,0,0,0,0,0,0,0,0,0,24,4,0,0,0,0,0,0,0,0,0,100
41835d87406be142a67da9039de3391351a412c1,1,20,0,20,0,0,0,2,5,54,1,1,0,156,25,3,24,24,0,1659,1573,86,11,11,0,100
b7aeb442953c5c2446031a186027e9a843b1c773,0,0,0,0,0,0,0,0,0,0,0,0,0,0,25,3,0,0,0,0,0,0,0,0,0,100
716c834ab5db5e7a94534d4625c4620fc514080d,0,0,0,0,0,0,0,0,0,0,0,0,0,0,26,4,0,0,0,0,0,0,0,0,0,100
ce0d9958ce38e4da5e437f37140a6ac8aaea4f0c,0,0,0,0,0,0,0,0,0,0,0,0,0,0,26,4,0,0,0,0,0,0,0,0,0,100
d46bc08e453dbcc7e6bf57df30f5bc8b3458a99f,2,10,3,13,0,0,0,3,5,269,2,2,0.89049164,423,27,4,91,90,1,3222,3141,81,37,37,0,100
a95d0ff795c3d3689bfa4b87b620662f475c89bb,0,0,0,0,0,0,0,0,0,0,0,0,0,0,27,4,0,0,0,0,0,0,0,0,0,100
a6dd821b7352251ceec92f13050a475cf35130b1,0,0,0,0,0,0,0,0,0,0,0,0,0,0,28,5,0,0,0,0,0,0,0,0,0,100
94b842e0a40aa8ddb3eec1a64e20a6a6dab10def,0,0,0,0,0,0,0,0,0,0,0,0,0,0,28,5,0,0,0,0,0,0,0,0,0,100
656e8c03b535b7caeb86589716b5d9ec6d381be6,0,0,0,0,0,0,0,0,0,0,0,0,0,0,29,6,0,0,0,0,0,0,0,0,0,100
9f6f914de2cdbfcdd4f6f21b04e8c52eae6513cd,0,0,0,0,0,0,0,0,0,0,0,0,0,0,29,6,0,0,0,0,0,0,0,0,0,100
ae1483645dada6027542fe3428aa04b2fa72791d,2,10,2,12,0,0,0,3,5,121,1,1,0.650022422,803,30,7,129,129,0,6492,6492,0,75,75,0,100
0f516a44ffd104af78107b2d3c3c2d77a5fa11dc,0,0,0,0,0,0,0,0,0,0,0,0,0,0,30,7,0,0,0,0,0,0,0,0,0,100
9dde359ddbf5d688735e9ea9b7286358457fca13,2,197,19,216,1,0,1,1,2,742,1,2,0.996038361,113,1,0,72,58,14,2254,1348,906,10,4,6,95.09493671
aa33dddf543a5b7e3489b63e951c623b6c6ea979,0,0,0,0,0,0,0,0,0,0,0,0,0,0,1,0,0,0,0,0,0,0,0,0,0,100
b8de48a7831711d6a0862ddb3da10d4e102ac58f,2,34,0,34,0,0,0,2,2,1378,1,1,1,204,31,6,66,66,0,1353,1353,0,42,42,0,100
59def38a4e0c53446aec63a238d8ec4c6f0a96b5,0,0,0,0,0,0,0,0,0,0,0,0,0,0,31,6,0,0,0,0,0,0,0,0,0,100
dc24a48411a2652e313abdf8a6f93bce59beb8d4,0,0,0,0,0,0,0,0,0,0,0,0,0,0,32,7,0,0,0,0,0,0,0,0,0,100
fa471a637f3b6adf5c9c22bb3f736d7c6f6dced3,0,0,0,0,0,0,0,0,0,0,0,0,0,0,32,7,0,0,0,0,0,0,0,0,0,100
c066b1666df0db7872a062529de62fb206a3d91f,3,109,73,182,0,0,0,5,9,315,1,1,1.187706089,635,2,1,147,142,5,5085,4951,134,47,47,0,100
b094802ac43001ec04f65bbb34a3292e4958dae6,0,0,0,0,0,0,0,0,0,0,0,0,0,0,2,1,0,0,0,0,0,0,0,0,0,100
cea6c41780719d5cfff77d880b2519399b2e24e8,1,13,10,23,0,0,0,5,10,5,1,1,0,494,3,2,108,107,1,4005,3997,8,28,28,0,100
558947ef653a2ca2b38fc1656881248366f51197,0,0,0,0,0,0,0,0,0,0,0,0,0,0,3,2,0,0,0,0,0,0,0,0,0,100
ccedbdd84405031b279fb9bbe5f16023f06caa49,2,153,642,795,0,0,0,2,4,866,1,2,0.438356361,732,33,2,60,154,94,1668,5367,3699,58,40,18,100
9580086bcbbb377b7c07c96cf1abe40b1b4f7b9b,0,0,0,0,0,0,0,0,0,0,0,0,0,0,33,2,0,0,0,0,0,0,0,0,0,100
ffe654ae874ab00f7cf07712626ea59a0ae2c432,0,0,0,0,0,0,0,0,0,0,0,0,0,0,34,3,0,0,0,0,0,0,0,0,0,100
bf5d4babac7b6149b75b5feb1b3d11e640c45338,0,0,0,0,0,0,0,0,0,0,0,0,0,0,34,3,0,0,0,0,0,0,0,0,0,100
810440fded63beee91d84f30df375e840e0e64ff,0,0,0,0,0,0,0,0,0,0,0,0,0,0,35,4,0,0,0,0,0,0,0,0,0,100
b15813017f2b9c496b1004aa98398c93451e5299,0,0,0,0,0,0,0,0,0,0,0,0,0,0,35,4,0,0,0,0,0,0,0,0,0,100
9701ea398ba8a9fea6e84b84eb99dd0d405021ff,8,283,84,367,2,0,2,1,5,468,1,8,1.736657263,655,4,0,140,131,9,5389,4850,539,79,77,2,99.16805324
bbad5d213f05de4aec1de7919bc490bea0bf47be,0,0,0,0,0,0,0,0,0,0,0,0,0,0,4,0,0,0,0,0,0,0,0,0,0,100
afe46a31902d79e7dc8f0dd50e4fa5905c43c593,1,6,4,10,0,0,0,2,2,1607,1,1,0,42,36,0,5,6,1,243,263,20,5,6,1,100
a7f52f1365c45c240135c6858b023f03f00ad00a,0,0,0,0,0,0,0,0,0,0,0,0,0,0,36,0,0,0,0,0,0,0,0,0,0,100
87c974611d7c6befc889794112c0452f0bb4053b,2,2,2,4,0,0,0,3,6,134,1,1,1,436,37,1,85,85,0,3868,3868,0,28,28,0,100
3a1a9c6a8fd77551b89f64c741dc7d669213c240,0,0,0,0,0,0,0,0,0,0,0,0,0,0,37,1,0,0,0,0,0,0,0,0,0,100
f5f1547d77d299f55a13a73c80c51cf6d9d68020,14,2059,0,2059,14,0,14,1,1,0,1,6,3.016018113,0,0,0,340,0,340,13158,0,13158,119,0,119,93.19620253
e4db20a1c92023bfcfb600d3fd739e9faed8d1e4,0,0,0,0,0,0,0,0,0,0,0,0,0,0,0,0,0,0,0,0,0,0,0,0,0,100
c978e8016d658d6935b67d44ec6b0bdbb80a178f,0,0,0,0,0,0,0,0,0,0,0,0,0,0,1,1,0,0,0,0,0,0,0,0,0,100
dcf1878f260727a85933fbd33c2c1bc9b7032bac,0,0,0,0,0,0,0,0,0,0,0,0,0,0,1,1,0,0,0,0,0,0,0,0,0,100
126259baaab72a8465737dd7ed632588389455f8,1,7,0,7,0,0,0,1,2,2,1,1,0,18,2,2,3,2,1,178,165,13,3,2,1,100
e1fc5d4c8d1f69d23afde99a91cc222bac9ece65,0,0,0,0,0,0,0,0,0,0,0,0,0,0,2,2,0,0,0,0,0,0,0,0,0,100
56f06bdb55e1e630b5a5c19e7fc235948de24d80,1,18,5,23,0,0,0,2,3,18,1,1,0,38,38,2,6,5,1,309,243,66,5,5,0,100
be97b66135445b504663862c6633be104e86e04e,0,0,0,0,0,0,0,0,0,0,0,0,0,0,38,2,0,0,0,0,0,0,0,0,0,100
f13c73ec6c585fc7c4692605cb3075e980765351,0,0,0,0,0,0,0,0,0,0,0,0,0,0,5,1,0,0,0,0,0,0,0,0,0,100
8277a58dc9975d6e97f95ef6120519984533a824,0,0,0,0,0,0,0,0,0,0,0,0,0,0,5,1,0,0,0,0,0,0,0,0,0,100
de29d0cfb2e6740b0552877870a4f471df032a08,0,0,0,0,0,0,0,0,0,0,0,0,0,0,39,3,0,0,0,0,0,0,0,0,0,100
0af3633956540b82cb511685d119e393a6cf830d,0,0,0,0,0,0,0,0,0,0,0,0,0,0,39,3,0,0,0,0,0,0,0,0,0,100
d48166d2de4cc0fdca5f91d61d7e5f9761a42eae,0,0,0,0,0,0,0,0,0,0,0,0,0,0,40,4,0,0,0,0,0,0,0,0,0,100
744621dd076cba9d1c561d604172fe07db843d40,0,0,0,0,0,0,0,0,0,0,0,0,0,0,40,4,0,0,0,0,0,0,0,0,0,100
bacaaf98a58e1c9eae0549895b63e0cdca9c60e9,0,0,0,0,0,0,0,0,0,0,0,0,0,0,41,5,0,0,0,0,0,0,0,0,0,100
fdddf7417e5fb696ca53f387264ec1f5472800e2,0,0,0,0,0,0,0,0,0,0,0,0,0,0,41,5,0,0,0,0,0,0,0,0,0,100
723f21baa6392219edd5e9b2d7b892c55ae31a0d,0,0,0,0,0,0,0,0,0,0,0,0,0,0,42,6,0,0,0,0,0,0,0,0,0,100
6d27a4bbc417cdd05966788dcdcfb0ba200b70e9,0,0,0,0,0,0,0,0,0,0,0,0,0,0,42,6,0,0,0,0,0,0,0,0,0,100
c28d8caa72af1d70d39dc5e6fc74f58615e04090,0,0,0,0,0,0,0,0,0,0,0,0,0,0,43,7,0,0,0,0,0,0,0,0,0,100
b24046e8ea4eef2543d098a3cab91837df9d7d1d,0,0,0,0,0,0,0,0,0,0,0,0,0,0,43,7,0,0,0,0,0,0,0,0,0,100
674b3fcddd320d49f1c093a0346bae6a29a7bb0f,0,0,0,0,0,0,0,0,0,0,0,0,0,0,44,8,0,0,0,0,0,0,0,0,0,100
e33af08ef072e637b66d7bf975bd1985b597eb2b,0,0,0,0,0,0,0,0,0,0,0,0,0,0,44,8,0,0,0,0,0,0,0,0,0,100
7bf92af1f13d94257a43b8c48ec3c46b9f6614a0,1,2,1,3,0,0,0,5,11,108,1,1,0,496,45,9,108,108,0,4019,4005,14,28,28,0,100
e9aac87a57656c4c938982c4b2764abda25016ab,0,0,0,0,0,0,0,0,0,0,0,0,0,0,45,9,0,0,0,0,0,0,0,0,0,100
751ea79c4288234fdd01bd5a530f8bc062a66338,0,0,0,0,0,0,0,0,0,0,0,0,0,0,46,10,0,0,0,0,0,0,0,0,0,100
0119303c029d4e75e59a00c9361404ba79c63756,0,0,0,0,0,0,0,0,0,0,0,0,0,0,46,10,0,0,0,0,0,0,0,0,0,100
e33ef9e547e9c5477d79bd0e13b8b9cc0cc3d8c1,0,0,0,0,0,0,0,0,0,0,0,0,0,0,47,11,0,0,0,0,0,0,0,0,0,100
731380d4aa31bf06d932901227060bf6734f882c,0,0,0,0,0,0,0,0,0,0,0,0,0,0,47,11,0,0,0,0,0,0,0,0,0,100
cc34812a8dfa1a35022019713c8cb59618a5a269,0,0,0,0,0,0,0,0,0,0,0,0,0,0,48,12,0,0,0,0,0,0,0,0,0,100
de48c0c28f5ea0fb97112f30747efe36b2680ca1,0,0,0,0,0,0,0,0,0,0,0,0,0,0,48,12,0,0,0,0,0,0,0,0,0,100
0dc916659db0e3a764a0e614fc61012ce9eac4d2,1,3,1,4,0,0,0,2,2,429,1,1,0,174,6,2,33,32,1,1182,1175,7,30,30,0,100
739a1c803eff48b717c5cad9c3bcbc1e7be9b286,0,0,0,0,0,0,0,0,0,0,0,0,0,0,6,2,0,0,0,0,0,0,0,0,0,100
0a8b1b3cf24058f077f7787c2f29059229c1f366,0,0,0,0,0,0,0,0,0,0,0,0,0,0,49,13,0,0,0,0,0,0,0,0,0,100
922c4f67791693bed7a7a04f679f7b71bd832eda,0,0,0,0,0,0,0,0,0,0,0,0,0,0,49,13,0,0,0,0,0,0,0,0,0,100
500555196eb18567997339ad363e03645c1a9b1d,0,0,0,0,0,0,0,0,0,0,0,0,0,0,50,14,0,0,0,0,0,0,0,0,0,100
9b0659431f9fa2d03cd9154c222ec3d4d19025a5,0,0,0,0,0,0,0,0,0,0,0,0,0,0,50,14,0,0,0,0,0,0,0,0,0,100
ef2d6d5bd3a47f2fbf974110b9e6a31d5eb09b7e,0,0,0,0,0,0,0,0,0,0,0,0,0,0,51,15,0,0,0,0,0,0,0,0,0,100
ed03a36d760a7b2bf87f0ad46f260ba15212d9b6,0,0,0,0,0,0,0,0,0,0,0,0,0,0,51,15,0,0,0,0,0,0,0,0,0,100
9d71be171a4a08fcc777bea50f418d087f2c2f49,0,0,0,0,0,0,0,0,0,0,0,0,0,0,52,16,0,0,0,0,0,0,0,0,0,100
04431162060d430c9e064625f886f675a38b9ad5,0,0,0,0,0,0,0,0,0,0,0,0,0,0,52,16,0,0,0,0,0,0,0,0,0,100
c45e0df0bae0a44b1aa68fb293d45417194cb012,0,0,0,0,0,0,0,0,0,0,0,0,0,0,53,17,0,0,0,0,0,0,0,0,0,100
6afc971df7f9d522ed3f8d5f7985833989807b39,0,0,0,0,0,0,0,0,0,0,0,0,0,0,53,17,0,0,0,0,0,0,0,0,0,100
dc26bac4793dd51a2a8e55c0b251518e9f226c7c,0,0,0,0,0,0,0,0,0,0,0,0,0,0,54,16,0,0,0,0,0,0,0,0,0,100
ba41f3281bf3b666b573a5d57940bf3a0bf8db6d,0,0,0,0,0,0,0,0,0,0,0,0,0,0,54,16,0,0,0,0,0,0,0,0,0,100
5ded73e0949be1cf67c835150ba06b7126e386a8,0,0,0,0,0,0,0,0,0,0,0,0,0,0,55,17,0,0,0,0,0,0,0,0,0,100
9dd338a5c5c3214d3e5dd6ced12b64e1c8169522,0,0,0,0,0,0,0,0,0,0,0,0,0,0,55,17,0,0,0,0,0,0,0,0,0,100
37e29d4e00c542e2fef1d0f0a74262101c91f5c5,0,0,0,0,0,0,0,0,0,0,0,0,0,0,56,18,0,0,0,0,0,0,0,0,0,100
6a2dbc1853413541c826c3f23f493763a2e5803a,0,0,0,0,0,0,0,0,0,0,0,0,0,0,56,18,0,0,0,0,0,0,0,0,0,100
4f681b466b8f5ff28dd78da80b9024236d0e4d2a,0,0,0,0,0,0,0,0,0,0,0,0,0,0,57,19,0,0,0,0,0,0,0,0,0,100
aece99cc4b456558cea668358a18c96cbd1de684,0,0,0,0,0,0,0,0,0,0,0,0,0,0,57,19,0,0,0,0,0,0,0,0,0,100
3c619678eb9b261cee7596053038ca9dbac616ab,0,0,0,0,0,0,0,0,0,0,0,0,0,0,58,20,0,0,0,0,0,0,0,0,0,100
a61da1f47b41a8543e8667afe7ee1311c40c6236,0,0,0,0,0,0,0,0,0,0,0,0,0,0,58,20,0,0,0,0,0,0,0,0,0,100
187699d797b4973143a4dcf1d846c2e56dab97fb,0,0,0,0,0,0,0,0,0,0,0,0,0,0,59,21,0,0,0,0,0,0,0,0,0,100
26bf01ca6f88edf108642966cf7cacad5d5bac6e,0,0,0,0,0,0,0,0,0,0,0,0,0,0,59,21,0,0,0,0,0,0,0,0,0,100
aecd3c88935a06c698e00ef7e0a7537aa5fa0e7b,0,0,0,0,0,0,0,0,0,0,0,0,0,0,60,22,0,0,0,0,0,0,0,0,0,100
b5963fa0204995a66558cb97375711098b00af18,0,0,0,0,0,0,0,0,0,0,0,0,0,0,60,22,0,0,0,0,0,0,0,0,0,100
9f6611e931ae122f69c5aee5aac95e72f6bf778d,4,75,15,90,0,0,0,2,4,1474,1,3,1.605205793,484,7,2,129,124,5,3605,3424,181,59,58,1,100
0d33fed2a8ba1598fc554304b8a2e198b5d1f216,0,0,0,0,0,0,0,0,0,0,0,0,0,0,7,2,0,0,0,0,0,0,0,0,0,100
fe134ad602b538841a9feb92691da606c3b95170,0,0,0,0,0,0,0,0,0,0,0,0,0,0,61,23,0,0,0,0,0,0,0,0,0,100
228beb01b53eaaeaac3e19cb672f7dbe8c18cf91,0,0,0,0,0,0,0,0,0,0,0,0,0,0,61,23,0,0,0,0,0,0,0,0,0,100
d542c57da8e39cdd212a80620432d314f80d16d6,0,0,0,0,0,0,0,0,0,0,0,0,0,0,62,23,0,0,0,0,0,0,0,0,0,100
e4da216f8afc4deb3bf96307586d683ba05b77ae,0,0,0,0,0,0,0,0,0,0,0,0,0,0,62,23,0,0,0,0,0,0,0,0,0,100
b091caf768086954d0d4de82e776d1b50827b61d,0,0,0,0,0,0,0,0,0,0,0,0,0,0,63,24,0,0,0,0,0,0,0,0,0,100
4a90bb4dcf0d4c87c65701ed62595140e7f39267,0,0,0,0,0,0,0,0,0,0,0,0,0,0,63,24,0,0,0,0,0,0,0,0,0,100
cd484be43f505e595c31b1023950907457ab7425,0,0,0,0,0,0,0,0,0,0,0,0,0,0,64,25,0,0,0,0,0,0,0,0,0,100
eeee4beafb370693c987ac7c0f258078ec93cfb1,0,0,0,0,0,0,0,0,0,0,0,0,0,0,64,25,0,0,0,0,0,0,0,0,0,100
dced91ba52a4dab44d293ef379c5b05f2b0ff618,0,0,0,0,0,0,0,0,0,0,0,0,0,0,65,26,0,0,0,0,0,0,0,0,0,100
660f6dd293c899f09a0f1a8bedb623ae86df4cd5,0,0,0,0,0,0,0,0,0,0,0,0,0,0,65,26,0,0,0,0,0,0,0,0,0,100
4572936a4e76a8537e6e725bd09224310f921f74,0,0,0,0,0,0,0,0,0,0,0,0,0,0,66,12,0,0,0,0,0,0,0,0,0,100
780ad302ed2ff9df0225e609ca58f5bad42c4f18,0,0,0,0,0,0,0,0,0,0,0,0,0,0,66,12,0,0,0,0,0,0,0,0,0,100
b04e85950ee5d64f44dd358302291bf6ed7c40a9,0,0,0,0,0,0,0,0,0,0,0,0,0,0,67,6,0,0,0,0,0,0,0,0,0,100
b4ce8e1bf02efc2288c20439b6c80bee949e57aa,0,0,0,0,0,0,0,0,0,0,0,0,0,0,67,6,0,0,0,0,0,0,0,0,0,100
5429038e2b0a77420930bb5ef6ffb241845e8c63,0,0,0,0,0,0,0,0,0,0,0,0,0,0,8,0,0,0,0,0,0,0,0,0,0,100
132b4a6d8a276624dafd426f462b6b75ad99bab5,0,0,0,0,0,0,0,0,0,0,0,0,0,0,8,0,0,0,0,0,0,0,0,0,0,100
838dbb14bb82aada29d247b1557fef64f9eefc6b,1,4,6,10,0,0,0,5,12,92,1,1,0,497,9,1,108,108,0,4014,4019,5,28,28,0,100
b9505d55b600fa82cae3f11ddc11d7aafef03eea,0,0,0,0,0,0,0,0,0,0,0,0,0,0,9,1,0,0,0,0,0,0,0,0,0,100
bf010f26487edbfdfd79588df01fe5c9458ca40b,1,7,1,8,0,0,0,3,4,878,1,1,0,71,11,0,15,13,2,540,514,26,8,8,0,100
86eb95f8c1cc7acde6924e741997012fd3e1872d,0,0,0,0,0,0,0,0,0,0,0,0,0,0,11,0,0,0,0,0,0,0,0,0,0,100
dfa409fc04425e0b86d55a2a62afb43c0f299baa,1,2,0,2,0,0,0,1,2,116,1,1,0,690,3,0,197,197,0,6733,6721,12,30,30,0,100
d9d4d97ef760a0ff5488c04cb88ca21878aeb7b5,0,0,0,0,0,0,0,0,0,0,0,0,0,0,3,0,0,0,0,0,0,0,0,0,0,100
3612a67f5e73956c49fd8d3da801c773e43a6754,0,0,0,0,0,0,0,0,0,0,0,0,0,0,12,0,0,0,0,0,0,0,0,0,0,100
1586ac478a4815b5bc611e857e557085bf79e45e,0,0,0,0,0,0,0,0,0,0,0,0,0,0,12,0,0,0,0,0,0,0,0,0,0,100
84d87c276902acfb261631b4deeebb67b961d035,1,3,3,6,0,0,0,5,6,140,1,1,0,228,13,1,54,54,0,1901,1901,0,26,26,0,100
bd557a04a85dad282c08f820f0935e20a2c9eb74,0,0,0,0,0,0,0,0,0,0,0,0,0,0,13,1,0,0,0,0,0,0,0,0,0,100
ea8ddfb3c2c33d00bdcef672e998871c3e1f4747,1,1,1,2,0,0,0,3,3,737,1,1,0,163,14,2,27,27,0,1308,1308,0,14,14,0,100
e3a8ca558c96ef8c5d61a27315ddb1e7ba991d68,0,0,0,0,0,0,0,0,0,0,0,0,0,0,14,2,0,0,0,0,0,0,0,0,0,100
1b4ea508f6e4b01de5ed511cc7b39b8858248b55,1,1,1,2,0,0,0,3,3,984,1,1,0,380,68,1,113,113,0,3083,3083,0,19,19,0,100
aa8402da983cd81f073a11b97e6e43230483ec2b,0,0,0,0,0,0,0,0,0,0,0,0,0,0,68,1,0,0,0,0,0,0,0,0,0,100
6c1cf81074f71979dd4dbf022c997bb1df99ddfd,0,0,0,0,0,0,0,0,0,0,0,0,0,0,69,2,0,0,0,0,0,0,0,0,0,100
77684c1487aa7d14cd2457c0f0f43d54266ff8a4,0,0,0,0,0,0,0,0,0,0,0,0,0,0,69,2,0,0,0,0,0,0,0,0,0,100
6ed2c732ef793d39d1805a543b637df987292f2c,2,7,2,9,0,0,0,4,4,6,2,2,0.918295834,543,70,2,140,140,0,4454,4391,63,33,33,0,100
534c0d9a04c48313e8a6d42c7f594852955d69bc,0,0,0,0,0,0,0,0,0,0,0,0,0,0,70,2,0,0,0,0,0,0,0,0,0,100
a4a2e99a6a05276bf04300c2b8f0381502ff2a73,1,54,4,58,0,0,0,3,4,904,1,1,0,102,71,3,19,13,6,1021,833,188,8,8,0,100
42aa7ce3247c1123a7f83e6908c931f65420038c,0,0,0,0,0,0,0,0,0,0,0,0,0,0,71,3,0,0,0,0,0,0,0,0,0,100
9fabc724c8b86be6cba1b70098b9b1823434c33e,2,46,1,47,1,0,1,1,2,877,1,2,0.25387844,70,72,4,18,16,2,534,407,127,14,13,1,99.39485628
5b719e97a0501c40a215d8b29364ba30eaf63fe6,0,0,0,0,0,0,0,0,0,0,0,0,0,0,72,4,0,0,0,0,0,0,0,0,0,100
75b7f20442e76f9c317126ae8a32885d7b336c1b,0,0,0,0,0,0,0,0,0,0,0,0,0,0,73,5,0,0,0,0,0,0,0,0,0,100
25569236caafb46aae5d3184f198a32cf2e7947f,0,0,0,0,0,0,0,0,0,0,0,0,0,0,73,5,0,0,0,0,0,0,0,0,0,100
87ef4a2cbd4f2438bbdd0095b3eda564c113628c,11,35,35,70,0,0,0,4,13,518,4,10,3.449454802,2259,74,6,457,457,0,17260,17348,88,203,203,0,100
70ff159fc7b4535f6e59a17317cca5e1618803d9,0,0,0,0,0,0,0,0,0,0,0,0,0,0,74,6,0,0,0,0,0,0,0,0,0,100
dd76e0c809d355bc0558abcd021b87bb4a8f5fb2,7,163,111,274,0,0,0,3,7,694,1,2,2.212728771,684,75,7,136,125,11,6162,5679,483,45,46,1,100
85bd7251c245eb2f4bad7e685be88fe6f35ec33c,0,0,0,0,0,0,0,0,0,0,0,0,0,0,75,7,0,0,0,0,0,0,0,0,0,100
21f6c4efd940ae577e3359fe7c795cf758ae30bf,0,0,0,0,0,0,0,0,0,0,0,0,0,0,76,8,0,0,0,0,0,0,0,0,0,100
8c4668019c56a215060036ea75ae0ca81db886a3,0,0,0,0,0,0,0,0,0,0,0,0,0,0,76,8,0,0,0,0,0,0,0,0,0,100
f228a138c3e31bdaa0f2085c942235f006c9e32b,0,0,0,0,0,0,0,0,0,0,0,0,0,0,77,9,0,0,0,0,0,0,0,0,0,100
e388c78803801b96fd4bf18dddbeb82c8c8fee50,0,0,0,0,0,0,0,0,0,0,0,0,0,0,77,9,0,0,0,0,0,0,0,0,0,100
cc50fdeed3c43d8991137db3ffc0b82258d41bb0,1,3,3,6,0,0,0,3,5,10,1,1,0,133,78,10,19,19,0,1021,1021,0,8,8,0,100
f69a4981dc8e82f169ffac10f4e2c263a29144fa,0,0,0,0,0,0,0,0,0,0,0,0,0,0,78,10,0,0,0,0,0,0,0,0,0,100
d25807281cacf571a02868df9fb54e862a20b04e,6,190,147,337,0,0,0,3,8,182,1,2,2.360946345,737,79,6,141,137,4,6564,6087,477,49,47,2,100
22d8611923b2e08d7480b7818c379e628fb31454,0,0,0,0,0,0,0,0,0,0,0,0,0,0,79,6,0,0,0,0,0,0,0,0,0,100
d71bf00104a4e1c6e036d96c41cb03978977e4e9,0,0,0,0,0,0,0,0,0,0,0,0,0,0,80,1,0,0,0,0,0,0,0,0,0,100
49013e47f214656b3941fa234b4ce2646d94bba7,0,0,0,0,0,0,0,0,0,0,0,0,0,0,80,1,0,0,0,0,0,0,0,0,0,100
83c9255ebc2756a9fb781f39d7248aa55971acd7,1,2,0,2,0,0,0,4,6,139,1,1,0,384,0,0,114,113,1,3135,3125,10,19,19,0,100
ff3c64249c646ba8e336f9c14b7cb40e896f185f,0,0,0,0,0,0,0,0,0,0,0,0,0,0,0,0,0,0,0,0,0,0,0,0,0,100
2bfeabadb562a202c2150c213baf71a605401d25,1,5,5,10,0,0,0,5,14,148,1,1,0,496,10,0,109,108,1,4017,4006,11,28,28,0,100
16d3d6c588e38b76f01081c1e8b1b3923cc226f8,0,0,0,0,0,0,0,0,0,0,0,0,0,0,10,0,0,0,0,0,0,0,0,0,0,100
f545363eb34a5e007d7f18490987e1a5e8a6b4b8,1,6,1,7,0,0,0,2,3,275,1,1,0,176,11,1,33,33,0,1202,1182,20,30,30,0,100
519e3b2cc60d26c4371ee76a917da521bb6f84db,0,0,0,0,0,0,0,0,0,0,0,0,0,0,11,1,0,0,0,0,0,0,0,0,0,100
8c0ce1bae4f5766f178d530f26bba0c11962d286,0,0,0,0,0,0,0,0,0,0,0,0,0,0,1,1,0,0,0,0,0,0,0,0,0,100
c312754378f4379c822904d009058c52c23db67d,0,0,0,0,0,0,0,0,0,0,0,0,0,0,1,1,0,0,0,0,0,0,0,0,0,100
f979d9db1051b2ff055f3bb2df4567663575e04e,4,152,24,176,1,0,1,4,9,101,1,1,1.025734705,634,2,2,133,119,14,6027,5447,580,41,37,4,98.8005997
c52078487987b6191eda45ae00187452190107a4,0,0,0,0,0,0,0,0,0,0,0,0,0,0,2,2,0,0,0,0,0,0,0,0,0,100
ea9bc0f1ad05fb84965c5f7518d9e44753084144,12,1009,112,1121,6,0,6,1,10,40,1,3,3.080485657,778,3,3,316,141,175,11683,6589,5094,103,49,54,91.98966408
0eb90cd89f224be5efc63b4d0a8f54ef58aac5dd,0,0,0,0,0,0,0,0,0,0,0,0,0,0,3,3,0,0,0,0,0,0,0,0,0,100
5daddbac992f9cce26b2983740b59e3921f79007,1,8,5,13,0,0,0,4,5,333,1,1,0,164,12,2,31,30,1,1064,1072,8,20,20,0,100
99ab3c377dfeaff8400c08c2655f14aa275aeb8a,0,0,0,0,0,0,0,0,0,0,0,0,0,0,12,2,0,0,0,0,0,0,0,0,0,100
6962d3fc7ad347f791497543ff9776d2eb68f752,7,296,23,319,1,0,1,4,11,12,1,3,1.483289928,945,4,4,247,196,51,9518,7847,1671,66,53,13,98.6409966
085c000ad03cc988cd8c26c68dcb8d115d6887ed,0,0,0,0,0,0,0,0,0,0,0,0,0,0,4,4,0,0,0,0,0,0,0,0,0,100
7782f6e6d4336c55de08ac73637b889b3feb499c,7,264,13,277,2,0,2,4,6,271,3,7,1.559701199,570,5,5,115,97,18,4611,3795,816,84,73,11,98.74572406
263ecbd5e6f96f1ed5e454eb2ec0d26b8746d781,0,0,0,0,0,0,0,0,0,0,0,0,0,0,5,5,0,0,0,0,0,0,0,0,0,100
c53e448eeebe1fb7105dbe6465c0e5a2c31cebde,0,0,0,0,0,0,0,0,0,0,0,0,0,0,81,0,0,0,0,0,0,0,0,0,0,100
687a96cf8cef710919ecc0783de99c4edc59e1ac,0,0,0,0,0,0,0,0,0,0,0,0,0,0,81,0,0,0,0,0,0,0,0,0,0,100
e4db45b39a0cc8e5ce04654824fb142da180521d,1,5,8,13,0,0,0,4,6,2,1,1,0,165,13,3,30,31,1,1072,1064,8,20,20,0,100
963a2c764c6e6fc48671bbf4483231b9dc1109d7,0,0,0,0,0,0,0,0,0,0,0,0,0,0,13,3,0,0,0,0,0,0,0,0,0,100
3a750258627ab09e0b2febf5b6cc2fb758d3c12d,1,8,8,16,0,0,0,4,7,0,1,1,0,164,14,4,30,30,0,1061,1072,11,20,20,0,100
33fda86c3e8ee962aa82ec39051fae8358eb0eb2,0,0,0,0,0,0,0,0,0,0,0,0,0,0,14,4,0,0,0,0,0,0,0,0,0,100
feee9b225107939dac427fdd778336122352b264,1,14,0,14,0,0,0,1,2,187,1,1,0,21,82,1,4,2,2,217,132,85,2,1,1,100
ef10dcc56790d4ba38da9e6144513c7b597cda11,0,0,0,0,0,0,0,0,0,0,0,0,0,0,82,1,0,0,0,0,0,0,0,0,0,100
b4be1b3811786a7cba1be1d370989afc03078286,2,9,1,10,0,0,0,4,12,4,1,1,0.721928095,534,6,5,118,117,1,4622,4586,36,34,33,1,100
3a2d7f0eb6561c557fc512932643458af4c7343a,0,0,0,0,0,0,0,0,0,0,0,0,0,0,6,5,0,0,0,0,0,0,0,0,0,100
83487fe9ae50303258038b2c8b4a4ddb5ed56c25,1,14,3,17,0,0,0,4,6,463,1,1,0,535,7,6,84,82,2,4931,4859,72,36,35,1,100
08d2d760ca0995da8b55c448a660cfc403c6ff8a,0,0,0,0,0,0,0,0,0,0,0,0,0,0,7,6,0,0,0,0,0,0,0,0,0,100
36dfd5b95a854d36845621fd8f98228ab8d18064,4,45,9,54,0,0,0,1,13,5,1,2,1.641098481,773,8,7,161,161,0,6949,6758,191,60,57,3,100
44ff082465653250edae51964e8372210cb9327b,0,0,0,0,0,0,0,0,0,0,0,0,0,0,8,7,0,0,0,0,0,0,0,0,0,100
3cd16d2e855c5d0a504007003418c5dfafb02883,2,16,4,20,0,0,0,4,14,0,1,1,0.970950594,549,83,2,116,115,1,4741,4719,22,37,36,1,100
f2759ed60f086cb882d0745fef6ba2da34b8c4a7,0,0,0,0,0,0,0,0,0,0,0,0,0,0,83,2,0,0,0,0,0,0,0,0,0,100
e30f56d4480dedb98978aca9e7f0943c07ad6f6b,1,26,0,26,0,0,0,1,2,6,1,1,0,43,9,8,15,5,10,423,313,110,15,5,10,100
8dfed9a70cd1651e366fc8e2cf95938949e0c0ed,0,0,0,0,0,0,0,0,0,0,0,0,0,0,9,8,0,0,0,0,0,0,0,0,0,100
da3d7b04f59c9d46566729b7855358c1aa9de0f0,1,3,0,3,0,0,0,2,3,2,1,1,0,63,84,3,16,15,1,434,423,11,16,15,1,100
b324848c48992c6f6800c9e30909a387735ac787,0,0,0,0,0,0,0,0,0,0,0,0,0,0,84,3,0,0,0,0,0,0,0,0,0,100
4e3ccbb8fa4303099bfe29edc79e49fc506c31a5,0,0,0,0,0,0,0,0,0,0,0,0,0,0,10,9,0,0,0,0,0,0,0,0,0,100
b4d6b4e9e544bf5d0085ff0013b891a42331dd6c,0,0,0,0,0,0,0,0,0,0,0,0,0,0,10,9,0,0,0,0,0,0,0,0,0,100
8e24f854c929c09db06aa19b154554f3494b327f,1,0,2,2,0,0,0,2,4,0,1,1,0,65,85,4,15,16,1,423,434,11,15,16,1,100
cf52faece0cfc13843181d6530826485832a8d49,0,0,0,0,0,0,0,0,0,0,0,0,0,0,85,4,0,0,0,0,0,0,0,0,0,100
8595861f466ba057eaad62776e59c09cbd952320,0,0,0,0,0,0,0,0,0,0,0,0,0,0,11,10,0,0,0,0,0,0,0,0,0,100
0bec9d863a0c7b81c964b7eac9f33ae908f48f75,0,0,0,0,0,0,0,0,0,0,0,0,0,0,11,10,0,0,0,0,0,0,0,0,0,100
f4788c81949d6608e6447c952bd4bf467b5db3e8,0,0,0,0,0,0,0,0,0,0,0,0,0,0,86,5,0,0,0,0,0,0,0,0,0,100
fa07cf8e3d2c451702214dc67658d9f36bc2bbf8,0,0,0,0,0,0,0,0,0,0,0,0,0,0,86,5,0,0,0,0,0,0,0,0,0,100
97d88cc3fa15ee53a8e491a88ab8ebbb59f38163,0,0,0,0,0,0,0,0,0,0,0,0,0,0,87,6,0,0,0,0,0,0,0,0,0,100
9b4e2f648b6c725517af3e43975ce38877d3cff8,0,0,0,0,0,0,0,0,0,0,0,0,0,0,87,6,0,0,0,0,0,0,0,0,0,100
de0f23036b2dc29a810ba33f49caffd1a7c655e4,0,0,0,0,0,0,0,0,0,0,0,0,0,0,88,7,0,0,0,0,0,0,0,0,0,100
3b9e369c2a45c1391ee0b9a250cec72c2538a177,0,0,0,0,0,0,0,0,0,0,0,0,0,0,88,7,0,0,0,0,0,0,0,0,0,100
3cd56ab34e19d5e9a035115afad9c48f01d72356,0,0,0,0,0,0,0,0,0,0,0,0,0,0,89,8,0,0,0,0,0,0,0,0,0,100
014aae87aca2867947f249d11ef45ff703c9bfd6,0,0,0,0,0,0,0,0,0,0,0,0,0,0,89,8,0,0,0,0,0,0,0,0,0,100
a6f68e1474c4ffb49d1dddeb5a1adba8380a8197,0,0,0,0,0,0,0,0,0,0,0,0,0,0,90,9,0,0,0,0,0,0,0,0,0,100
1b1e5989e52cc0aebded938b2f874d6869e68c53,0,0,0,0,0,0,0,0,0,0,0,0,0,0,90,9,0,0,0,0,0,0,0,0,0,100
8991c5b0977d226a5d9b00be3089e84d74204dc4,0,0,0,0,0,0,0,0,0,0,0,0,0,0,91,10,0,0,0,0,0,0,0,0,0,100
935aaaae9858e2e91f51e98b03ffcd3ff95a7f4b,0,0,0,0,0,0,0,0,0,0,0,0,0,0,91,10,0,0,0,0,0,0,0,0,0,100
f6a1dd621600f01b2e85666a4d06b4391bb21871,0,0,0,0,0,0,0,0,0,0,0,0,0,0,92,11,0,0,0,0,0,0,0,0,0,100
09d7bc992bc080109d1e9eed5b75f003b3b2f22e,0,0,0,0,0,0,0,0,0,0,0,0,0,0,92,11,0,0,0,0,0,0,0,0,0,100
33af553add6a40e123fadbcdafd382748c6c724e,0,0,0,0,0,0,0,0,0,0,0,0,0,0,93,12,0,0,0,0,0,0,0,0,0,100
be63175b5cebe17130cae8b3b1f63a6e56de3fa3,0,0,0,0,0,0,0,0,0,0,0,0,0,0,93,12,0,0,0,0,0,0,0,0,0,100
6698f7c20ae97faa124b431022de8a4499ca6d6b,0,0,0,0,0,0,0,0,0,0,0,0,0,0,94,8,0,0,0,0,0,0,0,0,0,100
43c25f33cbeceb80e7fea0e83e9f97a4dfbf1736,0,0,0,0,0,0,0,0,0,0,0,0,0,0,94,8,0,0,0,0,0,0,0,0,0,100
a96d68aebc480a1a7624977ff7c3c5244228b887,0,0,0,0,0,0,0,0,0,0,0,0,0,0,95,9,0,0,0,0,0,0,0,0,0,100
068fe59b9a67da5ee8a39642a1cfa1c8123a4fcd,0,0,0,0,0,0,0,0,0,0,0,0,0,0,95,9,0,0,0,0,0,0,0,0,0,100
e48277eaeb96b4507b728a443fed29a64e33ef1d,0,0,0,0,0,0,0,0,0,0,0,0,0,0,96,4,0,0,0,0,0,0,0,0,0,100
45402e8e98f9a620e4a154f44902871343a2073e,0,0,0,0,0,0,0,0,0,0,0,0,0,0,96,4,0,0,0,0,0,0,0,0,0,100
1ab2d8b864a81aa449ccb06529d0910818dfcea5,0,0,0,0,0,0,0,0,0,0,0,0,0,0,97,4,0,0,0,0,0,0,0,0,0,100
ef3c4ab865c0e363ba61254de1ff75a05de3b007,0,0,0,0,0,0,0,0,0,0,0,0,0,0,97,4,0,0,0,0,0,0,0,0,0,100
1d8d5f2fb28ed73680955f6df90610d2564a594a,0,0,0,0,0,0,0,0,0,0,0,0,0,0,98,4,0,0,0,0,0,0,0,0,0,100
c16ab63653451f985276cb7368004802518a2a00,0,0,0,0,0,0,0,0,0,0,0,0,0,0,98,4,0,0,0,0,0,0,0,0,0,100
45d204d58813a521d21c66dd51b93608f8e5e77e,1,6,0,6,0,0,0,4,5,260,1,1,0,112,99,5,13,12,1,934,900,34,7,7,0,100
75fb0f137923b9dfafb85a8dba69eed83aae938e,0,0,0,0,0,0,0,0,0,0,0,0,0,0,99,5,0,0,0,0,0,0,0,0,0,100
931f86c6c28acd851a6d48eccb1b59e94f4aaba4,0,0,0,0,0,0,0,0,0,0,0,0,0,0,100,6,0,0,0,0,0,0,0,0,0,100
4e29df90c53fecbd31ece5419e6fb8d04619b23a,0,0,0,0,0,0,0,0,0,0,0,0,0,0,100,6,0,0,0,0,0,0,0,0,0,100
8faaf51de5a59c0ef054b127f726f1102bb14491,0,0,0,0,0,0,0,0,0,0,0,0,0,0,101,7,0,0,0,0,0,0,0,0,0,100
68c57d6a94fd0722058fa3c7e0b03baf1f223e66,0,0,0,0,0,0,0,0,0,0,0,0,0,0,101,7,0,0,0,0,0,0,0,0,0,100
16accd4425801e350fdfa30876c1f64cc2888756,0,0,0,0,0,0,0,0,0,0,0,0,0,0,102,8,0,0,0,0,0,0,0,0,0,100
ac367f1ad20df33132c8d596523254629c2ad963,0,0,0,0,0,0,0,0,0,0,0,0,0,0,102,8,0,0,0,0,0,0,0,0,0,100
d39962e57bd4644de8b1b04625c8dc0c68c5d8aa,0,0,0,0,0,0,0,0,0,0,0,0,0,0,103,7,0,0,0,0,0,0,0,0,0,100
f1f7a8cd566d1d3c5e5b9aab428fc4061f812b7b,0,0,0,0,0,0,0,0,0,0,0,0,0,0,103,7,0,0,0,0,0,0,0,0,0,100
375f49eb4fb43d8fd94d775bcc996ea1fd04c50c,0,0,0,0,0,0,0,0,0,0,0,0,0,0,104,0,0,0,0,0,0,0,0,0,0,100
4647d6986dc0293adf8d7ab185584527346506ec,0,0,0,0,0,0,0,0,0,0,0,0,0,0,104,0,0,0,0,0,0,0,0,0,0,100
2288900cb02540b12d37a901506686e4973b6ea1,0,0,0,0,0,0,0,0,0,0,0,0,0,0,105,1,0,0,0,0,0,0,0,0,0,100
be32279cc5cce692054d94cdfc03bf7afb4f8d1a,0,0,0,0,0,0,0,0,0,0,0,0,0,0,105,1,0,0,0,0,0,0,0,0,0,100
2b3e2ba383e83daea0f0b6905b3279ce0f7f492c,0,0,0,0,0,0,0,0,0,0,0,0,0,0,0,0,0,0,0,0,0,0,0,0,0,100
50f6bffa3b51376fb1c9223fd16642d4af18746d,0,0,0,0,0,0,0,0,0,0,0,0,0,0,0,0,0,0,0,0,0,0,0,0,0,100
5f1d8e033fbc70f7fca46575dfb5fbcb72d05cf0,73,3465,805,4270,11,0,11,4,15,1178,6,34,4.77257958,6995,106,0,1688,1385,303,63235,54099,9136,896,690,206,86.04898829
f745fb2b631f6cf56d927135f60bef115dadcc26,0,0,0,0,0,0,0,0,0,0,0,0,0,0,106,0,0,0,0,0,0,0,0,0,0,100
e7eee670943eca0cfaeb77e2d94c9fdae83ac2b0,9,2767,0,2767,9,0,9,1,1,0,1,5,2.802428683,0,107,1,353,0,353,12099,0,12099,181,0,181,96.21962196
fc107e31815a76eef8030a5dcb5c90c773f14942,0,0,0,0,0,0,0,0,0,0,0,0,0,0,107,1,0,0,0,0,0,0,0,0,0,100
c401425d1d4100882bd9023725a8c740e4032cff,0,0,0,0,0,0,0,0,0,0,0,0,0,0,15,0,0,0,0,0,0,0,0,0,0,100
1edda03966eb57d9b102886d970425c1cd6c6bc7,0,0,0,0,0,0,0,0,0,0,0,0,0,0,15,0,0,0,0,0,0,0,0,0,0,100
3b54836096abc549d4942d5a4c524da0a12ab62e,2,3,4,7,0,0,0,3,4,24,1,2,0.591672779,482,108,2,96,96,0,3598,3609,11,48,48,0,98.32599119
049b9e19051ec416ae85876a7550f29ab9c5d0f8,0,0,0,0,0,0,0,0,0,0,0,0,0,0,108,2,0,0,0,0,0,0,0,0,0,100
1c75f0265f173945adcf2e7c01b7ea52103d9000,1,1,0,1,0,0,0,2,4,0,1,1,0,139,109,3,29,29,0,995,984,11,21,21,0,98.32599119
4d423f42358eef873574d75a0222ac87cca00cf0,0,0,0,0,0,0,0,0,0,0,0,0,0,0,109,3,0,0,0,0,0,0,0,0,0,100
9339be97637ba58d95711b922cea9d6da63ccd00,0,0,0,0,0,0,0,0,0,0,0,0,0,0,15,0,0,0,0,0,0,0,0,0,0,100
51412468f077a072ff4bf9c35b3989d1fc63d2a7,0,0,0,0,0,0,0,0,0,0,0,0,0,0,15,0,0,0,0,0,0,0,0,0,0,100
4f40cc48b417cb33448b607b17fb277651cd186b,10,37,59,96,0,0,0,2,6,244,2,6,2.721563881,787,16,1,133,133,0,5007,4986,21,99,99,0,88.7254902
dcff4bd4ce41be97ac9d2455c1a0f46798bbee0f,0,0,0,0,0,0,0,0,0,0,0,0,0,0,16,1,0,0,0,0,0,0,0,0,0,100
d8f1440abb8daa01ea49263d080ddc6059100ad5,5,25,30,55,0,0,0,4,16,218,2,4,1.480620423,940,17,2,182,182,0,7067,7078,11,79,79,0,89.31216931
207e0ca38228688a7c3cf96b26203fba05fda708,0,0,0,0,0,0,0,0,0,0,0,0,0,0,17,2,0,0,0,0,0,0,0,0,0,100
1f87683c46e09387de54b924ea94f218d7b56f07,2,9,15,24,0,0,0,3,9,40,1,2,0.41381685,240,18,3,39,39,0,1822,1831,9,23,23,0,100
a79c77499bbf0bd636abb220fe49e1fff51ac91d,0,0,0,0,0,0,0,0,0,0,0,0,0,0,18,3,0,0,0,0,0,0,0,0,0,100
0a1e555373a70a31e9f37fc064a41788efdffcc6,2,40,16,56,0,0,0,6,17,20,2,2,0.991703308,735,19,4,157,152,5,5863,5670,193,48,48,0,100
52dd95191a0544394c06472ca0d45dffa2857c59,0,0,0,0,0,0,0,0,0,0,0,0,0,0,19,4,0,0,0,0,0,0,0,0,0,100
056fad0d1a067acc3558a3ddb52869e7067fa4e5,0,0,0,0,0,0,0,0,0,0,0,0,0,0,20,5,0,0,0,0,0,0,0,0,0,100
8106d73f4ad334dbb45962991232e5927fc37017,0,0,0,0,0,0,0,0,0,0,0,0,0,0,20,5,0,0,0,0,0,0,0,0,0,100
21e76adbc50c21637b6fe88acc2d99a8aaa1aa05,0,0,0,0,0,0,0,0,0,0,0,0,0,0,110,0,0,0,0,0,0,0,0,0,0,100
d9889f20b190a29c238e5861330c4392fcea8725,0,0,0,0,0,0,0,0,0,0,0,0,0,0,110,0,0,0,0,0,0,0,0,0,0,100
0eaf9587c10fd25ced2f173af91196a3d9e038c7,3,366,6,372,2,0,2,1,7,174,1,2,1.200896098,386,1,0,136,114,22,4199,3135,1064,25,19,6,99.43661972
5c6f7dbabb47e18745920dbbba2511230f0b7e38,0,0,0,0,0,0,0,0,0,0,0,0,0,0,1,0,0,0,0,0,0,0,0,0,0,100
ad8af60311592ad36256ea4746b3b7d81f2ca3c9,6,127,129,256,0,0,0,2,2,162,1,5,2.058087657,1277,2,1,298,298,0,9661,9661,0,144,144,0,100
fbef7c92d61673aaf70090e622b1c71d0bf64ff3,0,0,0,0,0,0,0,0,0,0,0,0,0,0,2,1,0,0,0,0,0,0,0,0,0,100
b43a77692d1cf01c2c23c21a7a048b8fee9e0cbb,1,7,1,8,0,0,0,4,16,204,1,1,0,298,12,0,69,68,1,2390,2329,61,18,18,0,100
6eef3c4be029b7b9503d998d2dcced1538d73df7,0,0,0,0,0,0,0,0,0,0,0,0,0,0,12,0,0,0,0,0,0,0,0,0,0,100
eb58a60647c4804910432b202d52cdbfe6fa4b3a,0,0,0,0,0,0,0,0,0,0,0,0,0,0,13,0,0,0,0,0,0,0,0,0,0,100
c3f4effa90d07835b73f8c27fdefda9d844aa242,0,0,0,0,0,0,0,0,0,0,0,0,0,0,13,0,0,0,0,0,0,0,0,0,0,100
0c027955d23d4d52771aa3508292b881d07ee0b0,1,26,1,27,0,0,0,3,16,267,1,1,0,259,14,1,54,49,5,2566,2430,136,19,19,0,100
bb2589744c25d46bbb7ada8cefaa79a52751563a,0,0,0,0,0,0,0,0,0,0,0,0,0,0,14,1,0,0,0,0,0,0,0,0,0,100
2d7e17c00f5f07a1c5a0b6ab01bc278bc2fe1089,3,35,18,53,0,0,0,1,17,394,1,1,1.229804091,492,15,2,89,87,2,4139,4131,8,31,31,0,100
1ceb8b89d2182733adf8a3d7489952f8bfa39c60,0,0,0,0,0,0,0,0,0,0,0,0,0,0,15,2,0,0,0,0,0,0,0,0,0,100
419db470fb26f81a20f433a6036c98d4b60abb19,0,0,0,0,0,0,0,0,0,0,0,0,0,0,111,0,0,0,0,0,0,0,0,0,0,100
0a7370ae14d516de3c2f394155ac8ab0d2605719,0,0,0,0,0,0,0,0,0,0,0,0,0,0,111,0,0,0,0,0,0,0,0,0,0,100
201689d1d2b68dca79fd8ba00e53808681bf379f,2,28,41,69,0,0,0,2,9,26,1,1,0.903116172,223,112,1,35,35,0,1595,1573,22,12,12,0,100
46090449b714ead81f1cc36b292ce8e69822a3a8,0,0,0,0,0,0,0,0,0,0,0,0,0,0,112,1,0,0,0,0,0,0,0,0,0,100
2288c471b41a9957611414faca3cfd94bdc31466,2,175,0,175,2,0,2,1,1,0,1,2,0.955999093,0,113,2,15,0,15,374,0,374,9,0,9,99.53488372
4f4bcc7e9445ac00a03aa01fa36343b96fb88c79,0,0,0,0,0,0,0,0,0,0,0,0,0,0,113,2,0,0,0,0,0,0,0,0,0,100
b16cb1cb4c60ce25318accd5b551fc5244e74a71,0,0,0,0,0,0,0,0,0,0,0,0,0,0,0,0,0,0,0,0,0,0,0,0,0,100
576ddec78b5ec4aea285b81fee418dd5dfefe2d6,0,0,0,0,0,0,0,0,0,0,0,0,0,0,0,0,0,0,0,0,0,0,0,0,0,100
a8f5ec28b37de581ad711831c59896c49e940e4e,1,1,2,3,0,0,0,3,3,321,1,1,0,21,21,0,3,3,0,153,153,0,3,3,0,100
fbccdcd51802fae1f8a86463264ec5cb5378de18,0,0,0,0,0,0,0,0,0,0,0,0,0,0,21,0,0,0,0,0,0,0,0,0,0,100
61f90b669b74f2a5821443dcf221bc6963bc8a96,0,0,0,0,0,0,0,0,0,0,0,0,0,0,0,0,0,0,0,0,0,0,0,0,0,100
ad7e15b4aaad2eee51abe06dae214a44104786fb,0,0,0,0,0,0,0,0,0,0,0,0,0,0,0,0,0,0,0,0,0,0,0,0,0,100
e51060b1adaf4b5475e9d9437b2667380acfbabe,1,2,1,3,0,0,0,5,17,181,1,1,0,305,1,1,69,69,0,2402,2390,12,18,18,0,100
3ecb70ad9bcfc9e97424af3c16a41b795f75f54a,0,0,0,0,0,0,0,0,0,0,0,0,0,0,1,1,0,0,0,0,0,0,0,0,0,100
f78ae6f5d2bbc49bc028084913fdbe2d08d0e0e6,0,0,0,0,0,0,0,0,0,0,0,0,0,0,22,0,0,0,0,0,0,0,0,0,0,100
d56f37ea1b91c8d7066eff5b0b4b0dd1ff019a92,0,0,0,0,0,0,0,0,0,0,0,0,0,0,22,0,0,0,0,0,0,0,0,0,0,100
703449a3ddaa99161182ca0d7f562f8d1aff501a,2,14,3,17,0,0,0,2,18,414,1,1,0.873981048,333,2,2,66,66,0,3366,3348,18,31,31,0,100
6304fbedf22dd37b7a849ecdec5affc6fc2a0b59,0,0,0,0,0,0,0,0,0,0,0,0,0,0,2,2,0,0,0,0,0,0,0,0,0,100
e06e9091a7341f0715217f56e1054f4b74069111,0,0,0,0,0,0,0,0,0,0,0,0,0,0,114,0,0,0,0,0,0,0,0,0,0,100
feb10e0258f7c1a135195896300e0abb7e1d6ecf,0,0,0,0,0,0,0,0,0,0,0,0,0,0,114,0,0,0,0,0,0,0,0,0,0,100
390f8694eb890bc063fb99ed5de8feadf65ff113,0,0,0,0,0,0,0,0,0,0,0,0,0,0,115,1,0,0,0,0,0,0,0,0,0,100
e99d96cbf5d879da2b42e367b273f015bbe319d1,0,0,0,0,0,0,0,0,0,0,0,0,0,0,115,1,0,0,0,0,0,0,0,0,0,100
f03c7fc7305c40c5fe91360a3ec0535fd37a7c2d,1,1,0,1,0,0,0,4,7,400,1,1,0,115,116,2,13,13,0,947,934,13,7,7,0,100
f8e78a238106d57d12c687c21aff35615db2b1e0,0,0,0,0,0,0,0,0,0,0,0,0,0,0,116,2,0,0,0,0,0,0,0,0,0,100
e7bb428cfa979ad49f355f8bc85ba98b50eb34f3,2,47,10,57,0,0,0,2,10,142,1,1,0.58515699,221,117,3,48,35,13,1756,1595,161,12,12,0,100
ebed85fe78156be2d21596c9c0e6fbbddf2d54f2,0,0,0,0,0,0,0,0,0,0,0,0,0,0,117,3,0,0,0,0,0,0,0,0,0,100
e88e5e800d7ab28cd6a4e3a62aa30509569439c1,6,239,63,302,1,0,1,1,6,916,2,5,1.738348113,309,23,0,59,42,17,3171,2400,771,45,37,8,95.7011259
628468cd6b6fc7c742c361d7a0e36b1b79dcb4bd,0,0,0,0,0,0,0,0,0,0,0,0,0,0,23,0,0,0,0,0,0,0,0,0,0,100
7d7e93c223a7ebb4ece1875ecbf1c46c52b4cf60,1,5,3,8,0,0,0,1,2,1,1,1,0,109,24,1,19,19,0,758,784,26,9,9,0,100
eeebc4b2fdf8533a90d8f1df255ee989ffaca4b8,0,0,0,0,0,0,0,0,0,0,0,0,0,0,24,1,0,0,0,0,0,0,0,0,0,100
a99c78c25c2344a3ab98851495ccf3766bff933b,1,35,2,37,0,0,0,5,8,362,1,1,0,425,118,0,130,119,11,3675,3418,257,20,19,1,100
a954488598d1d15f85dfe8a142d51f46024873ec,0,0,0,0,0,0,0,0,0,0,0,0,0,0,118,0,0,0,0,0,0,0,0,0,0,100
b43abc4a4c3f53ff7f869a2c43626254fbb0fe67,0,0,0,0,0,0,0,0,0,0,0,0,0,0,119,1,0,0,0,0,0,0,0,0,0,100
4ad4d6af88196db4fbbb383d82a0ac5251b09114,0,0,0,0,0,0,0,0,0,0,0,0,0,0,119,1,0,0,0,0,0,0,0,0,0,100
ba16d43279934af49d0bac2528c38a2d08d7f1e3,0,0,0,0,0,0,0,0,0,0,0,0,0,0,120,2,0,0,0,0,0,0,0,0,0,100
05692d3b3b1e04f005f4a1aee9ea0e29d4850839,0,0,0,0,0,0,0,0,0,0,0,0,0,0,120,2,0,0,0,0,0,0,0,0,0,100
50075d9dcb8f51dbad13e94f2a1fee4e0dfb56ed,0,0,0,0,0,0,0,0,0,0,0,0,0,0,121,3,0,0,0,0,0,0,0,0,0,100
9ad9308a14ca8a4b6cfe6a1072dc97a844fdab3e,0,0,0,0,0,0,0,0,0,0,0,0,0,0,121,3,0,0,0,0,0,0,0,0,0,100
5482bcd6e862287d54361e550e444c10973dc9c4,0,0,0,0,0,0,0,0,0,0,0,0,0,0,122,4,0,0,0,0,0,0,0,0,0,100
e62836c5dcfaa6cdbfc823fdfb05c341cc621efb,0,0,0,0,0,0,0,0,0,0,0,0,0,0,122,4,0,0,0,0,0,0,0,0,0,100
48efefc5c2664e5289f8665da31d7234cf79556a,1,10,0,10,0,0,0,3,4,642,1,1,0,730,25,0,203,201,2,7218,7159,59,30,30,0,100
285d63ea21683415a9cc3c218f82a82f339935ca,0,0,0,0,0,0,0,0,0,0,0,0,0,0,25,0,0,0,0,0,0,0,0,0,0,100
97cf439fbdc95bd495e74b2e430ad954fb276bea,27,939,152,1091,0,0,0,2,19,1061,5,16,4.193747154,5205,123,0,1291,1196,95,46455,42636,3819,454,423,31,99.65635739
da8c98355f56a256e40c712506e29c2fc5f533a6,0,0,0,0,0,0,0,0,0,0,0,0,0,0,123,0,0,0,0,0,0,0,0,0,0,100
80f9afaa60b1a4194f8749eaa916f1f12323f80d,0,0,0,0,0,0,0,0,0,0,0,0,0,0,124,1,0,0,0,0,0,0,0,0,0,100
22e501483cbee03dcf63c903e16a52d18d84ad26,0,0,0,0,0,0,0,0,0,0,0,0,0,0,124,1,0,0,0,0,0,0,0,0,0,100
da48dd6611397326caa0b4b187d99dfb4a9d64e7,0,0,0,0,0,0,0,0,0,0,0,0,0,0,125,2,0,0,0,0,0,0,0,0,0,100
69c7b249ed8e95dec7ec73bbf54334eedb1912ae,0,0,0,0,0,0,0,0,0,0,0,0,0,0,125,2,0,0,0,0,0,0,0,0,0,100
08939c94d233587a7b31cb56d1372d61904b95c7,1,18,35,53,0,0,0,3,6,8,1,1,0,739,126,3,205,205,0,7007,7224,217,30,30,0,100
f2cf5370a2055be21d0b90f3af07ef32c9fa920c,0,0,0,0,0,0,0,0,0,0,0,0,0,0,126,3,0,0,0,0,0,0,0,0,0,100
d173a80bd2147c6d771e2272035a39dde1b4b227,1,1,1,2,0,0,0,5,10,8,1,1,0,474,127,4,134,134,0,3836,3836,0,20,20,0,100
099b0eea972382dac63c31809425de6cb29ae1ea,0,0,0,0,0,0,0,0,0,0,0,0,0,0,127,4,0,0,0,0,0,0,0,0,0,100
44998ab6d85ed1ce79132c0033b6dcb0905d731a,0,0,0,0,0,0,0,0,0,0,0,0,0,0,128,2,0,0,0,0,0,0,0,0,0,100
d0216287cda30f0394457a51d5b6ded137ece755,0,0,0,0,0,0,0,0,0,0,0,0,0,0,128,2,0,0,0,0,0,0,0,0,0,100
c7999a9dcab5baf2f84e295554fc39570a090c3d,6,895,0,895,6,0,6,1,1,0,1,4,1.912534895,0,129,3,141,0,141,4666,0,4666,55,0,55,98.41986456
292a8ac981cce2e608126b5c6d47db85b312f8b4,0,0,0,0,0,0,0,0,0,0,0,0,0,0,129,3,0,0,0,0,0,0,0,0,0,100
70f7c0fc694156d031b811d34d73d8948c39a854,1,38,0,38,0,0,0,1,2,0,1,1,0,29,130,4,11,5,6,275,164,111,6,4,2,100
f149ad06baa3025458e1f29d834896f2ad7f41c6,0,0,0,0,0,0,0,0,0,0,0,0,0,0,130,4,0,0,0,0,0,0,0,0,0,100
32789a82fdcaf48069d2d79d4825f9818650a7bc,0,0,0,0,0,0,0,0,0,0,0,0,0,0,131,3,0,0,0,0,0,0,0,0,0,100
7de9f41d4c39c7cedb58391bd0ff51586ae1d2ed,0,0,0,0,0,0,0,0,0,0,0,0,0,0,131,3,0,0,0,0,0,0,0,0,0,100
477fc27b8c75de4a07f9669733580d5b3f2f1842,0,0,0,0,0,0,0,0,0,0,0,0,0,0,132,4,0,0,0,0,0,0,0,0,0,100
346a7ae7a342588c00a4fd40e56f82bb219587c9,0,0,0,0,0,0,0,0,0,0,0,0,0,0,132,4,0,0,0,0,0,0,0,0,0,100
be7344ee4976f0c98762ddcd68107b454b628738,13,3620,0,3620,13,0,13,1,1,0,1,5,2.975832829,0,0,0,268,0,268,10542,0,10542,85,0,85,96.77419355
8a9ea8ebc323c7351319dbd0dc3456384097b403,2,29,3,32,0,0,0,1,2,0,1,2,0.337290067,738,1,1,184,177,7,5655,5497,158,30,30,0,100
962cdd67bc9672ed46da54b9a114c3ac8dfe14c1,0,0,0,0,0,0,0,0,0,0,0,0,0,0,2,2,0,0,0,0,0,0,0,0,0,100
b6a14758dc63851c272ca423d16e1c37e02cb16a,2,6,4,10,0,0,0,1,3,0,1,2,0.721928095,757,3,3,184,184,0,5680,5655,25,30,30,0,100
3a36e94a1b46b86a20dd1b6bab5f143bccedd6e9,14,1,3649,3650,0,0,0,0,3,43,2,6,2.975324912,2764,133,2,113,388,275,3711,14436,10725,36,121,85,96.77419355
f1917c4293090a208b55072e17634bbf83892542,0,0,0,0,0,0,0,0,0,0,0,0,0,0,133,2,0,0,0,0,0,0,0,0,0,100
3f37cbf80e18ad3c89dcbb906ffda219d53abd7c,1,33,2,35,0,0,0,5,19,110,1,1,0,333,134,3,84,84,0,2695,2695,0,19,19,0,100
87e64a58ff8c4bf307fa36233a093587e587426a,0,0,0,0,0,0,0,0,0,0,0,0,0,0,134,3,0,0,0,0,0,0,0,0,0,100
2a395d3c5001e761c0a3e7c65d564247f1deb3df,26,394,367,761,0,0,0,2,9,1241,5,16,3.863397332,2894,135,4,440,438,2,23107,23295,188,293,292,1,89.97890295
02cae63ac970f6148b6105cf896851ed1ebae627,0,0,0,0,0,0,0,0,0,0,0,0,0,0,135,4,0,0,0,0,0,0,0,0,0,100
ccd3b7e7169c7e939a27cd11222d007d2807e820,1,390,410,800,0,0,0,1,2,60,1,1,0,443,136,5,93,93,0,3068,3070,2,21,21,0,100
d10ac0c8b0fc876cefc2537913e7b7d3f7293d3a,0,0,0,0,0,0,0,0,0,0,0,0,0,0,136,5,0,0,0,0,0,0,0,0,0,100
5fa3e4495c5360ec2de4e33b06e22eb21d20923e,42,4392,831,5223,13,0,13,1,18,278,7,24,3.866230041,4203,4,4,993,730,263,43196,32581,10615,455,369,86,87.21881391
db0dcdc57bbaae8230224ecaf1d98481334e325e,42,818,4379,5197,0,0,0,1,19,781,7,24,3.873793334,6392,137,4,730,993,263,32581,43196,10615,369,455,86,87.21881391
197f13437bcd82fd99526bc0597ecc20aee197c7,0,0,0,0,0,0,0,0,0,0,0,0,0,0,137,4,0,0,0,0,0,0,0,0,0,100
885498179bc5d898adf303cb8ca9ac475899ac42,5,2,55,57,0,0,0,6,8,150,3,4,2.171049266,629,26,0,80,86,6,4406,4654,248,65,70,5,100
d7d21708aae317c660b9a925efbda3d4eba4aead,0,0,0,0,0,0,0,0,0,0,0,0,0,0,26,0,0,0,0,0,0,0,0,0,0,100
1b63c78c3c4034132324b43dd24a68774b14f90a,2,75,54,129,0,0,0,4,10,46,1,1,0.992661804,911,138,1,145,141,4,7510,7396,114,89,85,4,100
33c70b619c3746ef6d8a9c6ff5d8350e98665156,0,0,0,0,0,0,0,0,0,0,0,0,0,0,138,1,0,0,0,0,0,0,0,0,0,100
853adbfe70bf32d14225d349c3105a4143e088ca,0,0,0,0,0,0,0,0,0,0,0,0,0,0,139,2,0,0,0,0,0,0,0,0,0,100
e38692d844003af75d91e7152de2ff4afd7555fa,0,0,0,0,0,0,0,0,0,0,0,0,0,0,139,2,0,0,0,0,0,0,0,0,0,100
0b00d1e50c6a796fd3f9d1e58740ca12ef9bfabb,44,4501,897,5398,13,0,13,1,18,334,7,25,3.927043935,4244,5,0,1002,736,266,43947,32989,10958,463,376,87,87.21881391
395f2e2ad50d524f42ecc563104c165fa0fa6f39,1,3,1,4,0,0,0,1,6,18,1,1,0,692,6,1,165,165,0,5286,5267,19,28,28,0,100
d30b88ac24af61d4ed4fc954588e25b10c0afc3d,49,1442,4495,5937,0,0,0,1,19,679,7,27,4.230524672,7360,140,2,984,1245,261,40353,50839,10486,470,556,86,87.21881391
8dc0d39f4caa329ced1c75a14244be416ece5bcb,0,0,0,0,0,0,0,0,0,0,0,0,0,0,140,2,0,0,0,0,0,0,0,0,0,100
dd93039bf4c3673f85757d4499f2b4fab7c7ee09,1,76,33,109,0,0,0,5,12,0,1,1,0,531,141,3,145,139,6,4534,4327,207,21,21,0,100
071f7e45f21f8b926ebfcfb302e3de415f86d5d9,0,0,0,0,0,0,0,0,0,0,0,0,0,0,141,3,0,0,0,0,0,0,0,0,0,100
270b43bf667b90ac91ca50d5227c1a36290df6b5,0,0,0,0,0,0,0,0,0,0,0,0,0,0,142,4,0,0,0,0,0,0,0,0,0,100
2b0276b0fcf8fd10a8f96d1ff9271431979c25ce,0,0,0,0,0,0,0,0,0,0,0,0,0,0,142,4,0,0,0,0,0,0,0,0,0,100
5594f27bf034e6eeb4961ca8a694e10328f2be20,49,4547,1532,6079,13,0,13,1,18,535,7,27,4.242087887,5217,7,1,1246,990,256,50837,40560,10277,557,470,87,87.21881391
af7a2e281ff7850a23d1e6623a91a49e18cbe3d2,1,7,1,8,0,0,0,1,3,0,1,1,0,669,8,2,7,6,1,321,297,24,7,6,1,100
a205ad56bdf09de2228913e3e7b35432ed73ff0b,36,1518,916,2434,0,0,0,1,19,923,6,22,3.718633699,5133,9,3,990,979,11,40560,40186,374,470,469,1,90.2970297
7a01a219481df8723f7dce9518379efc19695a51,21,19,3646,3665,0,0,0,2,20,232,6,12,3.061818844,5121,27,0,669,941,272,23259,33903,10644,195,284,89,97.08171206
faf2ce65c2c279f721b9f076d6cc435d63a3a191,0,0,0,0,0,0,0,0,0,0,0,0,0,0,27,0,0,0,0,0,0,0,0,0,0,100
fde03a1a28e78743c5050da55c3008e460a7b8f5,1,2,2,4,0,0,0,2,2,1528,1,1,0,81,28,0,13,13,0,447,447,0,6,6,0,100
4f95f3fe1e451a6c05dd2e17c88d761a542b8cb4,0,0,0,0,0,0,0,0,0,0,0,0,0,0,28,0,0,0,0,0,0,0,0,0,0,100
e4088d5cb3b2f8c7eab7a84cc1c63e9412f9f8b1,13,3623,0,3623,13,0,13,1,6,3,1,5,2.976503406,0,10,0,268,0,268,10675,0,10675,89,0,89,97.08171206
e807d5941f73e3355b7583081f19243ff01573a9,2,19,0,19,0,0,0,1,7,364,1,2,0.74248757,1367,11,1,174,172,2,5680,5607,73,37,35,2,100
bcc60b6250ee566f0fac68bcfbeaf93b463268c9,1,3,111,114,0,0,0,1,2,468,1,1,0,171,12,2,1,0,1,727,0,727,1,0,1,99.71724788
6c34cb6be113091fed0128198972f3b0b2b011ff,1,0,68,68,0,0,0,1,5,0,1,1,0,684,13,3,9,9,0,374,374,0,9,9,0,100
34a272c3f6af9cdf76ea1c696d147ff6688a6d41,1,0,804,804,0,0,0,1,6,0,1,1,0,632,14,4,9,9,0,363,374,11,9,9,0,100
17cbe64a3d3a2baee11c4a051fca6f56d242b49d,1,20,13,33,0,0,0,1,8,0,1,1,0,698,15,5,166,165,1,5337,5306,31,28,28,0,100
5c167e007c05305aafa7d7cc76bcea9cd5c18d83,15,50,2669,2719,0,0,0,0,20,50,2,7,3.063398884,2301,1,0,148,415,267,6384,17661,11277,44,133,89,96.98736638
8964043d8de8c21cc79f96b7012005cf0b7e4a62,0,0,0,0,0,0,0,0,0,0,0,0,0,0,1,0,0,0,0,0,0,0,0,0,0,100
e4a024d23defebfd066f615fc46be81a185cc761,0,0,0,0,0,0,0,0,0,0,0,0,0,0,143,0,0,0,0,0,0,0,0,0,0,100
3960af2d65cb74e5be31a28c92c62e4650213131,0,0,0,0,0,0,0,0,0,0,0,0,0,0,143,0,0,0,0,0,0,0,0,0,0,100
9d53951cbef913c25247d4260f989aa709c1ce24,1,15,16,31,0,0,0,3,4,1290,1,1,0,45,144,1,6,6,0,344,344,0,3,3,0,100
af9de64dd8ebef8df8ec587bf757113294cd6d79,0,0,0,0,0,0,0,0,0,0,0,0,0,0,144,1,0,0,0,0,0,0,0,0,0,100
ddff02db5dd8d93903a1312e999af7867fd3b62f,6,131,138,269,0,0,0,3,21,699,2,3,0.961429479,877,145,2,184,184,0,7572,7520,52,68,68,0,100
c401e929da396fcd3c902ae76a71ba981ff2d67e,0,0,0,0,0,0,0,0,0,0,0,0,0,0,145,2,0,0,0,0,0,0,0,0,0,100
47794859f50ad5298bb5941e9262ebe98cca20d9,1,2,3,5,0,0,0,6,22,0,1,1,0,336,146,3,84,84,0,2765,2790,25,19,19,0,100
10a701b87343716607435e5a37282fef618e4a03,0,0,0,0,0,0,0,0,0,0,0,0,0,0,146,3,0,0,0,0,0,0,0,0,0,100
cdac4b29518f99352569972949c64bcc119e7e0c,2,12,3,15,0,0,0,3,9,829,2,2,0.721928095,652,0,0,148,147,1,5020,4980,40,47,47,0,100
0c9f047f179d6b0b448a1d26841caf4dae92a9b9,0,0,0,0,0,0,0,0,0,0,0,0,0,0,0,0,0,0,0,0,0,0,0,0,0,100
3dbd8f4046c1fb61baa980025cfd9b93ccaca332,0,0,0,0,0,0,0,0,0,0,0,0,0,0,1,1,0,0,0,0,0,0,0,0,0,100
8592e92fc9e95466fb7fdc839909e115ba9ee51d,0,0,0,0,0,0,0,0,0,0,0,0,0,0,1,1,0,0,0,0,0,0,0,0,0,100
90aedb7af30807558c4e035a03c9673229404fba,2,5,1,6,0,0,0,5,11,1214,1,2,0.918295834,753,29,0,114,113,1,6535,6494,41,56,56,0,100
c5a57530b676825ef052317d7ca131805459fc4c,0,0,0,0,0,0,0,0,0,0,0,0,0,0,29,0,0,0,0,0,0,0,0,0,0,100
614ee058a56b451ff5a3abc035b148bd2bfef3b0,11,186,54,240,0,0,0,3,21,1011,3,7,2.864137094,1769,147,2,437,412,25,13572,12896,676,194,178,16,99.89939638
902dc06e34555d3db41154ac0634dd8cccf55717,0,0,0,0,0,0,0,0,0,0,0,0,0,0,147,2,0,0,0,0,0,0,0,0,0,100
0dc2f1b20b4f47cbd18cd8c89b5f1e010e91d51f,11,961,0,961,11,0,11,1,1,0,2,3,3.241535503,0,148,3,110,0,110,5255,0,5255,50,0,50,97.46588694
f8509bd61e7f84de95b4a73adb8ed385140c364d,0,0,0,0,0,0,0,0,0,0,0,0,0,0,148,3,0,0,0,0,0,0,0,0,0,100
5b8f00dda6b9c1666977444852bca070207df9fb,1,1,1,2,0,0,0,3,7,21,1,1,0,90,149,4,15,15,0,719,717,2,3,3,0,100
66056fde207e71348b954a46d128289a4b6e8e78,0,0,0,0,0,0,0,0,0,0,0,0,0,0,149,4,0,0,0,0,0,0,0,0,0,100
26689ec21bda509c5ebca72e1dae2cf2d667e50d,0,0,0,0,0,0,0,0,0,0,0,0,0,0,150,0,0,0,0,0,0,0,0,0,0,100
6e60d9783f545cd28306b37a667b64bfff589dcf,0,0,0,0,0,0,0,0,0,0,0,0,0,0,150,0,0,0,0,0,0,0,0,0,0,100
f1a1c370ec7c44d4d191459a999060161cab0454,4,164,81,245,0,0,0,2,23,280,3,3,0.85559418,1374,3,0,318,309,9,11331,11060,271,104,103,1,98.10785241
8a117394a698d2e5df78106e273f38f72feda3ce,0,0,0,0,0,0,0,0,0,0,0,0,0,0,3,0,0,0,0,0,0,0,0,0,0,100
ea10e3720848ae6bb45643bd833d11f2fc63eac9,4,125,39,164,0,0,0,4,24,250,1,1,1.673185225,860,4,1,203,191,12,7987,7467,520,68,63,5,100
48a5cf82dde819540475a0b582537723cf4ef038,0,0,0,0,0,0,0,0,0,0,0,0,0,0,4,1,0,0,0,0,0,0,0,0,0,100
8268f4a0a708fc58afe5ce2c5f7731f74e1c0c82,1,6,7,13,0,0,0,8,22,170,1,1,0,639,5,2,136,136,0,5029,5022,7,31,31,0,100
5a1ef55c60561f904a563faaaa7d43f93357d26f,0,0,0,0,0,0,0,0,0,0,0,0,0,0,5,2,0,0,0,0,0,0,0,0,0,100
578ace6c2cb1477595e087288925e4d1d4b7662e,1,2,0,2,0,0,0,8,23,55,1,1,0,640,6,0,136,136,0,5039,5029,10,31,31,0,100
61779b62c4a63f26c982c58275f01c18472a4213,0,0,0,0,0,0,0,0,0,0,0,0,0,0,6,0,0,0,0,0,0,0,0,0,0,100
5d4d82d42c9dba9bd311f12d8949b4df1e868e83,107,8373,5425,13798,19,0,19,3,25,953,9,45,5.688256406,11772,7,1,3083,2521,562,111560,90714,20846,1467,1135,332,87.42616034
4b5a9783546eac906ae193a222f893d7a4d8f229,0,0,0,0,0,0,0,0,0,0,0,0,0,0,7,1,0,0,0,0,0,0,0,0,0,100
185cda722324d1b688df91fed9ba9ae13e7d946c,12,12,708,720,7,0,7,4,13,59,2,7,0.219205545,969,151,0,82,227,145,3194,7710,4516,38,59,21,98.30638953
a932118bafd233c3c78053fa9a9b5e9275ec2b24,0,0,0,0,0,0,0,0,0,0,0,0,0,0,151,0,0,0,0,0,0,0,0,0,0,100
22be506860ddae434d70f68f0de96759d516ef7d,0,0,0,0,0,0,0,0,0,0,0,0,0,0,152,1,0,0,0,0,0,0,0,0,0,100
cdce816378abe36c47de7c38f4a05f235837e153,0,0,0,0,0,0,0,0,0,0,0,0,0,0,152,1,0,0,0,0,0,0,0,0,0,100
2812ebe74054651584da9c7af3ee33bf3f09aaa2,137,8650,9530,18180,29,0,29,2,20,494,10,53,6.111474691,14733,1,0,2942,3258,316,105622,117083,11461,1321,1627,306,83.19112628
9b05ccf9899b1124cf60a53ad62dcb7547c63b2d,0,0,0,0,0,0,0,0,0,0,0,0,0,0,143,0,0,0,0,0,0,0,0,0,0,100
8015551e3a2c6dae1f3c754f471decdd7c457c43,1,15,16,31,0,0,0,3,4,1584,1,1,0,45,144,1,6,6,0,344,344,0,3,3,0,100
3ba3bf581eeb49170c0952bb2707d7eb54173cd1,6,131,138,269,0,0,0,3,21,921,2,3,0.961429479,877,145,2,184,184,0,7572,7520,52,68,68,0,100
692f89574beef37409e29720c7ca73f5e548482b,1,2,3,5,0,0,0,6,22,0,1,1,0,336,146,3,84,84,0,2765,2790,25,19,19,0,100
f6440d1468e9cd3aa1b0ba09888f52b94acf70a8,2,12,3,15,0,0,0,3,9,1087,2,2,0.721928095,652,0,0,148,147,1,5020,4980,40,47,47,0,100
60e937fbdffdfb01d6886f39baa96052c7420b71,0,0,0,0,0,0,0,0,0,0,0,0,0,0,1,1,0,0,0,0,0,0,0,0,0,100
5aeb07bd9e07ebe3b4c27c5e540d884059f237b6,2,5,1,6,0,0,0,5,11,1468,1,2,0.918295834,753,29,0,114,113,1,6535,6494,41,56,56,0,100
201818cc79160efe704f78fdda6ddfe005f196d7,11,186,54,240,0,0,0,3,21,1237,3,7,2.864137094,1769,147,4,437,412,25,13572,12896,676,194,178,16,99.90566038
668c61f1c8401bafb014b1f08bdc51fc3bd49485,11,961,0,961,11,0,11,1,1,0,2,3,3.241535503,0,148,5,110,0,110,5255,0,5255,50,0,50,97.61904762
be0c9945b789332b0d0b8c0cbd0ff03a545c06a9,1,1,1,2,0,0,0,3,7,0,1,1,0,90,149,6,15,15,0,719,717,2,3,3,0,100
eb492c6aa699c4a102c8c695db841765279d258a,0,0,0,0,0,0,0,0,0,0,0,0,0,0,150,7,0,0,0,0,0,0,0,0,0,100
492a78fa6d892f314c5921899d5ce631683a4fb4,4,164,81,245,0,0,0,2,23,202,3,3,0.85559418,1374,3,0,318,309,9,11331,11060,271,104,103,1,98.2190561
2164710e7ea211b72260dff4367b6e0f422c021d,4,125,39,164,0,0,0,4,24,229,1,1,1.673185225,860,4,1,203,191,12,7987,7467,520,68,63,5,100
2ea1854ad9993bb156e52354baf7ba7be3bd9a1d,1,6,7,13,0,0,0,8,22,0,1,1,0,639,5,2,136,136,0,5029,5022,7,31,31,0,100
d1c4ac4a6f070f88cfcadc51b151ea8ef426ccbb,1,2,0,2,0,0,0,8,23,0,1,1,0,640,6,3,136,136,0,5039,5029,10,31,31,0,100
136fc595ad3ff7e47bc9878967d2079948b36bc1,107,8373,5425,13798,19,0,19,3,25,929,9,45,5.688256406,11772,7,4,3083,2521,562,111560,90714,20846,1467,1135,332,87.67772512
1b5b36d3fee0ba23c0ead04e65f34de09295b907,12,12,708,720,7,0,7,4,13,60,2,7,0.219205545,969,151,8,82,227,145,3194,7710,4516,38,59,21,98.42293907
6d063fce92c7ac0ce7ae096284601931a33da2cb,0,0,0,0,0,0,0,0,0,0,0,0,0,0,152,9,0,0,0,0,0,0,0,0,0,100
6719773bb673d13c450a55bb284a82a556c257f3,0,0,0,0,0,0,0,0,0,0,0,0,0,0,16,0,0,0,0,0,0,0,0,0,0,100
30c671b1672655d6d7f4e2b2bd79486e44e8a3d2,1,17,7,24,0,0,0,1,2,831,1,1,0,45,17,1,5,5,0,373,313,60,4,4,0,100
ab2102a29ced91101c8d4987115996071efd02f9,3,22,30,52,0,0,0,1,9,664,1,2,0.590949517,790,18,2,185,186,1,5959,5998,39,37,37,0,100
32f704120b605ac2699b6b091cb9e573838404fe,13,0,2671,2671,0,0,0,0,0,0,1,5,2.992055515,1541,153,2,0,271,271,0,11516,11516,0,92,92,97.14285714
ee4be90dee2ceb4c656eb4a817c937b847796a3e,0,0,0,0,0,0,0,0,0,0,0,0,0,0,153,2,0,0,0,0,0,0,0,0,0,100
162c552447d86f7a820f459cab0a15a46ff0ba10,0,0,0,0,0,0,0,0,0,0,0,0,0,0,154,3,0,0,0,0,0,0,0,0,0,100
dda54ad518b4a78291cb9eb63ceb3d6900212c60,0,0,0,0,0,0,0,0,0,0,0,0,0,0,154,3,0,0,0,0,0,0,0,0,0,100
a306192c90a1c78fe9cb14a879a0d40429fec8a2,0,0,0,0,0,0,0,0,0,0,0,0,0,0,155,4,0,0,0,0,0,0,0,0,0,100
9bfd4c7d0d1a5774fce0c8ccde71b75f9b36dcf7,0,0,0,0,0,0,0,0,0,0,0,0,0,0,155,4,0,0,0,0,0,0,0,0,0,100
e4f3509e30bd5f2ad771909dec971ea2178a523c,0,0,0,0,0,0,0,0,0,0,0,0,0,0,156,5,0,0,0,0,0,0,0,0,0,100
8ac9048cf85570a330a807f876c0291ad926deb5,0,0,0,0,0,0,0,0,0,0,0,0,0,0,156,5,0,0,0,0,0,0,0,0,0,100
97ddc8a9da08d10eadf195aafaa64e20cef3a526,0,0,0,0,0,0,0,0,0,0,0,0,0,0,30,0,0,0,0,0,0,0,0,0,0,100
290777c2ef9a5dbd6472d9e3dde748fb2db89684,0,0,0,0,0,0,0,0,0,0,0,0,0,0,30,0,0,0,0,0,0,0,0,0,0,100
d59ad4bc0de5ec77ce7f137177734f7e4375f64a,13,2671,0,2671,13,0,13,1,9,250,1,5,2.992055515,0,19,0,271,0,271,11516,0,11516,92,0,92,97.14285714
ce83f25721fb2f5d837d88d497e45f670ded59ef,0,0,0,0,0,0,0,0,0,0,0,0,0,0,20,1,0,0,0,0,0,0,0,0,0,100
a7c5f7791923742513e254ad3e968e0c898b5c9a,2,28,26,54,0,0,0,1,7,248,1,2,0.133039649,110,21,2,14,14,0,753,736,17,13,13,0,100
77ccfec66f5cc9249898fe4f2d9cf0e37f398098,1,0,77,77,0,0,0,1,2,927,1,1,0,41,22,3,0,0,0,0,130,130,0,0,0,99.85465116
ed73e57c1c30243d872fd03a1def2410052ab015,1,3,2,5,0,0,0,1,4,28,1,1,0,54,23,4,5,5,0,390,390,0,4,4,0,100
41b512d8bd8b1dcac0139a0ed3c86d2b31e91b61,6,364,320,684,0,0,0,1,10,356,1,3,0.648810519,989,24,5,209,208,1,7464,7467,3,49,49,0,100
14d1f04dcd0d3456537e669300789e2974f31c7b,1,19,21,40,0,0,0,1,8,30,1,1,0,57,25,6,8,9,1,345,363,18,8,9,1,100
5266fcfdb31740f19b408814132dde2f22054b1f,12,0,2639,2639,0,0,0,0,0,0,1,5,2.861098141,1535,157,0,0,271,271,0,11382,11382,0,91,91,97.28915663
13a544679994216959abd8d3c039a9c029ba5231,0,0,0,0,0,0,0,0,0,0,0,0,0,0,158,1,0,0,0,0,0,0,0,0,0,100
f5917b35acfe770ad10cdf22c4f20b34b39a69e3,0,0,0,0,0,0,0,0,0,0,0,0,0,0,159,2,0,0,0,0,0,0,0,0,0,100
5a5f527e9dc94fd2e55216fc8465bdd43a47c13c,12,2639,0,2639,12,0,12,1,10,219,1,5,2.861098141,0,26,7,271,0,271,11382,0,11382,91,0,91,97.28915663
30822f1c15e6071cc55e00812facfa1e45d22d88,0,0,0,0,0,0,0,0,0,0,0,0,0,0,27,8,0,0,0,0,0,0,0,0,0,100
b4b4b8fee27b5a86b82eafc9568929475ed938e4,0,0,0,0,0,0,0,0,0,0,0,0,0,0,28,9,0,0,0,0,0,0,0,0,0,100
e8e58a42564621274ae4737ce3f07cebb9935b07,14,0,2639,2639,2,0,2,0,7,16,2,6,2.861098141,1535,160,3,0,271,271,0,11382,11382,0,91,91,96.97885196
f1976e063a2bc55ae047fe969673ed34f057044f,12,2639,0,2639,12,0,12,1,10,219,1,5,2.861098141,0,29,8,271,0,271,11382,0,11382,91,0,91,97.27272727
ace2c807d1492fe37cccb22b85eb3d1bd31e7f7c,0,0,0,0,0,0,0,0,0,0,0,0,0,0,30,9,0,0,0,0,0,0,0,0,0,100
56cc8cd21679dd60ea95ca43a5f59456bc9182d1,1,7,7,14,0,0,0,1,11,12,1,1,0,729,31,9,164,164,0,5291,5291,0,28,28,0,100
7b6ce7f2dca01dba249ed5d6a0f2eb6589d7cb10,1,7,7,14,0,0,0,1,12,0,1,1,0,729,32,10,165,164,1,5290,5291,1,28,28,0,100
ff4abfc7b668e6638b054b08dadf0abe0b105959,1,1,0,1,0,0,0,1,13,0,1,1,0,729,33,11,165,165,0,5296,5290,6,28,28,0,100
2202a2bc644b9ae21d0531adec165ce353cfa8e4,1,6,13,19,0,0,0,1,14,0,1,1,0,730,34,12,165,165,0,5268,5296,28,28,28,0,100
5190bd17d81b9a6ff4cdcf1a4b575d6a41618fc7,1,2,172,174,0,0,0,1,15,0,1,1,0,725,35,13,135,165,30,4577,5268,691,25,28,3,100
48806ff3a91e56d09089da11118950fe1b6d916d,1,10,10,20,0,0,0,1,16,0,1,1,0,624,36,14,135,135,0,4567,4577,10,25,25,0,100
62e363c0af2050d38668c09d1b0c6aba1ae13976,1,0,2,2,0,0,0,1,17,0,1,1,0,624,37,15,135,135,0,4561,4567,6,25,25,0,100
1d2d0610c6ecea8b9c8f6e1a7b5ab63db1b6e6a7,1,39,14,53,0,0,0,1,18,0,1,1,0,623,38,16,139,135,4,4610,4561,49,27,25,2,100
4ab5a9b190f8556993813b7afc110ea8b22f4312,2,136,103,239,0,0,0,1,19,472,1,1,0.287284981,733,39,17,162,157,5,5424,5217,207,40,36,4,100
d8dbd51ed5e59a224e586546ebbe220cd1fdcb6d,1,0,7,7,0,0,0,1,20,0,1,1,0,661,40,18,144,144,0,4745,4745,0,31,31,0,100
3519c5d0987808697440117e51c9babd4fb8053b,1,131,103,234,0,0,0,1,21,0,1,1,0,661,41,19,148,144,4,4925,4745,180,35,31,4,100
0a2a72eaf5832da87b80fa41008e0b28182d928b,1,79,98,177,0,0,0,1,22,0,1,1,0,687,42,20,138,148,10,4821,4925,104,35,35,0,100
7eb27927f2fdfdf2b6fb997f56297823f9920860,3,152,0,152,3,0,3,1,1,0,1,1,1.567638391,0,43,21,8,0,8,517,0,517,8,0,8,99.49127907
279faf0538a9483395ed9369b5e91ff671c01694,1,1,2,3,0,0,0,1,1,0,1,1,0,51,44,22,2,2,0,405,416,11,2,2,0,99.71139971
ba1c5a89f6a81a8439b9c91dcc17577ec0b92bc5,1,14,29,43,0,0,0,1,9,19,1,1,0,57,45,23,7,8,1,239,345,106,7,8,1,100
8ac3bf51d592c18928e9bf3c771e34be7196c5a6,7,521,9,530,5,0,5,1,23,9,1,3,2.399388579,761,46,17,199,156,43,7952,5500,2452,65,44,21,99.22041106
a39cfe48e29aca35e2c0c9d1a7e1a63688b123c4,20,0,3169,3169,0,0,0,0,0,0,1,9,3.619721227,1841,161,0,0,295,295,0,13836,13836,0,126,126,96.08856089
e39e9fbcdb020fed1e039a0e7f05ffb356709997,20,3169,0,3169,20,0,20,1,23,79,1,9,3.619721227,0,311,1,295,0,295,13836,0,13836,126,0,126,96.08856089
740253c905bb2e3f3dce8065619e483eae1c35df,0,0,0,0,0,0,0,0,0,0,0,0,0,0,312,2,0,0,0,0,0,0,0,0,0,100
8bdb4559e621511f174038be661ef4a5cbbef15c,1,2,1,3,0,0,0,2,2,162,1,1,0,14,51,0,1,1,0,115,115,0,1,1,0,100
5f55f9e57cde7a85a9bd86fc9c7184fa182aa819,2,50,7,57,0,0,0,4,6,87,2,2,0.297472249,568,313,3,133,123,10,4442,4053,389,28,28,0,100
a497d14c1bb59672954d5f16e91154ac8dc5a726,1,2,1,3,0,0,0,2,2,162,1,1,0,14,314,4,1,1,0,115,115,0,1,1,0,100
deda3f4a83986ba0ea6c31bf7ad6cd198e8f0bf7,1,1,0,1,0,0,0,2,2,18,1,1,0,55,315,5,8,8,0,460,453,7,3,3,0,100
0778e56715bfa2039f5872e82f102336fe1f00c0,1,33,0,33,0,0,0,4,7,2,1,1,0,594,316,6,132,132,0,4327,4327,0,27,27,0,100
148ca981db5e2abbfbd128b5a8419ec5344ffdc7,0,0,0,0,0,0,0,0,0,0,0,0,0,0,52,1,0,0,0,0,0,0,0,0,0,100
4ac1171d854bcf27ca29e5da57b90916db955b98,0,0,0,0,0,0,0,0,0,0,0,0,0,0,53,2,0,0,0,0,0,0,0,0,0,100
dce6a66ebe6a6c91c05143216873809c5641647c,0,0,0,0,0,0,0,0,0,0,0,0,0,0,0,0,0,0,0,0,0,0,0,0,0,100
475027d566d0b2d5e2dc73a53dde3f2bff62e3c1,2,13,19,32,0,0,0,1,8,537,1,2,0.974489403,646,317,7,142,143,1,4596,4602,6,33,33,0,100
40cc7a5b680a7c4aececb0777a38adf352b7de6e,0,0,0,0,0,0,0,0,0,0,0,0,0,0,318,8,0,0,0,0,0,0,0,0,0,100
ff312980a2af2acbca769a1e7dad30c4f1e27f94,0,0,0,0,0,0,0,0,0,0,0,0,0,0,319,6,0,0,0,0,0,0,0,0,0,100
68beaa7ff37c913c5071d4317b8f89292e69bb9d,0,0,0,0,0,0,0,0,0,0,0,0,0,0,320,7,0,0,0,0,0,0,0,0,0,100
64443cc75f7e10ba91788c53befb0411a8c122a4,2,12,2,14,0,0,0,5,24,1008,2,2,0.863120569,411,0,0,90,88,2,3626,3474,152,35,35,0,100
41aae36e900fc730ac60af2bf8283012310728b9,3,103,17,120,0,0,0,5,25,146,1,1,1.533233342,561,1,1,136,122,14,5535,5155,380,53,51,2,100
c2a095d4eb30fcfcc56792d62af3b870bc27f593,4,50,13,63,0,0,0,1,2,1796,1,2,0.656456501,365,321,4,82,82,0,2638,2645,7,50,50,0,100
da19993d2d92b62b301cad167c71d7617a2944ad,2,5,20,25,0,0,0,1,7,879,1,2,0.970950594,113,322,5,19,19,0,717,717,0,15,15,0,100
3c30e6166d4f2c897cfe67eec23c7f52e21fe3b0,3,8,3,11,0,0,0,4,26,32,3,3,1.322179346,1610,323,6,350,350,0,12403,12372,31,91,91,0,100
e00f420fbc0d3d89c4c8cc76509d501622c17b3e,0,0,0,0,0,0,0,0,0,0,0,0,0,0,324,7,0,0,0,0,0,0,0,0,0,100
d61a1735e3fdaeff00c4ecad85905e335651bafa,3,3,19,22,0,0,0,8,27,156,1,2,1.095795255,871,2,2,199,201,2,7483,7609,126,56,56,0,100
79808e5e4f51abd504656731ca26f5cdd607598e,2,19,5,24,0,0,0,2,5,635,1,1,0.41381685,210,325,8,36,32,4,1775,1628,147,20,20,0,100
d1a921204e45bb796f269cfd80c558c0167efd63,0,0,0,0,0,0,0,0,0,0,0,0,0,0,54,0,0,0,0,0,0,0,0,0,0,100
86d8f8f13afd91536e8063badf3cf61281ae1354,2,30,0,30,1,0,1,1,3,162,1,2,0.2108423,78,55,1,12,11,1,853,628,225,8,7,1,99.58188153
2cf5d4ed209656baf1ab3d57e682cda84aae20e8,1,1,1,2,0,0,0,4,7,328,1,1,0,163,326,0,45,45,0,1199,1189,10,17,17,0,100
22b5cf8e5bcd0c974167a1a5cf03a0771f30790a,0,0,0,0,0,0,0,0,0,0,0,0,0,0,327,1,0,0,0,0,0,0,0,0,0,100
89c025d2f9e4ba19378eb15537104c8775bf2474,2,34,0,34,1,0,1,1,7,172,1,2,0.430551867,147,328,2,33,30,3,1316,1083,233,23,21,2,99.72318339
dc76da920a438d632a102cd422cb8fb6b077f1ce,1,1,1,2,0,0,0,4,8,16,1,1,0,163,329,3,45,45,0,1189,1199,10,17,17,0,100
68302e213747700ca38cef546f05d0f15a3e99b4,3,125,37,162,0,0,0,2,28,216,2,2,0.892043085,1272,330,2,303,294,9,10739,10388,351,84,83,1,100
3cacf2a25f2f8937284d50805eeb353bf5a1eabc,0,0,0,0,0,0,0,0,0,0,0,0,0,0,331,3,0,0,0,0,0,0,0,0,0,100
92b88415820001da61e0a94aa526db3622b576dc,2,109,23,132,1,0,1,1,9,187,1,2,0.902393283,872,332,4,244,241,3,8620,8240,380,39,36,3,99.86282579
f840b5dda8856d09aa2e919e1d96ac7d0f26c233,3,60,45,105,0,0,0,5,12,305,2,3,0.917692681,893,3,0,206,206,0,6887,6802,85,60,60,0,100
60ce64877ea44cdc6ab295f8e6715e6da1b88ff8,14,761,654,1415,0,0,0,4,25,301,5,8,2.588601707,4173,4,1,1083,1097,14,35920,36786,866,569,551,18,100
36f21fba278f1b93c63280ef451c246a7a4bcd51,0,0,0,0,0,0,0,0,0,0,0,0,0,0,47,0,0,0,0,0,0,0,0,0,0,100
b167b3aca01b0557544501a4af3a8f5b75d0d6d6,0,0,0,0,0,0,0,0,0,0,0,0,0,0,333,0,0,0,0,0,0,0,0,0,0,100
b6d3e614f9634141c17ea7ed0de6dcc0f837891a,1,10,0,10,0,0,0,10,26,33,1,1,0,683,0,0,152,151,1,5430,5364,66,38,38,0,100
dd35192aca863c884e64478d4efc11eac7182b9a,0,0,0,0,0,0,0,0,0,0,0,0,0,0,1,1,0,0,0,0,0,0,0,0,0,100
a60a33703ffa774a32f11bceb8f3bc2474874681,15,1857,28,1885,8,0,8,9,25,37,3,4,3.096076399,2091,334,1,741,530,211,27654,18268,9386,456,332,124,97.07165109
8644c0b604d13f3701a03c13579566b6875c0361,1,10,0,10,0,0,0,10,26,33,1,1,0,683,335,2,152,151,1,5430,5364,66,38,38,0,100
90d1cc0af6fc9b812036aa0e6db05bb508318a2e,0,0,0,0,0,0,0,0,0,0,0,0,0,0,336,3,0,0,0,0,0,0,0,0,0,100
b51cdeeadc1e79474acd250e51a77645ad676ce6,9,342,5,347,7,0,7,1,5,98,3,6,2.759811071,103,337,4,35,18,17,1676,776,900,25,10,15,99.03737259
69caf50f56d80c1ecec832928eb1d73c515fce72,1,1,1,2,0,0,0,3,4,2,1,1,0,49,338,5,7,7,0,399,398,1,4,4,0,100
74d78cbe5425420909889fa18f8031e343c3e2bc,0,0,0,0,0,0,0,0,0,0,0,0,0,0,339,6,0,0,0,0,0,0,0,0,0,100
5d86c24d1e513b95ded9d3a2f74dd95fd82298a8,0,0,0,0,0,0,0,0,0,0,0,0,0,0,340,7,0,0,0,0,0,0,0,0,0,100
88b64d0be9621f65683556df8abe4ff0c84580db,0,0,0,0,0,0,0,0,0,0,0,0,0,0,341,8,0,0,0,0,0,0,0,0,0,100
d4d39ef31786189dd86883b3da29747088bf8c4e,1,0,0,0,1,0,1,4,4,455,1,1,0,0,342,9,0,0,0,0,0,0,0,0,0,99.88764045
56a01d954e14aff97fabef3d4a34095a90cda7a7,0,0,0,0,0,0,0,0,0,0,0,0,0,0,56,0,0,0,0,0,0,0,0,0,0,100
b4f8490281606a87cc2d5f0ba445e90ce8ea36b5,7,0,0,0,7,0,7,4,6,462,2,5,0,0,48,0,0,0,0,0,0,0,0,0,0,99.20634921
7a36351b2069f7d4193283a448c773595c3c1b3c,0,0,0,0,0,0,0,0,0,0,0,0,0,0,343,6,0,0,0,0,0,0,0,0,0,100
0d8def049b8173b36fa5e83dd4bdb373454839fe,0,0,0,0,0,0,0,0,0,0,0,0,0,0,344,7,0,0,0,0,0,0,0,0,0,100
5ea25841736e1aefba80b76011374e7d8d56a82e,0,0,0,0,0,0,0,0,0,0,0,0,0,0,345,8,0,0,0,0,0,0,0,0,0,100
e099e22df6fcdf9f58426791ff543ef7b981d287,0,0,0,0,0,0,0,0,0,0,0,0,0,0,346,9,0,0,0,0,0,0,0,0,0,100
c2d3c41246dea3b46d2cde46d6a857ea446d3ba6,0,0,0,0,0,0,0,0,0,0,0,0,0,0,347,10,0,0,0,0,0,0,0,0,0,100
d16ebfdb53850be0f0ed6809d5e4dfa720a9b2fd,0,0,0,0,0,0,0,0,0,0,0,0,0,0,348,11,0,0,0,0,0,0,0,0,0,100
c2d58dd1440b4e2c66c1f40a4b6d4169d79bb6d3,0,0,0,0,0,0,0,0,0,0,0,0,0,0,349,12,0,0,0,0,0,0,0,0,0,100
a72c5d36033fa393e492c047cb818b318edd2b35,0,0,0,0,0,0,0,0,0,0,0,0,0,0,350,13,0,0,0,0,0,0,0,0,0,100
c041049c579f85e993c6741eef01dacabd66f14b,0,0,0,0,0,0,0,0,0,0,0,0,0,0,0,0,0,0,0,0,0,0,0,0,0,100
3c5bd0ee53ab5d3651980d39c5a5b20002ababc9,3,173,3,176,2,0,2,1,13,30,2,2,0.664764012,236,351,14,62,55,7,2944,1972,972,27,26,1,99.65772961
685d73fd28b008c3a01e98a95c158ee5c0a24155,3,3,173,176,0,0,0,0,12,127,2,2,0.664764012,330,57,1,55,62,7,1972,2944,972,26,27,1,99.65772961
a5f04827720dc9cd9ddc65efa6986388181afc2c,0,0,0,0,0,0,0,0,0,0,0,0,0,0,58,2,0,0,0,0,0,0,0,0,0,100
bc9a3782fadcaa0253f41fcd2d2ea5dd3cd590bf,3,173,3,176,2,0,2,1,13,30,2,2,0.664764012,236,352,15,62,55,7,2944,1972,972,27,26,1,99.65772961
d48708eca5035fb576983e99e13f89045c1006b6,5,29,176,205,0,0,0,0,29,124,3,3,1.2099998,1127,0,0,249,252,3,9096,9948,852,75,75,0,99.65772961
1a42a6239caf8f444a3c53ad7f86a6b681f7eccc,2,8,4,12,0,0,0,3,30,386,2,2,0.918295834,430,351,8,96,96,0,3866,3828,38,32,32,0,100
af3a32385c487e6424ad8c1c8f15b5ce5388a989,0,0,0,0,0,0,0,0,0,0,0,0,0,0,352,9,0,0,0,0,0,0,0,0,0,100
0c5eacf4e6b060df8f6147a4f5fce6f66ff2389a,0,0,0,0,0,0,0,0,0,0,0,0,0,0,353,10,0,0,0,0,0,0,0,0,0,100
b712d9f9da5e236319f1d88620ec09d60aaccea4,3,173,3,176,2,0,2,1,13,30,2,2,0.664764012,236,356,13,62,55,7,2944,1972,972,27,26,1,99.65772961
95aae127e8b178c23866c80318199719cb1d6ccf,0,0,0,0,0,0,0,0,0,0,0,0,0,0,357,14,0,0,0,0,0,0,0,0,0,100
b90f5c88c4c91f6f3d1f9d2abd1bcb0dce128d03,1,14,14,28,0,0,0,7,31,2,1,1,0,385,358,15,90,90,0,3484,3484,0,29,29,0,100
c3271e2b6e760a56a5377b8e5811d226dea9d135,0,0,0,0,0,0,0,0,0,0,0,0,0,0,359,16,0,0,0,0,0,0,0,0,0,100
dc5996a5c110ca04e2a641c865f94ffe889f84fb,0,0,0,0,0,0,0,0,0,0,0,0,0,0,49,0,0,0,0,0,0,0,0,0,0,100
80d5d8d1c6f0f24772a1039f8220c679ffca6ea6,10,253,253,506,0,0,0,5,7,158,3,3,1.467432391,2467,50,1,668,668,0,21335,21859,524,520,520,0,100
0126ecd900ec6c9b036db4312073d5ec8ad5f1ca,0,0,0,0,0,0,0,0,0,0,0,0,0,0,51,2,0,0,0,0,0,0,0,0,0,100
f267370f1bb3a3bc3c69550be8c2d9d7d33affc7,3,61,24,85,0,0,0,1,25,453,1,3,1.213993812,772,52,3,161,159,2,5766,5509,257,53,49,4,100
eedcfed9d3ef3d82ce02fd5ef91f24c362773553,3,6,3,9,0,0,0,9,32,296,1,2,1.530493057,1007,5,0,259,256,3,8784,8750,34,55,55,0,100
30bb3af96d5c70ba2e70dca183c62fb6a49c343c,5,120,67,187,0,0,0,4,27,1191,2,3,0.767799584,1230,360,0,305,298,7,10413,9933,480,104,97,7,99.32088285
e1eb90a369851805ef8e1bd1a89f71cd1644f73b,0,0,0,0,0,0,0,0,0,0,0,0,0,0,361,1,0,0,0,0,0,0,0,0,0,100
2b48955ffb4008392ca96502401cb2b944892d1d,0,0,0,0,0,0,0,0,0,0,0,0,0,0,53,0,0,0,0,0,0,0,0,0,0,100
8ce063466a2c833efa7324540a9c5b780f56ee48,2,35,1,36,0,0,0,1,2,672,1,2,0.997772472,217,54,1,34,30,4,1902,1728,174,17,15,2,100
4909501b3f4d6045cba68374d2136d0c46c5d342,0,0,0,0,0,0,0,0,0,0,0,0,0,0,55,2,0,0,0,0,0,0,0,0,0,100
1d659edd9bfb1b0764f877c68cd50cbd38742b7d,0,0,0,0,0,0,0,0,0,0,0,0,0,0,0,0,0,0,0,0,0,0,0,0,0,100
390bb21f84960256074e3bd62f785af8026c4505,0,0,0,0,0,0,0,0,0,0,0,0,0,0,362,0,0,0,0,0,0,0,0,0,0,100
29cbf8ab03eb68898db0014e416de27d4932231d,0,0,0,0,0,0,0,0,0,0,0,0,0,0,363,1,0,0,0,0,0,0,0,0,0,100
8b94825c189c2c82595b70f61caff0adf449085b,0,0,0,0,0,0,0,0,0,0,0,0,0,0,0,0,0,0,0,0,0,0,0,0,0,100
5f86f58358e94593b7677825c4724943e2f8f054,0,0,0,0,0,0,0,0,0,0,0,0,0,0,1,1,0,0,0,0,0,0,0,0,0,100
dc037d97483f707d026b6961aa489b9f4e73668b,0,0,0,0,0,0,0,0,0,0,0,0,0,0,2,2,0,0,0,0,0,0,0,0,0,100
abc8bf7ab7349a3c6132f34b0c15a02b061ac8e5,0,0,0,0,0,0,0,0,0,0,0,0,0,0,3,3,0,0,0,0,0,0,0,0,0,100
ebf2572320f02efa4761e63bc4c977231e9a5ecf,0,0,0,0,0,0,0,0,0,0,0,0,0,0,364,2,0,0,0,0,0,0,0,0,0,100
da71d3078177c881a532f4a0de39ffa43103f2fd,0,0,0,0,0,0,0,0,0,0,0,0,0,0,365,3,0,0,0,0,0,0,0,0,0,100
bb30d94602e4ad16ebe29ff4197b40d19f13bc28,0,0,0,0,0,0,0,0,0,0,0,0,0,0,366,4,0,0,0,0,0,0,0,0,0,100
abc30e1b4b007269e155bfa3b00fe7615171751d,0,0,0,0,0,0,0,0,0,0,0,0,0,0,367,5,0,0,0,0,0,0,0,0,0,100
40841419df1899fcf06bbdac6164777ada8e15f9,0,0,0,0,0,0,0,0,0,0,0,0,0,0,368,6,0,0,0,0,0,0,0,0,0,100
99d1cf8e24490cfe5dafc1dfc85fa6225c456c60,0,0,0,0,0,0,0,0,0,0,0,0,0,0,369,7,0,0,0,0,0,0,0,0,0,100
68ce474b6813e9e5e8b021e3d255f90ddd7a3eb3,0,0,0,0,0,0,0,0,0,0,0,0,0,0,370,8,0,0,0,0,0,0,0,0,0,100
33b9a5bf451b28cba6c614e652baab17dd05f6d7,0,0,0,0,0,0,0,0,0,0,0,0,0,0,371,9,0,0,0,0,0,0,0,0,0,100
61a4747ffc1a329bbe60e95517881e963b4a76a8,1,29,0,29,1,0,1,1,1,0,1,1,0,0,56,0,1,0,1,43,0,43,1,0,1,99.88764045
65d6c7ac29d2cc041d067e5e7f0857936a7529d7,8,50,88,138,0,0,0,5,30,865,5,6,2.653862101,2919,372,8,638,638,0,21231,21804,573,201,201,0,100
1a8a14ba19be9bb6276f2be7148f39c3d8994d58,0,0,0,0,0,0,0,0,0,0,0,0,0,0,59,0,0,0,0,0,0,0,0,0,0,100
e7d6b6edc3d2392272263a0fb381fb9a2de166ff,3,45,11,56,0,0,0,1,6,393,2,2,1.186570545,130,373,1,29,29,0,1015,1015,0,15,15,0,100
0e66a0b0a858bca51c6b0cf7e62f7ecaf4b5c841,0,0,0,0,0,0,0,0,0,0,0,0,0,0,374,2,0,0,0,0,0,0,0,0,0,100
35a88e8a6f85e81462f6e1a66a56d9566f87939c,0,0,0,0,0,0,0,0,0,0,0,0,0,0,375,3,0,0,0,0,0,0,0,0,0,100
534b6594219d3c3e27285a7477559ccbed64c2a1,0,0,0,0,0,0,0,0,0,0,0,0,0,0,376,4,0,0,0,0,0,0,0,0,0,100
9540273d85d38835b651c76286e499d7aa418c16,1,61,4,65,0,0,0,5,12,257,1,1,0,589,377,0,134,130,4,4429,4210,219,27,27,0,100
df28e1de9c7b0446c071c525136d131920a66ba9,0,0,0,0,0,0,0,0,0,0,0,0,0,0,57,0,0,0,0,0,0,0,0,0,0,100
8da648456c49866a58480a14f1e11aa4a1ac0426,4,76,12,88,2,0,2,1,11,425,1,2,1.788880737,140,58,1,17,16,1,1047,913,134,16,15,1,97.4025974
903aeb016f1efa6fbd7bc245f849062e10e0bf11,2,31,20,51,0,0,0,1,2,1610,1,2,0.847861745,157,59,0,29,28,1,1197,1134,63,20,19,1,100
bb09d8916736e3e572eef2cb5e79fe11c80ad1de,2,82,16,98,0,0,0,1,12,363,1,2,0.73001663,128,60,1,26,20,6,1214,821,393,20,16,4,96.96261682
9c2d225d04cfa746244373fa661a1aa6f03250bb,2,124,0,124,2,0,2,1,1,0,2,2,0.990785248,0,0,0,6,0,6,624,0,624,4,0,4,99.51403888
ef68cead273324797cf292dbe6da18ee3fd819cb,2,60,34,94,0,0,0,1,2,0,2,2,0.997059057,70,1,1,10,6,4,731,624,107,5,4,1,100
8fbdef7de963defb1387f0fbbe9e56506b627ba3,1,10,0,10,0,0,0,1,3,0,1,1,0,37,2,2,3,3,0,394,337,57,2,2,0,100
5644a21c5c5678611c7cef4e2c922643088951b8,1,33,5,38,0,0,0,1,4,0,1,1,0,42,3,3,5,3,2,577,394,183,4,2,2,100
445edb12c35f867e7b81919ddfb509dd8c179ba3,1,8,6,14,0,0,0,1,5,0,1,1,0,60,4,4,5,5,0,615,577,38,4,4,0,100
81af4d3afcba4633d0c5d06ead9b4256ea60862f,2,43,10,53,0,0,0,1,6,2,2,2,0.386018901,110,5,5,14,12,2,1300,1009,291,9,7,2,99.46265449
80c0c26d8fb6a9a84ea39f5aa96cc343b4546266,2,68,23,91,0,0,0,1,7,0,2,2,0.989434022,138,6,6,14,14,0,1290,1300,10,9,9,0,99.78213508
c111e6290fa16d2cc560eb29dbc07eb2f8b7734b,1,33,2,35,0,0,0,1,8,48,1,1,0,93,7,0,8,8,0,1160,949,211,6,6,0,100
cf6e76585b18ff926f8e7e4928f2d7cd28ac7c6f,1,3,3,6,0,0,0,1,9,2,1,1,0,112,8,1,7,8,1,1119,1160,41,6,6,0,100
b0c9e89f84b2e2310bb19f3ad13d91873ed6738f,3,1,299,300,0,0,0,0,26,275,3,3,0.934753386,830,61,0,141,154,13,4944,6395,1451,37,46,9,99.61685824
a3f44256d6648962b8bb50e717e79698180a32c2,3,187,92,279,1,0,1,1,27,75,1,2,1.064133419,735,62,1,157,147,10,5781,5362,419,51,42,9,99.89010989
219557002f0e33ef6d0e2bb49471d24fb867b0ac,5,408,188,596,2,0,2,1,25,315,3,4,1.967222778,786,9,0,163,157,6,6923,5781,1142,51,51,0,99.50792783
62be0c312927e3ea4962eb966689b49dc1fcebce,2,44,16,60,0,0,0,1,11,73,2,2,0.90071968,172,10,1,18,16,2,1650,1570,80,11,9,2,100
8584911176712f63e316707ace23a12060588cdc,2,24,11,35,0,0,0,1,12,0,2,2,0.591672779,185,11,2,19,18,1,1708,1650,58,12,11,1,100
92b71a6d2c95492621a56e48470e951e982cc34f,2,6,9,15,0,0,0,1,13,0,2,2,0.566509507,191,12,3,19,19,0,1696,1708,12,12,12,0,100
8893fd5c6c53b19925c99668d24df23c52e70b1e,1,0,4,4,0,0,0,1,14,11,1,1,0,119,13,4,10,10,0,1040,1084,44,6,6,0,100
9cff33598231e9cf54060cecf1ccacdf62e64c5b,1,2,2,4,0,0,0,1,15,3,1,1,0,115,14,5,10,10,0,1042,1040,2,6,6,0,100
e817a7f0eeb2efb98937efb92701705ec80891b9,4,198,0,198,1,0,1,2,8,1277,3,4,1.112022205,129,15,6,33,15,18,2295,1157,1138,17,9,8,99.78225367
8f1acc6d4ef6c192e8fc06287558b7bc7c39b040,1,1,1,2,0,0,0,1,2,0,1,1,0,94,16,7,10,10,0,851,851,0,5,5,0,100
1f6ba329ecaa8d3c06c8b4bd159cca933e59c23a,10,189,641,830,1,0,1,0,27,245,5,9,2.608256224,2047,378,0,414,440,26,15159,17518,2359,96,107,11,99.23497268
ed768b4be6af4cc8fa18fa11bdb01c616101afbe,1,8,8,16,0,0,0,5,12,0,1,1,0,868,379,1,242,242,0,8235,8221,14,36,36,0,100
888c899f966c27dec1fb173611812f8574737da1,10,649,197,846,3,0,3,1,25,658,5,9,2.68351027,1783,17,8,440,414,26,17518,15173,2345,107,96,11,99.23497268
ad4f5601ebd52e182bf79ba4032dcb85d918b925,0,0,0,0,0,0,0,0,0,0,0,0,0,0,18,9,0,0,0,0,0,0,0,0,0,100
6252eddfecf5a9cba028e1d7529b6dee3ec5ef33,0,0,0,0,0,0,0,0,0,0,0,0,0,0,19,10,0,0,0,0,0,0,0,0,0,100
3cf550264d782bcffa15fdf62c584eca355cab29,0,0,0,0,0,0,0,0,0,0,0,0,0,0,20,11,0,0,0,0,0,0,0,0,0,100
678307454c0a2ab02a993bd8c25378c9e1a215b0,11,217,663,880,1,0,1,0,27,227,5,10,2.815833841,2197,380,2,445,471,26,16298,18612,2314,117,128,11,99.23497268
08c48d966475f7485b66beeb0b2f4591499b427a,1,14,20,34,0,0,0,4,9,0,1,1,0,155,381,3,31,31,0,1094,1125,31,21,21,0,100
2df96a1db3908539321d61971ab581e21fcf16e9,44,621,1260,1881,0,0,0,4,28,309,11,27,4.376587384,9362,0,0,2157,2208,51,73771,76023,2252,989,1020,31,97.20044793
a303ff796bff390cdf2368dbf2edfaeba33161f5,75,1459,785,2244,6,0,6,5,32,949,13,43,5.000762483,13384,382,4,2968,2917,51,112519,109687,2832,1382,1351,31,97.20044793
5e5416b5fed002d3a2f9e926b268ee0c3f831fd9,40,185,216,401,0,0,0,4,30,623,10,26,4.844595583,7573,382,4,1483,1483,0,61962,62517,555,536,536,0,100
cfd1c52f3e86ca0ae2d4e80446ce2e95a8825af0,0,0,0,0,0,0,0,0,0,0,0,0,0,0,383,5,0,0,0,0,0,0,0,0,0,100
983bed4f395e876c75d8419eddac9806f45a24da,0,0,0,0,0,0,0,0,0,0,0,0,0,0,384,6,0,0,0,0,0,0,0,0,0,100
606b79d762a456970cdd6b846f63b28a65a19bfa,40,263,189,452,0,0,0,4,32,1065,10,26,4.938052928,7542,383,5,1483,1483,0,62854,61962,892,536,536,0,100
ab86b27b4a848e6d8b5f8317edbe6aa9a925eb70,1,17,13,30,0,0,0,5,8,1165,1,1,0,150,386,8,31,31,0,1119,1094,25,21,21,0,100
130257370a9227faedf5ce843ea26e7a47e49001,0,0,0,0,0,0,0,0,0,0,0,0,0,0,387,9,0,0,0,0,0,0,0,0,0,100
965c44999d0afde2b6379b035c568d8539b0c384,20,569,68,637,3,0,3,1,31,937,9,17,2.728101924,3351,383,5,803,766,37,30657,28227,2430,229,209,20,99.34497817
2ce2fda5b7f688f1c5fa9e10f7c8ff64ce99be12,1,9,7,16,0,0,0,2,3,30,1,1,0,94,384,6,10,10,0,858,851,7,5,5,0,100
7c6a63e0dfbbc223353bab64cc6218b03bbff526,14,68,21,89,0,0,0,5,32,83,7,11,3.190080737,3187,390,12,751,751,0,27070,26708,362,200,200,0,100
ea44388f9883218f7314ed4bec51e3f2115cf33f,1,3,3,6,0,0,0,2,16,35,1,1,0,115,391,13,10,10,0,1036,1042,6,6,6,0,100
aad4ad41f914a3ceeb04965c0e6fefa7ddefec25,0,0,0,0,0,0,0,0,0,0,0,0,0,0,393,15,0,0,0,0,0,0,0,0,0,100
d5023d5e998a1aa883a0faf778438d3db22b06b8,44,297,479,776,0,0,0,4,30,580,10,28,4.516751985,7950,21,8,1508,1519,11,64309,65695,1386,552,561,9,99.89130435
578f5f88661cf60382c1e19434ccfbe761ba73f8,49,487,318,805,1,0,1,4,32,1068,10,33,4.653478815,8366,392,14,1685,1679,6,69772,68436,1336,625,616,9,99.89130435
f6bf4cfc328453af90c7ae44b37cecbf48e7060a,0,0,0,0,0,0,0,0,0,0,0,0,0,0,395,17,0,0,0,0,0,0,0,0,0,100
97d5845100ee1460da36e0d94c504a125a081834,0,0,0,0,0,0,0,0,0,0,0,0,0,0,396,18,0,0,0,0,0,0,0,0,0,100
c8550d3558d1a438b64409bcbac94f072c191d23,49,318,485,803,0,0,0,4,30,605,10,33,4.653130428,8474,21,8,1679,1685,6,68433,69772,1339,616,625,9,99.89130435
4086ece8cd2f9cd7a29bf46a1d290313c4e44d14,2,3,3,6,0,0,0,4,31,860,2,2,0.918295834,643,22,9,151,151,0,5079,5076,3,37,37,0,100
c6c087c9f8672bc386d93994e49e68dc97087896,63,665,500,1165,1,0,1,5,33,833,11,40,5.000801939,10303,21,7,2027,2023,4,83073,82153,920,847,838,9,99.89130435
e5ddb78f8fd60278f63a8bc0a944ab0506d30dfc,14,1,31,32,0,0,0,5,14,1045,7,10,3.452819531,1421,22,8,256,256,0,10797,11061,264,142,142,0,99.94571118
5389d0b335f078a57bc2d6c7f51f57a0e6def65d,2,3,3,6,0,0,0,4,33,448,2,2,0.918295834,605,23,9,138,138,0,4984,4982,2,46,46,0,100
1507a59a12928080401fd00c9114790905c912dc,2,4,5,9,0,0,0,2,8,2691,1,2,0.99107606,199,24,10,31,34,3,1475,1489,14,15,16,1,100
7cf4ec1d5f0ec50bb205d7fd786cfa9062aa9d8f,3,5,3,8,0,0,0,2,10,540,2,3,1.298794941,329,25,11,58,58,0,2521,2510,11,20,20,0,100
d4797dc28ec09a8aa34053826a3cf76f2eb7fe6c,52,338,199,537,2,0,2,4,32,792,11,36,4.421302364,8367,397,19,1687,1674,13,67641,66619,1022,696,689,7,99.62100704
6cdbe565f9e1b59adef38442124274eafe399ccd,3,5,4,9,0,0,0,6,34,0,3,3,1.530493057,1272,398,20,285,285,0,9591,9587,4,64,64,0,100
17bb1691e3aef00ce6ef7498f3308206db452fe2,1,1,3,4,0,0,0,6,18,0,1,1,0,625,399,21,134,134,0,4479,4475,4,27,27,0,100
20f322d3f9cf2d3d8544d455e3d3e3b8fd1bb017,49,194,225,419,0,0,0,5,36,873,11,34,4.301828451,8375,29,15,1671,1676,5,66439,67120,681,686,687,1,99.94600432
550c895893b657e8ef0022a54b794ec263bee983,0,0,0,0,0,0,0,0,0,0,0,0,0,0,400,22,0,0,0,0,0,0,0,0,0,100
f681764a1b3fb9daeac57266418a874794d22809,74,296,347,643,0,0,0,5,37,1021,10,41,5.475433311,11521,30,14,2297,2315,18,90379,91611,1232,912,912,0,100
e201926a3cbfe16d6636f86d184f991f8a0c8d17,0,0,0,0,0,0,0,0,0,0,0,0,0,0,401,23,0,0,0,0,0,0,0,0,0,100
d276fa580132fd007f592fa038ea03a39d439151,0,0,0,0,0,0,0,0,0,0,0,0,0,0,402,24,0,0,0,0,0,0,0,0,0,100
79fba16dc9bf0b1660861a233a218bc669173178,0,0,0,0,0,0,0,0,0,0,0,0,0,0,403,25,0,0,0,0,0,0,0,0,0,100
446b46a81d4a08112b3a7bba4ae15ad830221411,0,0,0,0,0,0,0,0,0,0,0,0,0,0,404,26,0,0,0,0,0,0,0,0,0,100
4a7aa37de90a03e03decb4deb24850d75147ce76,1,1,1,2,0,0,0,6,9,0,1,1,0,337,31,14,63,63,0,2644,2644,0,29,29,0,100
9482e10089fa3fe6c12450a690d7288355eb9d29,0,0,0,0,0,0,0,0,0,0,0,0,0,0,405,25,0,0,0,0,0,0,0,0,0,100
7c15a4f03bfa7cc31db3b9f3ef4f9b395e764f34,0,0,0,0,0,0,0,0,0,0,0,0,0,0,32,11,0,0,0,0,0,0,0,0,0,100
93cbd8cc31e40c0163f8c9daf3ccc237a2b59a13,0,0,0,0,0,0,0,0,0,0,0,0,0,0,63,0,0,0,0,0,0,0,0,0,0,100
11b1d7accbe787010218152b6eb25b17ecbe5809,3,209,22,231,0,0,0,9,13,85,2,3,0.955294416,345,406,0,65,48,17,3803,2803,1000,45,37,8,93.64096792
209d6632cb98a6c76a3c634f94222cb8b0d135ed,0,0,0,0,0,0,0,0,0,0,0,0,0,0,407,1,0,0,0,0,0,0,0,0,0,100
97fc0d678eed32b723ccb1ef6f3c8954743edb58,0,0,0,0,0,0,0,0,0,0,0,0,0,0,408,2,0,0,0,0,0,0,0,0,0,100
bcee2dbc6e86b3ec095dc3a24d27018e6a7366ca,20,93,120,213,0,0,0,6,38,463,6,15,3.357416887,4337,33,0,790,791,1,35446,35753,307,290,291,1,100
b5ba30c0999088d587755ad5cfdff97faaeb3fea,0,0,0,0,0,0,0,0,0,0,0,0,0,0,34,1,0,0,0,0,0,0,0,0,0,100
b79fc898f83994ebf61a2065a69055d0513bbdb5,1,6,1,7,0,0,0,2,4,96,1,1,0,129,409,0,16,15,1,1129,1110,19,11,10,1,100
a40f72f9823507c6995b26203160e8758d2f3276,0,0,0,0,0,0,0,0,0,0,0,0,0,0,64,0,0,0,0,0,0,0,0,0,0,100
356c1f8a825f883c8de43a3e25019ff230a26457,2,30,17,47,0,0,0,2,17,218,1,2,0.658191266,891,4,0,241,238,3,8408,8328,80,40,39,1,100
a11bf622685c55908b2a46ec7ec38870cd664824,1,17,12,29,0,0,0,1,3,261,1,1,0,95,410,0,7,7,0,983,983,0,1,1,0,94.93902439
e56eebb9de57eaa9e50ac434e58e0147e6d19312,0,0,0,0,0,0,0,0,0,0,0,0,0,0,411,1,0,0,0,0,0,0,0,0,0,100
0501812a6d21dcfbfa48d65a1e4d9c787b5f3aee,6,416,201,617,2,0,2,1,5,518,2,4,1.868117892,528,411,0,119,111,8,6012,4681,1331,88,84,4,94.97578692
0e6a30958bd523976e184206e120091f900a3d78,0,0,0,0,0,0,0,0,0,0,0,0,0,0,413,1,0,0,0,0,0,0,0,0,0,100
18bd38a0a1f90729b03e4d5a3ce8d450d3f9ff9d,5,208,23,231,1,0,1,1,4,651,1,2,1.352116507,330,414,2,93,79,14,3251,2403,848,43,36,7,97.38317757
15e659d5b9a81817b96945d281ea610682507910,5,23,208,231,0,0,0,0,3,966,1,2,1.352116507,430,414,2,79,93,14,2403,3251,848,36,43,7,97.38317757
e707ca6f5aca8ef8531b22acf5f2a2bcc8aa605c,1,4,1,5,0,0,0,9,15,396,1,1,0,235,415,3,55,55,0,1971,1971,0,26,26,0,100
aff724878db38c3c7adf2f12f827a7ed0bbe0fbe,0,0,0,0,0,0,0,0,0,0,0,0,0,0,416,4,0,0,0,0,0,0,0,0,0,100
61f6977cb1d9cf4a75c76060936eb40e945731ec,8,155,117,272,1,0,1,2,30,462,1,5,2.452529654,1025,65,0,200,193,7,7830,7491,339,78,77,1,99.2081448
83fb8d435963f35fd5de9675842958e8ced175d7,14,327,182,509,1,0,1,2,29,461,2,8,2.994120974,1626,415,3,341,334,7,12705,12204,501,146,140,6,97.14632665
3326f585ef40a3dbfafe4e8a9153095bf24e9300,1,4,1,5,0,0,0,9,15,396,1,1,0,235,419,7,55,55,0,1971,1971,0,26,26,0,100
26b189b838cc79e58a7b3fee2e3eb2534936672f,8,155,117,272,1,0,1,2,30,462,1,5,2.452529654,1025,420,8,200,193,7,7830,7491,339,78,77,1,99.40397351
5758faf59558380e5c7e64646ccda5eed901a258,2,204,0,204,2,0,2,1,1,0,1,1,0.873981048,0,421,9,15,0,15,782,0,782,7,0,7,90.8412483
9e14671986b67b18cbf5018cef62e948959e640a,0,0,0,0,0,0,0,0,0,0,0,0,0,0,422,10,0,0,0,0,0,0,0,0,0,100
01437e1aea6098e6a31f001d139246199ce48066,1,5,3,8,0,0,0,11,30,430,1,1,0,679,423,2,152,152,0,5217,5217,0,38,38,0,100
54fc2ad7164333691e6f620846f97fd68d77768f,1,104,18,122,0,0,0,3,3,1963,1,1,0,159,424,3,47,35,12,1406,1028,378,23,23,0,100
73a649fbccb9fa7751aafb20076354c1b10952fc,1,1,0,1,0,0,0,9,16,54,1,1,0,235,425,4,55,55,0,1977,1971,6,26,26,0,100
4968823b5a8ba6d8abe796414616584f6c104893,1,5,2,7,0,0,0,3,5,450,1,1,0,111,426,5,19,19,0,804,773,31,9,9,0,100
4f98503c014c359b6ab018f43920d454b0344160,2,2,0,2,0,0,0,3,4,2269,2,2,1,87,0,0,7,7,0,1118,1101,17,4,4,0,100
655cd3aa846751f4805ef5e84ecd9193fe2c7aa2,27,2454,1453,3907,7,0,7,3,39,1179,4,13,3.502635317,3257,427,0,799,742,57,27743,26292,1451,375,333,42,97.96776454
e0009e6d6e42d2b2462f28bcff83648f2a1b77a5,28,1446,2446,3892,1,0,1,3,38,412,4,14,3.522427885,3993,427,0,711,852,141,24697,30314,5617,310,408,98,97.96776454
3977e99b1ada20355acab444d4c60ec2186dac63,1,8,5,13,0,0,0,5,10,532,1,1,0,58,427,0,12,11,1,478,465,13,5,5,0,100
8fad49d718de55d45f469fcfdb363ac33eee0cf2,1,3,2,5,0,0,0,5,12,0,1,1,0,61,429,2,12,12,0,482,478,4,5,5,0,100
d46a96f4125cc0abf024226d7f43e6a6e614a1ec,1,1,1,2,0,0,0,5,13,0,1,1,0,62,430,3,12,12,0,483,482,1,5,5,0,100
96e623b035b2ab35fca15d03b790bee55636efcd,27,2454,1453,3907,7,0,7,3,39,1179,4,13,3.502635317,3257,432,0,799,742,57,27743,26292,1451,375,333,42,97.96776454
8267561e52a02bf9faf70a24484aac105cdcc9d0,9,1476,0,1476,9,0,9,1,1,0,1,5,2.925545154,0,433,1,181,0,181,7804,0,7804,101,0,101,95.21392313
b7fb9eea768a6daac93d1835726c737153f45ef4,16,49,1487,1536,0,0,0,0,13,197,3,11,3.140301908,2037,0,0,199,374,175,7091,14644,7553,122,220,98,90.26622296
828aa811f287e473cfc9ab3ae9646527313e149c,16,1487,49,1536,9,0,9,1,12,379,3,11,3.140301908,910,434,0,374,199,175,14644,7091,7553,220,122,98,90.26622296
570662b02bbe0a0bc10ea0490b323630fb9c0646,7,49,11,60,0,0,0,3,13,461,2,6,2.331102978,879,1,1,199,193,6,7091,6840,251,122,119,3,98.49892781
b0d69051961c797200ec92b37a1557f1be1c2c58,7,38,39,77,0,0,0,3,14,7,2,6,2.184986184,910,2,2,197,199,2,7209,7091,118,119,122,3,100
52b03d537c60b799dfc9f7259d43b56b6390c304,1,5,1,6,0,0,0,7,15,0,1,1,0,183,3,3,39,39,0,1341,1313,28,21,21,0,100
640852e1fcfda4fa69e03f47dba9122f36e9c882,1,2,2,4,0,0,0,7,16,0,1,1,0,187,4,4,39,39,0,1341,1341,0,21,21,0,100
ad5eb9da3821781dceb90b4db88f3bc4fd2d7010,5,21,61,82,0,0,0,1,12,300,2,5,1.487904241,780,435,1,118,122,4,5611,5991,380,73,73,0,98.49892781
049555130980de6663674923968795de99edfe1c,8,204,50,254,0,0,0,5,23,1150,3,5,1.472804734,3045,436,2,684,650,34,26460,25162,1298,404,382,22,100
348e020e1df6c0b3a5b8c38b220746617320fb43,6,1171,0,1171,6,0,6,1,1,0,1,4,1.634913976,0,437,2,176,0,176,6093,0,6093,50,0,50,98.79969992
32b93d8bff4fbdbe5ca65b4076d853e666e788f4,0,0,0,0,0,0,0,0,0,0,0,0,0,0,438,3,0,0,0,0,0,0,0,0,0,100
8a7101781ea18d8e3ca2a8e37978110337fe2373,7,16,1174,1190,0,0,0,6,11,109,2,5,1.726960518,1023,0,0,29,203,174,1404,7417,6013,15,64,49,98.79969992
f5a6d842d45bb592153b616085634b8fa3664d2d,49,437,338,775,0,0,0,6,40,1200,9,26,4.72796683,7595,1,0,1694,1694,0,58246,58246,0,767,767,0,100
9361023d62817926fbba612782225021e0a2865d,6,1171,0,1171,6,0,6,1,1,0,1,4,1.634913976,0,439,2,176,0,176,6093,0,6093,50,0,50,98.79969992
1ce9a887a93006180ea19b00b28473acde4c8b05,57,340,1636,1976,0,0,0,5,39,678,10,31,3.90949479,8917,1,0,1800,1978,178,62015,68205,6190,819,869,50,98.79969992
c0c8c6135021302e078e7e6387a95f90acd6763a,55,1608,338,1946,6,0,6,6,40,1064,10,30,3.836650401,7584,440,3,1868,1692,176,64270,58177,6093,817,767,50,98.79969992
ae1b59c3c7304bc6f9a02f6efdcbc9997888297b,2,56,15,71,0,0,0,3,16,4,1,2,0.992976887,301,441,4,55,51,4,2706,2309,397,32,32,0,97.61737912
22f400d5301a14a0dd30b0a5533a5cbd85c4bc6f,0,0,0,0,0,0,0,0,0,0,0,0,0,0,441,4,0,0,0,0,0,0,0,0,0,100
ef39527c11beba90669052fe8afea41c3ddb0bf8,0,0,0,0,0,0,0,0,0,0,0,0,0,0,443,6,0,0,0,0,0,0,0,0,0,100
fc00bb5b9b5223a43d0246d4fd478d90603e5f08,8,166,249,415,0,0,0,3,18,2054,1,4,1.893759468,1576,441,4,349,373,24,13481,13796,315,112,112,0,100
da103068127c2484ed3777852132b7bcd9172e90,0,0,0,0,0,0,0,0,0,0,0,0,0,0,445,8,0,0,0,0,0,0,0,0,0,100
73250856a0ca54da7f8a0e0b4a6360d7d374e28f,1,1,1,2,0,0,0,3,3,813,1,1,0,26,3,2,6,6,0,223,223,0,1,1,0,100
2b8b0610767f4cc51f0a393a0627b721069f052c,3,192,0,192,3,0,3,1,1,0,1,2,1.431059896,0,5,0,21,0,21,676,0,676,21,0,21,99.53673064
e8ed25deb75b4e9506bc6ac6121d4e7e7e5feaf6,6,218,402,620,0,0,0,0,34,70,3,4,1.428865188,1121,446,7,203,224,21,7474,8141,667,77,98,21,99.53673064
08c7151c4b98bd05c821933c2a3d20a71ced2483,0,0,0,0,0,0,0,0,0,0,0,0,0,0,447,8,0,0,0,0,0,0,0,0,0,100
8162ab5f1a364ca6e3c96d97507fbd2d782a7d7c,0,0,0,0,0,0,0,0,0,0,0,0,0,0,448,2,0,0,0,0,0,0,0,0,0,100
6d98c37f89f1c1d22cb8d65875ce30cd4f4d40c6,0,0,0,0,0,0,0,0,0,0,0,0,0,0,449,2,0,0,0,0,0,0,0,0,0,100
82a45c70cce38764e28ec9f7f75dcb636a9433ff,0,0,0,0,0,0,0,0,0,0,0,0,0,0,450,3,0,0,0,0,0,0,0,0,0,100
e28c661bccd40a0b03221ad6af08c2bcb3075149,14,892,218,1110,10,0,10,1,33,9,4,5,3.067677013,1252,6,0,337,258,79,12382,9437,2945,153,103,50,98.49771391
0e937a1d202fc910758897d66dff790317227990,14,218,892,1110,0,0,0,0,34,54,4,5,3.067677013,1648,0,0,258,337,79,9437,12382,2945,103,153,50,98.49771391
6949760dcda2be83a3c408502d89dfdc962f3764,0,0,0,0,0,0,0,0,0,0,0,0,0,0,3,0,0,0,0,0,0,0,0,0,0,100
5684bfa9be52505e49dec532b5b070184de0cfcb,20,1068,234,1302,10,0,10,1,33,546,4,7,3.166005736,1797,7,0,496,390,106,17322,13048,4274,235,183,52,87.07482993
29a3f615eb2c5a451378c1695ab250fbd7d4bb1a,1,86,9,95,0,0,0,1,4,4,1,1,0,251,8,1,56,42,14,2576,1908,668,16,16,0,100
73cc289467b1072e79f8a10aa4e95c0355814ca1,22,240,1159,1399,0,0,0,0,34,387,4,8,3.179764606,2524,6,0,401,521,120,13836,18847,5011,190,242,52,87.07482993
4a1b16ca3505f9509b37efa2e50eb0d3062498ef,0,0,0,0,0,0,0,0,0,0,0,0,0,0,7,1,0,0,0,0,0,0,0,0,0,100
d64a275f709bda4fc9c305db1937dde63eff0b22,7,0,368,368,0,0,0,2,4,1495,2,4,2.704092733,130,8,2,0,17,17,0,860,860,0,15,15,98.92473118
1cf3547af79b66928a978a0cba7dab9465408e0b,0,0,0,0,0,0,0,0,0,0,0,0,0,0,9,3,0,0,0,0,0,0,0,0,0,100
d2418c27cc9e8dca323fc43f1c28e9628f89c29f,0,0,0,0,0,0,0,0,0,0,0,0,0,0,10,4,0,0,0,0,0,0,0,0,0,100
d607fdfe37c3167fb997708811effc5c94f54af3,12,460,12,472,7,0,7,1,35,346,5,9,3.345998547,1210,4,1,288,263,25,10606,9333,1273,105,88,17,98.92473118
fb4ad6a47e940b22fc42c5640dd5c976428c7173,12,12,460,472,0,0,0,2,34,1206,5,9,3.345998547,1384,11,5,263,288,25,9333,10606,1273,88,105,17,98.92473118
fd80478e376790856b399f472283e58c3969f8fa,29,1569,240,1809,17,0,17,1,33,379,6,12,3.807523383,1890,9,2,550,401,149,20090,13836,6254,259,190,69,85.84544759
a05928a7e347e841ed0bb4359908b5feca390fb2,21,625,58,683,1,0,1,7,13,727,4,8,3.849100285,3488,10,3,922,882,40,31979,28376,3603,640,610,30,92.21949222
897c787e5f05793c710a96a3741fe9cde4af1ef7,1,43,43,86,0,0,0,1,7,0,1,1,0,369,11,4,65,65,0,2909,2909,0,16,16,0,100
c9d11af58f80f200972f4c59a11cfbb6afbbb532,2,5,1,6,0,0,0,1,8,0,1,1,0.918295834,398,12,5,72,72,0,3146,3126,20,20,20,0,100
4fdbf6c810a951918ed142d8fc3e83f985b5672c,2,56,2,58,0,0,0,4,5,212,1,1,1,371,13,6,100,96,4,3544,3076,468,82,78,4,100
b4cb434b726deedec52d570479289c1c655003bc,1,2,2,4,0,0,0,6,13,0,1,1,0,171,14,7,47,47,0,1233,1225,8,19,19,0,100
8ba235dd6cf2d61e714293fddb9239735a6d8e71,1,7,4,11,0,0,0,5,6,0,1,1,0,81,15,8,17,17,0,568,528,40,13,13,0,100
351eb6323824acc79e997c254bdebcfa3a29c3d9,0,0,0,0,0,0,0,0,0,0,0,0,0,0,16,9,0,0,0,0,0,0,0,0,0,100
44bf7101e44dd6690cf7165bd314511092ca86cd,12,213,80,293,0,0,0,7,14,12,4,5,3.524688919,3199,17,10,815,815,0,27583,27569,14,597,597,0,100
77bab097876cd2aa4b8024006c2eeae84902773f,12,224,592,816,0,0,0,2,34,1158,5,8,2.450521801,1245,451,0,214,231,17,8262,9182,920,84,99,15,98.75389408
ff1fddfdb016046cea8933adc2a04d05088c45a5,15,618,234,852,7,0,7,1,33,241,6,11,2.641031161,1408,18,11,303,285,18,11347,10378,969,137,122,15,98.75389408
c008fe6df2b58dca27f4d804f107999677cce8d7,12,224,592,816,0,0,0,2,34,1158,5,8,2.450521801,1245,452,1,214,231,17,8262,9182,920,84,99,15,98.75389408
f4debf25a3b5f0d299a72409675edee6eb6d1314,0,0,0,0,0,0,0,0,0,0,0,0,0,0,453,2,0,0,0,0,0,0,0,0,0,100
ed80810818c47d67668f26f3469e90ac10c97bb2,15,276,42,318,2,0,2,2,19,34,2,7,3.037837763,1256,0,0,270,255,15,11066,10079,987,119,109,10,99.68454259
a02c5dd9ff307cafdd89ff57c1fdd7f02cd06867,14,725,122,847,5,0,5,1,10,0,2,6,2.145946579,692,1,1,188,129,59,7811,5510,2301,69,48,21,91.24270225
ee6b6c058efc7194610f3b5b3e7b7d17564ff324,2,3,3,6,0,0,0,1,3,0,2,2,0.918295834,297,2,2,54,54,0,2332,2332,0,21,21,0,100
ba277032722bcba8710cbdcb7c0573c9a8c9649d,1,1,10,11,0,0,0,1,3,0,1,1,0,246,3,3,50,50,0,1938,1938,0,17,17,0,100
2f065e8669fb8699b6a08c157fb9ffc2c3254130,10,136,148,284,0,0,0,1,11,0,2,3,2.67088791,978,4,4,183,188,5,7742,7767,25,65,69,4,92.09876543
0b0b54be419fd8ad03ce0b09642f06985513860b,1,2,2,4,0,0,0,1,5,0,1,1,0,246,5,5,50,50,0,1938,1938,0,17,17,0,100
61c25fefbefe96b39c86ca7d260fa7d63f028912,0,0,0,0,0,0,0,0,0,0,0,0,0,0,6,6,0,0,0,0,0,0,0,0,0,100
6428e5d0d82aec4dfc8511f9e9d9ff5477b4dc31,1,4,6,10,0,0,0,8,19,251,1,1,0,860,4,0,236,236,0,8104,8128,24,37,37,0,100
4192c8751e546890e50da550cc7b8f737c91e502,1,6,11,17,0,0,0,7,8,266,1,1,0,79,5,1,11,11,0,582,627,45,7,7,0,100
d6c820b227ee1eea298126414e2e133096f7698a,9,1173,0,1173,9,0,9,1,1,0,1,4,2.337251639,0,6,2,119,0,119,4910,0,4910,50,0,50,98.41029523
c0031ab5ff9acfee04b8d0cc8ac53b0ae06fe19b,0,0,0,0,0,0,0,0,0,0,0,0,0,0,7,3,0,0,0,0,0,0,0,0,0,100
51e4a34145f39e03f3bb0eda20918125e44df907,0,0,0,0,0,0,0,0,0,0,0,0,0,0,8,4,0,0,0,0,0,0,0,0,0,100
788807eeb0335b163ab20c769983a91602273f22,2,161,4,165,1,0,1,1,11,526,2,2,0.305400571,63,9,5,29,18,11,1151,447,704,20,9,11,99.33872153
6406e124a1d1361629b5265c611e5a4504ffbb02,14,22,1345,1367,0,0,0,2,18,168,4,9,2.74448213,2114,7,7,335,465,130,12485,18030,5545,70,131,61,97.76119403
2289911757c09ad295cf4261d338a8c03ca32b5a,2,10,17,27,0,0,0,7,19,258,2,2,0.950956048,939,454,0,247,247,0,8686,8755,69,44,44,0,100
72ce897f9a3d0feded1687f68aea06375ff8ead2,11,1334,4,1338,10,0,10,1,11,95,2,6,2.625511878,63,455,1,148,18,130,6061,447,5614,70,9,61,97.76119403
a0249c07592f3f0932cdbb2b2f89cf3d85530705,5,84,1,85,4,0,4,1,2,1,1,4,2.179339741,27,10,6,4,4,0,232,188,44,3,3,0,99.42363112
0cb1aeed78f3efee8902a5bfeaaff22462753422,9,135,13,148,4,0,4,1,20,1236,1,4,3.046771174,942,11,7,247,247,0,8846,8802,44,47,47,0,99.43019943
f6b00394db9f958add41f8aa4f00499e05f0ae87,8,149,2,151,4,0,4,1,16,917,1,4,2.726063725,449,12,8,88,88,0,3323,3281,42,33,33,0,99.43661972
7bfbdd06dca8d8b3afa110b21d9a014fc1c5bf5c,6,117,38,155,4,0,4,1,10,94,1,4,2.373714034,611,13,9,117,117,0,4552,4510,42,60,60,0,99.44289694
35d9e99b6a08008bf8f1318cfc364f188d3334f0,5,91,0,91,4,0,4,1,35,50,1,4,2.267313535,668,14,10,150,150,0,5190,5148,42,38,38,0,99.44903581
a6cb1dafb5fdfe866a8b18a7e1bc8425d647e356,5,77,1,78,3,0,3,1,3,141,1,3,2.158024736,528,15,11,103,103,0,3949,3907,42,44,44,0,99.59072306
75243c6a4713d3fb7958538cd2f3994620c094f8,8,109,6,115,5,0,5,1,33,595,1,5,2.74064066,753,16,12,156,156,0,5541,5488,53,48,48,0,99.32523617
259f16353623eb9138d0c60d55b7864a0a05dbdb,7,118,2,120,3,0,3,1,2,168,1,3,2.678221548,768,17,13,161,161,0,5570,5528,42,41,41,0,99.59946595
2a3ecfbc951e3d2032b2df7e9fb9198a3ae8ebf7,1,5,7,12,0,0,0,5,8,339,1,1,0,198,18,14,35,35,0,1550,1553,3,19,19,0,100
498c783eb56b2ba3476f4e93f2f27149b63f6e41,1,1,1,2,0,0,0,1,2,18,1,1,0,417,19,15,87,87,0,3383,3378,5,30,30,0,100
e943b5a036644c850227d8de8d665eed45510f59,66,91,2228,2319,0,1,1,0,34,205,10,36,4.853232978,6201,8,7,1156,1286,130,42609,48496,5887,363,424,61,93.43794579
e5ca31b642570d6ec94e3df5dab752de082019c8,65,2228,90,2318,41,0,41,1,35,416,9,35,4.849881625,5061,456,2,1216,1086,130,45213,39315,5898,407,346,61,93.43794579
97c488e7f50500f7383380209661ab2fc321f6a5,0,0,0,0,0,0,0,0,0,0,0,0,0,0,457,3,0,0,0,0,0,0,0,0,0,100
c098f3486f4710d2f162b0bcac2bbc8149defada,39,725,8,733,35,0,35,2,12,45,3,37,5.198737356,1100,18,14,211,211,0,9063,8723,340,81,81,0,95.55273189
2b1f4aaf31f56b914b5e8e5b89963895506eb760,4,83,0,83,4,0,4,1,1,0,2,4,1.998855271,0,19,15,0,0,0,44,0,44,0,0,0,99.5157385
d08020c67f86b01c810d25881df9ea62d4e94f62,1,21,0,21,1,0,1,1,1,0,1,1,0,0,20,16,0,0,0,11,0,11,0,0,0,99.87966306
0eb2946c8289283d111eb65587dc76fd590b8a82,3,61,0,61,3,0,3,1,1,0,1,3,1.584576851,0,21,17,0,0,0,31,0,31,0,0,0,99.64071856
e97ecf1ec420e7bb5054e601207d139b4fa292c8,4,82,0,82,4,0,4,1,1,0,2,4,1.999570839,0,22,18,0,0,0,38,0,38,0,0,0,99.52494062
cbd8ad0ed04a4f47f7a48f50c10f62507a0c725d,2,22,1,23,1,0,1,1,2,5,1,2,0.558629373,1,23,19,0,0,0,20,11,9,0,0,0,99.88193625
5c0cc79a1734a0ccdea2aabe22a312ba4a67ca48,3,42,0,42,2,0,2,1,2,3,1,3,1.22857638,1,24,20,0,0,0,31,9,22,0,0,0,99.76470588
228c821e1f0edb31333cafb1d9dfd92eb0bc9c2c,4,82,0,82,4,0,4,1,1,0,1,4,1.999570839,0,25,21,0,0,0,42,0,42,0,0,0,99.53271028
cf52935d1cf71abf8ff49c40d4c867b149fc768f,3,62,0,62,3,0,3,1,1,0,1,3,1.584585122,0,26,22,0,0,0,31,0,31,0,0,0,99.65237543
57256e131ee547c3ed8f5f17cfa1f4c1d4373caa,2,41,0,41,2,0,2,1,1,0,1,2,0.999570839,0,27,23,0,0,0,20,0,20,0,0,0,99.76958525
a73e4190df396b11caea16fddd714d6af44759f6,4,82,0,82,4,0,4,1,1,0,1,4,1.999570839,0,28,24,0,0,0,42,0,42,0,0,0,99.5423341
3fb6c131056e0eda326f993596a9d6381ba0f3d8,131,92,3523,3615,0,1,1,0,34,103,14,97,6.202909933,6709,9,8,1238,1368,130,44951,51479,6528,394,455,61,85.73298429
29bab2e2cdec2f9e2a06bade4c56d970eba99fff,68,2242,100,2342,41,0,41,1,36,337,11,37,4.897134483,5913,20,16,1405,1275,130,52095,46197,5898,471,410,61,93.43794579
ad7b3074ad2f0960f1c998d1fe745c2a98d9a550,68,1299,11,1310,63,0,63,1,35,87,13,67,6.027781494,506,458,4,118,118,0,4932,4289,643,51,51,0,92.26993865
b0735a7146191098476ded06044865e3ebbb0281,2,7,6,13,0,0,0,1,15,53,2,2,0.779349837,465,459,5,98,98,0,3399,3399,0,35,35,0,100
b53627198eb15d648090310033cb04aa90a2ad24,2,9,4,13,0,0,0,9,36,152,1,2,0.619382195,424,460,6,99,99,0,3773,3773,0,36,36,0,100
239b7967b32128df30f67ed862cbdbdceb861dfa,0,0,0,0,0,0,0,0,0,0,0,0,0,0,32,28,0,0,0,0,0,0,0,0,0,100
4bd9db01a4ca5629d24216f4710fdb550f593335,1,1,1,2,0,0,0,3,6,15,1,1,0,264,32,28,42,42,0,2189,2189,0,15,15,0,100
bb1a1ac01b09d51018beaafbec5aedd19375f498,0,0,0,0,0,0,0,0,0,0,0,0,0,0,461,7,0,0,0,0,0,0,0,0,0,100
01856b565be8b6e890130dedc3bed89f63c96daa,135,229,3820,4049,0,1,1,0,35,126,14,97,6.129353733,8533,12,0,1518,1674,156,59510,67230,7720,522,611,89,85.73298429
b125b800187be7304461b6ed25a4288c3c58cd05,132,3530,85,3615,104,0,104,1,37,175,14,97,6.2117195,6310,13,1,1483,1353,130,55875,49254,6621,496,435,61,85.73298429
163d91bc284e5b5a53b9d314e9fd317964cef486,0,0,0,0,0,0,0,0,0,0,0,0,0,0,14,2,0,0,0,0,0,0,0,0,0,100
f5503ef369f2193f6395e72cc1875a94c04b33a3,3,40,48,88,0,0,0,10,38,42,1,2,1.102652051,951,462,0,190,188,2,7663,7432,231,71,70,1,100
854899e5db38fa14e7be56c1f850c35387d4df06,5,300,145,445,0,0,0,9,35,377,2,4,1.169600621,2190,462,0,404,380,24,19055,18183,872,182,155,27,100
882fac9790e64183999cf6d3714d12d0e73da351,1,1,1,2,0,0,0,1,3,321,1,1,0,135,463,1,21,21,0,796,795,1,18,18,0,100
c103f8951106f037b7e2b075c69610372d65aa4c,0,0,0,0,0,0,0,0,0,0,0,0,0,0,19,0,0,0,0,0,0,0,0,0,0,100
f14dbd4be9f0ed0729816466db0a803b1c7598a3,10,1371,1361,2732,0,0,0,7,11,120,3,3,3.063644676,2789,20,1,720,720,0,24885,24875,10,560,560,0,100
1d06958112db2a96b6b61934d3bbae9c33270019,7,98,14,112,0,0,0,7,12,0,3,3,2.807354922,2258,21,2,598,598,0,20229,20229,0,457,457,0,100
ac6c42b37385fd05fa9776e53d6de41320a202c4,13,1378,1463,2841,0,0,0,7,10,87,3,5,3.10730611,3058,10,0,767,765,2,27009,26893,116,587,587,0,100
70637707188c30111862d716b9af94cf7c742d1a,2,215,0,215,2,0,2,1,1,0,2,2,0.827447429,0,11,1,15,0,15,951,0,951,11,0,11,99.77272727
28e1011120468f183d7f1fb6371285946420a34b,2,69,26,95,0,0,0,6,11,489,1,2,0.996079991,187,12,2,29,27,2,1960,1618,342,13,12,1,92.56684492
b9f9f56bd29ce2fefc57acae76ad31c2f075840e,188,604,6402,7006,7,1,8,0,35,186,16,105,6.65364523,12768,5,0,2364,2733,369,81768,101346,19578,1222,1392,170,79.68665586
4cb5a8b4d46e9fc76cd91728855a431ddad2ca34,183,7610,1985,9595,122,0,122,1,36,238,16,105,6.263478953,10133,10,0,2688,2342,346,98432,80550,17882,1367,1213,154,77.25445146
1339aad4760ac9afb41a5e1f0eb42b71d0103e2b,23,1437,1535,2972,0,0,0,7,12,504,13,15,3.33223009,3916,34,0,912,915,3,32413,32437,24,670,674,4,100
dd66172613c9450f7a3141ed87b288c59bd8f301,2,5,4,9,0,0,0,1,11,645,2,2,0.764204507,472,464,2,84,84,0,3419,3414,5,47,47,0,100
0f11da5cbd6ad6428dbea890ac35efa7c64f5840,10,1467,1373,2840,0,0,0,8,13,10,3,3,3.076079756,2789,2,0,720,720,0,24835,24875,40,560,560,0,100
4410c415cc322244046a2234350c8d73f8649757,6,93,7,100,0,0,0,13,37,353,4,5,2.200467606,1288,6,1,324,314,10,10272,9884,388,142,138,4,92.45555022
3796843b08037457fa31750121cb71c55387035e,12,276,95,371,2,0,2,1,35,376,4,10,2.624540878,1691,3,1,393,384,9,14188,13157,1031,181,173,8,94.29484254
5846373ed25d32a37053853ae16265b7e560eeb1,2,39,4,43,0,0,0,4,34,324,1,1,0.99022469,726,0,0,158,152,6,5570,5322,248,48,46,2,100
0380911fc29f2a229ee98e9d8639c748bcaca65a,0,0,0,0,0,0,0,0,0,0,0,0,0,0,1,1,0,0,0,0,0,0,0,0,0,100
6658634542ea8c01fec17d0cc05d9217f6e40a0f,2,4,39,43,0,0,0,3,33,675,1,1,0.99022469,753,22,0,152,158,6,5322,5570,248,46,48,2,100
1fe93b6e00c706a862def239ccbbd0bc0821a017,0,0,0,0,0,0,0,0,0,0,0,0,0,0,465,0,0,0,0,0,0,0,0,0,0,100
33bab4a3e4711028adc30766b0cc797dab4604ba,1,2,2,4,0,0,0,10,37,458,1,1,0,387,0,0,91,91,0,3483,3483,0,29,29,0,100
fb7622fe7c81623e80d6d13bc605a0e974b29190,1,2,2,4,0,0,0,9,36,295,1,1,0,387,466,1,91,91,0,3483,3483,0,29,29,0,100
84cde80693c5baf593b684c93bd6e8a650c2426f,5,359,3,362,3,0,3,1,35,58,1,2,1.629028418,726,2,0,186,152,34,7119,5322,1797,61,46,15,99.54614221
d5d673cdf06aacf707c3aff8134a713e189d15b9,13,482,552,1034,0,0,0,0,33,1088,2,3,2.859384777,2037,23,1,413,447,34,13429,15226,1797,159,174,15,99.54614221
fbf5d58e78e89bf0a4e41c1406652ae7aa8a5f3d,9,195,481,676,0,0,0,1,37,1337,2,2,2.124759047,1455,467,2,352,352,0,11590,11590,0,142,142,0,100
f8706c99cbe2f3f1d1eb8bf96d445b6d9c47171c,8,479,193,672,0,0,0,2,12,1603,1,1,2.084791555,1068,24,1,261,261,0,8107,8107,0,113,113,0,100
c36a2c38b370799bd48a0eb30b1cced4c11dde4b,5,359,3,362,3,0,3,1,35,58,1,2,1.629028418,726,468,3,186,152,34,7119,5322,1797,61,46,15,99.54614221
560704c3afeb76408367fbd37087e814f9a0e7fa,4,135,289,424,0,0,0,10,38,115,2,3,1.091700535,1981,470,4,317,341,24,15564,16432,868,126,153,27,100
f3aed481b3d73f655f61e1dd35641f5a03de1415,6,96,7,103,0,0,0,13,41,407,4,5,2.191268735,1295,7,0,326,316,10,10324,9936,388,143,139,4,99.40179462
21ad6e94a5d3afba02a75e8e102fe7db1d56e4c0,7,7,100,107,0,0,0,12,38,409,4,6,2.339514888,1514,0,0,361,373,12,11162,11571,409,158,162,4,99.40179462
5664dc6791d97116f7613e9bb8407583b411b457,3,10,11,21,0,0,0,7,19,329,2,3,1.125490807,1173,0,0,197,195,2,10019,10026,7,92,92,0,100
76c86b960ea4e4d40e49b9c48fe865ca8e826e8e,3,14,9,23,0,0,0,6,39,281,2,2,1.214295263,1675,0,0,302,302,0,14000,13972,28,112,112,0,100
ce945da33c42463567c40a2d35fc34a0e23618d6,2,834,810,1644,0,0,0,12,38,285,2,2,0.034810552,1533,0,0,388,388,0,13398,13304,94,76,76,0,100
1d38afc472ba0fd0f67bdb555d1a790aa55ae60e,1,806,828,1634,0,0,0,9,21,532,1,1,0,873,0,0,236,236,0,8198,8198,0,37,37,0,100
4bbf52ee709aefebc47adc54fea908d1b2fe576c,1,1044,1042,2086,0,0,0,9,23,0,1,1,0,860,2,2,236,236,0,8198,8198,0,37,37,0,100
b0cd1950c978181890213e1c85e437e44421405e,4,1055,1057,2112,0,0,0,7,39,255,3,3,0.119693184,2539,1,1,538,538,0,22120,22198,78,149,149,0,100
d1a12514f1b9a710368877dc7592fc0769a6abda,4,1057,1055,2112,0,0,0,6,38,105,3,3,0.119693184,2537,35,0,538,538,0,22198,22120,78,149,149,0,100
9a253e365d2d38b78e18c848627f0aab6f708a6f,3,15,13,28,0,0,0,7,39,334,2,2,1.358157515,1679,471,0,302,302,0,14016,14000,16,112,112,0,100
aa01be9cec54b9a83cf8ddb22a61395461ca0560,1,3,3,6,0,0,0,13,41,3,1,1,0,678,472,1,152,152,0,5233,5233,0,39,39,0,100
2caa0ea3db494c6bb0e74d1f1fc8b8c86ddb5cf0,5,1057,1063,2120,0,0,0,4,38,330,3,4,0.150910297,2653,0,0,557,557,0,22908,23018,110,158,158,0,100
3f3232112edb829647ae489bed664e585d0b7d5e,4,1062,1056,2118,0,0,0,7,41,130,3,3,0.140201183,2537,473,0,538,538,0,22214,22104,110,149,149,0,100
d1347a5fdb48018050cf25d0e203019521ac8b77,3,33,2,35,1,0,1,1,2,88,1,2,0.626994856,32,66,0,2,2,0,294,236,58,2,2,0,99.54796585
0a7936017a5330a150ba422d493b59b1ffe3f6bf,3,2,33,35,0,0,0,0,1,0,1,2,0.626994856,40,474,1,2,2,0,236,294,58,2,2,0,99.54796585
d5593751fc8d05e502c15714d77ecd9310c834c8,3,33,2,35,1,0,1,1,2,88,1,2,0.626994856,32,475,2,2,2,0,294,236,58,2,2,0,99.54796585
442c7c2a2f8e643d5dcdea9ece00ab1a09caee3b,0,0,0,0,0,0,0,0,0,0,0,0,0,0,476,3,0,0,0,0,0,0,0,0,0,100
ce8daea35e0af024e73211cd58cd6f2af553f206,0,0,0,0,0,0,0,0,0,0,0,0,0,0,477,4,0,0,0,0,0,0,0,0,0,100
f05ac182262ce28750d0667f16061b11bc78ee97,0,0,0,0,0,0,0,0,0,0,0,0,0,0,478,5,0,0,0,0,0,0,0,0,0,100
d72aedffba18e37a20107ea9b146acbc01cc4965,0,0,0,0,0,0,0,0,0,0,0,0,0,0,479,6,0,0,0,0,0,0,0,0,0,100
3b48688f51d6cf618c760b24a341874f12e160d2,0,0,0,0,0,0,0,0,0,0,0,0,0,0,480,7,0,0,0,0,0,0,0,0,0,100
60e36d0cf5688f15fcc9e70e06fc3ebdaaa0cb29,0,0,0,0,0,0,0,0,0,0,0,0,0,0,481,8,0,0,0,0,0,0,0,0,0,100
ce30d08dc069387f68ede1f7233df9e0e408bf00,0,0,0,0,0,0,0,0,0,0,0,0,0,0,67,1,0,0,0,0,0,0,0,0,0,100
3a2e1ccfe1bc4338b7425e075341c135c3c0c0dd,0,0,0,0,0,0,0,0,0,0,0,0,0,0,0,0,0,0,0,0,0,0,0,0,0,100
9b632c5e1a951fbf06126063a3cee9ed65bea9a9,2,105,15,120,0,0,0,2,3,923,1,2,0.948078244,653,0,0,145,137,8,5316,4657,659,30,30,0,99.54841947
976a5c1db12d61ac2345f5aa6afcda8c1f3f4ed8,1,7,1,8,0,0,0,3,4,0,1,1,0,648,1,1,140,140,0,4678,4636,42,27,27,0,100
37d44b87426e72be10be780ec35a4b8656994107,0,0,0,0,0,0,0,0,0,0,0,0,0,0,482,0,0,0,0,0,0,0,0,0,0,100
e6eab433cf5584bac1f418dbc0caa5427408a209,15,1170,1210,2380,0,0,0,1,42,230,7,12,0.923271105,4045,8,0,870,868,2,32950,33406,456,294,290,4,99.25298805
3a4f1390673ea29f96be1166a8f28fee4bd7444a,16,1230,1177,2407,1,0,1,2,41,449,8,13,1.001673573,4051,0,0,880,880,0,33812,33288,524,292,296,4,99.25298805
1242a61db95dd10786a50caec1877544ad95e332,3,66,4,70,0,0,0,3,16,781,2,3,1.425067976,340,1,1,76,68,8,2917,2489,428,27,25,2,99.94984955
7c0e34eb942ae2fb990795c6ffce1632edfdccac,1,4,2,6,0,0,0,14,42,277,1,1,0,678,2,2,153,152,1,5244,5233,11,39,39,0,100
6e00139362d75c755f311ffffc2236998aaf237f,1,2,4,6,0,0,0,13,41,3,1,1,0,680,3,0,152,153,1,5233,5244,11,39,39,0,100
b9b91ae68d5ecc7a94d9aa14f3a93bb892c5da38,3,6,20,26,0,0,0,11,42,448,2,3,1.140115679,1728,3,0,291,294,3,14647,14670,23,105,108,3,100
58df5a4b6fc78631a1a306e514c85533ae11e862,1,4,2,6,0,0,0,15,44,7,1,1,0,680,4,0,153,152,1,5269,5258,11,39,39,0,100
1b20b1072c6a05276519115973b37ae8de8f8325,0,0,0,0,0,0,0,0,0,0,0,0,0,0,5,1,0,0,0,0,0,0,0,0,0,100
25188aacd98cbcfeec79026a285fb7b1f37187eb,11,49,129,178,1,0,1,3,17,1100,9,10,3.295917005,1268,3,3,148,163,15,8944,9574,630,125,140,15,99.498998
47d6d678e4ad80aae798060495b0ea9f5a7f05fb,0,0,0,0,0,0,0,0,0,0,0,0,0,0,3,0,0,0,0,0,0,0,0,0,0,100
a4b26e6c8b320b88d6a802f653a30b5d971d58fa,3,194,3,197,2,0,2,1,3,256,1,2,1.100878662,53,4,1,26,11,15,1231,300,931,12,5,7,99.35097354
c506f44f53f474b0ed7f1ffad47d087dace680a1,6,128,201,329,2,0,2,3,4,1,1,2,2.103319005,241,2,0,24,39,15,1165,2063,898,10,17,7,99.15296462
3b2f282dd68e6e3bae74c43fdd0b42039a9193d1,18,209,1243,1452,0,0,0,1,24,809,2,5,2.225537216,1773,3,1,193,353,160,7117,12139,5022,53,95,42,96.7339097
9e95efe2c5d7345400c1e5d081ad2c75bf833976,1,0,21,21,0,0,0,4,5,0,1,1,0,78,4,2,3,5,2,532,680,148,1,3,2,100
3879e1a68fa1d8fd500a2db1c5be2de8b2a3d4d4,1,0,104,104,0,0,0,3,5,9,1,1,0,64,5,3,0,3,3,0,574,574,0,1,1,98.69565217
d5e5560bac73885a34de1df66ea998f76006bc28,2,22,2,24,0,0,0,12,45,22,1,2,0.870864469,830,4,3,164,163,1,6827,6703,124,49,48,1,100
e796c8c511463cefdb6da785baf9373d19795995,33,1650,399,2049,9,0,9,3,44,430,11,17,3.453105383,2801,3,2,683,490,193,27380,20747,6633,288,215,73,97.59277834
cd3522aa47c542594dc9cc4d91b023a65db71ae9,42,1296,1639,2935,8,0,8,1,45,581,12,21,3.834726929,3728,6,4,614,683,69,24760,27408,2648,276,288,12,96.42679901
1ad1cc9c96d0e2a12612a9efa76503218a935316,45,2070,1371,3441,10,0,10,3,44,315,12,21,4.134177877,3533,4,1,762,614,148,29471,24788,4683,321,276,45,96.52260308
5608731163dc05b7f8d66ea4071d0a1af04911f2,30,397,1498,1895,3,0,3,1,45,817,10,15,3.228733344,3654,7,3,490,669,179,20732,26978,6246,215,274,59,97.89579158
8571ad90db93507118897e7fb51500ac4821c47c,2,91,42,133,0,0,0,1,3,0,1,1,0.907942863,279,8,4,73,63,10,2063,1744,319,23,22,1,100
3900a41d9a517025618f346b57bd0c5a1fbe89bd,0,0,0,0,0,0,0,0,0,0,0,0,0,0,9,5,0,0,0,0,0,0,0,0,0,100
b0c197744e40816bd5a1780684e9f31081949790,3,144,134,278,0,0,0,1,4,3,1,1,1.096595657,347,10,6,85,82,3,2338,2237,101,34,32,2,100
13f252e525e103155502953ebdad1006909747ba,0,0,0,0,0,0,0,0,0,0,0,0,0,0,11,7,0,0,0,0,0,0,0,0,0,100
eae36f4752f0e22465df552b1c8da1cb5db347fb,1,10,7,17,0,0,0,1,5,2,1,1,0,102,12,8,23,22,1,885,837,48,15,15,0,100
00d392f2c71e4c6b3e1c8a2fefff0b30afd7c05a,2,115,10,125,0,0,0,1,6,6,1,1,0.277839574,155,13,9,47,34,13,1548,1126,422,29,26,3,99.54977489
d68be8dfb013d7f8d1e56c94d554166d6440de35,4,271,154,425,0,0,0,1,7,5,1,1,1.546601423,541,14,8,122,120,2,3470,3378,92,53,53,0,100
a7b99f83aaf385cbe6772a5a0c7843b65153ec57,20,1303,881,2184,10,0,10,1,2,0,2,9,3.287034788,607,7,1,191,122,69,6066,3501,2565,95,53,42,97.33464956
05b791a62c03a35bdfbf156f795ff00edc61e4a1,7,119,9,128,1,0,1,2,3,0,1,2,2.741056595,774,5,0,165,165,0,4970,4970,0,76,76,0,99.80430528
6617b0bb81b7c7da327acf3be2bef9b8cb77337a,6,266,36,302,2,0,2,2,4,0,1,2,2.413103458,736,6,1,180,146,34,5243,4359,884,79,65,14,99.65836994
516f366cc27fa2654cf4017fa151cc07ad902a6d,7,492,299,791,3,0,3,1,5,0,1,4,2.583567653,910,7,2,169,164,5,5734,5656,78,66,62,4,99.02771026
7c3390d0a7cf72afe3ffb3e3748f993e85cce48b,26,1262,1895,3157,6,0,6,0,7,0,2,11,3.848900328,1346,15,9,169,230,61,4901,7380,2479,99,113,14,97.01419481
2695794ad01132486447e489b7e179edb357b974,28,2010,1303,3313,15,1,16,1,6,0,2,11,3.921057595,984,8,3,244,169,75,8442,4925,3517,123,99,24,96.77734375
89109b855537050f5b9d125a88d26ca2c1d12f78,3,194,17,211,0,0,0,1,7,0,1,2,1.198501047,811,9,4,182,153,29,6638,5630,1008,52,46,6,99.85514244
27b015e5dfdb67f8530e7c110d36aa55d0e42cb1,28,1444,2247,3691,6,0,6,0,8,0,2,11,3.935080361,1614,16,10,215,273,58,5846,9474,3628,101,129,28,96.33789063
c72f418ec98b259673c695ed60fa7290708a1d55,2,20,183,203,0,0,0,1,2,8,1,2,0.139777792,328,17,11,23,47,24,800,1391,591,22,46,24,100
b61eeaf0529f070ba19db904821b517a9e5528dc,2,31,20,51,0,0,0,1,9,0,1,2,0.238684511,454,18,12,98,98,0,2775,2801,26,38,37,1,100
4163a062f4f2986874a4e80a3e38ecf426559b0c,0,0,0,0,0,0,0,0,0,0,0,0,0,0,19,13,0,0,0,0,0,0,0,0,0,100
d3a44b261461ca260022638f75b83b24bf980641,0,0,0,0,0,0,0,0,0,0,0,0,0,0,20,14,0,0,0,0,0,0,0,0,0,100
5e383ef974541804382a639b79e3efbf6b03d2b2,33,2544,1333,3877,20,1,21,1,8,0,2,13,4.422851652,974,10,5,295,191,104,10635,5253,5382,151,78,73,95.82726832
3b44781f9514988a31e2748416b1cb7015e2767a,33,1311,2606,3917,6,0,6,0,10,2,2,13,4.440997467,1861,21,15,193,295,102,5271,10659,5388,78,151,73,95.82726832
65201d14389de67719d14edc5ede1496b21d17e2,0,0,0,0,0,0,0,0,0,0,0,0,0,0,22,16,0,0,0,0,0,0,0,0,0,100
ecd3c598b98212cbd47cd415819b62614496839e,2,3,3,6,0,0,0,1,4,0,1,2,0.918295834,167,23,17,28,28,0,852,852,0,20,20,0,100
4ce6a6e423700c72b99d28c7419aacc1dfe9e1ab,36,3251,1315,4566,25,0,25,1,9,2,2,13,4.643750112,1021,11,3,384,193,191,14462,5275,9187,198,78,120,95.25882922
2fe2c2bbbffcbeb968e523dd332ad087827b3f92,7,166,143,309,0,0,0,1,10,0,1,3,1.991103904,947,12,4,164,157,7,7233,6653,580,73,81,8,99.76292082
163624a9596298bf80bb41360fcd246a886a0688,3,22,6,28,0,0,0,2,11,0,1,2,0.946372936,373,13,5,59,58,1,2375,2258,117,43,43,0,100
4ebfabb194c88fa10db51d6f2db6282a357ae15d,1,8,1,9,0,0,0,2,12,0,1,1,0,186,14,6,33,33,0,1128,1045,83,28,28,0,100
cc452f8dc0d864c50279dfa61d56e57e5e40a740,7,129,26,155,0,0,0,1,13,0,1,4,2.302820044,1047,15,7,193,171,22,8477,7695,782,85,79,6,100
71a95b98f37d268eeafd2fb653ee1b2158416eaf,43,1817,3620,5437,9,0,9,1,1,0,2,16,4.735928419,2617,25,0,232,414,182,9691,16024,6333,83,196,113,86.11410118
434398203b50c8bc4a71b116ebfa99ef6d0de8a2,44,3739,1917,5656,29,0,29,0,14,0,2,16,4.723520023,1287,16,6,461,232,229,18309,9691,8618,215,83,132,86.02150538
3b35c36fa6855512fe3a228b82caf32952271203,68,1525,4249,5774,6,0,6,3,46,226,14,30,5.032915189,7214,9,0,982,1270,288,40256,53121,12865,443,594,151,93.32688588
055d5b48cc618b41b2a2d41d95e83fcfa232d838,16,1463,1570,3033,0,0,0,2,17,923,3,6,3.243544074,3058,10,1,795,784,11,27102,26814,288,603,592,11,99.70267592
b58722b587a29c8d8d069ceaafe4c2f63f6cc47e,0,0,0,0,0,0,0,0,0,0,0,0,0,0,11,2,0,0,0,0,0,0,0,0,0,100
2d667edb08ac241e857c9922d05f13a00c91fdc3,66,3673,2986,6659,19,0,19,1,45,437,16,31,4.803116442,8319,24,0,1803,1777,26,67520,67244,276,1057,1046,11,94.86419753
c485f5bed92b784a4dd915c6fe5d7b95a9990618,3,37,5,42,0,0,0,1,12,0,1,3,1.138097714,534,25,1,114,111,3,3559,3358,201,40,40,0,100
390a4358394c91b08ac7903d69689a62cc8c0fc8,2,10,15,25,0,0,0,1,13,6,1,2,0.989587521,501,26,2,108,108,0,3232,3240,8,34,36,2,100
dbe962a24475a2d288e1e1ff681c21ccd05b5cbc,2,55,32,87,0,0,0,1,14,6,1,2,0.988437428,496,27,3,106,108,2,3373,3232,141,34,34,0,100
a51b719cb265ec63f9699f74b498efc0d27c1920,41,6168,1601,7769,27,0,27,1,15,10,2,15,4.599086241,1191,17,1,895,211,684,34556,6376,28180,426,84,342,94.91362764
6ee55e92440c2eb8a25bffce9fe0b18e1d49b67c,43,1597,6225,7822,9,0,9,0,14,2,2,15,4.634473852,4471,28,4,211,895,684,6376,34580,28204,84,426,342,94.91362764
08fb5dd3465bf636093b056b059c8ce2deda42df,1,2,2,4,0,0,0,1,5,82,1,1,0,53,29,5,5,5,0,281,281,0,4,4,0,100
74147203997d0ff078b5847a0749b3e0f30d2137,0,0,0,0,0,0,0,0,0,0,0,0,0,0,30,6,0,0,0,0,0,0,0,0,0,100
360c6046623fc425c2125b2f9410290dbe5d69c6,0,0,0,0,0,0,0,0,0,0,0,0,0,0,31,7,0,0,0,0,0,0,0,0,0,100
c0aa76eb16031973f3e897ea535a0b38bfb7f11f,1,12,5,17,0,0,0,1,4,4,1,1,0,56,32,8,8,6,2,330,323,7,4,4,0,100
9c384099633c80249316af35922c99a70cbbc5be,8,50,39,89,0,0,0,1,15,36,1,4,1.62139248,1050,33,9,205,205,0,6013,6013,0,80,80,0,100
38037ca9530c84c8b7d88284d19b47bbc3f0ab58,0,0,0,0,0,0,0,0,0,0,0,0,0,0,34,10,0,0,0,0,0,0,0,0,0,100
7a5d7677e6ae10318907876c58727d68bdd72bac,3,59,6,65,1,0,1,1,9,0,1,2,0.870969213,186,35,11,20,18,2,1166,943,223,18,17,1,99.31473324
c5352b0e077ad1bebe6f3536e7fd1efe2fef5cfa,42,6281,1672,7953,27,0,27,1,16,8,2,15,4.62573064,1240,18,1,897,215,682,34506,6610,27896,425,85,340,95.117281
7a56d2484badfbceff130dab0c128f1a581827c0,44,1669,6338,8007,10,0,10,0,15,6,2,15,4.660602649,4464,36,12,215,897,682,6614,34530,27916,85,425,340,95.117281
d555d56324cfa620bba111242931fbb7337bfe4e,0,0,0,0,0,0,0,0,0,0,0,0,0,0,36,12,0,0,0,0,0,0,0,0,0,100
0e8b046e38af1dbf1fe4b2437b0865cb83bedfad,0,0,0,0,0,0,0,0,0,0,0,0,0,0,38,14,0,0,0,0,0,0,0,0,0,100
1500916bf165064d370c3583a19350010a88e2a1,1,2,34,36,0,0,0,1,7,2,1,1,0,240,39,15,48,53,5,1218,1319,101,7,8,1,100
99894b82ae77290ff43d84eeffe638c3ed55d2d9,42,6352,1641,7993,27,0,27,1,16,7,2,15,4.626128219,1218,19,2,905,210,695,35125,6517,28608,427,84,343,95.117281
962d7a6ad830b8a6feca752ddf39f4d705bd563e,30,2549,1823,4372,1,0,1,1,17,40,1,10,2.86237595,4457,20,3,999,901,98,37183,34946,2237,444,424,20,99.20037629
a2a4840549f7468500a8c903612b0383d0b7b975,46,1634,7155,8789,10,0,10,0,15,5,2,16,4.653009644,4989,0,0,210,1003,793,6513,37395,30882,84,447,363,95.01199041
170b62aeae48d2cff474edf0b275b0f2bb3a5f88,2,245,81,326,1,0,1,1,8,16,1,1,0.647642823,217,40,12,69,48,21,1800,1218,582,12,7,5,99.80497318
b26691806891840645059fa5e3a6c86f167f32cb,2,19,5,24,0,0,0,1,16,40,1,1,0.918295834,492,41,12,118,116,2,3368,3282,86,37,37,0,100
a9a3ad4922a45a76c8c6b1b76c011d72736e0c30,49,7743,1869,9612,31,1,32,1,18,13,2,15,4.814363886,1353,8,0,1103,233,870,40789,7203,33586,502,89,413,94.66477809
a2d63caeac9b1b640ea2d2004e4312393ec6efcc,4,570,185,755,1,0,1,2,10,0,1,3,1.478217764,789,9,1,277,221,56,8505,6272,2233,35,17,18,99.81676592
2695207be60528c10f0d03ac097c0af73a2ab292,14,87,101,188,0,0,0,1,11,0,1,5,3.210142785,2730,10,2,500,500,0,20080,20203,123,179,179,0,100
0de528effcfa595ff9f9c5cb3d0c7eaf18392554,15,406,121,527,0,0,0,1,19,4,1,6,2.974955893,3074,11,3,683,677,6,23888,23626,262,183,180,3,100
460f9f5b0f30b4ddd5d568ea4c381779e9dcf6f3,51,1818,8466,10284,11,0,11,0,17,4,2,16,4.875198065,5760,42,2,232,1165,933,7220,43194,35974,88,523,435,94.52571968
266ebf464983940a1e36f2bf15737d258d471f24,50,8402,1875,10277,32,1,33,1,20,12,2,16,4.8726476,1353,12,4,1164,232,932,43108,7242,35866,522,88,434,93.17738791
b1f906c263217909d7c8ba555eb2464ea120ade5,1,8,0,8,0,0,0,1,4,0,1,1,0,235,13,5,46,46,0,1877,1877,0,13,13,0,100
1fba41622f64af497b9da81fe6aa7de069da32c4,8,147,24,171,0,0,0,2,14,5,1,3,2.558083609,1633,14,6,365,359,6,13725,13159,566,68,66,2,100
bebc7a8a524e19739f6128437bab06212a35e75b,51,1825,8600,10425,11,0,11,0,18,4,2,16,4.87793567,5842,43,3,235,1170,935,7275,43707,36432,88,524,436,93.17738791
18c6426d1fbb60f0a52a5a7a021690f62d821955,1,1,1,2,0,0,0,1,19,0,1,1,0,395,44,4,98,98,0,2863,2873,10,21,21,0,100
683d902dc66c21b2353292880a00e0e149e548d4,50,8541,1882,10423,32,1,33,1,20,10,2,16,4.87379459,1358,21,0,1173,235,938,43718,7287,36431,524,88,436,93.17738791
31af406eb992beebcb8c0f6908df8031ef179aeb,51,1818,8608,10426,11,0,11,0,20,4,2,16,4.878599813,5850,45,4,231,1173,942,7214,43751,36537,88,524,436,93.17738791
837b12606b3c857c1d8df4b05424c607f3580230,8,250,8,258,4,0,4,1,21,22,1,4,2.331081371,589,46,5,134,123,11,4846,3809,1037,52,42,10,99.31972789
ce78ef520c44a075dd24d02f41edd4cccf47bc4b,54,8523,2117,10640,32,1,33,1,21,10,2,17,4.959995101,1543,15,7,1173,242,931,43718,8284,35434,524,98,426,92.60700389
3d4e1d69a27b96583cc9c8ccc1cd4abc9a7bf0b9,19,2131,0,2131,19,0,19,1,21,23,1,6,3.420434489,0,483,0,242,0,242,8251,0,8251,98,0,98,89.18640577
cbed41d00ab55776b8f7647ffe00818ff736ddba,27,0,4276,4276,0,0,0,2,41,1731,1,6,4.152126494,2675,484,1,0,597,597,0,20979,20979,0,193,193,86.57187994
89683c743000df84daddafdafe2e3308480e5c73,37,0,0,0,0,0,0,1,42,0,1,11,0,5799,16,8,1173,148,1025,43718,5883,37835,524,111,413,84.74399164
52d583affe4e4132d682e011930fe9c466fed27f,0,0,0,0,0,0,0,0,0,0,0,0,0,0,17,9,0,0,0,0,0,0,0,0,0,100
e7b4c3d162331f97ac2ef59ed939d5ed81103cd8,0,0,0,0,0,0,0,0,0,0,0,0,0,0,485,2,0,0,0,0,0,0,0,0,0,100
742df58cbacbac40aa29045c332089a98e21a286,6,198,105,303,0,0,0,12,43,36,1,4,1.44207295,1659,18,3,384,384,0,13872,13872,0,245,245,0,100
7a0174fa338294b3ff20859ad3b776b7f0e2970b,18,148,168,316,0,0,0,4,16,1434,1,9,3.60834743,1567,486,3,292,292,0,11060,11069,9,170,170,0,100
2303e85c5ba9e2aaa72b0e3ea88d589e312df104,101,5853,10610,16463,23,1,24,1,40,500,4,32,5.607711112,8988,26,0,1122,1715,593,41782,63141,21359,446,800,354,85.82949309
f6317e44558135dcbb58b188900019fe21e4eea6,87,10501,3975,14476,43,0,43,4,43,664,3,26,5.415623972,4225,27,1,1707,894,813,63018,32163,30855,792,366,426,85.96222563
96b9e96df165757f766e414633ae7ad05dd9d05e,5,44,7,51,0,0,0,1,3,144,1,2,0.925674911,1115,28,2,210,210,0,8483,8483,0,64,64,0,100
9617fbce70fef3ad0e0de235bab92bf6c836a647,15,0,1981,1981,0,0,0,0,0,0,1,6,2.768638652,1294,487,1,0,233,233,0,9745,9745,0,83,83,90.51269765
e7b97c70796be9f0b62d5d05a28c85486412c39f,15,1981,0,1981,15,0,15,1,3,48,1,6,2.768638652,0,488,2,233,0,233,9745,0,9745,83,0,83,90.51269765
68c67db30cc1b9d0eb564571750e4ecf65276855,0,0,0,0,0,0,0,0,0,0,0,0,0,0,489,3,0,0,0,0,0,0,0,0,0,100
b13743d9d90fbffa6edbea34d6ea80a60ccb8c8b,0,0,0,0,0,0,0,0,0,0,0,0,0,0,490,4,0,0,0,0,0,0,0,0,0,100
d173382084f73f4b2779fcb9131498f11f010371,0,0,0,0,0,0,0,0,0,0,0,0,0,0,491,5,0,0,0,0,0,0,0,0,0,100
fd2a5eee547d4f46c4863ba5c16e40bdde0a72e9,0,0,0,0,0,0,0,0,0,0,0,0,0,0,492,6,0,0,0,0,0,0,0,0,0,100
e1a496b2b95fa33313586870e821eedb14cb3ddd,0,0,0,0,0,0,0,0,0,0,0,0,0,0,47,0,0,0,0,0,0,0,0,0,0,100
6737f0f1aef3154944d5a1a1d30ec41c5484d595,0,0,0,0,0,0,0,0,0,0,0,0,0,0,493,6,0,0,0,0,0,0,0,0,0,100
1d5ce0051975f0aca46258ba1efe714768589b2d,1,1,1,2,0,0,0,1,2,87,1,1,0,377,19,0,92,92,0,3201,3198,3,10,10,0,100
43ddc91f9e0b77cbefdda850b7aadf3261505e04,159,7346,14595,21941,24,1,25,2,47,476,17,55,6.161234234,17646,12,0,2693,3536,843,100783,134449,33666,1419,1839,420,87.37327189
e3496145d2ee1d147bcf2af176b99c0ad12d43b9,1,3,0,3,0,0,0,1,2,10,1,1,0,20,13,1,2,2,0,147,131,16,2,2,0,100
0ae4ec44259ea0e3feec3e76671420438547fdae,2,15,5,20,0,0,0,11,17,10,2,2,0.468995594,250,14,2,25,24,1,2249,2229,20,20,20,0,100
4260fc0c6c52a8e3b03e08619afb5550a29541f0,159,14547,7311,21858,64,0,64,1,45,510,17,55,6.168441625,12729,20,0,3536,2694,842,134412,100856,33556,1839,1419,420,87.37327189
bf1165fac897d7d51fd6645a0eb8dfdd4eb4165c,159,7363,14595,21958,24,1,25,2,47,466,17,55,6.163118821,17646,15,0,2694,3536,842,100834,134449,33615,1419,1839,420,87.37327189
6428f2c6753975b5e72ba3d7c7eb69d1e1d578d1,159,14547,7319,21866,64,0,64,1,45,513,17,55,6.17034623,12732,494,0,3534,2694,840,134388,100871,33517,1839,1419,420,87.37327189
ad3f69751b3185fd0d178d5e7ed672960ffac343,1,1,1,2,0,0,0,1,2,87,1,1,0,377,495,1,92,92,0,3201,3198,3,10,10,0,100
6dc22695d51eb464df4bb27765b1af18ca757b9e,159,7382,14595,21977,24,1,25,2,47,462,17,55,6.167058249,17642,16,1,2695,3534,839,100902,134428,33526,1420,1839,419,87.37327189
f028a548b933c73c85c1f15a4900fe93fc1c4908,161,14411,7428,21839,56,0,56,1,45,528,17,56,6.161136757,12872,496,2,3552,2719,833,135022,101810,33212,1849,1436,413,87.04902868
546a1c7d5d40f45e7ce2331255c1763a5b04579e,1,1,1,2,0,0,0,9,18,997,1,1,0,169,5,0,45,45,0,1226,1226,0,19,19,0,100
e66d8cd80c0fd29925050aec9ff96095617dd076,1,16,0,16,0,0,0,6,10,2415,1,1,0,80,6,1,12,10,2,923,839,84,7,6,1,100
b06da5f32ec572c88f7ec5245a4b573c73ae8c22,46,1675,1216,2891,0,0,0,2,46,1106,13,31,4.548347165,11300,5,0,2258,2170,88,90210,86628,3582,829,825,4,97.47276688
73db5970c0248433d25be914308f76b03fdef175,2,4,1,5,0,0,0,6,25,4,2,2,0.721928095,902,6,1,236,235,1,8633,8628,5,37,37,0,100
28b78fae7a943c51e7c7d5f4a4802d913ef7fd04,46,1195,1657,2852,0,0,0,1,45,674,13,31,4.550187228,11741,0,0,2170,2259,89,86628,90215,3587,825,829,4,97.47276688
ff0918d4b8d6e45b0188e6a95ecf83b6ee1de0cb,0,0,0,0,0,0,0,0,0,0,0,0,0,0,0,0,0,0,0,0,0,0,0,0,0,100
dc754b16e2798242d2a050ba355488566d2ede08,0,0,0,0,0,0,0,0,0,0,0,0,0,0,2,2,0,0,0,0,0,0,0,0,0,100
e2d7341b3b72c001d5601c30f2d268f8987a7a4c,44,1678,1200,2878,0,0,0,2,46,1116,13,30,4.520476274,11042,6,0,2204,2113,91,88150,84479,3671,804,799,5,97.47276688
b782a0a58ad5886604e1e80a051727dc7fe101f3,24,54,191,245,0,0,0,8,47,120,12,18,3.485108725,8322,9,0,1762,1764,2,61397,63135,1738,532,532,0,100
750bf9d42a607d6f466ab9b93789cbb016948a69,24,191,54,245,0,0,0,8,46,863,12,18,3.485108725,8182,36,0,1764,1762,2,63135,61397,1738,532,532,0,100
76cc89cddd2cbda42518de8e304e92e3f341a744,17,82,1,83,0,0,0,5,15,2274,12,15,4.040146762,1021,0,0,204,189,15,7491,7256,235,130,115,15,100
0ee48ab3d96445a280852a1fd04206efb883baa9,6,24,13,37,0,0,0,16,47,31,3,4,2.205011032,922,1,1,207,201,6,7112,6975,137,67,67,0,100
eb4937418e700af5f8518f66e3d29bfc4d110798,16,78,78,156,0,0,0,5,48,0,11,14,3.835243272,1715,2,2,361,361,0,12561,12564,3,164,164,0,100
346ec4300c47b129e06411dc9cea097dab9a8e8e,39,63,292,355,0,0,0,8,47,388,12,31,4.476947812,9147,7,0,1896,1919,23,66552,68659,2107,622,637,15,100
dc70b14b542830cee434329cabee1b801ad51254,1,0,2,2,0,0,0,6,8,93,1,1,0,56,8,1,10,10,0,324,333,9,8,8,0,100
5e5e43dad805433c533948f63599ed27706ed6cb,28,1927,1579,3506,4,0,4,2,54,663,6,13,3.806128262,4639,24,0,1189,1142,47,41386,39251,2135,789,756,33,97.42765273
6d40006563f96442c039b9541355e3c18390ddab,15,1424,1721,3145,0,0,0,9,15,655,4,7,1.269859441,3888,25,1,996,988,8,33348,33183,165,772,764,8,100
0afed6a711c208fee64328cb852712e57036af5d,12,1818,7,1825,8,0,8,1,23,599,2,6,2.008928125,437,26,0,376,101,275,13292,3473,9819,114,44,70,95.58194774
8e3e3f35b903be1f73ae866f03b9c0da8c097db5,6,582,487,1069,2,0,2,1,55,12,2,4,1.520560353,1685,27,1,400,405,5,14068,13942,126,93,95,2,99.30491196
0b60c1fa734001f087c9865c49fdeaebae574557,6,257,89,346,1,0,1,1,56,232,3,4,1.631932713,1733,28,2,401,387,14,14320,13848,472,138,127,11,99.9076639
8d99c0554f4dcd620489eefd7963bce4d0a89dab,89,3793,5493,9286,3,0,3,1,48,379,16,52,4.489001143,17433,0,0,3570,3840,270,128325,137919,9594,1793,1871,78,94.22043011
5c3acdcbe14ee0d5174ae0a22c4222676342d82e,24,54,193,247,0,0,0,8,50,107,12,18,3.513632232,8335,1,1,1768,1770,2,61485,63232,1747,534,534,0,100
4ca9bd3382d1e6b5e768f984b4ab804d6f0259bd,71,5597,3604,9201,16,0,16,2,57,633,16,39,4.404173952,9150,29,3,2345,2056,289,85659,73702,11957,1436,1346,90,94.09395973
3dada3ae68d58491197deb8a3c1cc3f5504a48f8,71,3603,5596,9199,3,0,3,1,50,233,16,39,4.406877598,10446,0,0,2056,2345,289,73702,85659,11957,1346,1436,90,94.09395973
791e14cb9c8ac13fe4506470f2b8921c3cc542da,1,1,1,2,0,0,0,6,9,0,1,1,0,57,0,0,11,11,0,429,429,0,7,7,0,100
77be0d83d64f51553a915915ee6d56dafb6e75ed,69,5491,3606,9097,14,0,14,2,58,653,16,39,4.349270827,9150,30,4,2349,2056,293,85340,73702,11638,1437,1346,91,96.31818182
5578e731d97d974902d923da646650228a2a1446,3,127,385,512,0,0,0,1,6,0,1,2,0.892495967,871,31,5,168,211,43,5945,7505,1560,40,49,9,97.82503625
fb4b3552a497ea082cec27c69512e7f91dbca619,69,3606,5230,8836,3,0,3,1,50,191,16,39,4.321257847,10231,2,2,2056,2306,250,73710,83780,10070,1346,1428,82,95.2886836
4346216ffbed9a9adef2b90589436de543167c4c,24,2669,0,2669,24,0,24,1,1,0,1,8,3.494361144,0,1,1,381,0,381,15561,0,15561,139,0,139,95.32374101
a8398651d0b75fe9f161496b266b43d6382399b8,34,47,2701,2748,0,0,0,4,46,236,7,16,3.659761248,4486,3,0,549,929,380,21406,36769,15363,170,309,139,95.32374101
7d671376a47a7251dad9df2e8176946b4ddb3420,24,2669,0,2669,24,0,24,1,1,0,1,8,3.494361144,0,0,0,381,0,381,15561,0,15561,139,0,139,95.32374101
7545170df8047ea6127660c1750e1d0b59044e49,26,481,2461,2942,4,0,4,2,2,66,1,7,3.746681428,1815,1,1,68,381,313,2437,15541,13104,49,139,90,95.50111359
b1e2ae4c902691bbce02a90b76c4bee1c6e58455,2,99,7,106,1,0,1,1,3,31,1,2,0.933222699,145,2,0,39,27,12,1518,996,522,20,16,4,99.91452991
db7540e045fc07ef39d37163a263615c6e580efe,4,407,18,425,0,0,0,1,4,44,1,2,0.948689823,315,3,1,161,58,103,5046,2278,2768,44,31,13,100
87eddc2495cdeec9b28246ea08708540c365f34e,6,322,5,327,4,0,4,1,5,44,1,3,2.319046927,563,4,2,194,142,52,5996,4258,1738,46,33,13,99.65957447
740ab8145ac6c004d2b10ea46ea0f5c2a0a9f71f,13,238,104,342,1,0,1,1,6,92,1,4,2.080401361,1012,5,0,230,232,2,7372,7325,47,76,76,0,99.83050847
8220a15915a86faa68419fe47fd78d4c349f8353,0,0,0,0,0,0,0,0,0,0,0,0,0,0,6,1,0,0,0,0,0,0,0,0,0,100
446f42ea3685691ee10cf5054a055e8f1685077f,16,476,198,674,4,0,4,2,7,130,1,6,3.199619342,1191,7,0,223,230,7,7900,7363,537,79,76,3,97.76286353
89225d7ab30ef8fdc650d74ae93454a88fe14dc9,97,5263,5554,10817,14,0,14,2,58,486,17,53,4.870729164,13165,8,0,2844,2821,23,104653,102861,1792,1590,1590,0,94.15741188
6cec5f66c42d5439f1c491ac2d6d9c01d831db29,33,350,48,398,0,0,0,6,62,366,13,28,4.233840173,5866,10,1,1174,1106,68,47623,46050,1573,493,451,42,99.50884086
3b11b1c0e6852be80487963213c8d32774aa0c7e,0,0,0,0,0,0,0,0,0,0,0,0,0,0,11,2,0,0,0,0,0,0,0,0,0,100
eb97b425e36e2b9e4053fdc7ab59f7951b91e631,0,0,0,0,0,0,0,0,0,0,0,0,0,0,12,3,0,0,0,0,0,0,0,0,0,100
2e9508bc02e7624f3d3c84a544bf4f5425ddbb1a,0,0,0,0,0,0,0,0,0,0,0,0,0,0,13,4,0,0,0,0,0,0,0,0,0,100
2974126a934bddc526830182b402767c0f1eefd0,0,0,0,0,0,0,0,0,0,0,0,0,0,0,14,5,0,0,0,0,0,0,0,0,0,100
ad8a8978a5bcc1cc177bc2fabcc92cf70e861906,70,5286,5286,10572,22,0,22,1,51,343,9,30,4.727130514,8281,29,0,1890,1981,91,65700,68921,3221,1188,1230,42,94.06657019
56f8002ab47a1a1190bafa3ea327c6f4ffc900ea,6,73,84,157,0,0,0,4,50,519,1,4,2.103754606,1317,29,0,257,257,0,10307,10451,144,96,96,0,100
dff8b1a7821262b5158905abc30091f56dd4790e,0,0,0,0,0,0,0,0,0,0,0,0,0,0,29,0,0,0,0,0,0,0,0,0,0,100
6a90102ca121229db1e172fd4f84481117a71dbc,5,8,5,13,0,0,0,2,11,1241,1,3,2.192005835,353,29,0,32,30,2,1948,1923,25,26,26,0,100
0361086ee17ecf823c5e5c59dbc8b27a77097c94,10,424,8,432,4,0,4,1,19,100,3,6,1.830780953,524,29,0,92,77,15,5218,3174,2044,57,45,12,97.83631232
64380fd327b996443b061d01694e70b2c6ed3e13,5,0,419,419,0,0,0,0,18,199,2,3,1.618671854,396,31,0,45,62,17,1226,3295,2069,19,31,12,97.83631232
e9c561e5c98a10e5344b5899b6c65cf701589833,5,8,5,13,0,0,0,2,11,1241,1,3,2.192005835,353,33,1,32,30,2,1948,1923,25,26,26,0,100
b6c5132d8b532a3f0c1671932735825d41a1a0e9,0,0,0,0,0,0,0,0,0,0,0,0,0,0,34,0,0,0,0,0,0,0,0,0,0,100
692fdd600bc6224902aea3b76e671d5efa5ef589,6,84,73,157,0,0,0,5,51,1991,1,4,2.103754606,1306,9,0,257,257,0,10451,10307,144,96,96,0,100
4e7535a5de518cf4be28873da7a218fd89c1d8da,0,0,0,0,0,0,0,0,0,0,0,0,0,0,10,1,0,0,0,0,0,0,0,0,0,100
40ca0af450471fa0b0051200f93f1a30730ee380,75,5501,5279,10780,14,0,14,2,62,581,10,34,4.76694468,8708,15,0,2011,1922,89,70880,67699,3181,1256,1214,42,94.06657019
6ce47dcdea60e4b0d3abe03ddac01a65716cc173,30,1991,78,2069,19,0,19,2,64,549,3,14,3.70792616,1716,18,2,521,293,228,21095,12857,8238,204,122,82,97.19581749
8c373011bc0973df1f2136fda9b72b64a74d8552,48,3303,5417,8720,3,0,3,1,51,315,8,21,4.171783997,8168,36,0,1607,1924,317,55048,66480,11432,1076,1200,124,95.51192146
b366e6c5b70a7de8c15d0af4623a6ed4b2810830,0,0,0,0,0,0,0,0,0,0,0,0,0,0,37,1,0,0,0,0,0,0,0,0,0,100
3d921068b225994b20a31eef703d889cdabb05b4,85,1163,2367,3530,5,0,5,8,46,569,15,54,4.857320417,14109,29,0,2561,2737,176,100221,103667,3446,935,1013,78,95.28513696
224a3c368dae92bf0a6a8725b68b1fba9eb4a040,75,2390,315,2705,19,0,19,8,51,405,14,49,4.717968608,12035,39,1,2632,2338,294,99883,91857,8026,968,844,124,96.35555556
0a0ebbf02c08e303eacddc45854f8cd6e0e0f9d9,1,12,0,12,0,0,0,1,2,0,1,1,0,90,40,2,17,13,4,760,704,56,6,5,1,100
5ebd0e716736f3412088a6b9730563e4957f8683,57,5438,4186,9624,14,0,14,9,64,614,10,27,4.430451039,8300,19,0,2201,2021,180,75792,69280,6512,1264,1202,62,94.79262673
05499d26b0fd6b2ccaaacdd665ae4a45808bd642,1,5,0,5,0,0,0,6,11,1040,1,1,0,23,20,1,0,0,0,154,154,0,0,0,0,100
ec8b737e913ebe887e8d79e463fa49ecbc45ba95,2,1,2,3,0,0,0,2,26,508,2,2,0.918295834,696,21,2,161,161,0,5774,5774,0,55,55,0,100
d4c5710894d7a141863d94fe66ad79aea0b9eeec,0,0,0,0,0,0,0,0,0,0,0,0,0,0,22,3,0,0,0,0,0,0,0,0,0,100
0259f2ff599789739ec402ffc24afdc6d5392f5b,0,0,0,0,0,0,0,0,0,0,0,0,0,0,23,4,0,0,0,0,0,0,0,0,0,100
6a8f225173324e4bf593b3ec2bd60015e80d3f08,57,4261,5448,9709,6,0,6,8,51,294,10,27,4.410374587,9213,41,3,2024,2216,192,69728,76095,6367,1189,1279,90,94.79262673
c6396de2d9100032e58a39e6138787a2c133257e,6,138,67,205,0,0,0,1,4,2,1,3,1.898150694,736,42,4,148,140,8,5956,5404,552,49,49,0,100
09981b81a46ad43379b7f9fc9d8463c8954094ff,57,5443,4387,9830,14,0,14,9,64,628,10,27,4.446480805,8471,38,0,2201,2050,151,75792,70680,5112,1264,1207,57,94.79262673
7047f10b7c31fdb70b7088de0f0c02ef4e5d2d39,15,1161,17,1178,10,0,10,1,29,0,4,9,2.456103121,1777,44,6,550,402,148,21203,15224,5979,176,127,49,97.66055046
ccdddfe067274bfa3612d9e866c2f86c2a6c87a7,1,91,38,129,0,0,0,9,27,1149,1,1,0,649,45,7,143,140,3,5038,4620,418,27,27,0,100
6e552cf090053ecbb1ab4251528754373d0dd511,1,2,2,4,0,0,0,9,28,0,1,1,0,702,46,8,143,143,0,5038,5038,0,27,27,0,100
c57a14611951a6587f8eaba95b5b6b378997385a,1,45,8,53,0,0,0,9,29,5,1,1,0,702,47,9,147,143,4,5190,5038,152,27,27,0,100
c64f4a533a44a7a947f14e225c8ddeffe3962095,0,0,0,0,0,0,0,0,0,0,0,0,0,0,48,10,0,0,0,0,0,0,0,0,0,100
405bbf6bc240b726f6088a9782a2dda9a6c1c8f6,73,4007,6807,10814,5,0,5,8,50,222,12,36,4.765248244,11541,30,0,2163,2602,439,77792,92722,14930,1246,1401,155,92.97597043
b4b0228125aa129ca84efeea63b9c7dac9b61cb3,67,6825,3378,10203,25,0,25,9,64,698,12,33,4.588089763,8997,51,12,2585,2111,474,91505,73305,18200,1396,1223,173,94.23076923
0be0dc4618498c33e1f1c6105e45276c4c9143e4,16,156,761,917,0,0,0,0,27,448,5,9,3.256849619,2691,21,0,565,600,35,20699,23978,3279,305,323,18,97.32858415
9b4f29d41a71f58e2a0a31d03f1bb8117a9e8d60,9,114,160,274,0,0,0,2,26,507,5,5,2.513397409,2280,21,0,542,542,0,19947,19947,0,302,302,0,100
e325402aaa84d4f1501eb00c2c3f5c15e32713ca,9,160,114,274,0,0,0,3,27,714,5,5,2.513397409,2276,49,11,542,542,0,19947,19947,0,302,302,0,100
c7cae4dd788129153c1ab569883bdc4212b3c9db,1,1,5,6,0,0,0,5,7,919,1,1,0,245,50,12,39,39,0,1698,1698,0,21,21,0,100
81165ab04101234eb32407eba92a579429811ca8,30,469,285,754,0,0,0,9,65,825,15,21,4.05405973,11873,0,0,2633,2594,39,95114,93848,1266,906,883,23,100
0fc75e9ae42939a58e6864c81d868e8db1a2092b,10,284,156,440,0,0,0,10,31,493,6,6,2.521254154,2953,1,1,693,686,7,25297,24727,570,331,331,0,100
2325c61a9280d310818f99dea19853718c613557,44,979,471,1450,8,0,8,1,64,427,17,31,4.506497459,13565,52,10,2942,2931,11,109176,106699,2477,1025,1011,14,98.35841313
c4e29f3e7d2823406a8d675c376935bbf03396d4,9,156,118,274,0,0,0,3,27,790,5,5,2.513397409,2280,55,13,542,542,0,19947,19947,0,302,302,0,100
e6e6c2d91e0e8b6549b5eda8973e5f3c150a7774,1,5,0,5,0,0,0,4,5,3951,1,1,0,38,56,14,5,4,1,319,293,26,5,4,1,100
62ac8bb632def81e4822a8f340021a03ed4c0351,1,3,1,4,0,0,0,1,2,1,1,1,0,78,57,14,13,13,0,548,548,0,12,12,0,100
8bb377b272666c2e9d071293f5416c95ffae0a01,0,0,0,0,0,0,0,0,0,0,0,0,0,0,58,15,0,0,0,0,0,0,0,0,0,100
ab40eadf2da890903f4c5d74d0cb6f5459a5f995,1,1,1,2,0,0,0,9,27,6,1,1,0,174,59,15,45,45,0,1256,1262,6,19,19,0,100
78d971063ea902f7d097cb5301351652c92fe5ab,2,63,38,101,0,0,0,2,26,33,2,2,0.140327271,219,0,0,78,53,25,2059,1612,447,23,22,1,100
b04910db450eae9302c7b8536b805a25dcfb4c35,1,50,50,100,0,0,0,2,4,0,1,1,0,68,1,1,33,33,0,797,797,0,4,4,0,100
3e1735638eb179a2246a8208b744f0e3bfaabc24,3,432,35,467,1,0,1,2,4,36,1,2,1.028178297,609,2,2,158,113,45,6331,4645,1686,65,30,35,99.81933153
21283f6d7fbf64a87f98c9dea49d1fac87bd88f1,3,16,20,36,0,0,0,2,5,3,1,3,1.49553803,716,3,3,153,154,1,5746,5837,91,36,37,1,100
9aacf0f5ad895c7d5995b6b25635da9fd8488199,26,364,470,834,0,0,0,10,65,691,13,20,3.373221209,10246,2,2,2156,2179,23,78879,79079,200,634,646,12,99.81933153
b49a2d8c41db306b4a1aadccb04ba023668ee7a6,26,471,364,835,1,0,1,9,64,168,13,21,3.374097448,10264,4,4,2179,2156,23,79092,78879,213,646,634,12,99.81933153
eef7aecbe899eb772e48afd4e576449cb7d12c63,1,107,161,268,0,0,0,1,2,0,1,1,0,179,5,5,37,37,0,1428,1291,137,32,32,0,100
7b80edbfe28a488e1bbbe69741ff9f8432a676b8,6,56,419,475,0,0,0,1,65,41,3,5,1.607195368,1649,0,0,289,358,69,10801,12985,2184,76,111,35,99.81933153
181ee2d0217d4d192a7a1aa55f4e8906b036905d,27,333,9,342,0,0,0,10,66,172,14,20,4.503892885,10970,3,3,2366,2317,49,85694,83810,1884,714,688,26,100
75997da16d1bcbb94277b8c75fe831390bd03347,27,5,331,336,0,0,0,9,64,257,14,21,4.479278734,11330,60,6,2352,2401,49,84603,86495,1892,701,727,26,100
deb08b02f506ca12aaabe4472dc2fc27ce50863b,2,5,3,8,0,0,0,3,65,122,1,1,0.811278124,771,61,7,168,168,0,5800,5798,2,43,43,0,100
ff18fd397130aa18866ff130c903b77887c98b25,6,108,81,189,0,0,0,15,65,1272,2,4,1.600617705,1325,59,5,265,256,9,10310,10247,63,98,98,0,100
a2e0ee784252f05982493396fcc48ee2fd2e05bf,9,205,200,405,0,0,0,4,65,1217,3,7,1.855016047,1579,1,1,261,268,7,12679,12491,188,101,99,2,100
cb35901994d9b7d7b2bd3576409890cd17f84131,2,110,116,226,0,0,0,3,11,0,1,2,0.128319129,234,2,2,23,22,1,1953,1964,11,11,11,0,100
63542b00e3d08aa72efd21351b78a6c851c8baab,11,275,176,451,0,0,0,3,66,1917,3,9,2.312098425,1809,60,0,358,340,18,15564,15099,465,106,107,1,100
ba17009dd46e6c5f061eb58a68e7114e59a8e645,2,0,3,3,0,0,0,5,67,0,1,2,0.918295834,809,61,1,172,172,0,6245,6267,22,38,38,0,100
2d65ca654642def73497ba8fbc4c48d59e766fe9,3,6,4,10,0,0,0,3,69,43,2,2,1.370950594,985,65,2,221,221,0,7308,7312,4,61,61,0,100
d84d6998fa0b42e043a490d82d1df0578cb1446c,1,3,3,6,0,0,0,19,70,0,1,1,0,730,66,3,166,166,0,5616,5589,27,36,36,0,100
550462e71c6f41b92d2bd6eade0e4957b079e842,2,9,4,13,0,0,0,8,71,0,1,1,0.995727452,899,67,4,199,199,0,6769,6733,36,55,55,0,100
21eb666b162d492a9c03de6ff8289be5e442ec69,0,0,0,0,0,0,0,0,0,0,0,0,0,0,68,5,0,0,0,0,0,0,0,0,0,100
9b85f5a29fb11d54a690e2bce49da11679dcb3b2,4,416,51,467,1,0,1,2,6,2,2,4,1.495395047,654,69,6,190,121,69,7187,5001,2186,68,33,35,99.81933153
b3b1abb2ac3f62ceb720cd182a6cbefc048203c0,4,67,41,108,0,0,0,4,13,31,2,4,0.397596901,403,70,7,51,48,3,3677,3443,234,22,20,2,100
c6f3f0996b8031d4ca1f6e2e327730c796239b13,2,8,2,10,0,0,0,4,8,923,2,2,0.468995594,111,71,8,16,14,2,937,896,41,11,11,0,100
04d80101937123af1e9828bcc5433cbe2ba3773f,0,0,0,0,0,0,0,0,0,0,0,0,0,0,72,9,0,0,0,0,0,0,0,0,0,100
a56c6f10b01e96beb07af7dc2ef7b9fb9fea924b,0,0,0,0,0,0,0,0,0,0,0,0,0,0,73,10,0,0,0,0,0,0,0,0,0,100
ae505d68be6f4c126d1bbb72a40ddb3a2b8dcf6a,6,8,12,20,0,0,0,15,32,3339,2,4,2.321928095,668,73,10,68,69,1,5641,5647,6,51,52,1,100
81e8f511fc89546b156467eff0a6344731557f39,0,0,0,0,0,0,0,0,0,0,0,0,0,0,74,11,0,0,0,0,0,0,0,0,0,100
b848deb7f89822cf59a171e21dfa3161f92f6e07,0,0,0,0,0,0,0,0,0,0,0,0,0,0,76,13,0,0,0,0,0,0,0,0,0,100
d34d32bb3097ef7251884a31a748c23ecbd7b5c9,2,42,589,631,0,0,0,3,16,1340,2,2,0.842893654,702,77,14,70,135,65,2740,5488,2748,17,34,17,99.90958409
238d1c0566452aa58e577eb02a16d313b86c20f6,1,1,1,2,0,0,0,3,17,0,1,1,0,364,78,15,70,70,0,2746,2740,6,17,17,0,100
189ce6b6cb3df7c205dfc98a4922337a3b73f117,0,0,0,0,0,0,0,0,0,0,0,0,0,0,79,16,0,0,0,0,0,0,0,0,0,100
5de8b6b7ebcace007b9c5bb86a7d568fcb411825,26,330,4,334,0,0,0,10,74,118,14,20,4.453222258,10860,80,17,2353,2304,49,84913,83027,1886,707,681,26,100
8faaa4a902c9c9981f9e5b2219e0a437813d7849,3,21,44,65,0,0,0,4,7,78,1,1,1.584619242,802,81,18,161,164,3,6182,6354,172,29,30,1,100
40fec32db4e130d8ff1ef6ce1ef04a6afb8087ea,0,0,0,0,0,0,0,0,0,0,0,0,0,0,82,19,0,0,0,0,0,0,0,0,0,100
7e81becafac5deddbded0ea4f96cb323eebfdfb5,0,0,0,0,0,0,0,0,0,0,0,0,0,0,83,20,0,0,0,0,0,0,0,0,0,100
ea28767bf9afda6d08807a9ccfa794bd6bd2c6a0,0,0,0,0,0,0,0,0,0,0,0,0,0,0,84,21,0,0,0,0,0,0,0,0,0,100
5f21e1e7da64e45f315250585782c2f67f5f0d1a,0,0,0,0,0,0,0,0,0,0,0,0,0,0,85,22,0,0,0,0,0,0,0,0,0,100
57448088300149d40048b14c166de7ab9419f802,0,0,0,0,0,0,0,0,0,0,0,0,0,0,86,23,0,0,0,0,0,0,0,0,0,100
33b46e0dc1c6b3193cf53bd46ebcf58a49f5db5a,0,0,0,0,0,0,0,0,0,0,0,0,0,0,87,24,0,0,0,0,0,0,0,0,0,100
15a8426724be09f893f138a862646163e213a26e,0,0,0,0,0,0,0,0,0,0,0,0,0,0,88,25,0,0,0,0,0,0,0,0,0,100
e517117580eaa96df030a13b9cd943786c5b3187,32,605,357,962,1,0,1,2,71,279,15,25,2.99093674,11371,3,0,2340,2320,20,88097,87063,1034,740,747,7,99.90958409
3e650149ea721b201e0ddc9bd77fbff9ae2c7084,0,0,0,0,0,0,0,0,0,0,0,0,0,0,3,0,0,0,0,0,0,0,0,0,0,100
a5bdf81383dc41364175696bcddadefcee8f585c,0,0,0,0,0,0,0,0,0,0,0,0,0,0,4,1,0,0,0,0,0,0,0,0,0,100
afd66e408abf49cd484a902ee76f2eef97423730,0,0,0,0,0,0,0,0,0,0,0,0,0,0,6,3,0,0,0,0,0,0,0,0,0,100
f468a6706642b78665698c8b7e456e13eeaf0968,0,0,0,0,0,0,0,0,0,0,0,0,0,0,5,2,0,0,0,0,0,0,0,0,0,100
a04e09b1f9c129b2ef4da4fbb38a0084579590a8,0,0,0,0,0,0,0,0,0,0,0,0,0,0,8,5,0,0,0,0,0,0,0,0,0,100
56a8be0620d48d7e54d999f6018ff0ef82d0d5cb,32,357,605,962,0,0,0,3,74,767,15,25,2.99093674,11465,6,0,2320,2340,20,87063,88097,1034,747,740,7,99.90958409
943d86632fb2d4627b2f4f123ecefb1c9abc7be7,1,15,11,26,0,0,0,5,6,2179,1,1,0,90,0,0,16,16,0,618,617,1,2,2,0,100
47325ef4307e4fd5c34e707495e2f4689691c557,1,15,13,28,0,0,0,5,7,4,1,1,0,94,1,1,16,16,0,696,618,78,2,2,0,100
bbba90f16fef3d10f5440f9dee8b3c2fba57cba6,14,1238,1214,2452,0,0,0,10,16,1028,5,5,3.266926178,4023,7,1,1055,1055,0,36722,36801,79,798,798,0,100
8b9eeac0608b27bd337b9e4cafe3599c05fa58b9,50,4468,1584,6052,6,0,6,9,71,368,17,32,3.96181369,15298,3,0,3768,3359,409,136032,123168,12864,1818,1543,275,98.60748477
0835d5b41c26c96457eb9094019552cd3f6e21e6,2,13,9,22,0,0,0,1,2,8,1,2,0.773226674,215,4,1,34,32,2,1790,1776,14,16,16,0,99.83249581
d7ed667d156cd8d6bc9e6e9dc3c3d20219d636b4,2,39,61,100,0,0,0,1,3,20,1,1,0.778011304,160,5,2,25,26,1,1116,1340,224,9,10,1,100
dd1054211bc884e2ad9985de82f2d1b4054c3822,4,16183,31,16214,0,0,0,1,4,42,1,3,0.204595601,868,6,1,2906,213,2693,76907,6714,70193,2059,149,1910,99.00562041
80323c1b85c19190a0f634a8e9c524f70ab04613,1,2,14942,14944,0,0,0,1,3,19,1,1,0,9566,7,1,317,2837,2520,8497,73116,64619,232,2032,1800,100
32fd4208785b396b6067239afad0f389167606bb,1,0,1,1,0,0,0,1,5,20,1,1,0,147,8,2,24,24,0,1091,1091,0,8,8,0,100
21075471efdea9a2082151a691772b815d521f9e,4,57,844,901,0,0,0,1,6,30,1,3,0.445738552,1605,9,3,252,386,134,8965,12288,3323,159,259,100,100
1be58412bc5a221f14bc92f05fac70d1f0582f4e,37,357,3677,4034,0,0,0,3,74,649,16,28,2.995126277,13269,0,0,2320,2769,449,87063,101968,14905,747,1031,284,99.41520468
05bf5e43e4b12a786fbc45488931b7b8c908d72c,1,15,11,26,0,0,0,5,6,2343,1,1,0,90,0,0,16,16,0,618,617,1,2,2,0,100
95c607c3dd493b6cdd5958ee12287379e4c53e01,1,15,13,28,0,0,0,5,7,0,1,1,0,94,1,1,16,16,0,696,618,78,2,2,0,100
d90d2dfa4c2b377dfa53948dfd7841df6cba43dd,38,3688,374,4062,6,0,6,2,71,234,17,29,3.033887904,11467,10,0,2785,2336,449,102585,87759,14826,1033,749,284,99.41520468
56024e54065bfaf3aca0ea39d56938544719b816,4,993,42,1035,0,0,0,1,7,84,1,3,0.97697442,1168,11,0,392,252,140,12573,8965,3608,259,159,100,100
7327efe302db791b5800cd7d39eb9573e6c4c1cc,38,374,4639,5013,0,0,0,3,74,633,17,29,2.815475239,13830,3,0,2336,2925,589,87759,106193,18434,749,1133,384,99.41520468
9503d68c8c5f33f929ce9db04dfe7a73a0986e98,37,2635,374,3009,5,0,5,2,71,236,17,29,3.03926328,11467,12,1,2608,2336,272,98028,87759,10269,901,749,152,99.5047276
7cda23f62558cfaa2192c07df16a98fadc0bcc9e,0,0,0,0,0,0,0,0,0,0,0,0,0,0,13,2,0,0,0,0,0,0,0,0,0,100
506331f1d20e83a667fc562a3d177a831e66e47a,37,374,2635,3009,0,0,0,3,74,649,17,29,3.03926328,12727,89,0,2336,2608,272,87759,98028,10269,749,901,152,99.5047276
d177a938def592312238440be78aca23b1608aff,0,0,0,0,0,0,0,0,0,0,0,0,0,0,90,1,0,0,0,0,0,0,0,0,0,100
d92d298186b1cc11de4a89b6752677421223b8c8,0,0,0,0,0,0,0,0,0,0,0,0,0,0,91,2,0,0,0,0,0,0,0,0,0,100
30645c08b15553df3955f492631421e6a7bf5474,0,0,0,0,0,0,0,0,0,0,0,0,0,0,92,3,0,0,0,0,0,0,0,0,0,100
3ee5663944fcf2fe59186a38b9cc195b3fb33fac,0,0,0,0,0,0,0,0,0,0,0,0,0,0,93,4,0,0,0,0,0,0,0,0,0,100
cf8e66b9a580cbf79542586b4cd56012cdd5570f,0,0,0,0,0,0,0,0,0,0,0,0,0,0,94,5,0,0,0,0,0,0,0,0,0,100
5973677818221a5d8c25b7d9131dc6ca8b04fb88,0,0,0,0,0,0,0,0,0,0,0,0,0,0,95,6,0,0,0,0,0,0,0,0,0,100
bee2240a02b985131f15ad0d887d04c0c72232a4,0,0,0,0,0,0,0,0,0,0,0,0,0,0,96,7,0,0,0,0,0,0,0,0,0,100
d0c1897d27b52d9dcef46b248df7d012d2a34d1c,0,0,0,0,0,0,0,0,0,0,0,0,0,0,97,8,0,0,0,0,0,0,0,0,0,100
e4456a3e1221b915d5f6efd7bc943a2c52467fd9,37,2635,374,3009,5,0,5,2,71,236,17,29,3.03926328,11467,14,3,2608,2336,272,98028,87759,10269,901,749,152,99.5047276
be3b2eb753e7d3c09abdf6ef094c99e0901e8ba8,0,0,0,0,0,0,0,0,0,0,0,0,0,0,21,4,0,0,0,0,0,0,0,0,0,100
4068345c8d5b2846c57ecf34d1d1c9c2e0e4a908,0,0,0,0,0,0,0,0,0,0,0,0,0,0,22,5,0,0,0,0,0,0,0,0,0,100
2ca15b327a6f3d3fc64c36b969686c618fdb1ddf,0,0,0,0,0,0,0,0,0,0,0,0,0,0,23,6,0,0,0,0,0,0,0,0,0,100
689b13c83e3c4528c35286b5f8b7b263bf263775,33,374,616,990,0,0,0,3,74,744,16,26,3.092050432,11555,24,7,2336,2356,20,87759,88714,955,749,742,7,99.9103139
37e6c12ff72adc28e6305860dd8abfb52110a70c,3,45,32,77,0,0,0,1,9,6,1,2,1.428261906,536,25,8,75,75,0,4326,4119,207,27,27,0,100
c29f752d8cb4b9d1123911424e4f9036655ff91c,1,1,6,7,0,0,0,1,8,0,1,1,0,292,26,9,37,37,0,2313,2313,0,8,8,0,100
60bcac3e346eee8ee1c7a7119c1b29f931603a55,4,0,2027,2027,0,0,0,0,0,0,1,3,1.655884792,1185,98,9,0,252,252,0,9521,9521,0,159,159,99.59404601
d9b4b8eb73c84806971a7375fe35c038a0a10197,0,0,0,0,0,0,0,0,0,0,0,0,0,0,99,10,0,0,0,0,0,0,0,0,0,100
9975533547c7d2c15f454faf21d28f2a0a24dd58,0,0,0,0,0,0,0,0,0,0,0,0,0,0,497,0,0,0,0,0,0,0,0,0,0,100
d9eefd867bf8fff86bd7ff4c9b147353991137ca,0,0,0,0,0,0,0,0,0,0,0,0,0,0,100,11,0,0,0,0,0,0,0,0,0,100
482be554aac116e7c984b019df6ccca74e21629c,0,0,0,0,0,0,0,0,0,0,0,0,0,0,101,12,0,0,0,0,0,0,0,0,0,100
bd4b34ae74725d57b31ab5e83da3ea77f6213643,0,0,0,0,0,0,0,0,0,0,0,0,0,0,102,13,0,0,0,0,0,0,0,0,0,100
66172a080479c9e29ffab442492c3ca60fd8c4b1,0,0,0,0,0,0,0,0,0,0,0,0,0,0,103,14,0,0,0,0,0,0,0,0,0,100
9b1d297fc11f90850d0360c93b3bd65486a20834,13,1227,1197,2424,0,0,0,10,16,1111,4,4,3.21356113,3927,498,1,1039,1039,0,36105,36105,0,796,796,0,100
877d1188b4945ce69dd9175b6e3d681f5043dddd,15,196,114,310,0,0,0,11,26,260,4,5,3.06888357,5218,4,0,1266,1253,13,47087,46396,691,926,917,9,100
c3ef51dd23d439a941591b1cf3a0682e3c32ffd3,0,0,0,0,0,0,0,0,0,0,0,0,0,0,5,1,0,0,0,0,0,0,0,0,0,100
6167f732183246881747ab0d64bd38f6c36691af,1,23,0,23,0,0,0,10,18,0,1,1,0,437,6,2,121,118,3,3757,3693,64,92,89,3,100
cb9bf826a67ee243657080885fb15e7dad9a5fe6,15,114,219,333,0,0,0,10,25,971,4,5,2.955668992,5284,104,15,1253,1269,16,46396,47151,755,917,929,12,100
db33a88ad702964e652c8bac1f634c1b22a9ea0b,21,4257,1227,5484,8,0,8,9,15,484,5,7,3.366280473,3927,27,9,1442,1039,403,50352,36105,14247,1060,796,264,99.23595506
be695283b4e930d4d68e6d8881bdb4958f9cc794,2,20,2,22,0,0,0,1,8,0,1,2,0.574635698,213,28,10,21,21,0,1756,1756,0,14,14,0,100
2c642c1ce0e895881a3bd58f5669a12e87c1faa3,0,0,0,0,0,0,0,0,0,0,0,0,0,0,29,11,0,0,0,0,0,0,0,0,0,100
b4a57366b22260b6281074a1b75497d921edf9a6,1,486,486,972,0,0,0,1,3,2,1,1,0,1106,30,12,317,317,0,8945,8945,0,232,232,0,100
85f9889c555261c8bc8854e78335499aae9665d5,0,0,0,0,0,0,0,0,0,0,0,0,0,0,31,13,0,0,0,0,0,0,0,0,0,100
671ab051d8bc1c0c909c64381282546e55a1b2bd,23,1446,4389,5835,0,0,0,11,26,154,5,8,3.445227215,7011,499,2,1269,1656,387,47151,60643,13492,929,1181,252,99.23595506
284a95fbf9cadf0e850cbf9e5b010d032a27cd3b,23,4677,1446,6123,8,0,8,9,25,445,5,8,3.366940433,5284,32,14,1657,1269,388,60803,47151,13652,1182,929,253,99.23595506
3f48dce18047cd404567898399eadc8ebae74c85,2,31,44,75,0,0,0,1,12,4,1,1,0.962614706,423,33,15,65,65,0,3519,3519,0,18,18,0,100
fa57c91e694db6c6420b301c89e842646011144e,3,864,1095,1959,0,0,0,1,10,6,1,3,0.198823699,1373,34,14,344,339,5,11107,10859,248,249,247,2,99.56101844
7a25ec31a5d5d4931590507c37a7a82d26eafbb7,3,7,8,15,0,0,0,1,13,2,1,2,1.158938532,409,35,15,52,52,0,3380,3380,0,26,26,0,100
568057c4587cfe9d1bde56edca2f922e3bb1a220,0,0,0,0,0,0,0,0,0,0,0,0,0,0,36,16,0,0,0,0,0,0,0,0,0,100
c506202378e65627771d01066a5999d5cd5ef20f,0,0,0,0,0,0,0,0,0,0,0,0,0,0,37,17,0,0,0,0,0,0,0,0,0,100
048a7dd4a5be1630ca771c6d735b13f2e6276657,0,0,0,0,0,0,0,0,0,0,0,0,0,0,38,18,0,0,0,0,0,0,0,0,0,100
79e821503d113c24f8903feff224f127528b2d58,1,26,55,81,0,0,0,1,14,2,1,1,0,153,39,12,24,25,1,1200,1226,26,8,9,1,99.56101844
92817643aa5ba2f09337c87d647b5e2a4a25f890,0,0,0,0,0,0,0,0,0,0,0,0,0,0,40,13,0,0,0,0,0,0,0,0,0,100
504833f99f9bffd3b92bd46a48daebdabf1ccd57,42,3816,4408,8224,19,0,19,11,27,69,6,15,4.345426273,7049,1,0,1576,1661,85,57343,61025,3682,1042,1183,141,97.53954306
2f97b50c06cd040155a688cccf6990961f2170cf,0,0,0,0,0,0,0,0,0,0,0,0,0,0,2,1,0,0,0,0,0,0,0,0,0,100
2abf21fff3ef9fded04fb03f5b0cf8e0b4e7770e,6,120,0,120,6,0,6,1,1,0,1,6,2.584962501,0,7,0,0,0,0,62,0,62,0,0,0,99.48320413
e6e2b5a3bbcccbac99476eb01e73f84d4336cfd2,10,1116,0,1116,10,0,10,1,1,0,1,5,2.919276189,0,8,1,131,0,131,3695,0,3695,102,0,102,92.08523592
01128fd204d6efa58cd9a205fd123eb19a846ba9,3,25,16,41,0,0,0,1,2,0,1,3,1.351730886,302,9,2,47,45,2,1970,1907,63,23,23,0,100
4410a61e5d2724c200fc3ed8615a73f4322e7123,4,121,21,142,0,0,0,1,3,0,1,2,1.736756931,396,10,3,82,62,20,3081,2253,828,44,38,6,99.96577687
1a5a6666a4ba6c3cf4cc8d34a738dbd2cf4bb8ae,7,205,47,252,0,0,0,1,4,0,1,4,2.425824491,881,11,4,165,150,15,4947,4446,501,106,105,1,100
401dd68d019e9705f61d782115d0b6abeb842720,3,477,74,551,1,0,1,1,5,0,1,3,1.156377972,536,12,5,209,100,109,5444,2872,2572,71,62,9,99.93160055
9c504f7871e22505e0714076943a597d54abb4da,5,264,108,372,2,0,2,1,6,0,1,4,2.252678593,919,13,6,241,209,32,6761,5444,1317,65,71,6,99.86348123
09c94b74e4d39bd8b84f84d9de1abaca467e2d63,6,84,93,177,0,0,0,1,7,0,1,4,2.207073536,1173,14,7,260,262,2,7315,7259,56,73,79,6,100
52348aa832795e439a12af6666b4794013400d7a,2,63,101,164,0,0,0,1,8,0,1,2,0.972359464,680,15,8,147,150,3,4765,4530,235,28,43,15,100
b91e2500df38dccfa84d9d32c5474040634d8ea2,3,80,2,82,1,0,1,1,4,0,1,3,0.390509918,69,16,9,9,3,6,551,222,329,8,3,5,99.93188011
9dfda84821cb393382dc45f52ee96d03c82cca91,3,11,13,24,0,0,0,1,9,0,1,2,1.56320209,803,17,10,172,172,0,5866,5866,0,39,39,0,100
dcc39d96b058482571c47dab21315d046e96c838,5,53,26,79,0,0,0,1,10,0,1,3,1.726520875,1073,18,11,244,241,3,7688,7605,83,48,44,4,100
1f9bc1faf87889106cb68b1bdcacd9acde69cea9,2,9,9,18,0,0,0,1,11,0,1,2,0.503258335,680,19,12,154,154,0,5052,5053,1,29,29,0,100
9387c5c4a997cda4a5cc2886cc60a3e81db5f36c,0,0,0,0,0,0,0,0,0,0,0,0,0,0,20,13,0,0,0,0,0,0,0,0,0,100
d2d920a6d27dda881579ef611c7be937914d5595,7,79,123,202,0,0,0,1,12,0,1,5,2.459115318,1106,21,14,214,222,8,7192,7367,175,67,73,6,100
367f05990c426b83b9e3b0dbeb44a1e84c136462,2,8,3,11,0,0,0,1,8,0,1,2,0.684038436,194,22,15,24,23,1,1309,1292,17,8,8,0,100
3a97a90033d45d920ac6b1e935e424fb61a7402c,20,0,2079,2079,0,0,0,0,0,0,1,8,3.445386751,1641,3,2,0,306,306,0,9582,9582,0,94,94,91.31097561
fab0ab56ece8206d470dc0ed73906ded61368ec6,20,2075,0,2075,20,0,20,1,12,0,1,8,3.44267801,0,23,16,305,0,305,9567,0,9567,94,0,94,91.31097561
8db7a1089d7679645df5ab4b83567cc73acde694,0,0,0,0,0,0,0,0,0,0,0,0,0,0,24,0,0,0,0,0,0,0,0,0,0,100
d34e163fa12ac59b1eeb4bc8141084f8b30dcf0b,0,0,0,0,0,0,0,0,0,0,0,0,0,0,500,0,0,0,0,0,0,0,0,0,0,100
60356a8fa725122acaab95447aa957132153dab1,8,3092,0,3092,8,0,8,1,14,1,1,3,1.740130768,0,0,0,408,0,408,14629,0,14629,266,0,266,99.28861789
e02feb1b5e0d3af8e3a0041b76613801c0a97412,54,1316,5891,7207,0,0,0,9,25,182,6,20,4.979335368,8613,41,2,1253,1881,628,46396,66910,20514,917,1136,219,89.74654378
ea43a63c6ef0fe94f7e5b612081e3e689eeb8795,54,5891,1316,7207,39,0,39,11,27,55,6,20,4.979335368,5218,42,3,1881,1253,628,66910,46396,20514,1136,917,219,89.74654378
2bc911d2c8afad9d60bf0118317043111c4993c7,8,0,3092,3092,0,0,0,0,0,0,1,3,1.740130768,1831,4,3,0,408,408,0,14629,14629,0,266,266,99.28861789
c837c5ac418618d45974e7dffe34e19c010934f5,0,0,0,0,0,0,0,0,0,0,0,0,0,0,5,4,0,0,0,0,0,0,0,0,0,100
45a393c0487b3c04846e0aff46522ef979736c08,8,3097,0,3097,8,0,8,1,15,21,1,3,1.743139908,0,43,2,409,0,409,14728,0,14728,267,0,267,99.28861789
a354b35c5d77c0e67d4c2d01ca0306dd5f91e3d8,0,0,0,0,0,0,0,0,0,0,0,0,0,0,501,1,0,0,0,0,0,0,0,0,0,100
4af16a83784a9cd7474d0da40216995e1b846f6f,1,2,2,4,0,0,0,10,19,144,1,1,0,304,0,0,62,62,0,1601,1601,0,56,56,0,100
356f1dbba327b49041f033c2dceeaaebe5a7afd9,4,14,15,29,0,0,0,9,18,173,2,3,1.708843158,919,44,0,153,153,0,6747,6791,44,90,90,0,100
0297cf83d62b7de23d020cfd6e2d0919d6399601,4,15,14,29,0,0,0,10,19,71,2,3,1.708843158,917,502,0,153,153,0,6791,6747,44,90,90,0,100
01aef8026e0c314e4ea86100fa0bc2c6998e3ac8,3,12,13,25,0,0,0,1,16,99,1,2,1.310856298,615,45,1,91,91,0,5146,5190,44,34,34,0,100
3a742b7db1fa81ddd3e6c9a00e4dec8b28d42c8f,0,0,0,0,0,0,0,0,0,0,0,0,0,0,45,1,0,0,0,0,0,0,0,0,0,100
a3c734fb7c114703ce6905e756190799889d7d8f,0,0,0,0,0,0,0,0,0,0,0,0,0,0,47,3,0,0,0,0,0,0,0,0,0,100
f2bab9cebfe8514b9e67004f0b3c84158bf2b7cb,27,1996,12,2008,24,0,24,1,15,3,2,10,3.751248496,613,105,0,318,91,227,13944,5146,8798,103,34,69,98.27700464
784cf67bc760e7f0cc591ebe7c91e191f5d35222,27,12,1996,2008,0,0,0,0,16,9,2,10,3.751248496,1817,48,4,91,318,227,5146,13944,8798,34,103,69,98.27700464
8de999397c487116606539557ca03f4e75043386,24,1983,0,1983,24,0,24,1,1,0,1,8,3.684166149,0,49,5,227,0,227,8754,0,8754,69,0,69,98.27700464
00abd59c982c76157ac5863b4edc3732f7a49e0e,0,0,0,0,0,0,0,0,0,0,0,0,0,0,0,0,0,0,0,0,0,0,0,0,0,100
6b7e9a7b6c9b6a6c1982da45b160783970a45285,0,0,0,0,0,0,0,0,0,0,0,0,0,0,0,0,0,0,0,0,0,0,0,0,0,100
736d457cd9ba1243858477c7218585858c70060c,0,0,0,0,0,0,0,0,0,0,0,0,0,0,0,0,0,0,0,0,0,0,0,0,0,100
783580ca6f91e12bafeb227c00290ef5e149ecca,0,0,0,0,0,0,0,0,0,0,0,0,0,0,0,0,0,0,0,0,0,0,0,0,0,100
e08524c5d5aaac9fd3e4ed42739c03e398d6fa8b,1,13,15,28,0,0,0,21,75,946,1,1,0,748,4,0,168,169,1,5671,5706,35,37,37,0,100
18d95f9b59c7a74be741f400ff97fc2d83b396bc,1,6,3,9,0,0,0,6,15,1025,1,1,0,360,5,1,79,79,0,2424,2396,28,46,46,0,100
3f4d474c98c4c4fde94b915d54a60f126448def3,1,0,3,3,0,0,0,21,76,0,1,1,0,746,6,2,168,168,0,5644,5671,27,37,37,0,100
51ff495ca1c0dade1ae988940d211f9d0301ecf9,0,0,0,0,0,0,0,0,0,0,0,0,0,0,0,0,0,0,0,0,0,0,0,0,0,100
4adf88ca644c7ebc8b1ec95750fe22d4e79bf6c3,0,0,0,0,0,0,0,0,0,0,0,0,0,0,1,1,0,0,0,0,0,0,0,0,0,100
798f40208116e1c41222a2f7430d9b10096b4ec2,0,0,0,0,0,0,0,0,0,0,0,0,0,0,23,0,0,0,0,0,0,0,0,0,0,100
220bb3a4d1028db32aa499153c6431612615cc65,0,0,0,0,0,0,0,0,0,0,0,0,0,0,2,2,0,0,0,0,0,0,0,0,0,100
4ff0eb7f9e5732c895fd5d1bbfd20a4e34436932,0,0,0,0,0,0,0,0,0,0,0,0,0,0,24,1,0,0,0,0,0,0,0,0,0,100
56e62525164f3090124c4dad98d6496bfcf66253,1,14,16,30,0,0,0,3,5,4796,1,1,0,110,25,2,10,10,0,992,869,123,10,10,0,100
3ed6327e447a5c1606d263a161ddc48476614dc6,0,0,0,0,0,0,0,0,0,0,0,0,0,0,3,3,0,0,0,0,0,0,0,0,0,100
0b241ad057de385691a2b5fb8d6eb9efe55e72ea,4,6,68,74,0,0,0,1,3,2294,1,1,1.639457132,32,68,0,0,0,0,116,232,116,0,0,0,99.2578251
392b264fdb0da86556a632be5a12d41da3512f49,8,1908,0,1908,8,0,8,1,1,0,2,4,2.257682631,0,1,1,231,0,231,9141,0,9141,177,0,177,99.42784488
cc6255585dfffd51e3003c46f07b96b7082aa79f,13,395,443,838,1,0,1,2,40,3018,1,7,2.972687488,1562,69,1,284,295,11,11858,11936,78,118,119,1,99.87357775
e24756f6441bf00c25d245e3ef37798ca9acacce,11,187,248,435,2,0,2,1,14,2203,2,5,2.57185898,515,70,2,51,61,10,3016,3959,943,35,36,1,99.3624482
bdf5f0096d2447ad1a93b1119cebf4297133850c,1,2,2,4,0,0,0,2,6,0,1,1,0,110,71,3,32,32,0,816,816,0,17,17,0,100
d65aa1f3333467cb5a79029f585d76cf25797f94,2,2,15,17,0,0,0,3,11,0,1,2,0.787126586,155,72,4,14,16,2,1231,1286,55,14,15,1,100
c5515ca5f5e0d53e79db03898e52098cecf2276e,0,0,0,0,0,0,0,0,0,0,0,0,0,0,0,0,0,0,0,0,0,0,0,0,0,100
927ccdbd66d0dde483e7bac32ec00d1c702b4fa0,0,0,0,0,0,0,0,0,0,0,0,0,0,0,4,0,0,0,0,0,0,0,0,0,0,100
7daea67642f982f5fc4762e0eb2c812714d5be7f,0,0,0,0,0,0,0,0,0,0,0,0,0,0,0,0,0,0,0,0,0,0,0,0,0,100
9376adf1617e91a5629807423939eb8ceda1bc27,0,0,0,0,0,0,0,0,0,0,0,0,0,0,0,0,0,0,0,0,0,0,0,0,0,100
588cdc45f91951261ffbaf386590cffe5aeae9df,0,0,0,0,0,0,0,0,0,0,0,0,0,0,5,1,0,0,0,0,0,0,0,0,0,100
e7b629818c390efaab8758374f03ec48c898329f,0,0,0,0,0,0,0,0,0,0,0,0,0,0,2,2,0,0,0,0,0,0,0,0,0,100
77aaf1b5935d429aac92d66c3328eb8618d1c4e3,0,0,0,0,0,0,0,0,0,0,0,0,0,0,0,0,0,0,0,0,0,0,0,0,0,100
3ba38f003dcee475b33536ae684df04a36405d21,0,0,0,0,0,0,0,0,0,0,0,0,0,0,0,0,0,0,0,0,0,0,0,0,0,100
28168c3a14f241b4b052cd2f51a5e8c041f4a9a5,0,0,0,0,0,0,0,0,0,0,0,0,0,0,6,0,0,0,0,0,0,0,0,0,0,100
75d85e268fcdb868697de10e16366a06e5c66236,0,0,0,0,0,0,0,0,0,0,0,0,0,0,1,0,0,0,0,0,0,0,0,0,0,100
f202e4d236e048e0f960e5d00bb7aba9596bc2ba,0,0,0,0,0,0,0,0,0,0,0,0,0,0,7,1,0,0,0,0,0,0,0,0,0,100
5dd382a1340aea246f50452170377d9c5d808b86,2,68,4,72,1,0,1,4,4,1296,1,2,0.650022422,88,2,1,11,9,2,884,661,223,10,9,1,99.93573265
7f19ab900b78dbc5acbaa68ad8cc87716c5026c3,0,0,0,0,0,0,0,0,0,0,0,0,0,0,8,2,0,0,0,0,0,0,0,0,0,100
7bb1e5a2381695eaddb1afa994148c18568b8ba3,0,0,0,0,0,0,0,0,0,0,0,0,0,0,9,3,0,0,0,0,0,0,0,0,0,100
3d8d9b3ffbb8247daa2f1f1a82710f42884fe2a2,0,0,0,0,0,0,0,0,0,0,0,0,0,0,10,0,0,0,0,0,0,0,0,0,0,100
eb21056d9de8cfb48fc6b4881f860603c610cd51,0,0,0,0,0,0,0,0,0,0,0,0,0,0,11,1,0,0,0,0,0,0,0,0,0,100
88a1819c1bc86e65e95b1c0fd92db33273eab71a,0,0,0,0,0,0,0,0,0,0,0,0,0,0,12,2,0,0,0,0,0,0,0,0,0,100
a1efada2629bdd0fc024325c86059c5fb0176bdf,14,1475,0,1475,14,0,14,1,1,0,1,5,2.737337008,0,5,0,179,0,179,7020,0,7020,72,0,72,99.0155605
1ccae4622c4bd657f7ddde47206b593e0afffc5c,2,7,8,15,0,0,0,1,2,0,1,2,0.996791632,97,6,1,12,12,0,656,661,5,11,11,0,100
c80d232bfe57be8738da688b6307730c78eb89ca,4,155,21,176,0,0,0,1,3,160,1,3,1.768765695,687,7,0,165,135,30,6272,5039,1233,45,43,2,96.0488275
8b052303a069d63e36c11c6e0c917c17466f3d0b,24,27,1674,1701,0,0,0,7,41,1494,7,13,3.042889493,3319,0,0,365,580,215,17511,25991,8480,125,199,74,95.15919428
775171eca2ef9d64544a5dd95466055b85dcb18b,10,131,30,161,0,0,0,6,40,804,6,8,2.089413395,2158,0,0,371,365,6,17743,17511,232,125,125,0,100
ff64c7e6281efb338e9fb5fd32d4df0598a3abdd,0,0,0,0,0,0,0,0,0,0,0,0,0,0,503,0,0,0,0,0,0,0,0,0,0,100
dff7b93dc68bf9cfaeb1296135eaf3a862117384,14,1608,0,1608,14,0,14,1,3,44,1,5,2.763558147,0,13,0,209,0,209,8248,0,8248,74,0,74,95.15919428
3f90ea9a68e6f3a6803bfca5d241cd3870cf9cd7,1,26,12,38,0,0,0,22,77,670,1,1,0,743,1,0,170,168,2,5735,5644,91,37,37,0,100
281973754d704b663cf6209a0f9edebf32c9bd38,11,39,92,131,0,0,0,7,76,3122,7,9,2.485381865,2946,14,1,533,541,8,23155,23478,323,162,162,0,100
ba6980477c001bed7b31c9c18022f27bdd705ff0,1,7,0,7,0,0,0,4,9,1619,1,1,0,548,0,0,109,109,0,4270,4171,99,25,25,0,100
b38c957a6e6326fb827ca7f667566d060dabb4b1,2,1,7,8,0,0,0,3,8,2279,2,2,0.543564443,592,73,0,114,114,0,4475,4559,84,29,29,0,100
0aa87d3c343b002205e607224d7c8c06ad0817a9,2,19,8,27,0,0,0,4,10,2019,1,1,0.999010271,626,0,0,141,139,2,4495,4414,81,29,29,0,100
e0d088a9e30d460b1771cd1bd14c2e33cab6babc,4,15,20,35,0,0,0,4,9,469,3,3,1.670421026,1223,1,1,253,255,2,8973,8970,3,58,58,0,100
332420048ad146980effae3b9e4903728e5f6f34,0,0,0,0,0,0,0,0,0,0,0,0,0,0,2,2,0,0,0,0,0,0,0,0,0,100
efce549f53ad1dee1cff483ea166e6a8261039df,1,15,1,16,0,0,0,3,7,1713,1,1,0,112,3,3,15,14,1,1006,936,70,9,8,1,100
c361db5f750bb8227e419c2106709468f677c79e,8,16,29,45,0,0,0,2,10,1845,4,6,2.386137523,973,74,1,148,149,1,7015,7095,80,55,56,1,100
a6b817db1f121502d89d6432b5f099ec052ab2ec,3,31,11,42,0,0,0,3,41,3714,1,2,1.165784052,913,2,0,174,172,2,6975,6879,96,46,46,0,99.96714849
733d3b2343e32868abb35c1b3f5c3772e4833447,2,15,0,15,0,0,0,2,4,2570,1,2,0.353359335,59,3,1,12,10,2,474,431,43,9,7,2,100
314ac44b4dd0fef9c9d4c91c007b3b83fc86845d,3,112,2,114,2,0,2,1,42,0,1,1,1.150807907,742,4,2,166,157,9,5918,5580,338,46,39,7,99.80334317
810a3a4f5f153dbdcc1416ef2fda19bcca253ff9,2,106,0,106,1,0,1,1,8,2432,1,2,0.635211552,96,5,3,28,17,11,1110,628,482,13,8,5,99.93459778
925c732eb20e41251446472a1691adf4aa79324b,20,258,288,546,2,0,2,1,40,827,5,10,3.571033979,2358,1,1,425,426,1,17452,17197,255,136,137,1,99.5091623
80c9b057809dbbb0f49fa730c0a27ac8a84c12c3,13,156,199,355,1,0,1,2,10,896,4,8,2.768087421,1391,0,0,230,230,0,9360,9639,279,77,79,2,99.54113405
ba84a8fa162730929f1a4b2416a3f09ac32016f3,22,195,233,428,1,0,1,6,78,637,10,16,3.33149333,3538,2,1,610,616,6,26913,27203,290,207,213,6,99.73770492
61f47d57ff4c27156a8fcfe2f618513f9bc77be9,1,2,4,6,0,0,0,22,79,0,1,1,0,753,3,2,170,170,0,5731,5735,4,37,37,0,100
c49efe22e6e45c430dfa0ba8c47a983b86dc032f,28,339,209,548,3,0,3,7,76,2485,11,18,3.768958679,4497,6,4,814,808,6,35143,35037,106,275,267,8,99.63993453
d7421552fdafd37597bcd249c58bd3858c78feb8,3,171,13,184,1,0,1,1,3,0,1,2,0.953236948,65,7,5,22,11,11,1284,439,845,16,9,7,99.77316915
4e841ea3377c3924f5794782cf4daa0112edaaa4,13,205,439,644,2,0,2,0,40,446,3,6,3.149995346,1382,1,1,228,240,12,9064,9970,906,78,88,10,99.28594612
e063e161c5e316e0936e0673e6fe2e1bd5a3c603,13,216,170,386,1,0,1,1,11,630,4,8,2.847836102,1369,2,2,232,232,0,9704,9426,278,81,79,2,99.54113405
81d901b035780e7dc8d94684a02729fd06bf7a38,13,170,216,386,1,0,1,2,10,799,4,8,2.847836102,1404,2,2,232,232,0,9426,9704,278,79,81,2,99.54113405
7a7ec0a2b0f6d07ebba401cb03f833efcbfdb07c,11,36,211,247,0,0,0,1,10,387,5,8,2.363844878,1180,4,4,154,177,23,7265,8141,876,60,72,12,99.80302035
c4643816f8efd1466fad0de881e31ab4adeb8333,11,142,52,194,1,0,1,2,79,1510,5,8,2.47827487,1849,25,0,358,349,9,14237,13864,373,111,107,4,99.93434012
cd5ec39b55acf58c3fea5ff0536f2c90cad3515a,6,255,10,265,2,0,2,2,11,674,1,3,2.216812844,887,26,1,208,183,25,8049,6696,1353,59,44,15,99.73813421
db487fab7ff604b417e4cc60e622d11e190dcc7f,19,476,391,867,4,0,4,1,76,1102,4,9,3.732918925,3102,8,6,618,620,2,23349,23524,175,179,179,0,98.752
6defdc7d8cb624aa66fc1c2bc11247dabefd39d3,9,378,26,404,3,0,3,2,79,653,2,5,2.841974741,1758,27,2,418,382,36,15271,13420,1851,115,95,20,99.46456693
96d77b241717a20481b9ceb0b706a7805d15946a,2,29,4,33,0,0,0,3,10,12,1,2,0.999337504,660,28,3,125,123,2,5321,5107,214,34,33,1,100
60af963ebea3bf2050d51488167c5cdb28bd304e,3,192,0,192,2,0,2,2,8,0,1,2,1.38816856,47,29,4,29,4,25,1126,125,1001,17,4,13,99.84197219
5fa81de17d741544a2d20775fd1df24799e10532,3,7,21,28,0,0,0,2,4,660,3,3,1.287054028,148,75,2,15,15,0,821,926,105,11,11,0,100
6191aeae8fd3bfb1e87525ac3d02d5f5eaf7996e,2,11,7,18,0,0,0,2,17,902,1,2,0.309543429,316,76,3,49,49,0,2632,2605,27,25,25,0,100
0d6b8d273ab481e54dab0b3839285b7366fbabd9,0,0,0,0,0,0,0,0,0,0,0,0,0,0,77,4,0,0,0,0,0,0,0,0,0,100
b45581a371d2d69c472c37793efa085436056c9b,20,113,305,418,0,0,0,2,16,659,7,12,3.60195746,970,78,4,69,91,22,5325,6461,1136,54,65,11,99.93682881
97c6b4336117ce33a08a7c16dc26a67930f51bcb,0,0,0,0,0,0,0,0,0,0,0,0,0,0,79,0,0,0,0,0,0,0,0,0,0,100
705d3b5fa75b3028d43c9214b9bd3453e1d40c00,0,0,0,0,0,0,0,0,0,0,0,0,0,0,80,1,0,0,0,0,0,0,0,0,0,100
20220c0dd9a7de4903f8d5786b53ef330bd3ab3b,0,0,0,0,0,0,0,0,0,0,0,0,0,0,81,2,0,0,0,0,0,0,0,0,0,100
bd843c2cb4432d7a03185e1932e2e1c82e10ecc4,0,0,0,0,0,0,0,0,0,0,0,0,0,0,82,3,0,0,0,0,0,0,0,0,0,100
307ff87ef8581dd35acc3f3e0e0541cb138fdcbe,1,1,1,2,0,0,0,2,3,5069,1,1,0,27,83,4,4,4,0,184,188,4,3,3,0,100
718dd308d3659e547269ea9bd0fc3eb5c34e5eb3,6,35,29,64,0,0,0,3,12,2017,1,3,1.118392729,600,0,0,94,90,4,3463,3389,74,34,33,1,100
6aaf2c85b87069ec21af8d1612dbf63d3d192b38,6,29,35,64,0,0,0,2,11,951,1,3,1.118392729,611,0,0,90,94,4,3389,3463,74,33,34,1,100
80502535c510c44690028468d13e52c53f0fb934,0,0,0,0,0,0,0,0,0,0,0,0,0,0,84,0,0,0,0,0,0,0,0,0,0,100
5eb1e9bf81455c9c227b1cde324825493e41839c,0,0,0,0,0,0,0,0,0,0,0,0,0,0,504,0,0,0,0,0,0,0,0,0,0,100
5d397749a7594e84a312d032d24b4667affda7e9,0,0,0,0,0,0,0,0,0,0,0,0,0,0,505,1,0,0,0,0,0,0,0,0,0,100
88663d2790a570617630b18d84609d23d728c087,0,0,0,0,0,0,0,0,0,0,0,0,0,0,506,2,0,0,0,0,0,0,0,0,0,100
22d3af831dbd279151a55f610a747859fc20c74e,0,0,0,0,0,0,0,0,0,0,0,0,0,0,106,0,0,0,0,0,0,0,0,0,0,100
d265e86601cbcfff69379b49804a5ab1674cdcc8,0,0,0,0,0,0,0,0,0,0,0,0,0,0,507,0,0,0,0,0,0,0,0,0,0,100
d926947e149ee210c6413c2d1f7584d3b20d91e0,0,0,0,0,0,0,0,0,0,0,0,0,0,0,0,0,0,0,0,0,0,0,0,0,0,100
cd28146e4b4ad59587f2ad4c2748905954f837d8,6,35,29,64,0,0,0,3,12,2017,1,3,1.118392729,600,15,0,94,90,4,3463,3389,74,34,33,1,100
2d0d91093dd7bceb07a4d64fb6b075bdc2117abd,22,2436,0,2436,22,0,22,1,1,0,1,8,3.404724594,0,12,0,293,0,293,10824,0,10824,114,0,114,96.46282974
ffc3a13b778dce17db823dbcda8f5ab44640ab85,14,1595,1578,3173,0,0,0,2,2,0,1,7,2.700367442,1631,107,0,294,293,1,10876,10740,136,115,114,1,100
4a9394ecf8e91fc644a8f1103783ef3804f15312,0,0,0,0,0,0,0,0,0,0,0,0,0,0,16,0,0,0,0,0,0,0,0,0,0,100
3da368d4d46aaaded5543d01342abb3a49cd4d53,0,0,0,0,0,0,0,0,0,0,0,0,0,0,17,1,0,0,0,0,0,0,0,0,0,100
44ecabb241201c37f94ade36806b2070eca0144c,0,0,0,0,0,0,0,0,0,0,0,0,0,0,508,0,0,0,0,0,0,0,0,0,0,100
b04a239866d010d4850e6558f435c9cb1009f13c,14,1580,1597,3177,0,0,0,1,1,0,1,7,2.701286966,1649,0,0,293,294,1,10740,10876,136,114,115,1,100
cb8e6ba68438355572e480de2d93adddbfae637e,0,0,0,0,0,0,0,0,0,0,0,0,0,0,0,0,0,0,0,0,0,0,0,0,0,100
e2ef9987975212c044e20c75d3ab2758f741a02f,14,1595,1578,3173,0,0,0,2,2,0,1,7,2.700367442,1631,1,1,294,293,1,10876,10740,136,115,114,1,100
056eb7d5d53c869181f7b7b832cb9ae8dd306be7,0,0,0,0,0,0,0,0,0,0,0,0,0,0,2,2,0,0,0,0,0,0,0,0,0,100
f78de95ceab3e78840526a5bc3025d7bb262ee32,0,0,0,0,0,0,0,0,0,0,0,0,0,0,0,0,0,0,0,0,0,0,0,0,0,100
e779d7c48c934bd1cbdd382c0746ef90c95aa78a,0,0,0,0,0,0,0,0,0,0,0,0,0,0,18,0,0,0,0,0,0,0,0,0,0,100
acdb7f4dff403a1b4933c6c457c9ea5c2ac5c6e8,0,0,0,0,0,0,0,0,0,0,0,0,0,0,19,1,0,0,0,0,0,0,0,0,0,100
4672568e2d4ba301108fdf8a3b6384749206a41a,0,0,0,0,0,0,0,0,0,0,0,0,0,0,20,2,0,0,0,0,0,0,0,0,0,100
fd7a4238fbffd136dfb821907247075ae4fe35fe,3,249,0,249,3,0,3,1,1,0,1,2,1.45214077,0,0,0,31,0,31,1152,0,1152,24,0,24,97.79005525
a2a0e2184d7c7d0832cf2e4883ef4cee5e8cc2a4,3,165,41,206,1,0,1,1,2,90,1,2,1.087520863,154,1,0,40,29,11,1588,1056,532,21,22,1,97.88528389
13fc58561aab36c5debd33f90449288f4307b3d2,0,0,0,0,0,0,0,0,0,0,0,0,0,0,2,1,0,0,0,0,0,0,0,0,0,100
3acc4ed3a3aed78ec3efd8f4313a4972d37d8453,1,3,6,9,0,0,0,2,3,6,1,1,0,162,1,0,30,30,0,1118,1111,7,15,15,0,100
53c5628db7a9e116dfa1e02a975a7886b9cade15,3,285,0,285,3,0,3,1,1,0,1,2,1.365958811,0,2,1,15,0,15,1032,0,1032,14,0,14,96.69396421
8e4fbee5b192227e9b3af5c39b2c59cd0ecd1e2d,0,0,0,0,0,0,0,0,0,0,0,0,0,0,3,2,0,0,0,0,0,0,0,0,0,100
ea275745ee40fb6e351f6e4d972997411d6cfde7,1,16,3,19,0,0,0,2,4,39,1,1,0,162,4,3,30,30,0,1270,1118,152,15,15,0,100
db1137a9e134d45220e3225f9027802d5d8061ee,7,0,668,668,0,0,0,0,0,0,1,4,2.554020088,422,4,0,0,57,57,0,2875,2875,0,37,37,96.61997564
370234b8b975ad45dc789c15a3fb778b44da4061,0,0,0,0,0,0,0,0,0,0,0,0,0,0,108,0,0,0,0,0,0,0,0,0,0,100
c8e940d537b4d429237b489a10d3ddcc78f5dc4e,1,1,1,2,0,0,0,2,4,2552,1,1,0,74,109,1,7,7,0,454,454,0,3,3,0,100
073d6dfa3ae699bc8856611adb7ef531effbe8fc,1,37,6,43,0,0,0,2,2,3252,1,1,0,106,5,1,5,4,1,1364,1018,346,4,3,1,100
14e75d76fce93d8a417f8f50b8b28e06a91f9bc2,0,0,0,0,0,0,0,0,0,0,0,0,0,0,0,0,0,0,0,0,0,0,0,0,0,100
b4bd02765a8cbe0dd88adb3b2f0ed3a8badf79bb,1,0,21,21,0,0,0,3,10,2101,1,1,0,285,6,2,69,73,4,1672,1746,74,12,13,1,100
8440644c0d61ac0474035107808dd55be30f5154,26,2089,0,2089,26,0,26,1,1,0,1,9,3.703928888,0,0,0,238,0,238,9548,0,9548,89,0,89,98.37443946
2cccfdbed4fe72668660177572e1d24ed137b88b,3,87,47,134,0,0,0,2,8,5228,1,2,1.167135487,954,1,0,192,189,3,7535,7322,213,53,52,1,100
f5e12f398f2bbc36ebc752618765b7e68096dbc7,0,0,0,0,0,0,0,0,0,0,0,0,0,0,0,0,0,0,0,0,0,0,0,0,0,100
38f663965c823b6f98711c809fb9e8c515cb67e1,0,0,0,0,0,0,0,0,0,0,0,0,0,0,0,0,0,0,0,0,0,0,0,0,0,100
a1431ec0f416e486a717d5c878cc887c19ae9f59,0,0,0,0,0,0,0,0,0,0,0,0,0,0,1,1,0,0,0,0,0,0,0,0,0,100
283fa0aad6bec049977a543bec45a19ba41a84c3,1,1,1,2,0,0,0,5,9,447,1,1,0,831,85,0,169,169,0,6554,6551,3,35,35,0,100
0e8f8045fdd88d7fe39789a47541b83b1ad1f50f,0,0,0,0,0,0,0,0,0,0,0,0,0,0,86,1,0,0,0,0,0,0,0,0,0,100
65e6e51c6189dadfd265e17b818eb7c2d7b5249c,0,0,0,0,0,0,0,0,0,0,0,0,0,0,87,2,0,0,0,0,0,0,0,0,0,100
4bac876c854129181ca8a621df8bfa80f95ac899,14,1606,0,1606,14,0,14,1,1,0,1,5,2.806288114,0,0,0,213,0,213,8006,0,8006,82,0,82,96.4569161
8b5cea77f0e99d475f02db4598a1db4c271c0293,0,0,0,0,0,0,0,0,0,0,0,0,0,0,110,0,0,0,0,0,0,0,0,0,0,100
039571bbde45656dd8cdc1eaf3f8a2c72e2ef20a,0,0,0,0,0,0,0,0,0,0,0,0,0,0,111,1,0,0,0,0,0,0,0,0,0,100
6c6b06c916b969352a6757ba7025cc78055fa87a,7,668,0,668,7,0,7,1,4,24,1,4,2.554020088,0,112,2,57,0,57,2875,0,2875,37,0,37,99.5658466
