CommitID,NMF,TotalAddLines,TotalDeleteLines,LC,FileAdd,FileDelete,NAD,NDEV,NUC,AGE,NS,ND,Entropy,LT,EXP,REXP,CommitComplexity,LastCommitComplexity,CFC,CommitTokenCount,LastCommitTokenCount,NCC,CommitMethodNum,LastCommitMethodNum,NMC,a2a
88d58477d2bbe6adea5a315c6b1bd833949ee57c,18,812,178,634,1,0,1,1,2,0,1,5,2.969139989,1145,1,1,245,162,83,12718,8500,4218,120,82,38,98.87640449
c6a0b5f55b07dee08d1a41ca4a463f6753bd705f,20,734,358,376,3,0,3,1,3,0,1,3,2.970030659,1445,2,2,280,57,223,12915,4213,8702,136,39,97,87.10280374
93396a759a118f484e2ef1693cf011cb9e32aadb,16,495,86,409,6,0,6,1,2,0,1,2,3.70530165,1057,3,3,231,182,49,9625,7651,1974,120,95,25,97.13261649
83c50eb811bc1de46d78f751f1acfa3d1306a869,17,77,181,104,0,0,0,1,3,0,1,2,3.657911921,1069,4,4,188,206,18,7517,8010,493,101,114,13,95.221843
599d201d6665a685ec8765e2e9da026f063470c7,2,77,7,70,0,0,0,1,3,0,1,2,0.749595257,613,5,5,90,88,2,5356,4657,699,33,33,0,100
92350ed7b5ba3dd7b5c2e4226df9a245242f27d6,10,663,301,362,0,0,0,1,4,0,1,2,2.879108432,1633,6,6,269,251,18,16132,13182,2950,111,105,6,97.20767888
f1c242025e67b02917ab7a781875cf557622bf7c,4,190,103,87,1,0,1,1,5,2,1,2,1.601890213,496,7,7,128,131,3,3886,3115,771,55,54,1,99.28952043
9bcc9a37a3cddf39e02acb92c4265a8f63bf93b5,30,1365,989,376,2,0,2,1,6,0,1,9,4.344183719,3536,8,8,566,505,61,30559,28108,2451,249,248,1,93.20214669
d1d36daa13d0c24895a498cc6e3aa0821ae5944a,17,465,214,251,2,0,2,1,7,0,1,5,3.768690976,2736,9,9,350,315,35,23758,22292,1466,164,151,13,97.6146789
6ac6d31ace5d068e2f2c7dadded75ef507e9107d,0,0,0,0,0,0,0,0,0,0,0,0,0,0,10,10,0,0,0,0,0,0,0,0,0,100
ed1a2b03a19cddbd2c0046f5d45e627f611032de,5,318,21,297,1,0,1,1,4,5,1,3,1.64152318,428,11,11,43,33,10,4418,2899,1519,33,26,7,99.07578558
3b16e9854d20f1660e68ec4da6cd907f2be624aa,1,16,2,14,0,0,0,1,5,0,1,1,0,324,12,12,11,11,0,1990,1882,108,9,9,0,100
2e6464cb8cc4b122083d8d6efdc5cac5ee25abcb,20,1919,537,1382,10,0,10,1,6,12,1,8,3.320576024,776,13,11,186,63,123,13045,7645,5400,95,47,48,92.79279279
1fb9def1bae0e46506954e33d489dd0c1f5999ca,124,111,52,59,0,0,0,1,1,0,1,27,4.302047829,7921,14,11,1113,0,1113,60667,1736,58931,563,0,563,16.21621622
fba873cb07bc0add7c029a63febfe026eaf4964a,7,0,0,0,0,0,0,1,1,0,1,1,0,21,15,12,0,0,0,98,98,0,0,0,0,95.46925566
0b2d7c958d517fcee295b7c0db5c16a8d5c1821d,45,103,686,583,0,0,0,1,2,0,2,15,4.724869133,3156,16,13,253,226,27,22849,24370,1521,159,164,5,86.27118644
c5bc4c7f676286055e47b81041bdcecf30073607,50,326,327,1,0,0,0,1,3,0,3,15,3.546816567,4933,17,11,632,517,115,38550,34331,4219,289,234,55,79.89130435
57a60b3d0ae6280a38865757485d070b3591698d,4,47,41,6,0,0,0,1,4,0,2,2,1.895505621,952,18,12,77,76,1,6554,6597,43,35,34,1,98.17518248
43b754dd18c04d68ce5e7fd34997a5c49b7e7159,9,295,107,188,3,0,3,1,5,6,1,5,2.376651426,732,19,12,89,63,26,6190,5300,890,51,32,19,98.1981982
0fc4d209c15b0c5d7460d236e7eb59351f3ffe29,0,0,0,0,0,0,0,0,0,0,0,0,0,0,20,13,0,0,0,0,0,0,0,0,0,100
ca5f237f0dac69f32e80c786b2833bca6a4c8348,6,150,7,143,1,0,1,2,3,25,1,4,0.454737885,575,0,0,90,80,10,5354,4565,789,61,51,10,98.74551971
1d836057ce81f55e4693c83b5f5d83bb2ae6a57d,0,0,0,0,0,0,0,0,0,0,0,0,0,0,1,1,0,0,0,0,0,0,0,0,0,100
5dd00a0063bab4fc886895ebd73eefbbf0f63439,44,772,115,657,5,0,5,1,6,0,3,18,3.776932423,2461,21,8,305,241,64,21541,18049,3492,195,150,45,89.18918919
b0ba5063ea620026bc18484b4819c8fca403f88c,1,2,2,0,0,0,0,2,2,2,1,1,0,100,22,9,10,10,0,803,803,0,10,10,0,99.35794543
bd79d33a204733c27290f7e62e5f545c0bd285a8,1,15,12,3,0,0,0,2,3,0,1,1,0,100,23,10,10,10,0,838,803,35,10,10,0,100
ff2f01d6110e55cb3cffe77839535afdf1ed99c1,5,158,23,135,2,0,2,1,5,7,1,3,1.931877985,110,24,11,15,11,4,1391,942,449,11,8,3,98.2428115
0c2a1b9296ab4b7f2248bbfdf71d6b6f724c4eda,24,490,185,305,4,0,4,1,7,7,1,10,3.701410603,1882,25,4,233,194,39,14996,13164,1832,124,103,21,95.51083591
e92d333e6f5d16d9cce358c4d91e0ea8ace2a872,7,216,99,117,0,0,0,1,7,13,1,6,1.642153873,502,26,5,83,69,14,4683,4021,662,48,43,5,99.54614221
e0e9916fccf77434a44b41ebe7d60a99c8f58cb3,4,122,12,110,2,0,2,1,2,26,2,3,1.384462982,60,27,6,36,15,21,819,507,312,11,7,4,94.22222222
be9afe5e90fb052300e510734c160c0702f54128,9,73,58,15,1,0,1,1,8,8,4,5,2.12960023,357,28,7,82,55,27,2713,2438,275,31,27,4,96.85714286
c8f2d5d8d3ad943df6152ed26e3e76dfe9600d6b,7,62,38,24,0,0,0,1,8,0,2,6,1.709216439,1044,29,8,105,92,13,7735,7311,424,59,52,7,98.87323944
07be2d1261c3290160cbc32fbda22e9146648d54,32,769,253,516,10,0,10,1,4,0,1,11,4.472401937,730,30,9,126,70,56,7444,4286,3158,96,47,49,90.85948158
a364e4523a35c819f7f3ea3900654c2ac56ab1ba,9,493,47,446,3,0,3,1,2,0,1,4,2.330582267,255,31,10,60,36,24,4356,1751,2605,50,32,18,98.81889764
44e4b761bc9a885bbc03f0ba60166bf3f8ee1838,20,743,17,726,9,0,9,1,3,0,1,6,3.736153304,332,32,11,84,38,46,6066,2205,3861,68,34,34,94.79418886
9f054e6ff5d2e25aa730e597ffeb40f8dc1a779e,0,0,0,0,0,0,0,0,0,0,0,0,0,0,33,12,0,0,0,0,0,0,0,0,0,100
3bd467d739450b956f7f0f47257647596e51b2c3,9,204,120,84,0,0,0,1,9,21,1,4,2.332567498,646,34,13,135,113,22,5572,4718,854,76,66,10,96.70588235
75e4a0b0480fbc9c293429975ef385f0f375fe5c,7,173,108,65,0,0,0,1,10,14,1,5,2.137958677,726,35,14,107,99,8,6019,5584,435,64,61,3,98.14585909
1d19d51942a53de0b7a617af3230042c300ed1ac,5,116,11,105,0,0,0,1,11,6,1,2,1.527194745,358,36,15,69,55,14,3302,2631,671,35,29,6,98.7654321
f8e94a399e3e779c80a4887819af7a0f7ac3382e,33,290,794,504,0,0,0,1,9,4,1,11,4.390553903,2221,37,16,194,247,53,13538,16418,2880,122,169,47,92.4691358
7e6fa1eb15a21d0df81639f4854ecfa78cf41b9d,25,427,528,101,3,0,3,1,5,0,1,8,4.020524653,927,38,17,103,160,57,6074,7390,1316,80,137,57,93.50318471
9de1b50b9bb4ddd66bd65d964127d3440efc943e,16,82,83,1,0,0,0,1,12,0,1,5,3.687903146,715,39,18,78,89,11,5862,13256,7394,50,67,17,93.48659004
3e49a28287c9d9e5ecfa94f6088ef44ebdc505c0,1,2,2,0,0,0,0,1,2,0,1,1,0,75,40,19,3,3,0,807,840,33,3,3,0,100
ff56e30b8740dcdb680edc0596297954d80edf79,1,2,0,2,0,0,0,1,6,8,1,1,0,46,41,16,9,9,0,423,423,0,4,4,0,100
879f6babbc864392e9cc4c3455c577808bc426e6,4,145,2,143,3,0,3,1,5,0,1,3,1.516750228,46,2,0,29,9,20,1086,423,663,21,4,17,99.13043478
6cfe2a37160da1d322514dd3f2bb2512ee61fafe,8,159,40,119,0,0,0,2,4,10,1,6,2.155417968,373,3,1,53,41,12,4322,3322,1000,38,29,9,97.90123457
7b6037db899a1ff76042467b7105ca06dd8008f2,1,2,0,2,0,0,0,1,6,8,1,1,0,46,42,17,9,9,0,423,423,0,4,4,0,100
f2986563e94fdf56b2b42a3857c01b61233264db,3,48,51,3,0,0,0,2,3,0,1,1,0.61162566,167,43,18,18,18,0,1276,1323,47,11,11,0,98.2630273
67407b4766477057de849051758a494a363eeffb,164,11,22,11,0,0,0,1,1,0,6,39,2.794732575,10259,44,19,1428,328,1100,77620,29028,48592,763,328,435,20.31823745
146f055a2953c25ddf4fbcdd4c0f2aee59175c82,46,282,298,16,1,0,1,1,2,0,3,16,4.188800026,2013,45,20,243,139,104,15789,11931,3858,159,92,67,84.65408805
345e4fc5ab5306b2befae2aeb73f9e268be359f5,10,35,35,0,0,0,0,1,3,0,3,4,2.650571945,443,46,21,51,31,20,3315,1930,1385,36,20,16,92.76944065
bbaa3df24d9a8f7134a18962320c0703f833e2ef,1,0,0,0,0,0,0,1,1,0,1,1,0,92,47,22,8,8,0,699,699,0,7,7,0,97.90502793
6a9a267b8ad1bf0bd6219cfa0e12ea9d52b29a06,1,12,10,2,0,0,0,1,3,7,1,1,0,89,48,23,3,3,0,1011,991,20,3,3,0,100
001540def60058996d8685f12a04b1a466bb800c,15,83,82,1,0,0,0,1,4,0,3,9,3.391948023,802,49,24,81,74,7,6398,6268,130,62,55,7,98.89807163
e5e1c8279342dae2cc8641d7ac37a042fbc2b411,37,134,139,5,0,0,0,1,5,0,3,15,4.813790735,2809,50,25,300,213,87,21030,14435,6595,183,118,65,88.33107191
0c7f79826d027050a7a66524681bcc207d27a459,12,291,248,43,1,0,1,1,5,0,2,7,1.619482303,1163,51,26,132,132,0,8843,8338,505,67,67,0,98.13084112
674e767d5c665b3801336830e23ee471c816368d,4,38,20,18,0,0,0,1,6,0,1,4,0.812626558,703,52,27,66,61,5,5374,5200,174,29,27,2,100
ae7d09bd0a784d8780fa4d992f812b6dd7be68c2,2,100,0,100,2,0,2,1,1,0,1,1,0.841464636,0,4,2,9,0,9,583,0,583,4,0,4,97.05882353
a1be47d66dc67b8566653b6407948283279ac845,7,92,231,139,0,0,0,2,7,1,2,3,2.557252474,286,5,3,22,25,3,2129,2728,599,11,13,2,98.00531915
d1d14b927bd7c4618667c4b6e0985d6bbe12617f,26,813,222,591,4,0,4,1,7,0,4,13,3.086070152,2923,53,27,327,280,47,25870,22589,3281,171,156,15,94.16149068
5c0e819374a6c2e2b5afa6de04d450b069efa6f9,7,124,163,39,1,0,1,2,9,1,2,3,2.504856011,266,54,28,28,18,10,2525,2507,18,14,11,3,95.97069597
e239d68e3ef889908a70d5282e805a59401b4664,1,2,2,0,0,0,0,2,10,0,1,1,0,95,55,29,3,3,0,1037,1070,33,3,3,0,100
48cc8742b0ec482e4612478c0e96726bcf06cc67,7,198,63,135,1,0,1,2,11,0,1,5,1.830042603,1076,56,30,158,142,16,8294,7705,589,83,67,16,98.47522236
273ec2f6c15314b79899a4bd3c239f17b79f605a,15,84,106,22,0,0,0,1,12,0,2,7,3.387841618,1153,57,31,169,177,8,9087,10543,1456,88,64,24,95.31051965
cc2e2f2fd82cbcdea9003112658206d90046839c,15,54,55,1,0,0,0,1,7,0,3,12,3.649207119,1811,58,32,210,211,1,13363,13407,44,122,123,1,100
409636f062394b8e349271a03a83dc152de154c2,1,14,7,7,0,0,0,1,4,0,1,1,0,146,59,33,34,30,4,1193,1132,61,15,14,1,100
d07e776a45d4c0cae503abf1dcecbb1740d80471,9,149,119,30,0,0,0,1,8,2,3,6,1.441278127,651,60,31,95,91,4,5166,5062,104,57,56,1,98.06451613
a4a9bde4c4b93abb573891b1d2a4ed2b5d47da4d,1,12,0,12,0,0,0,1,4,2,1,1,0,121,61,32,5,5,0,992,908,84,4,4,0,100
99cee6e7c037812b1fa3715af13c30b2743cd592,4,9,10,1,0,0,0,1,7,3,4,4,1.400258233,230,62,32,33,33,0,1859,1859,0,19,19,0,100
da30b265f981f70904ccab02172d272b454ed82c,4,94,5,89,2,0,2,1,3,3,1,1,1.713769102,15,63,33,0,0,0,376,101,275,0,0,0,97.75429326
cc331d86f1c37094f25d188cf2b9550bb7ef0616,3,8,21,13,0,0,0,1,8,0,2,2,1.438627221,123,64,34,11,11,0,888,965,77,7,7,0,97.13914174
2ab4cd188a9953faf84b110bf9ad130670793f87,2,17,14,3,0,0,0,1,2,0,1,1,0.907165768,27,65,35,0,0,0,194,198,4,0,0,0,100
b9dc7255f54218b4b233573988e65fde60546972,5,162,12,150,2,0,2,2,13,0,3,3,1.791337825,519,6,4,46,37,9,4667,3696,971,19,15,4,94.35483871
cda77aa866af56929d05843f829fa3eed5b7a891,7,27,162,135,0,0,0,1,12,0,4,4,2.121986825,650,66,36,37,46,9,3890,4861,971,15,19,4,94.35483871
28173d5ea728da7a7778b89fa5369e0dc70bca9d,5,162,12,150,2,0,2,2,13,0,3,3,1.791337825,519,67,37,46,37,9,4667,3696,971,19,15,4,94.35483871
184d9a16564ac2dc44bc997f05e7fcbf4bca24a6,4,25,30,5,0,0,0,2,14,0,3,4,1.667447341,648,7,5,46,48,2,4678,4836,158,21,22,1,93.97905759
9f6aa34e605e6f209ed5d56c177596ee5ddd6032,39,867,836,31,6,0,6,1,15,0,5,12,4.471120563,2087,68,38,262,220,42,16747,16488,259,145,135,10,89.16449086
878adf1e0fcffbedbb055f3417701beaf909160d,4,7,6,1,0,0,0,1,16,0,3,3,1.546593564,200,69,39,17,17,0,1936,1927,9,16,16,0,100
dbb3ae352739652cd80d42ae5b6a5d73fb60a6bb,2,145,620,475,0,0,0,2,7,0,1,1,0.870655208,662,70,40,31,56,25,2800,5156,2356,11,18,7,92.36947791
4cc263996e1458466a2dff32bb6bf89734e80466,9,206,726,520,1,0,1,1,8,3,2,5,2.533367717,1270,71,41,107,135,28,7848,10081,2233,50,67,17,92.12328767
62035ee41b4637f506a1ac234905b08c24fcd050,4,82,11,71,1,0,1,2,9,2,2,3,1.182959979,366,8,6,48,39,9,4009,3552,457,22,18,4,96.16724739
e2ca2e8caa3b4ac2ee8099b41f7cefcde8405210,1,91,73,18,0,0,0,1,5,0,1,1,0,304,72,41,33,34,1,2786,3182,396,11,12,1,100
83bd8f90d72457c5e7d59cc7012606643d5eab5e,1,36,73,37,0,0,0,2,10,0,1,1,0,283,73,42,30,32,2,2516,2848,332,10,12,2,100
7c7596c9e8695a11b501d429e2c7cf491947a122,6,28,75,47,0,0,0,1,9,3,3,3,0.968114473,652,74,43,89,82,7,5719,5305,414,43,42,1,97.93814433
855e0d349c02610a9743d2f76f66dd898652f8bf,2,22,4,18,0,0,0,1,10,5,1,1,0.706274089,243,75,44,39,36,3,1877,1792,85,19,18,1,100
cf4984413d220cd3a78c761d46c704ae037a882b,2,69,12,57,0,0,0,1,11,11,1,2,0.876716289,482,76,44,41,40,1,4240,3954,286,17,16,1,100
8f1a5aaabec4aaef70cd049bb518d869247099cf,4,303,0,303,4,0,4,1,1,0,2,2,1.935132874,0,9,7,38,0,38,1507,0,1507,20,0,20,95.05703422
74c4d2374d14e3bfccb967711812e193acb4272c,6,102,180,78,0,0,0,2,17,7,3,3,2.393718362,900,10,8,74,84,10,6863,7338,475,29,35,6,95.71788413
b52b12f78d1ea9e84520badb9da08e9d5b68e367,1,1,1,0,0,0,0,2,13,0,1,1,0,338,11,9,33,33,0,2656,2641,15,11,11,0,100
5d006e57036b87c093887dab225b1599bc04bc59,3,233,0,233,3,0,3,1,1,0,1,2,1.493990705,0,12,10,29,0,29,998,0,998,17,0,17,99.13793103
4540b7bd50ff8559ab1fd675146f887096da756e,16,1331,1191,140,2,0,2,1,18,12,4,7,2.589706356,1681,77,36,188,181,7,16034,13183,2851,137,105,32,97.18137255
8990165aa9e32ca5986cbe40c4f8620286ca90f7,0,0,0,0,0,0,0,0,0,0,0,0,0,0,78,37,0,0,0,0,0,0,0,0,0,100
2c5ba09ad44700ad3339d32389faeff7945a1a63,0,0,0,0,0,0,0,0,0,0,0,0,0,0,79,38,0,0,0,0,0,0,0,0,0,100
8ff01ec269731043c3bffc64f0ce258b41c8d4f7,2,12,4,8,0,0,0,2,9,8,2,2,0.543564443,443,13,11,91,89,2,3432,3387,45,29,29,0,100
0e14cdd88d9e129d56af3f826f489cfc6d5f29b0,0,0,0,0,0,0,0,0,0,0,0,0,0,0,80,39,0,0,0,0,0,0,0,0,0,100
a9d052a3a27a93dc0a47f44dc721dfed25c9daeb,0,0,0,0,0,0,0,0,0,0,0,0,0,0,81,40,0,0,0,0,0,0,0,0,0,100
0a46ee9e72814cd5cf468af0299d60deed9265e9,11,1195,126,1069,6,0,6,1,4,0,4,5,2.884102081,1141,82,41,272,99,173,12812,9326,3486,238,68,170,96.61016949
a5a736c67e6c10c39cba740fa39d48bfa63885bb,1,1,1,0,0,0,0,1,3,0,1,1,0,377,83,42,9,9,0,3668,3668,0,9,9,0,100
df724cfce8ff42061c567576c964be8f90d48616,4,58,20,38,0,0,0,1,4,0,2,3,1.474956315,1156,84,43,105,101,4,9631,9428,203,68,67,1,100
1fadef949dc418ee89fe10d68680c78f9f820d86,0,0,0,0,0,0,0,0,0,0,0,0,0,0,14,12,0,0,0,0,0,0,0,0,0,100
8b9feef69f0f75a38676153316ed558e844c6c20,1,3,3,0,0,0,0,1,5,1,1,1,0,373,85,44,9,9,0,3655,3655,0,9,9,0,100
2619f7bae7a024ab50e0106c0784e78a2520b0c3,0,0,0,0,0,0,0,0,0,0,0,0,0,0,86,45,0,0,0,0,0,0,0,0,0,100
d640d794e4502881332f3f3772916c49f44e79b1,0,0,0,0,0,0,0,0,0,0,0,0,0,0,87,46,0,0,0,0,0,0,0,0,0,100
714d6af5f296d34d05933f96cfbb68555a8a9ffb,2,9,1,8,0,0,0,1,6,22,1,2,0.970950594,208,88,47,35,34,1,1867,1777,90,15,15,0,100
6ac1fd3d7eead707129ef02436a1298b7ef43c94,0,0,0,0,0,0,0,0,0,0,0,0,0,0,89,48,0,0,0,0,0,0,0,0,0,100
b1a7ecef5dd55c4eb281060595b8d44eb9f39b43,1,1,1,0,0,0,0,1,3,26,1,1,0,147,90,49,32,32,0,992,992,0,14,14,0,100
2658edc842e38a050749f34213f10550e3d70620,5,26,24,2,0,0,0,1,11,12,1,4,2.017320659,616,91,50,91,92,1,4680,4687,7,53,53,0,100
dd8024a1a7fdfced47cbca884962e459217ec925,0,0,0,0,0,0,0,0,0,0,0,0,0,0,92,51,0,0,0,0,0,0,0,0,0,100
6fcd88fee7dfab41158274163f362e679df3340d,0,0,0,0,0,0,0,0,0,0,0,0,0,0,15,13,0,0,0,0,0,0,0,0,0,100
afffc8d7425df8a21c9f80a097101a7e63e498de,0,0,0,0,0,0,0,0,0,0,0,0,0,0,16,14,0,0,0,0,0,0,0,0,0,100
e938db9eb52e05c978a28893dfc4ff6d58325cd6,0,0,0,0,0,0,0,0,0,0,0,0,0,0,17,15,0,0,0,0,0,0,0,0,0,100
ff1279ca3e40caaebe51bddcb12b9025426bd7e4,2,27,1,26,0,0,0,1,12,0,1,1,0.67694187,305,93,52,42,38,4,2559,2390,169,20,19,1,100
ba11458b0ad51b9ae219d3f668964e63daa83e53,0,0,0,0,0,0,0,0,0,0,0,0,0,0,94,53,0,0,0,0,0,0,0,0,0,100
1f449b9c7187cd8122ac134d0fa0bb0ba3c9d736,0,0,0,0,0,0,0,0,0,0,0,0,0,0,95,54,0,0,0,0,0,0,0,0,0,100
ce70601c0a78a6a617494657bdbb7e29814fc1a0,1,8,6,2,0,0,0,2,4,4,1,1,0,123,96,55,23,21,2,912,885,27,13,13,0,100
16f0dd648020bdd3a102a905bce1262bcbb3d4df,0,0,0,0,0,0,0,0,0,0,0,0,0,0,97,56,0,0,0,0,0,0,0,0,0,100
543dd8dc4dc3f0dbd63a522306424fb9254842c8,0,0,0,0,0,0,0,0,0,0,0,0,0,0,98,57,0,0,0,0,0,0,0,0,0,100
711541ed774c6226b0b12622f74ef154e29f886d,0,0,0,0,0,0,0,0,0,0,0,0,0,0,18,16,0,0,0,0,0,0,0,0,0,100
0bad3708253567241dcfb16913033e040ef4aae3,3,75,4,71,0,0,0,2,4,1,2,3,1.2086806,541,19,17,116,109,7,3237,2929,308,95,91,4,100
a632eccf41f16ba0e1c4ad082e8f1b286c3ed2a7,3,6,6,0,0,0,0,2,19,2,3,3,1.459147917,303,99,58,36,35,1,2652,2649,3,25,25,0,100
a05df6f34e897ab3d93a38fbdf36c43b08326c42,0,0,0,0,0,0,0,0,0,0,0,0,0,0,20,18,0,0,0,0,0,0,0,0,0,100
af93629f94d339b1fc11bac8981e944d0c5754ff,0,0,0,0,0,0,0,0,0,0,0,0,0,0,100,59,0,0,0,0,0,0,0,0,0,100
1f0bac7038998fa43581d5a3459957cef965d5eb,0,0,0,0,0,0,0,0,0,0,0,0,0,0,21,13,0,0,0,0,0,0,0,0,0,100
7b1a24f28a3e7633b515a51018bbd0798fe73acd,1,1,1,0,0,0,0,1,8,75,1,1,0,62,101,0,0,0,0,649,644,5,0,0,0,100
b9d5c247de7a47395af1be14f35afe3320476328,9,73,34,39,0,0,0,1,2,117,3,7,2.748445113,346,102,1,89,84,5,2700,2447,253,36,34,2,98.1416957
d87e1ba0ebee070864672a2162353b6dd06228fc,9,276,259,17,0,0,0,2,20,82,4,5,2.329799176,673,22,0,84,95,11,5425,5304,121,57,61,4,99.09297052
01da3efdf8947616a9d23a572dd80927915f0cc4,5,232,46,186,4,0,4,1,3,0,2,3,1.913887615,67,23,1,26,11,15,1431,460,971,14,6,8,98.98762655
51050a5e220cba8c769287fd9141ec5552bc80ef,1,1,1,0,0,0,0,1,1,0,1,1,0,96,24,2,11,11,0,773,771,2,6,6,0,99.5545657
2ac458c33a82e89ab0a0f11e6c69e04d031c38c5,5,683,0,683,5,0,5,2,5,5,2,3,1.904973371,0,25,3,75,0,75,3513,0,3513,38,0,38,98.78987899
14c5baeef7202336b2bb7b7b92920c01d7c625b9,1,0,0,0,0,0,0,2,6,27,1,1,0,162,26,4,36,36,0,1075,1075,0,15,15,0,99.56521739
e5b8a2ecccb61b4722551ad64be93aac5f9205cd,2,0,396,396,0,0,0,2,7,0,1,2,0.99909822,295,27,5,0,46,46,0,2089,2089,0,25,25,99.56331878
6ba3d344ec1640e160479e2b1d2b2630eb50bdc7,164,7379,1883,5496,61,0,61,1,20,15,12,37,6.48010968,8065,103,0,1673,705,968,88786,40616,48170,897,405,492,66.60649819
191987c7caf4bec34c18b670b7a5f886b3b60c5a,26,234,45,189,4,0,4,1,7,0,3,12,4.172774916,1745,104,1,247,243,4,13886,13000,886,131,129,2,96.50909091
83132c138642d9f08bccc8b13934d85b811fb369,16,748,259,489,7,0,7,1,22,24,6,7,3.198663077,676,105,2,129,96,33,7914,5405,2509,79,62,17,91.02011494
e484b24dbc2eb6a8aac89e8c49fd36c456b3d3ea,1,2,1,1,0,0,0,2,10,0,1,1,0,94,106,3,11,11,0,865,856,9,11,11,0,100
e29ffd9feab0a84afc53c80b5a63cbb9721b91a3,29,1020,121,899,7,0,7,1,23,0,4,9,3.970505399,2637,107,4,569,455,114,24633,19929,4704,273,192,81,94.23076923
043472b8ab4ff28e8399cf33665a781b72b01e39,1,54,0,54,1,0,1,1,1,0,1,1,0,0,108,5,3,0,3,172,0,172,3,0,3,99.87309645
6b392563da8a12d213e19eff076656489f149a78,0,0,0,0,0,0,0,0,0,0,0,0,0,0,109,6,0,0,0,0,0,0,0,0,0,100
b7ad70d4650f4a850f392c8deaf54368f8b34fdf,5,0,484,484,0,0,0,1,3,97,3,3,1.789953383,342,110,7,0,42,42,0,2463,2463,0,26,26,96.56862745
31f94d7b6aae34a492b80bfb7fece1e6cef8c237,43,1079,548,531,10,0,10,1,4,0,4,16,4.462384697,3070,111,8,486,425,61,28939,25999,2940,242,220,22,90.15444015
1a0a7d0c6ba1b988313b2602c5a0a3a8bb4afe22,19,274,124,150,2,0,2,1,3,1,2,5,3.638415156,990,112,9,107,47,60,9230,7664,1566,87,46,41,93.75
4bf0d8cd44d78ae886dcdcc83ef20d99711cc6f7,1,1,0,1,0,0,0,1,2,0,1,1,0,36,113,10,5,5,0,208,208,0,4,4,0,100
43c4de738308361aa3b778e4a291670ac4eb699a,1,10,0,10,0,0,0,1,8,21,1,1,0,454,114,11,11,11,0,4243,4125,118,11,11,0,100
9adf65f80ad0299893b4ea31f5a38e854503d429,10,635,5,630,7,0,7,2,15,34,1,5,2.120643756,842,28,0,181,98,83,9746,6205,3541,97,60,37,98.72881356
5ffc9abd48425be5b270ab0520f92f9accdce9a4,12,326,644,318,0,0,0,1,15,20,2,6,2.646180025,1818,115,11,128,196,68,11717,14176,2459,81,111,30,98.72881356
dfa01d74c22f672ecf02d76011ab61cdbee9aee0,10,635,5,630,7,0,7,2,17,16,1,5,2.120643756,1011,116,12,191,108,83,10262,6721,3541,101,64,37,98.8045007
64998fa2861f926c09a04b85985c8a3e110658e0,20,890,221,669,11,0,11,1,18,2,2,6,3.807009171,1050,29,1,247,190,57,10453,7755,2698,99,72,27,97.64868603
4a2245d1d8660ded1a308491b63eb63107c125c2,4,100,7,93,0,0,0,1,12,0,2,4,1.578199299,614,30,2,142,126,16,4958,4531,427,45,38,7,99.45205479
88d950405514a79f19800a266f272834c5d94793,1,4,0,4,0,0,0,1,4,0,1,1,0,216,31,3,50,49,1,1386,1358,28,15,15,0,100
20e1a59d3d6e181fc63f5a56adeb296046886cbd,6,63,12,51,2,0,2,1,19,6,2,4,2.374995276,1459,32,4,204,201,3,10347,10113,234,94,91,3,99.25423729
751569629efd39e2a87cb4126bd322d22bfb6fd7,2,34,0,34,0,0,0,1,2,0,2,1,1,20,33,5,2,2,0,131,131,0,2,2,0,100
32cc84d795b0b1a48fee2fc7c4c4894385087c3e,1,20,2,18,0,0,0,1,2,38,1,1,0,56,117,6,2,2,0,610,523,87,2,2,0,99.5923913
9bc18c56485c8798ce5fbe2f4f1b339d7a970a49,19,132,61,71,1,0,1,2,6,51,3,8,3.449223709,1161,118,7,217,212,5,9156,8479,677,121,118,3,95.75163399
f5be7d7108cbb3c7df598dc241ba4441ee462f7f,8,111,13,98,1,0,1,1,5,8,2,4,2.063585453,487,119,8,71,66,5,4381,3727,654,49,46,3,99.87437186
cb4f197a11e1b5cc9084ef495d2ab8896cf5a013,3,116,7,109,1,0,1,1,3,0,1,2,1.132407234,106,120,9,25,19,6,1592,834,758,12,10,2,98.59926918
21724348ea106b72baa5848cccfa7dd7248d237c,0,0,0,0,0,0,0,0,0,0,0,0,0,0,121,6,0,0,0,0,0,0,0,0,0,100
6f1fca756c860f07f7efdd5b7e03d4ba6aa750ac,0,0,0,0,0,0,0,0,0,0,0,0,0,0,122,7,0,0,0,0,0,0,0,0,0,100
87d7c5bf38d00428a20b801bbbaa571017a4430b,10,213,39,174,0,0,0,1,5,16,2,4,2.417785074,769,34,5,146,131,15,6637,5609,1028,68,59,9,100
93545690abbec16244334cf35f0eb487c2a4e54b,2,27,8,19,0,0,0,1,10,35,1,2,0.999411065,189,35,6,16,16,0,1701,1571,130,13,13,0,100
8348fea4b23c83bd12e20f0840cc6951bd0d7c2d,15,578,294,284,1,0,1,1,10,41,5,7,2.881552039,3643,123,8,366,335,31,33676,31321,2355,187,174,13,96.98113208
469fd114d2a1922e13301df532f5aee474928dbf,10,268,323,55,0,0,0,1,11,6,4,7,1.317330398,2718,124,9,305,331,26,22601,22426,175,156,157,1,97.94740218
701a0c3588f05354a707d24f2a194b8de4f81452,4,38,5,33,0,0,0,1,6,0,1,2,1.851007944,1534,125,10,210,212,2,13048,12832,216,111,108,3,100
6b1a668a4a5f0d42744e9c949a9df1f1622bfadf,9,82,12,70,2,0,2,1,12,22,3,6,2.805884742,1677,126,11,168,168,0,12976,12675,301,80,80,0,99.69325153
2684051d4c182781712a9e79b81c08a9112ec489,5,181,44,137,2,0,2,1,20,3,2,4,1.930426546,702,36,7,125,117,8,5625,4932,693,61,55,6,98.71007371
f125b108a0d7caffca30fce720961fd9144ff947,5,28,5,23,0,0,0,2,21,140,2,5,1.84712821,574,37,8,101,98,3,4047,3953,94,57,55,2,100
495bc469ba66f378792902462b11b205c406b589,11,183,35,148,0,0,0,2,13,124,3,7,3.294525719,1253,127,10,145,145,0,9704,9738,34,83,83,0,100
317176aadda464435c5e13037709db730266e02a,2,2,2,0,0,0,0,1,5,86,1,1,1,246,128,11,46,46,0,1724,1724,0,20,20,0,100
5df07f22e24146a6593754a334c38e94f6de5f3d,0,0,0,0,0,0,0,0,0,0,0,0,0,0,129,12,0,0,0,0,0,0,0,0,0,100
57c552ae6e1233b2ef5022c298aba8e4641394a2,0,0,0,0,0,0,0,0,0,0,0,0,0,0,130,13,0,0,0,0,0,0,0,0,0,100
2e0e1d3f17481ae331dd2bac2d109ced3c50afe6,1,5,5,0,0,0,0,1,5,8,1,1,0,214,131,14,46,46,0,1402,1402,0,24,24,0,100
41b41dcd19218a625ec04ad4cd7fc148e834c1e5,3,12,12,0,0,0,0,1,1,0,1,1,0,1377,132,15,110,42,68,10365,831,9534,68,42,26,99.26017263
e110f7a22b65d9d4e491b23c6633bc68c1f915b7,6,107,37,70,1,0,1,1,7,16,2,3,2.400570282,667,38,6,118,109,9,5118,4837,281,52,51,1,98.66017052
4ee5b56447f68d1f0f4bb1e4c664d8d48530b4b3,9,37,23,14,0,0,0,1,24,59,5,8,2.504210116,1085,133,16,162,161,1,8737,8620,117,75,75,0,100
83f449405a4e40a4a415d9370d5961f5298fdf16,1,9,5,4,0,0,0,1,2,11,1,1,0,535,134,13,21,20,1,4816,4800,16,13,13,0,100
f367188cbab673a9c0edb01dbc02fecd8f1949cf,0,0,0,0,0,0,0,0,0,0,0,0,0,0,135,14,0,0,0,0,0,0,0,0,0,100
5731395af67400c84d79e587dfd3249135f266b0,3,22,8,14,0,0,0,1,23,2,2,2,1.552389217,908,136,15,67,66,1,7835,7759,76,34,34,0,100
9f1eafbe2c08b6c6432a0ff77cf2c06ed19a465a,19,759,0,759,19,0,19,1,1,0,1,5,4.204812476,0,137,14,50,0,50,2134,0,2134,49,0,49,97.54672897
e09ea97d130c6f8be986723028442131552ac319,2,13,16,3,0,0,0,1,2,0,1,2,0.578794625,53,138,15,5,5,0,356,389,33,5,5,0,100
ba9dc3e5f55a54753b15108e2a64bc5ab67cd15f,22,993,3,990,10,0,10,1,13,21,6,13,3.71110366,912,39,3,231,132,99,12067,7173,4894,136,77,59,96.88561721
37b6d21d0eb6a6ec7110ab36821803f297995672,32,1216,538,678,13,0,13,1,3,0,1,5,4.78759446,307,139,16,123,60,63,5661,2353,3308,105,59,46,96.6553288
fe50e9b2f752db8893682d6707282d19d823425b,3,88,20,68,1,0,1,2,5,57,1,3,1.539083745,294,140,17,49,46,3,2511,2089,422,26,25,1,99.48892675
511fae36d5779062b26aaa0b497df17813e6a56f,15,216,169,47,0,0,0,1,3,0,1,4,3.691438444,722,141,14,112,108,4,5511,5065,446,94,90,4,99.94331066
61c4d0307cd5ca86f754f7318aa3145e781c5bd4,2,16,0,16,0,0,0,1,4,0,1,1,0.896038233,121,142,15,19,17,2,1094,992,102,16,14,2,100
282261ff6026c5bd35163e5bd2905195714c2908,2,24,29,5,0,0,0,1,5,0,1,1,0.73676801,135,143,16,18,19,1,1054,1094,40,15,16,1,100
b7f3cb4b4d6c3c22902bf485eed787fdf84b5ad8,0,0,0,0,0,0,0,0,0,0,0,0,0,0,40,4,0,0,0,0,0,0,0,0,0,100
ee4df37597b862383eb21a92d187ed13ba93aeea,0,0,0,0,0,0,0,0,0,0,0,0,0,0,41,5,0,0,0,0,0,0,0,0,0,100
d084401b839bab0ef59d0a33673c902382e5d761,23,608,61,547,6,0,6,1,6,0,2,5,3.396495801,846,144,17,189,97,92,8369,5807,2562,134,86,48,98.93138358
ee15d81179c2ee649231dfc5515c3a2741d0e305,0,0,0,0,0,0,0,0,0,0,0,0,0,0,145,18,0,0,0,0,0,0,0,0,0,100
a1cf1c823c55ff1974fa46506b658a0e33548afd,0,0,0,0,0,0,0,0,0,0,0,0,0,0,146,18,0,0,0,0,0,0,0,0,0,100
f5d086c2d91553e7799e3a4f674647fc42703bd9,7,55,25,30,1,0,1,1,6,24,2,3,2.160464493,396,147,19,63,61,2,2821,2767,54,45,43,2,99.72144847
786e307be3af356694b3ade3b3a92857baedff69,1,0,1,1,0,0,0,2,4,0,1,1,0,63,148,20,5,5,0,429,436,7,5,5,0,100
9b5a6ff821b9462639bc60a68f1578f5e16a9fba,0,0,0,0,0,0,0,0,0,0,0,0,0,0,149,21,0,0,0,0,0,0,0,0,0,100
16d744b75d51061de10f8650fb8c476c23f3b21f,0,0,0,0,0,0,0,0,0,0,0,0,0,0,150,22,0,0,0,0,0,0,0,0,0,100
d09ef2583197bacb31f579d17702cf7fa12ab370,0,0,0,0,0,0,0,0,0,0,0,0,0,0,151,23,0,0,0,0,0,0,0,0,0,100
f162485afe9f2fda7c727b084174c18b5a767d50,0,0,0,0,0,0,0,0,0,0,0,0,0,0,152,24,0,0,0,0,0,0,0,0,0,100
e2a62cc8a7810543fb0f4f7ca6f38d7e11b8bb4c,0,0,0,0,0,0,0,0,0,0,0,0,0,0,153,24,0,0,0,0,0,0,0,0,0,100
9ebdd22d422eeeee55393e5f159740f0efa2b0db,1,3,3,0,0,0,0,1,2,311,1,1,0,123,154,23,37,37,0,852,853,1,12,12,0,100
25c6e631ad5f66beb6f6c2f0e7a05210b56ec492,0,0,0,0,0,0,0,0,0,0,0,0,0,0,155,24,0,0,0,0,0,0,0,0,0,100
cad8683ab4832343b47b4f8efbb10c7aeea794aa,0,0,0,0,0,0,0,0,0,0,0,0,0,0,156,25,0,0,0,0,0,0,0,0,0,100
777d4835710ab1857d47d96842c5c622757cac03,3,55,28,27,0,0,0,2,2,18,1,2,1.505091363,138,157,26,13,13,0,1001,1041,40,7,7,0,99.88876529
c1fdad633800aa15fb2d5875d3f03eb986ee9876,0,0,0,0,0,0,0,0,0,0,0,0,0,0,158,27,0,0,0,0,0,0,0,0,0,100
2b97d8bb353f96271e4015e5a73364c50dfa2bb1,0,0,0,0,0,0,0,0,0,0,0,0,0,0,159,28,0,0,0,0,0,0,0,0,0,100
d799350b2ccd5696f0dcfa0329b18072524cf384,0,0,0,0,0,0,0,0,0,0,0,0,0,0,160,29,0,0,0,0,0,0,0,0,0,100
599ec85a29c47d591b5827d266a9c05bbcf7b4ba,0,0,0,0,0,0,0,0,0,0,0,0,0,0,161,30,0,0,0,0,0,0,0,0,0,100
dc67e3ff9a16c1b0309862ccc5027bc06d1d6954,0,0,0,0,0,0,0,0,0,0,0,0,0,0,162,30,0,0,0,0,0,0,0,0,0,100
64f1680cdf180acd8dbd2610587c4af36d5a55dc,0,0,0,0,0,0,0,0,0,0,0,0,0,0,163,30,0,0,0,0,0,0,0,0,0,100
430f1d80f009cb674bc5a851403537c65021218b,0,0,0,0,0,0,0,0,0,0,0,0,0,0,164,31,0,0,0,0,0,0,0,0,0,100
800736a8d7358cb07064bc0c371bab07d5a2f038,0,0,0,0,0,0,0,0,0,0,0,0,0,0,165,32,0,0,0,0,0,0,0,0,0,100
3534d6a0c89ed339fb4cea69680b1069142bbcf3,2,7,3,4,0,0,0,1,2,10,1,1,1,159,166,33,29,29,0,1271,1253,18,14,14,0,100
a6fbf2add4a40c103b5e3146c13804df34c4323c,1,4,2,2,0,0,0,1,6,276,1,1,0,156,167,34,35,35,0,1263,1263,0,15,15,0,100
2384e61b8d98f6e0c4531573d9808b45e3f34d46,0,0,0,0,0,0,0,0,0,0,0,0,0,0,168,35,0,0,0,0,0,0,0,0,0,100
75960e1e04c7c681c9ded552fbe06e0c45f2bd39,1,15,9,6,0,0,0,2,7,72,1,1,0,128,169,36,23,24,1,944,938,6,13,13,0,100
3edf7457893e9ffc6be399182bd9c875208e53a6,0,0,0,0,0,0,0,0,0,0,0,0,0,0,170,37,0,0,0,0,0,0,0,0,0,100
a1f45422a0cc1ae6fa45577b5322e8ba2de5b4b1,0,0,0,0,0,0,0,0,0,0,0,0,0,0,171,38,0,0,0,0,0,0,0,0,0,100
554c534bd5c71027740d266a960e749997efd6a1,0,0,0,0,0,0,0,0,0,0,0,0,0,0,172,39,0,0,0,0,0,0,0,0,0,100
b15a65a6965487b4d90774d56a91f9b5eb0cea2b,0,0,0,0,0,0,0,0,0,0,0,0,0,0,173,37,0,0,0,0,0,0,0,0,0,100
b83a1df394c5f258d9ad8314e8c66a92538793ab,0,0,0,0,0,0,0,0,0,0,0,0,0,0,174,37,0,0,0,0,0,0,0,0,0,100
128e4613cdcc0b5a8c46dc8526969682fba09cc0,1,1,1,0,0,0,0,2,24,42,1,1,0,292,175,38,45,45,0,2121,2115,6,21,21,0,100
d99d680ef1d8cb8f53c07c65f3a52bfa4027547a,0,0,0,0,0,0,0,0,0,0,0,0,0,0,176,32,0,0,0,0,0,0,0,0,0,100
9b2e384f2c7f1775a25891b836a003710385cb82,3,265,1,264,2,0,2,1,3,7,1,2,1.065205523,120,177,33,54,22,32,2535,931,1604,18,8,10,99.72268441
f0ba7ca155b65de67c81ac0e9979c17a52a56caf,4,116,23,93,1,0,1,1,25,74,3,4,1.405571117,209,178,24,24,11,13,2621,2174,447,16,10,6,99.88950276
eddbe54571efcb477853f7a748a9f44a8fe3dc0b,0,0,0,0,0,0,0,0,0,0,0,0,0,0,179,4,0,0,0,0,0,0,0,0,0,100
61ca72e10893fac097643aab490147408a306046,32,677,204,473,8,0,8,1,26,61,8,19,4.0724589,1905,42,0,232,183,49,17515,14840,2675,156,126,30,96.95155144
ae2d31c7a58c85fe2cff3dafa2dbe1e39f331bbc,3,73,0,73,0,0,0,1,5,149,2,2,1.510150647,1389,180,4,113,111,2,10618,10587,31,67,66,1,100
d205789ab938db23a5c9fe806bd261d2a7dd8acc,7,243,6,237,2,0,2,1,9,43,3,5,1.759745083,542,43,1,120,103,17,5051,3801,1250,48,38,10,98.88059701
b2031a71a631ea55f8450616cb45df871cd38525,4,87,1,86,1,0,1,1,13,158,1,3,0.986941435,191,181,2,15,12,3,2210,1705,505,8,7,1,99.84143763
330244a9e4c4f97c1911501169b50ada5e9772fc,0,0,0,0,0,0,0,0,0,0,0,0,0,0,182,2,0,0,0,0,0,0,0,0,0,100
d09c32ee318cb530273c5d9fef0740045bc978af,0,0,0,0,0,0,0,0,0,0,0,0,0,0,183,2,0,0,0,0,0,0,0,0,0,100
7db097623ecdb11e06e31e812aa1a454edf17ad3,0,0,0,0,0,0,0,0,0,0,0,0,0,0,184,3,0,0,0,0,0,0,0,0,0,100
a328c86acd3d311093e91f0e285c80675114ab09,0,0,0,0,0,0,0,0,0,0,0,0,0,0,185,3,0,0,0,0,0,0,0,0,0,100
0d2d0d4206182ef0ec494a976c155508f32e48df,0,0,0,0,0,0,0,0,0,0,0,0,0,0,186,2,0,0,0,0,0,0,0,0,0,100
b395dfe3bb065b8f980b9e8ba438ac3bb89a9af3,0,0,0,0,0,0,0,0,0,0,0,0,0,0,187,3,0,0,0,0,0,0,0,0,0,100
539ea2b89effa32475a9f8ceb97b44cca2fd0f61,0,0,0,0,0,0,0,0,0,0,0,0,0,0,188,4,0,0,0,0,0,0,0,0,0,100
97f2a86c5463c64c3c0f3e83159c4ce02e79eaef,0,0,0,0,0,0,0,0,0,0,0,0,0,0,189,5,0,0,0,0,0,0,0,0,0,100
886d6919ae463e1af1f646dd30271b53f2adbdc7,0,0,0,0,0,0,0,0,0,0,0,0,0,0,190,6,0,0,0,0,0,0,0,0,0,100
9ed2c0246e68bc5025865ab545235e010c65b982,1,6,4,2,0,0,0,2,26,119,1,1,0,291,191,6,46,45,1,2121,2113,8,21,21,0,100
5cd1567c3b0842dd6eb4fec7d3c81404612da288,34,474,259,215,2,0,2,2,27,197,5,18,4.46301904,3926,192,6,752,754,2,30887,27745,3142,307,307,0,95.05980239
47b1d04b12399ccc142685d08488e653d86b3c07,12,866,430,436,6,0,6,1,11,31,2,4,3.077131175,660,44,0,156,118,38,7146,5072,2074,65,42,23,96.37939827
71b94f21ddd6f7385afe2fefbd540504a44e5ab8,4,0,384,384,0,0,0,2,3,158,1,2,1.869762495,244,45,1,0,34,34,0,1817,1817,0,25,25,99.53940635
0511c11b291b1c67a857b90753595b3c6aa66894,3,49,20,29,0,0,0,2,28,149,1,1,1.251174489,337,193,4,51,50,1,2717,2487,230,25,25,0,95.37480064
f68377eccda731dbc9ad5cc246ca930d97f7ade7,7,190,22,168,2,0,2,1,4,91,3,4,2.460890592,382,46,2,65,48,17,3643,2830,813,38,29,9,92.47311828
1ce6e367bbfa0f49eaee19bba19a5fe1b1bf3bdd,6,191,20,171,0,0,0,1,29,195,4,6,2.002434806,799,194,2,169,145,24,6320,5508,812,90,72,18,100
187ab8170f34deb028cedbc3934cb40c3b4fc750,0,0,0,0,0,0,0,0,0,0,0,0,0,0,195,3,0,0,0,0,0,0,0,0,0,100
31deadb643eb618c4b5fbd2d919daf57fe9d7d70,4,142,1,141,1,0,1,1,6,105,4,3,0.827410051,506,196,3,102,87,15,4431,3523,908,52,42,10,97.87330317
a84cd9c262a372fa2c5b7858d4cd233c8b0f5409,1,95,0,95,1,0,1,1,1,0,1,1,0,0,197,4,11,0,11,531,0,531,9,0,9,99.90714949
fb2fa76355c1fcd4cb4da3159f90c203b69610d0,0,0,0,0,0,0,0,0,0,0,0,0,0,0,198,5,0,0,0,0,0,0,0,0,0,100
ad693b0e7aa6c99ebc3455ae00d865505f4198b5,2,373,2,371,0,0,0,1,6,182,1,1,0.047944468,1327,199,6,101,100,1,12595,10184,2411,56,55,1,100
b79d6a8a19ab58ffef1d80a4c11853bd7872fc4c,1,27,20,7,0,0,0,1,7,30,1,1,0,167,200,4,26,22,4,1289,1219,70,12,12,0,100
7194b3c5bcd22ad9c53d55faf2c74b7f86c439ea,1,1,1,0,0,0,0,2,7,41,1,1,0,175,201,5,39,39,0,1201,1201,0,15,15,0,100
c8a0fc54f41a380892d9d7a4f5b4c1b6d927e967,1,580,1,579,0,0,0,2,7,18,1,1,0,875,202,6,32,25,7,11102,7307,3795,22,15,7,100
a841099fc8417de79f4c1d66b9da34ef321a9f76,4,57,13,44,0,0,0,1,5,202,2,4,1.859233079,830,203,7,89,85,4,8004,7748,256,54,51,3,100
6f741af88071cf5220f32280cbcccca2a44d6c5b,0,0,0,0,0,0,0,0,0,0,0,0,0,0,204,8,0,0,0,0,0,0,0,0,0,100
3a6737681c29f795991ae9701dd92d069895dfaf,0,0,0,0,0,0,0,0,0,0,0,0,0,0,205,9,0,0,0,0,0,0,0,0,0,100
ab97f9a04174382e2f12a5763d6b6dc2faac572a,2,60,16,44,0,0,0,1,5,167,2,2,0.297472249,997,206,10,129,119,10,7145,6795,350,60,59,1,100
96db21d40fa39047ecf222990f5cfcf7c72de04c,0,0,0,0,0,0,0,0,0,0,0,0,0,0,207,5,0,0,0,0,0,0,0,0,0,100
795bf86c56bb14236a714353879657d32cbb2c42,1,1,1,0,0,0,0,1,3,72,1,1,0,135,208,6,22,22,0,1009,1007,2,15,15,0,100
234ecc641a8a21e8e387cf0e8bebd77325c6516b,1,2,2,0,0,0,0,1,8,42,1,1,0,175,209,7,25,26,1,1283,1289,6,12,12,0,100
e98c6825ae22955496ecad40622c6f1e0f4b54e2,0,0,0,0,0,0,0,0,0,0,0,0,0,0,210,8,0,0,0,0,0,0,0,0,0,100
21e6d1da388df03e2fd00880ebb258c251ddadbf,23,777,231,546,8,0,8,1,30,97,3,12,3.721882165,1616,47,0,275,241,34,15727,13420,2307,135,117,18,94.98050682
874d6fedf1f73ec2e1f0e04d21999bf0311fba53,21,994,12,982,15,0,15,1,16,54,2,9,4.042938169,479,211,4,151,51,100,9622,4753,4869,82,28,54,97.99095932
80c829f6b96d9db60529f49a6cb873e79b9a1b8a,2,7,2,5,0,0,0,2,9,2,1,2,0.764204507,264,212,5,40,40,0,2564,2530,34,19,19,0,100
41b4b8bea57dd5dae05f5a6892f19acff8e6d7db,24,1780,0,1780,24,0,24,1,1,0,1,4,4.401395818,0,213,2,161,0,161,8283,0,8283,125,0,125,97.36337488
ee8c726100f958a24a0b86812164e1b69d2b916b,1,14,12,2,0,0,0,2,5,394,1,1,0,37,48,0,5,5,0,361,361,0,4,4,0,100
7c91f04411adc6046edb8c41c3c1bfe8a60f5d78,75,5668,602,5066,25,0,25,1,31,268,10,30,4.831570733,7068,214,0,1404,917,487,84141,52121,32020,764,545,219,91.33126935
436d656c76d82c1c1145e420c4ce1c4d0a7f36a0,14,194,59,135,0,0,0,1,15,340,5,9,3.575489224,4153,215,1,347,337,10,39024,37778,1246,212,207,5,95.80658964
b16e33261f0563dbbb880e5ad22107851d593c7a,0,0,0,0,0,0,0,0,0,0,0,0,0,0,216,2,0,0,0,0,0,0,0,0,0,100
f69420eccf0e80b783bee296591c5ab11a2611a8,1,15,1,14,0,0,0,1,2,362,1,1,0,40,217,3,2,2,0,475,385,90,1,1,0,100
e764c5e1afb1e77b8190e33a0c577993ecc9fedb,0,0,0,0,0,0,0,0,0,0,0,0,0,0,218,4,0,0,0,0,0,0,0,0,0,100
0f763c6bb1be3547d4157865df4abb2ae6514318,2,34,0,34,1,0,1,2,16,63,1,1,0.733537929,368,49,1,83,82,1,2967,2863,104,19,18,1,99.82555604
e36fc4a3151d208e4327132f2bffb9e383d2c060,4,311,47,264,2,0,2,1,17,34,1,3,1.514278861,308,0,0,49,16,33,4298,3181,1117,21,9,12,99.78270317
5a0fb8c6406a7541c368f53e768032ee98731bf3,0,0,0,0,0,0,0,0,0,0,0,0,0,0,219,5,0,0,0,0,0,0,0,0,0,100
fdabc69da728cb3960c2e322c9f6b29ea94efd2a,0,0,0,0,0,0,0,0,0,0,0,0,0,0,220,6,0,0,0,0,0,0,0,0,0,100
1c009cdced80f8fede1bc938518ba5b46af2681d,2,3,3,0,0,0,0,1,18,63,1,1,0.918295834,200,221,7,0,0,0,2309,2309,0,0,0,0,100
f8c9504f70e683992171602af50e507bbdee91eb,0,0,0,0,0,0,0,0,0,0,0,0,0,0,222,8,0,0,0,0,0,0,0,0,0,100
cf0bf56745f8ef2dce83f3a029ca6c02efc575c0,3,4,4,0,0,0,0,1,11,0,1,2,1.5,301,1,1,49,49,0,2198,2198,0,21,21,0,100
df2cc164edd409b2aa68ed26092c474558f1d8b8,5,4,17,13,0,0,0,2,10,53,4,5,2.146543163,2788,223,9,126,126,0,26256,26371,115,110,110,0,100
dfba637bcd0f71da70db80740847258c718e9d5a,16,54,54,0,0,0,0,1,7,467,1,4,3.644733115,713,224,10,100,100,0,4845,4845,0,89,89,0,100
a42e121541b89a4eddebd274ad9a46214610f683,1,8,1,7,0,0,0,2,6,43,1,1,0,37,50,1,5,5,0,361,361,0,4,4,0,100
003a60c7eb9b48d83733d8c400f793473d89bde7,9,222,6,216,0,0,0,1,19,130,6,9,1.609421881,2415,225,8,197,185,12,22737,20855,1882,79,72,7,100
126d15b02690c5b58e87616f6c51ba5bf65f7c8a,0,0,0,0,0,0,0,0,0,0,0,0,0,0,226,3,0,0,0,0,0,0,0,0,0,100
d33d044fca900744c4945fdbbe9e2a6e14a1a8a8,0,0,0,0,0,0,0,0,0,0,0,0,0,0,227,4,0,0,0,0,0,0,0,0,0,100
6e52be00a1393f94beea8ffe0e6277c81b24102d,1,2,0,2,0,0,0,2,12,42,1,1,0,155,228,5,23,23,0,1235,1222,13,7,7,0,100
b00493ec999bf3feecd5183040c6fe15636c27a2,0,0,0,0,0,0,0,0,0,0,0,0,0,0,229,6,0,0,0,0,0,0,0,0,0,100
869783e4bb71b7dc65e67cb7184f59a19571d5b9,2,40,26,14,0,0,0,3,20,6,1,2,0.266764988,324,51,1,24,23,1,3420,3335,85,8,7,1,100
07b887083045b7483da16fad5dd2aed50331af8f,1,5,3,2,0,0,0,3,14,0,1,1,0,166,52,2,25,24,1,1310,1300,10,8,8,0,100
3952c850d78bc5273d1cc575f3976209f124463f,0,0,0,0,0,0,0,0,0,0,0,0,0,0,230,5,0,0,0,0,0,0,0,0,0,100
9e4aaf303fa28c7cabd955e3ebbb8c81f6820b28,16,369,82,287,6,0,6,1,27,51,7,11,3.367611207,2254,231,6,145,127,18,20375,22559,2184,95,106,11,97.39629303
52eb9886b55c59b5bc6a877426c050c272b85605,6,93,7,86,1,0,1,1,5,384,3,5,1.781466185,334,232,7,42,37,5,2970,2606,364,40,35,5,98.67579909
660a724fe35ebb3822477f7bf7482ea18a00a225,22,745,151,594,4,0,4,2,28,203,11,16,3.522742864,2288,53,2,205,139,66,22583,19375,3208,119,97,22,97.68064228
5e056a15d5b259ac39ef4fa7123969e7692b9b95,1,24,5,19,0,0,0,1,2,2,1,1,0,174,54,3,44,38,6,1239,1164,75,11,11,0,100
2f9abf6d00c0896d52e0b09397f15c415b484d90,1,1,95,94,0,0,0,2,29,3,1,1,0,116,233,8,2,3,1,474,1322,848,2,3,1,100
04108f9daf59056de15294e2aec770e40eed35a7,1,148,0,148,1,0,1,1,1,0,1,1,0,0,234,9,2,0,2,1137,0,1137,2,0,2,99.91423671
493cfa7e1bc58394fc41c323acbf2a21f04f9f30,2,2,2,0,0,0,0,2,14,4,2,2,1,1434,235,10,39,39,0,12147,12147,0,29,29,0,100
2f135e165e6fbff3221e27e52e5360cbe4c6a870,66,2515,77,2438,27,0,27,1,32,30,11,24,4.98297715,5984,236,11,767,506,261,61467,46617,14850,414,274,140,87.88958148
7998c47fcaea1118c34a10cea97122c9b8b31487,2,95,91,4,1,0,1,1,3,293,2,2,0.999666365,58,237,12,10,1,9,429,682,253,1,1,0,93.57720119
70711f73d5ebd486e18e9725be847aa5dad6e3cf,0,0,0,0,0,0,0,0,0,0,0,0,0,0,238,13,0,0,0,0,0,0,0,0,0,100
3f1ede539d1c8cfa7c0c140b10c001fd0232f64b,27,286,207,79,3,0,3,1,33,158,11,23,3.968295209,5014,239,14,579,569,10,39998,39659,339,268,261,7,96.6
d34100de8fe47671d351c94759f88382b451b43f,1,0,0,0,0,0,0,1,1,0,1,1,0,82,240,15,8,8,0,778,778,0,8,8,0,96.08247423
eb5a6b841270efc340e9170fe36cb2f7a718477f,0,0,0,0,0,0,0,0,0,0,0,0,0,0,241,16,0,0,0,0,0,0,0,0,0,100
7955d8ddf87627b5ae38050bacffe5154c47c355,1,7,9,2,0,0,0,1,2,8,1,1,0,58,242,17,10,10,0,431,429,2,1,1,0,100
e2bdee47e6f423ab75663b5ced7fe062d5cab743,2,66,66,0,0,0,0,2,17,3,2,2,0.439496987,1458,243,18,40,40,0,12521,12521,0,30,30,0,100
ae535b2eddc627d351b072dc8219647f8ce2afe1,2,2,2,0,0,0,0,1,2,180,1,1,1,60,244,19,10,10,0,411,411,0,10,10,0,100
1c2727cc27d851f9d97813cb056f85e3a6fb9526,8,218,18,200,1,0,1,1,21,125,3,5,2.298169269,506,55,4,63,60,3,6358,4644,1714,32,28,4,99.21030756
5467a33da724eb0e01aa4285e413ae1a82514b1b,12,174,145,29,0,0,0,1,18,120,6,10,2.552406589,3109,245,20,225,224,1,25406,25360,46,149,148,1,96.62781016
36034a692436e2b832ac233ce05fe0a72881543e,1,13,9,4,0,0,0,2,12,351,1,1,0,154,246,21,33,33,0,1120,1096,24,13,13,0,100
a90743be7fab4013709244912194c4660fb8d81c,4,13,12,1,0,0,0,1,19,2,3,3,1.459470571,2310,247,21,117,117,0,18729,18729,0,70,70,0,100
d2cb48b8b6bf47b1fc6db1b7449430766febc30a,3,133,26,107,1,0,1,1,5,7,2,3,1.040445819,573,248,22,48,32,16,4905,4519,386,41,27,14,99.87437186
91da46f24d6157180076dd73853a159f43b24846,1,7,12,5,0,0,0,1,3,77,1,1,0,534,249,23,29,29,0,5654,5662,8,29,29,0,100
e60093da1fe79f8bfec53a7a8500df0cce96e8a6,10,285,27,258,4,0,4,1,10,6,3,5,2.684638928,580,56,5,78,60,18,6061,5100,961,50,40,10,96.40872168
2df1fd94c3dc739426845965a15ce4e85491de5e,1,2,1,1,0,0,0,2,20,0,1,1,0,1376,250,24,32,32,0,11793,11795,2,22,22,0,100
ca6f9dd4f25b875567f97251ac80ae386c9400be,1,11,19,8,0,0,0,2,2,354,1,1,0,191,251,25,33,33,0,1389,1449,60,10,10,0,100
5ab0569ed251d29d1a65c7deb4b22f01d383ed76,2,8,6,2,0,0,0,2,13,1,2,1,0.863120569,344,252,26,67,66,1,2523,2509,14,23,23,0,100
86c136a9eb6b3c3ba051ed0cf04504ecb7d2ff75,2,23,2,21,0,0,0,2,21,0,2,2,0.40217919,1562,253,27,71,65,6,13333,13182,151,33,32,1,100
e2066967974f5562b264200364e219ff0d390a03,2,6,1,5,0,0,0,2,18,6,1,2,0.985228136,535,254,28,116,116,0,4107,4056,51,31,31,0,100
249a56e8900d6e1adffedc63434138cf67fb765f,7,19,22,3,0,0,0,1,22,11,3,5,2.320281255,1836,255,29,233,233,0,14500,14506,6,85,85,0,100
00e739dffcd83a3b41be13dfdd80cbfb86853ce1,7,60,19,41,0,0,0,2,5,7,3,4,2.351390483,434,57,6,34,36,2,4496,4146,350,24,23,1,94.0688511
afe298efe8da57c6791ccd009a0c0dfbe1ff2e0d,1,33,1,32,0,0,0,2,16,3,1,1,0,163,58,7,38,34,4,1417,1181,236,14,13,1,100
e338fe64f94dfa5365b699faa6f8621ce3f59bf2,60,1791,571,1220,9,0,9,1,23,84,7,22,5.152101931,4644,256,26,589,470,119,51024,42675,8349,299,249,50,90.60934891
9567e7c05d1db7e65d7e9861bc23cfbb95e16a0a,13,106,60,46,1,0,1,1,24,83,6,9,2.860032033,2972,257,27,179,188,9,24990,26747,1757,117,131,14,97.71428571
e6e62bf132bf77926051326ff78121ecdaf78c34,0,0,0,0,0,0,0,0,0,0,0,0,0,0,258,28,0,0,0,0,0,0,0,0,0,100
f778608a1162428001fb860dd1e633b606a67a87,1,1,1,0,0,0,0,1,3,12,1,1,0,58,259,27,10,10,0,431,431,0,1,1,0,100
a4fa09b744edf32e1035e87d0f70f07275f71b6e,0,0,0,0,0,0,0,0,0,0,0,0,0,0,260,28,0,0,0,0,0,0,0,0,0,100
3d2afec68f44d7eb866e46f56dab368cce4e5511,6,241,4,237,1,0,1,1,25,323,3,5,1.2509725,432,59,6,59,28,31,5135,4172,963,36,21,15,94.6407767
d3cc6164a6d8435fe2b5122c8913fd1a1f0a9574,3,9,2,7,0,0,0,1,26,0,1,2,1.494918848,363,60,7,29,28,1,3568,3489,79,19,19,0,95.30046225
7bce170df14d26afb4fb0a3ae6d3799568471e87,1,28,13,15,0,0,0,1,6,0,1,1,0,99,61,8,16,13,3,838,761,77,8,7,1,100
fd2a44155a8ce902c309eeebe54cabad7221ae74,7,135,66,69,1,0,1,2,23,58,3,6,1.9508018,1832,261,28,124,121,3,15819,15328,491,54,52,2,97.49890303
899de15d05fa60775f6cd04225f35950e6fa96a7,2,126,108,18,0,0,0,1,10,16,1,2,0.070998947,150,262,29,19,17,2,1195,1109,86,19,17,2,99.95503597
031d4c61f5f2f69b179a66918fecab2d8ccb16d5,7,48,19,29,0,0,0,1,27,109,2,3,2.309459448,941,62,9,154,149,5,7924,7697,227,59,59,0,99.549955
64b33bf804bccaf111762a006d97c2558a167aec,1,0,1,1,0,0,0,3,28,0,1,1,0,179,63,10,0,0,0,2206,2213,7,0,0,0,100
371708bb7bf0682a35669d08559a90258b39a192,0,0,0,0,0,0,0,0,0,0,0,0,0,0,263,30,0,0,0,0,0,0,0,0,0,100
d73f730a05ee845bf4ca97423a1b57fcca79a4fb,1,21,2,19,0,0,0,3,7,82,1,1,0,37,2,0,8,5,3,511,361,150,4,4,0,100
0f51ced29ef46934df06918afc76dc7e12cfd603,0,0,0,0,0,0,0,0,0,0,0,0,0,0,3,1,0,0,0,0,0,0,0,0,0,100
c44e01027f393d11f6e843c2b30169f2f43a0a9e,2,93,0,93,1,0,1,1,1,0,1,2,0,58,264,31,20,10,10,862,431,431,2,1,1,99.729973
87012696d89cdf9b6794ce82a6629f6f06ff3745,5,13,54,41,0,0,0,1,24,8,3,3,1.523567781,2989,265,32,102,102,0,29734,29734,0,87,87,0,100
a6fdb19fd17877539cb96f26d2f999b894c3629b,7,27,29,2,0,0,0,1,25,15,4,5,2.376717193,3133,266,33,110,110,0,31214,31229,15,94,94,0,100
e5484ea111ef177cc7cbeb3ca7cf91a8eb9d9ad4,4,5,5,0,0,0,0,2,26,6,4,3,1.921928095,1486,267,34,45,45,0,12739,12739,0,33,33,0,100
e7e518e2602ee87be63262474aa47be2ffdddd3f,10,131,76,55,0,0,0,1,29,174,6,8,2.059384367,2825,268,35,184,199,15,26460,26375,85,110,112,2,100
1ea67de774e1ab18f90a3391282265c8ae458318,5,8,8,0,0,0,0,2,30,26,4,5,2,2027,269,36,124,124,0,17768,17768,0,50,50,0,100
d6d6c194cc29be1347f9ab50ee6e33591f963c69,3,3,3,0,0,0,0,2,29,10,3,3,1.584962501,1488,270,37,49,49,0,12663,12663,0,30,30,0,100
7756104bca5eea99aee264c617a2bf2c8282e3e3,2,64,64,0,0,0,0,2,30,0,2,2,0.337290067,1451,271,38,40,40,0,12673,12673,0,30,30,0,100
209d23bcd977a68c6518cdcd26d8a544e83fb4e1,1,2,1,1,0,0,0,2,34,31,1,1,0,324,272,39,53,53,0,2374,2374,0,23,23,0,100
4d3cb03bc436231b09d7545f18199027f5afe46f,2,2,2,0,0,0,0,1,9,0,2,2,1,570,273,40,33,33,0,6813,6813,0,23,23,0,100
45b70a1a8489615abb1d08a70e4afecd006ab3b1,0,0,0,0,0,0,0,0,0,0,0,0,0,0,274,41,0,0,0,0,0,0,0,0,0,100
5064bd3055dd86095bd36b2d55c99f9977d654f5,1,6,3,3,0,0,0,1,3,40,1,1,0,189,64,10,45,44,1,1256,1239,17,11,11,0,100
401718e4b5c2ded82804f1013dd2c20da73189f0,3,36,18,18,0,0,0,1,31,7,1,2,1.052940761,488,65,10,57,54,3,4600,4526,74,22,22,0,100
b37943a0039560e3929e6540f8d1f6dcfd0a58e9,1,18,6,12,0,0,0,1,5,36,1,1,0,514,275,40,121,118,3,3514,3426,88,25,25,0,100
99e172ca1612a64bec22f87e3473e3634b3fe87c,1,20,1,19,0,0,0,1,4,39,1,1,0,162,276,41,13,12,1,1867,1716,151,11,10,1,100
e5196a5339ea63073e1ac7b0b1a720a3a9c74063,0,0,0,0,0,0,0,0,0,0,0,0,0,0,4,2,0,0,0,0,0,0,0,0,0,100
cf316b3c1a948357fb3040940951c42fa738d768,2,2,1,1,0,0,0,2,31,133,2,2,0.918295834,1511,277,40,54,54,0,12816,12802,14,37,37,0,100
6859ba79515c2d80f1f65cf7b3ca32686522d9bb,0,0,0,0,0,0,0,0,0,0,0,0,0,0,278,41,0,0,0,0,0,0,0,0,0,100
93a482278de24c3e29bdb276fae58ca7ba0ea1c7,0,0,0,0,0,0,0,0,0,0,0,0,0,0,279,41,0,0,0,0,0,0,0,0,0,100
288cf916bedecb31ac73b293f0262becb97ed4e0,3,18,13,5,0,0,0,1,5,466,1,3,1.417973441,163,280,41,30,30,0,1161,1091,70,25,25,0,100
028e5a6fc17599a183fa929298390aef08d8912d,0,0,0,0,0,0,0,0,0,0,0,0,0,0,281,42,0,0,0,0,0,0,0,0,0,100
d7d65578cf4fb554b89e5c1794f451188f6adc0d,0,0,0,0,0,0,0,0,0,0,0,0,0,0,282,43,0,0,0,0,0,0,0,0,0,100
8a91cb47253137b1e0a495194c950dcf2fec86dd,0,0,0,0,0,0,0,0,0,0,0,0,0,0,283,44,0,0,0,0,0,0,0,0,0,100
75c829edd288845d220d6985696f15cef16eb5ef,0,0,0,0,0,0,0,0,0,0,0,0,0,0,284,45,0,0,0,0,0,0,0,0,0,100
b728b48a79e5b249a86773209ec4160a254becfa,1,20,16,4,0,0,0,2,2,63,1,1,0,175,5,3,39,39,0,1217,1203,14,15,15,0,100
58fbc94e34987d1ed209d1b501d334e7818f5acd,1,2,56,54,0,0,0,3,16,10,1,1,0,175,6,4,27,27,0,1354,1344,10,8,8,0,100
f7d10cde8d8f38823adffb1fee8cda7d70436920,1,15,15,0,0,0,0,2,3,23,1,1,0,156,7,5,11,11,0,1282,1249,33,11,11,0,100
17f2787850682e727babfe368031c11c699f29a4,2,1036,0,1036,2,0,2,1,1,0,1,2,0.625555878,0,285,45,86,0,86,5198,0,5198,49,0,49,99.77568416
bd29a4c9a817279ac20c6f39567f43546b71d1db,0,0,0,0,0,0,0,0,0,0,0,0,0,0,286,46,0,0,0,0,0,0,0,0,0,100
82edc13b4dce67c8a59227edde6d3220e4f45c43,1,1,1,0,0,0,0,3,17,5,1,1,0,175,8,6,27,27,0,1354,1354,0,8,8,0,100
700023750cc1399952761555514c59ca94e5c70b,2,45,13,32,0,0,0,2,5,35,2,2,0.999142104,261,66,11,66,58,8,1784,1655,129,16,16,0,100
38b6f561da24804db43a7480673a973ec01b437e,0,0,0,0,0,0,0,0,0,0,0,0,0,0,287,42,0,0,0,0,0,0,0,0,0,100
8542db9c7a7eaaa953da2b78e0a272a297fe7e71,0,0,0,0,0,0,0,0,0,0,0,0,0,0,288,43,0,0,0,0,0,0,0,0,0,100
942842a7001dfda35d0197f18d7d44199ff5b572,2,79,0,79,0,0,0,2,32,14,2,2,0.914018511,1469,289,44,42,40,2,13218,12637,581,31,30,1,100
d03cf8c98d86fc0d274b16a19c9e0fbadf4b68b6,0,0,0,0,0,0,0,0,0,0,0,0,0,0,290,45,0,0,0,0,0,0,0,0,0,100
c72c1327ea5040bd6d9c362feb5d62f99103b71e,4,91,27,64,1,0,1,2,33,24,3,4,1.204463891,1480,67,11,51,44,7,12777,12591,186,33,28,5,99.2014197
af92049c7d27cabd5c158c19848882da5c4ab487,0,0,0,0,0,0,0,0,0,0,0,0,0,0,291,46,0,0,0,0,0,0,0,0,0,100
832e86c86e0a82b93fa651f926f3bf76a43cdead,2,65,17,48,0,0,0,2,18,61,1,2,0.686438167,229,9,7,34,29,5,2189,1829,360,11,9,2,99.69271291
34492a25850271db552d84a83c61a58e90e216d6,2,32,4,28,0,0,0,2,8,28,2,2,0.581321499,176,292,44,18,17,1,1563,1378,185,13,12,1,100
ce815ba01cc1546ea3066a6485086ac74be8b25f,0,0,0,0,0,0,0,0,0,0,0,0,0,0,293,45,0,0,0,0,0,0,0,0,0,100
49d4e9824482877ae6b8b12f900e2014a02796b6,0,0,0,0,0,0,0,0,0,0,0,0,0,0,294,44,0,0,0,0,0,0,0,0,0,100
f976aacb3ce222bc6d3dc7df482cab9c4d3c0d4d,0,0,0,0,0,0,0,0,0,0,0,0,0,0,295,44,0,0,0,0,0,0,0,0,0,100
46e5f878314e08332ff22f7b6b002a23116243f3,0,0,0,0,0,0,0,0,0,0,0,0,0,0,296,45,0,0,0,0,0,0,0,0,0,100
6dc462f3ddd1c5d9b33c51d6b72276fed5b783b8,0,0,0,0,0,0,0,0,0,0,0,0,0,0,297,46,0,0,0,0,0,0,0,0,0,100
8424e515098d85dc3334e65cb96baa82d192b8da,0,0,0,0,0,0,0,0,0,0,0,0,0,0,298,47,0,0,0,0,0,0,0,0,0,100
4e0f7df057338c936bee8a722f26b3580b2c7798,0,0,0,0,0,0,0,0,0,0,0,0,0,0,299,44,0,0,0,0,0,0,0,0,0,100
6ef000d0f980def110e3e9eda5a858cc0642fe6b,0,0,0,0,0,0,0,0,0,0,0,0,0,0,300,45,0,0,0,0,0,0,0,0,0,100
f7985c7702660c5a761278d6d0419101f1f55cc5,6,1083,24,1059,2,0,2,3,19,27,2,4,1.149181801,377,10,8,139,46,93,8335,3128,5207,74,22,52,99.69392217
ddb4be6f03d4f7dec3cea655b7b4227f64194c5c,0,0,0,0,0,0,0,0,0,0,0,0,0,0,301,45,0,0,0,0,0,0,0,0,0,100
65fefc3e839b661df7a766cd6aae115090cebaa4,0,0,0,0,0,0,0,0,0,0,0,0,0,0,302,46,0,0,0,0,0,0,0,0,0,100
508ca8df60faf8631bede927cfee75df43d52aa2,1,5,5,0,0,0,0,3,32,20,1,1,0,185,303,47,0,0,0,2285,2285,0,0,0,0,100
ef58c3d655893884f32502044a62039851e78462,0,0,0,0,0,0,0,0,0,0,0,0,0,0,304,48,0,0,0,0,0,0,0,0,0,100
b912ed6898e7b0c93ca2a41f1f96e2ce86a3ea21,0,0,0,0,0,0,0,0,0,0,0,0,0,0,305,0,0,0,0,0,0,0,0,0,0,100
e7057b723fcd524c1f120523542be5bb24b83a95,1,5,1,4,0,0,0,2,4,105,1,1,0,47,68,0,7,7,0,286,284,2,6,6,0,100
382237d16af0d94cf2e8cbac15476c07afcd591d,0,0,0,0,0,0,0,0,0,0,0,0,0,0,69,0,0,0,0,0,0,0,0,0,0,100
48fae88a597f730064a5f57f8e4f760806771407,0,0,0,0,0,0,0,0,0,0,0,0,0,0,70,1,0,0,0,0,0,0,0,0,0,100
eb491fc236bc11756f2e54313d9ee699e7088d2d,1,3,3,0,0,0,0,2,2,348,1,1,0,25,71,2,6,7,1,131,138,7,5,5,0,100
e26b7c111d643c6dc9519f91283ce2ab3bce08cd,0,0,0,0,0,0,0,0,0,0,0,0,0,0,72,3,0,0,0,0,0,0,0,0,0,100
7dec7eb44e88ab322c91bb25be746f03835a7efb,1,10,6,4,0,0,0,1,2,745,1,1,0,125,306,0,27,26,1,842,832,10,13,13,0,100
4288cfe140fe36bcc0fa268d5bc405185eb873ad,0,0,0,0,0,0,0,0,0,0,0,0,0,0,307,1,0,0,0,0,0,0,0,0,0,100
ef3ec3546e3dedcc2b8c399fa386dd38b161d83b,4,286,9,277,2,0,2,2,21,94,2,4,1.605092248,500,308,2,107,85,22,5789,4269,1520,28,20,8,93.05555556
184ee06e10def9be34be9feaa2e864080edb92b0,5,357,3,354,4,0,4,1,35,37,2,2,1.736878559,324,309,3,74,53,21,4119,2374,1745,44,23,21,99.38110749
9901058dc9dbf95b1e98311273f94eb623ecc8fe,6,300,1,299,4,0,4,2,34,61,2,5,2.356051877,2206,73,0,127,110,17,18910,17466,1444,73,64,9,99.42215088
6a4101a0e08faf38af51c6812b9d84981221021a,7,659,0,659,6,0,6,1,7,30,3,4,2.16582957,177,310,4,69,28,41,4706,1283,3423,53,18,35,84.96884735
03853f968e32fccd5a8bf45afe9b842648f5936c,6,21,1,20,0,0,0,2,9,186,6,6,2.305609892,432,74,1,52,50,2,4150,3983,167,44,43,1,100
6fac4afab1bcd92cfea3bae2a077b49a5fcebfd7,4,64,46,18,0,0,0,2,35,133,2,2,1.822576348,2601,311,5,178,175,3,20480,20430,50,88,86,2,100
c9b2e5514c36e7540080ae47b4c9d1e1cecfd645,2,41,17,24,0,0,0,2,36,0,2,2,0.767651587,1551,75,2,44,42,2,13157,12997,160,28,27,1,100
0af32a36821299b00f26dff4c632f5fe085bbc3a,13,2879,297,2582,6,0,6,1,37,219,3,5,1.595172108,2942,312,6,399,176,223,32201,23092,9109,215,116,99,88.60485269
40abc86cd0b9c366005583bec9ea4f0ccbf8d900,0,0,0,0,0,0,0,0,0,0,0,0,0,0,76,3,0,0,0,0,0,0,0,0,0,100
b5f3020659fe082ae7b7ad63556ef468e764de4a,5,52,29,23,0,0,0,1,5,388,3,4,1.663429984,291,77,4,35,31,4,2301,2154,147,19,17,2,100
61e85e0b89b415361159bb973d050bdd8ab92acb,1,21,0,21,0,0,0,1,2,14,1,1,0,45,313,7,11,5,6,555,395,160,4,3,1,100
b5ba2c01640bf2f9bd954942dc183917a07cec32,3,416,0,416,3,0,3,1,1,0,1,2,1.095496353,0,11,0,44,0,44,1703,0,1703,25,0,25,99.73210869
f5caa30c3e6ba185ccbead70503f74fb81d01896,0,0,0,0,0,0,0,0,0,0,0,0,0,0,12,1,0,0,0,0,0,0,0,0,0,100
afd623fa01ce668832bc6b3b0661fad8a7033857,0,0,0,0,0,0,0,0,0,0,0,0,0,0,13,2,0,0,0,0,0,0,0,0,0,100
12efad854b8c4c347bb882c0920f8d4404b3e7b2,0,0,0,0,0,0,0,0,0,0,0,0,0,0,14,3,0,0,0,0,0,0,0,0,0,100
88b31cf54e6aea000e49242aff8b407b474891fb,3,4,4,0,0,0,0,3,8,75,2,3,1.5,337,15,4,21,21,0,3154,3154,0,13,13,0,99.84732824
ad6a2aa769e5184e1f6df92b5d303e045aba686b,1,29,10,19,0,0,0,1,2,0,1,1,0,58,16,5,7,5,2,535,429,106,5,5,0,99.96183206
8a9c3adc029a1264d1a1c04494bb11ab8857b874,1,16,2,14,0,0,0,3,5,251,1,1,0,128,17,6,30,28,2,945,891,54,9,9,0,100
d4d9be2ae0e920f1c9c8caf2c43436b78f5c4043,0,0,0,0,0,0,0,0,0,0,0,0,0,0,18,7,0,0,0,0,0,0,0,0,0,100
41284da8c6faac7366bb1b85111b0ad113ebc35d,3,57,24,33,0,0,0,2,5,976,3,3,0.659086787,230,19,8,34,31,3,2123,1941,182,26,25,1,99.88545246
11b5c64fdd42546812e0d39d33d6b22f803b749d,2,8,2,6,0,0,0,1,3,215,1,2,1,116,314,8,20,20,0,876,862,14,2,2,0,100
841be250a382207abbed2a72e3b765b66ae1be0e,1,273,0,273,1,0,1,1,1,0,1,1,0,0,20,9,14,0,14,1702,0,1702,13,0,13,95.98230741
e39cd9ebec5ee1c6d44c96434d828bbabe3dc976,0,0,0,0,0,0,0,0,0,0,0,0,0,0,78,5,0,0,0,0,0,0,0,0,0,100
477f70a53b4fa8544b0ff2980e772b19dc5c0cb1,0,0,0,0,0,0,0,0,0,0,0,0,0,0,79,6,0,0,0,0,0,0,0,0,0,100
c007921252d51858fc87a627265dc88b1db50a99,0,0,0,0,0,0,0,0,0,0,0,0,0,0,80,7,0,0,0,0,0,0,0,0,0,100
395de9bc5a8ee18a223d864196b59106234e7898,4,70,7,63,0,0,0,1,9,19,2,3,1.389532829,342,21,10,47,36,11,3148,2764,384,26,23,3,94.18221734
db3ec3bb8060d9cab99a37802de934d357b1b202,3,126,4,122,1,0,1,1,38,44,2,2,1.241403307,2329,315,0,128,112,16,19098,18333,765,71,66,5,99.92481203
378426edf82c60cc2988af24d8835a3520a38f0d,0,0,0,0,0,0,0,0,0,0,0,0,0,0,22,0,0,0,0,0,0,0,0,0,0,100
602702228235dfd60ada3c0a425fa1801ed9eda9,4,165,68,97,0,0,0,1,3,56,2,3,0.367893266,540,23,1,81,67,14,4100,3693,407,44,41,3,100
08625fca674c4739c4b694d843037c6ec5da65db,1,275,0,275,1,0,1,1,1,0,1,1,0,0,24,2,14,0,14,1711,0,1711,13,0,13,98.56424982
79feb9364755ebd4a67018fb48a100ca3333e54d,13,929,48,881,12,0,12,1,5,20,3,7,3.443846847,215,81,0,128,52,76,4399,1375,3024,54,11,43,98.73287671
539b13f8b8c31e1cb5bf7feab1a910591528ee34,1,6,5,1,0,0,0,1,4,21,1,1,0,84,25,3,16,15,1,473,460,13,7,6,1,100
eaf6a08069e0caa2d9efca1b9489fef5d00a44f0,0,0,0,0,0,0,0,0,0,0,0,0,0,0,26,4,0,0,0,0,0,0,0,0,0,100
5735acfb19c446558b6c2f8d3359f6704bda7f19,0,0,0,0,0,0,0,0,0,0,0,0,0,0,27,5,0,0,0,0,0,0,0,0,0,100
6aaa7021a10febd04e9e41faa0f58be11ec5891c,17,181,82,99,0,0,0,3,36,284,4,9,2.95019215,3228,316,0,371,365,6,25021,24866,155,211,209,2,100
4f5bf9bb5b55740c3e9bde50dda71d51abda6b0a,10,82,32,50,0,0,0,1,37,119,4,4,2.843770236,2206,317,1,249,248,1,16453,16168,285,156,155,1,100
2096d0d4222bd4df83b6668f2902ffe37b9d1334,0,0,0,0,0,0,0,0,0,0,0,0,0,0,318,2,0,0,0,0,0,0,0,0,0,100
5c0b0f6b5312909f2aab082f600449be54225040,0,0,0,0,0,0,0,0,0,0,0,0,0,0,28,1,0,0,0,0,0,0,0,0,0,100
a9e7deaeef46104faf10146aed9f5084b3275d84,12,858,17,841,3,0,3,2,34,184,2,7,2.046540007,874,82,0,197,107,90,11461,7472,3989,88,44,44,98.22190612
f69acbbc4d02c12884101e7c8145efb77ef98f59,41,2689,11,2678,27,0,27,1,38,165,6,13,4.756318495,1706,319,3,497,302,195,25702,12133,13569,246,127,119,92.27537169
3fbe52952471c83fab3c820c606ef9dd15e2c830,1,4,4,0,0,0,0,1,2,0,1,1,0,233,320,4,33,33,0,1816,1816,0,15,15,0,100
566dbefeab6cb684d6acf1a7d1b04f22a4df250c,0,0,0,0,0,0,0,0,0,0,0,0,0,0,321,2,0,0,0,0,0,0,0,0,0,100
bfc23acde6bae3ed1fc0e66487e96edcd27361c8,0,0,0,0,0,0,0,0,0,0,0,0,0,0,0,0,0,0,0,0,0,0,0,0,0,100
705c0a61c9b3405567bb4528b42844beff1d2fc6,3,56,29,27,0,0,0,3,35,93,2,2,0.311946963,499,0,0,58,56,2,4891,4712,179,35,31,4,94.30894309
567bdb2b3cda84f0b149c29b5c11a6fc8dca3497,1,1,0,1,0,0,0,3,7,212,1,1,0,77,1,1,8,8,0,925,916,9,8,8,0,100
8ec228fa863c594a6222de00b9b3c5600f6db6e8,0,0,0,0,0,0,0,0,0,0,0,0,0,0,322,3,0,0,0,0,0,0,0,0,0,100
af4d63ceb0f93a3433495e05e4f14de93e003d36,0,0,0,0,0,0,0,0,0,0,0,0,0,0,323,4,0,0,0,0,0,0,0,0,0,100
bcccb165792b69319e8e44178b6ed0df92995bd0,0,0,0,0,0,0,0,0,0,0,0,0,0,0,324,5,0,0,0,0,0,0,0,0,0,100
b4080876b1b3d82183281d60913a71f2a64871e8,2,23,7,16,0,0,0,2,7,515,1,2,0.970950594,1244,0,0,162,160,2,11819,11688,131,70,69,1,100
dffc53d323d95fe9de392bdaa73ad7c0e75d6f13,1,4,0,4,0,0,0,1,2,50,1,1,0,351,83,0,59,58,1,1994,1976,18,23,23,0,100
a8792293a434999ddd0ec79995b7c695b67672a1,1,4,5,1,0,0,0,1,3,0,1,1,0,355,84,1,59,59,0,1994,1994,0,23,23,0,100
16536f9ce0252ff3f9198d309471e5663b29eeb8,2,9,15,6,0,0,0,1,4,37,2,2,0.994984828,485,325,4,85,86,1,2832,2862,30,36,36,0,100
32a88702f235302b6b636bafac7cb7743765a7d8,1,8,5,3,0,0,0,1,3,0,1,1,0,351,326,5,59,58,1,1994,1976,18,23,23,0,100
2c72ac5fd605ec26e7bf2ee9a7e274aa39077f5a,2,10,3,7,0,0,0,4,36,75,2,2,0.779349837,464,29,0,49,49,0,4195,4119,76,22,22,0,100
53f76396a4e274e184300b246fd7a88e2ccafbc3,5,86,5,81,1,0,1,2,4,113,2,4,1.634917881,698,85,2,110,102,8,5130,4673,457,56,50,6,99.76484421
c58ee3b039abecb5dc05d4ca83822c87bffe4cb0,4,105,61,44,0,0,0,2,37,71,3,3,1.504942747,701,30,1,46,44,2,6522,6272,250,34,33,1,94.5368171
02e2e0c68013e115a0d919ab9aa8ccedc7e96ac4,0,0,0,0,0,0,0,0,0,0,0,0,0,0,31,2,0,0,0,0,0,0,0,0,0,100
38f2c1433f30b69c272fa3135e302ddbcac47d1e,0,0,0,0,0,0,0,0,0,0,0,0,0,0,32,3,0,0,0,0,0,0,0,0,0,100
ca2e1596c5f0ebc798d1f8d93bccbf452e29c149,1,8,0,8,0,0,0,1,3,4,1,1,0,122,86,3,5,5,0,1201,1131,70,5,5,0,100
117af3f0cef2f808372b9806daeda928758ad7fd,1,0,1,1,0,0,0,1,2,5,1,1,0,31,87,4,5,5,0,246,255,9,4,4,0,100
bf3dcd7c996f9292c04932656664549bf90c54f6,3,89,24,65,0,0,0,2,7,3,2,2,1.380554767,534,33,4,45,46,1,4344,4142,202,33,34,1,99.66877447
cae6a6dffe0bcb39ccb0ebfd318baf773ad57a3f,0,0,0,0,0,0,0,0,0,0,0,0,0,0,327,6,0,0,0,0,0,0,0,0,0,100
de67dcb890d0ed5a97c1073d8d79280707913e9e,0,0,0,0,0,0,0,0,0,0,0,0,0,0,328,7,0,0,0,0,0,0,0,0,0,100
a346a8efa332d637c45b04fe0f247295ad21a3c2,2,74,18,56,0,0,0,2,5,14,1,2,0.388238978,485,329,8,70,65,5,3709,3204,505,30,29,1,100
92cead13be1cc2b48af98cc929c8982400ef5b02,2,12,4,8,0,0,0,1,3,251,1,2,0.954434003,93,88,5,18,16,2,755,663,92,7,7,0,100
82d967cdb380c6aeffa724a9a6340d09774739e8,1,16,6,10,0,0,0,1,2,252,1,1,0,72,330,8,7,7,0,443,397,46,4,4,0,100
c44a0957e2c9deb2415ddb0202522582b3451136,2,1,7,6,0,0,0,2,10,55,1,2,0.543564443,426,1,1,61,61,0,3635,3720,85,35,35,0,100
ac882796a7c2ce93fb79f68dd7383f721fedab57,1,1,2,1,0,0,0,1,8,256,1,1,0,177,331,6,28,28,0,1276,1283,7,18,18,0,100
48e42a32bae71a1ea1a1b035d7da19209af59703,0,0,0,0,0,0,0,0,0,0,0,0,0,0,34,5,0,0,0,0,0,0,0,0,0,100
d82e991a3ae1e9c60a892f4b8570dffbd659f17e,0,0,0,0,0,0,0,0,0,0,0,0,0,0,35,6,0,0,0,0,0,0,0,0,0,100
aff2b8465675f933c9c53fdaa2a5ae5a491cb5b8,0,0,0,0,0,0,0,0,0,0,0,0,0,0,36,7,0,0,0,0,0,0,0,0,0,100
86a6c6085265137fe6a7a8ff6a61ab60bb944ea9,3,5,5,0,0,0,0,2,8,39,2,2,1.370950594,705,37,8,77,77,0,5299,5299,0,40,40,0,100
c926db698b926ed7495684f3d3049fe570749b21,1,7,1,6,0,0,0,1,2,171,1,1,0,37,89,6,4,4,0,323,275,48,4,4,0,100
cb5fce360b06e7a1b77e58b6366075daccd3132e,3,148,28,120,1,0,1,2,39,140,2,3,1.209111568,1604,332,5,55,51,4,14412,13542,870,33,31,2,99.32193396
9c392896295d36a18b8929282aca8c187bff2bd7,2,301,3,298,1,0,1,1,39,42,2,2,0.120999418,334,333,6,75,52,23,4363,2574,1789,40,25,15,99.94236311
0e9aa874615a88132a0b666e2847b2931316b9db,1,22,5,17,0,0,0,1,2,6,1,1,0,224,334,7,25,23,2,1891,1796,95,15,15,0,100
a6317fc81a76c54425d1df07d4fe466ef4c5e3a5,1,10,2,8,0,0,0,1,3,0,1,1,0,237,335,8,25,25,0,1933,1891,42,15,15,0,100
1333808b075cf6b3f64a3f6fdcbc0ebee6309065,1,22,16,6,0,0,0,1,4,3,1,1,0,241,336,9,27,25,2,2017,1933,84,15,15,0,100
9fd276bba2f0960b15d76668441610dd7810d6ec,1,1,1,0,0,0,0,1,5,9,1,1,0,251,337,8,27,27,0,2017,2017,0,15,15,0,100
3b4a5e8d456634cce46c662866386566fb1af8cb,0,0,0,0,0,0,0,0,0,0,0,0,0,0,338,9,0,0,0,0,0,0,0,0,0,100
210c94e742fb64570094ee9cb96a00a963315462,0,0,0,0,0,0,0,0,0,0,0,0,0,0,339,10,0,0,0,0,0,0,0,0,0,100
4634bebea6a7875a9f0c93f3072b28430bf520eb,0,0,0,0,0,0,0,0,0,0,0,0,0,0,340,11,0,0,0,0,0,0,0,0,0,100
dd65dcc6c79a504a914a3c3722a1dc52c4f762c2,1,1,1,0,0,0,0,2,4,65,1,1,0,278,2,1,49,49,0,1838,1838,0,22,22,0,100
9423ded73871c19f82c4b54c33bf0108328e55a8,0,0,0,0,0,0,0,0,0,0,0,0,0,0,38,4,0,0,0,0,0,0,0,0,0,100
a5362cad587f47a33998561534b160e08216cbd5,8,321,166,155,0,0,0,1,40,312,3,5,1.906314207,1465,341,10,233,198,35,12747,11616,1131,106,93,13,100
6ab576db0bebf655c13bca89caaf14e8a1130676,2,132,13,119,0,0,0,2,7,23,1,2,0.99419398,612,342,11,105,90,15,5055,4267,788,39,35,4,100
bdffe20fe2425328dad21e265189ef53e5517267,0,0,0,0,0,0,0,0,0,0,0,0,0,0,343,12,0,0,0,0,0,0,0,0,0,100
f5f2ff438c6b2d594588c7f650fe1326dbaae03e,1,1,1,0,0,0,0,1,7,3,1,1,0,244,344,12,27,27,0,2039,2039,0,18,18,0,100
a2905911d9a7d1a92d18dbf29289927b7c402e6e,2,17,0,17,0,0,0,2,21,130,2,1,0.322756959,433,345,13,89,88,1,3244,3106,138,29,28,1,100
1ca4faa9bbad10b41b75ada4f10ec3c8d2022516,1,3,3,0,0,0,0,1,2,213,1,1,0,60,90,1,15,15,0,318,318,0,5,5,0,100
bfe4ce7e799a540a732ad0008e14620d48ee9a01,4,359,64,295,3,0,3,1,8,10,1,2,1.718396965,207,91,2,60,47,13,2797,1471,1326,20,14,6,99.79879276
99ba394a41db5c866c418760ee737720f358117c,3,27,46,19,0,0,0,1,9,0,1,2,1.153629961,375,92,3,59,59,0,2852,2757,95,19,19,0,99.62568385
dc547086c62657a76d4f76f442ba6ad9ad3f0112,1,6,2,4,0,0,0,2,41,10,1,1,0,384,346,14,65,65,0,2943,2905,38,28,28,0,100
4f68d7aac3b256aa9c1dbd9b27695cdcf3fb9d23,0,0,0,0,0,0,0,0,0,0,0,0,0,0,347,15,0,0,0,0,0,0,0,0,0,100
72a470d4532cc5762ac36f967fad57da1da04b2c,0,0,0,0,0,0,0,0,0,0,0,0,0,0,348,14,0,0,0,0,0,0,0,0,0,100
1e8d8a19580c0809dd39fb7a3b2065c09c5030dd,0,0,0,0,0,0,0,0,0,0,0,0,0,0,349,15,0,0,0,0,0,0,0,0,0,100
75866cb1d03f91f64fb9a01a7b7e36089ce84736,1,18,0,18,0,0,0,1,8,16,1,1,0,244,350,15,29,27,2,2129,2039,90,19,18,1,100
0de5a0aeebcdb3a75e22f35e574c1c148b5def1c,0,0,0,0,0,0,0,0,0,0,0,0,0,0,351,15,0,0,0,0,0,0,0,0,0,100
1cff9e35971bbe1b0df8397a24d4db1d40fcd952,2,34,3,31,0,0,0,1,39,24,1,2,0.405977038,368,352,15,42,36,6,4090,3874,216,16,15,1,100
be8bd5e0ea0e15a95116a84945d73081bf843f4e,0,0,0,0,0,0,0,0,0,0,0,0,0,0,353,16,0,0,0,0,0,0,0,0,0,100
31ac5c54f4027a43c81c10ca9236b101db8b6448,0,0,0,0,0,0,0,0,0,0,0,0,0,0,354,17,0,0,0,0,0,0,0,0,0,100
4d45d05454e0a0f7683b4182bed73d707d525792,4,171,252,81,0,0,0,1,12,564,3,4,1.156866032,415,355,18,57,64,7,3237,3419,182,30,34,4,100
367e849f31e3194212c1131bc70dd1649c5da542,15,313,22,291,5,0,5,1,8,244,4,8,2.737115917,1461,93,3,209,62,147,12113,7162,4951,119,50,69,95.51918433
edcba96ca5be22c9253280550bf127aa5b8b7358,12,200,29,171,1,0,1,3,30,354,3,7,2.987479517,757,356,14,81,65,16,8178,6866,1312,51,43,8,97.42074154
d8a65875e748c86839405b31d538d55b9d3f9214,1,0,0,0,0,0,0,1,1,0,1,1,0,17,357,15,4,4,0,74,74,0,4,4,0,99.88405797
bc5440045f671ada6c9409542c7c54c6e6ee0c83,4,8,8,0,0,0,0,1,2,2,1,2,1.75,377,94,4,58,58,0,2994,2840,154,22,22,0,97.56575266
1152a293d4f326f72adadd9b087ebf1c0f4a2741,0,0,0,0,0,0,0,0,0,0,0,0,0,0,358,14,0,0,0,0,0,0,0,0,0,100
affc182ac1a925061a81d20ce691484eba041c09,0,0,0,0,0,0,0,0,0,0,0,0,0,0,359,14,0,0,0,0,0,0,0,0,0,100
83fe6647f3122378e1eae739df37c4d8041bc424,0,0,0,0,0,0,0,0,0,0,0,0,0,0,360,14,0,0,0,0,0,0,0,0,0,100
0e1df0f872d2d9640823d192e82a291596c930b3,0,0,0,0,0,0,0,0,0,0,0,0,0,0,361,12,0,0,0,0,0,0,0,0,0,100
dd93ed27a0c6744a8fe5a57952847ad8bfb65bb0,7,208,8,200,4,0,4,2,9,7,2,3,2.44684331,424,362,12,81,66,15,4389,3621,768,38,30,8,99.73031284
e96e240f949a441e03159b9d401640f5343b4153,1,40,0,40,0,0,0,2,2,28,1,1,0,48,39,0,12,9,3,560,334,226,8,5,3,100
25c3c695422ded37bf0dfd93e933bccc2b1dc45b,6,120,45,75,0,0,0,1,3,192,1,2,2.357033323,715,363,7,102,92,10,6304,5600,704,47,44,3,100
bc220dc1d42695a9606d4ed952733cac93a1a6fe,3,55,38,17,0,0,0,2,10,458,2,3,0.638652024,286,364,3,20,21,1,2412,2687,275,18,19,1,100
ae03eb22ba64e239b7ed1072456148fcc052d57d,0,0,0,0,0,0,0,0,0,0,0,0,0,0,365,4,0,0,0,0,0,0,0,0,0,100
37973525d80534c48ddc2ec0d2b9d98724a3858e,0,0,0,0,0,0,0,0,0,0,0,0,0,0,366,3,0,0,0,0,0,0,0,0,0,100
f8b408f2059af780513faaea60c2e8988e36c24f,0,0,0,0,0,0,0,0,0,0,0,0,0,0,95,0,0,0,0,0,0,0,0,0,0,100
aeaca87dd15da1cab1d2b5a38018a1e6cad936f1,2,6,2,4,0,0,0,2,4,388,1,2,1,118,0,0,20,20,0,904,876,28,2,2,0,100
dd60e747b28d711bb26c7f57e72aba0665f41e45,0,0,0,0,0,0,0,0,0,0,0,0,0,0,96,1,0,0,0,0,0,0,0,0,0,100
c6762ce92f0b881ee22eae2500d0b3d1d7c856e2,0,0,0,0,0,0,0,0,0,0,0,0,0,0,367,4,0,0,0,0,0,0,0,0,0,100
fc00415647d0ac1dcc4f0146425c192fd2caa7ab,8,256,11,245,2,0,2,2,42,372,3,5,2.458688989,1124,97,1,241,215,26,9157,7987,1170,107,91,16,99.8656997
89c4760680b32d18eaa6849cbfe46a696ccbdb61,3,163,14,149,2,0,2,1,1,0,1,3,1.420474917,41,98,2,13,8,5,888,321,567,10,4,6,99.78563773
55f176d390920ea81a4d06a5a9349dbb9244de0b,2,5,2,3,0,0,0,1,2,2,1,2,0.985228136,93,99,2,14,14,0,733,703,30,8,8,0,100
db0e17886fe58b7a3aa5973630b2e9c737f60c8e,38,1182,753,429,2,0,2,1,41,651,6,15,3.961061522,5263,368,0,832,813,19,46585,42859,3726,407,398,9,98.44686649
d90efa63b7858866628bcc1be1c0b8b6809cc0c1,11,422,25,397,4,0,4,2,42,269,4,8,3.012342747,1165,369,1,254,223,31,10075,8308,1767,117,95,22,99.64018821
712c80ef857adc242c6c99a969a6a01f3ed9ff35,4,37,25,12,0,0,0,1,23,6,1,4,1.512062464,736,100,3,150,138,12,5391,5401,10,56,48,8,99.77912755
e5cb26aef001931e56792486bafbe19599643547,4,61,50,11,0,0,0,2,43,6,1,4,1.015896325,1079,101,4,211,208,3,7999,7933,66,82,80,2,100
1ffd116ae71db127feded8dc9cd3e57fc3652a88,2,6,2,4,0,0,0,2,5,454,1,2,0.811278124,189,102,5,28,28,0,1683,1653,30,11,11,0,100
2b325edb0e8b49b0b522eab129dc3786f3b5735a,0,0,0,0,0,0,0,0,0,0,0,0,0,0,103,3,0,0,0,0,0,0,0,0,0,100
40dd1984971c96e4255ad95f093ae6309d4c0853,2,70,1,69,0,0,0,1,5,315,1,2,0.464514944,319,40,0,62,52,10,2241,1976,265,29,25,4,100
25fc2375eb7c84de88ec6e2a1ee254346db58a11,2,17,1,16,0,0,0,1,6,0,1,2,0.964078765,365,41,1,65,62,3,2307,2241,66,32,29,3,100
2759abe4766849f506d95268f0e16a604ea55c80,2,23,3,20,0,0,0,1,7,0,1,2,0.840358672,378,42,2,70,65,5,2391,2307,84,35,32,3,100
5de7465b2505b4c49f0c37d93aabc368eb6abc18,2,27,5,22,0,0,0,1,8,0,1,2,0.757878463,393,43,3,75,70,5,2475,2391,84,38,35,3,100
a0efb4b4c15cb0a223e33cae1c21027b02f408dc,1,7,1,6,0,0,0,2,9,0,1,1,0,346,44,4,70,68,2,2225,2197,28,31,31,0,100
b1179de9b6e7f775919829627e44c5cc975aa6a5,1,12,0,12,0,0,0,1,7,0,1,1,0,65,45,5,9,7,2,332,278,54,9,7,2,100
4db63daf4e554ce848f372b98bb033e0032e5cd2,1,15,0,15,0,0,0,1,8,0,1,1,0,75,46,6,11,9,2,416,332,84,11,9,2,100
0d82b57270dc5d46af5314d738361ff84ac9609d,1,6,10,4,0,0,0,2,10,0,1,1,0,351,47,7,70,70,0,2219,2225,6,31,31,0,100
f22064aa3783ef7ea85d755de1624131d355d7ce,0,0,0,0,0,0,0,0,0,0,0,0,0,0,104,3,0,0,0,0,0,0,0,0,0,100
a4383ec24c38c16f406255e77248daec32308242,1,319,0,319,1,0,1,1,1,0,1,1,0,0,48,8,15,0,15,2031,0,2031,13,0,13,95.84210526
42dfaaee51b3f75849a0205927824b4812085bcb,3,19,1,18,0,0,0,1,9,60,1,2,1.438758681,611,370,0,83,81,2,5392,5270,122,27,26,1,100
8100d409e547be5f15918d8ef1fcce260c27a65e,0,0,0,0,0,0,0,0,0,0,0,0,0,0,105,2,0,0,0,0,0,0,0,0,0,100
b38d5f9442dd05aabb391deb68d958293e3f4268,2,13,3,10,0,0,0,4,40,112,2,2,0.954434003,551,49,9,70,70,0,4787,4715,72,31,31,0,100
da358949d3b3c8dee925688bd8c0b2d7ad98d786,1,1,4,3,0,0,0,2,12,57,1,1,0,229,106,3,48,49,1,1379,1405,26,26,26,0,100
af5179647be73e60dd7984d55e63a83af60941c5,0,0,0,0,0,0,0,0,0,0,0,0,0,0,50,10,0,0,0,0,0,0,0,0,0,100
a1ad390d5e6599790e00488d9c1d6386bed9a25e,5,5,6,1,0,0,0,2,40,313,2,2,2.186704346,2224,51,11,104,104,0,18648,18648,0,74,74,0,100
d7badf47b131df0548b0664163820c208627d4de,0,0,0,0,0,0,0,0,0,0,0,0,0,0,371,1,0,0,0,0,0,0,0,0,0,100
86a37bbc3254a51f140474a8fd41dac3febe8be5,2,13,8,5,0,0,0,4,41,26,2,2,0.702466551,559,52,4,70,70,0,4833,4787,46,31,31,0,100
10de69b673937e24fdd31a7c8c4416e4c0dd2e7d,0,0,0,0,0,0,0,0,0,0,0,0,0,0,107,0,0,0,0,0,0,0,0,0,0,100
4ca54c5a13e7bbf600a483cdebd653e8adcbc2a9,3,193,1,192,2,0,2,1,3,154,2,3,1.074535467,31,108,1,20,2,18,1089,291,798,14,1,13,99.28149859
3ef4a08d522a6fcacaedbfdd1a17e19a2e115089,0,0,0,0,0,0,0,0,0,0,0,0,0,0,109,2,0,0,0,0,0,0,0,0,0,100
d3d269f939f068dfd4228ab54cbd3b66986a0841,8,272,4,268,4,0,4,1,44,175,4,5,2.345494754,581,110,3,104,85,19,5161,4444,717,61,43,18,99.76470588
260fdc724dc48ceb7b576094e48dbd16b70aa80d,0,0,0,0,0,0,0,0,0,0,0,0,0,0,111,4,0,0,0,0,0,0,0,0,0,100
c062ee1d473927f716f663448e19f523d51aeda2,2,224,2,222,1,0,1,1,45,16,2,2,0.299411329,410,372,0,86,71,15,4381,3062,1319,44,32,12,95.96934431
66bc41a8ef8b53e9aaafc2cef09f165677d5121e,3,50,2,48,0,0,0,1,11,459,2,3,0.751797709,362,373,1,62,60,2,3051,2731,320,36,34,2,99.96882793
a970502aaea2ae5f97bf1e3834431f9856b7a36f,21,2006,5,2001,17,0,17,3,41,160,5,12,3.507675987,1634,374,1,201,49,152,24716,13714,11002,117,32,85,95.34467323
2adc917e486860cf0d009bd50786d5c5bb87c374,11,625,521,104,3,0,3,2,46,176,3,9,2.574364589,1768,375,2,278,272,6,13232,12795,437,136,130,6,99.6
5169480b3e09d900e32ed0e429a84974209c466b,5,481,6,475,2,0,2,1,2,51,2,3,1.070891592,251,376,2,57,25,32,4612,1760,2852,50,23,27,97.69544924
1a67f33dbe3ce5ae609307c6808fd4ef769be0be,1,60,10,50,0,0,0,1,2,0,1,1,0,261,377,3,17,15,2,2425,2173,252,16,14,2,100
0b52704ac57d36cfcf8519ede464e6769d577f00,1,9,9,0,0,0,0,2,13,165,1,1,0,354,53,0,70,70,0,2258,2258,0,31,31,0,100
ee3a15212da27ae6942ac1c03008ba172190a40c,0,0,0,0,0,0,0,0,0,0,0,0,0,0,54,1,0,0,0,0,0,0,0,0,0,100
e59366faf9e43fb79d4da44a7f4d0d10dcd7200a,4,266,0,266,4,0,4,1,1,0,1,3,1.913934416,0,55,2,17,0,17,1121,0,1121,9,0,9,99.7323818
fd623eb936ef96ad91a56f59ad013fb58e379841,0,0,0,0,0,0,0,0,0,0,0,0,0,0,56,3,0,0,0,0,0,0,0,0,0,100
eba3eb96c23733706f20394777b809d8c136485b,7,8,0,8,0,0,0,3,42,123,1,2,2.75,3385,378,4,194,194,0,28257,28180,77,119,119,0,100
43fb9e4a32ff8fb370e3980fd28963ce78cdc098,0,0,0,0,0,0,0,0,0,0,0,0,0,0,379,5,0,0,0,0,0,0,0,0,0,100
5fd06aff2ce5a6328141239f70b67dcb8b277cea,1,1,0,1,0,0,0,2,3,910,1,1,0,176,57,4,39,39,0,1224,1217,7,15,15,0,100
93b56251f77e5a9415775e4fee401d84a2cfcb8e,0,0,0,0,0,0,0,0,0,0,0,0,0,0,380,4,0,0,0,0,0,0,0,0,0,100
9aaeeed179cd9cd0a5ad378f7bf0d8b736fe814e,54,2483,321,2162,27,0,27,3,42,341,7,26,4.875924315,3789,381,1,580,462,118,43339,36010,7329,300,246,54,96.0807601
e60357c60a8ce93a6b5332a217d447a48d2872e1,1,1,0,1,0,0,0,2,47,94,1,1,0,377,112,0,63,63,0,2846,2835,11,31,31,0,100
74e2dcef45f38be970e3a082d81d677fe3a60e45,0,0,0,0,0,0,0,0,0,0,0,0,0,0,58,0,0,0,0,0,0,0,0,0,0,100
02d9b39d77cf2256fe318980d0f5fee4b4b3e96e,16,898,80,818,6,0,6,1,6,187,4,6,3.066454329,1104,382,0,211,160,51,12557,8135,4422,141,111,30,96.3533946
f0af8bd6ca966319a234c83a85272555545442cb,3,153,9,144,0,0,0,1,2,54,2,3,0.854485661,419,383,1,34,28,6,4345,3479,866,17,14,3,100
21ad01621a2ea0913e07130c02b55ebd4c22ddba,1,1,0,1,0,0,0,3,43,110,1,1,0,2128,384,2,102,102,0,17571,17562,9,45,45,0,100
a36cdac05882b2b02169b2a5ba380415592e62b5,0,0,0,0,0,0,0,0,0,0,0,0,0,0,113,0,0,0,0,0,0,0,0,0,0,100
bdf71dafa7ece8ff9805e6a425d30c033b9a598e,8,67,97,30,1,0,1,3,13,235,3,5,2.053239889,573,114,1,60,62,2,5397,5799,402,30,29,1,99.73396394
a61ce32d063cbf1722c746b526cc6bcabb15a1f5,1,32,0,32,1,0,1,1,1,0,1,1,0,0,115,2,1,0,1,32,0,32,1,0,1,99.88190139
088781433b7fa29548bdc394e946e4a5c7427801,12,15,15,0,0,0,0,3,44,189,2,3,3.456564762,4848,116,3,261,261,0,40233,40233,0,179,179,0,100
d9391c913587b5b7d039a47b82fdf62a02481c2e,0,0,0,0,0,0,0,0,0,0,0,0,0,0,385,1,0,0,0,0,0,0,0,0,0,100
1c4ac5c29c437b3edc2627bf405ec62debb1918d,0,0,0,0,0,0,0,0,0,0,0,0,0,0,386,1,0,0,0,0,0,0,0,0,0,100
32bc347ec5106b7aca9f7ae435c97f48a59c9b4d,0,0,0,0,0,0,0,0,0,0,0,0,0,0,117,3,0,0,0,0,0,0,0,0,0,100
89171c17a4e586d87d94f3ed434d3d209b1a77de,0,0,0,0,0,0,0,0,0,0,0,0,0,0,118,4,0,0,0,0,0,0,0,0,0,100
5145c2d3dcd52bb15c974c0976cc4a54eec677cb,1,1,1,0,0,0,0,2,5,1081,1,1,0,135,119,4,22,22,0,1013,1011,2,15,15,0,100
17ec36714be6d75f3a8368e41a8e94e2b596980c,3,0,215,215,0,0,0,1,2,468,1,3,1.540443101,125,120,3,0,13,13,0,888,888,0,10,10,99.82269504
974312ead08db421ce2df614419c3d83e4c61be5,0,0,0,0,0,0,0,0,0,0,0,0,0,0,387,0,0,0,0,0,0,0,0,0,0,100
b40aa7881697645ce9dca5f167ce12bfa91c4d59,1,11,2,9,0,0,0,1,10,489,1,1,0,176,388,1,28,28,0,1326,1276,50,18,18,0,100
d298308f184388ff9d83ce1b47e1feb4add7004f,0,0,0,0,0,0,0,0,0,0,0,0,0,0,389,2,0,0,0,0,0,0,0,0,0,100
e037c3f334d2c1c6d45b63872de7eacef962e719,1,2,2,0,0,0,0,2,18,812,1,1,0,818,121,1,78,78,0,5642,5642,0,41,41,0,100
68f600da2143a94c34b05ec3217986580a53d182,1,32,9,23,0,0,0,2,9,265,1,1,0,500,122,2,100,95,5,3021,2925,96,33,32,1,99.88158674
412fdd256dcdefa7f37f469ad27a22e6dbf966dc,1,3,1,2,0,0,0,1,2,182,1,1,0,60,390,3,3,3,0,537,506,31,3,3,0,100
616df99847c6ae3fd023d44ae262582ddcd1b063,1,3,0,3,0,0,0,2,4,88,1,1,0,346,391,4,11,11,0,2498,2481,17,11,11,0,100
02d5a14b0a3d167b37315e314749850e64538b16,5,269,49,220,1,0,1,1,22,601,2,2,0.885890658,616,123,2,144,116,28,5863,4696,1167,53,40,13,99.4636472
dbbc730cf28a9773b172ef5877224e9a327c7e4e,1,116,121,5,0,0,0,1,2,0,1,1,0,177,124,3,27,29,2,1406,1436,30,14,14,0,100
1b2e5281bf64a497623dbce7b29ed0cd6834aba3,2,2,2,0,0,0,0,1,5,1270,1,1,1,65,392,4,7,7,0,444,444,0,7,7,0,100
a63961b2015fe9b3466bd530a260d263c2c0bdb1,2,36,1,35,0,0,0,2,5,78,2,2,0.303374836,482,393,5,35,33,2,3778,3554,224,18,17,1,100
13682b6c0af047b9186d47758c21e2e4a62412bb,2,38,0,38,0,0,0,1,5,74,1,2,0.175565026,208,394,6,28,25,3,2170,1870,300,10,7,3,98.36591771
75daf4025a070c78fff2eb4bed4e5717336a9c86,2,80,2,78,0,0,0,3,26,154,2,2,0.226410948,627,395,7,99,95,4,5966,5360,606,26,24,2,100
0105554ab4f921afe010e3d6a56b82671fb1b63a,3,52,6,46,0,0,0,1,2,204,1,3,1.337239,63,396,8,10,7,3,870,501,369,7,6,1,99.97159091
73160feac6b4f7a17295ec6b2a7a2af0c2e86b2f,5,55,6,49,0,0,0,2,13,579,3,4,2.289019037,514,125,4,95,90,5,3351,3074,277,62,59,3,100
1140aee65a56c3a66849c9eae0a554f3c45f17e1,0,0,0,0,0,0,0,0,0,0,0,0,0,0,397,9,0,0,0,0,0,0,0,0,0,100
d02fda4b3c364b6f9dacc83e10bd3793c0b83cf4,0,0,0,0,0,0,0,0,0,0,0,0,0,0,398,9,0,0,0,0,0,0,0,0,0,100
ae64e7dfde5cc8147087ea2db696973f764596aa,0,0,0,0,0,0,0,0,0,0,0,0,0,0,126,5,0,0,0,0,0,0,0,0,0,100
f1f4fa2239c2218405e19d65bb12f89ee31305e8,1,18,2,16,0,0,0,1,10,552,1,1,0,180,399,7,35,33,2,1478,1426,52,18,17,1,100
d3573a94b950ec4de9ccae115b292a7d4d0334b0,1,116,82,34,0,0,0,3,14,298,1,1,0,354,127,2,73,70,3,2362,2258,104,31,31,0,100
868e5715e4a3fe21c08cedfd58ba5cd67ff65fe1,5,46,18,28,0,0,0,1,12,555,2,3,1.590056205,752,400,8,107,104,3,6330,6168,162,63,60,3,98.64864865
197e9960d2724056f257ddb64980a62b40cf8d6a,1,12,4,8,0,0,0,3,15,6,1,1,0,393,128,3,77,73,4,2394,2362,32,31,31,0,100
0edaec6e33f68f6fe68b2e63e6f867401f194c2d,2,6,3,3,0,0,0,1,43,122,1,1,0.918295834,380,401,9,33,32,1,3679,3662,17,16,16,0,100
4c7ddb58ff4d9f655e3e7f919a6ac8d91bdcbb06,2,38,8,30,0,0,0,2,45,101,1,1,0.95033767,2947,402,10,182,180,2,23392,23213,179,87,86,1,100
56dd56dd1f5888f6c7bc4ec23e1d345156185401,2,22,17,5,0,0,0,2,46,0,1,1,0.391243564,2974,403,10,182,182,0,23440,23392,48,87,87,0,100
dd51f5482005041142f9889854f238e529644030,0,0,0,0,0,0,0,0,0,0,0,0,0,0,129,4,0,0,0,0,0,0,0,0,0,100
18ee2e869a75756b5a641bcffea50ada228fd84a,0,0,0,0,0,0,0,0,0,0,0,0,0,0,130,5,0,0,0,0,0,0,0,0,0,100
d29a819f3d9fbcd9b7c2ca68d7850b3d83468968,0,0,0,0,0,0,0,0,0,0,0,0,0,0,131,6,0,0,0,0,0,0,0,0,0,100
c59837df42f77870eee27d41580485bb655cce12,0,0,0,0,0,0,0,0,0,0,0,0,0,0,132,7,0,0,0,0,0,0,0,0,0,100
9ca6bd53f0a1a0ab4ac72007b5627248f6fc397f,0,0,0,0,0,0,0,0,0,0,0,0,0,0,133,6,0,0,0,0,0,0,0,0,0,100
f71d9c83eab79dffc519e22b0e0c3b4714372a0d,0,0,0,0,0,0,0,0,0,0,0,0,0,0,134,7,0,0,0,0,0,0,0,0,0,100
768c12009a4b005f310968a8fe66b944bb9c566f,2,90,0,90,2,0,2,1,1,0,2,2,1,0,404,5,6,0,6,330,0,330,2,0,2,99.38752784
8e5cacff32286ff533c5d71e00c350ab76150799,15,614,12,602,4,0,4,2,48,448,7,12,2.406307883,1183,405,1,244,192,52,13195,9319,3876,141,115,26,96.44800917
711f14fd2999e609bf1682f6f5f93fe43903e111,0,0,0,0,0,0,0,0,0,0,0,0,0,0,406,2,0,0,0,0,0,0,0,0,0,100
92f2965020a7fcdcaf924d32fd503b87b3570c29,1,10,4,6,0,0,0,2,10,187,1,1,0,518,135,0,104,100,4,3057,3021,36,33,33,0,100
38d581b77601c68d6024097406980f58511f1218,0,0,0,0,0,0,0,0,0,0,0,0,0,0,136,1,0,0,0,0,0,0,0,0,0,100
bd940b7a5413a73199d83f54d5af28cd0e1b5d11,0,0,0,0,0,0,0,0,0,0,0,0,0,0,0,0,0,0,0,0,0,0,0,0,0,100
a8927c91ab985199f7174dafddda88852a09d7b0,0,0,0,0,0,0,0,0,0,0,0,0,0,0,1,1,0,0,0,0,0,0,0,0,0,100
7b986df3211f8538f0bcf74d9a8118d76f262eae,2,4,1,3,0,0,0,2,10,292,1,2,0.970950594,244,407,0,43,43,0,2014,1985,29,12,12,0,100
f78c26ec6b9f6fb341661553b64a353c1270283c,1,81,19,62,0,0,0,2,2,1831,1,1,0,60,408,1,11,4,7,785,427,358,6,2,4,100
8c39133596855641dcd992505aac8a38282998e9,2,91,9,82,0,0,0,2,11,540,1,2,0.904381458,748,409,2,119,115,4,5798,5216,582,43,41,2,100
c1b9a27bf8061074a2635f7f90ef73504faf8f91,2,19,1,18,0,0,0,2,15,237,1,2,0.468995594,305,137,0,60,58,2,2053,1918,135,37,35,2,100
8a2ae7d116e06cfef9ca82416670ec963c5850f6,5,5,6,1,0,0,0,2,11,734,5,5,2.186704346,436,410,3,68,68,0,3531,3541,10,32,32,0,100
7c4b44af66d7fce69b854a1371ea2a4fbe51f637,5,238,43,195,0,0,0,3,16,58,5,5,1.350596068,493,411,4,54,41,13,6136,4468,1668,28,23,5,100
59735a88c66bca0e7ccc2f093614551908757ae4,0,0,0,0,0,0,0,0,0,0,0,0,0,0,138,1,0,0,0,0,0,0,0,0,0,100
1275b08820bac477901d3a6e207ea867426c5e6c,2,79,4,75,0,0,0,2,16,28,1,2,0.731462562,321,139,2,67,60,7,2527,2053,474,43,37,6,100
ba4c2010a5fa1785fc014362900744aa727a1489,2,2,8,6,0,0,0,2,27,316,2,2,0.721928095,811,412,0,161,164,3,5602,5626,24,51,51,0,100
5abdde8bce31a82bcf9c13cb5a17ce9ca773a010,3,9,8,1,0,0,0,2,12,43,1,3,1.548565226,944,413,1,134,134,0,6761,6753,8,58,58,0,100
2192932e012186ca8dc5777bdcc1b14d162c9128,3,37,2,35,0,0,0,1,44,642,2,3,0.560279319,520,414,2,65,63,2,5295,4908,387,25,25,0,100
7d839171a7c2ecda217732718ae5aedf4d429fba,2,16,3,13,0,0,0,2,13,2,1,2,0.981940787,822,415,3,121,119,2,5912,5806,106,44,43,1,100
2ef76e918f7ee1005cae179182d0ceb9b3505946,5,152,13,139,0,0,0,2,17,173,3,4,1.971947823,655,140,2,120,107,13,4513,4030,483,83,73,10,100
4a2f59404abf631ed07c61c2495fdf481ef27b87,2,5,6,1,0,0,0,2,45,189,1,2,0.845350937,428,416,4,45,45,0,4125,4125,0,16,16,0,100
654f31d63be55e45e8a9deebbb579f6f00fc9c19,0,0,0,0,0,0,0,0,0,0,0,0,0,0,141,3,0,0,0,0,0,0,0,0,0,100
0d9fa0dac0012ddd718f9d3e3910bdc60dc00878,89,3421,1631,1790,45,0,45,1,46,262,12,36,5.891969569,4969,2,0,815,612,203,48256,42262,5994,444,332,112,92.41761446
3345acf39047852b46d6aaa7e966b3ebfaa35874,6,28,55,27,0,0,0,4,29,0,4,5,2.373796663,1331,3,1,192,192,0,11052,11100,48,80,80,0,98.05249788
67ddfa752774bc429b1da5f19e4a266ed54f2c71,13,71,21,50,0,0,0,4,47,0,3,10,3.178786807,3181,4,2,408,399,9,25567,25165,402,204,202,2,100
774d8a74310c9047f14769e7f36126c026b6dc48,1,137,34,103,0,0,0,4,47,326,1,1,0,2150,5,3,108,102,6,18329,17722,607,47,45,2,100
731ce595f1d68850cdd55bca9eb2ddd4d367044e,1,313,115,198,0,0,0,4,48,8,1,1,0,2236,6,4,116,108,8,19419,18329,1090,52,47,5,100
9f28214709b5a889d8e1a5bd3049d0c61564d371,1,62,0,62,0,0,0,4,49,3,1,1,0,2399,7,5,118,116,2,19775,19419,356,54,52,2,100
0a4fb9a7d41a1e8a6169f4c2ad8ebd8915cc306b,2,92,22,70,0,0,0,1,6,1568,1,2,0.629249224,703,417,0,150,134,16,5760,5381,379,40,36,4,100
68416ccfd14330c0a2f84472c9220feb6f127879,5,235,33,202,1,0,1,4,50,227,3,4,1.911441673,2804,8,6,185,174,11,23725,22610,1115,90,82,8,97.7706151
79e707aa4a3ff39360232cfc40f2c04ddf49ace0,109,2689,4371,1682,19,0,19,0,46,167,18,51,5.939360171,10525,142,0,1065,1235,170,76637,82807,6170,552,628,76,90.40619989
ce3ca3cedfd4390e3b95ce1c3ceded7e0bef4fc8,127,4796,3055,1741,31,0,31,1,50,210,20,56,6.105882285,10086,142,0,1346,1063,283,91193,77588,13605,687,553,134,88.53467562
27a9a21ecada1751388d2724e74eefd51bb16839,1,11,4,7,0,0,0,1,2,2,1,1,0,123,143,1,18,18,0,971,971,0,5,5,0,100
3ba341a317bf030ce71fb31742a4bc80c56604d8,1,0,5,5,0,0,0,1,2,3,1,1,0,41,144,2,5,5,0,166,200,34,3,3,0,99.91438356
887a49a879738abba4eba2984095309bc3ea740b,1,28,14,14,0,0,0,1,3,478,1,1,0,173,145,3,29,27,2,1476,1406,70,14,14,0,100
30e5b9fd7fee3e54a4838c8563666cd4f3346423,1,0,1,1,0,0,0,1,4,1,1,1,0,187,146,4,29,29,0,1467,1476,9,14,14,0,100
32feae7fedfe20b3bf8d328a63957b695b74b3a9,2,37,12,25,0,0,0,5,17,281,1,2,0.963335546,483,9,0,87,83,4,3402,3129,273,37,36,1,100
bc716d92a60469088b5b9b57da9004e46333af93,2,15,1,14,0,0,0,2,6,674,1,1,0.896038233,184,147,5,40,36,4,1443,1354,89,22,21,1,100
5ee7942fb9629bb948eed69a0e9105eb25dbed58,1,21,14,7,0,0,0,5,18,11,1,1,0,420,10,1,79,80,1,2686,2626,60,32,32,0,100
74ce27e9928bd528ad66ecb3c535eb70a7a3ae25,1,0,5,5,0,0,0,5,19,6,1,1,0,426,11,2,79,79,0,2652,2686,34,32,32,0,100
571d8d2d67d48a56b85caf04f3c5a12c0299c12c,1,1,7,6,0,0,0,2,4,15,1,1,0,38,148,6,10,10,0,177,205,28,7,8,1,100
fd2bbbbe2c3c9143b7a65ab6d4f3a5a513f37fe1,1,7,1,6,0,0,0,2,3,674,1,1,0,33,12,3,10,10,0,205,177,28,8,7,1,100
2376b9565bf23a0b3122926c493b5cc0fd3e1341,1,1,7,6,0,0,0,2,4,15,1,1,0,38,13,4,10,10,0,177,205,28,7,8,1,100
016a47dc6b08192a4d762ad305313519dc2f31a5,18,764,616,148,4,0,4,1,9,94,7,10,3.059502084,1192,14,5,162,158,4,10310,10463,153,91,87,4,99.2022792
4f2b2dd8b791d6de2436bbf33b6b8dfdd1586096,1,1,1,0,0,0,0,5,20,21,1,1,0,421,15,6,79,79,0,2652,2652,0,32,32,0,100
95136c51b1425f66cb226c3b74fafca77e71af97,139,3252,6081,2829,20,0,20,0,46,145,21,60,6.314272722,12561,143,0,1260,1429,169,86541,93543,7002,659,727,68,88.14174107
905135b66b4e431a90ad625b88837ea9af986d64,129,5463,2566,2897,35,0,35,1,50,199,20,54,6.090153026,9766,151,3,1444,1045,399,94176,73087,21089,716,506,210,88.25955458
f6ce9f630db708a3575af218206e0cadf75375d0,0,0,0,0,0,0,0,0,0,0,0,0,0,0,418,0,0,0,0,0,0,0,0,0,0,100
79afd870decc8451a71c15c1c514ce267bb8f1ca,0,0,0,0,0,0,0,0,0,0,0,0,0,0,419,1,0,0,0,0,0,0,0,0,0,100
cc9e4cfc73544f8d5a3e7ac1b9693a15b4a33a55,0,0,0,0,0,0,0,0,0,0,0,0,0,0,420,2,0,0,0,0,0,0,0,0,0,100
48fba646f34fd0025089351ee41e5ee138ecd8fb,2,20,0,20,0,0,0,2,6,1713,1,2,0.609840305,187,152,3,30,27,3,1471,1355,116,13,12,1,100
cc27d465e116ff7445b562dcb421ad96f717f8e0,0,0,0,0,0,0,0,0,0,0,0,0,0,0,16,5,0,0,0,0,0,0,0,0,0,100
7a122bfb7dc324ab54c97aebb7b55ef1e8ce36b1,2,39,2,37,0,0,0,2,7,0,1,2,0.999570839,205,153,4,37,30,7,1714,1471,243,15,13,2,100
62a19f4f7c1644fb08362adb00da27a631a0b528,2,22,1,21,0,0,0,2,6,40,2,2,0.258018669,272,154,4,41,37,4,2315,2156,159,15,14,1,100
d495eb3da8902f5c5c3a71c87bfb4784ca6db754,0,0,0,0,0,0,0,0,0,0,0,0,0,0,421,3,0,0,0,0,0,0,0,0,0,100
d9f8cf41e05be1c68766a22402bb03d55feb547c,1,6,1,5,0,0,0,2,49,437,1,1,0,399,422,4,68,68,0,3044,2998,46,32,32,0,100
a9fa66fbb60a07def688c668d857484d95c7533a,3,3,3,0,0,0,0,1,4,51,2,3,1.584962501,199,155,5,27,27,0,1330,1330,0,15,15,0,100
98db9fbd1bf70f24c5cc73539198ee0cf84e06b8,0,0,0,0,0,0,0,0,0,0,0,0,0,0,423,5,0,0,0,0,0,0,0,0,0,100
734d425b75e2c5f637b43841b1b0e6854b4a6f87,0,0,0,0,0,0,0,0,0,0,0,0,0,0,424,6,0,0,0,0,0,0,0,0,0,100
cc37cf2fd73ac678373f535248901586fac03084,1,24,2,22,0,0,0,5,21,56,1,1,0,421,17,1,81,79,2,2875,2652,223,33,32,1,99.97239094
e671df4c00849e9694d7431d1990e3fc1d877efe,0,0,0,0,0,0,0,0,0,0,0,0,0,0,425,7,0,0,0,0,0,0,0,0,0,100
895457d990bf012faced29121b8783d402393d3e,2,15,0,15,0,0,0,2,50,129,1,1,0.566509507,630,426,1,70,68,2,5937,5853,84,34,32,2,100
0dc3b376a0c6d910cec6b6e6577c19be92ba235c,2,4,1,3,0,0,0,2,4,720,2,2,0.970950594,130,156,0,18,18,0,1045,1024,21,5,5,0,100
bd26abb2191a5d9a7bd7fd8e22c6e9b65edf5e6f,1,1,1,0,0,0,0,3,13,230,1,1,0,137,18,1,16,16,0,1097,1091,6,16,16,0,100
dd16033d34346c61b9666e614f5872f7c93a7b39,15,816,17,799,7,0,7,4,51,240,6,9,3.264735336,4151,19,1,434,373,61,37275,32570,4705,217,182,35,99.36882547
c6af41252de23e47ebe3227385021c3e99faec12,0,0,0,0,0,0,0,0,0,0,0,0,0,0,427,0,0,0,0,0,0,0,0,0,0,100
43b8b43ba4ba1a9489b09338dfbe2fdfa972dcea,7,25,28,3,0,0,0,3,51,570,2,2,1.356983998,2495,428,1,240,241,1,18965,18976,11,150,150,0,100
801e821a1761ddf39440656e17ec836847948bbe,2,22,4,18,0,0,0,2,14,289,1,2,0.89049164,695,157,0,131,128,3,4267,4206,61,41,41,0,98.35587377
5416a7c1d5081aa6739cabf6db1177794bb10b44,1,4,2,2,0,0,0,1,2,129,1,1,0,236,20,2,42,42,0,1846,1844,2,17,17,0,100
f93d47042f528681e2a2b0097a9b6a432a2febd2,1,3,2,1,0,0,0,1,2,147,1,1,0,77,21,2,13,13,0,530,511,19,10,10,0,100
ec2eccda4df612dd982e555205209b651c1ed9d0,2,270,13,257,0,0,0,2,15,181,1,2,0.79551006,842,429,2,155,123,32,7505,5966,1539,54,44,10,100
e66c2f07cc688c7a2eb71bd7f7a1fa99e5de0140,1,5,3,2,0,0,0,2,16,2,1,1,0,711,430,3,138,137,1,4285,4275,10,39,39,0,100
f4a8abf23bf95124a34e0c9596741898f6129068,4,302,75,227,1,0,1,2,17,82,1,4,1.918872966,1387,431,4,235,220,15,11606,10118,1488,87,78,9,98.51655629
b24df614d6aaed4ccfcd3d473255466fd84f6ba7,6,88,51,37,0,0,0,2,14,614,2,3,1.648164627,872,432,3,130,128,2,7238,6984,254,73,70,3,100
370c292b159a4c7b3b8ce40321f454f08ad31e21,30,460,124,336,4,0,4,1,49,780,9,17,4.540454355,2501,158,0,367,338,29,21079,19395,1684,160,155,5,98.72594199
977a25b73315371edcdff038e3b5da34ab638042,2,0,2,2,0,0,0,2,6,0,2,2,1,110,159,1,15,15,0,716,746,30,12,12,0,99.81106613
82c145a0410a31a3733a6d3334d21e40880cd86e,7,456,10,446,1,0,1,2,52,342,5,7,1.707960833,1206,433,4,161,137,24,12100,9235,2865,94,84,10,99.94606257
bd0586ddb8fae96cb5620d5db42a150c4296963f,1,17,1,16,0,0,0,2,4,14,1,1,0,232,434,5,43,41,2,1911,1841,70,18,17,1,100
477d842c2736259266944ae2ba71dccacb5ccf09,0,0,0,0,0,0,0,0,0,0,0,0,0,0,22,0,0,0,0,0,0,0,0,0,0,100
2c9adff8ae7693c5bdc8f77aa9965d7a08fa900f,0,0,0,0,0,0,0,0,0,0,0,0,0,0,435,6,0,0,0,0,0,0,0,0,0,100
5e9e3cb34659a6c677166842bc161ba2857d1915,4,901,16,885,2,0,2,1,18,25,2,2,1.608696569,837,436,7,253,162,91,10458,4577,5881,103,68,35,97.46905089
0baa77b86eaa813787a713e8f80c11302274f15d,4,639,79,560,1,0,1,1,19,24,2,2,1.134162561,1408,437,4,275,223,52,12938,9911,3027,97,73,24,99.94385177
b1e089a78855da4a1f51e68a9ee56a52afd820a8,1,28,18,10,0,0,0,2,20,5,1,1,0,1059,438,3,229,227,2,6578,6531,47,58,58,0,100
317066fa8749169d9dca03f60a943ea195c9cad6,1,4,1,3,0,0,0,2,21,3,1,1,0,1069,439,3,229,229,0,6606,6578,28,58,58,0,100
9a36b2b77df486f11a2a5653e90dd334a9bd6c3f,1,5,1,4,0,0,0,2,8,1545,1,1,0,724,440,2,44,43,1,7818,7785,33,41,41,0,100
d268487ccf566a2f8ba2c3666e50bfcef28e2462,1,6,3,3,0,0,0,1,5,1974,1,1,0,545,441,3,33,32,1,4104,4077,27,27,27,0,100
06a61b602363b4e86fd2e0fcbdc8284ddfd70230,4,23,2,21,0,0,0,3,21,121,3,4,1.842292189,694,160,0,117,115,2,3791,3734,57,75,73,2,100
fae40583d026e94a77f3bf6168bb53a917c24b38,11,1221,27,1194,4,0,4,3,52,221,5,7,2.75814777,5109,442,0,647,523,124,44712,38188,6524,242,195,47,99.80397648
02fea3a67e16bd12fecd8dc2818e34064f332c5d,4,46,19,27,0,0,0,1,6,168,2,3,1.086929852,213,161,1,31,24,7,1824,1579,245,13,12,1,100
db926c9e742525acfd3c6f28f5f562782e904e38,2,50,0,50,1,0,1,1,22,130,1,2,0.529360865,441,443,1,81,81,0,3130,2875,255,33,33,0,99.94413408
611ffae8d1bec04bffc93605f7acc8f1e8c7f728,1,7,0,7,0,0,0,2,53,134,1,1,0,412,444,2,70,69,1,3133,3105,28,34,34,0,100
be727f18c967ce78f4e290a2cdf4614738a65046,12,627,7,620,5,0,5,1,13,883,1,6,3.267297551,1144,445,3,204,142,62,14154,10523,3631,105,75,30,92.38774903
c414c58ad541b2fd04a86c98bbfd730a2d6a1207,2,19,5,14,0,0,0,1,23,59,2,2,0.41381685,1482,446,4,273,273,0,9885,9782,103,73,73,0,100
b618ff3e350eb24a0626b5ae90e1c246ce5e325b,6,413,0,413,6,0,6,1,1,0,1,2,2.492796223,0,447,5,29,0,29,1970,0,1970,15,0,15,99.55668144
0c1ff50fe9e1d82ab12be8d8246a416f02106e8e,5,312,25,287,3,0,3,2,4,259,3,5,1.999121285,210,23,0,63,44,19,3721,1936,1785,24,14,10,99.68434343
dc86bde75682c7a69b7bb3fb24908b18f3ee0e42,2,16,12,4,0,0,0,2,3,1114,2,2,0.985228136,123,448,5,23,22,1,838,832,6,15,15,0,95.64186184
928b4a27a15246fa7901418fe43ee0649adf0c14,3,43,2,41,0,0,0,2,11,1621,1,2,0.819418662,1348,162,0,107,101,6,15735,15373,362,54,52,2,100
55f9405c415225b3fe2d3cb5c1753bcf95b760c5,4,280,152,128,0,0,0,2,24,138,2,2,0.45585089,2001,0,0,330,305,25,15039,14173,866,111,99,12,100
2fc2220f558df0b67a11e0a86558b7cd894f1084,2,43,38,5,0,0,0,5,53,53,2,2,0.380946586,4182,0,0,410,409,1,31783,31740,43,134,133,1,100
c59bfeb3a1467606568df6829c0edc6cdc801fb5,15,245,520,275,3,0,3,2,5,548,7,9,3.249751914,1131,24,0,148,181,33,7404,8968,1564,80,98,18,99.49762769
d88a2878c182d484f388519134b817c501354708,12,605,43,562,9,0,9,1,54,287,1,3,3.461287452,698,449,0,183,123,60,7826,5344,2482,89,64,25,99.25020828
0450f8420896e353032694e689abb6f18d1a7730,0,0,0,0,0,0,0,0,0,0,0,0,0,0,450,1,0,0,0,0,0,0,0,0,0,100
ccfe33d5dea846a6255639945269163ee47d2079,3,55,4,51,0,0,0,3,50,408,2,3,1.415050252,902,451,2,120,117,3,8832,8364,468,40,39,1,100
31bb1e029f7a4d89e0f6bb2846e2464babbaa858,27,801,206,595,9,0,9,1,5,472,4,9,3.851863093,934,25,1,167,116,51,10147,7461,2686,95,69,26,97.33924612
e20e5b06e3d8184376ab7a53835f3405433e9ee9,3,93,1,92,2,0,2,1,3,0,1,1,1.105810441,93,452,3,19,11,8,873,626,247,16,10,6,99.86122676
f165a6d1901bb5023faba2d61eb5d256012b34eb,7,418,13,405,2,0,2,2,12,726,3,5,2.149691632,2134,453,4,193,169,24,27151,23920,3231,91,85,6,98.76609442
cb5465755a81d9826a3160af3b626f5ef9b39514,1,35,0,35,0,0,0,1,11,0,1,1,0,305,454,5,10,9,1,2837,2638,199,9,8,1,100
470400f12ed66e1a15cc67be0963b3fb8b6a0e43,4,10,134,124,0,0,0,4,21,252,3,4,1.709940977,965,26,1,95,107,12,7640,8613,973,42,46,4,100
26361b6e7ad5021746b4f6cfda081ca69b274f4d,3,12,31,19,0,0,0,4,22,169,2,2,1.549377563,648,27,2,71,74,3,5947,5977,30,29,29,0,100
48b4ad74d4f4fedeeb2aa71e09043a7eff902628,9,79,42,37,0,0,0,2,54,351,4,5,2.906536173,4418,455,2,228,228,0,39203,38770,433,131,131,0,100
87fcd4d65bf6ec1bc97e346cd6003d41399b272f,9,450,17,433,2,0,2,1,7,285,4,7,1.909892162,532,163,0,117,69,48,5610,3542,2068,53,35,18,99.89615784
539557c902404529c4636bfe0425ba44980cc177,1,1,0,1,0,0,0,2,12,342,1,1,0,202,456,3,43,43,0,1433,1427,6,12,12,0,100
055c9df524e251b852986324141464497c3a402b,1,7,6,1,0,0,0,1,2,17,1,1,0,197,164,1,33,32,1,1325,1317,8,10,10,0,100
42f8ec75e4810d2629f1be8258908c50fa627b58,1,6,1,5,0,0,0,1,3,27,1,1,0,199,165,1,35,33,2,1353,1325,28,11,10,1,100
501fd7e660d15ea92705ccd69bebb3342c885fab,8,216,49,167,1,0,1,2,14,862,5,7,1.981366918,1458,457,0,329,313,16,11205,10648,557,122,112,10,99.94815967
d6f6f6efc10b19a487c9101f2f0261f978f19d5e,8,609,34,575,1,0,1,1,7,242,2,3,0.940029835,780,166,2,141,105,36,7970,5127,2843,73,47,26,98.46609257
58ffaf2136bd065b5a6d74444611919cf15dad8a,2,9,3,6,0,0,0,1,6,237,2,2,0.979868757,139,167,2,23,22,1,908,887,21,14,13,1,100
0a9f33b03ed57e37eaebba62db78ff948ea1aae3,9,483,0,483,9,0,9,1,1,0,2,2,3.094817652,0,168,3,51,0,51,1418,0,1418,31,0,31,99.44320713
9c65733f0fb419e88b3ffc84714155555266952b,3,65,2,63,1,0,1,2,8,1021,2,3,1.372058851,200,169,4,45,40,5,1640,1356,284,14,11,3,99.04371585
999831779eeb2dbaffc2e655ac1727382dc93afa,2,42,2,40,0,0,0,1,13,92,1,2,0.773226674,598,458,1,86,84,2,5163,4918,245,26,25,1,100
8a057724991d1ba0c38d3619b9aada265faf8674,4,46,0,46,0,0,0,3,22,267,3,4,1.569955304,628,459,2,108,102,6,3462,3265,197,80,77,3,100
d98f8dd5fcd505073a361de97c135706bad2d343,4,24,1,23,0,0,0,3,55,36,3,4,1.647351814,980,460,3,166,163,3,6076,5987,89,105,103,2,100
8005afe13790480ae3e590fef643a69901c548f6,4,95,2,93,1,0,1,2,9,736,1,3,1.782326997,1452,461,4,182,177,5,14250,13838,412,87,82,5,99.94609164
1755fdfa0fbdb9a016383bfd07905489c89a9319,2,24,5,19,0,0,0,3,5,1692,1,2,0.978449329,122,170,4,20,20,0,1042,904,138,2,2,0,99.83844911
33bb1ce5727a54721baec0125dd1254d275160ac,59,866,528,338,1,0,1,1,15,1472,10,23,3.824437313,8091,462,4,918,899,19,76522,73879,2643,539,523,16,98.19650067
34b1cd03d57c742bfe182c54a4fef21103a15fb6,1,50,0,50,0,0,0,1,2,1,1,1,0,88,463,5,3,2,1,1503,1100,403,3,2,1,100
9f354a4559d2679590100cb7b0df3578a229d49c,0,0,0,0,0,0,0,0,0,0,0,0,0,0,464,6,0,0,0,0,0,0,0,0,0,100
0aa422e648ad53d6aa3f6134c27c92dee5b86e5a,1,2,2,0,0,0,0,2,9,23,1,1,0,538,465,7,119,119,0,4068,4090,22,29,29,0,100
e385625006829bfd3373645c08471dd75473f6a6,1,26,14,12,0,0,0,2,8,450,1,1,0,622,466,8,26,25,1,5033,4882,151,23,22,1,100
37b41663f91d930bb785e9a562bb60d0d63f0818,16,373,118,255,0,0,0,4,55,462,2,3,3.274965812,6756,467,9,362,362,0,57438,55677,1761,253,253,0,99.97307485
8cd9b40fc0be8719f0e305bcd718cc681efda0ae,8,14,8,6,0,0,0,1,56,0,1,1,2.824242144,4831,468,10,224,224,0,39465,39424,41,147,147,0,100
d5a875982b6ae2acc8028185bf88d312e124cb91,6,53,54,1,0,0,0,4,57,29,2,3,1.462748654,4654,469,11,278,278,0,37948,37966,18,129,129,0,100
af5d6abeb924fc9233376a899bd482218444b1db,9,6122,6132,10,0,0,0,2,58,0,1,1,2.113080392,5251,470,12,0,250,250,3392,42405,39013,0,165,165,99.70398278
5c4e4d2ecd6fb333ef62bd24f14e7919dde7ba37,6,1556,1555,1,0,0,0,4,25,0,1,2,2.293181322,1654,471,13,13,97,84,3127,14254,11127,12,75,63,99.78483055
c9b24897e3cdbbd9a1e60fde76b459828ab2ee52,2,3,3,0,0,0,0,3,12,523,2,2,0.918295834,207,472,14,15,15,0,1631,1621,10,13,13,0,100
2e530d3b69a53d391213776d299cb1b5cc19543c,3,6,5,1,0,0,0,3,56,70,2,2,1.322179346,851,473,15,83,83,0,7751,7729,22,46,46,0,100
04b5561ea9a558a4b15c330c325779823c924777,2,10,2,8,0,0,0,3,14,1067,2,2,0.918295834,281,474,16,23,23,0,2362,2250,112,22,22,0,100
a4ab854fab50b239c7723ea6616760b3a4749aae,1,2,2,0,0,0,0,3,16,35,1,1,0,178,475,17,33,33,0,583,583,0,33,33,0,100
2bb8d1e0d3f1a0c39f456701fef2e9011d94b568,3,3625,3619,6,0,0,0,5,59,6,3,3,0.017445685,280,476,18,157,30,127,25494,2178,23316,79,19,60,99.97310382
56cedc0ae038b1447ae125b4b8d1094bd1db5551,13,4058,4058,0,0,0,0,4,26,0,1,2,3.551177214,492,477,19,208,0,208,31397,4548,26849,168,0,168,99.75780409
9632b697060bfeffa2e03425451a3e9b3980c45e,6,57,27,30,0,0,0,2,60,0,1,1,2.347656283,4556,478,20,212,212,0,37270,37097,173,133,133,0,98.93503727
eda2fa5e74f06357d9387d7b672f13418e10cf66,2,2,2,0,0,0,0,1,9,188,1,2,1,210,171,1,34,34,0,1305,1305,0,12,12,0,100
43bb06d66b35d6cdc00a7d8a8f8c1305efc993ed,4,87,42,45,0,0,0,3,57,26,3,4,1.623016373,1001,479,17,175,166,9,6407,6098,309,115,105,10,100
99d7b8f73616e182c4c04101aff7cdbc9d0ed6c6,1,4,4,0,0,0,0,3,25,0,1,1,0,367,480,18,67,67,0,2041,2041,0,42,42,0,100
4124b556b66c72f51208fac59fbcbccd2e3f26e8,3,26,7,19,0,0,0,4,33,821,2,2,1.404826958,879,172,1,118,113,5,7843,7741,102,34,33,1,100
e7d7516b0e25e6b4e1a3c1598b5cd411f2f84504,2,36,15,21,0,0,0,1,5,334,1,2,0.95260921,866,481,19,97,94,3,8188,8054,134,57,55,2,100
319ec0e46cbfbc610868501b2611c9fca931e6bd,1,1,1,0,0,0,0,2,5,0,1,1,0,256,28,0,54,54,0,1844,1844,0,17,17,0,100
fa56190a3de7d33ac07392f81def235bdb2d258c,0,0,0,0,0,0,0,0,0,0,0,0,0,0,29,1,0,0,0,0,0,0,0,0,0,100
5a08e3742da32b75820d22b0acaf37a485d3df65,2,9,4,5,0,0,0,1,8,753,1,1,0.961236605,299,482,4,53,52,1,2111,2066,45,25,25,0,100
751b14a25f994370a318bb990d01704bd10dcca6,2,6,2,4,0,0,0,2,9,90,1,2,0.811278124,259,483,4,32,31,1,2182,2114,68,16,16,0,100
e7736bd8010b20f857685583a8b3fff560430e7a,0,0,0,0,0,0,0,0,0,0,0,0,0,0,484,5,0,0,0,0,0,0,0,0,0,100
d3582aeb7e34288fa0a54c6cfbf5286cbb7b6b95,2,90,8,82,0,0,0,2,10,4,1,2,0.849260782,263,30,2,41,32,9,2970,2182,788,21,16,5,99.97367035
39aa06ee8655cdf4e2d1875868a3a1875a3ac2cd,3,12,3,9,0,0,0,1,5,738,2,3,0.905587262,299,173,1,55,53,2,2205,2169,36,19,19,0,100
ddaf373fc14e0ae10d6ead8660673681774d8320,4,95,0,95,1,0,1,1,10,75,2,3,1.660405615,225,174,2,37,31,6,2074,1695,379,11,9,2,99.89476454
1671f684fa43ccc2f9901521a1df69605dedabc6,2,15,2,13,0,0,0,1,11,6,1,2,0.787126586,229,175,2,34,34,0,1669,1609,60,10,10,0,100
18a2eecd73d82c0e270cb0706a643cddaea4dbb6,1,8,1,7,0,0,0,2,4,211,1,1,0,183,176,3,42,41,1,1310,1274,36,15,14,1,100
0a919c0b100d22bb0252ec8bac25b197f8ee87e4,3,2,2,0,0,0,0,3,9,52,2,2,1,688,177,4,35,35,0,6010,6012,2,29,29,0,100
3607f38fcf1b499579da7b11c1992484197d9a56,2,1,4,3,0,0,0,3,58,70,2,2,0.970950594,702,31,1,125,125,0,5275,5295,20,53,53,0,100
14d72d3d9a1b191c5f871c58a6a296a46a30a373,0,0,0,0,0,0,0,0,0,0,0,0,0,0,32,2,0,0,0,0,0,0,0,0,0,100
ffc4ef94f63f9b3fc407265a8b3b509446379360,5,71,6,65,1,0,1,1,11,287,3,4,1.229814595,442,485,0,93,89,4,3557,3286,271,39,37,2,99.92117709
3506d617c77396992d4d7ed7bced2befb959d3c3,2,53,15,38,0,0,0,1,12,34,1,2,1,238,178,3,37,34,3,1772,1669,103,10,10,0,100
a8abfdd11a50baf766227ad82cad814c371ff227,1,7,5,2,0,0,0,2,6,1761,1,1,0,151,486,1,29,28,1,1145,1124,21,11,11,0,100
79965f175a0e25c0362b279259fb20c4ecc8f75a,0,0,0,0,0,0,0,0,0,0,0,0,0,0,179,3,0,0,0,0,0,0,0,0,0,100
0bcc6594eeeaf76f731f152e3f43f2fb3cfcc1e3,0,0,0,0,0,0,0,0,0,0,0,0,0,0,487,2,0,0,0,0,0,0,0,0,0,100
3158bc842c910bcbc485f16a1fafcc0b6e530093,6,0,0,0,0,0,0,1,1,0,1,2,0,1784,488,0,258,42,216,10630,2658,7972,117,24,93,99.3697479
447b8fd7a328304c6660391ba8941d1d0e8f03d4,14,989,90,899,9,0,9,1,13,67,5,11,3.5221378,918,180,0,183,114,69,10316,5770,4546,105,62,43,98.27360711
9619a398f9ed57d4cd7f705e73f100e85921bfdd,3,333,0,333,1,0,1,1,23,185,3,3,0.363091507,517,489,1,109,92,17,5691,3537,2154,51,37,14,99.94794378
e6a7cb402aafc28cb1d257aecbcc4c4b7d67ba51,10,848,72,776,3,0,3,3,61,437,3,2,2.126960778,4461,33,0,311,239,72,38579,34764,3815,193,129,64,96.33766234
8751e69ce9f7d7e55b65e1af8c7f11ca6c7556a8,0,0,0,0,0,0,0,0,0,0,0,0,0,0,34,1,0,0,0,0,0,0,0,0,0,100
c9bd9785286bc53916e8948e6dd881fabf5e15f3,0,0,0,0,0,0,0,0,0,0,0,0,0,0,35,2,0,0,0,0,0,0,0,0,0,100
784aac55d8519565dc2edc25b8290f3b17d0d349,0,0,0,0,0,0,0,0,0,0,0,0,0,0,36,3,0,0,0,0,0,0,0,0,0,100
f95528434e055a4db8f75cd9c370ec7af88dd21a,5,76,56,20,0,0,0,3,14,173,2,2,2.266921225,1113,490,2,80,75,5,9197,8923,274,67,65,2,99.92207792
48b92898c0e59f4f943a97742facf67fa081d3d9,1,0,180,180,0,0,0,2,6,927,1,1,0,130,491,3,0,14,14,0,982,982,0,12,12,98.06882892
fd0d5197b3fd3440a598a75771d02f96c3691278,3,2,31,29,0,0,0,1,1,0,1,1,0,591,37,4,67,36,31,3667,5898,2231,61,30,31,99.71644612
30a5f7eceba22bdf8723f49e532b4671a2cdf1b3,0,0,0,0,0,0,0,0,0,0,0,0,0,0,492,4,0,0,0,0,0,0,0,0,0,100
22be2b9a731ec254fa010e109223ec29b63ae11a,2,5,3,2,0,0,0,3,18,110,1,1,0.954434003,670,38,5,41,41,0,5063,5051,12,31,31,0,96.11626159
e88632142e839e362c9ed9cdc6b02ce0eb7374bf,0,0,0,0,0,0,0,0,0,0,0,0,0,0,39,6,0,0,0,0,0,0,0,0,0,100
62c759678df9852e92b0f54edd6ed8d2a99cf6ea,2,11,7,4,0,0,0,1,2,32,1,2,0.964078765,220,181,1,18,18,0,2222,2186,36,4,4,0,100
94ec60ca5b8db35c038abf06f2a6e78b4a3cb7c2,2,56,2,54,0,0,0,2,26,586,1,2,0.66319684,1780,182,2,309,305,4,13080,12715,365,94,92,2,100
aba0f0b133aaa331b86e329866ea959753967ca9,1,34,8,26,0,0,0,4,27,0,1,1,0,1335,183,3,289,285,4,8715,8548,167,74,73,1,100
2c18dd898623e707ac382ab680b2501283ebd722,1,10,5,5,0,0,0,3,59,148,1,1,0,444,184,4,72,71,1,3457,3431,26,37,36,1,100
e4a844a7c3a78c2e35e20582a288eb04f9507083,2,6,16,10,0,0,0,3,58,112,2,2,0.902393283,704,40,7,124,126,2,5205,5301,96,53,54,1,100
b036065f786c240eb469192a0eff94f010d59ee3,1,10,5,5,0,0,0,3,59,148,1,1,0,444,41,8,72,71,1,3457,3431,26,37,36,1,100
933e848a627b7ee82c351d103983a564f1046b01,3,72,28,44,0,0,0,2,15,1508,1,2,0.47853391,148,493,5,14,14,0,1363,1047,316,10,10,0,100
db601e350d014bef58b16f7f631c3056d1f00dd3,3,4,7,3,0,0,0,1,12,245,2,2,1.435371391,244,42,9,44,43,1,1818,1840,22,21,21,0,99.89336177
6769bd88906158c2352d1a0aeece5d1e0622452d,2,3,6,3,0,0,0,1,4,508,1,2,0.764204507,137,43,10,18,19,1,1072,1068,4,16,16,0,100
c65fbb87848ca11beee5412cd3f8f9d257105cd5,0,0,0,0,0,0,0,0,0,0,0,0,0,0,44,11,0,0,0,0,0,0,0,0,0,100
432494a17ef2a9c329531b76bd3a4446b866c15e,5,58,8,50,0,0,0,1,25,432,3,5,1.473789401,518,185,5,80,75,5,4295,4012,283,33,31,2,100
0cab1fc8068d9094b9c4913e7dd2c84a03120eef,0,0,0,0,0,0,0,0,0,0,0,0,0,0,494,5,0,0,0,0,0,0,0,0,0,100
8ba1e9c8796b6b0b4df3662e4a29c4a66752f6d6,0,0,0,0,0,0,0,0,0,0,0,0,0,0,495,6,0,0,0,0,0,0,0,0,0,100
cd11749f4365c901de6584820492185aee532378,0,0,0,0,0,0,0,0,0,0,0,0,0,0,496,7,0,0,0,0,0,0,0,0,0,100
878c6ecc5ca90578dd94e4c582fbf52317854cbf,0,0,0,0,0,0,0,0,0,0,0,0,0,0,497,8,0,0,0,0,0,0,0,0,0,100
8397b56b0840ee9c915eab3486ccf9bfe3a5a9f8,0,0,0,0,0,0,0,0,0,0,0,0,0,0,498,9,0,0,0,0,0,0,0,0,0,100
bbf2030c35930644eaeb19a64ee031885efe9c03,0,0,0,0,0,0,0,0,0,0,0,0,0,0,499,10,0,0,0,0,0,0,0,0,0,100
c914d2c459bc6b7e88fc6992d3b7447f9f5b29ee,0,0,0,0,0,0,0,0,0,0,0,0,0,0,500,11,0,0,0,0,0,0,0,0,0,100
f7459f677a977fcc3a4751e65907da1db4f001b6,0,0,0,0,0,0,0,0,0,0,0,0,0,0,186,5,0,0,0,0,0,0,0,0,0,100
fa76388a910be8596ad0221c69e2d9cb90c8f4b4,0,0,0,0,0,0,0,0,0,0,0,0,0,0,501,12,0,0,0,0,0,0,0,0,0,100
248a69e97c27f52d1d3487aa31bebbe680851266,0,0,0,0,0,0,0,0,0,0,0,0,0,0,187,6,0,0,0,0,0,0,0,0,0,100
8612457bf21ca1c8dd31ffe611ba586d6d1046ae,0,0,0,0,0,0,0,0,0,0,0,0,0,0,502,13,0,0,0,0,0,0,0,0,0,100
77859b8d053204ff6adb8c33532b8faac8d11a75,0,0,0,0,0,0,0,0,0,0,0,0,0,0,45,12,0,0,0,0,0,0,0,0,0,100
dea8391172344586528e177bbbed1ac67d00894d,0,0,0,0,0,0,0,0,0,0,0,0,0,0,188,7,0,0,0,0,0,0,0,0,0,100
0c9c334cb2d7bc5f4cb6609734de1654197d5ada,2,8,1,7,0,0,0,1,4,2,1,2,0.918295834,163,189,8,21,20,1,1403,1363,40,4,4,0,100
b315194fb92476805f72465514a1d038b924125e,0,0,0,0,0,0,0,0,0,0,0,0,0,0,190,9,0,0,0,0,0,0,0,0,0,100
5c433c11fe46bc6ed3c64fa44d4a62c8f1ddb678,0,0,0,0,0,0,0,0,0,0,0,0,0,0,191,10,0,0,0,0,0,0,0,0,0,100
3c0f082c4d196ea1f46f21ad965bae2ebf310eed,0,0,0,0,0,0,0,0,0,0,0,0,0,0,192,11,0,0,0,0,0,0,0,0,0,100
1509453c5a5281fea39a1bc6aded653e3bd7f517,0,0,0,0,0,0,0,0,0,0,0,0,0,0,503,13,0,0,0,0,0,0,0,0,0,100
2504be2fa3e1d8f6aa96ee6297ca1af2d5077826,1,2,2,0,0,0,0,1,2,297,1,1,0,36,193,12,8,8,0,199,203,4,4,4,0,100
82539e4024cdf3ed74f25d12705fc3b7a091efc2,3,196,0,196,3,0,3,1,1,0,1,3,1.532031358,0,46,0,17,0,17,804,0,804,9,0,9,99.65416334
a70a3b56cf54e1c1088d57bf7f4c1dbe06b291c4,42,3188,585,2603,10,0,10,2,60,686,9,24,4.335232935,6902,504,0,1349,1062,287,68349,52015,16334,617,504,113,95.6532856
3f5670db42ef684d814b0fb31794c6771f574c9f,7,493,15,478,1,0,1,3,27,103,4,6,1.603501373,1137,505,1,238,194,44,9016,5888,3128,174,145,29,96.25093727
ffeb989b0c50fdb78292a8b367fd883990f013c2,0,0,0,0,0,0,0,0,0,0,0,0,0,0,47,1,0,0,0,0,0,0,0,0,0,100
1f94d588a20c5384e79b8935a5dbf4fbd4c1fb6c,4,9,1,8,0,0,0,5,62,1140,2,3,1.570950594,3251,506,2,182,180,2,26214,26169,45,89,89,0,100
baeb6c3e9c28037953b307090321e00b3a53fdba,1,2,2,0,0,0,0,5,63,0,1,1,0,2940,507,3,126,126,0,23879,23863,16,60,60,0,100
0b527aca1f260a76aafae664b859c3978093056e,3,26,28,2,0,0,0,5,64,120,3,3,0.871095535,3395,508,4,209,211,2,27304,27298,6,95,95,0,100
05fd6fefceb779a2d748068232afe023dd49d1b2,1,20,14,6,0,0,0,1,7,341,1,1,0,35,509,5,3,2,1,342,254,88,1,1,0,99.97465788
ea7efe7add95ae62fb6f6b0f3287e13a09653b56,0,0,0,0,0,0,0,0,0,0,0,0,0,0,48,2,0,0,0,0,0,0,0,0,0,100
96e396223511980abefed2c6d47b1a0851247a5f,26,303,305,2,2,0,2,1,61,1484,9,18,3.57075438,3619,510,6,522,512,10,26065,26248,183,360,353,7,97.99107143
374f51e0240eb81c3bc60daca8acd24a68bb7c77,1,18,2,16,0,0,0,1,3,0,1,1,0,14,511,7,5,2,3,129,81,48,5,2,3,99.97571637
7806a411a847442723dbe4b064aacdce896d1d61,3,268,6,262,1,0,1,1,65,2,2,2,0.687422404,3150,512,8,177,162,15,27229,25504,1725,86,76,10,96.50665996
5f0bfdf8791c28b8ed804bc81ad48c2e1223ea15,2,3,29,26,0,0,0,1,2,5,1,1,0.200622324,435,513,9,27,30,3,3591,3739,148,22,25,3,100
8a6545109f257977838e015820ca9f1ca18aac74,4,117,11,106,0,0,0,1,13,263,2,3,0.931189198,1019,514,10,163,160,3,9379,8533,846,59,58,1,100
8bee25912d72500a800e1759185ef5330cc3a995,4,11,117,106,0,0,0,1,14,0,2,3,0.931189198,1109,515,11,160,163,3,8533,9379,846,58,59,1,100
5f27642e98d9fbe101ddab13153319d4b94717aa,2,29,3,26,0,0,0,1,5,1,1,1,0.200622324,416,516,12,30,27,3,3739,3591,148,25,22,3,100
3d37f7b274a324a2c34041b0c209ebcb4f954a68,3,6,268,262,0,0,0,1,66,2,2,2,0.687422404,3347,517,13,162,177,15,25504,27229,1725,76,86,10,96.50665996
26338adc5f49e77c2bae4f3e01e520a8b6ae4c3d,3,268,6,262,1,0,1,1,67,3,2,2,0.687422404,3150,518,14,177,162,15,27229,25504,1725,86,76,10,96.50665996
6f7bd2339250027751f73ceb96a94150551f985b,22,85,350,265,0,0,0,3,68,146,4,4,3.638553766,8966,519,15,484,510,26,70649,71728,1079,334,360,26,95.87366276
8008d559c6b6ba15b55e711ad262530ef4300948,2,38,46,8,0,0,0,5,69,0,1,1,0.371232327,3099,520,16,137,137,0,25203,25183,20,70,70,0,100
62da197bfd98ab26b07a1d6f72c7e36dc0952978,13,42,75,33,0,0,0,3,21,0,1,1,3.49586806,3544,521,17,183,183,0,29361,29459,98,158,158,0,100
9c5c6b7efd66ee1df46240a83c9e639c6e869c32,2,3,29,26,0,0,0,1,9,0,1,1,0.200622324,433,522,18,27,30,3,3607,3755,148,22,25,3,100
3ddb28ea3d61de8413c86eaa1c9b5126b24aed31,4,24,24,0,0,0,0,1,8,12,3,4,1.055353219,1155,523,19,86,86,0,9215,9383,168,57,57,0,100
c2635885dddf6cfb4db85cfe16dbe5dfd476cbb5,8,332,9,323,2,0,2,1,18,1054,3,5,1.566943538,735,49,2,147,124,23,7455,5706,1749,82,66,16,96.0010124
a6d4cbab6e36341ed0bc5eccabe49d1277271d74,2,46,16,30,0,0,0,2,11,2718,1,2,0.999249248,109,194,0,25,21,4,1070,875,195,11,10,1,98.93992933
e341e597f8a3817bc1db884695774e9dfd5d9a51,1,21,1,20,0,0,0,1,14,158,1,1,0,177,195,1,30,28,2,1327,1217,110,7,7,0,100
3a7799fbff76003b5f11ac314ae31a8b7c568c63,1,1,1,0,0,0,0,2,2,35,1,1,0,174,196,2,32,32,0,1517,1515,2,13,13,0,100
7861f20e5c318b5dcfe28949b68d5c8d82b4b390,9,140,53,87,0,0,0,1,70,375,3,4,1.455014049,4991,524,20,362,361,1,41432,40793,639,170,171,1,100
8706baa1d5da3adc578f237e183605278e0b6552,1,1,1,0,0,0,0,2,3,0,1,1,0,174,197,3,32,32,0,1515,1517,2,13,13,0,100
5bd464f5200c8184b24feed158002677be1a1584,5,74,44,30,0,0,0,1,11,0,4,5,2.116322367,1372,525,21,98,94,4,11617,11532,85,68,64,4,100
611c52fba429136a2c9ecc201dc94339e559ba7e,2,2,2,0,0,0,0,1,10,1249,2,2,1,573,526,22,38,38,0,4155,4119,36,30,30,0,100
d146064c734840fafc424d23ae65e5eed34372f6,1,1,0,1,0,0,0,1,11,0,1,1,0,542,527,23,34,34,0,3918,3905,13,28,28,0,100
df0fe7ceffb89bce681515088bfd90617a95a56e,11,26,15,11,0,0,0,1,18,558,5,8,3.049522968,1544,528,24,178,178,0,11681,11681,0,95,95,0,100
8013ff479afd7c4df24b1af35746af6940fb332a,2,8,0,8,0,0,0,2,19,0,1,2,0.543564443,286,529,25,52,52,0,2261,2198,63,21,21,0,100
3becd55ddd7d6e2591c2968444341c98c1fa61e2,1,40,6,34,0,0,0,2,20,0,1,1,0,253,530,26,55,50,5,2135,1913,222,21,19,2,100
933b73e77ba96965b8f8ed15f28f4fb17db09ac9,3,29,18,11,0,0,0,1,19,354,2,3,0.695293133,295,531,27,46,46,0,2449,2344,105,20,20,0,100
d98a80f2e8d4589e316cb9c01278c0377ee0dc6d,7,16,5,11,0,0,0,2,20,1701,2,7,2.62472621,458,532,28,62,61,1,3535,3463,72,33,33,0,100
a8b190deecd318f4109996a3205f97dc759730fb,1,7,5,2,0,0,0,1,12,1,1,1,0,233,533,29,8,8,0,2261,2240,21,7,7,0,100
3e36bc69be673bb9c17569d951474e9d1bc50122,0,0,0,0,0,0,0,0,0,0,0,0,0,0,198,4,0,0,0,0,0,0,0,0,0,100
99593c2e7054dc234b00194ccea4f13ba428df44,6,128,15,113,0,0,0,1,15,277,4,5,1.789068332,991,199,5,124,114,10,7038,6198,840,73,66,7,100
2074cddf07218ccdd7c198292519cc6df2577e4c,10,75,137,62,0,0,0,1,21,332,6,10,2.998639341,1988,534,29,225,233,8,15229,15626,397,121,126,5,100
687dd1da951be2f4efa50d2d4704f0ad38ce7bd9,1,11,0,11,0,0,0,3,62,29,1,1,0,624,535,30,118,118,0,5064,5021,43,48,48,0,100
7edeac5d80e161663fea14bafd4d7f662d25d767,7,54,19,35,0,0,0,2,63,18,3,6,2.599285131,2046,536,31,403,394,9,16135,16009,126,120,120,0,100
51194fbbe5662b16bd644d64faa450e43f771c80,9,166,10,156,0,0,0,3,28,788,4,8,2.359408672,1367,200,6,283,252,31,7917,7250,667,188,177,11,100
7819df6387a0726acae01f8f6942c7331d4a5420,5,45,18,27,0,0,0,1,17,658,4,4,1.897473717,816,201,7,136,132,4,5289,5151,138,54,53,1,100
a492c678ae3bf9a5f661a9127508fe5dfe24f9ac,1,35,0,35,0,0,0,1,4,16,1,1,0,437,202,8,36,34,2,3047,2752,295,29,28,1,100
ce52a55429535eeb034d7dae2a7d01f54c57be2f,3,279,17,262,0,0,0,1,53,83,3,3,1.071344591,950,537,27,118,90,28,10029,8460,1569,53,40,13,100
15ae0d7818b5c1ff2710295437f410b1a5b4d3ed,0,0,0,0,0,0,0,0,0,0,0,0,0,0,203,9,0,0,0,0,0,0,0,0,0,100
8cb451daf2d2db841780eab78afe928de397c966,6,137,7,130,0,0,0,3,29,77,4,5,1.876001323,1352,538,25,267,244,23,7742,7102,640,190,179,11,100
ff8c1e250d0dec9e274bed548186af22d66af71a,7,143,35,108,0,0,0,2,16,660,5,7,2.145460408,1414,50,0,206,196,10,12064,11464,600,82,77,5,100
278ca7e8a83e906f466cae9a296d7a9ad0a4968f,2,4,2,2,0,0,0,2,7,740,1,2,0.918295834,322,51,1,34,34,0,2956,2910,46,18,18,0,100
61b4f8d2418e7b459aa74f57d074afbf1382c277,4,377,0,377,4,0,4,1,1,0,1,2,1.641257895,0,539,5,28,0,28,2345,0,2345,15,0,15,99.75296443
69cbfa58705def7f80e0a31e05924505f8b2811e,4,355,8,347,2,0,2,1,4,92,1,3,1.369566209,67,204,4,43,13,30,1888,570,1318,23,5,18,99.77870666
6c7a0599ccb7cae2be77bd46ebc4d41eccd1a4c8,1,10,11,1,0,0,0,3,64,45,1,1,0,633,540,3,119,119,0,5072,5076,4,48,48,0,100
e1ef89a7b2fa43dcbc707a0d1e977eb2eddf8d09,1,5,3,2,0,0,0,2,18,48,1,1,0,214,205,1,36,35,1,1446,1438,8,8,8,0,100
566155285031dbd8b01527072a586a9ddcb65142,0,0,0,0,0,0,0,0,0,0,0,0,0,0,206,2,0,0,0,0,0,0,0,0,0,100
148c6adbe0bd2fe72ac0b7a71d3e7f1d8b6d3b35,0,0,0,0,0,0,0,0,0,0,0,0,0,0,207,3,0,0,0,0,0,0,0,0,0,100
d76947cc7fb997b10dbda3fc06cafad8874a5664,0,0,0,0,0,0,0,0,0,0,0,0,0,0,208,4,0,0,0,0,0,0,0,0,0,100
64e46bfcbc755f3f369365ad97167cebc763cee5,0,0,0,0,0,0,0,0,0,0,0,0,0,0,209,5,0,0,0,0,0,0,0,0,0,100
bbeffd82c64f645814062ef0e451caa7677ab1fc,0,0,0,0,0,0,0,0,0,0,0,0,0,0,52,2,0,0,0,0,0,0,0,0,0,100
32690d2049f42fad35078d22864b4348a2efa5ba,2,64,0,64,1,0,1,1,12,40,1,2,0.69621226,80,210,6,17,10,7,996,696,300,7,4,3,99.9509082
ae185396f89ace1338c5db327606ac6e505fbed9,0,0,0,0,0,0,0,0,0,0,0,0,0,0,211,7,0,0,0,0,0,0,0,0,0,100
4b08fb4c580fb2d385b7d5ab910b2a29b4ad1aed,0,0,0,0,0,0,0,0,0,0,0,0,0,0,212,8,0,0,0,0,0,0,0,0,0,100
1996652bab5b714b9c7c4d5698efb0f0bf5cd913,0,0,0,0,0,0,0,0,0,0,0,0,0,0,53,3,0,0,0,0,0,0,0,0,0,100
c28224c876f1b646ddefeb66b94d517a2f170935,4,144,38,106,0,0,0,2,17,776,2,3,1.522946637,1375,54,2,214,199,15,13055,12403,652,96,91,5,100
9bc05de0763b653e001cd3aa2e4a73c7a3584de9,1,12,4,8,0,0,0,2,7,469,1,1,0,125,55,3,5,4,1,1255,1220,35,5,4,1,100
4488a043bd440d0af0c77a008e12507c13b6dea4,0,0,0,0,0,0,0,0,0,0,0,0,0,0,213,9,0,0,0,0,0,0,0,0,0,100
2eb51e601ada268c178e746478dd7945ec26ec12,8,184,36,148,1,0,1,2,12,568,4,6,2.379752664,634,541,0,89,88,1,6318,5123,1195,48,47,1,99.92643453
a738b878b39c92046fedf15dfaed577598fc8c43,1,44,2,42,0,0,0,1,3,89,1,1,0,249,56,0,15,14,1,2198,1942,256,12,11,1,100
47edcbc16c040f6a68a9e15354439188a79fe3b0,1,3,5,2,0,0,0,2,5,3003,1,1,0,66,214,0,8,8,0,428,438,10,8,8,0,100
98057fd20db280b3dcd131425fc50992cf29a1a4,16,16,16,0,0,0,0,2,6,2403,1,4,4,769,215,1,96,96,0,5232,5216,16,86,86,0,100
d88194a2632b66445a6561e5937661d4d38bc274,2,28,3,25,0,0,0,2,23,165,1,2,0.981152234,412,57,0,52,48,4,3823,3710,113,25,23,2,100
a227981fa4287adcb431fa4e17c378117b8ef934,0,0,0,0,0,0,0,0,0,0,0,0,0,0,58,0,0,0,0,0,0,0,0,0,0,100
286e02a44dfb5f9ee101007b46bcb8ee47fa62d7,16,379,27,352,1,0,1,2,30,1390,6,11,3.131505032,3180,59,1,516,468,48,25821,23606,2215,330,311,19,99.85308521
f98abb9c607ec7ec57de0ffabc9192844a98dbb6,0,0,0,0,0,0,0,0,0,0,0,0,0,0,216,0,0,0,0,0,0,0,0,0,0,100
e56c3a048af509eba9a82c7afac3c0e41e64900f,0,0,0,0,0,0,0,0,0,0,0,0,0,0,60,2,0,0,0,0,0,0,0,0,0,100
e2a34700d857ff36526a8b5943e4af56fc77a3cf,1,6,1,5,0,0,0,2,6,126,1,1,0,67,217,0,9,8,1,478,457,21,9,8,1,100
f64fb46186b2a5382af728155cbf0a1d3d7c9adc,0,0,0,0,0,0,0,0,0,0,0,0,0,0,61,0,0,0,0,0,0,0,0,0,0,100
1ee8600ed5c2cd4097d98af36bc24d46c424db03,0,0,0,0,0,0,0,0,0,0,0,0,0,0,62,1,0,0,0,0,0,0,0,0,0,100
adb792de110b15a57dba257c5d8dac5ada76414e,0,0,0,0,0,0,0,0,0,0,0,0,0,0,218,1,0,0,0,0,0,0,0,0,0,100
b65997d50f75cc1ac577b81f1db8f77ebe153401,0,0,0,0,0,0,0,0,0,0,0,0,0,0,63,2,0,0,0,0,0,0,0,0,0,100
b596dca0efa5eff053121211b5c8a0ed3f271a57,0,0,0,0,0,0,0,0,0,0,0,0,0,0,219,2,0,0,0,0,0,0,0,0,0,100
b67e9bc0e83a1804b8801ab6ee508c85913f875e,0,0,0,0,0,0,0,0,0,0,0,0,0,0,220,3,0,0,0,0,0,0,0,0,0,100
c252a251a8e66ccaf960555ef8bac87a4e6b4bb6,1,1,1,0,0,0,0,1,2,556,1,1,0,81,221,3,14,13,1,633,626,7,6,6,0,100
b8fc0d77cdc38d9ba39b937fc7d95ccf622bc866,0,0,0,0,0,0,0,0,0,0,0,0,0,0,64,3,0,0,0,0,0,0,0,0,0,100
5750a7cd9931c64fc65d116f2718df3d6c173d45,4,185,185,0,0,0,0,2,14,1029,3,3,1.712508596,1119,222,4,82,92,10,8074,9298,1224,51,59,8,100
c9b1cfda2d26dac36d40bcd3e31002d62e2e6407,0,0,0,0,0,0,0,0,0,0,0,0,0,0,65,3,0,0,0,0,0,0,0,0,0,100
58322f6146e312f93b8fea5bfcfd4ed39653cce4,0,0,0,0,0,0,0,0,0,0,0,0,0,0,66,4,0,0,0,0,0,0,0,0,0,100
e9c7f3d3bfed08b018a40284f029ffcf696d0994,0,0,0,0,0,0,0,0,0,0,0,0,0,0,223,5,0,0,0,0,0,0,0,0,0,100
3375ee1abd365a80a6bbe256648824d58a256448,0,0,0,0,0,0,0,0,0,0,0,0,0,0,67,3,0,0,0,0,0,0,0,0,0,100
6f57a474ad9c157679dcca5d214f22baaf8ef885,0,0,0,0,0,0,0,0,0,0,0,0,0,0,68,4,0,0,0,0,0,0,0,0,0,100
0bd487d668bd802f8c6a1f34cf0019804fcce6dc,0,0,0,0,0,0,0,0,0,0,0,0,0,0,69,5,0,0,0,0,0,0,0,0,0,100
d64d848dcbd42ee566f8c9cdbe06e7e535b51817,0,0,0,0,0,0,0,0,0,0,0,0,0,0,224,3,0,0,0,0,0,0,0,0,0,100
b37e4293d2abfb2db0b2a63a571ffe7d54866242,4,276,5,271,3,0,3,1,7,382,1,3,1.700826579,88,225,0,23,7,16,2032,776,1256,17,5,12,99.46885563
e5ef45aaecd5dc7372403302fb8be21e485f3a45,3,180,1,179,0,0,0,1,29,904,2,3,1.447776601,2038,226,1,366,342,24,15984,14714,1270,116,109,7,100
b15b65f4d35269a2c28cf4bbcecb43490c42a149,2,74,57,17,0,0,0,1,8,48,1,2,0.113970208,197,227,1,20,16,4,1700,1658,42,11,10,1,100
fb0587976c8a5198b57f3d17c27703f39af01f52,0,0,0,0,0,0,0,0,0,0,0,0,0,0,228,2,0,0,0,0,0,0,0,0,0,100
495369f989e5b5d8307264b75411bb36ae6d45cb,1,6,3,3,0,0,0,1,6,41,1,1,0,218,229,2,31,31,0,1745,1739,6,16,16,0,100
684466faadf4627391bd74042c782ec47a44d6b5,5,119,8,111,0,0,0,1,7,1830,2,3,0.509103842,410,230,3,76,61,15,3652,2989,663,39,35,4,100
6eb64e5256f7d735e1db3cefd10fca6cd67d92ca,1,17,2,15,0,0,0,3,65,509,1,1,0,632,231,4,119,119,0,5117,5072,45,48,48,0,100
62a75e0e015ae35f27a08e156f792b6e5517fb6a,4,88,34,54,0,0,0,5,54,686,3,3,0.787088941,1083,232,0,151,143,8,9050,8735,315,60,60,0,100
ce9aa244163a8db709722eb786f4fb45ec59e7fd,2,40,6,34,0,0,0,5,71,647,2,2,0.258018669,3177,70,0,177,175,2,25946,25715,231,79,78,1,100
5cb02e2f997bc307c432dce84b1040d55b64a4d9,0,0,0,0,0,0,0,0,0,0,0,0,0,0,233,1,0,0,0,0,0,0,0,0,0,100
febf20c0570bdcff727e0053b895cc41b00f1a30,2,70,1,69,0,0,0,3,15,520,1,2,0.857743537,736,71,1,89,82,7,5742,5400,342,42,40,2,99.11778732
2d77f09f86134f4b665a7bbae2d7c04461e114fc,1,15,4,11,0,0,0,2,23,15,1,1,0,247,72,2,53,50,3,1913,1857,56,20,19,1,100
0ff2c9edac99f7b16b9361d15841f8be3741ada5,0,0,0,0,0,0,0,0,0,0,0,0,0,0,234,1,0,0,0,0,0,0,0,0,0,100
d9a4ce6caa238f52f5165f72b2de061c0134ce9c,0,0,0,0,0,0,0,0,0,0,0,0,0,0,235,2,0,0,0,0,0,0,0,0,0,100
f76eec9914c02b97f870326b825d7604dfec02d1,1,12,5,7,0,0,0,4,30,195,1,1,0,1447,236,3,314,310,4,9385,9302,83,78,78,0,100
4fe30705b16ca54dc6a58a88fdd135a4dc59bc75,8,254,0,254,5,0,5,1,55,422,2,5,2.337165421,439,73,2,30,14,16,5666,4627,1039,22,12,10,99.73828218
d5f006586b8b50eb243bda43d2d59232dbd195f8,0,0,0,0,0,0,0,0,0,0,0,0,0,0,74,3,0,0,0,0,0,0,0,0,0,100
9bcca2581bd280ee21d32206b912687471b0183b,0,0,0,0,0,0,0,0,0,0,0,0,0,0,237,3,0,0,0,0,0,0,0,0,0,100
c6caebd4be9b6f1d3882d4e5938007fbaad55678,19,2816,8,2808,14,0,14,3,66,95,4,7,3.890600793,1741,75,2,496,325,171,20970,10220,10750,322,210,112,97.74141507
43d07683b687ffffe9302e390669bfeccdcf98fc,2,103,0,103,1,0,1,1,6,1699,1,1,0.236924747,20,238,4,15,5,10,592,142,450,15,5,10,99.82034583
77c56e2e64dfe347f8d8cfaebbcbaf6755b55618,0,0,0,0,0,0,0,0,0,0,0,0,0,0,76,3,0,0,0,0,0,0,0,0,0,100
c51b0feb65d3bfe90227b54cd3d02a8938fff0c4,0,0,0,0,0,0,0,0,0,0,0,0,0,0,77,4,0,0,0,0,0,0,0,0,0,100
c7c58cddab5e7818d6f2a390cb354a9c16aaf8da,2,52,1,51,0,0,0,3,16,76,1,2,0.23181305,795,78,5,90,89,1,5961,5742,219,43,42,1,100
30298e1e467f9c88503321b6fc6d4525b2e2f41a,0,0,0,0,0,0,0,0,0,0,0,0,0,0,79,6,0,0,0,0,0,0,0,0,0,100
c6aa4700afaeba0d23c643e97feb3410047f5b23,0,0,0,0,0,0,0,0,0,0,0,0,0,0,239,2,0,0,0,0,0,0,0,0,0,100
f345f889508306c739b15c49a462b3d1d838768a,28,1062,7,1055,17,0,17,3,56,100,4,14,4.394055426,2966,80,6,581,490,91,24412,19875,4537,342,276,66,99.08685969
13cea0c5eb39fb22e23505575a76b06a58d3d0ec,1,1,1,0,0,0,0,1,2,1,1,1,0,46,81,7,5,5,0,419,420,1,3,3,0,100
7c9b30aad4ec45c0d4434a24a1332129ceb9e29b,3,69,20,49,1,0,1,2,17,1159,2,3,1.105533758,652,82,4,70,66,4,4836,4603,233,33,31,2,98.329718
47e89d000106ed505280662a1a2f53c589b24fa4,2,119,0,119,2,0,2,1,1,0,1,1,0.814590929,0,83,5,10,0,10,466,0,466,5,0,5,98.28893221
653dbf6a15a9a077e21745abbc4e737970e4570e,4,219,0,219,4,0,4,1,1,0,1,3,1.808208478,0,240,1,12,0,12,738,0,738,9,0,9,99.80267485
6446d5d2f6b379510184eb94f534841a3670122c,0,0,0,0,0,0,0,0,0,0,0,0,0,0,241,2,0,0,0,0,0,0,0,0,0,100
6eb0a6e5bec8222d766d2517af6b91e52a9cb5e7,0,0,0,0,0,0,0,0,0,0,0,0,0,0,242,3,0,0,0,0,0,0,0,0,0,100
3a394adb19573ecff255b1b8858f4586e2d88457,2,60,21,39,0,0,0,3,13,633,1,2,0.99107606,1313,84,6,169,165,4,12656,12421,235,72,72,0,100
b4fea509fde4d292893bd98043f1efc5231d0103,2,21,4,17,0,0,0,1,6,1309,1,2,0.904381458,351,243,4,54,53,1,2701,2622,79,27,26,1,100
5f7d5c2c419d0dba82a66d5c155face158e76000,0,0,0,0,0,0,0,0,0,0,0,0,0,0,85,7,0,0,0,0,0,0,0,0,0,100
99519d4451392243c65e8f3ef35606e5dd339a7b,17,17,17,0,0,0,0,2,7,524,1,4,4.087462841,837,244,4,106,106,0,5699,5682,17,96,96,0,100
33307d5753b946952b5ef2cd5fc09f0a636f33a0,6,568,0,568,6,0,6,1,1,0,1,2,2.373907102,0,245,0,22,0,22,1825,0,1825,15,0,15,99.69458988
3e3db7b4ff62134479bb7f698dbe00152f6ed7ef,9,20,28,8,0,0,0,2,24,1227,6,7,2.561849349,1436,246,1,278,279,1,10481,10461,20,116,117,1,100
5b0dde2bbd2f1b1598095143a91d09a93a92d71b,1,11,2,9,0,0,0,2,19,768,1,1,0,216,247,2,37,36,1,1481,1446,35,8,8,0,100
f1d0ab8b57e79e401e8dd9b4232843d057dd7722,1,12,1,11,0,0,0,2,20,0,1,1,0,222,248,3,40,37,3,1568,1481,87,8,8,0,100
785ea084a617df7ad637a7afed9740bd569c07ae,0,0,0,0,0,0,0,0,0,0,0,0,0,0,249,4,0,0,0,0,0,0,0,0,0,100
de34419d48564049b49451e860bfe8a442e35af6,1,30,0,30,0,0,0,2,6,1186,1,1,0,629,250,5,44,43,1,6518,6344,174,41,40,1,100
7287e35597fffee78cfa2d3de4297c59873b6c6a,2,47,1,46,0,0,0,3,18,99,1,2,0.543564443,833,86,0,91,90,1,6195,5972,223,44,43,1,100
29538657c2c1e89dbcc75fa41128b995dc0724a8,2,39,1,38,0,0,0,2,21,452,2,2,0.669015835,273,251,6,53,43,10,2278,2027,251,13,11,2,100
d4ae9ae5220f1e2dc2a874592276856f35e54b3a,1,101,9,92,0,0,0,3,11,578,1,1,0,200,252,7,13,10,3,2049,1649,400,11,9,2,100
f31e46f5c25b882f3904648907ba1c94dcab794c,13,559,137,422,5,0,5,3,17,1071,3,4,3.245226582,1043,87,1,174,96,78,10542,8194,2348,116,68,48,98.96995708
f9d8e07d768459240c8665f139cc140575dc5216,1,27,0,27,1,0,1,1,1,0,1,1,0,0,88,2,1,0,1,52,0,52,1,0,1,99.957663
9f08a22e2d1366ff7ce4fcd27ef0399a7bc4a0ad,1,1,0,1,0,0,0,3,7,1549,1,1,0,36,89,3,3,3,0,368,359,9,1,1,0,100
87a7592ea9fd2b3ceb40e7e7ec3aadf3c2b8c087,0,0,0,0,0,0,0,0,0,0,0,0,0,0,90,4,0,0,0,0,0,0,0,0,0,100
ee0028fdb31741d6f8f76acec77c32bdd1f37507,1,1,0,1,0,0,0,3,67,153,1,1,0,659,91,5,120,120,0,5187,5178,9,48,48,0,100
027e7018a9cf8eef6671e29c4907d5cd2e4d2cd4,0,0,0,0,0,0,0,0,0,0,0,0,0,0,253,8,0,0,0,0,0,0,0,0,0,100
1bc09836ce8a1cbeb8d4a51283d4974be486210e,0,0,0,0,0,0,0,0,0,0,0,0,0,0,92,6,0,0,0,0,0,0,0,0,0,100
b65a0175bf9e61f775918414e3049f1452aca74e,0,0,0,0,0,0,0,0,0,0,0,0,0,0,93,7,0,0,0,0,0,0,0,0,0,100
253a201e9f7c90a25bd6cb09ebabc4dfa057f1e9,0,0,0,0,0,0,0,0,0,0,0,0,0,0,94,8,0,0,0,0,0,0,0,0,0,100
6d012564d4febbf2a6e0b08f8a08a127a6604acf,0,0,0,0,0,0,0,0,0,0,0,0,0,0,95,9,0,0,0,0,0,0,0,0,0,100
a96176b1f36accb83a0150c214f10ea060f7c9a0,0,0,0,0,0,0,0,0,0,0,0,0,0,0,254,9,0,0,0,0,0,0,0,0,0,100
336c7b3878cec4b4e9455c68dde8553e98fd753d,0,0,0,0,0,0,0,0,0,0,0,0,0,0,255,10,0,0,0,0,0,0,0,0,0,100
fb0dc061fe1200037d7beed48dcfb23c0877fecf,1,2,2,0,0,0,0,1,2,194,1,1,0,39,96,5,6,6,0,232,218,14,6,6,0,100
978826a6f7746ee0531e10ff257fd89720b8cc16,2,73,0,73,1,0,1,1,5,1798,1,1,0.30642473,20,97,1,11,5,6,450,142,308,11,5,6,99.95769882
215cedac6c3348d3ad60e444122436c41ad6da87,2,72,0,72,1,0,1,1,6,0,1,1,0.309543429,23,98,2,12,6,6,449,163,286,12,6,6,99.34252386
b9a30a3e82ec668e769666604cdf7d259b4c689b,1,35,0,35,0,0,0,3,8,126,1,1,0,72,99,3,16,11,5,679,520,159,11,6,5,100
7458fa67095ccefaf4f8ac80512c67c90d4266cb,0,0,0,0,0,0,0,0,0,0,0,0,0,0,256,0,0,0,0,0,0,0,0,0,0,100
e2e39f3faa2f75ac632c425fe916bfed1c6bcc0d,2,293,71,222,1,0,1,3,8,187,1,1,0.987419731,215,100,4,65,32,33,2555,1568,987,47,14,33,99.95746491
869ced5de8b948965b58d2c4415bc1e383a89ba0,2,22,11,11,0,0,0,3,9,2090,1,1,0.945660305,288,101,5,51,49,2,2159,2107,52,25,24,1,100
082455c358f81f62dd48152be8df0ebdcf4b768a,4,840,3,837,3,0,3,1,3,234,1,2,1.492021877,250,102,6,98,11,87,5573,2157,3416,92,9,83,96.84278351
f3ffc815d2bdbfb9003ad2724bb83ede8b0c34c8,0,0,0,0,0,0,0,0,0,0,0,0,0,0,103,3,0,0,0,0,0,0,0,0,0,100
1ad4d0b05ec907c8fcebca4eb844bfa68246d2be,7,93,2,91,0,0,0,4,68,275,4,6,2.505874555,2541,0,0,457,448,9,13894,13596,298,337,332,5,100
91958827383d37cc3835fcd56c385bff489d9b48,0,0,0,0,0,0,0,0,0,0,0,0,0,0,1,1,0,0,0,0,0,0,0,0,0,100
039915f6e642c97d43501c922f451c7cc3e679d9,4,90,5,85,1,0,1,1,10,1908,1,2,0.906711618,343,104,4,62,58,4,2985,2514,471,40,36,4,99.95661605
ebc2ac8192627034b72892744b5277eaf5fc9439,15,65,102,37,0,0,0,2,32,1833,7,11,3.672815792,3467,105,5,399,399,0,28378,28649,271,163,163,0,95.41952946
d6fda9c8d6b8d51f931dd715a4792c000820051f,10,624,15,609,7,0,7,1,11,139,3,6,3.120363442,407,257,0,99,58,41,5785,2997,2788,48,27,21,99.5218171
a7351ae7a7af0fabb621196b84bf512fba2c712e,10,15,624,609,0,0,0,0,10,416,3,6,3.120363442,790,106,4,58,99,41,2997,5785,2788,27,48,21,99.5218171
b5bf07d7d8ebee2861054a516d21c32912cd7f82,11,813,30,783,8,0,8,1,12,126,3,6,3.073157461,407,258,1,118,58,60,6480,2997,3483,58,27,31,99.50209122
b8a2b11e717dee7ad79257753b42b06e080ab2cf,0,0,0,0,0,0,0,0,0,0,0,0,0,0,259,2,0,0,0,0,0,0,0,0,0,100
fd7e79755ceaec2b37dc54e7db3be45f5d3f27ba,11,30,813,783,0,0,0,0,10,379,3,6,3.073157461,895,107,4,58,118,60,2997,6480,3483,27,58,31,99.50209122
3db608ea9ce3e2109ad992013efe3ed811734686,0,0,0,0,0,0,0,0,0,0,0,0,0,0,108,5,0,0,0,0,0,0,0,0,0,100
dccdedda43ef1fd91200469273bcbc98d1b57735,10,50,32,18,0,0,0,2,69,928,4,7,2.727063221,2058,2,2,444,439,5,15598,15435,163,142,141,1,100
0b161c91ffa6323672b27537c74f3cded626e4a3,0,0,0,0,0,0,0,0,0,0,0,0,0,0,109,6,0,0,0,0,0,0,0,0,0,100
54281ba585b67c8cd387c0076bc9d86184fd8351,22,904,81,823,8,0,8,1,68,229,7,13,3.437068636,2622,260,3,598,537,61,23081,19409,3672,238,204,34,99.50209122
9032f6416320679ffb2802a89bb610803fd4bbf0,4,48,72,24,1,0,1,1,2,18,2,3,1.494367172,196,261,4,21,19,2,1264,1386,122,9,8,1,99.9207607
fef119af69f8145fefd0ab68d18afbbb5d98728e,1,37,26,11,0,0,0,1,3,3,1,1,0,208,262,5,31,30,1,1537,1457,80,13,13,0,99.98019017
47c1f4ac2ec942cad7472f7aa3ef6201b96f1e0b,10,50,32,18,0,0,0,2,69,928,4,7,2.727063221,2058,263,6,444,439,5,15598,15435,163,142,141,1,100
8eaf3bbf12c81452c1e0c30fdcd6fefb634b2bf6,1,60,10,50,0,0,0,3,4,71,1,1,0,249,3,1,14,11,3,2264,2148,116,10,9,1,100
1957648c34964696783d06f28b01da8b0c1b02ef,0,0,0,0,0,0,0,0,0,0,0,0,0,0,110,4,0,0,0,0,0,0,0,0,0,100
2bdc703945a3c0645f39dbb35f7165308a8cff80,10,525,103,422,6,0,6,1,2,1364,1,2,3.147553051,252,4,2,58,37,21,3283,1417,1866,38,17,21,99.70367444
521a542d2a34169319ba2dccbb3f7afee8b137ca,47,131,131,0,0,0,0,2,70,1749,14,32,4.993190749,7900,5,3,1545,1545,0,55313,55237,76,567,567,0,100
e90109f37f287d0705c0e772357b13665ea776b4,5,180,91,89,1,0,1,2,9,1043,2,3,2.012874695,562,264,7,94,86,8,4379,3907,472,35,33,2,99.90155542
f1dcae4dc38cd67c59eb6f6050231332020bc6ae,2,32,29,3,0,0,0,2,6,9,2,2,0.990479974,341,265,8,47,46,1,2455,2423,32,18,18,0,100
761dd5d44ac873df692ec3cf8ecdbf8342e3d0e8,2,0,0,0,0,0,0,1,1,0,1,2,0,134,111,4,20,20,0,1042,1048,6,2,2,0,99.84258166
edf54197e0a57611dd2f58ed4597cf94c2ccbceb,0,0,0,0,0,0,0,0,0,0,0,0,0,0,266,8,0,0,0,0,0,0,0,0,0,100
3f8ff2aafe442f654bbab46b2b6dfadd9a054096,0,0,0,0,0,0,0,0,0,0,0,0,0,0,267,9,0,0,0,0,0,0,0,0,0,100
d82f834ceffd52ead5112400a7f56af5a1c59590,13,51,183,132,0,0,0,3,71,70,7,11,3.440866364,4261,6,4,478,480,2,36810,37931,1121,231,237,6,100
7cb85e28bf932a8727d7f794c7ac13ae67591f3f,0,0,0,0,0,0,0,0,0,0,0,0,0,0,112,5,0,0,0,0,0,0,0,0,0,100
2bec3185795a268b4ac447a5e22582be6f120fc8,3,3,4,1,0,0,0,3,32,245,1,3,1.556656707,2077,7,5,353,352,1,14902,14902,0,106,106,0,100
6b6865ddcca9f3fae4e70c97b22169018eb929a3,0,0,0,0,0,0,0,0,0,0,0,0,0,0,8,6,0,0,0,0,0,0,0,0,0,100
d187a877cd9fac4cf8c203c0bc2cfb1fcc774b73,3,19,10,9,0,0,0,3,5,504,2,3,1.501357929,228,9,7,48,48,0,1799,1745,54,18,18,0,100
9af4fe40178cf69778421e8c8f8af81c9b157574,2,7,1,6,0,0,0,3,6,583,2,2,0.811278124,263,268,4,59,58,1,2000,1986,14,14,14,0,100
c23759ae26b8d3adb49643044c26b563a56a3c5c,5,107,61,46,0,0,0,1,3,35,1,2,2.230648682,362,10,7,51,47,4,3090,2561,529,28,27,1,100
c346ee3798d84eb862cabda2d95d6409d7b4da0f,0,0,0,0,0,0,0,0,0,0,0,0,0,0,11,5,0,0,0,0,0,0,0,0,0,100
15bb53810b5af0009a4c0a6df2a3e7bc0729ed67,9,35,36,1,0,0,0,3,23,1258,9,8,2.593212633,1513,269,4,308,307,1,9871,9885,14,112,111,1,100
2d51810c2b9123a9ff6be1a6d269efecc32ba16f,4,10,23,13,0,0,0,1,14,383,3,3,1.912065596,834,270,5,141,141,0,6265,6295,30,54,54,0,100
1fdae18db98de6dd144bb7e25dd49fd760e813b1,4,0,649,649,0,0,0,2,10,289,2,2,0.858124262,938,113,2,80,110,30,2120,4194,2074,76,98,22,96.08433735
9596f2dc2d0e55f37ff78fb73ad0bfc548ad8c7a,5,22,0,22,0,0,0,4,72,55,4,4,2.24447453,2094,271,5,379,375,4,11610,11532,78,258,255,3,100
5ae580ed00cb4cff5691bf5d7ee8ce208b1a6d05,12,679,0,679,7,0,7,1,3,859,2,6,2.60036671,183,114,1,82,26,56,5299,1355,3944,43,16,27,99.5697603
56d444fd8c43c928719af1054ba54762d37408cb,0,0,0,0,0,0,0,0,0,0,0,0,0,0,115,2,0,0,0,0,0,0,0,0,0,100
1ce0e9b6cf8a5f80cab28da1a1c739013bcb6d54,2,14,1,13,0,0,0,3,36,180,1,2,0.566509507,751,272,4,121,120,1,5007,4931,76,77,76,1,100
239677c60d2f5480691fdbe5fed19576ead1d3b2,0,0,0,0,0,0,0,0,0,0,0,0,0,0,116,3,0,0,0,0,0,0,0,0,0,100
308f96989c36470d75164360c676ed64d39c873b,0,0,0,0,0,0,0,0,0,0,0,0,0,0,117,4,0,0,0,0,0,0,0,0,0,100
7484e3e7d62b123a674d605ff40028c78134f16b,0,0,0,0,0,0,0,0,0,0,0,0,0,0,118,5,0,0,0,0,0,0,0,0,0,100
ade9d7a9967b8f2d229e2c214566c1de0322829a,1,4,2,2,0,0,0,2,2,369,1,1,0,240,12,2,21,19,2,1788,1764,24,11,11,0,100
f9da2747af2b9ef6b62ff82de9af6c7e46348ce2,2,2,2,0,0,0,0,1,5,112,1,2,1,403,119,6,22,22,0,3598,3590,8,18,18,0,100
56176ef442f1ff605d7701ec610bccc7a0375131,0,0,0,0,0,0,0,0,0,0,0,0,0,0,13,1,0,0,0,0,0,0,0,0,0,100
9f7e34f114d499da39f98ec3c77a389e9d0538a4,1,2,1,1,0,0,0,3,14,96,1,1,0,252,273,2,37,37,0,1936,1932,4,16,16,0,100
ff126bac8eae216e7b14b9920f842f8728093763,0,0,0,0,0,0,0,0,0,0,0,0,0,0,274,3,0,0,0,0,0,0,0,0,0,100
6c00009740077cbce66f7cfc5129440dd35868e9,0,0,0,0,0,0,0,0,0,0,0,0,0,0,120,7,0,0,0,0,0,0,0,0,0,100
3ee68053e7d41d3aa6e8777e5e599596fc7ce6a1,2,18,5,13,0,0,0,2,25,174,2,2,0.965636133,365,14,2,78,75,3,2740,2665,75,31,31,0,100
318fb19d1c94eeaa370c2140e4c7b78936f97aee,0,0,0,0,0,0,0,0,0,0,0,0,0,0,121,8,0,0,0,0,0,0,0,0,0,100
8857bef1ec39d1af0075dae86e0de3601752d883,3,56,3,53,0,0,0,3,7,590,2,3,1.182460855,397,275,3,61,54,7,3383,3087,296,31,27,4,100
d3c6aefd31490ab9612b55c7106939e131a0d684,0,0,0,0,0,0,0,0,0,0,0,0,0,0,122,8,0,0,0,0,0,0,0,0,0,100
835e185b22dd5c7756226af4d4ad86d37ed63f74,0,0,0,0,0,0,0,0,0,0,0,0,0,0,123,9,0,0,0,0,0,0,0,0,0,100
b1178205bff92070d504473c5c50b00046f0a60c,0,0,0,0,0,0,0,0,0,0,0,0,0,0,124,9,0,0,0,0,0,0,0,0,0,100
d783b5ce78b012f8541b0baf1d32a381094146f4,0,0,0,0,0,0,0,0,0,0,0,0,0,0,276,4,0,0,0,0,0,0,0,0,0,100
65ca3c109d2278fbe97dd41e2463cd182f264336,0,0,0,0,0,0,0,0,0,0,0,0,0,0,277,4,0,0,0,0,0,0,0,0,0,100
ba4ddecec1f84ccf62e18bf54996abbaa212d0ce,2,2,2,0,0,0,0,2,27,142,1,1,1,690,15,0,128,128,0,4692,4692,0,51,51,0,100
5f61ef8a6c7b9bf3baa58cb3bb5f028a64d728aa,1,1,1,0,0,0,0,1,2,1083,1,1,0,28,278,1,6,6,0,197,198,1,3,3,0,100
ed3de63f87b49714eb7d55915ad4ef857631f59f,0,0,0,0,0,0,0,0,0,0,0,0,0,0,16,1,0,0,0,0,0,0,0,0,0,100
3f6abb23ede59f4a37eb37369880806620ce0bd3,0,0,0,0,0,0,0,0,0,0,0,0,0,0,17,2,0,0,0,0,0,0,0,0,0,100
3b01d36d90548eb5f689503e7b77e91ed680d047,0,0,0,0,0,0,0,0,0,0,0,0,0,0,18,3,0,0,0,0,0,0,0,0,0,100
f389cab9e222c40e0f6bc38a8ae520c479ee9471,0,0,0,0,0,0,0,0,0,0,0,0,0,0,279,1,0,0,0,0,0,0,0,0,0,100
cfa28c76644561b7921eaa3565b09f8fb26d32e4,3,78,35,43,1,0,1,1,4,131,1,3,1.526500007,130,280,2,22,17,5,1268,977,291,8,7,1,99.8976668
ee332f57824ee1fc4cb2343f5824e31895a30fda,3,99,1,98,0,0,0,3,15,830,2,3,1.547524772,1291,281,1,152,143,9,12902,12278,624,77,74,3,100
1c9020182aca0bfa255059fb9040463c7abe7984,10,247,0,247,3,0,3,4,57,309,5,8,2.482954308,2099,282,2,352,334,18,14197,13040,1157,252,238,14,99.83656793
5cb614de4dcaf6da1a04d60db73e58306b4c6c22,15,73,46,27,0,0,0,3,39,1135,9,12,3.201745944,5594,283,3,1102,1096,6,36902,36824,78,395,389,6,100
5dac768d2ed2ad051724b998db5a7a1f39a599b0,11,28,28,0,0,0,0,2,73,1074,7,9,2.473131835,2038,284,4,361,361,0,15753,15729,24,166,166,0,100
22f0af4de5ac89a7ead9d6e3958262b7a4fda9c6,10,159,28,131,0,0,0,2,4,1528,6,10,2.704849724,688,285,4,79,73,6,7376,5713,1663,42,39,3,97.80683256
3dc4efb8febe9cfdf1e4baf5331c6904bc44f93a,2,6,5,1,0,0,0,2,3,3473,1,2,0.439496987,169,286,5,21,20,1,1589,1568,21,9,9,0,100
1bcfe47aa3b8f69f92ccd21789025b4806c6fd7d,1,3,1,2,0,0,0,4,38,17,1,1,0,636,287,6,115,115,0,3534,3532,2,71,71,0,100
0f207409c02fff54e3fb3a5a1c0b3865ef91e7db,7,68,21,47,0,0,0,2,3,453,1,2,1.569237945,829,19,0,93,85,8,5674,5444,230,54,54,0,100
c32cd10f2cc10b053d2bda47a76bcbb51d2e802e,7,89,3,86,0,0,0,4,39,904,4,4,2.503260129,2007,288,5,338,332,6,11810,11118,692,259,255,4,100
fb2e31348a25619e244ff6cf1e634c01001e2f18,0,0,0,0,0,0,0,0,0,0,0,0,0,0,289,4,0,0,0,0,0,0,0,0,0,100
efc361ddc97209a2d87f69018701dbcc5a3450fc,1,67,36,31,0,0,0,2,10,283,1,1,0,123,290,5,21,16,5,1018,859,159,6,5,1,100
5515056406afd48a6b55f4188fe80816c2133744,103,184,184,0,0,0,0,2,74,1251,24,52,6.238900916,26112,20,1,3142,3142,0,204751,205353,602,1444,1444,0,100
d0726a227d4f10e57489554b8adf8406e6d96920,10,269,37,232,0,0,0,4,40,1180,4,7,2.877262663,2050,291,3,385,356,29,12082,10879,1203,277,255,22,99.91270188
8c1c94b9e81d5a624075448be75702ffa08e40c5,2,20,2,18,0,0,0,1,4,2209,1,2,0.574635698,61,292,4,10,6,4,596,487,109,4,4,0,100
111d8974771f23976bc802ea9b9d12d5fbd6f527,12,1457,57,1400,5,0,5,4,75,31,4,5,2.998051519,2586,21,2,509,419,90,21925,16123,5802,332,286,46,96.90423163
17f5209f80efcee37e7ad28af992cc832420391c,22,83,83,0,0,0,0,2,42,481,8,11,3.762905806,7016,293,5,910,910,0,49841,49839,2,521,521,0,100
6a921359dd192b3ff46d7483b9f382a741fbcd33,1,1,1,0,0,0,0,4,32,0,1,1,0,444,294,6,88,88,0,1542,1537,5,86,86,0,100
dc0042e67ff1533d727aae886d7256bef88490f9,4,163,238,75,0,0,0,1,12,412,1,2,1.824396079,852,295,6,91,97,6,5234,5698,464,48,48,0,99.84058301
5022bb43aff894fe5f596a8f5ad551693a48deab,1,3,1,2,0,0,0,2,4,48,1,1,0,142,22,2,11,11,0,921,911,10,5,5,0,100
39a552772c7f03fd4af17e14b7460f74f9ab1bbf,7,259,213,46,1,0,1,4,76,200,2,3,2.471263253,1522,23,3,276,278,2,10211,10182,29,153,156,3,97.54409466
771a2fc0d4f1526eb5d72f62ef3f8fd6115f3269,3,475,421,54,2,0,2,1,6,2,1,1,1.275898324,466,296,5,42,36,6,3350,3087,263,35,29,6,99.78161171
e4768f1efce860099c6a1f8d366e2a58954c0314,5,291,1,290,4,0,4,4,27,4,2,5,1.949149696,261,297,6,78,54,24,3641,1919,1722,31,20,11,99.80404964
2d6447e948a5492d592d1c63a09a0cd9c696f824,0,0,0,0,0,0,0,0,0,0,0,0,0,0,24,4,0,0,0,0,0,0,0,0,0,100
061951bc95736de0d77d2f876f9c638692e80c3e,15,137,33,104,0,0,0,3,28,21,1,1,3.902757667,4877,25,5,315,300,15,40425,39657,768,226,226,0,100
8f72475234be14397ae0f0ea03cb91d9d6d56d5a,6,59,9,50,0,0,0,2,13,235,2,3,2.189417989,852,26,5,111,105,6,5955,5572,383,70,67,3,100
947efa2141deee1c1b5bd3159d6c3da2dbb7b049,0,0,0,0,0,0,0,0,0,0,0,0,0,0,27,6,0,0,0,0,0,0,0,0,0,100
ebdb1d793c33ac67962dbe712167dd328cc7d010,9,200,20,180,1,0,1,1,14,190,4,5,2.339972648,1029,298,5,147,132,15,8141,7143,998,78,71,7,99.63035442
6d17873c93af181f511ade54b73e555c08f9a3db,1,1,1,0,0,0,0,2,4,5,1,1,0,385,28,7,33,33,0,2954,2952,2,26,26,0,100
607568408ef78b0f07cf9d853ff9bda9ad138f06,10,1139,1861,722,0,0,0,4,73,162,2,2,2.118896068,5707,29,7,358,444,86,39097,41383,2286,238,321,83,95.96879064
0064e33d62a6544d79e1aca7075f369303b23bd3,0,0,0,0,0,0,0,0,0,0,0,0,0,0,30,8,0,0,0,0,0,0,0,0,0,100
f4ccdfd696bca10c73e7a7e336d9e72d4db423b5,5,36,5,31,0,0,0,3,77,86,3,4,2.184060933,2150,299,3,383,378,5,13944,13767,177,231,228,3,100
1ecb6934a4aa1128f9c168dbc822e055e9e09452,1,5,0,5,0,0,0,5,11,63,1,1,0,95,300,4,11,9,2,855,832,23,5,5,0,100
b13c21a45a9983d6ba0339da6e18172aa102f45d,11,653,4,649,8,0,8,5,32,67,3,7,2.679983593,816,31,7,103,65,38,10644,7317,3327,64,36,28,96.98145752
1314f1dccdc3db132b71b400d96a61a09073224c,1,4,12,8,0,0,0,3,8,1296,1,1,0,131,301,3,4,5,1,1220,1255,35,4,5,1,100
4eeff1a6d156db860245916fa44e2a1505247e43,4,45,146,101,0,0,0,3,20,580,2,3,1.487397315,1481,302,4,200,214,14,12623,13265,642,92,97,5,100
dfb96e1b4335a133007f9868f68a488a39c343ac,1,8,11,3,0,0,0,3,11,0,1,1,0,280,303,5,71,72,1,1539,1547,8,28,28,0,100
5bbc4f9ea80021f331039ffee3e92b1199886e34,1,11,8,3,0,0,0,3,12,0,1,1,0,278,304,6,72,71,1,1547,1539,8,28,28,0,100
537690745cb4fc88d5083367d37f2a71de03e2e9,1,4,15,11,0,0,0,4,28,51,1,1,0,271,305,7,54,57,3,1945,2001,56,20,21,1,100
680e8a6e4faf6b65dcb81a61525faedb0e937f09,6,70,14,56,1,0,1,3,74,33,4,4,1.682099331,4412,306,8,354,350,4,33930,33722,208,159,157,2,99.8924037
4c2675aab4bfb4ae3a08250d75f349e3387c1cb1,0,0,0,0,0,0,0,0,0,0,0,0,0,0,307,6,0,0,0,0,0,0,0,0,0,100
98a08fc7ea43397ad6a70b20278f7f625332cd3a,2,44,12,32,0,0,0,2,5,107,1,2,0.940285959,353,32,0,32,28,4,2672,2490,182,17,16,1,100
315a0ba9b1fd72999666c46ce300b808acb33d63,0,0,0,0,0,0,0,0,0,0,0,0,0,0,308,2,0,0,0,0,0,0,0,0,0,100
3004ba8b9b78d603e04d8c6f2313b0b527fdd252,2,103,22,81,0,0,0,2,5,1810,1,2,0.994406653,152,309,3,15,11,4,2408,1580,828,9,6,3,100
47c27955f77f23b3b0c597b1c17598ca2ac69a8c,4,3,8,5,0,0,0,2,3,3047,2,2,1.858555212,362,310,4,69,69,0,1893,1914,21,37,37,0,100
96fbfc94a9388c3829f15d5e0775ab0cc04182f2,0,0,0,0,0,0,0,0,0,0,0,0,0,0,311,5,0,0,0,0,0,0,0,0,0,100
83b17a5d5a8e8f48f303140c27e3b4b96055d80e,0,0,0,0,0,0,0,0,0,0,0,0,0,0,33,1,0,0,0,0,0,0,0,0,0,100
bd4330cf8f37ecfd8f9c5d8101316db3868096cb,0,0,0,0,0,0,0,0,0,0,0,0,0,0,34,2,0,0,0,0,0,0,0,0,0,100
54e3a7edd6bea957639215daaa02eb465889a5c6,1,17,0,17,0,0,0,1,4,4668,1,1,0,14,312,0,5,2,3,223,89,134,3,2,1,99.76369495
4789bbc634ac960f4156bdc5b50ab7a745531216,0,0,0,0,0,0,0,0,0,0,0,0,0,0,313,1,0,0,0,0,0,0,0,0,0,100
95a1e3db84e4f9e74d942a059d46b6eed612abcf,0,0,0,0,0,0,0,0,0,0,0,0,0,0,314,2,0,0,0,0,0,0,0,0,0,100
a59b404ca15f5e6cc4fbf7ee3621e6a1963454a9,0,0,0,0,0,0,0,0,0,0,0,0,0,0,315,3,0,0,0,0,0,0,0,0,0,100
3d2901be41a3b4eaa777d996c0fc408e267ba923,0,0,0,0,0,0,0,0,0,0,0,0,0,0,316,4,0,0,0,0,0,0,0,0,0,100
edecb857a6c01886103361577713cc308d8ad201,0,0,0,0,0,0,0,0,0,0,0,0,0,0,317,5,0,0,0,0,0,0,0,0,0,100
0b15afc6cb421de54991dfaa5193853e2cf5d2df,5,213,144,69,0,0,0,2,10,608,3,5,1.500113748,669,318,6,92,80,12,6242,5874,368,36,35,1,100
659e02ce37416e0652485fbe5b17969f98b08409,5,79,3,76,0,0,0,2,4,1622,5,5,2.268834961,440,319,4,63,61,2,3736,2780,956,26,26,0,98.54514335
cbe21a0a0728106a8bdc7b85b5094a8b2ac5e7df,4,41,19,22,0,0,0,2,44,320,1,4,1.451005038,1005,35,0,166,162,4,6963,6821,142,104,103,1,100
5adc176102b1a32591bce737f8993b26903cca36,0,0,0,0,0,0,0,0,0,0,0,0,0,0,320,2,0,0,0,0,0,0,0,0,0,100
d89e03ae38f3ff85a7c984e842f953f824437d42,0,0,0,0,0,0,0,0,0,0,0,0,0,0,321,3,0,0,0,0,0,0,0,0,0,100
da4946cc48218f4e833d15770bab295b048d091b,0,0,0,0,0,0,0,0,0,0,0,0,0,0,322,4,0,0,0,0,0,0,0,0,0,100
9523200bfa80b008acfcff266766e754a7311abf,0,0,0,0,0,0,0,0,0,0,0,0,0,0,323,5,0,0,0,0,0,0,0,0,0,100
38194dc964b56ceb8daba686415e6e391ea3f704,0,0,0,0,0,0,0,0,0,0,0,0,0,0,324,6,0,0,0,0,0,0,0,0,0,100
037dc504d6435aa61d90b9fdb2f8926471cfe683,5,252,2,250,3,0,3,1,20,362,1,4,1.970452873,633,36,1,54,36,18,5399,4515,884,40,29,11,99.82960596
364d3f47257b5ea6b4956b96ad571e3cfdae80f2,0,0,0,0,0,0,0,0,0,0,0,0,0,0,325,6,0,0,0,0,0,0,0,0,0,100
9b4be5e51e20b1deffd29ce3e392e9e6759501dd,0,0,0,0,0,0,0,0,0,0,0,0,0,0,326,7,0,0,0,0,0,0,0,0,0,100
c7c5581de387f6804b786d6b1fa5ccc0633909cd,0,0,0,0,0,0,0,0,0,0,0,0,0,0,327,8,0,0,0,0,0,0,0,0,0,100
f1dd7d1acddd9b661da4a63d77a521fd57150bd3,0,0,0,0,0,0,0,0,0,0,0,0,0,0,328,9,0,0,0,0,0,0,0,0,0,100
115913527c0aee51922addb12cf559574cb78c3d,0,0,0,0,0,0,0,0,0,0,0,0,0,0,329,9,0,0,0,0,0,0,0,0,0,100
af9b0c3d1ce18f787ccf5c5d2055c2da98e70711,1836,110652,110675,23,918,0,918,1,78,738,54,438,9.99535549,73542,37,1,9458,15884,6426,572798,1041786,468988,5102,7856,2754,28.26086957
bea3974a89bbe2dd83be26f3e94e2c9cea0bba31,1836,110675,110652,23,918,0,918,0,77,147,54,438,9.99535549,73532,37,1,9458,15884,6426,573606,1040978,467372,5102,7856,2754,28.26086957
ac532bd73c5da8997f865e048b36c76fd3c11301,3,57,2,55,1,0,1,2,3,574,1,1,0.500968259,115,38,2,17,14,3,1062,918,144,12,11,1,99.76575809
d2f0fc0e5ec07d0e8d4633ce8bc0f0723a34efbe,1,38,1,37,0,0,0,7,75,218,1,1,0,3571,0,0,173,172,1,28393,28122,271,80,79,1,100
6657f2fd9f52c8303fc9a2d1d72eef38be719288,17,111,382,271,0,0,0,4,76,241,2,2,4.006797252,8183,1,1,432,457,25,64135,66671,2536,284,299,15,99.0833511
a4ba9bb5c46a36649907b9662ee7686c2c1d943a,1836,110653,110442,211,918,0,918,1,78,738,54,438,9.995462657,73330,40,3,9458,15860,6402,572813,1039536,466723,5102,7842,2740,28.25780463
a25f8a77bc80b7314b2e7a7983a125592db759fe,1,54,0,54,1,0,1,1,1,0,1,1,0,0,41,4,3,0,3,129,0,129,1,0,1,99.86661585
912c53602a409e4361a73130e4dbc55a7b73c8ea,17,174,360,186,0,0,0,1,2,0,2,2,4.053542986,8127,42,5,432,456,24,64464,66141,1677,284,298,14,95.5098071
d5c2255faac8fb1ef4d15cb53ca32056de1700ee,1837,110442,110521,79,918,0,918,0,77,147,54,438,9.996251975,73387,2,2,9434,15863,6429,571356,1039445,468089,5088,7843,2755,39.39857288
841295208ff9ae88e86c403542b884f59a2e6bf8,19,8,326,318,0,0,0,5,26,53,1,1,3.885891849,5088,3,3,214,264,50,39568,41616,2048,172,222,50,99.64142586
f1bbea9b73d0e24454cf65a3c015b083f9247aa2,7,67,31,36,0,0,0,7,77,1405,6,5,2.537365629,4347,4,4,205,205,0,36544,36221,323,104,104,0,100
2e6713b6c33b54533e6d81ab575ce292aaa43f0d,1840,110528,110216,312,919,0,919,1,78,738,55,440,9.997665059,73250,43,6,9457,15833,6376,572311,1038982,466671,5091,7795,2704,39.915754
202b3dc8b8d955336689ce5c20860d5a69482dd2,1840,110206,110528,322,919,0,919,0,77,155,55,440,9.997581298,73525,5,5,9407,15890,6483,570772,1041001,470229,5041,7848,2807,39.915754
f4de8565783976a912c87c14382680994f3f9375,4,7,60,53,0,0,0,6,33,128,2,3,1.941870196,1556,6,6,175,184,9,10727,11119,392,141,142,1,100
6135abd3997fb5eaa08b83dec0158f67d1a13ae9,27,76,73,3,0,0,0,4,78,1159,13,20,4.21986437,6520,7,7,1256,1256,0,46999,47002,3,434,434,0,100
60900b9553f2b90029b3b9840fd437bc173bf951,1,29,0,29,0,0,0,7,78,15,1,1,0,3607,8,8,174,173,1,28624,28439,185,81,80,1,100
c7cbd46a2dcc3cc8a87b948ad5468577ed25651b,4,133,95,38,0,0,0,3,10,100,1,2,1.593156906,756,9,9,86,81,5,6140,5524,616,54,51,3,100
5f413f35eb9fd67f67ff031d5b0b15af534d54e6,0,0,0,0,0,0,0,0,0,0,0,0,0,0,330,0,0,0,0,0,0,0,0,0,0,100
ca9247f4d06eaeb8eb24b1696fd5a7b80cb13340,4,95,11,84,0,0,0,3,15,146,1,2,1.438758006,819,10,10,107,100,7,6740,6169,571,52,48,4,100
e88c7a998f953d7a6625e34818d8ab759950e03b,0,0,0,0,0,0,0,0,0,0,0,0,0,0,11,11,0,0,0,0,0,0,0,0,0,100
50f46e9eed9ccc27a54cb71a090322b023fd7a8b,1840,110348,110307,41,919,0,919,1,78,738,55,440,9.995408797,73313,44,4,9411,15837,6426,571572,1039929,468357,5048,7802,2754,26.9356821
773ac9d8e2594241d5d95448b19a75982f467efd,1840,110387,110348,39,919,0,919,0,78,163,55,441,9.995531403,73365,12,12,9416,15844,6428,572444,1040262,467818,5053,7805,2752,26.9356821
5c95ab4e31ee547807e83e4b2d972b4d33da9eb2,3,9,3,6,0,0,0,4,11,32,1,1,1.584962501,990,0,0,47,47,0,7996,7996,0,40,40,0,100
751f7648982dff7ffbaf1dbb1cb1a02fb831d797,1,2,2,0,0,0,0,2,5,1776,1,1,0,66,39,0,4,4,0,700,704,4,2,2,0,100
e2e1251466c26ea70c145f1b456eaa42d2002f24,18,99,90,9,0,0,0,5,79,59,1,1,2.47514858,7714,13,9,353,353,0,62044,62063,19,231,231,0,100
582cc7e38a99f4dc624325cccd66e12a0923ec6f,1839,110230,110189,41,919,0,919,1,78,738,55,440,9.992484225,73236,46,3,9406,15825,6419,570770,1038617,467847,5043,7794,2751,28.57433809
2e3758434a9afb1fa6b4a02df991b59cbf7be8dc,1,1,1,0,0,0,0,1,1,0,1,1,0,157,47,4,10,10,0,1474,1474,0,10,10,0,97.52198241
f4a4355d430ae6152eaefbfd3a118cfd65b00f07,1,0,0,0,1,0,1,1,4,0,1,1,0,0,48,5,0,0,0,0,0,0,0,0,0,99.95980707
aac2054c83399669a7084dbb8452013f7e3b532c,1840,110384,110443,59,919,0,919,0,80,163,55,442,9.995481593,73445,14,9,9414,15849,6435,572237,1040934,468697,5051,7810,2759,26.9356821
4978951cc14bd63db2eace832b4db5544b80bee0,18,223,223,0,0,0,0,5,81,0,1,1,2.448520135,7702,15,8,351,351,0,61860,61860,0,229,229,0,100
3557612d5a5d904c3dfa61ba03cccfbbd365b296,5,278,25,253,0,0,0,3,11,166,2,3,0.801315718,823,16,7,102,84,18,8333,6601,1732,70,57,13,99.91651012
a5a88258b82d8451710d048eba94a39cbd4da343,1,1,1,0,0,0,0,5,12,13,1,1,0,487,40,1,17,17,0,4028,4028,0,15,15,0,100
3a411555fa9a89965281604c4e56709325abf743,7,109,1,108,0,0,0,4,19,834,3,6,1.956900001,955,331,1,208,192,16,8139,7660,479,114,102,12,100
2666894bc84281ed78890110ab15b009fa5f2830,9,303,131,172,0,0,0,4,25,749,4,8,1.562244563,1336,17,7,261,258,3,11697,10198,1499,129,124,5,99.79127531
416ee7c15076ddcaf25cd6a908e6cf1b39683673,1840,110960,110917,43,919,0,919,1,78,738,55,442,9.996994416,73786,50,6,9451,15877,6426,575798,1044127,468329,5081,7835,2754,26.9356821
d3f507f9424b7deb355696c1c6d5f5aad142157d,1840,110914,110960,46,919,0,919,0,81,164,55,442,9.996979193,73840,41,2,9450,15884,6434,575936,1044488,468552,5080,7838,2758,26.9356821
c833bf907566301e525f514354dcb0325f5e0738,9,97,95,2,0,0,0,3,12,424,5,7,3.091106129,1595,18,8,168,168,0,12232,12257,25,106,106,0,99.66499162
935f81fb0f446a18eb09d5c710f679e4012a7cc1,2,6,20,14,0,0,0,1,10,17,1,2,0.961236605,374,19,7,43,44,1,2449,2559,110,31,31,0,100
8537d424205dce5b032bbb4c37362d91dd3cfeb5,2,21,1,20,0,0,0,1,11,0,1,2,0.945660305,364,20,8,45,43,2,2603,2449,154,32,31,1,100
5432c872271e42d1ba8981e5f5de2059d5509ba2,4,26,2,24,0,0,0,4,45,549,3,4,1.775831021,1457,331,0,258,254,4,7617,7533,84,183,181,2,100
3a0119b217bb71d107b335c27abac77847b2bfe4,2,20,12,8,0,0,0,3,11,170,2,2,0.757878463,336,332,1,79,77,2,2366,2268,98,22,21,1,100
c2ca443262a848ae0d56e03e92ecba32fbf149f2,40,5315,39,5276,35,0,35,1,59,77,4,14,4.486727848,1058,333,2,478,114,364,31248,9633,21615,217,55,162,95.57404956
78ef4e50ba6f7522aa363d5d1df8f8d04320003e,1,160,0,160,1,0,1,1,1,0,1,1,0,0,21,8,6,0,6,1213,0,1213,3,0,3,96.95044473
a841e2656b359e4f9bd6e819eba2b9723faec1bb,7,0,1637,1637,0,0,0,1,2,0,1,2,2.093042288,1283,334,3,0,97,97,0,6596,6596,0,42,42,99.67238389
b3107e91c5466619e33d0ccb68ab0a85a40d96c3,1840,111279,111240,39,919,0,919,1,78,738,55,442,9.993836414,74037,52,7,9496,15922,6426,577500,1045858,468358,5098,7852,2754,29.22178988
668aea18059d18b6a9b3e9ade16e734b853756cd,31,98,98,0,0,0,0,1,5,0,4,10,4.590938534,3033,53,8,289,61,228,20488,7838,12650,149,43,106,97.63671875
ca93de84346ac58a39a7339df9297f7925b0db47,4,474,0,474,4,0,4,1,1,0,1,2,1.732594105,0,54,9,54,0,54,1606,0,1606,54,0,54,99.80552314
10b3473ae0ab88645322ef4798f9eb696cb59b93,1901,114632,115114,482,947,0,947,0,81,160,57,457,10.04612114,76748,42,3,9733,16413,6680,592533,1076723,484190,5210,8102,2892,27.41185587
7815945dcc1e4a5b81d237fe9c98fa4a1af0e5c3,1903,115249,114632,617,953,0,953,1,78,723,57,457,10.04789565,76390,55,6,9795,16355,6560,594028,1074993,480965,5272,8048,2776,27.54687802
51348f838106241efbf34534168c478d77a35d6e,4,31,0,31,0,0,0,1,2,100,1,1,1.985193084,497,57,8,88,85,3,3763,3599,164,48,45,3,100
cdac6ff076d3a4bca1eae643d086571c3b9180be,4,0,205,205,0,0,0,1,3,0,1,2,1.235568645,245,58,9,10,51,41,488,1198,710,10,51,41,100
145ed5dd673e89db278ad5b7257690e3b23e3109,1903,114632,115075,443,947,0,947,0,81,160,57,457,10.04725548,76659,22,7,9733,16386,6653,592535,1076452,483917,5210,8075,2865,27.54687802
7b4755d57c8998d1aed62c100124b8a94a3427db,2,179,0,179,0,0,0,3,7,25,1,2,0.712898985,364,335,4,51,40,11,4482,2992,1490,25,21,4,100
c5aedf40f21ffc9f884330e576ff8f680fd5f368,0,0,0,0,0,0,0,0,0,0,0,0,0,0,336,5,0,0,0,0,0,0,0,0,0,100
557d569faef9b9e894ac380f8488cd03eb52823d,1903,115081,114811,270,953,0,953,1,78,723,57,457,10.04683207,76526,59,10,9758,16366,6608,593501,1076485,482984,5235,8052,2817,27.54687802
90f1df7f5b4ed33a9462a46f2fc5afff032890a2,1903,114832,115081,249,947,0,947,0,81,161,57,457,10.04662842,76664,43,3,9746,16387,6641,594104,1076471,482367,5215,8076,2861,27.54687802
5de920bd092d2822a32aa546d01bb8e64de3a5a9,6,150,3,147,0,0,0,3,26,35,3,6,1.773035679,1708,23,5,198,194,4,15210,13937,1273,96,93,3,100
ff3af36d63609cd0b60400071e9df26ec41e96d3,0,0,0,0,0,0,0,0,0,0,0,0,0,0,24,6,0,0,0,0,0,0,0,0,0,100
485769b95b44f47699c48c47945a75c2b1d2ff97,0,0,0,0,0,0,0,0,0,0,0,0,0,0,44,3,0,0,0,0,0,0,0,0,0,100
d762ed3fd9193ad6e837fec1747d18f334872951,0,0,0,0,0,0,0,0,0,0,0,0,0,0,45,3,0,0,0,0,0,0,0,0,0,100
7b401def625630cbf1f9ee5f8993bbcb3269c222,15,1901,329,1572,6,0,6,2,2,18,2,4,2.810602075,1563,46,4,246,130,116,18272,8952,9320,115,49,66,99.65264377
2d236e78b70ef7fb312ebf0fa198657595e2f4ba,4,530,12,518,2,0,2,1,6,195,1,2,1.288839651,342,47,4,60,42,18,3512,1998,1514,26,14,12,99.76914198
0719da376065950d8786576cf92f71367d9aba8d,0,0,0,0,0,0,0,0,0,0,0,0,0,0,337,2,0,0,0,0,0,0,0,0,0,100
92b1505a70057aef762ac20bf80a7249d947e3e9,6,0,587,587,0,0,0,2,5,1097,1,4,2.346697754,422,338,2,0,63,63,0,3834,3834,0,48,48,96.79940454
8affbc0226fb2e587bdadaac9270b071d52b8062,1896,114969,114518,451,953,0,953,1,78,726,57,453,10.02955822,76336,65,4,9710,16258,6548,593546,1071440,477894,5192,7984,2792,30.00554631
6acfa43f419b7dfc579988efce32091f8349e0e7,1896,114518,114969,451,947,0,947,0,81,157,57,453,10.02955822,76611,25,2,9685,16290,6605,592550,1072946,480396,5167,8012,2845,30.00554631
9c7aa7e1c7471f71c783681b68beea8e6f3fc2dc,13,412,80,332,0,0,0,1,27,51,5,10,3.062178303,2783,26,3,343,326,17,25023,22473,2550,175,168,7,97.7224474
78d35f16f84f91985bbbd7582d79f648e4ef76e9,1890,114969,114850,119,947,0,947,1,78,726,56,449,10.02931648,76586,66,5,9710,16275,6565,593546,1073990,480444,5192,7991,2799,25.14898689
7d0bff16e7128e5f2e10b54237cbc93f45932ffc,9,11,11,0,1,0,1,1,3,0,2,4,2.845350937,1291,67,6,136,88,48,9827,8712,1115,81,48,33,99.27660385
bb467b8c4ecd87fc83ec1cf2863767b0330f171e,1905,116870,116933,63,948,0,948,0,81,157,56,449,10.0386644,77902,27,4,9844,16482,6638,605308,1086853,481545,5257,8117,2860,24.79650586
2288231780703f13b8f80da8e36787c4d494424c,2,105,3,102,0,0,0,3,13,4,1,2,0.183122068,836,28,3,96,88,8,7485,6642,843,49,45,4,100
8ecac9216e6512afe84e0325a6e6b27d87689fde,1,15,0,15,0,0,0,3,10,78,1,1,0,537,339,2,118,114,4,4150,4076,74,40,39,1,100
0e13dc72e7719163ffca638a7f809dce3f9cf54c,6,338,32,306,0,0,0,2,3,60,2,3,1.534596798,749,340,3,133,98,35,7789,5738,2051,46,40,6,100
c440344ae3216d4f16c897d803cdf766bda2d97d,1,1,1,0,0,0,0,1,3,987,1,1,0,64,341,4,9,9,0,431,430,1,9,9,0,100
986615ff6756ee9b6940dbba0e536c5bcba5de25,1,1,0,1,0,0,0,3,11,0,1,1,0,548,342,5,118,118,0,4157,4150,7,40,40,0,100
aa62fa2dbdca59b175eefb62e97b5528f40d076b,4,468,2,466,0,0,0,3,28,8,2,4,1.19326987,1176,29,4,138,124,14,14597,10507,4090,64,56,8,100
a08aaf742a97a3c35c94e28406fc4b6ef3184005,8,905,0,905,8,0,8,1,1,0,1,2,2.88234896,0,48,1,59,0,59,3208,0,3208,32,0,32,98.74276591
994ac325d592426f8d4abcf45b1e95a5f2d267e8,4,59,30,29,0,0,0,3,6,767,1,3,1.84038649,423,30,5,58,47,11,3824,3711,113,22,18,4,100
58780d37c96f1f49f3863ecd065a09fb3bfda26a,1905,118149,117697,452,954,0,954,1,78,720,56,449,10.02819755,78628,69,5,9941,16545,6604,613483,1095457,481974,5305,8121,2816,27.79047619
222385bf85bb0c234ca5da981f575ee8db0cd2d3,1884,110745,119298,8553,919,0,919,0,81,159,57,446,10.02494479,79353,332,0,9448,16377,6929,574448,1081301,506853,5076,8070,2994,27.04203013
3346d99e361e1dab74fc8774d3089f9049529941,1,1,1,0,0,0,0,3,7,107,1,1,0,66,333,1,3,3,0,976,976,0,2,2,0,100
9577842b1b72fbeed9c622118917a64fbf869c4f,1884,119298,110745,8553,963,0,963,1,78,730,57,446,10.02494479,73655,70,5,10000,15818,5818,616691,1038548,421857,5337,7806,2469,27.05812339
41952dd3344e2c83e35109bc778623017bc0ab73,1918,115993,119054,3061,953,0,953,0,81,152,56,449,10.06326645,79353,31,6,9740,16671,6931,606338,1102721,496383,5205,8196,2991,27.1998473
f5490414dfb23a0d9a46e96aa904a1cc8c04f3e4,105,3642,9169,5527,7,0,7,2,58,335,16,51,5.241123518,15230,334,2,1613,1905,292,86406,118296,31890,840,969,129,94.50901804
1ee937071b236909a38dc764db451e65a3225ad6,81,7682,873,6809,35,0,35,3,59,309,13,40,5.232762422,8204,347,9,1574,1115,459,98510,64195,34315,807,603,204,94.42247659
c211d05e98c82d57eb0af61487a76f0ddd99660d,1,21,20,1,0,0,0,5,20,109,1,1,0,347,348,10,68,67,1,2519,2511,8,33,33,0,100
9ad9bcdbbdb82acdabd05fe1500da9a6f8d22634,38,3105,2909,196,9,0,9,5,60,567,10,24,3.51944915,7104,49,1,874,953,79,61086,54394,6692,431,458,27,98.6013986
62a23febbe6f1bc4aaade9d1fa0540cea5a839f3,0,0,0,0,0,0,0,0,0,0,0,0,0,0,32,7,0,0,0,0,0,0,0,0,0,100
485520df21c94339066b53af35de13fadc5c632c,39,2962,3109,147,3,0,3,5,59,231,10,24,3.55930406,7458,349,9,961,880,81,55925,62183,6258,465,437,28,98.6013986
710e784871662a54e0e8994b038a49e735f8be2b,32,3104,2799,305,9,0,9,5,60,543,10,20,3.426092497,6296,350,10,724,786,62,55213,48034,7179,352,367,15,98.6013986
b60322a6e2ba97b9f989d1efbe5183bfbc009c56,3,312,0,312,2,0,2,1,6,55,1,3,1.179239809,74,351,11,44,16,28,1938,676,1262,22,5,17,99.90379065
11ec78adc7fced033b84eb7a7f29f816d8472714,3,33,6,27,0,0,0,2,3,1827,1,2,1.309466963,145,50,2,24,22,2,1223,1046,177,11,10,1,100
c754cc06ac33c7cfff28c47ec562d888241c2641,1918,118089,117628,461,962,0,962,1,78,717,56,449,10.06167803,78660,73,5,9873,16512,6639,617406,1101793,484387,5289,8120,2831,28.84579526
4d60e4149a9fd484f8b54faeb082bf40fa3611d4,1918,117628,118089,461,956,0,956,0,81,155,56,449,10.06167803,78944,0,0,9848,16544,6696,616273,1103436,487163,5264,8148,2884,28.84579526
46109ad8563ea2286ca7e4756410e7753b2fd9cb,1922,118709,118248,461,963,0,963,1,78,716,56,450,10.07090539,78921,74,6,9903,16570,6667,618898,1105383,486485,5309,8152,2843,28.63543028
1451428f7cca88758e8163276cb5f6a33c1f812d,92,198,224,26,0,0,0,1,7,102,14,36,6.203707625,20787,75,7,1370,1130,240,179587,173915,5672,1007,840,167,96.28343175
67ad3e38f3d415d4ed7f7ae76ed5e27d9cb33a3f,1966,120631,121038,407,979,0,979,0,81,155,57,458,10.10665932,80782,352,8,10232,17106,6874,626848,1126698,499850,5562,8523,2961,30.30519365
7f58a165f1af9fb7ab45169f5e58b858fdc9c682,1,19,0,19,0,0,0,2,2,2350,1,1,0,49,51,2,3,2,1,486,376,110,3,2,1,100
12217b17d181d995d53e49d48a19baa48f130577,0,0,0,0,0,0,0,0,0,0,0,0,0,0,52,3,0,0,0,0,0,0,0,0,0,100
951a725d03764a4ff570194592dea804e392e22a,1,1,2,1,0,0,0,2,4,219,1,1,0,47,53,4,5,5,0,421,429,8,3,3,0,100
89dd77886e7f9990e2b5ac2a78012c0d8dfc7cbd,8,489,12,477,5,0,5,3,11,393,4,3,2.678121456,433,353,9,139,85,54,5815,3329,2486,52,40,12,97.59544787
6b250b1930235e0eff526c1c787a2680207ae150,0,0,0,0,0,0,0,0,0,0,0,0,0,0,354,10,0,0,0,0,0,0,0,0,0,100
a068eb8da8848ca5b5729fb568984621bfb60bf2,4,564,224,340,0,0,0,1,4,60,1,2,0.632686707,614,355,9,138,98,40,6032,4492,1540,47,31,16,100
f52dc20159ae1d8adcd6e9f9966b7bb6b42d14cf,9,86,5,81,0,0,0,4,12,45,3,8,2.772336676,1512,356,10,266,256,10,13022,12666,356,120,114,6,100
898827c1f01e11b510fde07bf80dfd7bd3d80882,0,0,0,0,0,0,0,0,0,0,0,0,0,0,357,11,0,0,0,0,0,0,0,0,0,100
d4b0dc608f886dd30ea17767e24e5f3179fffa0d,0,0,0,0,0,0,0,0,0,0,0,0,0,0,358,12,0,0,0,0,0,0,0,0,0,100
2c69152f49a22dbd6c9947a26965e3041a4f92d9,1966,121561,121126,435,985,0,985,1,78,718,57,458,10.10407921,80954,79,6,10315,17136,6821,629953,1128014,498061,5613,8522,2909,33.44704076
e70904b3d32af5df4c55f652187eda6b3719ab37,6,10,11,1,0,0,0,1,6,0,2,2,2.474952542,855,80,7,139,137,2,5822,6066,244,54,50,4,99.48590381
fa6acbef83700e0fbbbe23fa1ffac8d6b103b94a,1976,121547,121981,434,984,0,984,0,81,156,58,458,10.1134652,81561,359,7,10337,17250,6913,631332,1133884,502552,5597,8574,2977,33.06602969
24d51ad9e36de2ad84d45d8ed19af41441b16765,0,0,0,0,0,0,0,0,0,0,0,0,0,0,360,8,0,0,0,0,0,0,0,0,0,100
5af2413c4ea4593a081e4f5ad8ba6b2d3cf78e12,43,3762,9,3753,27,0,27,1,61,143,6,20,4.512917524,4651,361,2,826,570,256,53524,35095,18429,491,348,143,97.72688719
eb7d1421821784371bcc478832960da004a5126e,0,0,0,0,0,0,0,0,0,0,0,0,0,0,362,3,0,0,0,0,0,0,0,0,0,100
6474b61be2a106f0debd4bd274782d10bbb298e2,2,17,2,15,0,0,0,3,5,104,1,2,0.485460761,197,363,4,16,13,3,1983,1894,89,8,8,0,100
2ff3e756c6486bf34b605052df463488a5f9123e,0,0,0,0,0,0,0,0,0,0,0,0,0,0,364,5,0,0,0,0,0,0,0,0,0,100
d835af99ba4c0c5fdfeddb6d8ccd03f2c6616333,0,0,0,0,0,0,0,0,0,0,0,0,0,0,54,0,0,0,0,0,0,0,0,0,0,100
27217ead9a67bcded8978133a9d7abe40ebc1d1a,1,5,2,3,0,0,0,3,5,7,1,1,0,103,33,0,15,14,1,740,727,13,7,7,0,100
55be159283d77b382fa3325df5987410548640c9,3,17,8,9,0,0,0,1,7,722,1,2,1.541315277,308,365,4,49,48,1,2278,2243,35,24,23,1,100
844506f28204ef382b492c72645cf053190a115a,0,0,0,0,0,0,0,0,0,0,0,0,0,0,366,5,0,0,0,0,0,0,0,0,0,100
a8fbf80096f5fc6363fc7e5e182d29f2d57af080,1,185,0,185,0,0,0,3,6,7,1,1,0,108,367,6,6,2,4,3079,1256,1823,3,1,2,100
7b2114638cabcdcbdb72534c14ae349dc9ef7a42,0,0,0,0,0,0,0,0,0,0,0,0,0,0,0,0,0,0,0,0,0,0,0,0,0,100
a09e751d8e9d3a5f8a8989dec11f96d517bc16b5,2,12,3,9,0,0,0,2,4,137,1,2,0.566509507,601,55,1,83,80,3,4087,4038,49,26,26,0,100
828ea38fcfd4a4edee2813ae9d357ee0f555afc8,5,1020,9,1011,2,0,2,3,37,62,1,4,1.725546413,2115,56,2,452,360,92,20206,15262,4944,150,108,42,97.79216467
e482e2e93687d8601f94f8134544ebe1e0a04108,7,381,35,346,0,0,0,1,62,15,4,7,1.640194616,1326,368,7,140,112,28,13184,10795,2389,67,55,12,100
8df6e80e48bca4aeec32f0fa2bfdacecf4730cd0,1,1,1,0,0,0,0,7,82,242,1,1,0,3626,369,8,174,174,0,28541,28541,0,81,81,0,100
6eacf68adf2dfa3f6769ed29d79025d57e681d27,3,342,0,342,1,0,1,1,7,68,2,2,0.82517307,243,370,9,66,48,18,3899,1915,1984,15,8,7,99.94961371
13287d2c186079aedc2dbaa7bef299845aff0b2a,2,18,2,16,0,0,0,4,48,24,1,2,0.811278124,910,57,3,145,144,1,6148,6018,130,97,96,1,100
a874f399e05835c359ded4ee2c7b822c7baa3231,22,1602,165,1437,9,0,9,4,63,40,4,10,3.308261636,4212,371,10,693,551,142,33518,26735,6783,370,302,68,99.39748954
19362b9dd99586e64ba4cadc6e29a41d40e41f72,1,1,1,0,0,0,0,4,15,2,1,1,0,500,58,4,102,102,0,1787,1787,0,99,99,0,100
bfb556c91c8722d42db1895a2a2e71fa7466baea,2,21,10,11,0,0,0,1,3,15,1,1,0.770629069,465,372,11,93,90,3,3151,3090,61,46,46,0,100
370c8610587a2a3045f699525f9a77ffbcce9f9f,0,0,0,0,0,0,0,0,0,0,0,0,0,0,373,12,0,0,0,0,0,0,0,0,0,100
22a7304a602105ed01ed37e19cba086f3296e4af,1976,123438,123007,431,990,0,990,1,78,718,58,458,10.09384107,82383,86,5,10478,17334,6856,640180,1140851,500671,5685,8609,2924,35.18821604
e766b3b77bf2d3a0a00e4f8bf8ef261a5f8122fb,43,293,285,8,1,0,1,1,5,1,5,20,4.401078875,6381,87,5,856,1259,403,47560,167003,119443,360,605,245,95.05147791
c65eee251600ac487fb2d5f7f749a0180ccf788b,2054,128684,129123,439,1023,0,1023,0,82,145,59,478,10.15795742,86351,34,0,10889,18068,7179,668061,1190002,521941,5873,8964,3091,30.95157467
2b77fe102878f2c1e1e9831cfe1be3df75adfbd1,0,0,0,0,0,0,0,0,0,0,0,0,0,0,1,0,0,0,0,0,0,0,0,0,0,100
7d42ffd065c66d810a52a90f8c2dace55f3aceed,2,53,13,40,0,0,0,2,2,86,1,1,0.745517843,383,2,0,85,77,8,3109,2955,154,33,33,0,100
7e03a9cf1714747df01c4fa4afc00615feafa8c5,2,118,51,67,0,0,0,4,38,88,1,2,0.451883342,2568,3,1,418,408,10,18539,18169,370,140,135,5,100
a438bcc1e4dec613f078ecea25bb177a3904a3a7,3,65,14,51,0,0,0,2,15,94,1,3,1.487685967,1125,4,2,195,188,7,8475,8166,309,69,69,0,100
348c4d7def61f6296a7cf192ed00e38a8e5c3714,8,298,46,252,3,0,3,2,5,119,1,2,2.352887772,1119,5,3,155,134,21,9843,8829,1014,92,82,10,99.81672776
e0adfbd0768e839afe5b8988d4c5ad6ca93a4656,0,0,0,0,0,0,0,0,0,0,0,0,0,0,35,0,0,0,0,0,0,0,0,0,0,100
6d4756f3d6b6c16949aec2580a5b1698ea69a3eb,0,0,0,0,0,0,0,0,0,0,0,0,0,0,36,1,0,0,0,0,0,0,0,0,0,100
772bc33d48dd37be5cd098992df3e50db24326f3,1,1,1,0,0,0,0,1,3,671,1,1,0,82,59,0,19,19,0,620,624,4,2,2,0,100
99e6a54afb53fdd8b4311f9a5892698d2551c635,0,0,0,0,0,0,0,0,0,0,0,0,0,0,37,2,0,0,0,0,0,0,0,0,0,100
e5fd0622493a7e3c62811ea03ff7931c979dd87a,2054,129342,128903,439,1029,0,1029,1,78,659,59,478,10.15516019,86260,89,1,10947,18069,7122,670074,1190063,519989,5906,8944,3038,32.84297521
92e2ec59a5940a9e7c67ec5cd29044f811dee40a,3,4,4,0,0,0,0,1,1,0,1,1,1.5,73,90,2,13,27,14,551,1008,457,7,12,5,99.75365413
12b6fdc79327241a71a2a7a3d0afed08e6bccaff,0,0,0,0,0,0,0,0,0,0,0,0,0,0,374,0,0,0,0,0,0,0,0,0,0,100
c25cd68256697e7284f6d441ca6998b81c811b4d,0,0,0,0,0,0,0,0,0,0,0,0,0,0,375,1,0,0,0,0,0,0,0,0,0,100
90d4339973870fbaa9c48eeae6896fefec95035d,20,841,4,837,16,0,16,1,5,68,1,10,3.961961074,83,91,0,74,11,63,2885,507,2378,74,11,63,99.10408861
7fb3a7251b19568f5b78d4c5e4256e22b36ae141,3,4,4,0,0,0,0,1,2,465,2,2,1.5,117,92,1,18,18,0,1007,1007,0,12,12,0,100
509c332b68eae90403639b779cd4f7e5f61ad6f5,4,5,5,0,0,0,0,1,2,476,2,2,1.921928095,135,93,2,20,20,0,1077,1077,0,18,18,0,100
0deafca6c89293a237a50722e3d37d826cfb343e,0,0,0,0,0,0,0,0,0,0,0,0,0,0,6,0,0,0,0,0,0,0,0,0,0,100
7025086a8a0ab757cb24486b27515f8f5331bfa0,16,1791,271,1520,4,0,4,2,7,186,4,9,3.127248955,1717,7,1,429,284,145,21502,13600,7902,167,98,69,99.7420187
e8ba712c8b5a102c95aa2e70d27b2fe32f9d620c,2,1,9,8,0,0,0,2,8,256,2,2,0.721928095,1571,8,2,121,121,0,12779,12827,48,70,70,0,100
5af2d25f67f6b432f0af194298586ad71531588d,6,54,2,52,0,0,0,2,8,107,3,5,2.435714465,1343,9,3,271,267,4,10759,10505,254,105,103,2,100
834d6432572c8c60477a965b5cf2aeac1b8db073,0,0,0,0,0,0,0,0,0,0,0,0,0,0,10,4,0,0,0,0,0,0,0,0,0,100
6212381ec38e1e7ad18a6ffb30656a8fe3c742fd,3,191,2,189,1,0,1,1,3,323,1,3,1.112155539,49,542,0,23,3,20,1319,521,798,16,1,15,99.90349043
5b57a5151c5dbb68741f47709c64265f090ef354,1,363,0,363,1,0,1,1,1,0,1,1,0,0,543,1,14,0,14,2421,0,2421,5,0,5,97.86150713
cd336759970caaa6051e28b9204dfe46034c01de,7,179,43,136,0,0,0,2,9,76,4,6,1.792890439,4635,11,5,714,692,22,35671,35079,592,246,242,4,99.45789664
8e84ca65b3264725eeff3bbddabc8eb798419f9d,0,0,0,0,0,0,0,0,0,0,0,0,0,0,12,6,0,0,0,0,0,0,0,0,0,100
ce710ae6731b78c15b1ea810c1d0072617153de4,0,0,0,0,0,0,0,0,0,0,0,0,0,0,13,7,0,0,0,0,0,0,0,0,0,100
faad66d1239a4f4151b0433f5a8862064eee4210,0,0,0,0,0,0,0,0,0,0,0,0,0,0,14,8,0,0,0,0,0,0,0,0,0,100
7590d4fa76b113dad9c4bec08655d5d0ec4201f7,2,11,5,6,0,0,0,2,2,385,2,2,0.811278124,185,376,0,30,29,1,1315,1271,44,11,11,0,100
f595f47e4871bb7f77f7395d6aab8a4e4a0f62bc,1,26,0,26,0,0,0,2,2,510,1,1,0,91,544,2,3,2,1,1319,1106,213,3,2,1,100
d47e382e6412ebd6f515dc80e111d0871822283e,0,0,0,0,0,0,0,0,0,0,0,0,0,0,15,9,0,0,0,0,0,0,0,0,0,100
886f76ed186fe81e4d8f72182629a098437f43bf,0,0,0,0,0,0,0,0,0,0,0,0,0,0,38,0,0,0,0,0,0,0,0,0,0,100
9f666c391ebf5b88496bd1bf2556b8a15b86ca04,0,0,0,0,0,0,0,0,0,0,0,0,0,0,16,9,0,0,0,0,0,0,0,0,0,100
b751c72e93266fd83355d80bc536a75828bb5e30,0,0,0,0,0,0,0,0,0,0,0,0,0,0,17,10,0,0,0,0,0,0,0,0,0,100
c3c0bf742dfe2f9f61c844625c1724ac4d133e12,0,0,0,0,0,0,0,0,0,0,0,0,0,0,18,11,0,0,0,0,0,0,0,0,0,100
2372ea5713883531720a450d88b2ba5609144433,0,0,0,0,0,0,0,0,0,0,0,0,0,0,19,12,0,0,0,0,0,0,0,0,0,100
10b1ed02e64561325110ad2ec14fcf9c4532748f,2,28,41,13,0,0,0,1,2,50,1,2,0.375051406,300,20,9,55,58,3,2536,2829,293,32,31,1,100
165ea0fde4df1c2cc0ba17f6f4a51e64ac61098c,12,565,101,464,1,0,1,2,7,68,3,5,1.784110975,1578,21,10,251,214,37,15880,12492,3388,112,100,12,99.26780157
d402f6d23b796f97c4cf32b0a2ff45150a4d2d66,5,195,28,167,0,0,0,2,8,169,1,2,0.867694252,1407,22,11,224,205,19,11240,10380,860,63,57,6,100
cf768a74da3da2c00d158ba6aeb38751b6c3510c,3,211,54,157,0,0,0,2,10,26,2,3,1.174756882,2168,23,12,290,277,13,18368,17413,955,94,92,2,100
2dd78920b940546942cbec33055d9ace996bef38,0,0,0,0,0,0,0,0,0,0,0,0,0,0,545,1,0,0,0,0,0,0,0,0,0,100
7e588554ad3510663ee27d9345d680a42c584ae0,0,0,0,0,0,0,0,0,0,0,0,0,0,0,546,2,0,0,0,0,0,0,0,0,0,100
92946b8d7b6efaabaa0f1074843a3a9682fa3367,0,0,0,0,0,0,0,0,0,0,0,0,0,0,24,9,0,0,0,0,0,0,0,0,0,100
f1d3e1031d2ad4f959723f08aafd40b89ae96a88,1,1,0,1,0,0,0,1,4,222,1,1,0,147,94,0,21,21,0,1188,1181,7,4,4,0,100
ec915ded83af86ad96d005c957b03b8807cd197e,6,498,155,343,2,0,2,2,4,12,1,2,2.062449283,1118,25,9,128,108,20,12178,10002,2176,77,62,15,99.81577008
5b3843a89d70c4f8e9b13227480bee1b4a90568b,2,79,0,79,1,0,1,1,3,233,1,2,0.340373286,104,377,0,22,20,2,1406,691,715,15,14,1,99.94481236
64a762f531e87923d3b4ff10141b69ee78904b17,1,17,0,17,0,0,0,1,2,1,1,1,0,61,378,1,1,1,0,670,670,0,1,1,0,100
c7da8f6b7d9d9296e453df2ab296f9fce4e76dfb,6,295,32,263,0,0,0,2,8,110,1,2,2.19932038,2556,26,6,224,205,19,19459,18025,1434,126,121,5,99.92649761
1a50523f32e1a8e2be69fce48d982df856639dad,3,122,1,121,0,0,0,1,6,400,3,3,0.325988715,817,95,1,99,95,4,8566,7649,917,41,40,1,100
21ac567db07c3f2196dfb41cb7bf9bbb786801a2,4,48,2,46,0,0,0,2,11,15,3,3,1.604114055,1098,27,7,235,228,7,8427,8222,205,67,67,0,99.52441924
e6a79a806b32026b653c19e77327fdc4c5e0f8c1,0,0,0,0,0,0,0,0,0,0,0,0,0,0,39,0,0,0,0,0,0,0,0,0,0,100
5f9ee5a080ef82abbf8f368cd9ae01bae205ec88,16,52,74,22,0,0,0,2,12,339,7,11,3.546447942,3584,40,1,722,729,7,26776,26779,3,245,248,3,99.58446251
9b5665be7016f3a574702d0ac843e9e677214dc5,1,3,0,3,0,0,0,2,2,587,1,1,0,76,41,2,12,12,0,628,601,27,8,8,0,100
6f45554182d122a39511a6d145d5f99b4cc19c50,2,82,9,73,0,0,0,1,5,214,1,2,0.717510653,247,96,2,52,45,7,2236,1914,322,16,14,2,100
8c919a4f419517db7c43dffafc46ee7785302e37,0,0,0,0,0,0,0,0,0,0,0,0,0,0,42,3,0,0,0,0,0,0,0,0,0,100
167053bd1ecbb403de8b8c377c8c0ede66b22956,0,0,0,0,0,0,0,0,0,0,0,0,0,0,28,4,0,0,0,0,0,0,0,0,0,100
4c1cb80cca7c26b11f32febd23ec887f13b7606d,0,0,0,0,0,0,0,0,0,0,0,0,0,0,29,4,0,0,0,0,0,0,0,0,0,100
97d865e51ee51b9b0d300dcb8dd90b29fa2a3e4b,0,0,0,0,0,0,0,0,0,0,0,0,0,0,30,4,0,0,0,0,0,0,0,0,0,100
2e8716d89854a407314e5910cb6b37db0400d050,0,0,0,0,0,0,0,0,0,0,0,0,0,0,31,5,0,0,0,0,0,0,0,0,0,100
76df40b9535fbbaf8fd826dc35f15b585e81fa36,2,45,4,41,0,0,0,1,9,81,1,2,0.975525951,251,32,6,47,40,7,2099,1835,264,31,29,2,100
2a8d86617e2b9109f6a366dd4f6bdc20fbd25050,7,308,13,295,2,0,2,1,6,183,2,4,1.680335135,474,33,5,105,71,34,4366,3274,1092,50,32,18,99.76731699
84d36bad4a05e0a25ea9a9d7be006b64161a59ea,0,0,0,0,0,0,0,0,0,0,0,0,0,0,34,6,0,0,0,0,0,0,0,0,0,100
ff5d35f0b4de19a5566e52e5b4162950ee4f5b23,2,60,4,56,0,0,0,2,11,59,1,2,0.757878463,717,35,7,126,120,6,6607,6163,444,19,18,1,99.94634234
a27c8ebcb81e6f8a1d1b57aef2b0203d9d855eff,0,0,0,0,0,0,0,0,0,0,0,0,0,0,36,8,0,0,0,0,0,0,0,0,0,100
ed0ec11e23c828d395c01949e98a1b574a44208a,2,138,0,138,0,0,0,2,2,624,1,2,0.401157044,61,37,9,18,11,7,1550,322,1228,10,9,1,95.42234332
9fd0be12685ecd844cdaeef07f68478cad96d5a4,1,26,11,15,0,0,0,1,4,438,1,1,0,114,97,1,22,20,2,928,816,112,7,7,0,100
ee55e06fcf58c98959afab774fd891f1d9fa49ad,1,1,1,0,0,0,0,1,5,2,1,1,0,127,98,2,22,22,0,928,928,0,7,7,0,100
02f1b8b5ad4ccf9936bb650c7228e401acee09cd,5,271,30,241,1,0,1,1,4,374,3,4,1.342052081,587,99,3,93,84,9,6359,4864,1495,51,46,5,93.27643268
335dbd989fdfb667dbf6a09ad959743935da47a1,7,42,298,256,0,0,0,0,3,132,4,6,1.735533228,937,37,9,116,127,11,5910,7517,1607,61,66,5,93.27643268
7446fbc4356f6a6d098d39d091f9c300b404646b,6,297,41,256,1,0,1,1,5,311,4,5,1.693448605,701,100,3,115,104,11,7287,5680,1607,58,53,5,93.27643268
591e0bd3c09fd7fe937920fbf5ec1c5bd36a386f,0,0,0,0,0,0,0,0,0,0,0,0,0,0,101,4,0,0,0,0,0,0,0,0,0,100
a6d2f52409e1b9cf497d76cd799ad73f17579092,4,387,0,387,4,0,4,1,1,0,1,3,1.9723352,0,39,10,37,0,37,1827,0,1827,21,0,21,99.76943347
98dbfe990887c2ce032015781cc99d4ae8198cbe,2,93,6,87,0,0,0,1,10,38,1,2,0.960707902,284,40,9,57,47,10,2483,2099,384,35,31,4,100
c8a58d3c73d9ea2afe85cb030f5d7bb1d1ad0188,16,136,64,72,0,0,0,2,13,152,4,10,3.591661063,4091,41,9,508,504,4,29464,28884,580,162,160,2,93.40883773
a587795d455df1a9c3b1d8d0ef2a23f965dd2127,0,0,0,0,0,0,0,0,0,0,0,0,0,0,42,9,0,0,0,0,0,0,0,0,0,100
c7f28551f9489d7327792ec97f032ac932016af9,2,30,16,14,0,0,0,1,2,18,1,2,0.558629373,166,43,10,22,18,4,1201,1149,52,14,11,3,100
fe84b04561f6131ddc0593fb811cd1bfba21316d,10,376,256,120,0,0,0,2,4,475,3,3,1.834836913,1411,379,0,264,267,3,10709,10314,395,112,113,1,100
75f1de31248638b2357de365df99ecf0e76c8be1,0,0,0,0,0,0,0,0,0,0,0,0,0,0,44,7,0,0,0,0,0,0,0,0,0,100
f8cad74ca71768243aadda69bb6cb54067e06656,1,1,1,0,0,0,0,2,3,573,1,1,0,209,380,1,35,35,0,1416,1412,4,9,9,0,100
8257ed4439e577c2100fbd95bf11bc969136641e,7,494,86,408,0,0,0,2,13,159,3,7,2.064187627,1403,45,6,270,220,50,14735,11731,3004,77,69,8,100
84aa9565f6ada9f991f0184815f4ba2f04c2fdfe,3,72,25,47,0,0,0,2,2,483,1,2,1.36936067,200,46,7,41,31,10,1628,1407,221,22,16,6,100
33d530c5623dd0c4cb3a977d9aaea02744deefce,0,0,0,0,0,0,0,0,0,0,0,0,0,0,102,0,0,0,0,0,0,0,0,0,0,100
8e2cebda6bde0548af3fd85a91ab32e6040e0918,0,0,0,0,0,0,0,0,0,0,0,0,0,0,0,0,0,0,0,0,0,0,0,0,0,100
4ec9ae4e1b3526965a4ad52754841dd8908e76ae,0,0,0,0,0,0,0,0,0,0,0,0,0,0,47,7,0,0,0,0,0,0,0,0,0,100
10ad502285ca410e8a6cfb4414e34b0494f208a7,2,3,3,0,0,0,0,2,6,492,1,2,0.918295834,752,381,2,60,60,0,7337,7323,14,31,31,0,100
2df45990583690fbdf5bc79ee99d9193439185d7,0,0,0,0,0,0,0,0,0,0,0,0,0,0,48,8,0,0,0,0,0,0,0,0,0,100
689d9bfd69de4afb544f76a97967ce0f4726a0dd,15,575,22,553,8,0,8,1,8,56,1,2,3.346804314,348,49,9,125,78,47,4629,2565,2064,56,23,33,99.44633731
fbd84791e1b90e636d974fd194bd63c47f24e355,1,0,48,48,0,0,0,2,6,116,1,1,0,1117,50,10,65,69,4,10303,10596,293,56,60,4,100
20d018cedf2757bf21bec8f387daee73b0a43ffb,8,1277,20,1257,3,0,3,1,7,200,1,5,1.858087151,1018,103,1,177,90,87,14459,8884,5575,92,51,41,98.49894292
5db4c8c13c54f63ee396f13deedabacea1bc6ad7,2,21,6,15,0,0,0,1,3,56,1,2,0.950956048,177,51,6,23,22,1,1248,1201,47,16,14,2,100
5ecb51e3c32941d3dfe85f323003f48cc737c519,1,12,8,4,0,0,0,2,7,138,1,1,0,341,382,2,27,27,0,6105,6045,60,13,13,0,100
6e56ea05f2ce56bb610ad51f2fc7ae9b0aa9b66d,1,6,5,1,0,0,0,1,2,18,1,1,0,418,104,2,74,73,1,2397,2389,8,31,31,0,100
7468deb442752c1e04af4921826e5bb42cd9fd87,0,0,0,0,0,0,0,0,0,0,0,0,0,0,52,7,0,0,0,0,0,0,0,0,0,100
d0aa9ec73f747554be8d588fa9db66fead26da5e,2,35,12,23,0,0,0,1,3,11,1,2,0.997059057,604,105,3,79,80,1,3972,3869,103,35,35,0,100
e1ba9d96a1e15bb7f09ba405e050c63aa54dbdbc,0,0,0,0,0,0,0,0,0,0,0,0,0,0,53,6,0,0,0,0,0,0,0,0,0,100
2caee34ee9e93406a8b54f2d282e1e42eb892474,7,97,21,76,0,0,0,1,8,168,3,5,2.129553276,2565,106,4,338,326,12,16955,16678,277,232,229,3,100
e587af9fb6a0cbecce9d0d89f28aa227388c3502,1,3,4,1,0,0,0,3,14,68,1,1,0,769,54,7,170,169,1,5749,5746,3,52,52,0,100
d8ba648ea30ff93684c92ff7c78173d5ea3037b0,0,0,0,0,0,0,0,0,0,0,0,0,0,0,55,7,0,0,0,0,0,0,0,0,0,100
105dacd6a9018cd82a8e4837dbff8de112b60069,0,0,0,0,0,0,0,0,0,0,0,0,0,0,56,8,0,0,0,0,0,0,0,0,0,100
5d2ed18d43c2f9c03dc894ea5ba247d7900907c4,2,259,31,228,1,0,1,1,3,20,1,2,0.91244118,105,57,8,36,28,8,2312,781,1531,12,6,6,99.6856005
e0fea744d68ff004c2b258b8a7263311bced2531,1,59,12,47,0,0,0,2,7,39,1,1,0,1084,58,9,68,65,3,10673,10303,370,59,56,3,100
2420226cbde79a8b7649e02122baadbbe4acbf06,2,45,10,35,0,0,0,2,14,54,1,2,0.994030211,962,59,9,157,154,3,8829,8663,166,21,21,0,100
dab6c828686bbbbc80d30c345fce222bbe1db3cd,0,0,0,0,0,0,0,0,0,0,0,0,0,0,60,9,0,0,0,0,0,0,0,0,0,100
31e8dc07f86f5c68f82f868c6dded3919b5a516c,2,6,1,5,0,0,0,1,4,20,1,2,0.863120569,189,61,10,25,23,2,1279,1248,31,17,16,1,100
f36f65911bcb33953d34f88bf8add9895cedee63,0,0,0,0,0,0,0,0,0,0,0,0,0,0,62,11,0,0,0,0,0,0,0,0,0,100
9925a6372cb46bee9a4e40bdf0eac914b54b2717,0,0,0,0,0,0,0,0,0,0,0,0,0,0,63,12,0,0,0,0,0,0,0,0,0,100
5bdd73d8db5e57ed68c9848c7736617fe7018ec5,0,0,0,0,0,0,0,0,0,0,0,0,0,0,64,13,0,0,0,0,0,0,0,0,0,100
c25abaf019fd65afc4b2ec19d0d98aca4310446d,0,0,0,0,0,0,0,0,0,0,0,0,0,0,65,14,0,0,0,0,0,0,0,0,0,100
1e7fc7127a1682014c1e98119d9ccbce0602c4b9,0,0,0,0,0,0,0,0,0,0,0,0,0,0,107,3,0,0,0,0,0,0,0,0,0,100
8886615ae738c3c606562ac6080a72ee42b446f8,0,0,0,0,0,0,0,0,0,0,0,0,0,0,66,15,0,0,0,0,0,0,0,0,0,100
a3fb6df71767a869c6fa168b2664e6834f068568,0,0,0,0,0,0,0,0,0,0,0,0,0,0,108,4,0,0,0,0,0,0,0,0,0,100
12a1fd65d97ec5c584bad12c9960d58870aa974d,0,0,0,0,0,0,0,0,0,0,0,0,0,0,109,5,0,0,0,0,0,0,0,0,0,100
c061d20a8135ff80d8c99cb5403a5f295b1c2a63,2,32,13,19,0,0,0,2,3,567,1,2,0.956457405,129,67,16,19,16,3,1051,961,90,11,10,1,100
90b5a0073eeb418517fda20a43d1a9cee588fd37,0,0,0,0,0,0,0,0,0,0,0,0,0,0,110,6,0,0,0,0,0,0,0,0,0,100
1afbbea2eaafbb3e789a4fcd86b8bc132587fc99,6,134,7,127,0,0,0,2,6,160,4,6,1.747294568,2198,68,16,325,319,6,13964,13075,889,223,219,4,100
fc0e59a9cf6eb77ef7f516591d9cdab5d413332f,1,9,7,2,0,0,0,3,9,104,1,1,0,210,69,16,38,37,1,1614,1606,8,8,8,0,100
8a1f03b1c63d8b445302dc1ed46b033086fcb9be,5,256,83,173,0,0,0,3,15,34,2,3,1.561066506,1864,70,17,229,219,10,17877,16597,1280,93,89,4,99.70960382
dcd25a0569c8d004ccd7247f9a308fd91d3ef43e,2,1,12,11,0,0,0,2,15,72,1,2,0.619382195,1201,71,18,187,189,2,9403,9471,68,65,65,0,100
532baa04961174c978b5b7e14f70bd4d6b96874a,3,58,20,38,0,0,0,1,9,323,1,2,1.423745905,1297,111,5,164,162,2,11802,11556,246,59,59,0,93.33460657
0e8b54e948ae1c40826d307deb189275c454ef6f,0,0,0,0,0,0,0,0,0,0,0,0,0,0,383,0,0,0,0,0,0,0,0,0,0,100
c9053394548d1e4ced9230ef875b49c7bf920812,0,0,0,0,0,0,0,0,0,0,0,0,0,0,384,1,0,0,0,0,0,0,0,0,0,100
375b624c48bb0e422f9c33dc8b3428ce1f68f400,1,2,2,0,0,0,0,2,10,2,1,1,0,414,112,5,0,0,0,4618,4618,0,0,0,0,100
11796c96b7a8d257bd0376b646c413792093efb4,4,217,156,61,2,0,2,2,3,369,1,2,1.396210191,219,385,2,32,28,4,2067,1942,125,13,9,4,99.83982915
691a212129fbf50a091d2b5c05e070d88929eaf8,4,296,0,296,4,0,4,1,1,0,1,2,1.696807773,0,72,14,18,0,18,1525,0,1525,14,0,14,99.49982136
b4455c4c63b209d8e778d9e88984adf8786cd570,2,137,0,137,1,0,1,1,2,0,1,2,0.999961567,114,73,13,31,8,23,1876,1158,718,21,8,13,99.73070018
069c028cbf0135e56b29df84ee77ad4b2cf19a82,0,0,0,0,0,0,0,0,0,0,0,0,0,0,74,14,0,0,0,0,0,0,0,0,0,100
c7477c12ffc7aadc0a89c11da36104cdacdd92fb,0,0,0,0,0,0,0,0,0,0,0,0,0,0,386,3,0,0,0,0,0,0,0,0,0,100
b509532d18fe1c50fc499e9fd36870ccf74bb07e,0,0,0,0,0,0,0,0,0,0,0,0,0,0,75,12,0,0,0,0,0,0,0,0,0,100
bf3fc5eb09cfb7db53f83f10b6dbbfdbe1dbe1f6,0,0,0,0,0,0,0,0,0,0,0,0,0,0,76,13,0,0,0,0,0,0,0,0,0,100
c06cebd7ee51f4a912671d334c10dd8cd61d6826,0,0,0,0,0,0,0,0,0,0,0,0,0,0,77,11,0,0,0,0,0,0,0,0,0,100
4bdf635cedd6da93d2ea0b3a629749838f3b41ba,6,318,79,239,0,0,0,2,16,102,2,4,1.521106842,2261,78,12,233,211,22,16646,15114,1532,44,37,7,99.94623656
9d385e457d9bed289fca2730c9d2be6c3996c76a,7,498,1,497,6,0,6,1,3,80,1,3,2.734478348,617,113,6,69,33,36,6244,4422,1822,49,27,22,94.04572036
a03e9c53b56c5f55215689593d6d0b6b36ea7c8a,0,0,0,0,0,0,0,0,0,0,0,0,0,0,79,13,0,0,0,0,0,0,0,0,0,100
e08fc6bb80095f43bc0519180b43e7b569b57dec,0,0,0,0,0,0,0,0,0,0,0,0,0,0,80,14,0,0,0,0,0,0,0,0,0,100
f7f6a21c47120177e9e61d37bc8cc7fb2a2ca7ae,0,0,0,0,0,0,0,0,0,0,0,0,0,0,387,4,0,0,0,0,0,0,0,0,0,100
1d5eae8ee896e6eb7cc7b78beb9fd0fdf56dde39,5,56,71,15,0,0,0,2,11,15,4,5,2.076068128,2683,81,14,314,316,2,13212,13407,195,219,215,4,100
86a8ed1bf08af2123a44c33d3f7f8ab4b05147e3,0,0,0,0,0,0,0,0,0,0,0,0,0,0,114,4,0,0,0,0,0,0,0,0,0,100
a7d0efc10028409bac8f4d997c9a97e4095a1b71,1,58,0,58,1,0,1,1,1,0,1,1,0,0,115,5,4,0,4,253,0,253,3,0,3,99.7899895
b83a8bcf0d056151e822e7698014dd19fc0f0bfc,0,0,0,0,0,0,0,0,0,0,0,0,0,0,82,14,0,0,0,0,0,0,0,0,0,100
7439e6968d5ad9241ca242b04248080ea7e8c996,2,202,10,192,0,0,0,2,11,518,2,2,0.763256108,490,83,15,46,43,3,11176,10477,699,34,32,2,100
26182eb355c4555773462534050af56240ea77aa,3,327,1,326,0,0,0,2,12,278,3,3,0.745589813,1014,84,16,162,136,26,16889,15137,1752,87,76,11,100
1c75488e7888cd019995fcae758621fa8691fa9c,0,0,0,0,0,0,0,0,0,0,0,0,0,0,388,5,0,0,0,0,0,0,0,0,0,100
7953de69200ba1e9c2189bdd1b9a387831c79376,3,315,20,295,2,0,2,1,7,60,1,3,1.53059021,92,85,16,48,20,28,2125,880,1245,22,5,17,99.91287681
29614f38602629eb55049074d5a2dee296bb7d9d,0,0,0,0,0,0,0,0,0,0,0,0,0,0,86,17,0,0,0,0,0,0,0,0,0,100
8f47214ae6da788c67d3432cf3321e6de8dd76db,2,2,2,0,0,0,0,1,2,0,1,2,1,182,87,18,26,26,0,1149,1149,0,17,17,0,100
d990bcb5911d4037c9ce9835adc65626218092d9,0,0,0,0,0,0,0,0,0,0,0,0,0,0,88,18,0,0,0,0,0,0,0,0,0,100
925c879ae4bf2885dfa3844c21e42e38e9b75083,1,10,6,4,0,0,0,3,5,38,1,1,0,784,0,0,154,153,1,6254,6228,26,52,51,1,100
a1640b99e667687f370c4760e37959d99cc6a578,2,29,15,14,0,0,0,2,2,794,1,2,0.994030211,355,0,0,38,41,3,2962,2891,71,20,20,0,100
82e981be87093accf4dfd19fec53df5ee57e9429,0,0,0,0,0,0,0,0,0,0,0,0,0,0,89,19,0,0,0,0,0,0,0,0,0,100
be42781207475ed5c7e9d5015c026d3896307a75,1,11,1,10,0,0,0,2,3,383,1,1,0,59,90,19,16,14,2,465,411,54,3,3,0,100
9a1a5840173824a8a1e9cea52c398793d7e609a9,0,0,0,0,0,0,0,0,0,0,0,0,0,0,91,19,0,0,0,0,0,0,0,0,0,100
06df07ec93bd377fa50ef483dfadbf33eb1d8d39,3,11,7,4,0,0,0,2,12,13,1,1,1.382102253,398,92,20,64,62,2,3081,3039,42,11,11,0,100
8ba9d923501e8a5f016133030dd328cf2d33855a,3,79,8,71,0,0,0,2,6,465,1,3,1.112854817,273,389,6,41,35,6,2839,2256,583,22,18,4,100
cfb0ce18c9948eef01f7f9b1a0d20f2e80fb227f,6,161,26,135,0,0,0,2,13,88,5,6,2.434954214,2732,93,21,428,419,9,25643,24978,665,298,293,5,100
8ea911cc1c7dcd82c397a3d08f4183d0d1e9d7e8,2,2,2,0,0,0,0,1,3,4,1,2,1,182,94,22,26,26,0,1149,1149,0,17,17,0,100
437a9a88323d0973ebdd135115ba23f8a20a6d81,2,2,4,2,0,0,0,3,16,42,1,2,0.918295834,1173,95,23,168,168,0,10285,10299,14,52,52,0,100
189b55414cb5b5c0cb9c9d8718c74eac5cf06f14,3,44,4,40,0,0,0,2,7,120,1,3,1.28067213,339,390,4,49,47,2,3191,2845,346,27,26,1,100
27c1c0f8d10e3a763fc7b676d5f9c4ed087fc870,2,122,0,122,2,0,2,1,1,0,1,2,0.996896037,0,116,3,6,0,6,398,0,398,4,0,4,99.93041058
5f3450f743f70c214ef8aadb2c82d92bba69c1ca,1,2,2,0,0,0,0,2,10,12,1,1,0,107,96,23,0,0,0,893,893,0,0,0,0,100
cc61bc9207c6b52f35bfafe5d31f9a74ad962ee5,0,0,0,0,0,0,0,0,0,0,0,0,0,0,391,5,0,0,0,0,0,0,0,0,0,100
403624ad4a60fae3481030d1a6c679db989dd2eb,0,0,0,0,0,0,0,0,0,0,0,0,0,0,392,6,0,0,0,0,0,0,0,0,0,100
adee2135698c74877446abfd83da8c848e4ff35e,0,0,0,0,0,0,0,0,0,0,0,0,0,0,393,6,0,0,0,0,0,0,0,0,0,100
43ab7bdf01a1e8b0ec4f3cb47539e049d7f02b94,0,0,0,0,0,0,0,0,0,0,0,0,0,0,394,7,0,0,0,0,0,0,0,0,0,100
67ffeb432e42caf957bd9c4dc6dd8f3c9230a7e9,0,0,0,0,0,0,0,0,0,0,0,0,0,0,395,8,0,0,0,0,0,0,0,0,0,100
f6c8583369d1970ef7882149f7fc931c3603a466,0,0,0,0,0,0,0,0,0,0,0,0,0,0,396,9,0,0,0,0,0,0,0,0,0,100
25227ae6fa9fb9b45c0e0c21476f68961f82878b,0,0,0,0,0,0,0,0,0,0,0,0,0,0,397,10,0,0,0,0,0,0,0,0,0,100
b31c15af017c3d0716a89513f4c772025c443ea4,0,0,0,0,0,0,0,0,0,0,0,0,0,0,398,11,0,0,0,0,0,0,0,0,0,100
335e873378490c4af96d25324f863ed1a3466f6c,4,135,10,125,0,0,0,2,17,163,4,4,0.596188137,2040,97,18,337,332,5,23124,22327,797,143,141,2,100
a1e1b207b8eff5d38234df7931cb919082ec1f4a,0,0,0,0,0,0,0,0,0,0,0,0,0,0,117,3,0,0,0,0,0,0,0,0,0,100
1b053c5e11b6fca3e88c0ccfb4911e4c8bba5bed,3,131,43,88,0,0,0,2,3,147,1,2,1.403916495,239,98,17,50,41,9,2040,1628,412,27,22,5,100
08cf0cbcaf5b7ede13515dd3d975ed62ade2dc7c,0,0,0,0,0,0,0,0,0,0,0,0,0,0,99,17,0,0,0,0,0,0,0,0,0,100
2a6d72c34c90faf861b714c4ad3260571fb328a8,4,171,3,168,0,0,0,1,3,52,1,2,1.335355537,228,100,18,59,31,28,3046,1988,1058,41,24,17,100
040e9442c2ac63d689dfad3b9c6ee9a36a1e39be,0,0,0,0,0,0,0,0,0,0,0,0,0,0,399,11,0,0,0,0,0,0,0,0,0,100
da237588d13ea9bd2d6e5e81f9ec7aa7824f770e,0,0,0,0,0,0,0,0,0,0,0,0,0,0,118,2,0,0,0,0,0,0,0,0,0,100
eca804d571553a4c045c03df3e2aba223fe5aedd,6,545,8,537,1,0,1,3,9,291,4,6,0.994726511,1630,400,10,341,298,43,11826,8666,3160,228,213,15,99.86091794
e739efea44e26fc187cf5074b16d2a4bf28a5967,0,0,0,0,0,0,0,0,0,0,0,0,0,0,119,2,0,0,0,0,0,0,0,0,0,100
d1c1ca5f74c027c5d4d32aecf162e0d1154b61ae,4,191,13,178,0,0,0,2,4,420,1,3,1.057198675,387,101,4,85,56,29,3829,2877,952,47,31,16,100
a5fcb4be1d368ab2ea2d84c8770d0e318b376936,1,1,0,1,0,0,0,2,2,223,1,1,0,66,401,2,10,10,0,352,345,7,5,5,0,100
928bfab30d244881efb632ad9d0543960cb72783,1,22,8,14,0,0,0,2,3,4,1,1,0,67,102,3,12,10,2,391,352,39,6,5,1,100
611569d120f6d5c43d04faeab111daf54a4ff892,3,107,4,103,1,0,1,1,4,287,2,3,0.855982567,289,402,3,50,47,3,2605,1897,708,25,24,1,99.96524157
af682ac82cd46e8c28a2c38d4aed7bb5af2fb60d,0,0,0,0,0,0,0,0,0,0,0,0,0,0,403,4,0,0,0,0,0,0,0,0,0,100
055ec2a7cacc3c961b377d047bd8230022b31a8a,0,0,0,0,0,0,0,0,0,0,0,0,0,0,103,3,0,0,0,0,0,0,0,0,0,100
0e34aa16c86b619a1400ca589408f94f0728497d,1,1,1,0,0,0,0,1,3,621,1,1,0,700,120,2,170,170,0,5460,5460,0,39,39,0,100
7f8f9791255d7dd2425a6feb0aa466bd15019d61,1,54,0,54,0,0,0,2,3,846,1,1,0,30,404,4,15,3,12,539,89,450,6,3,3,100
138a99bed99ba1920dc09dc92886d258a5cd0091,4,112,0,112,1,0,1,3,10,18,3,4,1.445432669,1448,121,3,264,257,7,7486,7219,267,206,202,4,99.96526572
db50800726efc6005f1eaea5547d3a9e8bdf514c,2,30,1,29,0,0,0,2,17,98,1,2,0.345117315,999,104,3,163,160,3,9181,8911,270,21,21,0,100
6f308e524df7a49a2f2f7c28459ba1a70bc451db,0,0,0,0,0,0,0,0,0,0,0,0,0,0,122,4,0,0,0,0,0,0,0,0,0,100
cc2821d706cf0a9229eb73d7f53fed2ad379374c,2,11,11,0,0,0,0,4,18,36,2,2,0.439496987,842,405,5,185,185,0,6245,6244,1,59,59,0,100
f422f016b15b20b53f5e1b7f748922780149cf1a,4,39,0,39,0,0,0,3,11,27,3,3,1.931962003,2248,406,6,418,413,5,13702,13523,179,258,256,2,100
93fd7c712e1aeb9be0df63ecd78fdf5523fdf5ba,0,0,0,0,0,0,0,0,0,0,0,0,0,0,407,7,0,0,0,0,0,0,0,0,0,100
a8076927814f3f921d167428ef73260ce00100ba,18,47,20,27,0,0,0,2,6,752,10,14,4.01953075,1662,43,0,308,308,0,11487,11487,0,121,121,0,100
2aa46453d49f19e25f989a421a3df6a3eb61a155,0,0,0,0,0,0,0,0,0,0,0,0,0,0,408,6,0,0,0,0,0,0,0,0,0,100
f8219575bb6a8adad5f16083592413c461e1e134,0,0,0,0,0,0,0,0,0,0,0,0,0,0,409,7,0,0,0,0,0,0,0,0,0,100
89bf09f9706f49de5f076ecb9f586efeb6139ca1,0,0,0,0,0,0,0,0,0,0,0,0,0,0,123,3,0,0,0,0,0,0,0,0,0,100
c94d9b1e68570760c7990f15e9d7e3670ed233c1,10,734,19,715,3,0,3,3,12,179,4,9,2.51682904,2443,105,1,416,362,54,20170,16248,3922,292,253,39,99.84396671
6e7266ad3649e1804ee869afed04f79a71e48b7d,4,17,3,14,0,0,0,1,6,8,2,4,1.570950594,586,106,1,88,88,0,4230,4166,64,37,36,1,99.79220779
d6c681669425242c7ff2e0760de3ae9c065f7dde,1,1,1,0,0,0,0,1,6,504,1,1,0,820,124,2,34,34,0,7137,7151,14,31,31,0,100
e4033958a007e0d659936c2b806986bf6801ce49,0,0,0,0,0,0,0,0,0,0,0,0,0,0,125,2,0,0,0,0,0,0,0,0,0,100
c7a0a99316b4a79bf3939bab627b793e15628a41,2,21,0,21,0,0,0,1,3,6,1,2,0.791858353,160,107,2,23,21,2,1308,1200,108,14,13,1,100
898e0a2d9c63947333635b811157d49a45b357ec,0,0,0,0,0,0,0,0,0,0,0,0,0,0,410,2,0,0,0,0,0,0,0,0,0,100
11539a2e3618eed2ba0f87ed5222eaa0dce591dc,6,55,5,50,0,0,0,3,19,38,3,5,2.324826684,3507,126,3,476,472,4,25159,25008,151,296,294,2,100
f8909f52a3b17773f139b4bca0a4bb4380241d5e,0,0,0,0,0,0,0,0,0,0,0,0,0,0,127,4,0,0,0,0,0,0,0,0,0,100
96728794b9303e12568c83c62b1c0e599549e493,3,262,0,262,3,0,3,1,1,0,1,2,1.329105265,0,128,5,37,0,37,879,0,879,37,0,37,99.50025849
b2ec86f71046867d7798635853a9c7076f6e3a20,5,43,89,46,0,0,0,1,7,19,2,5,2.03316191,1120,108,3,96,98,2,10144,10338,194,70,75,5,100
35b65a26727245b75420551851f78d574a6d2c0b,2,68,8,60,0,0,0,1,5,2,1,2,0.884483973,160,109,4,36,23,13,1535,1205,330,15,12,3,100
2717b15749ad01f0c3a1120c66825ffffd9d3832,1,10,3,7,0,0,0,2,9,183,1,1,0,1098,110,5,69,69,0,10417,10335,82,59,59,0,100
e844eff90b5993da01ab6027a93265d3f1f0077f,5,129,8,121,0,0,0,1,8,4,2,5,1.890792246,1270,111,6,147,139,8,12155,11355,800,73,70,3,100
b152de65c5e81b055198ce52c959157c0604aa82,0,0,0,0,0,0,0,0,0,0,0,0,0,0,411,3,0,0,0,0,0,0,0,0,0,100
a3414a962be5c01d9aee5294cfb492564b7c1dbf,1,4,2,2,0,0,0,2,10,6,1,1,0,1105,112,7,69,69,0,10459,10417,42,59,59,0,100
c555bafbd151e4410f525839e79f5a2044574bd4,2,86,1,85,0,0,0,2,9,8,1,2,0.79732651,932,129,5,92,88,4,9805,9238,567,40,39,1,100
4729799d6cc7fedef378e6f7fe3ac8409754f342,2,27,5,22,0,0,0,1,7,16,1,2,0.337290067,211,113,7,40,36,4,1663,1537,126,18,15,3,100
bc6683f4e67f1c1904a82b4d488293124f565e26,3,106,3,103,0,0,0,1,10,326,2,3,1.12867339,1072,130,6,115,103,12,10924,10394,530,50,48,2,99.98285322
1eae4179b3777c6b55f68b28a90a80d3cb50b107,0,0,0,0,0,0,0,0,0,0,0,0,0,0,412,2,0,0,0,0,0,0,0,0,0,100
94979115817fbde49b0bd77fe42e1e087033b57a,0,0,0,0,0,0,0,0,0,0,0,0,0,0,413,3,0,0,0,0,0,0,0,0,0,100
954f8665861c11ff300081e3ddc6a1e7094242de,0,0,0,0,0,0,0,0,0,0,0,0,0,0,414,4,0,0,0,0,0,0,0,0,0,100
2139d7b57ccec743c3d14ded0827aab958570173,0,0,0,0,0,0,0,0,0,0,0,0,0,0,415,5,0,0,0,0,0,0,0,0,0,100
b90305043c1a89b69f03e3026bcefcae0a3ee83a,0,0,0,0,0,0,0,0,0,0,0,0,0,0,114,7,0,0,0,0,0,0,0,0,0,100
f92733c28b5188c26023c6d95b0220915dd30748,1,0,71,71,0,0,0,2,11,2,1,1,0,727,115,8,32,36,4,7263,7926,663,28,32,4,100
ed24bcdb704f7be0b34424f87ceb5fdceca952dc,2,18,6,12,0,0,0,1,7,13,1,2,0.979868757,341,116,9,44,42,2,2421,2331,90,33,31,2,100
9482351e75a34dc692ad7fbfb09e8711a6f8dc70,2,88,1,87,1,0,1,1,13,83,1,1,0.312089566,230,117,10,58,47,11,2092,1719,373,12,8,4,99.93144816
c3851dd8686003400fec75132526e08c18455510,1,3,2,1,0,0,0,2,5,360,1,1,0,340,118,6,65,65,0,2445,2440,5,33,33,0,100
529854861c9882f6124ab1a84909f5aa1a813676,1,6,10,4,0,0,0,2,2,987,1,1,0,54,119,6,9,9,0,339,365,26,5,5,0,100
4fdefcbbea9bbbe838fef9a718895729be6c21c9,1,7,2,5,0,0,0,1,2,987,1,1,0,254,131,2,51,50,1,1649,1638,11,20,20,0,100
95ac193ed536bb0db0fc09c17d93c66b765b668b,2,19,6,13,0,0,0,1,8,27,1,2,0.970950594,234,120,7,43,41,2,1780,1716,64,20,19,1,100
72dbf4886aaac1e4b2c91d8d485a876c90911164,4,91,34,57,0,0,0,1,12,26,2,4,1.062421397,964,121,8,77,75,2,9778,9582,196,50,48,2,100
b61e8d529c60a5b0c62b2535b65a09e1a9cf036a,0,0,0,0,0,0,0,0,0,0,0,0,0,0,416,4,0,0,0,0,0,0,0,0,0,100
2134f080ae6aa73a0fd47e184d5476b68e52bd99,2,4,21,17,0,0,0,2,10,0,1,2,0.942683189,267,417,5,42,45,3,1843,1935,92,21,22,1,100
45c0de9dee9fcfca15b30ac11725f96b3669e2ab,1,2,7,5,0,0,0,2,6,27,1,1,0,185,418,6,16,17,1,1185,1215,30,16,17,1,100
2784b52fb1f7a00dac566a3e30fe111e278c9592,0,0,0,0,0,0,0,0,0,0,0,0,0,0,122,7,0,0,0,0,0,0,0,0,0,100
7a7450b90c1cc244a4bc96fcc9845c6de8464d63,1,18,17,1,0,0,0,2,12,186,1,1,0,586,123,8,110,109,1,4304,4296,8,48,48,0,100
7349a72993f54028b1d314578a1c0b77327c635b,0,0,0,0,0,0,0,0,0,0,0,0,0,0,419,3,0,0,0,0,0,0,0,0,0,100
aa587bb8287b22839b6d12a8cbab032c5b77dfaf,0,0,0,0,0,0,0,0,0,0,0,0,0,0,420,4,0,0,0,0,0,0,0,0,0,100
e9612fcc9c9d278bef06bc1ad9a59bf87799d535,1,6,1,5,0,0,0,1,2,1008,1,1,0,34,132,1,3,3,0,245,243,2,3,3,0,100
d303eee27b7eeef3affbab99713b17d7c6916832,0,0,0,0,0,0,0,0,0,0,0,0,0,0,44,0,0,0,0,0,0,0,0,0,0,100
cbf35dfb023bf5ec66a0663ba695cf9ee37a5aa7,9,421,1,420,8,0,8,1,2,113,1,2,2.942541384,42,124,6,40,3,37,2128,343,1785,25,1,24,99.70964987
86d3a52e7709282b0ddd70213fd6e55a4fc616a1,1,6,2,4,0,0,0,2,11,80,1,1,0,1107,125,7,69,69,0,10500,10459,41,59,59,0,100
4987c3645247898ac0e0e6e8ee6cfe11324a2669,0,0,0,0,0,0,0,0,0,0,0,0,0,0,421,5,0,0,0,0,0,0,0,0,0,100
7b196983748d945a7d078ef6da9184bbf7343ea9,0,0,0,0,0,0,0,0,0,0,0,0,0,0,422,6,0,0,0,0,0,0,0,0,0,100
1d399f26a06dc10e8038634dcf5442cb7e0b69c7,0,0,0,0,0,0,0,0,0,0,0,0,0,0,423,7,0,0,0,0,0,0,0,0,0,100
e51dc99ac30a183c66f113a400fc514b4be6ba9e,1,16,0,16,0,0,0,2,3,178,1,1,0,222,133,1,39,37,2,1655,1576,79,18,18,0,100
4220e8bb2ebde6abe8c2b5ddec72de21097dec34,1,190,10,180,0,0,0,2,2,181,1,1,0,48,134,2,2,1,1,2051,645,1406,2,1,1,99.94891878
4016804624b610cbc7e45b1758ff2c26941dc54c,0,0,0,0,0,0,0,0,0,0,0,0,0,0,135,2,0,0,0,0,0,0,0,0,0,100
c60417751b9602050c3dd95b1659558900add5ba,0,0,0,0,0,0,0,0,0,0,0,0,0,0,136,3,0,0,0,0,0,0,0,0,0,100
4ba05e197764349071f0049ff46caeec78833c54,7,199,0,199,0,0,0,1,6,763,3,7,1.997531625,861,137,1,133,123,10,9947,8298,1649,81,74,7,99.82955514
bc0cca6e57740ed514acd606711d787735964ada,0,0,0,0,0,0,0,0,0,0,0,0,0,0,138,2,0,0,0,0,0,0,0,0,0,100
18bd3b8e279bd4a7c93a1808feee34e5f9a13900,1,6,3,3,0,0,0,2,2,1113,1,1,0,262,424,0,54,54,0,1951,1945,6,20,20,0,100
13a55e94e4b3886a7ba065d77ea05b0fbe23f3bd,7,50,52,2,0,0,0,1,7,83,2,6,2.677417701,1061,139,2,150,152,2,10379,10323,56,83,85,2,100
cb9911a25a2dae1abfd6c1e5a8ef0ee865afa4d9,0,0,0,0,0,0,0,0,0,0,0,0,0,0,140,1,0,0,0,0,0,0,0,0,0,100
0f8b05eb22bbb58b1872fa6a64ecda750b6b6fac,15,15,0,15,0,0,0,2,3,692,1,7,3.906890596,383,0,0,62,62,0,2346,2316,30,62,62,0,100
16e1b6243ba64a73a9251c73775fdabd54b1f5d1,0,0,0,0,0,0,0,0,0,0,0,0,0,0,1,1,0,0,0,0,0,0,0,0,0,100
5bf7bc5d01d57481a53c04f6db05e26f42a0e9ca,30,248,225,23,0,0,0,2,18,743,13,21,4.338120986,7113,2,2,1394,1394,0,51452,51022,430,468,468,0,99.93174061
159bb800c4572818026d60c830bffbf0f9c0e71d,97,846,757,89,0,0,0,2,19,725,27,55,5.84220305,24659,3,3,3035,3036,1,185101,183429,1672,1248,1249,1,96.33144734
28a77b7273d2b4515ee2f8898d70e6a380c57144,4,6,9,3,0,0,0,2,9,362,3,3,1.806238929,1061,4,4,97,98,1,8569,8579,10,59,59,0,100
baa43294f5190064310b40546d643b9f022c7cb4,20,561,562,1,0,0,0,4,15,604,9,11,2.961742583,4363,5,5,822,822,0,29482,29482,0,402,402,0,100
93a096a4726d048e7485d85170707457ee54b026,27,0,105,105,0,0,0,2,14,738,15,22,2.659782943,4324,6,6,496,496,0,35498,36486,988,284,284,0,99.98038446
8dc4495a77d9c56145265a52561a1504c3a5d9a9,44,251,126,125,0,0,0,2,8,942,17,25,5.00425016,5899,7,7,538,538,0,54230,52996,1234,333,333,0,100
a66a78cb6ff308b821fbfcdfd94eff14b6cc23eb,1,19,7,12,0,0,0,2,2,1193,1,1,0,253,8,8,39,37,2,1971,1933,38,17,16,1,100
9e412e536b021b1ae0b75c8b8a7ef871f3faf680,5,22,22,0,0,0,0,2,15,347,2,4,1.874587334,1292,9,9,92,92,0,12101,12101,0,33,33,0,100
058d7463df9bbc5b6520e16f6e856c5580ca7a5c,6,41,47,6,0,0,0,2,5,77,2,2,1.300937605,695,10,10,69,64,5,5408,5397,11,42,42,0,100
6a92c4ba61333c5357694713d52c1db15e537870,1,43,90,47,0,0,0,2,5,5,1,1,0,252,11,11,14,14,0,2218,2310,92,9,10,1,100
6070f78118af6a2fd1ee69ff510d693175a45cc8,0,0,0,0,0,0,0,0,0,0,0,0,0,0,12,12,0,0,0,0,0,0,0,0,0,100
c705f62da522401220674ea6613f97f57321ffdc,0,0,0,0,0,0,0,0,0,0,0,0,0,0,13,13,0,0,0,0,0,0,0,0,0,100
3bbd0181833ca3d8407fc6f04c80202afda55929,1092,1096,1096,0,0,0,0,2,20,634,57,249,10.08935528,93698,14,14,11898,11898,0,739072,739074,2,6414,6414,0,100
afe591b1d89db7f745135cef57d1b73245306ac3,37,491,532,41,0,0,0,2,9,69,9,21,5.12282566,2655,15,15,253,253,0,15007,15007,0,180,180,0,100
a4c263f06235955e789b487ca13053bc8a196aa1,0,0,0,0,0,0,0,0,0,0,0,0,0,0,126,0,0,0,0,0,0,0,0,0,0,100
4df0672d1abb1cebcbc288b4fa1b1c7594a576a4,1,1,32,31,0,0,0,3,4,0,1,1,0,157,0,0,20,26,6,889,1115,226,7,8,1,100
b95b2510ff814dfc6918c90ee261524178ddd8ff,1,1,3,2,0,0,0,2,3,0,1,1,0,36,16,16,4,3,1,121,129,8,1,1,0,100
51659e41397ebed5115e4afd7bfb16766be3b4d9,3,5,8,3,0,0,0,3,6,0,1,1,1.57662122,303,17,17,47,47,0,1746,1776,30,26,26,0,100
eb2eabce70d39ac5786158d208654bedb70af859,1,1,2,1,0,0,0,2,4,0,1,1,0,122,18,18,9,9,0,1145,1156,11,4,4,0,100
c0f52c201b28dd1336f0ece4764cc248e5fb0c9e,2,4,11,7,0,0,0,3,5,0,1,1,0.836640742,199,19,19,23,22,1,1116,1180,64,10,10,0,100
c4f946382a96478d4fc1a232b75d5bda6a3e4ed3,1,6,4,2,0,0,0,2,3,7,1,1,0,66,20,20,11,9,2,487,496,9,1,1,0,100
c8635c55ac7d59e1bc780c75d634ece59d75c793,2,5,1,4,0,0,0,3,5,0,2,2,1,162,1,1,20,20,0,1138,1103,35,7,7,0,100
0df17cf27d6af447612b42c267d3f6519c375920,0,0,0,0,0,0,0,0,0,0,0,0,0,0,21,21,0,0,0,0,0,0,0,0,0,100
ec5135b6e4a7bd3fb2356579e638ca87f9d6fee7,0,0,0,0,0,0,0,0,0,0,0,0,0,0,22,22,0,0,0,0,0,0,0,0,0,100
e29c1c1b02289a62eec6deafb6960cdbffc1a9b9,0,0,0,0,0,0,0,0,0,0,0,0,0,0,23,23,0,0,0,0,0,0,0,0,0,100
aceb26a9fd31fcec2458401343bb127a81c4d33f,0,0,0,0,0,0,0,0,0,0,0,0,0,0,24,24,0,0,0,0,0,0,0,0,0,100
a32edadd0575acbceb0dd0f5fe89192ba1bbfdc3,0,0,0,0,0,0,0,0,0,0,0,0,0,0,25,25,0,0,0,0,0,0,0,0,0,100
a5376e6c82832eca331ab04433b5ee2cd42457a9,0,0,0,0,0,0,0,0,0,0,0,0,0,0,26,26,0,0,0,0,0,0,0,0,0,100
9229dd36c624917cf2149eead13f49079958895d,1,11,61,50,0,0,0,3,7,3,1,1,0,411,127,1,10,11,1,2472,2787,315,10,11,1,100
bb280aa8476b079cd8c44cd3b84fecd7eeb41433,0,0,0,0,0,0,0,0,0,0,0,0,0,0,27,27,0,0,0,0,0,0,0,0,0,100
61ae35976a736b3acc0c279c25c51086d880c2a2,0,0,0,0,0,0,0,0,0,0,0,0,0,0,28,28,0,0,0,0,0,0,0,0,0,100
5cc08477c645f19afe85ab4c97adde3d6b645282,0,0,0,0,0,0,0,0,0,0,0,0,0,0,29,29,0,0,0,0,0,0,0,0,0,100
6f8245a21ad6ff4266ce5698c2313d8ea1976c11,0,0,0,0,0,0,0,0,0,0,0,0,0,0,30,30,0,0,0,0,0,0,0,0,0,100
e9016eb809e7cbf5810d89aeb6c71c044f3316d9,0,0,0,0,0,0,0,0,0,0,0,0,0,0,31,31,0,0,0,0,0,0,0,0,0,100
ced350642dd0afe0c550c87af7486eceb58b34c8,0,0,0,0,0,0,0,0,0,0,0,0,0,0,32,32,0,0,0,0,0,0,0,0,0,100
a7d55cb5a7223740a5172ec61f4b867bf8f800d7,0,0,0,0,0,0,0,0,0,0,0,0,0,0,33,33,0,0,0,0,0,0,0,0,0,100
645f4efa3a13aa3d25ec0d0c9a9070380bb9a08c,7,214,144,70,0,0,0,2,6,7,2,2,2.208515913,715,34,34,48,46,2,6344,5846,498,44,42,2,99.84304493
bf956d73cdf7a94729ada417b1e069079e9b402b,2,8,9,1,0,0,0,2,4,14,1,1,0.672294817,153,35,35,17,17,0,1011,992,19,7,7,0,100
e19f5f389bf7e257be32ebeae2775fdda4954b34,0,0,0,0,0,0,0,0,0,0,0,0,0,0,36,36,0,0,0,0,0,0,0,0,0,100
171a0504edc8a51375bb396342627aa52dbffa50,0,0,0,0,0,0,0,0,0,0,0,0,0,0,37,37,0,0,0,0,0,0,0,0,0,100
235f968569084bedb2bf16f9a077fdfb528f77d8,0,0,0,0,0,0,0,0,0,0,0,0,0,0,38,38,0,0,0,0,0,0,0,0,0,100
f6acd1d1f0cbb614d2decd7414a146491848b4b4,0,0,0,0,0,0,0,0,0,0,0,0,0,0,39,39,0,0,0,0,0,0,0,0,0,100
2b1386557d278396fa19c3d0e20c16a2a4941e2b,0,0,0,0,0,0,0,0,0,0,0,0,0,0,40,40,0,0,0,0,0,0,0,0,0,100
93f49e4e1b61f750c8d935f63876f167d5c35b55,0,0,0,0,0,0,0,0,0,0,0,0,0,0,41,41,0,0,0,0,0,0,0,0,0,100
dda85a453804cc017f112e95d557686aea93ffe3,0,0,0,0,0,0,0,0,0,0,0,0,0,0,42,42,0,0,0,0,0,0,0,0,0,100
c00e64610220cee3b305661b8a62872e48c14242,0,0,0,0,0,0,0,0,0,0,0,0,0,0,43,43,0,0,0,0,0,0,0,0,0,100
21f56abcebfd30f1bc39dd70a5318cd92c691d36,0,0,0,0,0,0,0,0,0,0,0,0,0,0,44,44,0,0,0,0,0,0,0,0,0,100
ddb44d95343af6058cc72f545079467b1ef70e8c,0,0,0,0,0,0,0,0,0,0,0,0,0,0,45,45,0,0,0,0,0,0,0,0,0,100
8da57544c376d01d7ba6d9aafac0324e9ed6078e,0,0,0,0,0,0,0,0,0,0,0,0,0,0,46,46,0,0,0,0,0,0,0,0,0,100
0551ac46c2e82bf955ce7e5481be3c39b59caf79,0,0,0,0,0,0,0,0,0,0,0,0,0,0,47,47,0,0,0,0,0,0,0,0,0,100
ce9d03a3dd9f07e19a08d6c1757bd2ccbac8c07a,0,0,0,0,0,0,0,0,0,0,0,0,0,0,48,48,0,0,0,0,0,0,0,0,0,100
ad0f75dcf25476c3f50572f3a4d21c78afbf968c,0,0,0,0,0,0,0,0,0,0,0,0,0,0,49,49,0,0,0,0,0,0,0,0,0,100
8cb1fe38e537559ff824d63745abccb70b6dbd3d,0,0,0,0,0,0,0,0,0,0,0,0,0,0,50,50,0,0,0,0,0,0,0,0,0,100
5bd8f5dd999c2c78ba58ed90a1c344a3471ea67d,0,0,0,0,0,0,0,0,0,0,0,0,0,0,51,51,0,0,0,0,0,0,0,0,0,100
9d929d9c5663586ee10ebb4a29bfcd7415510b8e,0,0,0,0,0,0,0,0,0,0,0,0,0,0,52,52,0,0,0,0,0,0,0,0,0,100
dd816b068f87f137dbe1819b4242701ef9ce6ef9,0,0,0,0,0,0,0,0,0,0,0,0,0,0,53,53,0,0,0,0,0,0,0,0,0,100
ba22ef8d9ad9fb703dc82584a9310d1b8908f243,0,0,0,0,0,0,0,0,0,0,0,0,0,0,54,54,0,0,0,0,0,0,0,0,0,100
0b14270dc8f84e0f3e9b5cfe08c017cd28a1a1dd,0,0,0,0,0,0,0,0,0,0,0,0,0,0,55,55,0,0,0,0,0,0,0,0,0,100
683be6188fe2c9e36cfa282cea3851221b7c4ff2,1,3,4,1,0,0,0,2,5,17,1,1,0,138,56,56,22,22,0,1466,1468,2,9,9,0,100
fedfc8af76b854e55f31f5ca29c73ec85f5383cf,0,0,0,0,0,0,0,0,0,0,0,0,0,0,57,57,0,0,0,0,0,0,0,0,0,100
1fb503e9c780c0bab214875316244cee1297d1b8,0,0,0,0,0,0,0,0,0,0,0,0,0,0,58,58,0,0,0,0,0,0,0,0,0,100
bb2066662948a960c9706483bd7171a50c72ca07,0,0,0,0,0,0,0,0,0,0,0,0,0,0,59,59,0,0,0,0,0,0,0,0,0,100
c315e0c6d96614466ce22aacf7ed3e79ae1005a7,0,0,0,0,0,0,0,0,0,0,0,0,0,0,60,60,0,0,0,0,0,0,0,0,0,100
f827495a18cbd9657206320e97ac6e4e2b6685f8,0,0,0,0,0,0,0,0,0,0,0,0,0,0,61,61,0,0,0,0,0,0,0,0,0,100
45eee785582bd003857698b49ab8b9576f9b0f82,0,0,0,0,0,0,0,0,0,0,0,0,0,0,62,62,0,0,0,0,0,0,0,0,0,100
427242bc9f49a7445af69a0f621e8fbae3ece372,0,0,0,0,0,0,0,0,0,0,0,0,0,0,63,63,0,0,0,0,0,0,0,0,0,100
a60062273d0f2e480eda282f283cf1845650965a,0,0,0,0,0,0,0,0,0,0,0,0,0,0,64,64,0,0,0,0,0,0,0,0,0,100
3999c9234dca285900617926b9a32ef989d9852f,17,168,136,32,0,0,0,3,7,17,5,8,3.162453276,2934,65,65,263,266,3,20409,20011,398,133,132,1,100
5d9b75e6b1b57c35e2f8a0e4ad7169069c38e2df,2,22,19,3,0,0,0,2,7,8,1,1,0.659375881,384,66,66,21,20,1,3715,3736,21,18,17,1,100
4889be64eeb0bbf42c82b1a984427c2e1340cfdc,18,88,69,19,0,0,0,3,21,15,5,12,3.673679929,8516,67,67,894,894,0,73133,72774,359,357,357,0,100
ff41f56567ced9e1768cc9b31cc0422f43191250,5,11,11,0,0,0,0,2,4,20,3,3,2.186704346,517,68,68,17,17,0,4559,4579,20,13,13,0,100
97f6525a405117e02938251c9f66e03c7de48571,0,0,0,0,0,0,0,0,0,0,0,0,0,0,69,69,0,0,0,0,0,0,0,0,0,100
e95841c49fa9861064f91647004ac8770fe7f10a,0,0,0,0,0,0,0,0,0,0,0,0,0,0,70,70,0,0,0,0,0,0,0,0,0,100
a3614db44251e644ac03c905f338faeadef8a17f,0,0,0,0,0,0,0,0,0,0,0,0,0,0,71,71,0,0,0,0,0,0,0,0,0,100
bcb2e1f0196548d9cc54ca94e8fe79198ef61906,1,93,14,79,0,0,0,4,4,33,1,1,0,282,128,2,66,54,12,2176,1951,225,30,20,10,100
d6e93fef94be266bc4eec958ecd29595ea07817f,1,40,3,37,0,0,0,2,3,42,1,1,0,32,72,49,10,2,8,250,85,165,10,2,8,100
19166412f24ee76abf11140fff952f0beab7f592,2,2,12,10,0,0,0,2,4,42,1,2,0.749595257,87,73,50,3,3,0,245,320,75,1,1,0,99.94114185
79493c2d8219c48c7a64c032d0b3e246a08f4426,3,189,10,179,1,0,1,1,5,14,1,3,1.046716155,87,74,51,14,6,8,1746,471,1275,7,4,3,99.96078431
c299db6a43ca6ad9a8e8886827ef49bc029eeb9e,1,5,0,5,0,0,0,2,3,46,1,1,0,564,141,0,122,122,0,4122,4102,20,28,28,0,100
9846cd05fee5327bfcb70363fdfb9ec2ec328b7f,0,0,0,0,0,0,0,0,0,0,0,0,0,0,425,0,0,0,0,0,0,0,0,0,0,100
e2d179d726a36bed69ac2f24929664d746ce380c,2,5,7,2,0,0,0,2,7,60,1,2,0.979868757,178,75,16,26,26,0,944,964,20,18,18,0,100
4f606a13067b7d7173604f9207369d7604ac1d96,0,0,0,0,0,0,0,0,0,0,0,0,0,0,76,4,0,0,0,0,0,0,0,0,0,100
4548f18300a5c2b9bffd6a76e77238732c5fcb8b,1,3,1,2,0,0,0,2,5,52,1,1,0,125,77,5,15,15,0,958,938,20,5,5,0,100
3df51f870d970c9da3ff0258f0204e968ab04baf,0,0,0,0,0,0,0,0,0,0,0,0,0,0,78,6,0,0,0,0,0,0,0,0,0,100
76770fbea66c12f31674c13755374d65fe058b76,3,20,0,20,0,0,0,2,4,66,1,2,1.368995594,279,79,7,41,39,2,1810,1672,138,14,14,0,99.0017616
84d794f843a8f73fa089f36af0e01cf421685cf9,113,258,258,0,0,0,0,3,22,0,28,64,5.352389594,22718,45,0,3116,3116,0,164490,164740,250,1521,1521,0,100
87d7291bd3bdfe498d6f692430b3d02fe47c21ab,1,14,11,3,0,0,0,4,5,41,1,1,0,333,80,8,69,66,3,2224,2176,48,30,30,0,100
ff03a00902ff73cf7a707e4331130bbb759e5760,0,0,0,0,0,0,0,0,0,0,0,0,0,0,81,9,0,0,0,0,0,0,0,0,0,100
2bd2601206a26b586be11f720beeaf626af8d6b4,4,57,99,42,0,0,0,2,6,57,1,3,1.756637205,741,82,10,128,129,1,4674,4708,34,54,56,2,99.86325454
3f360a77bd227122dc5fbad0597c2b6e06a22aad,6,1,87,86,0,0,0,2,5,72,1,2,1.89237048,382,83,11,37,48,11,1675,2165,490,20,23,3,99.94140625
a46a232b7e2281a8625c8413df9c416dbc1923d4,14,17,17,0,0,0,0,3,12,49,5,9,3.690116518,2659,46,1,375,375,0,17467,17525,58,186,186,0,100
b8ddf1e32161fe9091ce539541dbd5ba210108ae,18,11,77,66,0,0,0,5,17,56,8,13,3.130770771,3392,84,12,446,455,9,20565,20683,118,274,274,0,100
78c3bad46748ff1396acdc2b113089282edc597d,1,61,25,36,0,0,0,3,5,3,1,1,0,264,85,13,61,53,8,1810,1682,128,26,18,8,100
121da5440e4ca318bd7f8378c338219673b4f8b7,12,32,32,0,0,0,0,3,13,64,4,7,3.148897082,7683,47,2,524,524,0,58273,58273,0,279,279,0,100
4961cd139348292635e0de2380005d3d59d7f930,72,572,569,3,0,0,0,3,17,41,21,40,4.989213445,21859,86,14,1944,1948,4,171717,169952,1765,1026,1026,0,100
e08d5453084adcc65c81eb0ab2f5ba28ce013676,22,27,27,0,0,0,0,3,17,42,11,16,4.384517132,4869,48,3,829,829,0,31984,32081,97,398,398,0,100
381eef37a43054279b89344ab55086e5c5adb47f,57,505,418,87,2,0,2,3,6,43,1,11,3.451038702,3780,426,1,410,402,8,21162,20860,302,305,298,7,99.86333463
c65e7507388cde75cdccdebdb80e20b583b28b42,2,3,1,2,0,0,0,1,5,2,1,1,0.811278124,328,427,2,45,44,1,2216,2211,5,22,21,1,100
abc7ddc2db935f1914f64e2a4bf378bfaca23e8f,0,0,0,0,0,0,0,0,0,0,0,0,0,0,49,4,0,0,0,0,0,0,0,0,0,100
410d29e41f244e4b69b692f4479b8804048760d2,0,0,0,0,0,0,0,0,0,0,0,0,0,0,50,5,0,0,0,0,0,0,0,0,0,100
1526f58b2539a8ae1958f9c488a63219c8b834bb,0,0,0,0,0,0,0,0,0,0,0,0,0,0,87,12,0,0,0,0,0,0,0,0,0,100
cb6bbb5821fbbfaf344fbb7364749cd4c1888e2c,1,6,4,2,0,0,0,3,5,99,1,1,0,234,88,13,33,33,0,1556,1559,3,15,15,0,100
33fc9e93b11b68c98961b76bc8c498992cf7128f,1,2,76,74,0,0,0,4,7,21,1,1,0,340,89,14,57,70,13,2058,2297,239,20,30,10,100
d3cea960813b2308466f1772392d0038349f85b8,5,1,81,80,0,0,0,5,18,49,3,4,2.078056713,2566,90,15,436,443,7,14985,15284,299,278,281,3,100
80dc25512fabf87ed0a9fad0ff78332a2bdf634b,1,8,12,4,0,0,0,3,3,99,1,1,0,73,129,0,6,6,0,328,359,31,3,3,0,100
8b128c2f1090507d863f0ffc1923ad30b2264cae,0,0,0,0,0,0,0,0,0,0,0,0,0,0,91,16,0,0,0,0,0,0,0,0,0,100
59311f757e51297cb1baf6986dba0307911b292e,1,7,0,7,0,0,0,3,4,2,1,1,0,69,130,1,7,6,1,353,328,25,4,3,1,100
124b3368e3f3fd4799cdfcbe44c732973ea6b8db,5,8,18,10,0,0,0,2,8,55,3,2,2.199687795,1084,92,16,192,195,3,6546,6581,35,69,69,0,100
91d8cdcc313280953448c77bbfce7c97179955c3,2,56,17,39,0,0,0,1,3,57,1,1,0.73275255,450,428,2,83,76,7,3055,2828,227,59,54,5,100
3098fadba67a93f8374593ccb76887fe475d0e6b,0,0,0,0,0,0,0,0,0,0,0,0,0,0,93,17,0,0,0,0,0,0,0,0,0,100
2868f4a160e9b4285cebbbd3e3aa0f41dd9ddafd,2,52,30,22,0,0,0,2,7,56,2,2,0.801469893,496,94,17,42,39,3,3712,3542,170,25,24,1,100
488e4445cf7e37c0c645b65c77c3a95c06500cfe,147,139,1596,1457,0,0,0,3,19,8,31,69,6.166874596,21075,95,18,2484,2485,1,140792,140967,175,1278,1278,0,100
15b471ee941c0cf1c84fc8dc5cb30566ec163dad,23,126,228,102,0,0,0,3,18,42,9,17,4.102154008,6666,96,19,489,491,2,61041,61173,132,309,311,2,97.24665392
82b2f45dfc4e6b6e59d8f4b905c01d18dcbfbc0d,205,1559,1113,446,4,0,4,2,23,6,41,100,5.7701169,34250,143,43,4521,4497,24,230531,228700,1831,2139,2116,23,95.35667478
ef7afca67048e3a7df6b43fad89c9e9b480bba20,0,0,0,0,0,0,0,0,0,0,0,0,0,0,144,44,0,0,0,0,0,0,0,0,0,100
7046c22734546adb272084aeb3d6178cb6055830,0,0,0,0,0,0,0,0,0,0,0,0,0,0,145,45,0,0,0,0,0,0,0,0,0,100
1c72a57e27d29fcd37607935fa34247cf0727bc6,2,21,2,19,0,0,0,3,6,133,2,2,0.965636133,872,51,0,176,174,2,6271,6184,87,53,51,2,100
5f6df55d4f8ecf9dd48019aacb581fc8b0bf15e1,0,0,0,0,0,0,0,0,0,0,0,0,0,0,146,22,0,0,0,0,0,0,0,0,0,100
85ccaae92945b1cb2b50e02f00eab8e7b0f457a6,2,19,49,30,0,0,0,2,12,106,1,2,0.977417818,657,147,23,90,91,1,4041,4016,25,38,38,0,100
12eac267e14d1d4fe6e160858b159533332eae7a,1,12,10,2,0,0,0,2,6,99,1,1,0,379,148,23,72,72,0,2376,2365,11,40,40,0,100
1f7e67efe7a9b7d72303b5a837a10c2232aaff8d,12,16,17,1,0,0,0,4,15,43,8,11,3.33138427,3931,149,24,790,790,0,25461,25465,4,255,255,0,100
86babd32d62b2cbea0c866b3c037c9b288f2e1bb,10,48,132,84,0,0,0,2,21,82,5,8,2.865709719,2956,150,25,556,571,15,20428,20677,249,186,186,0,100
8e51af3175a04bb6721e608c156577bca561548a,39,143,152,9,0,0,0,3,24,99,14,28,4.321828376,7034,151,26,718,719,1,59244,59811,567,336,336,0,95.50273598
a60b032963a8aa664981d1f0a502523a8d33376b,16,110,107,3,0,0,0,2,15,91,8,12,2.37565766,3022,152,27,206,206,0,22583,22790,207,145,145,0,100
0edcb97954e89c8a82e73e5101ebf8b448692ec5,0,0,0,0,0,0,0,0,0,0,0,0,0,0,153,28,0,0,0,0,0,0,0,0,0,100
aea405d65620e9e37779ee0799f7e1b9824e6ba8,0,0,0,0,0,0,0,0,0,0,0,0,0,0,154,29,0,0,0,0,0,0,0,0,0,100
f99093c80046edc18b482309d8b447ea9e88257b,0,0,0,0,0,0,0,0,0,0,0,0,0,0,155,30,0,0,0,0,0,0,0,0,0,100
a1d7b372f077fe4352c243aa2b348b6e2cf377b5,0,0,0,0,0,0,0,0,0,0,0,0,0,0,156,31,0,0,0,0,0,0,0,0,0,100
4865be98245cf217cd5ec0bdfa808cf1bccec14f,0,0,0,0,0,0,0,0,0,0,0,0,0,0,157,32,0,0,0,0,0,0,0,0,0,100
e5938e86f70f4eedbe3056379505557158f8a4ef,0,0,0,0,0,0,0,0,0,0,0,0,0,0,158,33,0,0,0,0,0,0,0,0,0,100
c7badbdb2025d687e229929744480568d34f4af1,0,0,0,0,0,0,0,0,0,0,0,0,0,0,159,34,0,0,0,0,0,0,0,0,0,100
18173b086393e6a9894b8f9328c691bdf9d7015c,0,0,0,0,0,0,0,0,0,0,0,0,0,0,160,35,0,0,0,0,0,0,0,0,0,100
ff10c74facbcbd81cebf7498b585a9fef05133d0,0,0,0,0,0,0,0,0,0,0,0,0,0,0,161,34,0,0,0,0,0,0,0,0,0,100
0cf6248caa7b7270ebf0a0f905786b24c1209444,0,0,0,0,0,0,0,0,0,0,0,0,0,0,162,33,0,0,0,0,0,0,0,0,0,100
57a2814b86864f6b6b6e75995085c4cd7ae4ee05,1,4,1,3,0,0,0,5,17,5,1,1,0,803,163,34,154,154,0,6288,6259,29,52,52,0,100
129774dbf0e3cb4cc85279628f8c26af388c8734,0,0,0,0,0,0,0,0,0,0,0,0,0,0,164,35,0,0,0,0,0,0,0,0,0,100
191b91409ee388637bcc9f67572a92c64b573148,0,0,0,0,0,0,0,0,0,0,0,0,0,0,143,0,0,0,0,0,0,0,0,0,0,100
d49cb66256039a5dec2fb2c7bd968c7249294ef3,2,7,1,6,0,0,0,3,18,27,2,2,0.954434003,4457,165,28,329,329,0,35064,35028,36,133,133,0,100
660b5bca04504b3d801ae2bd74f3fce812003b19,0,0,0,0,0,0,0,0,0,0,0,0,0,0,166,29,0,0,0,0,0,0,0,0,0,100
3760da52f4164efcf0db9dc4794c46cc80fdf65c,3,74,52,22,0,0,0,3,16,9,2,3,1.350041655,2838,430,0,453,451,2,21513,21089,424,158,156,2,100
2190ce463f099230ad6388a526705c69469d05c2,1,17,24,7,0,0,0,4,15,0,1,1,0,859,167,28,34,34,0,8202,8232,30,31,31,0,100
2fd54459357188e16cca1b6d64e9064e04f20cb2,0,0,0,0,0,0,0,0,0,0,0,0,0,0,168,28,0,0,0,0,0,0,0,0,0,100
ca5a0885346e9eba2480554d1721db50790b69bf,0,0,0,0,0,0,0,0,0,0,0,0,0,0,169,28,0,0,0,0,0,0,0,0,0,100
8773ba8deb867f6f1d52d1ffc48138c7846382ee,3,0,67,67,0,0,0,2,5,181,3,1,1.308330807,83,170,28,0,0,0,84,375,291,0,0,0,99.54280309
da478a55717b2bb94afee872ed14fa8abbc4f517,3,558,21,537,1,0,1,1,5,41,2,2,1.285009782,479,144,1,119,83,36,5803,3034,2769,83,59,24,94.10760034
2e5c0866ed3609533a9a24f7d5f695cd6abe9323,2,150,0,150,2,0,2,1,1,0,1,1,0.987137774,0,0,0,17,0,17,596,0,596,7,0,7,99.92559524
4df88bb80d2785febc5f11de154355a30c2a66e3,2,19,64,45,0,0,0,1,6,2,2,2,0.530744567,644,145,2,70,70,0,4588,4695,107,33,34,1,100
2e7749c0e3557ce12bd56eea10cc8776dd98391b,0,0,0,0,0,0,0,0,0,0,0,0,0,0,171,25,0,0,0,0,0,0,0,0,0,100
5118098662d42abf6c6b24ba9174806c8fd9a8a5,0,0,0,0,0,0,0,0,0,0,0,0,0,0,172,26,0,0,0,0,0,0,0,0,0,100
d2e7a107b7c491a8e119b46c8812e1dbaee68808,0,0,0,0,0,0,0,0,0,0,0,0,0,0,173,27,0,0,0,0,0,0,0,0,0,100
c36287807c1ff2ecf604d7b34c26f3456f578fdf,0,0,0,0,0,0,0,0,0,0,0,0,0,0,174,28,0,0,0,0,0,0,0,0,0,100
1210bfbc9783da5901fdc71b96df426ec5056723,0,0,0,0,0,0,0,0,0,0,0,0,0,0,175,29,0,0,0,0,0,0,0,0,0,100
f6d7168c5bc3f4778fdb857b5b4bf23357aa841e,1,3,1,2,0,0,0,2,9,48,1,1,0,266,176,30,46,45,1,1887,1879,8,28,28,0,100
9c7a806d1adb54e0fa555fa9145b62f8bfab0fa1,4,46,6,40,0,0,0,3,11,187,2,4,1.393899355,396,177,31,71,63,8,3054,2779,275,32,27,5,100
00dcbeab4ae54ea0b3cbe24fcceb5d750cacfc8a,1,48,2,46,0,0,0,1,3,3,1,1,0,231,146,3,16,16,0,2293,1796,497,11,11,0,100
8e004963be83881547903da9de75a5eee72838ca,2,25,4,21,0,0,0,2,3,212,1,2,0.957553484,215,178,32,32,31,1,1614,1375,239,16,15,1,100
6736393ddb51b5eed583b437af683cdd17df5be9,220,880,1085,205,0,0,0,2,21,0,36,100,6.986912736,32457,179,33,3902,3903,1,216269,216727,458,1873,1874,1,100
f54e9d2d47ee5927ab102986a1d240049828ecc9,227,716,1087,371,0,0,0,3,25,5,36,86,7.19121782,46773,180,34,6006,6082,76,333032,336145,3113,2777,2777,0,100
6a35473a9ccf411e32a8681b9005a032d6473afa,132,408,445,37,0,0,0,2,26,21,35,69,6.358048415,25483,181,32,4299,4298,1,164613,164672,59,1779,1779,0,100
671a6659e9822f8f96dccf3fc60c8ad44d2b6435,0,0,0,0,0,0,0,0,0,0,0,0,0,0,182,29,0,0,0,0,0,0,0,0,0,100
c478a0629e6017a68f1c831b0f838b4c1b8cea40,5,17,17,0,0,0,0,2,9,147,5,5,2.092395373,858,183,30,32,32,0,7933,7933,0,21,21,0,100
be7f4f37ea0d716a6767ce41ef9f31fdf9912ff7,83,203,541,338,0,0,0,2,23,30,25,43,5.446174074,19798,184,31,3143,3164,21,141877,143214,1337,1345,1352,7,99.81457445
f7eb4538bcd49905944fbd665cf689b1beda85d9,15,41,105,64,0,0,0,2,27,55,7,10,3.096825106,3710,185,22,757,762,5,24843,24994,151,267,269,2,99.96299038
c2cbb345b0af2cba3ab63a726aef6df0573fe71a,14,30,99,69,0,0,0,3,28,32,4,12,2.808375375,2171,186,23,378,382,4,13295,13356,61,150,149,1,100
fcb97c75d5264c4b8d75d82b18be00e2ea15688f,17,110,131,21,0,0,0,3,24,38,8,11,3.371457781,3584,187,24,581,582,1,23531,23514,17,253,253,0,100
e7262162a6d4e3efdd1a666cc33b7e575aa746af,14,44,65,21,0,0,0,2,25,44,9,11,3.553652309,4440,188,23,858,860,2,28036,28141,105,336,334,2,100
8b1329b221b3e5862b80cacfce939e80d09a175d,15,29,221,192,0,0,0,2,22,61,9,12,2.256854087,4356,189,24,832,838,6,27152,28097,945,259,264,5,99.88882713
ea040febbc3d7f162ac4a54bc71646eb1ce79d6b,7,10,11,1,0,0,0,3,18,24,5,6,2.73732278,2930,190,25,251,251,0,25520,25527,7,160,160,0,100
aa4ef4758a097630fa323bfca14fea12f2b296b8,0,0,0,0,0,0,0,0,0,0,0,0,0,0,191,26,0,0,0,0,0,0,0,0,0,100
59954fb32b4a7bc5ec439751495a7491f158a492,0,0,0,0,0,0,0,0,0,0,0,0,0,0,192,27,0,0,0,0,0,0,0,0,0,100
89caa5feeed706abc8d7ce1407830ae00d97d405,112,956,1672,716,2,0,2,3,21,44,26,46,5.861046518,31114,193,28,1897,1969,72,256936,258157,1221,1209,1230,21,95.88369242
ecbbbd00a2240b8e25677ec5548916ea189cd87f,0,0,0,0,0,0,0,0,0,0,0,0,0,0,194,29,0,0,0,0,0,0,0,0,0,100
c00066050bfaa7409f64eb112e8e52f82d66c253,15,90,139,49,0,0,0,2,23,17,9,13,3.680140873,4745,195,30,891,895,4,32054,32282,228,308,308,0,97.60204082
3fde508f218451e66d443dcc07aeebdc0a0c0637,0,0,0,0,0,0,0,0,0,0,0,0,0,0,52,0,0,0,0,0,0,0,0,0,0,100
fc1f085f30d9bdb9ba75d640c487e8bb1a8c0607,2,105,7,98,1,0,1,1,7,10,1,2,0.591672779,68,2,0,19,7,12,731,349,382,9,4,5,99.93026499
4d08dcac1c1b256281855c91fec1a5e9219e1e30,10,29,31,2,0,0,0,3,12,91,5,7,3.049812301,2219,196,26,334,334,0,16529,16468,61,130,130,0,100
c8cfa3309a8e3bdeb0ce431ee5ff6c4f6b1cd7c0,0,0,0,0,0,0,0,0,0,0,0,0,0,0,197,27,0,0,0,0,0,0,0,0,0,100
7cda49a71c05a65a3b28f2ee4532fb83d8ea9a14,3,4,4,0,0,0,0,4,24,14,1,3,1.5,2796,198,28,611,611,0,19022,19022,0,179,179,0,100
dbe099260a7a3b8f768f33c28a41f045a92965ce,0,0,0,0,0,0,0,0,0,0,0,0,0,0,199,29,0,0,0,0,0,0,0,0,0,100
ef6bb24a173312cf8b46e343240d36149a13bbdf,0,0,0,0,0,0,0,0,0,0,0,0,0,0,200,30,0,0,0,0,0,0,0,0,0,100
dc90162c3cc893bc3e64c2f66f5870b336b5eaa0,1,1,1,0,0,0,0,3,9,23,1,1,0,400,201,30,54,54,0,2789,2789,0,22,22,0,100
c659fdb70d8927c613964dcef6a9e5765dd0b126,1,3,5,2,0,0,0,2,3,246,1,1,0,52,202,31,4,4,0,285,287,2,2,2,0,100
59c45d3a3e040a5640c203bec5a64f466d83cf7b,1,13,13,0,0,0,0,5,24,14,1,1,0,792,203,32,150,150,0,6184,6184,0,51,51,0,100
632a6b64f8794c602f0c3f86bd3cdd990a5fbe58,1,30,32,2,0,0,0,3,11,18,1,1,0,573,204,33,124,122,2,4116,4090,26,30,29,1,100
e1bbb2c170f5996f49d8536b8d2195f1fffe80e9,0,0,0,0,0,0,0,0,0,0,0,0,0,0,205,34,0,0,0,0,0,0,0,0,0,100
f957897a56ca45285f9cd838bc5fddf88b0b2ea1,0,0,0,0,0,0,0,0,0,0,0,0,0,0,206,35,0,0,0,0,0,0,0,0,0,100
80a3e976f1e40692e9c3a89cd7abbcd5c09da9c2,0,0,0,0,0,0,0,0,0,0,0,0,0,0,207,36,0,0,0,0,0,0,0,0,0,100
9e8afcafdc924ea814678177ea02356b58422bd2,0,0,0,0,0,0,0,0,0,0,0,0,0,0,208,36,0,0,0,0,0,0,0,0,0,100
225524175459a403410a3c7d8588ae80f75098ea,8,51,29,22,0,0,0,2,10,49,4,4,2.876381219,837,209,37,49,49,0,6872,6625,247,41,41,0,100
dd0c41e6be501a86af4a857e54a305eace1b3f11,37,89,123,34,0,0,0,2,22,46,10,17,3.519388352,13528,210,38,685,686,1,124541,124719,178,455,456,1,100
3fb0b88e6232e423d746befde3407ba13db4e400,7,21,32,11,0,0,0,3,26,37,5,6,1.829814122,3607,211,39,711,717,6,23237,23311,74,279,279,0,100
3f65b6bc81d4d088137a7d267a5d1d9132898132,33,5,261,256,0,0,0,2,23,20,12,20,3.778930315,12558,212,40,1002,1005,3,106803,107118,315,512,513,1,100
89fcabec45c2a80fa2f352a638a8b0110a2eaf92,0,0,0,0,0,0,0,0,0,0,0,0,0,0,213,36,0,0,0,0,0,0,0,0,0,100
1d107f253afaec4a11c740cf30f7c8893990ea20,0,0,0,0,0,0,0,0,0,0,0,0,0,0,214,36,0,0,0,0,0,0,0,0,0,100
ecbebb882e4b1b497788eddb0df58df440a33115,2,298,0,298,1,0,1,2,12,1,2,2,0.829368151,139,147,0,23,6,17,2589,989,1600,18,5,13,93.58624015
0628059787ede30551f7a067421f71cd72dfb252,2,0,298,298,0,0,0,2,11,10,2,2,0.829368151,333,215,37,6,23,17,989,2589,1600,5,18,13,93.58624015
4e04a520801d0a586af8446e7204397349b15a66,0,0,0,0,0,0,0,0,0,0,0,0,0,0,216,38,0,0,0,0,0,0,0,0,0,100
9a2404e75eb5fa8b2a779bbb2ae91d8e4a48d0e8,0,0,0,0,0,0,0,0,0,0,0,0,0,0,217,39,0,0,0,0,0,0,0,0,0,100
19236096adeaa785518f0348022e203b5758d62e,2,293,0,293,1,0,1,2,12,1,2,2,0.835975845,139,148,1,23,6,17,2571,989,1582,17,5,12,93.58624015
e601924406446f44c74ee53cca108cf657a70a7f,0,0,0,0,0,0,0,0,0,0,0,0,0,0,0,0,0,0,0,0,0,0,0,0,0,100
eb831f2b1e4174239c804da1c8cdb19caa47c092,11,423,101,322,2,0,2,3,14,47,3,4,2.894681213,1342,431,0,226,198,28,10016,8421,1595,126,112,14,96.96152208
ac3c0e0592f2e88a8c7559999340224ca6f8c448,0,0,0,0,0,0,0,0,0,0,0,0,0,0,218,24,0,0,0,0,0,0,0,0,0,100
f0e9be6c4c5f090205325560b1cbc08082daddde,0,0,0,0,0,0,0,0,0,0,0,0,0,0,219,25,0,0,0,0,0,0,0,0,0,100
6beea15ba0d6ce88c89fb57087b408230f3a635b,0,0,0,0,0,0,0,0,0,0,0,0,0,0,220,26,0,0,0,0,0,0,0,0,0,100
ef316c6e6734764c6c546b87d3283a79db9587d4,0,0,0,0,0,0,0,0,0,0,0,0,0,0,221,27,0,0,0,0,0,0,0,0,0,100
1834f888428fe823ddd7fe2b3414cb3da69db2fa,0,0,0,0,0,0,0,0,0,0,0,0,0,0,222,27,0,0,0,0,0,0,0,0,0,100
62f9ab8302b1bacfff0f41f7f39696ca081ca0df,0,0,0,0,0,0,0,0,0,0,0,0,0,0,223,27,0,0,0,0,0,0,0,0,0,100
4c83f9de7bb0db78e5d248a56e29db999970f06d,0,0,0,0,0,0,0,0,0,0,0,0,0,0,224,19,0,0,0,0,0,0,0,0,0,100
723e5d71810938224e3953be6e30c42db09c68cd,0,0,0,0,0,0,0,0,0,0,0,0,0,0,225,20,0,0,0,0,0,0,0,0,0,100
23d73dba075e40594e2ba4cf69fddf02b587447f,0,0,0,0,0,0,0,0,0,0,0,0,0,0,226,21,0,0,0,0,0,0,0,0,0,100
4dba014d2fc59fc6b6f4e325a80f417ad09836ad,0,0,0,0,0,0,0,0,0,0,0,0,0,0,227,9,0,0,0,0,0,0,0,0,0,100
193502a3000b04d2121364dd0b3989cd70df99f0,2,14,14,0,0,0,0,2,9,57,1,2,0.905928216,283,228,10,27,27,0,2771,2772,1,5,5,0,100
856e4ad1ef20578cf8dc78008ac22d36d70e9fb1,8,287,19,268,1,0,1,2,13,123,4,7,2.774963888,1145,229,11,167,142,25,11969,9879,2090,107,90,17,99.87786674
20b0a38b6b93d5a5b91085a6c7d6695b5b1ddd79,0,0,0,0,0,0,0,0,0,0,0,0,0,0,230,12,0,0,0,0,0,0,0,0,0,100
b85fec2804f986882193f646d4f61b7fd09a1bff,6,71,32,39,0,0,0,2,29,81,2,6,2.530648612,2046,231,13,429,419,10,14944,14777,167,139,134,5,100
67e6e9d165ddf92ad41072da9141b92210cf0543,0,0,0,0,0,0,0,0,0,0,0,0,0,0,0,0,0,0,0,0,0,0,0,0,0,100
68dd248b8d6c89081c5e2403e3cc30be07e51f32,1,7,10,3,0,0,0,3,11,43,1,1,0,247,232,13,34,34,0,1837,1847,10,19,19,0,100
572ab38205e1a94498df52a8e5ddafc18231c914,0,0,0,0,0,0,0,0,0,0,0,0,0,0,233,10,0,0,0,0,0,0,0,0,0,100
b0fac168a8da3d2afb2c8a4c5e946352fe23cc50,0,0,0,0,0,0,0,0,0,0,0,0,0,0,234,11,0,0,0,0,0,0,0,0,0,100
1d19a804ebc7b50c948ce97fa2106b46b2c2aff5,14,143,181,38,0,0,0,3,30,55,7,13,3.310111775,4127,235,12,768,771,3,27741,27836,95,324,327,3,100
eb9b667a814997b9317f28fc92920092f0c26d8b,2,514,0,514,1,0,1,1,11,48,1,2,0.020324738,223,3,0,130,35,95,2678,1319,1359,107,12,95,99.9728187
b38a64b70e410e6b1e69fef1c325c56d237efc7b,0,0,0,0,0,0,0,0,0,0,0,0,0,0,236,9,0,0,0,0,0,0,0,0,0,100
1a8f83f5a8a329d090b89c6bd875f16824e8b723,0,0,0,0,0,0,0,0,0,0,0,0,0,0,237,10,0,0,0,0,0,0,0,0,0,100
825d0a93826a176dbd556b9d9d91080256bfa353,0,0,0,0,0,0,0,0,0,0,0,0,0,0,238,6,0,0,0,0,0,0,0,0,0,100
a23e70a1d37e1e0e3cbf057918da1295c62ad539,0,0,0,0,0,0,0,0,0,0,0,0,0,0,239,7,0,0,0,0,0,0,0,0,0,100
5bde1fe7affde09d2bb8b4e25c766883733de3f8,0,0,0,0,0,0,0,0,0,0,0,0,0,0,240,8,0,0,0,0,0,0,0,0,0,100
95e6d2b8b0c74ac1d7ebda41b163348abe20363a,0,0,0,0,0,0,0,0,0,0,0,0,0,0,241,9,0,0,0,0,0,0,0,0,0,100
cd29c4b8171d2610cc46113efc68ed319b989a3a,6,406,65,341,2,0,2,1,14,94,1,2,1.848780737,488,242,9,95,75,20,5571,2962,2609,54,38,16,97.02970297
fbad8fdc247e55e143353806a662efea5315199f,0,0,0,0,0,0,0,0,0,0,0,0,0,0,243,10,0,0,0,0,0,0,0,0,0,100
f17167da59975c81166430e77f8ed935c62aa8ae,0,0,0,0,0,0,0,0,0,0,0,0,0,0,244,8,0,0,0,0,0,0,0,0,0,100
c050dd2c6da14e1d0221f328393e0559da0eb72a,0,0,0,0,0,0,0,0,0,0,0,0,0,0,245,9,0,0,0,0,0,0,0,0,0,100
a95ed96b13c9eb55bee7dfbd9099d736c29d7614,0,0,0,0,0,0,0,0,0,0,0,0,0,0,246,10,0,0,0,0,0,0,0,0,0,100
dd0d6967805301077004c83c9db8ec2a0948923b,0,0,0,0,0,0,0,0,0,0,0,0,0,0,247,11,0,0,0,0,0,0,0,0,0,100
e14c539a9d07ea46a68b1db624394700d4e21818,0,0,0,0,0,0,0,0,0,0,0,0,0,0,248,12,0,0,0,0,0,0,0,0,0,100
f745a08ad39f0fa3bfcb87c87324bcdb3cc74b0a,0,0,0,0,0,0,0,0,0,0,0,0,0,0,249,13,0,0,0,0,0,0,0,0,0,100
918bb6ebac23f9785bfce26f4e7315fd86233691,1,1,1,0,0,0,0,3,6,164,1,1,0,315,0,0,13,13,0,1943,1943,0,3,3,0,100
6a369600dc98c5d2119e527bfac449164200dfba,0,0,0,0,0,0,0,0,0,0,0,0,0,0,1,1,0,0,0,0,0,0,0,0,0,100
ca1cdd4eb6da2f4888ce1fbf5f45641a00f457d1,2,4,4,0,0,0,0,3,13,178,2,2,0.811278124,543,250,5,53,53,0,7319,7319,0,30,30,0,100
4eb7bcdf3ca878117aef54076cf0f6ef5e610550,0,0,0,0,0,0,0,0,0,0,0,0,0,0,251,6,0,0,0,0,0,0,0,0,0,100
24cd643d84d7fc7b58a01174dd1486b98ce2022d,0,0,0,0,0,0,0,0,0,0,0,0,0,0,252,7,0,0,0,0,0,0,0,0,0,100
105b8d548eb11401cfa9d61dd02c6039ea129780,0,0,0,0,0,0,0,0,0,0,0,0,0,0,253,8,0,0,0,0,0,0,0,0,0,100
63e1a75df6678ff7dd567c1583a54a88525c80fe,0,0,0,0,0,0,0,0,0,0,0,0,0,0,254,9,0,0,0,0,0,0,0,0,0,100
a7a56720ab2c6070793f436873bcada6700fe62f,0,0,0,0,0,0,0,0,0,0,0,0,0,0,255,10,0,0,0,0,0,0,0,0,0,100
ee13638dd216d6d33cf0f60930ee3b83a9cf00ca,0,0,0,0,0,0,0,0,0,0,0,0,0,0,256,11,0,0,0,0,0,0,0,0,0,100
a05c0c2b8aa71b246ddd239a475e59b27dce15ee,0,0,0,0,0,0,0,0,0,0,0,0,0,0,257,12,0,0,0,0,0,0,0,0,0,100
f067b8ffbee5186f838ad73ab3a8e6e37b44256e,3,8,10,2,0,0,0,3,19,106,1,2,1.530493057,4463,258,13,209,209,0,38374,38374,0,105,105,0,100
bc01baf8a25230424060f247329cc7fbbaf3925f,0,0,0,0,0,0,0,0,0,0,0,0,0,0,2,2,0,0,0,0,0,0,0,0,0,100
ffc516043b772cde2d85262880d59ae3860c951a,0,0,0,0,0,0,0,0,0,0,0,0,0,0,259,9,0,0,0,0,0,0,0,0,0,100
a2fc323e2285512ddcfa7f75d2eba0f469958847,0,0,0,0,0,0,0,0,0,0,0,0,0,0,260,10,0,0,0,0,0,0,0,0,0,100
d2f30e40a3cd8a80158dd0070fc338cebec92508,0,0,0,0,0,0,0,0,0,0,0,0,0,0,261,11,0,0,0,0,0,0,0,0,0,100
a7a353a16ecf7a9f62fa18530afdbdaae85b565c,0,0,0,0,0,0,0,0,0,0,0,0,0,0,262,12,0,0,0,0,0,0,0,0,0,100
88dda9684886e28a9e6d7b17abe4276877449c91,0,0,0,0,0,0,0,0,0,0,0,0,0,0,263,13,0,0,0,0,0,0,0,0,0,100
0267cadb094c0c153ff3e77d3e798b7e96e16552,0,0,0,0,0,0,0,0,0,0,0,0,0,0,264,14,0,0,0,0,0,0,0,0,0,100
c5d4111a0ddf1831da8b16abfd0ecf0518aa1dea,0,0,0,0,0,0,0,0,0,0,0,0,0,0,265,15,0,0,0,0,0,0,0,0,0,100
dac2f2e289ea4ca99afd37dadcfc623fdac19fb1,5,94,8,86,0,0,0,4,16,205,3,4,1.508477666,1815,3,3,145,140,5,17301,16827,474,87,84,3,99.8588839
6aa1759d108250ffd93ba809e7106705c081e8a2,1,8,484,476,0,0,0,2,2,117,1,1,0,410,266,16,1,95,94,157,1352,1195,1,95,94,99.85946084
9cdf531fb3d7259e8d16d27bb2ed7cdf1de6e4df,4,85,18,67,2,0,2,1,15,107,2,3,1.637872214,632,267,17,116,112,4,3795,3619,176,51,48,3,99.92365441
41aa098a64d6c15416ba611b5ea81df2da0aadfd,1,1,10,9,0,0,0,1,2,2,1,1,0,43,268,18,3,5,2,218,256,38,2,3,1,100
06a37c012909b6fa8326fc9f4f1160a4577610af,1,0,2,2,0,0,0,2,11,221,1,1,0,206,269,19,14,14,0,1519,1525,6,12,12,0,100
92b1afe7d200c16d21f711b4bd1fe2678136ae5e,2,103,17,86,0,0,0,3,13,224,1,2,0.983708263,332,1,0,66,52,14,2684,2239,445,17,16,1,100
45766567d15ec814e6379dcce9e93043a0ffef91,29,952,163,789,0,0,0,6,28,182,5,16,4.221360468,8369,0,0,1385,1316,69,59514,55066,4448,645,607,38,91.2881052
ac53ac4288c04ff639e32e1cff6f2efbb791c4f3,10,29,27,2,0,0,0,4,27,131,4,8,2.349756925,4865,1,1,771,771,0,36347,36318,29,253,253,0,100
8f3b21c44e699f69d6eceb33c7a1a696b8bcd777,0,0,0,0,0,0,0,0,0,0,0,0,0,0,270,11,0,0,0,0,0,0,0,0,0,100
a165686f3b0f86954580a1177518791b88e72ee4,0,0,0,0,0,0,0,0,0,0,0,0,0,0,271,12,0,0,0,0,0,0,0,0,0,100
5790d08098fdeb053ac195941a2949b5c9d13b52,0,0,0,0,0,0,0,0,0,0,0,0,0,0,272,13,0,0,0,0,0,0,0,0,0,100
94e423c7288df44d2648afc87703bdb1596c2029,5,310,51,259,0,0,0,3,17,74,1,5,1.520640187,1154,2,2,130,118,12,10542,8568,1974,67,61,6,94.02588782
04a60fb9f1f65007ef702106fd0c80e67fb3d499,10,201,36,165,1,0,1,1,28,130,5,6,2.151105285,4030,4,1,668,649,19,29181,28275,906,260,246,14,94.28055388
df120a701f2fbba6324528c7e5a2817e7a02e0da,13,1234,621,613,5,0,5,6,29,5,3,7,2.695705099,2785,273,11,456,429,27,19462,16112,3350,336,305,31,91.96413466
465ee3476aa3d31caafe63d7d6597ad32f1d732c,2,41,6,35,0,0,0,3,18,0,1,2,0.14854949,324,274,12,51,43,8,1929,1804,125,28,28,0,100
fe15d443d1df4020c3cba94bb88cd5d907113f14,4,133,18,115,1,0,1,1,27,25,3,4,1.889208069,1205,5,1,217,195,22,9661,8997,664,80,72,8,99.92104224
283d638f728015120cd9838ac7676f8b8b649d3b,0,0,0,0,0,0,0,0,0,0,0,0,0,0,0,0,0,0,0,0,0,0,0,0,0,100
1262230a1d4b96d098524fd301fc2bb062415137,6,547,89,458,1,0,1,3,28,16,2,5,1.034348824,1716,3,3,226,207,19,17345,14101,3244,81,73,8,99.8226601
08dea106dbef920258095a9fc30325a2ea50b810,14,748,18,730,6,0,6,3,30,21,4,8,2.401301095,2228,275,6,457,384,73,16738,12947,3791,266,224,42,92.12010919
42c341190db362b9679b0dd1ee4a91b0de82635e,0,0,0,0,0,0,0,0,0,0,0,0,0,0,6,2,0,0,0,0,0,0,0,0,0,100
34675d7e7540f4696b9d936d2569f662e5e190e5,0,0,0,0,0,0,0,0,0,0,0,0,0,0,276,7,0,0,0,0,0,0,0,0,0,100
07702de9cfecec959782808cc36b242c9cf26ef0,0,0,0,0,0,0,0,0,0,0,0,0,0,0,277,8,0,0,0,0,0,0,0,0,0,100
5bf73af9ea8f6779b71c2fc9c5916c0fd8f8d185,0,0,0,0,0,0,0,0,0,0,0,0,0,0,278,9,0,0,0,0,0,0,0,0,0,100
599258bc0df34cb84f51aa8aadd449755fbc7794,0,0,0,0,0,0,0,0,0,0,0,0,0,0,279,10,0,0,0,0,0,0,0,0,0,100
1832f6693d1dd401c589ddb1e6465b3df2b13d93,0,0,0,0,0,0,0,0,0,0,0,0,0,0,280,11,0,0,0,0,0,0,0,0,0,100
dea6c98ee67df8a4695789e33b990b86a2d9ce11,2,56,31,25,0,0,0,6,31,20,2,2,0.688552168,980,7,3,170,167,3,5859,5761,98,110,110,0,100
771c964495699938705c6702b497723f4d73cb30,0,0,0,0,0,0,0,0,0,0,0,0,0,0,8,4,0,0,0,0,0,0,0,0,0,100
c21793602344d213554926cba35f00c24c282491,11,424,73,351,1,0,1,6,32,15,3,8,2.803478198,3518,4,2,476,458,18,26195,24439,1756,324,308,16,98.85097493
984b0e950da0fcf56610f03edaf05dc7e31c6f30,1,40,9,31,0,0,0,7,29,20,1,1,0,820,9,5,170,158,12,6680,6415,265,57,53,4,100
9a7f97420682d1f4f009ce57f15804e91c078f3d,1,1,0,1,0,0,0,3,7,2,1,1,0,44,281,11,0,0,0,261,261,0,0,0,0,100
bd0ab3e1f8afd2453ca60b723c04d043a283d451,0,0,0,0,0,0,0,0,0,0,0,0,0,0,282,12,0,0,0,0,0,0,0,0,0,100
bb870b8002915d9bb2b299e46154924b341a7618,0,0,0,0,0,0,0,0,0,0,0,0,0,0,283,13,0,0,0,0,0,0,0,0,0,100
c30a87b620b78cc705e2c9cba64f6bbf73cf00c6,0,0,0,0,0,0,0,0,0,0,0,0,0,0,284,14,0,0,0,0,0,0,0,0,0,100
7d97dbeacf0f992670242d56303716a35d7f652d,0,0,0,0,0,0,0,0,0,0,0,0,0,0,10,6,0,0,0,0,0,0,0,0,0,100
5fb449118bbcddccea0750dd7a97e66f53f32c60,1,7,7,0,0,0,0,7,30,6,1,1,0,846,285,12,170,170,0,6684,6680,4,57,57,0,100
75a540c918969b478ad4986f5837106c4b63ece6,0,0,0,0,0,0,0,0,0,0,0,0,0,0,286,13,0,0,0,0,0,0,0,0,0,100
399bb6584c05a7c1307a900e33b324bbd20373a8,7,622,562,60,0,0,0,3,21,61,2,4,2.237380611,1495,5,2,100,125,25,12515,11968,547,53,62,9,93.38579726
d96128dfa3d8c8a656a94d97719fb28737fae925,5,297,37,260,1,0,1,1,22,3,2,5,1.267367908,1231,6,3,145,131,14,10633,8980,1653,76,68,8,99.32012432
b3963eb33a3bc664214a16c2c16f04de8d777078,5,30,57,27,0,0,0,3,8,332,1,2,1.589044482,614,0,0,56,57,1,3213,3269,56,31,31,0,100
8f5c00ddc979e9ae4edef527140874a980d46ffe,1,6,3,3,0,0,0,1,2,39,1,1,0,235,287,12,22,22,0,1696,1678,18,13,13,0,100
4ea6f9b4de8437598a87f8480133135622ccb3b3,1,1,1,0,0,0,0,3,9,0,1,1,0,136,288,13,10,10,0,854,854,0,8,8,0,100
8a504c7c7f8e6a07ded65c671b64ccd702f47668,4,224,16,208,0,0,0,2,13,201,1,2,1.401666373,754,4,0,133,114,19,5709,4654,1055,89,80,9,100
6d05bb882a78403470d161a7f7116a147b69fb0a,1,105,0,105,1,0,1,1,1,0,1,1,0,0,0,0,9,0,9,496,0,496,5,0,5,99.92316558
32d8ac6a1ed216e42138aec7f37d709c4a970037,1,4,2,2,0,0,0,3,10,317,1,1,0,327,289,2,63,63,0,2284,2281,3,25,25,0,100
c1b2cbd2a0c24e2a01a27285f30e9ee6d463de66,9,10,12,2,0,0,0,6,27,204,6,8,3.079225802,2030,290,3,358,356,2,11801,11816,15,201,201,0,100
7181eb130a7eafbb9615ad3e2c3e55fba986b086,0,0,0,0,0,0,0,0,0,0,0,0,0,0,291,4,0,0,0,0,0,0,0,0,0,100
c918ed47711a8d48b133725d1cc256a9ee6c2c6a,79,609,357,252,3,0,3,4,31,236,19,38,4.79152563,19708,7,0,2233,2210,23,163741,162355,1386,913,904,9,99.56098492
da3b41726f0b8f0111ffd72754c7a3bccb416df0,0,0,0,0,0,0,0,0,0,0,0,0,0,0,292,3,0,0,0,0,0,0,0,0,0,100
1bdc62975880e1d7e448ea24c3cea3f214928d6f,0,0,0,0,0,0,0,0,0,0,0,0,0,0,11,0,0,0,0,0,0,0,0,0,0,100
52194f70f7f76007f7b3d2423a11ec920879a63b,1,3,4,1,0,0,0,2,2,17,1,1,0,77,293,4,11,11,0,396,396,0,8,8,0,100
8d28295454013cfe50eb98ca97f18fa51beb80e7,3,109,46,63,0,0,0,2,14,57,1,2,1.090710358,680,5,0,88,82,6,4884,4566,318,39,38,1,100
0be5b7c82b4a80556c4291de0bd84a89c69f7571,0,0,0,0,0,0,0,0,0,0,0,0,0,0,294,5,0,0,0,0,0,0,0,0,0,100
b3536b613ef37c235b539a0a7a3b058fb8d70ce3,0,0,0,0,0,0,0,0,0,0,0,0,0,0,295,6,0,0,0,0,0,0,0,0,0,100
9bc418dc5fe804599a2e1fb466f32deacaf2a39c,0,0,0,0,0,0,0,0,0,0,0,0,0,0,296,7,0,0,0,0,0,0,0,0,0,100
83054a0abd322257c16112f022e6a8962285e267,0,0,0,0,0,0,0,0,0,0,0,0,0,0,297,8,0,0,0,0,0,0,0,0,0,100
c4cbc5eb4ca109f16fe14f1c4f1b26f33f62c7ca,0,0,0,0,0,0,0,0,0,0,0,0,0,0,298,9,0,0,0,0,0,0,0,0,0,100
07d4af68bfec827d182c8e3a0967b680cad9b883,0,0,0,0,0,0,0,0,0,0,0,0,0,0,299,10,0,0,0,0,0,0,0,0,0,100
9b611aea89a7ff0ef9205e071e076c92b4afccdf,2,26,4,22,0,0,0,7,30,71,1,2,0.353359335,1793,2,0,390,387,3,11705,11549,156,110,110,0,99.71439452
32940ee263b23336cbc995f3ddb4ba518e8713c4,1,1,6,5,0,0,0,2,3,2,1,1,0,49,3,1,4,5,1,275,283,8,2,2,0,100
99447cc0174c03ae41f22d6c66e85b69af6726dc,0,0,0,0,0,0,0,0,0,0,0,0,0,0,6,1,0,0,0,0,0,0,0,0,0,100
fdeeec693e73a63e3470786eeda2eb3085a7f80c,0,0,0,0,0,0,0,0,0,0,0,0,0,0,1,0,0,0,0,0,0,0,0,0,0,100
95f8c8f8a35b17976b567dffb0dbe8bfa60db7d4,0,0,0,0,0,0,0,0,0,0,0,0,0,0,0,0,0,0,0,0,0,0,0,0,0,100
759e65e95e4c6708aa1d39781b5374465ad0d94f,0,0,0,0,0,0,0,0,0,0,0,0,0,0,0,0,0,0,0,0,0,0,0,0,0,100
1ce7fc4e16490fdb21bf60d6a1e17e6b9436a62d,3,31,1,30,0,0,0,2,15,127,1,2,1.2586633,908,7,0,142,139,3,5835,5708,127,93,90,3,100
5444a2ae2a5f7270f4639e513db7396f822eb81c,5,143,72,71,1,0,1,1,7,344,1,5,1.933396269,289,300,0,22,17,5,2180,1916,264,13,8,5,100
bdfbe08ca452b5659e62ca269bd83e33c6c6fd0d,8,313,6,307,0,0,0,7,33,396,4,6,2.228536661,2336,4,0,458,429,29,16007,14093,1914,305,292,13,100
3f657bab2fd9887ffb45c9edded6b76b9f55e976,1,4,3,1,0,0,0,5,13,215,1,1,0,202,12,0,34,34,0,1247,1237,10,7,7,0,100
c80ad98e324b63a0aa4f88f77b7c310e54a9ff21,4,29,0,29,0,0,0,6,15,422,1,1,1.863231501,644,0,0,101,98,3,4332,4150,182,52,49,3,100
4d7ccad55aaf03245153ef68f620ed14d9ad127a,2,29,2,27,0,0,0,5,34,113,1,2,0.938315352,1128,13,1,195,192,3,8211,7966,245,131,129,2,99.94269341
fc968d94b09fa56d2c363b0a8cf5828691ef49e3,0,0,0,0,0,0,0,0,0,0,0,0,0,0,0,0,0,0,0,0,0,0,0,0,0,100
7c2cf00332c5f5123516cebca6f942bfda5eb516,0,0,0,0,0,0,0,0,0,0,0,0,0,0,301,0,0,0,0,0,0,0,0,0,0,100
3fd62231e51901073e5c9a44ef8a62394bd7c808,0,0,0,0,0,0,0,0,0,0,0,0,0,0,302,1,0,0,0,0,0,0,0,0,0,100
c68857abcc56bca8c45427b33b31502ff6aeefce,1,11,15,4,0,0,0,4,15,339,1,1,0,348,0,0,21,21,0,5775,5835,60,11,11,0,100
ce85fed6451fe9ec8d9c01e7011faee59e839bc5,1,29,20,9,0,0,0,3,9,440,1,1,0,124,0,0,22,19,3,915,874,41,6,5,1,100
3e73a7a04eb71f00611a027ddcd5fea37ae34187,0,0,0,0,0,0,0,0,0,0,0,0,0,0,303,1,0,0,0,0,0,0,0,0,0,100
764925696a992c674f2247bd1cd6b0fc6c12353c,0,0,0,0,0,0,0,0,0,0,0,0,0,0,304,2,0,0,0,0,0,0,0,0,0,100
248f08c7537cf1e9b631b768f18a7dbb6b7e5cbd,36,2639,0,2639,36,0,36,1,1,0,1,15,4.768483024,0,8,0,206,0,206,13282,0,13282,113,0,113,91.80275376
1b8bc7bc041a0b638adcde04c83624bf24b4bd23,0,0,0,0,0,0,0,0,0,0,0,0,0,0,9,1,0,0,0,0,0,0,0,0,0,100
4d2ca826405b4d9424915c3186b3ec5c6cdfe51b,0,0,0,0,0,0,0,0,0,0,0,0,0,0,305,2,0,0,0,0,0,0,0,0,0,100
e04d429fe36173ab42b570b6ad4108fdc563f071,0,0,0,0,0,0,0,0,0,0,0,0,0,0,0,0,0,0,0,0,0,0,0,0,0,100
9f3e1a3c354646c17b4d79dce3e5557889afe78c,8,733,298,435,4,0,4,1,2,0,1,3,2.569897341,738,10,2,140,91,49,7533,5191,2342,73,42,31,93.98148148
16a8ed1311291cef3a7429189e8875528ad0f46a,0,0,0,0,0,0,0,0,0,0,0,0,0,0,11,3,0,0,0,0,0,0,0,0,0,100
d9f99242b5cbc80809d73e41dd0157f554977f15,1,121,199,78,0,0,0,6,24,251,1,1,0,494,306,3,78,81,3,2928,3247,319,36,36,0,100
1a6c3b14dcbe517b45d6209cb2c60731b7046acc,0,0,0,0,0,0,0,0,0,0,0,0,0,0,307,4,0,0,0,0,0,0,0,0,0,100
539a977d361918a7335b2bd700d0d5e23cd0af39,0,0,0,0,0,0,0,0,0,0,0,0,0,0,308,5,0,0,0,0,0,0,0,0,0,100
4169e5506a98c56e151f59f2e272e71a6585fde9,0,0,0,0,0,0,0,0,0,0,0,0,0,0,309,6,0,0,0,0,0,0,0,0,0,100
96f4e2f06be8446cb8f465ceb6cd8005509ba657,0,0,0,0,0,0,0,0,0,0,0,0,0,0,310,7,0,0,0,0,0,0,0,0,0,100
0160c259694ded95014dfd3da337d972a716177c,0,0,0,0,0,0,0,0,0,0,0,0,0,0,311,8,0,0,0,0,0,0,0,0,0,100
ee4284eeaf31d8f186fc9f1a982485e0a889a6ea,0,0,0,0,0,0,0,0,0,0,0,0,0,0,312,9,0,0,0,0,0,0,0,0,0,100
1861cd07e40577e8049b6916f9c7fbf3532943a5,0,0,0,0,0,0,0,0,0,0,0,0,0,0,313,10,0,0,0,0,0,0,0,0,0,100
2f6d4bf499cbd62fb735f0e96dd8724927b9bb59,0,0,0,0,0,0,0,0,0,0,0,0,0,0,314,11,0,0,0,0,0,0,0,0,0,100
d56415d1d7d6f0b5ca3aeb3e2b9b36da342f1ba2,0,0,0,0,0,0,0,0,0,0,0,0,0,0,315,12,0,0,0,0,0,0,0,0,0,100
eb67f11c75ddd20bcf2c0507c239c6e5ff3ec9ad,0,0,0,0,0,0,0,0,0,0,0,0,0,0,316,13,0,0,0,0,0,0,0,0,0,100
6d3e6bf9c609126a461340d2328d774ec2e1494b,0,0,0,0,0,0,0,0,0,0,0,0,0,0,317,14,0,0,0,0,0,0,0,0,0,100
eaee2a82787e42846606e3531580c3b78ff9319b,0,0,0,0,0,0,0,0,0,0,0,0,0,0,318,15,0,0,0,0,0,0,0,0,0,100
26be94cf145df478159963b99dcac892cc88eb7a,0,0,0,0,0,0,0,0,0,0,0,0,0,0,319,16,0,0,0,0,0,0,0,0,0,100
c909d6532be64ab5ba3385546a71bc93f1d6a9a8,0,0,0,0,0,0,0,0,0,0,0,0,0,0,320,17,0,0,0,0,0,0,0,0,0,100
393907d7f1e5c6824f906e888555617a4d9dcc94,0,0,0,0,0,0,0,0,0,0,0,0,0,0,321,18,0,0,0,0,0,0,0,0,0,100
f658d33e32f50647db71964bd951bc9068ac862b,0,0,0,0,0,0,0,0,0,0,0,0,0,0,322,19,0,0,0,0,0,0,0,0,0,100
1610d4acd1ff1f159a44bb93cd9a9eb76fad22d7,0,0,0,0,0,0,0,0,0,0,0,0,0,0,323,20,0,0,0,0,0,0,0,0,0,100
953939c2cfc52c0a3efa59b162ee8fae2d04777b,0,0,0,0,0,0,0,0,0,0,0,0,0,0,324,21,0,0,0,0,0,0,0,0,0,100
38cf82e3e24d5d70e08e2e3ecb7e943978746596,0,0,0,0,0,0,0,0,0,0,0,0,0,0,325,22,0,0,0,0,0,0,0,0,0,100
ecbb8e6449230a3ff95bc115084e9f2753542e81,0,0,0,0,0,0,0,0,0,0,0,0,0,0,326,23,0,0,0,0,0,0,0,0,0,100
cdfee1e797d92ace59fb1685c10a057c9b827353,0,0,0,0,0,0,0,0,0,0,0,0,0,0,327,24,0,0,0,0,0,0,0,0,0,100
20561b7c516617702213a292c8f64a8300c39ddd,0,0,0,0,0,0,0,0,0,0,0,0,0,0,328,25,0,0,0,0,0,0,0,0,0,100
5284719f344af0fd415c134c68f5807d13f63bee,0,0,0,0,0,0,0,0,0,0,0,0,0,0,329,26,0,0,0,0,0,0,0,0,0,100
4e1908a5eb4ae77bda7ae8f36f320d66eb4b3a65,0,0,0,0,0,0,0,0,0,0,0,0,0,0,330,27,0,0,0,0,0,0,0,0,0,100
db78b0c51d20479b58a808999d34eb4f9c49b299,0,0,0,0,0,0,0,0,0,0,0,0,0,0,331,28,0,0,0,0,0,0,0,0,0,100
fadd900bb63e11e0c5a38c630ef0c31ce63623b0,0,0,0,0,0,0,0,0,0,0,0,0,0,0,332,29,0,0,0,0,0,0,0,0,0,100
85eac5ecd4f325f0d83b107b64e79b3903dadced,0,0,0,0,0,0,0,0,0,0,0,0,0,0,333,30,0,0,0,0,0,0,0,0,0,100
15961fe3e73ca0f2193935b25f2f806e0b1a6eed,0,0,0,0,0,0,0,0,0,0,0,0,0,0,334,31,0,0,0,0,0,0,0,0,0,100
459667851e511ea8a3d71cccccd7f52af590d2a4,0,0,0,0,0,0,0,0,0,0,0,0,0,0,335,32,0,0,0,0,0,0,0,0,0,100
c08c11c17d97467b38022addd77dafe99ff65b99,8,111,152,41,0,0,0,2,20,610,5,7,2.284898757,4779,336,33,311,315,4,36330,36418,88,139,138,1,100
3d0e3b5a6c05a1da9a4af3925307497b8b9a2d5a,1,250,156,94,0,0,0,2,2,357,1,1,0,282,337,33,56,43,13,2536,2078,458,30,24,6,100
abde1c1fe8eee758cb42ba4a68a67133f98319f7,0,0,0,0,0,0,0,0,0,0,0,0,0,0,0,0,0,0,0,0,0,0,0,0,0,100
0ac46f34a14b6c89e497e551c8cb583fdf8dc832,2,21,11,10,0,0,0,6,18,438,1,1,0.69621226,463,12,4,96,95,1,3161,3097,64,33,33,0,100
24d3bf3a3fd6a56dd2dcf167b6193b60eeee1c02,1,12,0,12,0,0,0,2,3,11,1,1,0,349,338,33,56,56,0,2578,2536,42,30,30,0,100
2a127101a4a7ba3ae3f37039eb36403d5d46922e,12,591,62,529,3,0,3,7,35,234,5,10,2.994106135,1984,8,0,404,349,55,13023,10393,2630,293,269,24,93.67033604
51e4363596cebf8fc6ea90b3bfcaf162715dc1ec,0,0,0,0,0,0,0,0,0,0,0,0,0,0,1,1,0,0,0,0,0,0,0,0,0,100
da11a654118347ecf208aa7eeb13f323c06990cf,1,5,2,3,0,0,0,6,25,52,1,1,0,416,339,2,78,78,0,2959,2928,31,36,36,0,100
082cb1e14d757390e3fba73dbab04b904a8af187,0,0,0,0,0,0,0,0,0,0,0,0,0,0,340,3,0,0,0,0,0,0,0,0,0,100
027ac7401cdf4ce4b8e1cd377b33d5a35c3f3be0,2,3375,0,3375,2,0,2,1,1,0,1,2,0.999999937,0,341,4,410,0,410,15828,0,15828,186,0,186,99.93098689
a76f64bb71f6f408a1899a3732d2f617626d7d28,5,75,97,22,0,0,0,1,36,39,4,5,1.808756963,4082,342,5,744,744,0,25865,25877,12,446,446,0,100
77f0c515a9948b860668b6efea16d6879e166a78,0,0,0,0,0,0,0,0,0,0,0,0,0,0,343,6,0,0,0,0,0,0,0,0,0,100
e90beeaa4624129de936991284f3caa6f67ac652,2,78,5,73,1,0,1,1,4,317,1,2,0.834286742,45,14,0,12,6,6,603,195,408,7,3,4,99.9448352
a1d86ae0351954d553d1795f4da7313ebea7e46a,0,0,0,0,0,0,0,0,0,0,0,0,0,0,15,1,0,0,0,0,0,0,0,0,0,100
a4587b6a2ba3f03b6742fffb426c05bffc92b092,2,48,46,2,0,0,0,2,21,229,2,2,0.342463772,1043,16,2,121,116,5,8606,8520,86,71,71,0,100
471cf78a4258e56f55d1668bd4d8d8881c1329e9,0,0,0,0,0,0,0,0,0,0,0,0,0,0,344,5,0,0,0,0,0,0,0,0,0,100
61b8d35758a81e1d05ae011d701e4379c1cbe00b,0,0,0,0,0,0,0,0,0,0,0,0,0,0,345,6,0,0,0,0,0,0,0,0,0,100
30446bf80fefaa934d7f41d934208252cd9da53b,1,38,28,10,0,0,0,3,4,801,1,1,0,117,346,7,12,11,1,932,903,29,6,6,0,100
40485c5ac3edb492ffd2494d03f3a46f6eab23dd,0,0,0,0,0,0,0,0,0,0,0,0,0,0,0,0,0,0,0,0,0,0,0,0,0,100
512147f6fd4677baa8f8ffed6034fac256157337,0,0,0,0,0,0,0,0,0,0,0,0,0,0,1,1,0,0,0,0,0,0,0,0,0,100
ae44c17b93d97b35160369c45e7cf41d702bb12a,0,0,0,0,0,0,0,0,0,0,0,0,0,0,1,0,0,0,0,0,0,0,0,0,0,100
34723fd546e1c996904614fb35eb37ca740dd789,3,0,115,115,0,0,0,1,2,102,1,3,1.584853724,102,13,0,0,3,3,0,479,479,0,3,3,99.88957902
b10a852e9035048f67306f288d7efce935961775,3,78,39,39,1,0,1,1,2,68,1,1,1.484990561,83,14,1,7,4,3,728,458,270,4,3,1,99.95856354
f199443cf943d249ec775d9c0c85c091e23cc6e9,0,0,0,0,0,0,0,0,0,0,0,0,0,0,2,1,0,0,0,0,0,0,0,0,0,100
17dfaa68d3e1251f696592f96c4e8f1cfba84490,0,0,0,0,0,0,0,0,0,0,0,0,0,0,1,0,0,0,0,0,0,0,0,0,0,100
1b3e3dfc62cf5211238a4de5b5e241a3f0836c24,0,0,0,0,0,0,0,0,0,0,0,0,0,0,347,3,0,0,0,0,0,0,0,0,0,100
c38cf6c8826ae6b7edee028cf0aab96a2bfa6d01,0,0,0,0,0,0,0,0,0,0,0,0,0,0,348,4,0,0,0,0,0,0,0,0,0,100
6e8e47f09022b2ade9b399f1125983afb981ec3d,0,0,0,0,0,0,0,0,0,0,0,0,0,0,349,5,0,0,0,0,0,0,0,0,0,100
5fa3e03e816beca1b3bd1eecad143e15018ee81f,0,0,0,0,0,0,0,0,0,0,0,0,0,0,350,6,0,0,0,0,0,0,0,0,0,100
9fa268e09d032f42aaab88cf4100f04b66a2bd1c,0,0,0,0,0,0,0,0,0,0,0,0,0,0,351,7,0,0,0,0,0,0,0,0,0,100
13580cfa604876c94168bff4988561770f380a31,0,0,0,0,0,0,0,0,0,0,0,0,0,0,352,8,0,0,0,0,0,0,0,0,0,100
dcfdae0b9047dec5b977755ce47401961b318668,0,0,0,0,0,0,0,0,0,0,0,0,0,0,353,9,0,0,0,0,0,0,0,0,0,100
e561254e4d24e6e656d7a013b6aa2062e12c06f2,0,0,0,0,0,0,0,0,0,0,0,0,0,0,354,10,0,0,0,0,0,0,0,0,0,100
494435101a6a312acbb72434d0f7f623d5fde581,0,0,0,0,0,0,0,0,0,0,0,0,0,0,355,11,0,0,0,0,0,0,0,0,0,100
3be8d5d0642f957601f70ffd8180f0fd3fa64a49,29,1010,274,736,0,0,0,1,3,78,1,15,3.381257304,1820,15,2,289,155,134,13877,11367,2510,211,92,119,99.94474375
3a9dbea63cacc9105e183cb5bfdb5bb2075938aa,0,0,0,0,0,0,0,0,0,0,0,0,0,0,3,2,0,0,0,0,0,0,0,0,0,100
6b080d8fe298fdca33b3479c8a78e0d4ab8e82d0,0,0,0,0,0,0,0,0,0,0,0,0,0,0,0,0,0,0,0,0,0,0,0,0,0,100
8a2e6ae8570d8affecd7c0915e0402c4f57ba458,3,33,10,23,0,0,0,4,16,777,1,3,1.252900774,822,5,0,40,38,2,5780,5739,41,31,31,0,100
359f220d0ece4b79fadb53bdd378bdd5d3908224,2,76,0,76,1,0,1,1,4,2,1,2,0.949452015,704,16,3,97,91,6,5237,4950,287,77,72,5,99.94474375
d398c633ec676f5861ab6a035030193c299d15d1,0,0,0,0,0,0,0,0,0,0,0,0,0,0,356,12,0,0,0,0,0,0,0,0,0,100
862416727ea739805caf0505318bbdef87877d6d,0,0,0,0,0,0,0,0,0,0,0,0,0,0,357,13,0,0,0,0,0,0,0,0,0,100
d2ae683078160113d8e49c55059d5ce7012910e6,0,0,0,0,0,0,0,0,0,0,0,0,0,0,4,3,0,0,0,0,0,0,0,0,0,100
34d393743e6d0cb0da4219a7b0027b16433d5640,1,3,11,8,0,0,0,4,17,11,1,1,0,698,358,14,35,35,0,4721,4723,2,29,29,0,100
42610512b6422917fc7aef3580ac80ce0c84c273,0,0,0,0,0,0,0,0,0,0,0,0,0,0,5,4,0,0,0,0,0,0,0,0,0,100
096e717dd4550a93ad0531d4d4010375d899de65,4,157,33,124,2,0,2,1,5,7,1,2,1.87834858,825,17,4,112,106,6,6223,5672,551,90,84,6,99.93100593
c7328c9e44d353f3d6ac949cdb193650186cf7c4,2,44,40,4,0,0,0,3,9,683,1,2,0.276195428,314,359,12,53,52,1,1894,1858,36,33,32,1,100
232c42260313005502fff19d81cbe47f2b653848,0,0,0,0,0,0,0,0,0,0,0,0,0,0,0,0,0,0,0,0,0,0,0,0,0,100
eb6d3c5533bdc2b0b9d25fb47af961fdd2bc9051,0,0,0,0,0,0,0,0,0,0,0,0,0,0,6,4,0,0,0,0,0,0,0,0,0,100
0619f0ec0569752b240082cdc9c78e8d8b1262f2,0,0,0,0,0,0,0,0,0,0,0,0,0,0,360,13,0,0,0,0,0,0,0,0,0,100
55adc6a9cd59525f41159c5499ab214749887be9,8,362,442,80,2,0,2,1,32,425,2,3,2.700778467,1820,6,1,220,215,5,14755,15151,396,86,81,5,95.10751013
379b162d50e7364086fcc6953db2626a66ec33ba,0,0,0,0,0,0,0,0,0,0,0,0,0,0,7,4,0,0,0,0,0,0,0,0,0,100
880ced160966dca3979d11aa401552e834d8d460,2,8,13,5,0,0,0,2,10,365,2,1,0.918295834,254,361,5,22,22,0,1938,1939,1,15,15,0,100
970527abe846f2dc45388d950b9454fd69d6a755,3,145,0,145,3,0,3,1,1,0,1,1,1.577412268,0,0,0,13,0,13,444,0,444,9,0,9,99.8569129
4fde38686d907083469b0a231f4562586212e51f,0,0,0,0,0,0,0,0,0,0,0,0,0,0,362,6,0,0,0,0,0,0,0,0,0,100
81fe6fcb71b9d55d07fddbd34d126fe0d8ef9558,3,98,1,97,0,0,0,3,12,836,2,3,0.651607034,515,7,1,49,46,3,4444,3852,592,27,25,2,100
51d25c541f4ff47b6bf85d507477970518d415da,0,0,0,0,0,0,0,0,0,0,0,0,0,0,0,0,0,0,0,0,0,0,0,0,0,100
a102269496c895067f74c0bb25a90b52281e9740,3,49,1,48,2,0,2,3,6,143,2,1,1.197477624,68,0,0,12,11,1,534,487,47,2,1,1,99.92859693
cc27ffebf8b41895612526246f7c3189bcdf9e1f,0,0,0,0,0,0,0,0,0,0,0,0,0,0,17,0,0,0,0,0,0,0,0,0,0,100
8a8fe3b6d0ebf9671a1ccc065ccf12c86ca30c3c,1,9,5,4,0,0,0,3,8,519,1,1,0,287,18,1,25,24,1,2088,2071,17,17,16,1,100
9ae8d4e85c84ab6167a9c92d25006c46111babb3,2,85,14,71,0,0,0,6,21,434,1,2,0.503258335,1104,19,2,102,95,7,11144,10401,743,46,41,5,100
32c3f2d4b727697c26c6022dd6051b0a28d6f4df,3,25,4,21,0,0,0,4,9,323,1,3,1.130738017,442,363,0,21,19,2,3608,3451,157,15,14,1,100
a6197d16cf723a4d87e433ae805dbe36fca9e823,0,0,0,0,0,0,0,0,0,0,0,0,0,0,1,0,0,0,0,0,0,0,0,0,0,100
af2699b6087c710ec674db515b69a4c7705c05ab,0,0,0,0,0,0,0,0,0,0,0,0,0,0,1,0,0,0,0,0,0,0,0,0,0,100
fd7df3456565dd1a2dc421c84f81762f0e80e1b9,0,0,0,0,0,0,0,0,0,0,0,0,0,0,8,0,0,0,0,0,0,0,0,0,0,100
b1cc3a7e1737231777ca3d3fc5bd8168a51fe0cf,3,0,31,31,0,0,0,2,17,278,1,2,1.238278588,920,18,0,139,142,3,5675,5811,136,90,93,3,100
880217d79543e7e029db391e2acdfc868a06ab61,2,12,0,12,0,0,0,2,18,213,1,1,0.918295834,564,19,1,75,73,2,3987,3933,54,31,31,0,100
5d3acde92d6d82da15f32bf1289999b63f6d82dd,2,259,0,259,2,0,2,1,1,0,1,2,0.980024636,0,2,0,32,0,32,1370,0,1370,14,0,14,99.91088932
ea086a4f72aa0d62b0e2d840964361b584f41f8a,1,4,14,10,0,0,0,2,2,1,1,1,0,78,364,1,5,6,1,471,476,5,5,5,0,100
074a0354b815968a162790f09189ff47ca04e169,5,479,6,473,0,0,0,3,6,464,2,4,1.177970014,342,3,1,109,38,71,5005,2205,2800,57,17,40,100
36cdb97febfd0aa7d0dfbf4c8f9b165a7c7ee0aa,0,0,0,0,0,0,0,0,0,0,0,0,0,0,20,3,0,0,0,0,0,0,0,0,0,100
de014d3b47eef8c2576402b4a511fba4dc18426a,1,1,1,0,0,0,0,2,3,507,1,1,0,238,21,4,22,22,0,1696,1696,0,13,13,0,100
ebda495ce8bd52d63086f911f626f362be284c71,1,4,5,1,0,0,0,2,4,0,1,1,0,238,365,2,22,22,0,1691,1696,5,13,13,0,100
3897835372b0bbc2b7c70beb9842a660fbbb2031,0,0,0,0,0,0,0,0,0,0,0,0,0,0,8,0,0,0,0,0,0,0,0,0,0,100
51599721fe24bf5d980f42bb363896e10ad29017,0,0,0,0,0,0,0,0,0,0,0,0,0,0,22,4,0,0,0,0,0,0,0,0,0,100
b46c378a44885a7d1227413f50def739d5791a0e,0,0,0,0,0,0,0,0,0,0,0,0,0,0,23,5,0,0,0,0,0,0,0,0,0,100
1bf9d8ff5f73b93acc46ee693c27ee1db807a782,0,0,0,0,0,0,0,0,0,0,0,0,0,0,24,6,0,0,0,0,0,0,0,0,0,100
c149dbde4d976d48a7c244b24590f76886b36e10,0,0,0,0,0,0,0,0,0,0,0,0,0,0,25,7,0,0,0,0,0,0,0,0,0,100
5b3e9e40561c4fa031a06943d493126fcee6e948,0,0,0,0,0,0,0,0,0,0,0,0,0,0,26,8,0,0,0,0,0,0,0,0,0,100
6542076c9dff25b9dbf5e419e37eef0d4ad9a24c,0,0,0,0,0,0,0,0,0,0,0,0,0,0,27,9,0,0,0,0,0,0,0,0,0,100
5831155be864d58d75e178991d40da98c1e5a804,0,0,0,0,0,0,0,0,0,0,0,0,0,0,28,10,0,0,0,0,0,0,0,0,0,100
15ce5d6271d375993f86f7af7aaa14de6e66f7e0,0,0,0,0,0,0,0,0,0,0,0,0,0,0,29,11,0,0,0,0,0,0,0,0,0,100
9ab8e4466e197bc020c74e2af257ac9153631acd,0,0,0,0,0,0,0,0,0,0,0,0,0,0,30,12,0,0,0,0,0,0,0,0,0,100
d51771a115912d2ccfd10abb17d78f08771b6019,0,0,0,0,0,0,0,0,0,0,0,0,0,0,31,13,0,0,0,0,0,0,0,0,0,100
9b7e7aeb31ba15ee18fe03d450544016ea1dc4dd,0,0,0,0,0,0,0,0,0,0,0,0,0,0,32,14,0,0,0,0,0,0,0,0,0,100
24c364e3dc7a4763b657d1a605d82c6d74896ebf,0,0,0,0,0,0,0,0,0,0,0,0,0,0,33,15,0,0,0,0,0,0,0,0,0,100
9f0d0265c9e89b5dd70e533352cfd8fcaed4e3ce,0,0,0,0,0,0,0,0,0,0,0,0,0,0,34,16,0,0,0,0,0,0,0,0,0,100
48ae3bdbbf678196085a6f31c33f0e3ee5727908,0,0,0,0,0,0,0,0,0,0,0,0,0,0,35,17,0,0,0,0,0,0,0,0,0,100
62b7acf7c65d146b06bcd05ceaec256197b3799c,1,5,3,2,0,0,0,2,5,5,1,1,0,237,366,3,22,22,0,1713,1691,22,13,13,0,100
ac21cb65ae0f63664b63c4dbabd221bf0831f094,0,0,0,0,0,0,0,0,0,0,0,0,0,0,2,1,0,0,0,0,0,0,0,0,0,100
731d8ff13f8ae7f376e911b01bcedc1cc2af246c,0,0,0,0,0,0,0,0,0,0,0,0,0,0,9,1,0,0,0,0,0,0,0,0,0,100
e89aaaf9f86d5b4b32a1ee46dd77b57229b3fad5,0,0,0,0,0,0,0,0,0,0,0,0,0,0,10,1,0,0,0,0,0,0,0,0,0,100
8b1d79f930317b5f076d6dda4567d483d2948270,0,0,0,0,0,0,0,0,0,0,0,0,0,0,0,0,0,0,0,0,0,0,0,0,0,100
6422b540f38627a9bc3982ef99e09a9d3fce4327,2,322,18,304,0,0,0,2,4,44,1,2,0.978905524,559,4,0,137,98,39,5908,3981,1927,72,52,20,100
c636d5b5ee8056f534a68222cd4b967cd9600bda,0,0,0,0,0,0,0,0,0,0,0,0,0,0,36,14,0,0,0,0,0,0,0,0,0,100
51b9ab77960eeb1a65248ac2f602d7903765ac82,6,266,82,184,3,0,3,1,19,401,4,4,2.173654856,386,37,1,79,67,12,3546,2509,1037,30,15,15,99.83988614
854017d8a7f29fc7e85bd1e3c020b41752e793c1,2,95,0,95,1,0,1,2,6,82,1,2,0.815422498,778,0,0,108,99,9,5928,5444,484,87,79,8,99.9644634
836063568cee538b28e70565f0e10100340fc0bc,2,133,1,132,1,0,1,1,3,382,1,1,0.111909909,61,11,2,23,9,14,993,289,704,10,3,7,99.91123735
00c36e8c97ada0a006c87f9efe74c2917517e485,5,10,10,0,0,0,0,3,11,777,3,3,1.291760148,1564,367,0,68,68,0,12229,12210,19,35,35,0,100
d00f061ec03f01f65788b0cb2d8f89ffcf4bab28,0,0,0,0,0,0,0,0,0,0,0,0,0,0,0,0,0,0,0,0,0,0,0,0,0,100
61bdb989f3c42f38377dc26f96a3838c7e499ede,0,0,0,0,0,0,0,0,0,0,0,0,0,0,0,0,0,0,0,0,0,0,0,0,0,100
8e7e9d93bceb09fb77fe0bb77fdf01ab5ef6dbf7,12,816,669,147,9,0,9,1,6,6,1,3,2.716146082,883,38,2,141,140,1,6584,6282,302,70,73,3,99.52246197
5c2c7a727d8e88e47ce1d14cb803c9a9f4473c29,11,280,51,229,3,0,3,1,2,0,1,2,3.028981891,845,39,3,147,125,22,7143,5826,1317,76,62,14,99.78873239
739fc28284f50cf91ca7b527dc6560fd40b48f7e,0,0,0,0,0,0,0,0,0,0,0,0,0,0,368,1,0,0,0,0,0,0,0,0,0,100
b80ffff3bf3c9e4a1a9c31124409f90085b51cdc,0,0,0,0,0,0,0,0,0,0,0,0,0,0,369,2,0,0,0,0,0,0,0,0,0,100
290aa1d71bace192e15fb98d6be708e2b68c167f,0,0,0,0,0,0,0,0,0,0,0,0,0,0,370,3,0,0,0,0,0,0,0,0,0,100
ca56439da6552d109c23d854a95ab5e49fcae985,0,0,0,0,0,0,0,0,0,0,0,0,0,0,371,4,0,0,0,0,0,0,0,0,0,100
325c782ab9a95af00a4581e2a681b602f5befc9f,0,0,0,0,0,0,0,0,0,0,0,0,0,0,372,5,0,0,0,0,0,0,0,0,0,100
8a5ff6e72632578779ff4a91834390f44707c80c,0,0,0,0,0,0,0,0,0,0,0,0,0,0,373,6,0,0,0,0,0,0,0,0,0,100
ae424d287d39f5ea18754a6170f6dda2c0fd11e8,0,0,0,0,0,0,0,0,0,0,0,0,0,0,374,7,0,0,0,0,0,0,0,0,0,100
7864212e8278ee16adf7f0db6366de7ba9a929d1,0,0,0,0,0,0,0,0,0,0,0,0,0,0,375,8,0,0,0,0,0,0,0,0,0,100
978298b08c8883ac9c7d8e6bc8439b8e1c499fcc,0,0,0,0,0,0,0,0,0,0,0,0,0,0,376,9,0,0,0,0,0,0,0,0,0,100
176d5f463f3a1d7b4ce39335eabad4f44300a054,0,0,0,0,0,0,0,0,0,0,0,0,0,0,377,10,0,0,0,0,0,0,0,0,0,100
e002ee6a1d89480941d51efb81b745b86fb027ae,0,0,0,0,0,0,0,0,0,0,0,0,0,0,378,11,0,0,0,0,0,0,0,0,0,100
be050cf1d51e8f6174183ea8abafcc56581d79b2,0,0,0,0,0,0,0,0,0,0,0,0,0,0,379,12,0,0,0,0,0,0,0,0,0,100
390fb27b13c824a14b200ac729253758a6d92c21,0,0,0,0,0,0,0,0,0,0,0,0,0,0,380,13,0,0,0,0,0,0,0,0,0,100
7e594abfe2fa1c404b548676b3bf5143bda5cbeb,0,0,0,0,0,0,0,0,0,0,0,0,0,0,381,14,0,0,0,0,0,0,0,0,0,100
cb3a9044d46dcb7a522072ba4624fdfdb7d40ab7,0,0,0,0,0,0,0,0,0,0,0,0,0,0,382,15,0,0,0,0,0,0,0,0,0,100
91ed928add63f666669f8316948d0996e7212db5,0,0,0,0,0,0,0,0,0,0,0,0,0,0,383,16,0,0,0,0,0,0,0,0,0,100
432ec50ece0ce89b0e1af5962d07611d7820fc1d,0,0,0,0,0,0,0,0,0,0,0,0,0,0,384,17,0,0,0,0,0,0,0,0,0,100
40e0de200a195411cd77597d5916a38e28bd2ff9,0,0,0,0,0,0,0,0,0,0,0,0,0,0,385,18,0,0,0,0,0,0,0,0,0,100
39880dacbbf3933a989574695e6403c743a609b1,2,59,32,27,0,0,0,1,3,240,1,2,0.619382195,2498,386,19,414,410,4,15972,15828,144,188,186,2,100
47d247cfa01c2622d135539af958e109514b86e5,0,0,0,0,0,0,0,0,0,0,0,0,0,0,387,20,0,0,0,0,0,0,0,0,0,100
a3d8d796b7e8526b03887d599633cfe59304b328,0,0,0,0,0,0,0,0,0,0,0,0,0,0,388,21,0,0,0,0,0,0,0,0,0,100
34f2aa0917c7453d27d66c0389eaa43670c2c6fb,2,22,1,21,0,0,0,2,3,8,1,2,0.987692509,393,0,0,48,46,2,3409,3234,175,34,33,1,100
951853b26a38b45f4277a4ab9ccd4d18af368ee2,2,98,9,89,0,0,0,2,3,10,1,2,0.733002265,139,1,1,27,17,10,2142,932,1210,18,10,8,100
579b43fb1ccb29a420c21fca1895b8d166b727cd,4,22,4,18,0,0,0,2,4,2,1,2,1.634695839,493,2,2,48,44,4,4794,4629,165,34,32,2,100
431dcd24918fd8c6b4b60c30fd287061670f805b,6,585,341,244,3,0,3,1,15,330,1,2,1.940312783,514,0,0,54,34,20,4497,3527,970,32,18,14,99.80688202
2aa16efd71bd6dd9fd886ca1772ee3dd612da276,1,4,4,0,0,0,0,3,4,0,1,1,0,125,389,22,10,10,0,1738,1740,2,9,9,0,100
b98e77ee906dc9c6326b7d8703870faf523694ae,4,102,28,74,0,0,0,2,12,756,2,3,1.668554699,604,40,3,85,68,17,5464,4689,775,42,36,6,100
9258e3d2b7710bcd59de7d03320c6907dc5cc5b9,1,2,1,1,0,0,0,4,13,6,1,1,0,183,390,23,21,21,0,1299,1299,0,7,7,0,100
84c8287e1152aa347505ef6d0d92736c69072898,1,1,2,1,0,0,0,3,7,89,1,1,0,76,391,24,8,8,0,440,430,10,4,4,0,100
adc250c3bb6898efe162292d9c38331f93ed7c42,0,0,0,0,0,0,0,0,0,0,0,0,0,0,392,25,0,0,0,0,0,0,0,0,0,100
b5c6486db72030d269f75974bd282b3eec55549d,16,847,68,779,6,0,6,1,8,15,2,3,3.597247209,962,41,3,220,130,90,10465,6356,4109,136,73,63,99.75511632
f7acac99b10064f6f992f3352d2446d6661fe373,1,9,15,6,0,0,0,5,10,209,1,1,0,161,2,0,34,36,2,830,883,53,18,18,0,100
2cf99f412b7555e6d799e5994db8c6404ce029d4,0,0,0,0,0,0,0,0,0,0,0,0,0,0,393,4,0,0,0,0,0,0,0,0,0,100
e305987524273dfc1a4cac23004f8017b652e838,0,0,0,0,0,0,0,0,0,0,0,0,0,0,394,5,0,0,0,0,0,0,0,0,0,100
e8e7cbd03616e1a4ab7aa4c5bcf5632c57ed815d,1,19,23,4,0,0,0,4,15,450,1,1,0,266,395,6,57,57,0,2255,2266,11,17,17,0,100
04f5d86a0caa466755d287827e2b783f5896099f,2,327,2,325,0,0,0,2,6,22,1,2,0.994388066,479,3,0,95,60,35,6568,4033,2535,67,46,21,100
f58a46da9272c8d3b4f863864346d1f072cf59d8,0,0,0,0,0,0,0,0,0,0,0,0,0,0,396,3,0,0,0,0,0,0,0,0,0,100
05333e8d096c400fa2bc8839fa4ce96f5ab7d92d,1,12,12,0,0,0,0,2,6,6,1,1,0,294,4,1,70,70,0,1971,1971,0,45,45,0,100
45043b488624c85cc16b518d674b7513323a29a1,11,76,83,7,0,0,0,2,7,18,1,2,3.342455112,1463,42,1,210,209,1,11110,11110,0,132,131,1,100
ae65dd89b0a18b10db4ec6c250d82704137f2638,2,42,25,17,0,0,0,2,8,8,1,2,0.709825885,704,5,2,98,95,3,6681,6554,127,67,67,0,100
e21ce87dd2c91fcb56bd8dfe08fba410f604790d,0,0,0,0,0,0,0,0,0,0,0,0,0,0,397,4,0,0,0,0,0,0,0,0,0,100
db8cc2347070ce5956ad6e881224c285f825acb6,15,1367,17,1350,5,0,5,1,22,426,4,9,2.935918768,2071,20,0,323,162,161,23354,17090,6264,175,68,107,91.36416377
f3eddab9b854f1774ecf89ac39ec03566e296113,28,293,1497,1204,2,0,2,0,21,56,6,13,3.769002226,4515,5,0,384,536,152,29038,34591,5553,208,307,99,91.28850613
15a85c0d1a8ebe96616dfdf204b3b62bf793814e,26,1497,137,1360,5,0,5,1,22,249,5,11,3.567093557,3534,6,1,536,371,165,34591,28200,6391,307,199,108,91.37845441
245b9166b81d1f299072b40f7e789bf77ce883b3,0,0,0,0,0,0,0,0,0,0,0,0,0,0,7,2,0,0,0,0,0,0,0,0,0,100
9e55444e03b07d6b3f717f4ce09930b1314cfe93,63,1031,100,931,10,0,10,1,33,148,7,18,3.941505034,5568,43,1,893,620,273,43653,30248,13405,399,205,194,90.05736138
1bdbdee67be13cc3b83605350536ffc246fb722e,5,90,36,54,0,0,0,6,24,133,2,3,1.888134368,1528,44,2,181,175,6,13404,12855,549,88,85,3,100
b3923f29ddfee3b10ed99097480aefacb3878f04,3,300,32,268,0,0,0,3,22,746,1,2,0.636924193,1058,398,2,107,104,3,10097,8793,1304,64,64,0,100
7f27b565bd6d38c490d0a59a60b63c23fe892188,1,1,1,0,0,0,0,2,2,15,1,1,0,171,399,3,37,37,0,981,981,0,24,24,0,100
9305dca16a9d6b80cd16677f087fc6fba6d4fff6,0,0,0,0,0,0,0,0,0,0,0,0,0,0,0,0,0,0,0,0,0,0,0,0,0,100
d99f1e50e07ce2910efdf8d681b17ad86623115e,0,0,0,0,0,0,0,0,0,0,0,0,0,0,45,2,0,0,0,0,0,0,0,0,0,100
8bc8991a83fe959a815e1fcbc801e1cc5576578e,2,14,2,12,0,0,0,2,9,40,1,2,0.954434003,487,6,1,37,36,1,5158,5035,123,29,28,1,100
9175fbdc47cb1c61dee4704e0c13f361805f8232,0,0,0,0,0,0,0,0,0,0,0,0,0,0,400,3,0,0,0,0,0,0,0,0,0,100
1c662380e808cfcf564ea993390ef1088ca5b14e,0,0,0,0,0,0,0,0,0,0,0,0,0,0,401,4,0,0,0,0,0,0,0,0,0,100
b29066aa0b034c43294dcf2637a575a6af8cd151,0,0,0,0,0,0,0,0,0,0,0,0,0,0,402,5,0,0,0,0,0,0,0,0,0,100
e8b4643730759dc79a151ce2dce18faa77c2c8d6,0,0,0,0,0,0,0,0,0,0,0,0,0,0,403,6,0,0,0,0,0,0,0,0,0,100
c479a6017865bba203a4e547ca2b3be31ad85b4a,0,0,0,0,0,0,0,0,0,0,0,0,0,0,404,7,0,0,0,0,0,0,0,0,0,100
facbe5523e0f1a7fc2894e0acef4b6c72b81f00c,0,0,0,0,0,0,0,0,0,0,0,0,0,0,405,8,0,0,0,0,0,0,0,0,0,100
6f9ee509458179bd3d9ee8b9bb9202f456d52d49,0,0,0,0,0,0,0,0,0,0,0,0,0,0,406,9,0,0,0,0,0,0,0,0,0,100
7ea965492198beb6ba778ef3d9198c6887eecdf1,0,0,0,0,0,0,0,0,0,0,0,0,0,0,407,10,0,0,0,0,0,0,0,0,0,100
48d6c4aff9693ae0616298a9a5bfa7ad19d39a05,0,0,0,0,0,0,0,0,0,0,0,0,0,0,408,11,0,0,0,0,0,0,0,0,0,100
a3b92f90d5147bb2b06d9f869dffc190bc59d9cf,0,0,0,0,0,0,0,0,0,0,0,0,0,0,409,12,0,0,0,0,0,0,0,0,0,100
ea24d43f9a8102f331eeffec628a741d2f30426f,0,0,0,0,0,0,0,0,0,0,0,0,0,0,410,13,0,0,0,0,0,0,0,0,0,100
0752fb9600a78f00fbe1daf1ee5e640a1b1c7eb2,0,0,0,0,0,0,0,0,0,0,0,0,0,0,411,14,0,0,0,0,0,0,0,0,0,100
b3b1c2eca3a731be9131493cef2d614695a34f67,0,0,0,0,0,0,0,0,0,0,0,0,0,0,412,15,0,0,0,0,0,0,0,0,0,100
7fb9db195f696b4dac7d7abb4171b402ee84f4e3,0,0,0,0,0,0,0,0,0,0,0,0,0,0,413,16,0,0,0,0,0,0,0,0,0,100
e442d610b772b379539a26e3e22974f1f15980a3,0,0,0,0,0,0,0,0,0,0,0,0,0,0,414,17,0,0,0,0,0,0,0,0,0,100
c5a360712aad282269d2fd1ef9d0ea9a49a5451c,0,0,0,0,0,0,0,0,0,0,0,0,0,0,415,18,0,0,0,0,0,0,0,0,0,100
4fa8b6eeba29937a94e66abf71c993b97fd77aa1,0,0,0,0,0,0,0,0,0,0,0,0,0,0,416,19,0,0,0,0,0,0,0,0,0,100
1d29c0b178fdc05a17a873b60f954a58f839a3f4,0,0,0,0,0,0,0,0,0,0,0,0,0,0,417,20,0,0,0,0,0,0,0,0,0,100
ff638cb6db57caed4e7130df316b403001437152,0,0,0,0,0,0,0,0,0,0,0,0,0,0,0,0,0,0,0,0,0,0,0,0,0,100
d9a3eb9307e91ef1b40d72fed9f22511fe4b1646,4,124,4,120,0,0,0,3,21,663,3,4,1.595799104,4336,418,20,286,282,4,34661,33915,746,128,125,3,100
855f12ea2c7343ae0ef5a72cbb22a7a973ffbbd8,6,240,52,188,0,0,0,2,19,34,3,5,2.141986437,1575,131,0,216,200,16,13011,12171,840,134,121,13,100
0367fe8e05f0ab920fd17dc43703506cb81f97c7,0,0,0,0,0,0,0,0,0,0,0,0,0,0,419,21,0,0,0,0,0,0,0,0,0,100
89bae580c9757bd9cb2821b95c6a07f482b8a340,7,350,4,346,4,0,4,2,5,245,1,3,2.343556036,123,132,1,53,13,40,1955,500,1455,38,9,29,99.78719288
5d6ed0f1090404664e82eee48d5949846b85df0a,0,0,0,0,0,0,0,0,0,0,0,0,0,0,46,3,0,0,0,0,0,0,0,0,0,100
7cb0d1bd50962b9798a6ed0ae655f45b83d3bb23,0,0,0,0,0,0,0,0,0,0,0,0,0,0,420,22,0,0,0,0,0,0,0,0,0,100
94d91e9d3362d373a17f3acf7880a54cc96becb3,0,0,0,0,0,0,0,0,0,0,0,0,0,0,421,23,0,0,0,0,0,0,0,0,0,100
5625b14d53528f623ac96aa7ed951c2ba4cb20ef,0,0,0,0,0,0,0,0,0,0,0,0,0,0,422,24,0,0,0,0,0,0,0,0,0,100
7dc3a7a64d12078eedaaf02433cf3e8552139157,0,0,0,0,0,0,0,0,0,0,0,0,0,0,423,25,0,0,0,0,0,0,0,0,0,100
bf5e0ad35497cb6be26fdb6866044a320bbe10f3,0,0,0,0,0,0,0,0,0,0,0,0,0,0,424,26,0,0,0,0,0,0,0,0,0,100
093e16b02fc324f50470d81d2cc46b1724ed2aa7,0,0,0,0,0,0,0,0,0,0,0,0,0,0,425,27,0,0,0,0,0,0,0,0,0,100
c9838fcccfde1ee309bef02bc871675bacfad35c,0,0,0,0,0,0,0,0,0,0,0,0,0,0,426,28,0,0,0,0,0,0,0,0,0,100
ddc8011bbb9d1d6e9f5aa0b1537edb8eaf831a87,1,16,3,13,0,0,0,6,7,132,1,1,0,63,47,3,6,3,3,499,389,110,1,1,0,100
7ff6a927e792ae32e24b3c6a10688aba598812e3,0,0,0,0,0,0,0,0,0,0,0,0,0,0,427,29,0,0,0,0,0,0,0,0,0,100
426054cc93ccf3d9df1f05280fd23154139a117b,0,0,0,0,0,0,0,0,0,0,0,0,0,0,428,30,0,0,0,0,0,0,0,0,0,100
896f0f16ae0229d7983c71ede2310af426675a4b,0,0,0,0,0,0,0,0,0,0,0,0,0,0,429,31,0,0,0,0,0,0,0,0,0,100
2eb4bab063db05325da3ed2fb09d01cd8daebda1,0,0,0,0,0,0,0,0,0,0,0,0,0,0,430,32,0,0,0,0,0,0,0,0,0,100
4179fee8f6567fa66478be3fa7556937fe090cf3,0,0,0,0,0,0,0,0,0,0,0,0,0,0,431,33,0,0,0,0,0,0,0,0,0,100
84ae9b499bfc852f252ce6e9bc00af453fa26f77,0,0,0,0,0,0,0,0,0,0,0,0,0,0,432,34,0,0,0,0,0,0,0,0,0,100
5c7a9ebff9faae614c78e1d7d0b244b77692b836,1,1,1,0,0,0,0,2,6,198,1,1,0,239,433,35,22,22,0,1713,1713,0,13,13,0,100
0defc4fdd187884240f02dc3a49a15706c88b2a5,0,0,0,0,0,0,0,0,0,0,0,0,0,0,434,36,0,0,0,0,0,0,0,0,0,100
3a28598ead96b637a7057948294595f3b99ee60d,0,0,0,0,0,0,0,0,0,0,0,0,0,0,435,37,0,0,0,0,0,0,0,0,0,100
247eb8657c369c8a5d7a3fb8ca46f0a3d53c19d1,0,0,0,0,0,0,0,0,0,0,0,0,0,0,436,38,0,0,0,0,0,0,0,0,0,100
53a106c27c1188895bdd66be61d5322a9fbf6751,2,60,7,53,1,0,1,1,12,384,1,2,0.767190321,320,48,4,48,44,4,2443,2227,216,23,20,3,99.96138996
6f7d633b1bfc62fdd6f2203348d65afebbf6771a,10,10,10,0,0,0,0,3,12,567,4,4,3.321928095,2082,437,39,109,109,0,15382,15382,0,69,69,0,100
2b6cee2d9081628348e0925a9e7e7b596292eee3,54,208,301,93,0,0,0,3,34,551,20,33,5.03556977,13500,438,38,2449,2470,21,94832,95272,440,992,994,2,99.96140486
af68e28bc211fc819137587dd112e4d46b5148dc,5,101,9,92,2,0,2,1,14,48,2,4,1.813863057,638,49,4,89,84,5,5633,5385,248,46,41,5,99.90360517
62d2bf9adb8d0894f039ee6dbf2d55bbaa596a6a,5,23,25,2,0,0,0,1,11,755,5,4,1.874550388,963,439,39,64,64,0,7846,7815,31,43,43,0,100
a3e450ea0ec282cb1ad41c6314b1e6bfce3c4dc5,0,0,0,0,0,0,0,0,0,0,0,0,0,0,440,40,0,0,0,0,0,0,0,0,0,100
584f210a5e67ec9fd9c4c3758b524081c475083b,1,7,14,7,0,0,0,2,2,0,1,1,0,29,441,41,3,3,0,99,100,1,3,3,0,100
14ac2900373e641423bf91cfb5d2faf00bed1e52,13,56,55,1,0,0,0,4,35,592,9,12,2.421026189,9149,442,42,938,938,0,71040,70905,135,435,435,0,100
96587a4ed89ce6691198a0df8a96a9c81ddb875f,13,263,20,243,1,0,1,8,37,407,3,5,2.24845607,3086,1,0,464,444,20,18935,17821,1114,327,317,10,99.82635539
b144016b629be5fd4c526e25e5d40d2c4265c761,1,1,1,0,0,0,0,4,9,2,1,1,0,259,443,43,37,37,0,1395,1396,1,11,11,0,100
acfbc344bda8aa5b880c98d739b8217ec33ac1ef,32,172,463,291,0,0,0,2,27,1148,6,18,4.235435385,1485,444,44,57,126,69,3905,5545,1640,54,123,69,94.05813098
d2ee1efedfa093f704e476bc6ac65bf22bae7dcc,8,30,100,70,0,0,0,2,16,601,4,5,2.612453381,1168,445,45,170,181,11,7336,7732,396,81,83,2,99.92979993
9b244d7b4101f386bb71bc4244c77e37d0dfb0b5,11,35,45,10,0,0,0,3,34,705,9,10,2.756286772,2681,446,46,475,474,1,18641,18570,71,192,192,0,100
40f699fa3acebf8671aa4050418c00261d39c5b3,2,21,19,2,0,0,0,5,18,844,2,2,0.669015835,791,447,30,155,155,0,5667,5647,20,34,34,0,100
90559a40c2c5f412bcc1ad1825e48aff89a6929a,2,11,8,3,0,0,0,2,8,520,2,2,0.831474388,162,448,31,16,16,0,963,924,39,9,9,0,100
029c9b8d64605dd3d09ea22b0d2b7e6818f05300,2,14,12,2,0,0,0,2,4,396,1,2,0.89049164,577,133,2,69,69,0,3635,3582,53,34,34,0,100
9c69c8c08f19bce87e71c09b86c77603bbb94f6f,9,345,66,279,3,0,3,4,35,358,4,8,2.698887079,1733,50,4,327,299,28,14743,13562,1181,132,118,14,99.87730061
16dd645efeb6a51f840858339430c438490593df,5,8,37,29,0,0,0,4,32,157,4,5,1.724407081,3042,449,29,582,586,4,19973,20194,221,192,192,0,100
c9cb1702588c3e309ed0c03235718bcedb9c1ee9,6,238,12,226,1,0,1,1,10,595,1,2,1.693945896,597,2,1,79,64,15,3969,3105,864,37,27,10,99.82508309
ef4fd73ca73630721ee9e2790c9104bbccdf85e0,0,0,0,0,0,0,0,0,0,0,0,0,0,0,1,0,0,0,0,0,0,0,0,0,0,100
b54f7f3c7a69e0ecb56587045e5d863d06e99372,3,231,85,146,1,0,1,1,11,463,1,2,1.474298627,194,450,13,36,27,9,2351,1173,1178,17,9,8,93.33556597
048d62057b7c58a7da1255c68fb8b6578622f7fd,1,2,1,1,0,0,0,1,3,1294,1,1,0,36,451,2,2,2,0,154,145,9,2,2,0,100
61ecb34d28c318a5620b6ede7c13aecf71634c17,0,0,0,0,0,0,0,0,0,0,0,0,0,0,0,0,0,0,0,0,0,0,0,0,0,100
1436feddff5a40c2ed51912e046c80ada1f6a0f9,0,0,0,0,0,0,0,0,0,0,0,0,0,0,452,3,0,0,0,0,0,0,0,0,0,100
3b495a1d5b659fc4e53fbc28933d4bab02d48ab9,7,638,0,638,7,0,7,1,1,0,1,2,2.423558609,0,134,0,60,0,60,2907,0,2907,38,0,38,99.74350753
ebbf8d6bcba267c956ea469111ca443afddf77b6,2,47,34,13,0,0,0,4,17,1095,1,2,0.994605981,286,453,4,43,41,2,1953,1829,124,21,20,1,100
6b1898f274b0e8e35b5322cd8900bf8737112d24,12,568,1,567,7,0,7,1,2,0,1,2,3.051319335,275,135,1,91,33,58,3716,1286,2430,59,25,34,99.72916999
bd24b537b722b98b7dec7ec00b5af7d795ae196b,2,62,4,58,0,0,0,3,11,52,1,2,0.823066079,563,8,0,56,46,10,5941,5720,221,39,33,6,100
586207f780590eb112a0f6ca9050bfa91ba49577,2,106,11,95,1,0,1,1,2,262,1,2,0.793901359,57,136,2,15,7,8,679,322,357,7,4,3,99.93653816
4be5227269695efc862d2876e65f10dc18c40c33,2,71,22,49,0,0,0,2,26,616,1,2,0.938315352,876,51,0,101,98,3,7150,6870,280,58,53,5,100
1071c1dbf8a7ee31d49e2dada17da20c2b14c316,13,447,23,424,7,0,7,1,3,214,1,6,3.163274957,398,137,3,81,59,22,3771,2031,1740,54,42,12,99.65217391
13d386698fe8e516676c192b603deda5aae08d0d,3,87,15,72,1,0,1,1,16,621,1,2,1.24682952,613,52,1,119,110,9,4234,4013,221,62,53,9,99.21457744
aff3a9dc4b163aa43d5e1e39ff32622eea43ee92,2,40,3,37,0,0,0,1,2,0,1,2,0.968164732,132,138,4,10,7,3,1005,797,208,6,5,1,100
73bd80f9a2b037946a7269d6a46551378c96f3de,2,93,0,93,1,0,1,3,7,127,1,2,0.823811633,798,139,4,109,101,8,6062,5611,451,88,81,7,99.9687011
eac453ecc8f986dd852fc08a65aa2d0b3c08437f,3,412,414,2,0,0,0,3,5,94,1,2,0.358634035,787,53,2,80,74,6,5656,5183,473,38,37,1,100
3b28f4f5e89c865d948198d1f3df77bae81d18df,23,327,159,168,2,0,2,3,8,275,1,16,3.38725337,2047,140,5,250,253,3,13082,12301,781,199,196,3,99.90619137
88d57269d9118eaa364cde0044bb0545d8e69619,3,19,6,13,0,0,0,3,9,0,1,2,1.217796812,1004,141,6,128,127,1,7120,7067,53,98,97,1,99.92188721
8cc1d5bf3be8e7bb7395df00834cbccc29e69b01,1,1,1,0,0,0,0,9,38,106,1,1,0,864,142,7,182,182,0,5396,5396,0,117,117,0,100
eac277811863f7b41b6d9c8a312f299c3862fca8,5,126,17,109,0,0,0,3,12,75,1,2,1.96830796,1027,54,3,157,143,14,9466,8482,984,101,94,7,99.98437988
56ab602d8f0e9ec92bfa083cc14badce8169468c,2,63,8,55,0,0,0,4,27,602,1,2,0.838007851,1071,55,4,161,159,2,9806,9251,555,22,21,1,100
1b019617d408312ac33bf8f07f0ec862f7b33382,9,191,98,93,2,0,2,1,17,417,4,8,2.577543007,884,454,0,107,106,1,6772,6274,498,39,36,3,98.44559585
6aab5dec949d0f053c822e9c51a7faf167d60cfd,2,101,0,101,1,0,1,3,10,3,1,2,0.930935072,909,143,7,125,115,10,7105,6602,503,97,89,8,99.9718706
fc0a00213dac11cf0e37dcad9e22615b7503d075,0,0,0,0,0,0,0,0,0,0,0,0,0,0,0,0,0,0,0,0,0,0,0,0,0,100
4a47303b6fef73f7efd10015f2354b5d3b983a6d,1,9,1,8,0,0,0,5,14,150,1,1,0,321,7,0,47,45,2,2283,2238,45,20,20,0,100
a65831960a528f43b46221610365fe2baa8ab33e,7,92,13,79,0,0,0,3,23,493,5,6,2.260019582,3246,0,0,296,284,12,28392,27857,535,185,181,4,100
cdcb1860b1e7b3dde83e469fe400a5a3aecd16df,4,126,6,120,1,0,1,5,36,148,2,2,1.292097983,1563,56,0,193,182,11,14390,13755,635,70,63,7,93.64622827
cc235fd1de6dbd09f9a4967736db9974a5136366,0,0,0,0,0,0,0,0,0,0,0,0,0,0,455,0,0,0,0,0,0,0,0,0,0,100
b94872cf1cf18ca906c31d0e58d051726c2b2a8b,3,247,0,247,2,0,2,4,11,20,1,2,1.580232166,936,12,0,141,119,22,7925,6801,1124,108,92,16,99.95115995
64025c58fa5c7c47c296e9ae902342b809db10f1,1,1,1,0,0,0,0,2,2,240,1,1,0,68,456,1,0,0,0,724,724,0,0,0,0,100
bf12bc05cae4e977160a7662b19290d68a870609,0,0,0,0,0,0,0,0,0,0,0,0,0,0,457,2,0,0,0,0,0,0,0,0,0,100
21f7c42f9fa078ddd069e9b10935a267448cd2c1,0,0,0,0,0,0,0,0,0,0,0,0,0,0,458,3,0,0,0,0,0,0,0,0,0,100
381ec452b8a9e88cddcd8cbb70daa3f3ee03a72a,0,0,0,0,0,0,0,0,0,0,0,0,0,0,459,4,0,0,0,0,0,0,0,0,0,100
0ea79e4b2c1aa48012904b52ba3d4ca1d18d5554,0,0,0,0,0,0,0,0,0,0,0,0,0,0,460,5,0,0,0,0,0,0,0,0,0,100
d672acd7b3469ed3df36b08fbbd5cda90a29de94,0,0,0,0,0,0,0,0,0,0,0,0,0,0,461,6,0,0,0,0,0,0,0,0,0,100
4d845a845f47f81499468f6259bfe3f343fd8a5a,0,0,0,0,0,0,0,0,0,0,0,0,0,0,462,7,0,0,0,0,0,0,0,0,0,100
2f79624cba2de565d028dbd1f4964139be9b8be3,0,0,0,0,0,0,0,0,0,0,0,0,0,0,463,8,0,0,0,0,0,0,0,0,0,100
f316a9e329dd69165491efc2c9270f282fd64275,0,0,0,0,0,0,0,0,0,0,0,0,0,0,464,9,0,0,0,0,0,0,0,0,0,100
1be1317ad8b80da9b2ffb9c0b6e67bf4868e4554,0,0,0,0,0,0,0,0,0,0,0,0,0,0,465,10,0,0,0,0,0,0,0,0,0,100
4ba641a36624ff05bf6281fd47c04b1c37efd8d8,0,0,0,0,0,0,0,0,0,0,0,0,0,0,466,11,0,0,0,0,0,0,0,0,0,100
ad4fee151bb6c3bb1ea5910215818050613c0cb5,0,0,0,0,0,0,0,0,0,0,0,0,0,0,467,12,0,0,0,0,0,0,0,0,0,100
8870654143d04c5b0f6c7ebe28f74f5deba3864a,0,0,0,0,0,0,0,0,0,0,0,0,0,0,468,13,0,0,0,0,0,0,0,0,0,100
5c7a2c510d22df016739bdb716897d720069a500,0,0,0,0,0,0,0,0,0,0,0,0,0,0,469,14,0,0,0,0,0,0,0,0,0,100
cd43e30e96e483abaa6b4ca45d0047e42036818b,0,0,0,0,0,0,0,0,0,0,0,0,0,0,470,15,0,0,0,0,0,0,0,0,0,100
a0822d7af817d26105766a4deb436fbb78d6b762,0,0,0,0,0,0,0,0,0,0,0,0,0,0,471,16,0,0,0,0,0,0,0,0,0,100
b0125053609b6e0234bcf37bce3b474fbd6db6a7,0,0,0,0,0,0,0,0,0,0,0,0,0,0,472,17,0,0,0,0,0,0,0,0,0,100
f62131afd4e09be1d9f87a329900ee6d1a7c4725,0,0,0,0,0,0,0,0,0,0,0,0,0,0,473,18,0,0,0,0,0,0,0,0,0,100
b58a0a8b41833cd9752931ca7fa94485b9310926,0,0,0,0,0,0,0,0,0,0,0,0,0,0,474,19,0,0,0,0,0,0,0,0,0,100
7f2c9814f2531ff5935fd75051b98ea839db26c0,0,0,0,0,0,0,0,0,0,0,0,0,0,0,475,20,0,0,0,0,0,0,0,0,0,100
a304c44a6e287a21ab0940f3cef8204c8bf837b0,0,0,0,0,0,0,0,0,0,0,0,0,0,0,476,21,0,0,0,0,0,0,0,0,0,100
9cc0fa97e72941023065148883aa9098ece58e71,1,10,9,1,0,0,0,2,8,186,1,1,0,238,477,22,22,22,0,1744,1744,0,13,13,0,100
2b7f7712b8f2777b9944d218067b86e3800c37b0,0,0,0,0,0,0,0,0,0,0,0,0,0,0,478,23,0,0,0,0,0,0,0,0,0,100
56726b4f58b8ca96c7756f5b08eab52a28facc86,20,772,197,575,5,0,5,1,39,145,6,9,2.846833342,5185,57,1,895,674,221,38109,31687,6422,448,367,81,99.53698063
7e9a79dd85de235841ada1e7bee986d9a8c9631a,15,1065,16,1049,10,0,10,3,22,39,1,5,3.414926967,1557,9,0,359,216,143,17932,12644,5288,179,120,59,99.66015293
22b61f1068337588f884127eed3aefbd12344645,1,21,29,8,0,0,0,6,23,0,1,1,0,620,479,24,89,89,0,4460,4498,38,40,40,0,100
69b08afa9080c58ea83ee331f1e6e6b3c4be1392,13,399,44,355,4,0,4,1,40,0,5,7,3.045880574,3169,58,2,622,587,35,21617,19784,1833,381,361,20,99.85479187
36ee8abe2e69bc69f04d26abfe377e0f9fa06b2e,6,267,11,256,1,0,1,1,24,15,1,3,1.289228851,1281,10,1,237,194,43,10494,9113,1381,92,78,14,99.91537718
89ae00a9ee35eeef4a22ae1f4348ab1bb54d511a,2,11,6,5,0,0,0,1,16,0,1,2,0.997502546,530,11,2,86,86,0,3591,3551,40,33,33,0,100
5bea67f7d6fbab6cf5ec6e658c46dfbe3fa222d5,3,45,1,44,0,0,0,1,3,12,1,3,1.565340216,386,59,2,59,52,7,3248,2941,307,28,24,4,100
0325d071216d0bbe30121af424e107c124719014,9,187,77,110,0,0,0,5,39,7,3,5,2.61523925,1785,60,3,288,268,20,14600,13839,761,110,101,9,99.95166163
03e818d776f82f957c7b9f03916066ef7f7c1d24,1,1,1,0,0,0,0,6,25,5,1,1,0,623,480,25,91,91,0,4537,4537,0,41,41,0,100
51797e33bb08570318b59bb8b9740485c83e2e9a,0,0,0,0,0,0,0,0,0,0,0,0,0,0,481,25,0,0,0,0,0,0,0,0,0,100
3ac8f38c18ac817d3982205c590d48f0986b11a9,0,0,0,0,0,0,0,0,0,0,0,0,0,0,482,26,0,0,0,0,0,0,0,0,0,100
18139373b00db8ef6f9100a38f8454cab470783c,0,0,0,0,0,0,0,0,0,0,0,0,0,0,483,27,0,0,0,0,0,0,0,0,0,100
9e2b7a983f17ed543e8ee0093efaa6b97c3f589f,0,0,0,0,0,0,0,0,0,0,0,0,0,0,484,28,0,0,0,0,0,0,0,0,0,100
5142a9250927676e43239ed2cf895b4c0830ab3d,0,0,0,0,0,0,0,0,0,0,0,0,0,0,485,29,0,0,0,0,0,0,0,0,0,100
e5252e33444f9376959105f62fc46217ae255972,0,0,0,0,0,0,0,0,0,0,0,0,0,0,486,30,0,0,0,0,0,0,0,0,0,100
e057c3c673003d2d04a5f56cd8fabd5258520fb9,0,0,0,0,0,0,0,0,0,0,0,0,0,0,487,31,0,0,0,0,0,0,0,0,0,100
3282d8950d84b1bc96deb86893b8f75903e38dbf,0,0,0,0,0,0,0,0,0,0,0,0,0,0,488,32,0,0,0,0,0,0,0,0,0,100
693961ef53a7bae432692eecf64eef9e4b4070e6,0,0,0,0,0,0,0,0,0,0,0,0,0,0,489,33,0,0,0,0,0,0,0,0,0,100
5e9b53ad8d5b8a6fe65b8995b17dae8d56d1aca4,2,116,24,92,0,0,0,3,27,136,1,2,0.957026815,905,490,33,107,101,6,7722,7150,572,59,58,1,100
3f364a601673e0e28522b1139bf955c5550483a8,5,141,81,60,0,0,0,2,15,775,1,3,1.025405187,1066,491,12,126,124,2,9063,8339,724,53,51,2,100
294cd1b14a0392b76897320ea8289e06c9a9bc77,1,6,1,5,0,0,0,1,3,21,1,1,0,184,12,3,37,36,1,1168,1148,20,11,11,0,100
bc277f9afcc7cc335da375f8c5aabdaabe9a4277,0,0,0,0,0,0,0,0,0,0,0,0,0,0,492,13,0,0,0,0,0,0,0,0,0,100
c898b475a21c7aee5ff7624a6f62b325c8ce9497,1,1,1,0,0,0,0,2,4,1468,1,1,0,50,493,14,0,0,0,328,328,0,0,0,0,100
ce2f1bbd84a3d50f0719dc344fb59150f72ac419,83,4530,163,4367,45,0,45,2,36,85,5,40,5.764549067,4807,144,0,1077,723,354,51628,30674,20954,611,372,239,91.67680043
278de057af78c59781d9ac10681d0f6ae8c05fa6,10,108,35,73,1,0,1,2,6,70,1,6,2.88162135,879,61,2,113,100,13,6225,5699,526,59,55,4,99.96936275
4578327cf1c84098e1f5297e2f83b19532ea2ae4,7,113,27,86,1,0,1,5,26,194,2,4,2.416096771,1305,145,1,132,130,2,10876,10415,461,62,60,2,99.89285168
94c2d8bb8ede51ec79236d650b5ccf80f59ef2ff,0,0,0,0,0,0,0,0,0,0,0,0,0,0,494,14,0,0,0,0,0,0,0,0,0,100
76249877b76dccc2a2b65de0123364af0bfac643,0,0,0,0,0,0,0,0,0,0,0,0,0,0,495,15,0,0,0,0,0,0,0,0,0,100
97e17a1eab912f01e708be1f7988bc2ecac109ec,0,0,0,0,0,0,0,0,0,0,0,0,0,0,496,16,0,0,0,0,0,0,0,0,0,100
9e29357119032df652914268b32e8452b717e83c,0,0,0,0,0,0,0,0,0,0,0,0,0,0,497,17,0,0,0,0,0,0,0,0,0,100
f1cec12e720cdedb398ae050f60f98577dd01051,4,200,5,195,2,0,2,4,13,5,1,3,1.84846323,1244,13,0,186,170,16,9737,8925,812,123,113,10,99.92355909
d2ee4dcb75ac41a0f5664bff1199e22eea72d506,2,23,14,9,0,0,0,8,21,47,1,2,0.98678672,1230,146,2,144,144,0,10313,10275,38,85,85,0,100
4c79ca3eb1f4d0a42712255200049406d173a0c8,6,111,33,78,0,0,0,1,10,44,1,3,2.227659483,790,13,1,153,142,11,5426,4945,481,45,43,2,99.86251146
98e547f2d7f850994d880a97b07380eeb84b649f,2,29,26,3,0,0,0,4,6,14,1,1,0.970950594,312,14,1,57,58,1,1773,1771,2,37,37,0,100
704c6ec8643a7e686868717bf61e0ad2c772a852,0,0,0,0,0,0,0,0,0,0,0,0,0,0,0,0,0,0,0,0,0,0,0,0,0,100
d05d307e0b1bea9f2f1a63a02392a917b35814c0,2,7,3,4,0,0,0,3,11,461,1,2,0.970950594,313,498,18,52,51,1,1873,1841,32,33,33,0,100
fad576388df3297e79a611d407e7a700b0d27b9c,2,9,1,8,0,0,0,3,14,68,1,2,0.721928095,831,14,2,109,108,1,7863,7803,60,75,74,1,100
90a623b1678773bc0dc5ac4491f9fab2afd73312,7,290,15,275,1,0,1,9,41,48,5,7,1.98545329,3193,147,3,542,513,29,22086,20924,1162,370,349,21,99.90829895
e90158c6d672070facf5efd053b2d47871e0d491,0,0,0,0,0,0,0,0,0,0,0,0,0,0,499,8,0,0,0,0,0,0,0,0,0,100
c758be4775e53fcb869bd70c711be12597a6a2b2,7,103,74,29,0,0,0,5,18,34,3,5,2.535501095,847,148,4,122,116,6,5603,5239,364,64,59,5,100
f9071e047a06d25ca1594af1fc8d7351c6c09192,0,0,0,0,0,0,0,0,0,0,0,0,0,0,15,2,0,0,0,0,0,0,0,0,0,100
73c8f844f53e6692a9d20e001a491a1f03f92b89,7,163,3,160,0,0,0,9,42,4,3,5,2.491594421,2207,16,3,418,403,15,13022,12159,863,319,309,10,100
30d5cb7f719f4df7e414655cbd1233059752fce0,2,4,8,4,0,0,0,3,15,10,1,2,0.811278124,837,8,0,109,109,0,7856,7863,7,75,75,0,100
186ca4ac117c079aa96db91eb353080d6cea3740,1,21,16,5,0,0,0,7,28,48,1,1,0,432,149,5,80,80,0,3076,3068,8,40,40,0,100
03f62b0025d78f17791e995666b684d91e88431e,4,17,0,17,0,0,0,1,5,87,2,3,1.321606958,654,62,0,102,100,2,4478,4412,66,61,59,2,100
871f3b736fb1ccf626c162c321f9b421998c5a74,2,40,6,34,0,0,0,4,14,50,1,2,0.495969072,1119,150,3,159,150,9,8213,8057,156,115,111,4,100
61e513e1a828a18ec2ced0ffec470384477c277c,10,187,105,82,2,0,2,1,23,81,4,6,3.12858676,1509,151,4,236,230,6,10317,9853,464,106,103,3,99.78596545
7d4e997465eed2f01ad013618a36eba0bf5ae261,2,24,3,21,0,0,0,4,15,33,1,2,0.99107606,1097,1,0,149,146,3,7983,7843,140,111,110,1,100
58e3b99384ac3b0ca4f26c094c0c0a58571b5d92,2,39,6,33,0,0,0,5,15,288,1,1,0.982474087,470,17,2,67,61,6,3075,2812,263,20,19,1,100
b04e5cb6c3abfc484c617adb78e991c0f4aed0d2,0,0,0,0,0,0,0,0,0,0,0,0,0,0,500,0,0,0,0,0,0,0,0,0,0,100
20927ee19ce09bad9a1ced35dbf23eb0f9ee7992,0,0,0,0,0,0,0,0,0,0,0,0,0,0,501,1,0,0,0,0,0,0,0,0,0,100
3a48b24f4a3adf8af7d42c452079452578043602,0,0,0,0,0,0,0,0,0,0,0,0,0,0,502,2,0,0,0,0,0,0,0,0,0,100
fe7337e0247d060ed643194e161decf48408e7f7,0,0,0,0,0,0,0,0,0,0,0,0,0,0,503,3,0,0,0,0,0,0,0,0,0,100
ce6cf1037037b66547b0bec4c2cf569a9ecf4393,0,0,0,0,0,0,0,0,0,0,0,0,0,0,504,4,0,0,0,0,0,0,0,0,0,100
ab82a93a6929562a2453e19b45efd2beb6609e3c,0,0,0,0,0,0,0,0,0,0,0,0,0,0,505,5,0,0,0,0,0,0,0,0,0,100
5dd38046c8d142de230cb55d77b0aa45c2afd5af,0,0,0,0,0,0,0,0,0,0,0,0,0,0,506,6,0,0,0,0,0,0,0,0,0,100
17908b9bdd7ce0705d23b217f21a4a80161a58c7,0,0,0,0,0,0,0,0,0,0,0,0,0,0,507,7,0,0,0,0,0,0,0,0,0,100
cbbf233bfd06cdd8443e1eea8a5613ee9df34cf4,0,0,0,0,0,0,0,0,0,0,0,0,0,0,508,8,0,0,0,0,0,0,0,0,0,100
03fab89e40c7fea425ca6153546813a008ced630,3,129,5,124,2,0,2,1,16,4,1,3,1.568607829,1050,0,0,153,142,11,8112,7635,477,117,106,11,99.92362914
5eedc61070fb036db8e6c705416e9b71add43b27,18,938,10,928,10,0,10,3,43,138,7,7,3.523948481,3633,63,1,705,585,120,28678,23644,5034,440,368,72,99.57420925
04ec47e085d09326d8908d7b2c1ebecc28c9d8a9,7,141,6,135,0,0,0,9,44,16,3,5,2.205413818,2336,18,1,439,421,18,14052,13282,770,327,320,7,99.90900819
abdb8874e3cf9b62393a28b14ec0d91f4932f665,0,0,0,0,0,0,0,0,0,0,0,0,0,0,1,0,0,0,0,0,0,0,0,0,0,100
054655049b2bf35030e1566f10135c949c2316e0,0,0,0,0,0,0,0,0,0,0,0,0,0,0,2,1,0,0,0,0,0,0,0,0,0,100
4f6730e31984421ee28c0951a45adf0f9f341f91,0,0,0,0,0,0,0,0,0,0,0,0,0,0,509,9,0,0,0,0,0,0,0,0,0,100
c48ff3ec7247de10b9fa4418456ec606f81fa427,3,21,9,12,0,0,0,6,17,61,1,3,0.905587262,1258,64,1,181,178,3,9084,8977,107,128,128,0,100
f8f04d302deffe7d677138f95ff114e1f0a0fc0e,0,0,0,0,0,0,0,0,0,0,0,0,0,0,510,10,0,0,0,0,0,0,0,0,0,100
317568b4edba848383a27d210fa687a9d0b5c5fa,0,0,0,0,0,0,0,0,0,0,0,0,0,0,511,11,0,0,0,0,0,0,0,0,0,100
84b513d5372cb303ddd2e48c0a0c3c96fd772570,0,0,0,0,0,0,0,0,0,0,0,0,0,0,512,12,0,0,0,0,0,0,0,0,0,100
355775150ceafaaf34d97fbf37eb50b1a0d69a80,0,0,0,0,0,0,0,0,0,0,0,0,0,0,513,13,0,0,0,0,0,0,0,0,0,100
ab9cee9e08f87e7c5dbe8f95ebe65d24838c6542,0,0,0,0,0,0,0,0,0,0,0,0,0,0,514,14,0,0,0,0,0,0,0,0,0,100
cb9f6188408061eda2c5d67a3cc99d9fa3b6bf0c,0,0,0,0,0,0,0,0,0,0,0,0,0,0,515,15,0,0,0,0,0,0,0,0,0,100
c809697f765ec767e6c3f2e7b41436fd68e45934,0,0,0,0,0,0,0,0,0,0,0,0,0,0,516,16,0,0,0,0,0,0,0,0,0,100
72ada1726127351d2fa5668baf46e0edf17fa8c8,0,0,0,0,0,0,0,0,0,0,0,0,0,0,517,17,0,0,0,0,0,0,0,0,0,100
b9acb12003124581d83a4cc4d4d4d17814eb23d1,0,0,0,0,0,0,0,0,0,0,0,0,0,0,518,18,0,0,0,0,0,0,0,0,0,100
5890da3a70e7becae2107f4687a072da8179f809,0,0,0,0,0,0,0,0,0,0,0,0,0,0,519,19,0,0,0,0,0,0,0,0,0,100
e02ff7319b4518f005b1b8351d03adb6efc7a2f6,0,0,0,0,0,0,0,0,0,0,0,0,0,0,520,20,0,0,0,0,0,0,0,0,0,100
60989bb35cb8333303a12ecf2c4bd866e5ffece2,0,0,0,0,0,0,0,0,0,0,0,0,0,0,521,21,0,0,0,0,0,0,0,0,0,100
86bd4fb7e36b97322e6aff999b5a613374597a9e,0,0,0,0,0,0,0,0,0,0,0,0,0,0,522,22,0,0,0,0,0,0,0,0,0,100
926adc68691d751ad89261313ea54a5007d95787,5,13,53,40,0,0,0,3,45,93,2,3,1.822510467,2742,65,2,417,421,4,19869,20176,307,223,225,2,100
5c46e4c1f4436de224bb6c5c408c3849d8ed784b,2,14,3,11,0,0,0,1,2,30,1,1,0.787126586,311,66,3,63,59,4,2615,2463,152,27,27,0,100
f39d0c515a87132ac1e3bc649ba4f650bfeea4e9,20,152,43,109,1,0,1,1,21,608,4,11,3.586248291,4737,523,15,534,525,9,32107,31357,750,275,270,5,93.51187189
e2ea842e4638eeeedf6c4484483937b14e451964,15,426,288,138,0,0,0,4,24,219,4,9,3.372089919,3112,152,0,394,394,0,23706,22754,952,227,225,2,94.83879895
6ca3a4eab9ccb83f17dd8efebf7b8c499aa244f2,3,16,8,8,0,0,0,8,42,94,2,2,0.785235442,1061,67,4,195,194,1,8296,8254,42,65,64,1,100
27a8113ca02f14f66aefd8238c13b79249a94b25,2,5,5,0,0,0,0,5,46,440,1,2,0.721928095,1212,524,15,207,207,0,8631,8631,0,140,140,0,100
2e2230f27b5e35e4ebb4acdf8b48d0f12569acb7,6,268,223,45,2,0,2,5,43,263,1,4,1.754189582,2631,68,5,364,366,2,21900,21499,401,123,124,1,99.90843888
58d8479b2ac8f3609178b744fbd839784823737f,2,2,5,3,0,0,0,1,38,0,1,2,0.985228136,759,69,6,159,159,0,5762,5745,17,49,49,0,100
36155bc222bae44a2f1a6ebe973620bee763f386,0,0,0,0,0,0,0,0,0,0,0,0,0,0,70,6,0,0,0,0,0,0,0,0,0,100
49d08ba57cdec116f25503d73570b47439873ee2,4,239,4,235,0,0,0,7,39,18,2,4,1.263931316,1298,153,1,240,215,25,11228,9871,1357,86,80,6,93.072
998e720776d4b36f0440876664e84a712b8a5933,6,338,31,307,1,0,1,1,3,35,2,3,1.552156154,469,71,7,110,79,31,5554,3202,2352,67,43,24,99.96638655
bef8b19e02a81b6580e4469ea64730e50eadf5bc,2,3,3,0,0,0,0,1,4,0,1,2,0.918295834,364,72,8,57,57,0,2981,2985,4,34,34,0,100
840af4f5de180dc53e2c28c5dbab01bef72a6ddb,2,4,1,3,0,0,0,1,5,0,1,1,0.970950594,369,73,9,76,75,1,3117,3084,33,32,32,0,100
ffa7f55791c82a710d6e5de891fdf00fdd203646,0,0,0,0,0,0,0,0,0,0,0,0,0,0,525,16,0,0,0,0,0,0,0,0,0,100
0ec8ce1c9a160281cf5381611a10a20f8c394602,7,1179,4,1175,4,0,4,6,33,202,1,4,2.269003458,3074,19,0,590,413,177,30114,24506,5608,253,139,114,99.84901862
3d17ede66d29ccf41e95c469e56c696f99262df5,22,1182,97,1085,2,0,2,2,40,614,5,9,2.471739843,5331,154,2,714,635,79,44433,37900,6533,435,372,63,99.93304319
b93cc1c68afa0e773027bfa2745f1d37f376bca1,18,669,60,609,2,0,2,3,26,555,2,7,2.410637796,2547,15,0,435,350,85,22439,18847,3592,217,183,34,99.56630525
9a7767a5e5dbe588e48087c24338b5ae98ff90f4,2,31,2,29,0,0,0,3,17,2,1,2,0.684038436,596,16,1,47,45,2,6349,6164,185,35,34,1,100
b22505022b17388c099e419185409a35455f1827,2,29,1,28,0,0,0,3,18,2,1,2,0.996791632,867,17,2,119,115,4,8363,8150,213,81,78,3,100
46ccd34da21c045c0727d217c281ae0c427dbe1f,3,108,0,108,1,0,1,3,19,0,1,2,1.063162808,889,18,3,134,119,15,8911,8363,548,87,81,6,99.66711052
52ca823cb212566fab912c624e652858972214c8,4,26,5,21,0,0,0,2,13,24,2,3,1.398110314,1394,155,2,244,243,1,10458,10315,143,109,108,1,100
fd8e1bb8aebcb40531bdda6cf828f9d3476be6bb,4,133,15,118,3,0,3,1,6,103,1,1,1.872000565,42,0,0,10,3,7,583,180,403,5,1,4,99.83363833
0026377664ff9ed4382a16d860aa1dc85f8ae37c,0,0,0,0,0,0,0,0,0,0,0,0,0,0,74,0,0,0,0,0,0,0,0,0,0,100
aaf1748525d304511c254b1aaba4b480e54b38c1,3,38,18,20,0,0,0,3,12,81,1,2,1.044246967,524,156,1,72,71,1,3807,3707,100,50,50,0,100
38b56bbf3807cf9d2c4578a7948e4bb5bfaf47a1,11,109,19,90,0,0,0,3,34,1137,3,8,2.717068463,1878,20,0,260,250,10,11617,11262,355,131,126,5,100
92b2ac4ea0fa8b3379136b5fb6e441a65547629a,0,0,0,0,0,0,0,0,0,0,0,0,0,0,526,0,0,0,0,0,0,0,0,0,0,100
d3b556b5c6e90f791151c593284853ccd787401f,0,0,0,0,0,0,0,0,0,0,0,0,0,0,527,1,0,0,0,0,0,0,0,0,0,100
89206511aad7cacb91c7fa032490816e7cdd18ba,2,101,36,65,0,0,0,3,4,64,1,2,0.841569357,671,19,3,109,101,8,5758,5182,576,46,43,3,100
7a93dd4037477585607057f6a632163448eb564a,6,32,16,16,0,0,0,4,22,84,4,6,2.443780192,1589,528,2,183,183,0,12482,12491,9,135,135,0,100
f857f7cf2424b95c1f7d6e209327452208ab3e55,0,0,0,0,0,0,0,0,0,0,0,0,0,0,529,3,0,0,0,0,0,0,0,0,0,100
4dc04c531b4d97265f7da0fff509fbda7250cc59,0,0,0,0,0,0,0,0,0,0,0,0,0,0,530,4,0,0,0,0,0,0,0,0,0,100
060ba836487af2a97d6e72bb30fe375324739535,0,0,0,0,0,0,0,0,0,0,0,0,0,0,531,5,0,0,0,0,0,0,0,0,0,100
fe2dc0e9110052044b011774ca1f6d9571263e93,0,0,0,0,0,0,0,0,0,0,0,0,0,0,532,6,0,0,0,0,0,0,0,0,0,100
b146ae746a1c215c8f7bdfa835c51488f52869b7,0,0,0,0,0,0,0,0,0,0,0,0,0,0,533,7,0,0,0,0,0,0,0,0,0,100
b174138caf8e6ac0e1c4ef77e347030137ab2147,0,0,0,0,0,0,0,0,0,0,0,0,0,0,534,8,0,0,0,0,0,0,0,0,0,100
0449ee64d7590e61c7aa0121d52c1c15db497cb9,0,0,0,0,0,0,0,0,0,0,0,0,0,0,535,9,0,0,0,0,0,0,0,0,0,100
e6aaf40301dafc9cdce617c19a558be52c0cccbe,0,0,0,0,0,0,0,0,0,0,0,0,0,0,536,10,0,0,0,0,0,0,0,0,0,100
d35f3de3c6957e88248fa02e53199a928b4e1569,0,0,0,0,0,0,0,0,0,0,0,0,0,0,537,11,0,0,0,0,0,0,0,0,0,100
e3079b201a2a547862475b20b803c5979f4b0148,0,0,0,0,0,0,0,0,0,0,0,0,0,0,538,12,0,0,0,0,0,0,0,0,0,100
94ce397316ac743f18454028112cad6f05a3e8db,0,0,0,0,0,0,0,0,0,0,0,0,0,0,539,13,0,0,0,0,0,0,0,0,0,100
31df513cdee1bf58845268477226a6b680bda1dc,0,0,0,0,0,0,0,0,0,0,0,0,0,0,540,14,0,0,0,0,0,0,0,0,0,100
7f8a5a0712f423b13ed96b1ea5c8277c628fd944,0,0,0,0,0,0,0,0,0,0,0,0,0,0,541,15,0,0,0,0,0,0,0,0,0,100
8f39d033272742472cb29293650a416ddf53c84b,0,0,0,0,0,0,0,0,0,0,0,0,0,0,542,16,0,0,0,0,0,0,0,0,0,100
7a8b459ef503c87f9b6bb7c441dbf8f08d52c302,0,0,0,0,0,0,0,0,0,0,0,0,0,0,543,17,0,0,0,0,0,0,0,0,0,100
dc71011ff48d5d0205472fa26ead937d7ddc717b,0,0,0,0,0,0,0,0,0,0,0,0,0,0,544,18,0,0,0,0,0,0,0,0,0,100
b5d97a197d22da5900715b5a84a7e3b22c03cea9,0,0,0,0,0,0,0,0,0,0,0,0,0,0,545,19,0,0,0,0,0,0,0,0,0,100
0e04e5c005e9cc7d3f0f811633477a5067deb0aa,2,23,23,0,0,0,0,4,14,6,1,2,0.258018669,481,546,20,72,72,0,3453,3353,100,50,50,0,100
1834c67ccdcac118dc2a925072f3f6e6203621a4,6,52,16,36,0,0,0,1,5,102,1,1,2.059264637,977,20,1,182,178,4,6456,6243,213,54,50,4,100
4127124b5f623f39cce070d93b5f0e7632b243a1,0,0,0,0,0,0,0,0,0,0,0,0,0,0,1,0,0,0,0,0,0,0,0,0,0,100
3189fe7b9f02a0318f62662fa1eaf6369a0ee6e6,0,0,0,0,0,0,0,0,0,0,0,0,0,0,547,21,0,0,0,0,0,0,0,0,0,100
10d8e3ce4d0a70e54afdbda98e3fb2a08a29726f,0,0,0,0,0,0,0,0,0,0,0,0,0,0,21,2,0,0,0,0,0,0,0,0,0,100
7aa020eb59c5d6fd178d17ed82e550556e9e9d32,1,1,1,0,0,0,0,3,10,464,1,1,0,106,22,3,22,22,0,636,636,0,9,9,0,100
de2a115aa7179eeebe87efada365fcda2fe9084e,2,20,14,6,0,0,0,3,11,738,1,2,0.672294817,217,23,4,30,30,0,1389,1289,100,11,11,0,100
03cd1f931cb3a701ba825c78026279cc9247abb6,2,18,1,17,0,0,0,3,20,73,1,2,0.949452015,731,24,5,75,73,2,7553,7442,111,42,41,1,100
0535ab9162228505f1247b51288f42476a31b306,0,0,0,0,0,0,0,0,0,0,0,0,0,0,548,22,0,0,0,0,0,0,0,0,0,100
4c003804c4c3821cb42df6c2f78505556be16b2f,18,43,163,120,0,0,0,3,23,1425,5,11,3.515334478,2689,549,23,199,211,12,20823,21587,764,89,93,4,100
5bc3cc5c438364218566a7b66ec9830a01501b05,2,19,14,5,0,0,0,4,5,38,1,2,0.884963636,723,75,0,112,109,3,5865,5758,107,46,46,0,100
55af417331cab572203df9a0d2933a954609096d,5,12,4,8,0,0,0,9,47,181,2,4,2.186278124,1189,76,1,224,224,0,7713,7673,40,138,138,0,100
7ca30e00680a4c3c41dc8269542a3f608f8c42a8,5,27,21,6,0,0,0,5,48,62,2,4,1.892079564,1830,157,0,327,328,1,12273,12282,9,186,186,0,100
f0462bec45cb034ed9ecf31bdf927e3745ec11b4,0,0,0,0,0,0,0,0,0,0,0,0,0,0,0,0,0,0,0,0,0,0,0,0,0,100
f96b62d133d300519fc45f295f5e7a2b58922949,2,83,75,8,0,0,0,4,7,70,1,2,0.135716379,554,77,2,85,83,2,4096,4018,78,27,26,1,100
bbcaaff1d3483d706f7d76c344920b4f755809b7,0,0,0,0,0,0,0,0,0,0,0,0,0,0,1,0,0,0,0,0,0,0,0,0,0,100
da1e739a93d31cdd71d358df79e4a388cc4a24ab,0,0,0,0,0,0,0,0,0,0,0,0,0,0,550,3,0,0,0,0,0,0,0,0,0,100
dbdfe7fc23c3e2f05deb0867913cea74c0b0032c,3,108,9,99,0,0,0,2,24,67,2,2,1.310119716,1220,158,1,177,168,9,11047,10375,672,24,21,3,100
0e0f94e545bc4ab405ad872eae4d97ef05006acc,0,0,0,0,0,0,0,0,0,0,0,0,0,0,551,3,0,0,0,0,0,0,0,0,0,100
77ed53fe365c8cdedcd7516f8539024113a5d56a,0,0,0,0,0,0,0,0,0,0,0,0,0,0,552,4,0,0,0,0,0,0,0,0,0,100
eda72dd48f6ca8234e74c20bf10f2b3fb93439eb,0,0,0,0,0,0,0,0,0,0,0,0,0,0,78,3,0,0,0,0,0,0,0,0,0,100
ce810ac229c9ce4d4439a3d8404e812d7bd6b648,13,710,219,491,4,0,4,1,44,94,3,5,3.069214873,2521,79,4,434,370,64,24522,21217,3305,168,132,36,99.76790451
f4019ae33eca291ac19b87822e12b150eaea3b24,1,12,0,12,0,0,0,7,34,127,1,1,0,1905,21,0,423,421,2,12426,12329,97,112,111,1,100
91a81ce43ac90b8b1eec3ea9ec9cf162efbe25a2,0,0,0,0,0,0,0,0,0,0,0,0,0,0,2,0,0,0,0,0,0,0,0,0,0,100
57184ab02ffe8020f9b91f64b73d73e1d7f38131,3,359,152,207,0,0,0,4,8,15,1,3,0.59349527,885,159,2,127,114,13,7772,7089,683,59,47,12,100
a2a4335946b74b27ea23a6cf95c30f69e765517d,1,3,1,2,0,0,0,5,19,204,1,1,0,188,22,1,34,32,2,1261,1246,15,10,10,0,100
17e96dfc1b895c0519a762ed22785e2cac7e0a3e,6,52,6,46,0,0,0,9,49,117,4,4,2.412804803,2057,80,3,391,382,9,11809,11569,240,293,287,6,100
ce0f2a9d6a757610132343cb6133cc2bda9388e2,3,126,21,105,0,0,0,5,41,155,1,3,0.892334666,1586,160,1,153,149,4,14314,13633,681,58,56,2,100
fa485e628d335f0395eebdb5a57d1304b31af874,25,1242,151,1091,0,0,0,9,50,604,5,12,3.470202627,7589,161,0,1063,947,116,61712,55379,6333,682,631,51,96.57824517
2242282719c590e9adbeb60a2699e307c5f472a7,0,0,0,0,0,0,0,0,0,0,0,0,0,0,2,0,0,0,0,0,0,0,0,0,0,100
c845d4a51700748b00bdaa6a7a6e0117c5fada5c,1,4,1,3,0,0,0,3,11,9,1,1,0,264,162,1,48,47,1,1496,1491,5,22,22,0,100
918be5a38b93df4ffe59affd7d61d3410ec3a236,3,54,7,47,0,0,0,8,26,101,1,2,0.982240821,1430,163,2,163,161,2,12392,12015,377,94,94,0,100
9b9b4ead5bcd1b40ec9c6efd36d78297857dc6bb,2,10,15,5,0,0,0,3,12,12,1,2,0.795040279,670,81,0,100,101,1,4604,4605,1,49,49,0,100
12733e7184f707af37bb55809ee3142732867be1,0,0,0,0,0,0,0,0,0,0,0,0,0,0,0,0,0,0,0,0,0,0,0,0,0,100
91236d39db9a8193d7b93706887e10d0e41e16a3,0,0,0,0,0,0,0,0,0,0,0,0,0,0,1,1,0,0,0,0,0,0,0,0,0,100
7c1900dccc403876f703b62d21931d85c4e533bf,2,127,0,127,2,0,2,1,1,0,1,2,0.976210142,0,82,1,10,0,10,565,0,565,9,0,9,99.92538427
d1852e3af0fb0513a8ecaff00fad3967bcccde55,13,1248,22,1226,8,0,8,3,13,8,2,6,3.288842034,1021,164,3,226,128,98,13754,7548,6206,116,72,44,96.42299281
dcdeace47a179851ee0810d446d2ad903ac826c2,4,150,10,140,0,0,0,3,14,0,1,3,1.02027612,1092,165,4,154,143,11,8852,8042,810,75,68,7,100
d10e15d5eda566bc978bc2cc3e7c8fa26cd73577,2,74,42,32,0,0,0,8,23,511,1,2,0.883388272,1155,23,0,102,98,4,11349,11118,231,47,46,1,100
fe0d0e7f65998f854f8892229a8f0e4b9b05fe47,8,369,12,357,7,0,7,1,19,80,1,3,2.905504082,212,83,2,53,31,22,2986,1542,1444,18,4,14,99.72199509
2c28207b09732f1e6103813789e5a2f19024866b,2,35,1,34,0,0,0,5,20,260,1,2,0.41381685,236,24,1,38,34,4,1796,1581,215,10,10,0,100
d5eb5f57f158978767da0450bc45abada49aedf2,1,1,1,0,0,0,0,5,21,0,1,1,0,218,25,2,38,38,0,1453,1453,0,10,10,0,100
71f676bf895d97ea6d95b82addd22b8598fdee9b,7,576,67,509,2,0,2,1,15,5,1,3,1.824132005,1463,166,4,221,171,50,13928,11453,2475,112,92,20,99.90221643
3017a180becf80d4f49bfeea96dc121c3f428148,3,17,12,5,0,0,0,6,21,211,1,2,1.563192201,466,84,3,63,63,0,3139,3054,85,16,16,0,100
863e7ab1e30f99036c905ca16fdd9aa31d095e56,10,88,74,14,0,0,0,1,45,16,2,4,2.439118953,1934,85,3,319,429,110,15201,31065,15864,121,211,90,99.52799479
93c663c0a407af8fff0a5c0e6822ddadfa011828,7,59,36,23,0,0,0,3,16,811,3,5,2.796553472,1232,86,4,174,172,2,9464,9169,295,72,74,2,99.98373455
b804e2b01418c544eeb5d432de0df9a339d9f92d,3,128,7,121,1,0,1,1,6,210,2,2,1.371572893,228,87,4,70,52,18,2056,1510,546,42,29,13,99.90245489
f1183bfa23a49b4da8a675aa72eefb5588e6c4b0,0,0,0,0,0,0,0,0,0,0,0,0,0,0,553,0,0,0,0,0,0,0,0,0,0,100
5c1992ed9e077fa0d03379b0de7ce2be156cfc8a,0,0,0,0,0,0,0,0,0,0,0,0,0,0,554,1,0,0,0,0,0,0,0,0,0,100
ae5c586de678712dfa575121f6811ac7759c0514,49,2007,177,1830,33,0,33,9,51,156,3,12,5.284526791,4870,88,1,779,620,159,41832,33295,8537,533,412,121,91.94460989
a03bf6dec21c1f045cc36b3d7ea945f2b09c94d8,0,0,0,0,0,0,0,0,0,0,0,0,0,0,555,2,0,0,0,0,0,0,0,0,0,100
e28442e277a871a89077f16caaf4dbc486dd30a0,12,276,30,246,2,0,2,2,7,384,3,8,2.469325196,968,89,1,171,152,19,8026,6292,1734,100,88,12,99.91760505
d2aecb7af22768086d6d1668c7e794f69267650e,0,0,0,0,0,0,0,0,0,0,0,0,0,0,556,3,0,0,0,0,0,0,0,0,0,100
a244be45618f2f297d4def9953520eb3b4d37a13,2,20,3,17,0,0,0,4,8,252,1,2,0.932111568,866,90,2,128,127,1,6693,6597,96,60,59,1,100
7879cef08e8c0806e53017e98de801d17d4ba44a,0,0,0,0,0,0,0,0,0,0,0,0,0,0,0,0,0,0,0,0,0,0,0,0,0,100
cd38d9dd72a20fb67971583a3aa8d3f6303c0d0d,0,0,0,0,0,0,0,0,0,0,0,0,0,0,557,1,0,0,0,0,0,0,0,0,0,100
9884d30ca6f0385ea824f233a10c9210e615aaf6,0,0,0,0,0,0,0,0,0,0,0,0,0,0,558,2,0,0,0,0,0,0,0,0,0,100
61b23dffbf07b06aa13d1c7fddbb183202fe49b2,0,0,0,0,0,0,0,0,0,0,0,0,0,0,559,3,0,0,0,0,0,0,0,0,0,100
b7ab10a95ad0641d333fa41acf10355b7002e511,0,0,0,0,0,0,0,0,0,0,0,0,0,0,560,4,0,0,0,0,0,0,0,0,0,100
eb20ab4f5a52d77fcec175725d1a4f2b1c69d19b,0,0,0,0,0,0,0,0,0,0,0,0,0,0,561,5,0,0,0,0,0,0,0,0,0,100
bc04ae9db02c3c4313c8b03fcbfac8f323931f3f,0,0,0,0,0,0,0,0,0,0,0,0,0,0,562,6,0,0,0,0,0,0,0,0,0,100
791dad1fe6e1d20a32371961bc041764cdd3e50b,0,0,0,0,0,0,0,0,0,0,0,0,0,0,563,7,0,0,0,0,0,0,0,0,0,100
2bfa09432576368a29b78baac2d87684ed2bdfe6,0,0,0,0,0,0,0,0,0,0,0,0,0,0,564,8,0,0,0,0,0,0,0,0,0,100
1028645baf5b1c7c45eb29616a0f59485866206c,0,0,0,0,0,0,0,0,0,0,0,0,0,0,565,9,0,0,0,0,0,0,0,0,0,100
3f3a9195044d770ee2a59595f3ff063ac3f2336a,0,0,0,0,0,0,0,0,0,0,0,0,0,0,566,10,0,0,0,0,0,0,0,0,0,100
27819370afaeb3482121b337f60988d67b281e6e,0,0,0,0,0,0,0,0,0,0,0,0,0,0,567,11,0,0,0,0,0,0,0,0,0,100
4f3fafb0d2fe00507e322b62db9078cc7536146f,0,0,0,0,0,0,0,0,0,0,0,0,0,0,568,12,0,0,0,0,0,0,0,0,0,100
d38272c0c21d685884fd8c460f10140fd4c42ca4,0,0,0,0,0,0,0,0,0,0,0,0,0,0,569,13,0,0,0,0,0,0,0,0,0,100
2613313c5fe3a7de6ecbba871187281e22213f95,0,0,0,0,0,0,0,0,0,0,0,0,0,0,570,14,0,0,0,0,0,0,0,0,0,100
7ccd35823bfd0f59a8dabb1eb9ed4fb553d4454c,0,0,0,0,0,0,0,0,0,0,0,0,0,0,571,15,0,0,0,0,0,0,0,0,0,100
486836c031c5a786dd0055c18147c0c88bb26846,0,0,0,0,0,0,0,0,0,0,0,0,0,0,572,16,0,0,0,0,0,0,0,0,0,100
6bef73989a1e4aea68a19096ca3e7f9b97c05e07,0,0,0,0,0,0,0,0,0,0,0,0,0,0,573,17,0,0,0,0,0,0,0,0,0,100
808410042a960b936a8d85cb658b2cad18ed60db,4,12,8,4,0,0,0,8,52,143,2,4,1.83949107,1602,574,17,228,228,0,11058,10998,60,160,160,0,100
cfcb08e062a1f25da2bfd7bddb2c8e7d544110c6,4,49,35,14,0,0,0,3,20,1265,1,3,1.653844978,827,575,18,88,88,0,7164,6896,268,27,27,0,100
b7caa778aefe2e757d65280b72d5f583ad0521b8,0,0,0,0,0,0,0,0,0,0,0,0,0,0,0,0,0,0,0,0,0,0,0,0,0,100
bdee3172d8e99aa42ceeeaba6a3cee10abb51248,6,118,6,112,2,0,2,1,53,167,4,6,1.778768729,2554,0,0,405,397,8,19150,18770,380,277,269,8,99.94513032
01d47c5b34a96b4ebea5e585b1b6d409117d0b88,7,183,23,160,0,0,0,5,22,1049,3,5,2.423123237,1156,91,0,183,158,25,8912,7572,1340,69,58,11,96.51602071
a48eff8425c90db6b58b871053de8506550045fd,22,1271,27,1244,18,0,18,1,31,85,4,8,4.097718919,1144,92,1,323,215,108,13823,7365,6458,174,111,63,99.17555082
235bfd4333a77871acccb127663faf22c82dad6e,10,291,2,289,5,0,5,10,54,419,5,6,2.57802126,1917,25,0,383,359,24,11333,10133,1200,297,279,18,99.90108803
fdcc6d4c57c72d5ae6d7600094119b8c6957525e,19,360,169,191,1,0,1,10,55,153,4,10,3.10754661,5626,93,2,928,908,20,38369,37141,1228,567,550,17,100
433468916e079a0dd92ef7a294eccd2ad0875767,1,1,1,0,0,0,0,6,16,599,1,1,0,198,0,0,23,23,0,1419,1419,0,8,8,0,100
2032332b06dec21e02e1b60677c16a7c0c5f8c93,0,0,0,0,0,0,0,0,0,0,0,0,0,0,576,0,0,0,0,0,0,0,0,0,0,100
dcb260a0445cf3a79232b9edc094b3e2b7facfb8,0,0,0,0,0,0,0,0,0,0,0,0,0,0,577,1,0,0,0,0,0,0,0,0,0,100
03533899b4345f318a915df39f58e9afa38ab2cb,0,0,0,0,0,0,0,0,0,0,0,0,0,0,578,2,0,0,0,0,0,0,0,0,0,100
593fefac964fd24e219d54ab86f2e953f21b74bc,0,0,0,0,0,0,0,0,0,0,0,0,0,0,579,3,0,0,0,0,0,0,0,0,0,100
b66e1a47d04df2e0899d82b8ef2a1895983b7947,0,0,0,0,0,0,0,0,0,0,0,0,0,0,580,4,0,0,0,0,0,0,0,0,0,100
97620b10a2d6ed1c5ee535a54ffe7aacc52901f9,0,0,0,0,0,0,0,0,0,0,0,0,0,0,581,5,0,0,0,0,0,0,0,0,0,100
d61fd2c4362cb29aab96d24108af303e9e8a97cb,0,0,0,0,0,0,0,0,0,0,0,0,0,0,582,6,0,0,0,0,0,0,0,0,0,100
5f2bea133e0c5e6a311199229cb0685ce6ae7cb9,0,0,0,0,0,0,0,0,0,0,0,0,0,0,583,7,0,0,0,0,0,0,0,0,0,100
1cb699218258454fd348d18df8f221e33e5d95b7,0,0,0,0,0,0,0,0,0,0,0,0,0,0,584,8,0,0,0,0,0,0,0,0,0,100
0f1c6158688cd66e7f195903898e3ee5805602c6,0,0,0,0,0,0,0,0,0,0,0,0,0,0,585,9,0,0,0,0,0,0,0,0,0,100
6fb741d863c1aa3547d216f3e2f6d50139d75828,0,0,0,0,0,0,0,0,0,0,0,0,0,0,586,10,0,0,0,0,0,0,0,0,0,100
90070c01eaa91df0d9ec24125dd782595b0eca6e,0,0,0,0,0,0,0,0,0,0,0,0,0,0,587,11,0,0,0,0,0,0,0,0,0,100
49646060aaad243d350196a83409368468f6107b,0,0,0,0,0,0,0,0,0,0,0,0,0,0,588,12,0,0,0,0,0,0,0,0,0,100
b8d45cb5f0e37183de43062bd95e92f5863151d5,0,0,0,0,0,0,0,0,0,0,0,0,0,0,589,13,0,0,0,0,0,0,0,0,0,100
be97e5d682c3d680c33860b0a1237ff9bbc89fd7,0,0,0,0,0,0,0,0,0,0,0,0,0,0,590,14,0,0,0,0,0,0,0,0,0,100
b518853eb4cbaa1e0b37cca7a66613def39694bc,2,23,14,9,0,0,0,2,17,530,1,2,0.405977038,263,26,0,29,28,1,1827,1754,73,12,12,0,100
2b1d0853ae89c17654ca6fec901a48ffc8616db6,10,29,9,20,0,0,0,3,41,211,3,8,2.754377842,3906,591,15,318,318,0,30999,30999,0,208,208,0,100
5e025be914eaebba5ef352b8c029e77e8a458468,0,0,0,0,0,0,0,0,0,0,0,0,0,0,592,16,0,0,0,0,0,0,0,0,0,100
04685c3ecdd02ef5b0d698ba0099fb626622051a,1,3,1,2,0,0,0,2,6,448,1,1,0,499,94,0,116,116,0,3700,3662,38,14,14,0,100
83152cdf671a2c8018ddf97f9c33306d2adc9101,3,275,1,274,1,0,1,1,17,501,3,3,0.192462805,333,27,1,66,55,11,4096,2359,1737,40,31,9,100
2127c3a14bcc1344e3dcc4142941e8964abd2b74,6,60,28,32,1,0,1,1,27,239,5,5,2.006689983,1028,167,0,162,160,2,7177,7097,80,40,40,0,99.73213027
673bb4b9532fba3f4ad9b6238340b787109f723c,19,669,37,632,0,0,0,7,17,1037,4,9,3.272060805,1662,28,0,236,173,63,15597,11028,4569,117,88,29,99.76120242
11a9b6e47465ddc5d374d2fcd444b915cb1bd32d,8,135,39,96,0,0,0,4,56,456,5,7,2.080490528,6878,26,0,763,758,5,50022,49558,464,443,440,3,100
5bf5f6de9f7315495f4c5e2686ee187e29ed5de7,12,118,19,99,0,0,0,10,57,355,3,8,2.777252786,4835,95,0,608,599,9,35511,34410,1101,407,402,5,100
ed77c70a76f351744d7b62b1ef9cacd753ef0ae6,2,62,2,60,1,0,1,1,2,1099,1,1,0.988699408,103,27,0,17,11,6,939,636,303,6,5,1,100
a619758f6a07db81561a2f9bf5d27639269f4b2e,4,123,22,101,0,0,0,3,18,679,1,3,1.135583363,739,29,0,93,88,5,6718,6126,592,48,45,3,100
bde25bc416c0ab24689f2b0e1638df9d4ab504da,0,0,0,0,0,0,0,0,0,0,0,0,0,0,593,0,0,0,0,0,0,0,0,0,0,100
e32ab1aad5cbf138d5a46566cc692aacd35cd43f,0,0,0,0,0,0,0,0,0,0,0,0,0,0,594,1,0,0,0,0,0,0,0,0,0,100
d861b126b9b65895eb7356dab4c8018d87bd845d,0,0,0,0,0,0,0,0,0,0,0,0,0,0,595,2,0,0,0,0,0,0,0,0,0,100
94b445ea18585f0571e177fba72c1af7560943b1,2,56,6,50,0,0,0,5,34,116,1,2,0.637387499,1088,0,0,131,128,3,8890,8613,277,68,68,0,100
1a7d05efd95b41edd370abde9b2a0e2093c9f293,3,27,4,23,0,0,0,3,18,153,1,2,1.514356267,554,30,1,51,48,3,4064,3910,154,25,23,2,100
41590e185efa2c8d8c4aaf22fbc562c498ba808d,4,470,408,62,3,0,3,1,12,285,1,1,1.793491715,313,596,3,26,52,26,2630,4780,2150,8,16,8,98.16501473
4db62361575bfad3986cee013e6e7f0cab570431,1,1,1,0,0,0,0,4,7,1409,1,1,0,68,31,1,12,11,1,495,487,8,1,1,0,100
9aa87729c0f28293432404d0ec0b1746c7ee099c,2,69,2,67,0,0,0,4,8,124,1,2,0.312733376,489,32,2,52,50,2,4785,4220,565,19,18,1,100
6976ecec199c8fe13d0f69170f447fc839fc324a,0,0,0,0,0,0,0,0,0,0,0,0,0,0,28,0,0,0,0,0,0,0,0,0,0,100
d361481c3fca9754a82f9c780d654f1be772fd4f,2,33,2,31,0,0,0,3,19,66,1,2,0.822404226,608,33,2,72,70,2,5490,5274,216,38,37,1,100
559a89bace181735d981cfec24f964738eb36a1a,0,0,0,0,0,0,0,0,0,0,0,0,0,0,597,0,0,0,0,0,0,0,0,0,0,100
55023ce95903862881176afdb6a7dee680e6f67a,0,0,0,0,0,0,0,0,0,0,0,0,0,0,598,1,0,0,0,0,0,0,0,0,0,100
4650b51c17b51094d057d2f6c4aac8a98f16be9c,0,0,0,0,0,0,0,0,0,0,0,0,0,0,599,2,0,0,0,0,0,0,0,0,0,100
44280b331a96c50deae6be83260caa454db86784,0,0,0,0,0,0,0,0,0,0,0,0,0,0,600,3,0,0,0,0,0,0,0,0,0,100
b9f020b03cb8744cd88053ec34f43d7291e85f67,0,0,0,0,0,0,0,0,0,0,0,0,0,0,601,4,0,0,0,0,0,0,0,0,0,100
76e986233aeb46bced029c8e54309c6a6fd573f2,0,0,0,0,0,0,0,0,0,0,0,0,0,0,602,5,0,0,0,0,0,0,0,0,0,100
905a9311a68b18778b5a9c5b55e9f4caa55acab1,0,0,0,0,0,0,0,0,0,0,0,0,0,0,603,6,0,0,0,0,0,0,0,0,0,100
84af35a422577ac51bbc842a7b978f2c916e7c35,0,0,0,0,0,0,0,0,0,0,0,0,0,0,604,7,0,0,0,0,0,0,0,0,0,100
44178a60c3f6ca5c5b78b351724d4852d88afb13,0,0,0,0,0,0,0,0,0,0,0,0,0,0,605,8,0,0,0,0,0,0,0,0,0,100
24fe9ce9a5abd0fbf76c6f606458d7fa92fd9b43,0,0,0,0,0,0,0,0,0,0,0,0,0,0,606,9,0,0,0,0,0,0,0,0,0,100
a6f483153183a3f3c39f6ffe48b19abc1d544be7,0,0,0,0,0,0,0,0,0,0,0,0,0,0,607,10,0,0,0,0,0,0,0,0,0,100
f5079cd003ede3f5318747b9336283690f3a6e2d,0,0,0,0,0,0,0,0,0,0,0,0,0,0,608,11,0,0,0,0,0,0,0,0,0,100
1d1a19ce3860aa7b5b29ffa57beaec8034cf5aa4,0,0,0,0,0,0,0,0,0,0,0,0,0,0,609,12,0,0,0,0,0,0,0,0,0,100
32155ce8ad0e86e924024da0699c6615a3c27655,0,0,0,0,0,0,0,0,0,0,0,0,0,0,610,13,0,0,0,0,0,0,0,0,0,100
33ad107166c8eec8a02805c5e63a864551a54f84,7,34,1,33,0,0,0,2,22,1219,2,2,2.749936235,1349,96,0,206,206,0,10006,9758,248,109,109,0,100
fbdb2ed74fd5f35ca540007a5dde387cfdf73e8f,0,0,0,0,0,0,0,0,0,0,0,0,0,0,611,14,0,0,0,0,0,0,0,0,0,100
a6e2827d979b8bc3908e56989d1e7f2da125ce66,0,0,0,0,0,0,0,0,0,0,0,0,0,0,612,15,0,0,0,0,0,0,0,0,0,100
bb6fef1e897f2090b2e571a486892566d6fc4bc3,0,0,0,0,0,0,0,0,0,0,0,0,0,0,613,16,0,0,0,0,0,0,0,0,0,100
6f464ae96b888744d0e1d490426135302b305aaf,0,0,0,0,0,0,0,0,0,0,0,0,0,0,614,17,0,0,0,0,0,0,0,0,0,100
f83dddbf270bb5153b16253154e583e989865c50,0,0,0,0,0,0,0,0,0,0,0,0,0,0,615,18,0,0,0,0,0,0,0,0,0,100
8e0e3f25c4edaf4d31e1629cd5bbd7dec9b04a29,0,0,0,0,0,0,0,0,0,0,0,0,0,0,616,19,0,0,0,0,0,0,0,0,0,100
32eef071077f4ec9ca0b73cc7dbfa2368429141d,0,0,0,0,0,0,0,0,0,0,0,0,0,0,617,20,0,0,0,0,0,0,0,0,0,100
6f5808d8b871f5390a0b42492b9e83c567ce7fe5,0,0,0,0,0,0,0,0,0,0,0,0,0,0,618,21,0,0,0,0,0,0,0,0,0,100
ceca4651559a898cda2ffd9538b8aaa1b334d3b2,0,0,0,0,0,0,0,0,0,0,0,0,0,0,619,22,0,0,0,0,0,0,0,0,0,100
c2013f3208eb706356ddfefeda5383d8aa916caf,0,0,0,0,0,0,0,0,0,0,0,0,0,0,620,23,0,0,0,0,0,0,0,0,0,100
bc640a7fed94f1b4ffde40c6cd10dcad2875ca52,0,0,0,0,0,0,0,0,0,0,0,0,0,0,621,24,0,0,0,0,0,0,0,0,0,100
116a667e1e3373410435b757b4c6f53379c1cdc0,0,0,0,0,0,0,0,0,0,0,0,0,0,0,622,25,0,0,0,0,0,0,0,0,0,100
68b98c1ef6a66867340888e8292c609a10c93e64,0,0,0,0,0,0,0,0,0,0,0,0,0,0,623,26,0,0,0,0,0,0,0,0,0,100
447f9539f95782890ac9f2e07b3a6a06ee9d7403,0,0,0,0,0,0,0,0,0,0,0,0,0,0,624,27,0,0,0,0,0,0,0,0,0,100
835dddac88f921dfb38d66943ff8a3fcd2cc525e,0,0,0,0,0,0,0,0,0,0,0,0,0,0,625,28,0,0,0,0,0,0,0,0,0,100
6a8373f615258fbbf5b948139e8a12a9b5707702,0,0,0,0,0,0,0,0,0,0,0,0,0,0,626,29,0,0,0,0,0,0,0,0,0,100
ff6295e5faad8fcd449cbb2e2963dbdf7266a138,0,0,0,0,0,0,0,0,0,0,0,0,0,0,627,30,0,0,0,0,0,0,0,0,0,100
4986d22446b06d44e91a3ae17520bce96321803a,0,0,0,0,0,0,0,0,0,0,0,0,0,0,628,31,0,0,0,0,0,0,0,0,0,100
a8271029edfcccb0f8b079d885d3b04db7e86c11,0,0,0,0,0,0,0,0,0,0,0,0,0,0,629,32,0,0,0,0,0,0,0,0,0,100
4d990ac29e8d92290a28b23775f63d8194c16f1a,0,0,0,0,0,0,0,0,0,0,0,0,0,0,630,33,0,0,0,0,0,0,0,0,0,100
44e3c6516aaf7a013101027d88567ec6317ed153,0,0,0,0,0,0,0,0,0,0,0,0,0,0,631,34,0,0,0,0,0,0,0,0,0,100
8555544f11912c529cb3feabb09ca714df6ed52c,0,0,0,0,0,0,0,0,0,0,0,0,0,0,632,35,0,0,0,0,0,0,0,0,0,100
1b8afb16af907854bfa83b0c95a2f9eda1c75e0a,0,0,0,0,0,0,0,0,0,0,0,0,0,0,633,36,0,0,0,0,0,0,0,0,0,100
34e4ae4d8c7a779bdbdd3a47214c25217be11590,0,0,0,0,0,0,0,0,0,0,0,0,0,0,634,37,0,0,0,0,0,0,0,0,0,100
5bcc50cbfb09ce43dcea388a16cb11a61fc88043,26,682,973,291,0,0,0,5,28,1015,7,17,3.189797116,5675,98,0,669,629,40,39491,43983,4492,348,328,20,93.95981377
110f4153bd4a6cee447e7cb59014ac130b00d55d,0,0,0,0,0,0,0,0,0,0,0,0,0,0,99,1,0,0,0,0,0,0,0,0,0,100
85d82366bf489851a7e5e5e1c294d96f817ac98f,11,230,22,208,1,0,1,2,9,206,2,7,1.802641118,1226,169,1,201,185,16,9343,8272,1071,73,63,10,99.71817755
0ebfab7eae1d784109a95166c6a875bc9bed445b,0,0,0,0,0,0,0,0,0,0,0,0,0,0,0,0,0,0,0,0,0,0,0,0,0,100
23788597796aa23d70b68aa3f3d201199d7bf6e7,0,0,0,0,0,0,0,0,0,0,0,0,0,0,0,0,0,0,0,0,0,0,0,0,0,100
81591369501b82880987d09e5704d685d97aaf4a,2,42,8,34,0,0,0,3,20,236,1,2,0.995378439,630,35,0,73,72,1,5646,5490,156,39,38,1,100
26161f173241d1eaa056657422f72892a340fde0,0,0,0,0,0,0,0,0,0,0,0,0,0,0,29,0,0,0,0,0,0,0,0,0,0,100
b395f0ca183bc8fe2b3da6717b3c9428d9f8f4d0,2,115,16,99,1,0,1,1,11,276,1,2,0.996592553,105,30,1,27,16,11,1139,603,536,13,5,8,99.97648719
cbf6dc85c728aa1d3d93216e8980ad8a5626be38,0,0,0,0,0,0,0,0,0,0,0,0,0,0,0,0,0,0,0,0,0,0,0,0,0,100
9e2ce5e6f6b517203741529f9ea014fcb5bb87d0,2,26,0,26,0,0,0,4,17,737,1,2,0.706274089,454,0,0,37,36,1,4225,3954,271,27,27,0,100
fab8bace0e78cf1503bf19781be5f302db587938,8,325,81,244,0,0,0,5,25,444,2,4,1.97117308,1881,170,0,187,168,19,15714,14512,1202,107,94,13,99.67120714
007024fc6eb9516b6060f665bdf50a9ff00a2a15,5,134,27,107,0,0,0,5,26,0,1,2,1.389038426,1699,171,1,166,158,8,13556,12976,580,100,95,5,100
71c7470d1d54cf810bfc17f6f62be57d14af4875,4,0,24,24,0,0,0,5,18,446,2,3,1.548794941,879,100,0,120,123,3,6111,6314,203,53,54,1,100
d0d5417d22f359d5910d934c37175fa00213b694,3,129,56,73,0,0,0,4,10,513,1,3,1.166323847,1033,101,1,137,128,9,8530,7897,633,65,60,5,100
cc5eb1a3b6c94129680d1794d94e8e1783c6104d,0,0,0,0,0,0,0,0,0,0,0,0,0,0,102,2,0,0,0,0,0,0,0,0,0,100
ca909964cf0c61a205ce6dee2978ff19b4f13839,17,624,106,518,4,0,4,1,33,410,3,9,3.398281703,2832,103,3,416,343,73,24764,22005,2759,201,172,29,90.73151017
4906682f2f0b316bb6d2ddc102959df5eedeeddd,2,4,0,4,0,0,0,9,29,140,1,2,1,1297,104,4,168,168,0,9853,9826,27,98,98,0,100
2be034535c025daf71818f717bd784286e01dd65,13,239,217,22,2,0,2,5,30,195,5,10,3.188991211,4612,105,5,486,491,5,36971,36801,170,262,265,3,96.32021628
48d04f3053e3ab92c2aab6bd4e75cf4086efa154,2,437,19,418,0,0,0,4,9,254,1,2,0.406184597,543,36,0,64,52,12,8533,4785,3748,23,19,4,93.8547486
f7913f986f4394f19c71adf2371c6474ddac80fb,2,29,5,24,0,0,0,6,31,428,1,1,0.430551867,478,31,0,71,67,4,3644,3527,117,13,13,0,100
76cc9f5b5ee1f169399e51ba096842152defd1a9,0,0,0,0,0,0,0,0,0,0,0,0,0,0,32,1,0,0,0,0,0,0,0,0,0,100
9e2b831343974670057c24ea590cb942f2433be3,18,391,81,310,1,0,1,4,32,376,3,8,3.421593646,4259,106,6,616,574,42,33070,31132,1938,334,305,29,93.66262815
2eb336426eddae345060bf0b697f6971c685c497,10,797,500,297,2,0,2,1,28,135,2,4,2.345704783,1954,172,1,271,192,79,16660,14265,2395,157,104,53,99.92021701
ac80f0a712f38fc8f41b52816ce73db8507e7249,8,132,17,115,1,0,1,1,28,284,4,6,2.11196131,1178,173,1,170,156,14,9297,8717,580,91,83,8,93.50369872
3712540038306fa2e7899275a2282ec2faa32e12,2,76,1,75,0,0,0,4,16,834,1,2,0.922564137,440,37,1,53,48,5,4332,3573,759,26,24,2,100
025a014e63509383ee2c8d0cf72338fcd2a1f44d,10,51,16,35,0,0,0,4,30,55,5,7,2.963325558,3130,174,2,491,485,6,22761,22541,220,276,275,1,98.75740994
bcce97b7b83d0086bba113321c8bfff50f1b3e8a,6,121,28,93,0,0,0,1,30,9,1,3,1.782159179,1768,175,3,243,228,15,14815,14297,518,133,126,7,100
4a34946211477bf9fc7ae3771dd3ac3fd4c38eb2,4,57,11,46,0,0,0,1,9,1269,1,2,1.874309982,295,176,4,41,37,4,2108,1790,318,32,27,5,100
0ce10e34a4f58002b590d40070855259ecee14b1,9,169,43,126,0,0,0,1,23,123,2,6,3.027528565,1482,177,5,256,243,13,10959,9773,1186,131,122,9,93.49549792
b523cec5986a9c9b6700e34a3363178e58bfa3c8,2,259,0,259,2,0,2,1,1,0,1,2,0.992146525,0,38,1,15,0,15,1506,0,1506,10,0,10,93.37969402
56107628e8d725b86500ddab8037363ea0ae9360,6,215,0,215,2,0,2,10,58,278,4,6,2.001479167,2079,107,0,419,395,24,12981,11811,1170,317,298,19,99.94080739
fcac9b2c5c2e1bb406e6ffd412714485ae4d0a31,1,7,5,2,0,0,0,8,33,68,1,1,0,435,178,3,71,71,0,3212,3187,25,13,13,0,100
b07dbee0b9bccf877d351d6e596554fb76e894ca,14,911,37,874,6,0,6,10,59,210,4,11,3.139320752,3033,108,1,579,489,90,26382,20657,5725,420,367,53,96.13011778
4a44fb7873c59c549929e9899ee23b97b289daf8,0,0,0,0,0,0,0,0,0,0,0,0,0,0,1,0,0,0,0,0,0,0,0,0,0,100
c1e8a3c98a50c09d199949c5a7e95ba7a1a9c9e6,15,261,33,228,1,0,1,5,34,332,4,8,3.426237928,3873,39,1,446,431,15,32889,31334,1555,267,261,6,99.94667804
754a6b996114a4bb7a8fe9692a87290f10eb9285,2,36,11,25,0,0,0,1,2,20,1,2,0.850770704,279,109,1,33,28,5,2449,2311,138,23,20,3,100
6b8fcd35db605f249e8126051babc4ac2e539ba2,2,4,4,0,0,0,0,1,2,22,1,2,1,149,110,2,13,13,0,1277,1277,0,10,10,0,100
8a95b1fe4ebd8605480db300dc051eb404db2bb9,5,112,6,106,0,0,0,10,60,25,3,5,1.962907339,2067,111,3,395,383,12,12150,11493,657,314,304,10,100
64f469bec7f67f3f63b78e8abc6cce1dbd9fdeac,9,543,101,442,4,0,4,1,31,56,2,5,2.627310595,1765,179,0,246,215,31,16482,14637,1845,151,126,25,99.80814325
b7e4075939772b98e67ee34a37fb3c2129a7bdf0,5,149,16,133,0,0,0,10,35,59,2,5,1.91201092,2097,112,4,235,213,22,18323,17255,1068,116,109,7,99.94676887
69a74ce9c3ef509ab8fdb947bf110bb7f51c0aef,5,41,6,35,0,0,0,10,61,0,3,5,1.976332139,2149,113,5,399,395,4,12401,12150,251,317,314,3,100
df309fac77c04c23d586c3c7701afc60b4d8b339,3,94,13,81,0,0,0,10,36,46,1,2,0.895046891,1506,114,5,195,189,6,12179,11590,589,106,102,4,100
303645acc9dcad81984f7cdd9f26a736809aa6bb,0,0,0,0,0,0,0,0,0,0,0,0,0,0,0,0,0,0,0,0,0,0,0,0,0,100
e605d9c9d004f2926fa1fd271f9d09ea370df3bf,11,740,37,703,1,0,1,1,31,117,3,7,2.299584942,2290,40,0,304,274,30,23525,18119,5406,175,154,21,99.92547642
dd716eafc5da45ae39f85300ab62c63ef15ee55a,11,204,51,153,0,0,0,1,37,52,3,6,2.954822134,2093,115,6,296,266,30,17858,16728,1130,137,124,13,100
53849ac45757a8b915dec3ff912a5e7e7665f18a,25,545,52,493,2,0,2,10,62,28,5,12,4.012507667,7474,116,5,1237,1177,60,54931,51595,3336,758,728,30,99.94676887
b55e9ce16c46b630bf9295b011cdcfd2b250e5b3,3,215,2,213,0,0,0,3,8,1128,2,3,0.84255366,469,1,0,51,36,15,6122,4151,1971,34,24,10,99.98935944
2bd305d3aee25a5d15a78b3df310f552eaa87dd1,7,62,57,5,0,0,0,4,33,23,3,4,2.131692606,2917,117,3,390,389,1,24327,24280,47,209,210,1,100
b9d35381a62a3e31be966c6e19bbfd7c72151e00,0,0,0,0,0,0,0,0,0,0,0,0,0,0,118,2,0,0,0,0,0,0,0,0,0,100
8f70ba9a20d941ccab9510d298744d1f04bd71f2,1,37,1,36,0,0,0,9,39,27,1,1,0,554,119,3,107,96,11,4482,4184,298,21,20,1,100
8fd966f7fa2872701b79f6d9c48f7f234178b750,2,31,4,27,0,0,0,5,14,102,1,2,0.951762676,463,41,0,59,56,3,3364,3206,158,37,37,0,100
e46e50212ef05017d0b40d5242b346ac463d1e3e,0,0,0,0,0,0,0,0,0,0,0,0,0,0,120,1,0,0,0,0,0,0,0,0,0,100
3a615dac0eb8c29fab058326c9c5c8086d4fdacd,2,7,7,0,0,0,0,1,7,1170,1,2,0.591672779,399,121,1,65,65,0,3256,3268,12,37,37,0,100
deec67b4476618803f1051b3a40960335602a8bb,0,0,0,0,0,0,0,0,0,0,0,0,0,0,122,2,0,0,0,0,0,0,0,0,0,100
59c3a3d97e6a93f0cd6c712f3257cabba48a8d9c,3,33,6,27,0,0,0,3,16,81,1,1,1.306083003,576,123,3,72,69,3,5123,4884,239,29,28,1,100
ec66f35ae3619afee6b86b4c254e163a8d5328bc,2,78,60,18,0,0,0,2,3,150,1,2,0.615253891,223,124,4,16,15,1,1898,1552,346,11,10,1,99.93616342
ed5ec762e45a9b367af129d339b9a0d81de0e17a,2,181,5,176,0,0,0,5,10,254,1,2,0.365522253,869,180,0,73,64,9,9804,8533,1271,26,23,3,96.94514398
cb48e0f6c42bebd3b43e9fceaaf4e7b2a293ec76,1,4,7,3,0,0,0,8,34,76,1,1,0,374,125,5,72,72,0,2641,2641,0,20,20,0,100
1ef048fa2d6ad6de566b1435880e3fe998839f59,2,31,8,23,0,0,0,3,16,1530,1,2,0.999525689,439,0,0,69,64,5,3752,3587,165,26,25,1,100
5d55531be109bf3693e835e7091488690182b79c,2,6,0,6,0,0,0,10,40,119,1,2,0.650022422,1598,126,1,219,218,1,12675,12601,74,111,111,0,100
a821cf3c5eb61cd71d456f3dc5fa4da6d5a04dbd,12,240,15,225,1,0,1,4,41,112,4,7,3.001601756,3450,127,0,539,511,28,27997,26616,1381,284,267,17,99.94362386
a617d00192791090dbf0e69d8c1a46174f9d9d4e,2,28,6,22,0,0,0,4,25,175,1,2,0.522559375,1258,128,1,205,203,2,9419,9152,267,103,102,1,100
f60601fefbfb1209dfb6e74a9816227aa9765dfb,7,105,8,97,0,0,0,4,63,310,5,6,1.793816825,3776,129,2,631,617,14,25254,24560,694,430,424,6,100
875da32324a4d0beb2cb24e0553c3f622acd51ea,0,0,0,0,0,0,0,0,0,0,0,0,0,0,0,0,0,0,0,0,0,0,0,0,0,100
1cd7033782a95aa369d0496f5d2e386649efad40,2,8,3,5,0,0,0,10,43,4,1,2,0.994030211,1705,130,3,236,236,0,13589,13547,42,118,118,0,100
928a0c42098558e8cd951a641911d626543473d5,2,86,6,80,0,0,0,2,5,216,1,2,0.994538682,222,1,1,30,21,9,2793,2013,780,20,15,5,100
d14ba146714921d5f8bdd4b2b5fa44ddf2d66950,0,0,0,0,0,0,0,0,0,0,0,0,0,0,131,4,0,0,0,0,0,0,0,0,0,100
ddb75cfb8b067a426b529720f79cc8ecc73511c8,2,2,2,0,0,0,0,6,15,1285,1,1,1,356,2,2,19,19,0,2492,2492,0,13,13,0,100
7daacd2a582d65fab6cdda35d73df7f46b70efe9,7,535,41,494,0,0,0,5,11,609,1,5,1.641244955,1334,42,0,134,115,19,15266,11363,3903,59,51,8,100
c8e115bf6656e2444bb2d5e098a20dc21a1f65ed,1,8,1,7,0,0,0,7,19,1451,1,1,0,494,3,3,16,15,1,4020,3992,28,15,14,1,100
248d9aad876ed90d308002d24f1e7cc55111accb,2,177,52,125,0,0,0,7,35,1404,1,2,0.99932588,2724,132,5,477,459,18,22167,21319,848,154,145,9,100
06498732741ab7d7162cb85c4741b4e25187275f,2,81,3,78,0,0,0,4,21,1074,1,2,0.749595257,516,4,3,47,36,11,5597,5060,537,15,7,8,100
ba54cc3b7baeb0a4db500234953391da0be7b176,2,2,2,0,0,0,0,8,42,1121,2,2,1,680,5,4,142,142,0,5122,5116,6,48,48,0,100
4d8e28fad12b47d54d5f5f5cb9a6502b3a960d6c,1,1,1,0,0,0,0,4,18,50,1,1,0,173,6,5,0,0,0,1957,1957,0,0,0,0,100
8c135d42529df20d5bdb8fb3b43d06b224716a2c,0,0,0,0,0,0,0,0,0,0,0,0,0,0,7,3,0,0,0,0,0,0,0,0,0,100
a43b1ff1e304dcbcb90e277d998477fa3e5890d7,2,45,4,41,0,0,0,11,44,76,1,2,0.975525951,1709,8,4,241,236,5,13909,13589,320,121,118,3,100
3a2eabc6a7402da24724a607121f0ea0b78b6777,0,0,0,0,0,0,0,0,0,0,0,0,0,0,635,0,0,0,0,0,0,0,0,0,0,100
eecf3cad2626d0aaaa44f383e25f7a5fc931d9fc,5,269,29,240,1,0,1,7,21,301,2,5,1.317062111,763,43,0,137,134,3,7158,5383,1775,53,51,2,94.43722381
70f4800f2ad3a405776ac59be813e1e6520e47d9,6,6,12,6,0,0,0,2,35,1560,5,6,2.419381946,890,9,2,0,0,0,8593,8651,58,0,0,0,100
9ee06f3b6b0695afbeb02fe133871ec66600cd0b,2,62,17,45,0,0,0,11,45,44,1,2,0.994329046,1747,10,1,245,241,4,14239,13909,330,123,121,2,100
bd291f87239c05f3722bfe1796da22c17a7c5e02,2,31,5,26,0,0,0,11,46,0,1,2,0.41381685,1788,11,2,247,245,2,14464,14239,225,124,123,1,100
8080b28f5d71d037752362f511515e2d9e064cb2,0,0,0,0,0,0,0,0,0,0,0,0,0,0,0,0,0,0,0,0,0,0,0,0,0,100
762ba37f69f314f5463eeb5e7e8b8a4a28c8491c,6,89,1,88,0,0,0,10,64,504,5,5,2.226448352,2324,33,0,421,411,10,13630,13214,416,339,330,9,100
486abb0c3ad1d9ad6d3deb1af2dbe73da1968970,2,31,24,7,0,0,0,1,7,269,1,2,0.869892686,470,133,0,63,66,3,3694,3636,58,27,27,0,100
4307f89f857a36d157430c31ff68f20ca8636264,1,13,1,12,0,0,0,1,2,178,1,1,0,63,134,1,12,9,3,345,315,30,12,9,3,100
b83e3315ee3c099634cb2faee074faf8cdf7969d,0,0,0,0,0,0,0,0,0,0,0,0,0,0,12,0,0,0,0,0,0,0,0,0,0,100
312131f096608e3492d1e99b06487504edc7f975,5,89,21,68,0,0,0,2,8,72,2,3,1.844131858,831,13,1,127,122,5,6782,6234,548,78,72,6,99.95395242
a0cb4e9083b79abf0fb88af8545d7f6b76f1c88d,3,27,1,26,0,0,0,4,19,343,1,3,1.135815998,320,14,2,41,38,3,2492,2251,241,14,13,1,99.95393828
9518b438669125655b4a53e7586e862d7eaddd77,2,9,1,8,0,0,0,1,2,478,1,2,0.721928095,140,135,2,19,18,1,821,752,69,16,15,1,100
eb82cd9fda9ea9ebf6a026f50d5134445debff52,1,3,2,1,0,0,0,10,47,62,1,1,0,678,136,3,120,120,0,5165,5156,9,26,26,0,100
2a0a41637ff79a31062065456527b2a755dcfe9d,2,32,20,12,0,0,0,11,48,31,1,2,0.51594693,1813,137,4,252,247,5,14569,14473,96,126,124,2,100
0acdbe30f71b40ecd19288a0a9b0e4996186c67d,0,0,0,0,0,0,0,0,0,0,0,0,0,0,15,3,0,0,0,0,0,0,0,0,0,100
471496e87c00b38d74370136bb7fef3ba7dc9f15,3,3,0,3,0,0,0,4,47,2230,3,3,1.584962501,1044,44,0,192,192,0,8040,7997,43,66,66,0,100
8cf5f7d595311eb36e32ba8f710771bd3cd7b511,0,0,0,0,0,0,0,0,0,0,0,0,0,0,0,0,0,0,0,0,0,0,0,0,0,100
737074cd057a7c531683d40e87d573f30fd03fe1,0,0,0,0,0,0,0,0,0,0,0,0,0,0,0,0,0,0,0,0,0,0,0,0,0,100
321d6b163f8404f3fa97b18fa10856aaa22a478d,0,0,0,0,0,0,0,0,0,0,0,0,0,0,1,1,0,0,0,0,0,0,0,0,0,100
5dcb19f4bc4726b24fb941736ffedb202af594f3,1,0,6,6,0,0,0,4,26,219,1,1,0,574,138,3,111,112,1,3710,3741,31,53,54,1,100
6924df21aa76a9c658134db49075f5bdedef055d,0,0,0,0,0,0,0,0,0,0,0,0,0,0,45,1,0,0,0,0,0,0,0,0,0,100
69e36aec83a830f09eaf66c6b7438c0099ef9de2,0,0,0,0,0,0,0,0,0,0,0,0,0,0,46,2,0,0,0,0,0,0,0,0,0,100
d36f29ae0052f930394e52f9e169cf8e78ac54a9,3,50,24,26,0,0,0,5,11,441,1,3,1.048799641,810,139,1,72,66,6,7376,7164,212,33,30,3,100
d6e62f27e47910d78f6b425ebf96ec05f1e083ed,0,0,0,0,0,0,0,0,0,0,0,0,0,0,1,0,0,0,0,0,0,0,0,0,0,100
95b7787d2acd6181ff9c1a6df8f3f2a31a4a5b19,0,0,0,0,0,0,0,0,0,0,0,0,0,0,16,0,0,0,0,0,0,0,0,0,0,100
2575a52b7398895cfdfce06e3361344f576b9fd8,1,1,1,0,0,0,0,2,9,83,1,1,0,258,140,1,45,45,0,1783,1782,1,15,15,0,100
2c45bbd37a80a7c7030c5c0c52017171a93a4d73,3,213,3,210,1,0,1,1,22,511,1,3,1.259674427,409,47,1,79,71,8,4221,2869,1352,21,18,3,95.41123002
1013849f85fd110133bbbeb11022cbebeb4655d3,0,0,0,0,0,0,0,0,0,0,0,0,0,0,141,1,0,0,0,0,0,0,0,0,0,100
c87268bacc4536da69c4918e9abc2f6a83db1afe,0,0,0,0,0,0,0,0,0,0,0,0,0,0,142,1,0,0,0,0,0,0,0,0,0,100
86c1a96259604d33104a96259d4ce3e921bdc9bb,3,38,0,38,0,0,0,2,9,599,1,1,1.432983121,327,143,2,50,45,5,2786,2529,257,25,22,3,100
188df42622ab6aa6b4ad7a42a5a77d6fd14594f3,2,17,0,17,0,0,0,3,8,3197,1,2,0.977417818,206,34,0,43,41,2,1350,1272,78,16,14,2,100
ac8d8f085ea7d8d70217b8142a7a0434c4709915,3,36,1,35,0,0,0,1,23,96,1,3,1.500154201,569,48,0,80,79,1,4551,4221,330,21,21,0,100
823d4aeec02c75620ce7ac082fe2e9ddf8afb291,0,0,0,0,0,0,0,0,0,0,0,0,0,0,17,0,0,0,0,0,0,0,0,0,0,100
cd8849314b5d2a516d353554f9a1d140a36a58cb,69,587,819,232,0,0,0,3,48,2423,21,33,5.232832347,18087,18,1,1756,1784,28,142827,142671,156,797,826,29,94.68761691
cd0d5b7a6cfea4bf75681bc4c190def76f69b137,17,161,56,105,0,0,0,5,49,1601,5,11,3.336739561,6454,144,0,995,985,10,48228,47527,701,382,373,9,100
7f05d4962da43ec11151f4a772da4e5bc74805be,0,0,0,0,0,0,0,0,0,0,0,0,0,0,0,0,0,0,0,0,0,0,0,0,0,100
d772f41b846daedac7d5d9a49c8d47eacbde755d,1,1,1,0,0,0,0,3,5,38,1,1,0,58,19,1,7,7,0,345,345,0,3,3,0,100
3a18b13aeb729e98807e21d0efaac54c5483193e,5,52,12,40,0,0,0,10,65,176,3,5,1.811718758,3196,145,1,546,538,8,20200,20061,139,373,368,5,100
242aed4e29887197b378ddb8cbf5a466f46af3a5,0,0,0,0,0,0,0,0,0,0,0,0,0,0,49,0,0,0,0,0,0,0,0,0,0,100
1877e776bea8ea93a61c3951ec961e5901d63fc5,0,0,0,0,0,0,0,0,0,0,0,0,0,0,20,0,0,0,0,0,0,0,0,0,0,100
9407018829fb7b0fcb2aad33bd470b29bf3f9132,0,0,0,0,0,0,0,0,0,0,0,0,0,0,146,0,0,0,0,0,0,0,0,0,0,100
624a62ec1a41fdb4f7fb2858a4b9c665cc769874,0,0,0,0,0,0,0,0,0,0,0,0,0,0,21,1,0,0,0,0,0,0,0,0,0,100
67e7dd3589d562cf87536417c57aa1ff8dbf4ced,15,82,162,80,1,0,1,3,36,2041,6,11,3.284405858,5031,22,0,490,497,7,36141,36875,734,199,203,4,98.8301512
50892c4bc6a1ffef13c46c9bf0af6384097c7835,0,0,0,0,0,0,0,0,0,0,0,0,0,0,147,0,0,0,0,0,0,0,0,0,0,100
828c29fc2de40e67b78f26aea350c93ff62dd2ba,0,0,0,0,0,0,0,0,0,0,0,0,0,0,23,1,0,0,0,0,0,0,0,0,0,100
52b9eb7c098a1855f750511274c9b7d7d86856fc,3,59,0,59,0,0,0,2,21,1432,1,3,1.107000715,1203,148,1,168,160,8,8906,8503,403,125,121,4,99.96743732
87502b3adca5d162b77e4aa057ad36777a82151b,0,0,0,0,0,0,0,0,0,0,0,0,0,0,149,2,0,0,0,0,0,0,0,0,0,100
ca202894f3e83b4e49f131b320a656f7732d8c5d,1,1,2,1,0,0,0,4,7,177,1,1,0,255,50,0,13,13,0,2190,2190,0,8,8,0,100
c04efbeecc4831ec1b7075cfc7ca06527ef67897,2,34,6,28,0,0,0,5,45,142,1,2,0.769192829,1223,150,3,164,160,4,9765,9613,152,65,63,2,100
2426bd493feef9fd6d3f3041cfbaea7503e4c15e,14,111,33,78,0,0,0,6,49,642,6,10,3.116789372,5390,151,4,664,654,10,44777,44176,601,345,339,6,100
4073660cc307fe3f769ddd3f521d15a3b50293ec,3,89,4,85,0,0,0,3,20,1280,1,3,1.002740651,550,51,1,76,72,4,4876,4210,666,43,41,2,96.67638484
a29223a58c96947bfa8e4d61bc0f9d558198bfe1,23,697,89,608,2,0,2,3,66,1178,7,10,2.851762539,5125,152,3,912,822,90,36020,31998,4022,554,498,56,99.61069949
fcaf700a205b9faa3b02b5faf1243d702c09efcc,4,166,10,156,0,0,0,5,21,496,2,4,1.205138566,1025,52,0,116,109,7,9726,8642,1084,71,67,4,100
197e92a7b8be6d3de0fbfeab8c45c10507edd0d3,1,1,3,2,0,0,0,3,3,3717,1,1,0,49,53,1,5,5,0,217,217,0,2,2,0,99.98748122
db03ec34f18287f8bc833e881e445fabd480dfa2,0,0,0,0,0,0,0,0,0,0,0,0,0,0,1,0,0,0,0,0,0,0,0,0,0,100
df6dd3afc2726b03e66f2c7f74dfb079652364b1,0,0,0,0,0,0,0,0,0,0,0,0,0,0,181,0,0,0,0,0,0,0,0,0,0,100
ed91811f811ef15c25bc8d5c8ea75facd4490026,18,1212,41,1171,13,0,13,1,12,827,4,8,3.72712139,450,24,0,179,37,142,9842,2715,7127,102,18,84,94.77140692
848689b0b0e8c6a969dd5bdd2f85d40cf4047a73,3,51,9,42,0,0,0,11,50,331,1,2,1.200435784,1897,153,0,259,252,7,15460,15149,311,128,126,2,100
5b4040ffeb6c0fee7a69b87ae83b54077b0c634e,4,92,5,87,0,0,0,2,51,276,2,3,1.658578374,2041,154,1,310,292,18,16553,15871,682,165,159,6,100
cbae31d384f2343f9af4f1851f2fae60c82b8e56,6,511,4,507,5,0,5,1,12,588,2,3,2.200329689,288,54,0,87,60,27,4772,1757,3015,47,26,21,99.7965412
87f80c9f358175c1f4970d082ca5ba80edc84dec,0,0,0,0,0,0,0,0,0,0,0,0,0,0,0,0,0,0,0,0,0,0,0,0,0,100
69a92c2d33d467b855a397444a103e82f7e566de,19,305,133,172,0,0,0,2,52,533,6,11,3.550360263,5938,155,2,823,785,38,48913,47755,1158,418,400,18,92.75400715
17130f451a7165d1e3b1d767c09c1bbf23451f94,2,18,2,16,0,0,0,4,13,64,1,2,0.970950594,298,25,0,44,43,1,2212,2065,147,17,16,1,93.63137434
f324039c9241d9bb2ba7a50369c46e6144f18812,0,0,0,0,0,0,0,0,0,0,0,0,0,0,0,0,0,0,0,0,0,0,0,0,0,100
4fa244ff37ef3cccb366d821a798c0db37bbd31e,0,0,0,0,0,0,0,0,0,0,0,0,0,0,1,0,0,0,0,0,0,0,0,0,0,100
68d44a4e38bd7256f7aaa4d5ee1237d1421d27d0,0,0,0,0,0,0,0,0,0,0,0,0,0,0,0,0,0,0,0,0,0,0,0,0,0,100
2ddfecef996e59ab33e3c578d9ae11ef041164d1,0,0,0,0,0,0,0,0,0,0,0,0,0,0,1,1,0,0,0,0,0,0,0,0,0,100
c4699b994f5d020c6613970595f8b4048d892426,10,343,310,33,0,0,0,7,53,291,4,8,2.884808535,4029,26,0,533,526,7,32197,31900,297,301,290,11,93.50272653
a7eed67f81799f2bba24d7f22aeb49a893d6a526,4,40,36,4,0,0,0,3,22,849,1,2,1.78604754,1105,55,0,132,132,0,8426,8457,31,70,70,0,93.38103757
0eaaabfeb71345379d76f71754fa064d2dba5e1c,4,44,0,44,0,0,0,2,24,1980,1,4,1.646010461,389,56,1,53,48,5,2980,2640,340,14,12,2,99.95397538
c16d597996990ba3afe443c2aebea54cd925a1c9,3,46,17,29,0,0,0,3,6,2814,1,2,1.40898093,274,27,1,48,43,5,1848,1576,272,32,29,3,100
0b6bf4f852aa9c0f5806d9ba4f3bcb6a62798900,9,142,41,101,2,0,2,1,54,426,3,5,2.325385124,4059,156,0,603,596,7,31213,30997,216,281,275,6,98.49162011
69bfd417263e62dd37d69979b627561aa2198573,5,41,0,41,0,0,0,10,67,313,3,3,2.183918229,3417,157,1,569,565,4,23300,23046,254,373,369,4,100
c60ad2e5a33ce5b83b39366209c82d1372315ba4,0,0,0,0,0,0,0,0,0,0,0,0,0,0,2,2,0,0,0,0,0,0,0,0,0,100
3163401292d0640a6ade44d77cbefce1db8d9f10,2,32,51,19,0,0,0,2,7,770,1,2,0.626177654,371,28,2,39,39,0,3062,3199,137,24,24,0,100
2c7140ed4e4231134f0a91f5c99fcfe321e8611f,1,6,0,6,0,0,0,10,55,39,1,1,0,808,158,2,151,150,1,6331,6270,61,30,30,0,100
08ba70c4cc16c7c74f9f792aa779f6dcb18392ae,3,16,7,9,0,0,0,6,25,516,2,2,1.214295263,4176,159,1,222,222,0,32907,32821,86,114,114,0,100
d5f0c377812a96df356681e924be983bbc00608c,0,0,0,0,0,0,0,0,0,0,0,0,0,0,57,0,0,0,0,0,0,0,0,0,0,100
3b63b9851937b484546d974612e6ddd3ceaabbc9,6,163,17,146,0,0,0,10,68,177,4,5,1.756491617,3626,160,2,625,600,25,23298,22478,820,456,444,12,100
5b6f389dffb9319f13a707b2f38340ec3682a612,0,0,0,0,0,0,0,0,0,0,0,0,0,0,29,0,0,0,0,0,0,0,0,0,0,100
1b177a2638126afb5280ad5c113e901e42fec375,3,74,4,70,0,0,0,3,14,1370,2,3,0.969431155,418,30,1,55,51,4,3251,2738,513,26,23,3,99.98914459
7ac870f16563eda499b7eafa072bb119f4cd5754,4,181,54,127,1,0,1,3,27,2070,1,2,1.772647181,1035,31,2,175,162,13,7568,6830,738,114,104,10,99.95662076
b15685c953f8e7763cd4770b8457d263951eca66,1,2,2,0,0,0,0,4,6,1712,1,1,0,98,161,3,3,3,0,808,808,0,3,3,0,100
fc48add49a0c6015247b71ca118c90fb6dde347f,1,2,2,0,0,0,0,5,11,21,1,1,0,245,32,3,57,57,0,1257,1257,0,57,57,0,100
8c468b095128ef9dd83e08d80e45a4c3db2ff44d,7,89,6,83,0,0,0,3,56,139,4,5,2.258804068,2882,33,4,415,409,6,22590,22050,540,193,191,2,96.13830798
93bceed9c33d8e63cb48bdac86d9bc98fca44f90,14,281,16,265,1,0,1,3,16,1661,5,7,3.037632428,1709,58,1,257,228,29,14347,12633,1714,125,113,12,94.39456131
e2bfa1535317186c3e7b69de188f998aeb864431,3,63,29,34,0,0,0,4,22,1812,1,2,0.697770135,693,34,3,81,77,4,5079,4738,341,46,44,2,100
ce523efddab377a6a2067f88f4b587064914a4d2,0,0,0,0,0,0,0,0,0,0,0,0,0,0,3,0,0,0,0,0,0,0,0,0,0,100
641d0a4cd6ee21fbf303af3dd21e5b91753318f1,0,0,0,0,0,0,0,0,0,0,0,0,0,0,4,1,0,0,0,0,0,0,0,0,0,100
53d9456dc7ad725c30b73b38a52a751b55ae0dbb,1,1,2,1,0,0,0,6,12,69,1,1,0,353,162,0,69,69,0,2503,2503,0,19,19,0,100
02763cae0f3f148f089d7807e49184169d2d258f,0,0,0,0,0,0,0,0,0,0,0,0,0,0,0,0,0,0,0,0,0,0,0,0,0,100
6cdd2f0589e44bb464cf03f4e6848b059fd9c113,10,147,44,103,0,0,0,1,11,1149,2,4,1.475196343,1373,163,1,280,67,213,6488,2028,4460,244,56,188,99.56156833
aa8e1531f970d5477d60f7ea2c669657b5bf077a,2,178,28,150,0,0,0,8,38,781,1,2,0.870346055,2827,35,1,499,477,22,23187,22146,1041,162,154,8,100
31485649e6ea11921b97dbbce5672d5eef5bf0b9,2,20,2,18,0,0,0,2,3,2865,1,2,0.994030211,130,0,0,15,12,3,938,813,125,9,8,1,100
50a0552dc428069f396fe4926f4bff0e97372cfc,5,87,18,69,1,0,1,4,4,1743,1,3,2.08618095,310,164,2,51,46,5,1976,1706,270,35,30,5,99.94990607
d972cbbc9442a8d88003926482a83fdf41629eb7,0,0,0,0,0,0,0,0,0,0,0,0,0,0,0,0,0,0,0,0,0,0,0,0,0,100
3b365bfc868d8428f6a69dd73070d9321903102f,0,0,0,0,0,0,0,0,0,0,0,0,0,0,1,1,0,0,0,0,0,0,0,0,0,100
262ba6f29762f05239de762e42bd5d065b6f461f,0,0,0,0,0,0,0,0,0,0,0,0,0,0,2,2,0,0,0,0,0,0,0,0,0,100
295a041a728444d1a1ee7b82104dfe387a704929,0,0,0,0,0,0,0,0,0,0,0,0,0,0,5,0,0,0,0,0,0,0,0,0,0,100
52c586587c512fa5a72eb12f2df7dfa4ac8f5ec2,0,0,0,0,0,0,0,0,0,0,0,0,0,0,6,1,0,0,0,0,0,0,0,0,0,100
167bc5268fcfc3418faeddbaea06ce4decf926c2,0,0,0,0,0,0,0,0,0,0,0,0,0,0,7,2,0,0,0,0,0,0,0,0,0,100
9bd8afab5cca536a3a2831477035f5c03f41fa35,0,0,0,0,0,0,0,0,0,0,0,0,0,0,3,3,0,0,0,0,0,0,0,0,0,100
43f4723ea2cce745c4916721155cb962dd04e855,12,58,57,1,0,0,0,5,12,1256,3,7,3.148234958,2396,59,0,170,167,3,21832,21767,65,77,77,0,100
13da40cdb66c159ccd65637164f193935ce9681c,0,0,0,0,0,0,0,0,0,0,0,0,0,0,4,4,0,0,0,0,0,0,0,0,0,100
d0726adc704aabee5475875496eb5ea1421792cd,0,0,0,0,0,0,0,0,0,0,0,0,0,0,5,5,0,0,0,0,0,0,0,0,0,100
c65a01daca72091d0b6398e0024d7c9274a74b10,0,0,0,0,0,0,0,0,0,0,0,0,0,0,6,6,0,0,0,0,0,0,0,0,0,100
f6d190d7a1339eef199e26d9b053fedbb9dc4dcb,2,46,22,24,0,0,0,2,4,32,1,2,0.873981048,146,1,1,15,15,0,1124,938,186,10,9,1,100
40139df79cf5434417237d115984a341236c1a37,2,11,3,8,0,0,0,7,17,1589,1,2,0.591672779,365,0,0,44,44,0,2636,2572,64,17,17,0,100
32ecc76be4bb4e1728fb9acf537a5a619dfcd7ef,1,1,1,0,0,0,0,7,13,1,1,1,0,85,1,1,0,0,0,739,739,0,0,0,0,100
4366185351eb0dfa40d1ccac4a0766bf707bd440,0,0,0,0,0,0,0,0,0,0,0,0,0,0,2,2,0,0,0,0,0,0,0,0,0,100
120915227d1b44e30ac8f0d9924675c854b8ce4a,2,39,11,28,0,0,0,11,57,172,1,2,0.998845536,2174,165,0,312,306,6,17768,17636,132,147,145,2,100
ae0fe4606e56aa5ccccb63714504c6951e3bb1c0,1,1,0,1,0,0,0,6,12,1074,1,1,0,64,166,1,9,9,0,475,466,9,3,3,0,100
82cd96d99398cc9aad86596fb65240ccd0244498,6,373,0,373,2,0,2,10,69,439,3,6,2.059059946,2362,3,0,455,412,43,16360,13860,2500,366,336,30,99.93744526
07cd031e1ee2e6be14308749d61cb5a495a6fe11,6,28,0,28,0,0,0,11,70,984,3,6,2.159534726,3018,0,0,483,480,3,19531,19397,134,367,364,3,100
d51173a83e364d6eacf19d9ac8823ea2afb807f5,6,90,48,42,0,0,0,7,71,178,4,5,1.836415356,3621,1,0,621,614,7,24309,23977,332,414,413,1,100
255ca75236a415e72ff506546135a660708bf6a3,2,21,15,6,0,0,0,5,16,250,1,2,0.710676854,352,36,0,53,53,0,2533,2513,20,20,19,1,100
5121758bc86d53c7a41314486be1d5d9b5e074a4,0,0,0,0,0,0,0,0,0,0,0,0,0,0,37,1,0,0,0,0,0,0,0,0,0,100
28159cfb26c289ca87701c633be643cdbf2b4357,0,0,0,0,0,0,0,0,0,0,0,0,0,0,167,0,0,0,0,0,0,0,0,0,0,100
78a058900f17078ea3278cc41bf8cc9540ed4415,15,662,285,377,4,0,4,1,38,1286,5,8,2.772756656,2187,4,0,210,182,28,20527,17710,2817,107,95,12,94.30350012
66012400d4bf1e850e80d17709b8ab6a07f91a07,13,448,83,365,2,0,2,4,72,8,5,11,2.509700965,4136,5,1,648,608,40,30374,27941,2433,458,437,21,99.92252352
2deaf375b9f7869b3e72982397eec34785378c40,2,5,7,2,0,0,0,5,25,607,1,1,0.811278124,388,60,0,52,52,0,2752,2765,13,13,13,0,100
32f14e4709320c9dd1f10ebbb1a6846b33c2541e,9,163,205,42,0,0,0,11,73,1,3,8,2.508917059,3727,6,2,515,519,4,25741,26347,606,393,396,3,100
d63507868b1ebef8b1337650a0346250647d47f6,5,383,0,383,4,0,4,3,7,607,2,4,1.772084878,69,168,1,51,12,39,2389,357,2032,27,6,21,98.44321388
eaa77e33ef0c8c883cc220e18ded06ef6789e7d9,6,159,4,155,0,0,0,5,34,913,2,4,1.509627037,1906,169,2,198,175,23,18333,17388,945,100,91,9,95.73603003
71e073fbf94bbeeb62ad087f90a9e4968aac107e,7,138,63,75,0,0,0,1,40,6,3,5,2.048305848,2133,7,3,190,181,9,18892,18442,450,88,85,3,100
b7f9f2149333460f4e870ccc1ed23717d4ef0ad5,2,178,0,178,2,0,2,1,1,0,1,2,0.984554353,0,170,3,15,0,15,732,0,732,8,0,8,99.94497634
c6fb098ef1b4c4dd2806b52a2bbe5a6904e97927,2,1,8,7,0,0,0,7,26,206,1,2,0.918295834,293,38,0,37,37,0,2073,2108,35,6,6,0,100
428804e518d3b0078b32dd34df39d43a98602b7e,2,44,0,44,0,0,0,3,22,2084,1,2,0.976020648,928,35,0,126,122,4,8967,8685,282,87,84,3,100
634a25d343d70c54be1efcf7064195d12f5a5550,2,8,0,8,0,0,0,5,11,2712,1,2,0.811278124,153,39,1,17,16,1,1113,1024,89,13,13,0,97.24571429
3b0c1bbcc1456b872dc32eadb556085d4dbb5b97,2,5,5,0,0,0,0,8,39,268,1,2,0.970950594,2968,40,2,499,499,0,23187,23187,0,162,162,0,100
f4c2981ea22f9fea28c90a5b33cecdd95561918e,2,32,3,29,0,0,0,11,58,150,1,2,0.822404226,2193,171,3,319,312,7,18058,17768,290,150,147,3,100
e46ec513a2f1d8a14fd4e08cb8a868b05756c5bc,2,24,3,21,0,0,0,3,27,727,2,2,0.825626526,1167,172,1,179,177,2,10732,10524,208,25,24,1,99.95240928
14f57546c12912d99c33da574ef387b2b501138d,1,5,5,0,0,0,0,10,59,42,1,1,0,827,173,1,156,157,1,6458,6468,10,30,30,0,100
7496c39dc72d7eba4643d7167eab1aafafc9685d,4,12,12,0,0,0,0,2,24,1309,1,3,1.918295834,1433,174,2,199,199,0,10243,10238,5,147,147,0,100
a73608cbd61d3801760ce514c193329d641bb4f0,2,8,0,8,0,0,0,7,60,310,1,1,0.811278124,898,175,3,156,156,0,7076,7015,61,30,30,0,100
d8d46d9737c9038b071a2b39809c18fc92e20f19,0,0,0,0,0,0,0,0,0,0,0,0,0,0,41,0,0,0,0,0,0,0,0,0,0,100
c47a425a6a70669134716ce552a7cca4abb12dbe,10,113,6,107,1,0,1,3,74,1963,5,6,2.237089427,3448,8,0,725,711,14,22700,22100,600,430,420,10,95.05975114
b8a0185d886f87dd5d5f7305c8b9fdff66c50f52,11,22,20,2,0,0,0,3,8,3452,10,9,3.410905972,611,176,3,69,69,0,3112,3112,0,37,37,0,99.88504279
29efc4149d461938bc4c517bec07b95e704ef5aa,0,0,0,0,0,0,0,0,0,0,0,0,0,0,177,4,0,0,0,0,0,0,0,0,0,100
2a4bba1638fdae3c39da1c424bd32da501afae0e,2,34,1,33,0,0,0,11,33,142,1,2,0.863120569,1013,36,0,113,109,4,8609,8414,195,51,49,2,100
812fd52e9af3cb3b86f60adc5791ea6d21808c3a,1,7,1,6,0,0,0,7,20,52,1,1,0,709,61,0,169,167,2,5465,5436,29,40,40,0,100
070ccf3cc62761c33b41dfee7679f22e58357a46,22,1824,19,1805,10,0,10,3,75,848,6,12,3.592287952,3259,62,1,718,554,164,30359,18769,11590,491,396,95,98.09866393
ccddcc8df1b4676c692fc1b1bd4093e4ffcef2c2,5,20,2,18,0,0,0,7,61,435,2,4,2.170134892,1715,178,0,225,225,0,14611,14353,258,62,62,0,100
693455fc9ba6da6f7a01cb9cca90d2005634d586,2,20,2,18,0,0,0,4,14,4002,1,2,0.976020648,457,42,0,47,46,1,2618,2518,100,33,32,1,100
ebac40dd4992d0e7fd7bd1ebf622a041dad2679c,8,81,43,38,0,0,0,2,62,670,3,7,1.573724189,2862,179,1,394,391,3,22812,22450,362,180,178,2,95.37843269
a2a8adc3bc7c1aced84347ff181f62b4486d9d37,0,0,0,0,0,0,0,0,0,0,0,0,0,0,9,0,0,0,0,0,0,0,0,0,0,100
258c4e45c11b16dc49be039134a61ba743aa2095,7,287,79,208,1,0,1,3,18,681,5,5,1.316351791,782,10,1,166,153,13,8552,6596,1956,61,57,4,93.81467004
38d0c329e7920915b6879c7a6820211c9b06d575,0,0,0,0,0,0,0,0,0,0,0,0,0,0,2,0,0,0,0,0,0,0,0,0,0,100
35a0106f996e8cc77dd0669ccfbfbe91cf90e121,0,0,0,0,0,0,0,0,0,0,0,0,0,0,180,0,0,0,0,0,0,0,0,0,0,100
6d3f960b54fee520b2311f614a073cc8c2592403,26,1163,266,897,8,0,8,4,76,1042,4,13,3.988497672,5323,43,0,821,694,127,42221,35382,6839,555,471,84,99.65753425
daa8384d1c08d9e632b7e87ceed732fbc4bbea5e,0,0,0,0,0,0,0,0,0,0,0,0,0,0,182,0,0,0,0,0,0,0,0,0,0,100
1cc8cc6700d3012ee7e937c9c14463dbcdc7993d,6,403,0,403,6,0,6,1,1,0,1,2,2.55704764,0,0,0,33,0,33,1824,0,1824,27,0,27,99.85361569
b35270dca76416ce44523923a2a7f7bb39402fff,1,2,0,2,0,0,0,2,2,113,1,1,0,121,181,1,4,4,0,1283,1271,12,4,4,0,100
041aebf26e8d8b4c0a3fba367688b4447085e4a6,1,2,3,1,0,0,0,3,3,0,1,1,0,123,44,1,4,4,0,1299,1283,16,4,4,0,100
616a4e06e8c24c6ba65250d4f853851d6a7d81b9,12,211,43,168,0,0,0,12,77,36,3,7,2.94024934,4249,45,1,691,673,18,29280,28278,1002,469,460,9,100
811888face674bf94ab58b0743d29a3927d65a56,1,1,1,0,0,0,0,1,3,3,1,1,0,153,46,2,23,23,0,965,965,0,15,15,0,100
e2a4779345f1c039e2411f2eb573990b85d1e00f,0,0,0,0,0,0,0,0,0,0,0,0,0,0,11,0,0,0,0,0,0,0,0,0,0,100
a2e679024d5e3b5aaaa38c32cc3b96358af5e559,0,0,0,0,0,0,0,0,0,0,0,0,0,0,12,1,0,0,0,0,0,0,0,0,0,100
618e7e10db2076c4de4aca19112c2f6deb8bfc09,2,34,15,19,0,0,0,2,8,794,1,2,0.591672779,334,182,1,37,35,2,3246,3126,120,23,23,0,100
096def73176ed40e73e69bce627975cf686eed7c,0,0,0,0,0,0,0,0,0,0,0,0,0,0,7,0,0,0,0,0,0,0,0,0,0,100
bc8fac953228c28d9aec57b2a3f44de3bc16451f,0,0,0,0,0,0,0,0,0,0,0,0,0,0,2,0,0,0,0,0,0,0,0,0,0,100
835acd72b81c80f45fdbca7448fe9164fe3e5259,0,0,0,0,0,0,0,0,0,0,0,0,0,0,8,1,0,0,0,0,0,0,0,0,0,100
b8fc2c7989c0a4702fc5c1836d0e2988df5e958e,6,135,3,132,0,0,0,5,78,584,5,6,2.031379001,3663,47,3,611,595,16,30672,29769,903,444,437,7,100
1a620f90f2552a3644706952b09fc53d0249e8be,0,0,0,0,0,0,0,0,0,0,0,0,0,0,13,2,0,0,0,0,0,0,0,0,0,100
3493d7520969434f31979aa88ddec7cc29dec7fe,0,0,0,0,0,0,0,0,0,0,0,0,0,0,183,2,0,0,0,0,0,0,0,0,0,100
2e1155f96288fbc0a7302ea9cee0a67cdae99037,0,0,0,0,0,0,0,0,0,0,0,0,0,0,9,2,0,0,0,0,0,0,0,0,0,100
2227873b1eb8e6c45a3908aab7735c1c348eded0,0,0,0,0,0,0,0,0,0,0,0,0,0,0,0,0,0,0,0,0,0,0,0,0,0,100
6a4d5dfb4cca531a3adda0e6330cc806d0192249,28,848,360,488,4,0,4,1,63,1323,13,18,3.831556053,5846,184,0,742,708,34,52255,47803,4452,327,306,21,94.36361677
5fcd049127ea275d4819a780ec0fcc4c9d4862b9,0,0,0,0,0,0,0,0,0,0,0,0,0,0,185,1,0,0,0,0,0,0,0,0,0,100
bf7abca058f1614756aa928ddada8860d9b1677c,0,0,0,0,0,0,0,0,0,0,0,0,0,0,186,2,0,0,0,0,0,0,0,0,0,100
f9f336ab949f967bdd1fcd46b7d87501bc4c74cb,1,3,1,2,0,0,0,5,10,1987,1,1,0,429,63,0,87,87,0,3154,3142,12,27,27,0,100
5a70e628a74de26cf4b2370443777cd58abe64bf,0,0,0,0,0,0,0,0,0,0,0,0,0,0,187,1,0,0,0,0,0,0,0,0,0,100
642b224b1de74c3b7f0fbea28cc4b4f1bf826f6d,2,5,4,1,0,0,0,11,34,292,1,2,0.764204507,1037,48,0,113,113,0,8629,8609,20,51,51,0,100
481c8db838884ba9842fc1f7d3f0f4cd83a96164,2,48,4,44,0,0,0,5,13,626,1,2,0.391243564,1322,64,1,93,89,4,13624,13427,197,33,31,2,100
359f12a1a1f5f0e3386ca9838d5409caf763fa14,2,11,3,8,0,0,0,3,9,2945,1,2,0.985228136,462,14,0,68,67,1,3242,3168,74,36,36,0,100
dfde5c7417cfd111478df30c29f556fd31a2a7d8,0,0,0,0,0,0,0,0,0,0,0,0,0,0,3,0,0,0,0,0,0,0,0,0,0,100
fb685178890a5db337e7e69392ab4efc04ecf770,13,156,66,90,0,0,0,2,79,1169,5,11,3.108283369,5704,188,0,941,928,13,38736,37960,776,598,596,2,100
6e38c795647505c8892ac427432d6de9b242c6d7,0,0,0,0,0,0,0,0,0,0,0,0,0,0,10,0,0,0,0,0,0,0,0,0,0,100
ac3e28fe92b69f7f2e282805dc5f1d3f9add88bf,0,0,0,0,0,0,0,0,0,0,0,0,0,0,11,1,0,0,0,0,0,0,0,0,0,100
93ed57d5d71a6fc3d3c5e95c3cb7eafa483392db,0,0,0,0,0,0,0,0,0,0,0,0,0,0,12,2,0,0,0,0,0,0,0,0,0,100
f3c9f9baeaf420de4f4c591451742e0bd5b91dda,0,0,0,0,0,0,0,0,0,0,0,0,0,0,13,3,0,0,0,0,0,0,0,0,0,100
f555baaf3d8e78a089fd83dda2c8976e305ae016,0,0,0,0,0,0,0,0,0,0,0,0,0,0,14,4,0,0,0,0,0,0,0,0,0,100
5cbf11a4c75a25d96b2b06303ee23ce61cd6ba68,0,0,0,0,0,0,0,0,0,0,0,0,0,0,15,5,0,0,0,0,0,0,0,0,0,100
58328b6bddd9c39abf790a36d8ea5cb343cb1754,4,201,1,200,2,0,2,1,43,257,1,2,1.272111043,925,49,1,81,66,15,9236,8271,965,43,34,9,99.95180723
dd8b0e700a8d0058a18703ab419495850f33b4cb,0,0,0,0,0,0,0,0,0,0,0,0,0,0,183,0,0,0,0,0,0,0,0,0,0,100
e9b3d9e5005d2bd40f5013b508a84a14c8ea31f8,4,67,24,43,0,0,0,2,13,1855,1,3,1.554394126,843,189,1,112,108,4,6495,6138,357,36,35,1,99.96387718
49983cb3b49655488487e13da40191a73ff6589a,3,10,6,4,0,0,0,3,19,710,2,2,1.298794941,806,50,1,125,125,0,6232,6188,44,20,20,0,100
c5590282608ab185808f5a45bba21c07500361e6,2,28,1,27,0,0,0,3,20,269,1,2,0.362051252,360,65,0,36,35,1,3316,3020,296,15,14,1,100
aa22316072d77efa43729a2a7a07b06964dfc053,0,0,0,0,0,0,0,0,0,0,0,0,0,0,51,2,0,0,0,0,0,0,0,0,0,100
383e045269537b39a23afeff545845bd8f43f8c6,1,46,37,9,0,0,0,3,7,1935,1,1,0,187,52,2,11,11,0,1892,1839,53,8,8,0,100
bfcbcda46e76081d693a40782d185f53edb0f4a2,0,0,0,0,0,0,0,0,0,0,0,0,0,0,53,3,0,0,0,0,0,0,0,0,0,100
c06874cc819cddd422cc30f227cf0282c402c970,2,33,3,30,0,0,0,8,40,480,1,2,0.88797632,2968,190,1,502,499,3,23498,23187,311,163,162,1,100
e5427b1a3aea9f31cfb521e2d9845226169570d1,1,1,0,1,0,0,0,6,15,185,1,1,0,304,54,2,47,47,0,2069,2062,7,14,14,0,100
3408180ff63afb5c79eacb2c9657c2162c557aeb,0,0,0,0,0,0,0,0,0,0,0,0,0,0,184,0,0,0,0,0,0,0,0,0,0,100
6512cc8703385d7daebfbd434b6638eed1b609dc,4,62,12,50,0,0,0,2,2,2940,1,2,1.559326195,774,55,1,114,110,4,7101,6637,464,45,43,2,100
d5943c6d0bb29cf9f82882fca80c1fd64b103817,0,0,0,0,0,0,0,0,0,0,0,0,0,0,66,0,0,0,0,0,0,0,0,0,0,100
698388eff9d46d34165a414aea310108b6683c23,2,2,2,0,0,0,0,5,14,345,2,2,1,95,191,0,0,0,0,670,670,0,0,0,0,100
4a8c14b30ef5664a04cd0a6f59278f09f9309c52,1,2,2,0,0,0,0,11,52,671,1,1,0,926,56,0,180,180,0,7304,7304,0,57,57,0,100
1b54d520b3ba0ef6d1e5b7b816d3ddf67fd2bfab,13,558,77,481,0,0,0,4,14,1249,3,8,1.858313917,2475,67,1,200,188,12,24219,20726,3493,89,83,6,100
c81fb094e7e140c46ace11c292108053604f127e,4,44,13,31,0,0,0,4,28,1841,1,3,1.776942459,1135,192,0,183,176,7,7821,7473,348,120,115,5,100
e49444249bdc22afb8a1f717bf59dfaf8eefe67e,1,9,2,7,0,0,0,4,5,848,1,1,0,81,57,1,12,11,1,596,520,76,6,6,0,100
1672a7474bb9210ddfe397575c6fbfb34a2a3389,7,29,1,28,0,0,0,3,44,613,3,6,2.480797137,2792,58,1,241,239,2,25258,24870,388,56,56,0,100
45394aa590af4b14a874ec49340e450dd20611d9,1,2,2,0,0,0,0,6,14,255,1,1,0,364,193,0,71,71,0,2579,2598,19,19,19,0,100
b2bc33f3ba02e23066baebbdd2f6dde160ecec5d,5,104,34,70,0,0,0,2,3,753,1,2,1.61489329,858,59,1,131,118,13,7825,7275,550,56,49,7,100
ead942b837b92d0369400b6e36c55fd31e657dfc,0,0,0,0,0,0,0,0,0,0,0,0,0,0,60,2,0,0,0,0,0,0,0,0,0,100
7dba8c01bc3a966c7cabdcad26195d169026ac9a,1,10,7,3,0,0,0,6,13,1134,1,1,0,243,61,3,45,44,1,1396,1382,14,21,20,1,100
8d0564b1d60214ef3e1e7bb9111ff50ea5bdf776,1,30,12,18,0,0,0,4,12,107,1,1,0,304,68,0,62,60,2,2233,2185,48,16,15,1,100
4ee5073bcc8068fa7989558d8b6bd8079684bd10,4,48,34,14,0,0,0,3,35,1554,3,4,1.951876695,1288,62,3,146,146,0,10181,10119,62,70,68,2,100
82d6d603933fd012ad692c7cce729f9b03db1208,5,69,24,45,1,0,1,4,15,175,1,3,1.903397835,1509,194,0,215,211,4,11973,11778,195,87,84,3,94.27286712
2c339f746236599ad8dc1637133361cb0d8339b3,5,53,4,49,0,0,0,3,22,2383,3,5,1.804798023,979,63,0,157,150,7,8186,7867,319,51,48,3,100
5ed96ecc04c27dea41c21bfce12929c1c29ccd79,1,5,4,1,0,0,0,6,16,83,1,1,0,351,195,0,72,70,2,2518,2488,30,18,18,0,100
cd0ef17113caf546ac0a3ec32f82acba42959c2c,4,16,5,11,0,0,0,4,53,660,2,3,1.784941827,2111,196,1,310,310,0,17817,17777,40,102,102,0,100
989b99f33d5e0ebabcd7aebd5bfbcb1fe382c5f4,1,3,1,2,0,0,0,8,49,2,1,1,0,588,197,2,130,130,0,4516,4512,4,45,45,0,100
1d65e691c3b0627924bf541ec9f9dcfc40c6dc0e,1,10,9,1,0,0,0,8,26,863,1,1,0,213,64,1,35,35,0,1433,1431,2,9,9,0,100
017242ac73724b930102a82fd1449f4e56d7b84f,5,10,5,5,0,0,0,3,14,77,3,5,1.906890596,810,65,2,117,117,0,6553,6517,36,31,31,0,100
6b5de546edbf375046f465f2da836f90514d44b9,2,134,0,134,2,0,2,1,1,0,1,2,0.976734986,0,0,0,10,0,10,562,0,562,9,0,9,99.94186722
8f1fe56e1a48b40e7ea3b41a34fb48dd586aad84,5,26,10,16,0,0,0,3,36,329,3,5,2.235879087,1388,66,2,148,146,2,11025,10920,105,71,70,1,100
2886e70ae9ba7ce2a634ce5164f8383eea574b29,2,2,2,0,0,0,0,3,5,4644,2,2,1,430,69,0,66,66,0,3058,3056,2,33,33,0,100
dc00e6794c1dc4cdc9c47f35a0c6a27c1136a69c,0,0,0,0,0,0,0,0,0,0,0,0,0,0,0,0,0,0,0,0,0,0,0,0,0,100
8bb882d7432709af2844b8acdbe939ac9203225d,2,37,1,36,0,0,0,3,10,4623,2,2,0.949452015,612,67,0,95,92,3,4859,4631,228,32,30,2,100
1b2424d6c13480df40a654df5ee524083ab96943,1,2,1,1,0,0,0,3,4,2291,1,1,0,108,68,1,10,10,0,809,795,14,5,5,0,100
82a31c5cab3b8078162a6d0c1d76ae22be4a1d5d,2,4,2,2,0,0,0,3,41,2018,1,1,0.918295834,2274,69,2,489,488,1,14867,14852,15,139,139,0,100
e74e0b293127f7a43945c66eb1d3bdd4f0bf0891,2,10,0,10,0,0,0,2,4,252,1,2,0.721928095,658,70,3,101,100,1,5984,5894,90,41,40,1,100
024897d8d4ebad2cc5e1b199e485b5dbc39040af,0,0,0,0,0,0,0,0,0,0,0,0,0,0,70,0,0,0,0,0,0,0,0,0,0,100
74883eb1a383216518d67950368337bc2ae47073,0,0,0,0,0,0,0,0,0,0,0,0,0,0,1,0,0,0,0,0,0,0,0,0,0,100
ab2749bcd719dc23965ef44ef8263842314e83e7,0,0,0,0,0,0,0,0,0,0,0,0,0,0,0,0,0,0,0,0,0,0,0,0,0,100
8c4db7a9c46dbb9740141240c5ad943defdddc72,5,42,45,3,0,0,0,2,54,137,2,3,2.013998673,1805,198,0,301,306,5,15021,14973,48,106,108,2,100
1111d04ad7f15627b9d034d3460cd7698e88e72f,4,40,7,33,0,0,0,1,17,911,1,2,1.648062651,889,199,1,142,134,8,7110,6804,306,63,61,2,99.76711691
8294730b4c967e0760914a6ac01945c8974beae7,2,2,1,1,0,0,0,2,4,1672,1,2,0.918295834,154,200,2,18,18,0,963,943,20,13,13,0,100
c46cdc9d95cabc4a978a21e9b750cb911f7f2771,0,0,0,0,0,0,0,0,0,0,0,0,0,0,201,3,0,0,0,0,0,0,0,0,0,100
6eac567fafd01da0e7fd1e10b60b5f052c8837c6,2,68,2,66,0,0,0,8,42,270,1,2,0.553507265,2997,71,2,510,502,8,24083,23498,585,168,163,5,100
733a82fb3456b02109f8669b4dd79a429f3f0845,3,29,1,28,0,0,0,2,6,155,1,2,1.212059467,438,72,0,41,37,4,4232,3994,238,28,26,2,99.95334189
eb683275d312e9656f76767eb7928833c48702e9,5,57,10,47,0,0,0,1,21,2252,3,3,1.152471885,1742,202,0,265,260,5,11971,11762,209,87,85,2,100
7d18bc4fad938aee6fca4d114ce15e21dbaa8874,1,3,0,3,0,0,0,2,5,72,1,1,0,158,73,1,25,25,0,1228,1200,28,10,10,0,100
69a1a71644e5740c82e8ef45de250229945d2340,1,2,1,1,0,0,0,3,5,5174,1,1,0,86,0,0,9,9,0,516,502,14,8,8,0,100
dcbba884a1f33215fd4aa38c2e87b2b48a0b802c,6,33,6,27,0,0,0,6,14,4287,3,5,2.397654197,439,74,0,50,46,4,3008,2787,221,27,25,2,100
b9b7329339a9c5376c51cf87abf3bdf2c9f05198,2,8,4,4,0,0,0,9,26,398,1,2,0.918295834,1511,75,1,240,238,2,11075,11035,40,137,137,0,100
550bcc401a6cfe84a88778ab13f1a22504c83abc,2,7,0,7,0,0,0,2,7,113,1,2,0.985228136,663,203,0,98,97,1,5983,5923,60,40,40,0,100
3f3a65baddb58e4ad5d6bb0c0aa1d039fba688b5,16,274,9,265,3,0,3,3,80,1012,7,13,2.858024159,5032,76,2,829,807,22,35876,34407,1469,477,462,15,98.66092222
3af43b73cef94481679ec42157a0a07d227f586f,6,36,2,34,0,0,0,12,81,1408,4,4,2.397443032,2637,204,1,499,495,4,15074,14975,99,386,382,4,100
1da5edc9f044a83262f485e2cdb767384a92038c,3,146,20,126,0,0,0,5,16,374,1,3,1.060521744,1157,77,0,166,141,25,10210,9322,888,75,66,9,100
8e7513a66c6576172840c89ef1c3e576bec0322f,1,1,0,1,0,0,0,8,23,372,1,1,0,335,78,1,61,61,0,2536,2529,7,27,27,0,100
c49302a0f7ac27f92811d4d65cdc76da7077f5d2,14,289,35,254,2,0,2,2,64,1293,6,10,3.250063042,3352,205,0,544,511,33,26934,25623,1311,207,191,16,98.84088514
f91385662a09b1014f1e1935944fb55bcb47f0a0,15,196,25,171,0,0,0,4,82,908,6,10,3.218859727,6354,206,1,1043,1012,31,45836,44803,1033,677,663,14,100
01361812f852988681bda05565b9607ceb427b38,4,40,0,40,0,0,0,12,83,21,3,3,1.76660311,3220,207,2,633,626,7,19858,19579,279,419,415,4,100
895022c4539a81543f5f0e946550cfc3feff3275,2,5,4,1,0,0,0,9,30,12,1,1,0.99107606,442,208,3,60,60,0,3224,3210,14,12,12,0,100
ff6bcbcac5c5d0e8f00f4944207975f5b1bfeebf,3,26,3,23,0,0,0,3,6,90,2,3,1.217016339,220,79,2,23,21,2,1572,1353,219,16,14,2,100
838dcd837217d55c2568a715dc992ed53c6eac9a,39,162,132,30,0,0,0,3,19,3227,1,22,5.151450436,2947,80,3,344,338,6,17834,17568,266,212,210,2,100
1eeaf7315372bd7f8592e828dcac61740ba64581,3,3,26,23,0,0,0,3,7,0,2,3,1.217016339,241,81,4,21,23,2,1353,1572,219,14,16,2,100
01a422ebfbddbefe3beff4e8ae4d0169774f6211,1,8,8,0,0,0,0,10,66,26,1,1,0,888,209,4,174,173,1,6918,6911,7,35,35,0,100
eef24f4ae652240360783fe9766e9161fd8bb4d5,2,31,6,25,0,0,0,11,67,13,1,2,0.800392208,2295,210,5,342,339,3,18817,18656,161,157,156,1,100
34a76c39c0b27e48801715a87a2ff3376bef59e9,0,0,0,0,0,0,0,0,0,0,0,0,0,0,211,6,0,0,0,0,0,0,0,0,0,100
fbed6e7cf095f3e5f6328163de15e5925544372d,6,49,1,48,0,0,0,3,28,446,4,4,1.770054506,606,212,7,96,89,7,4180,3793,387,42,38,4,96.5238982
