CommitID,NMF,TotalAddLines,TotalDeleteLines,LC,FileAdd,FileDelete,NAD,NDEV,NUC,AGE,NS,ND,Entropy,LT,EXP,REXP,CommitComplexity,LastCommitComplexity,CFC,CommitTokenCount,LastCommitTokenCount,NCC,CommitMethodNum,LastCommitMethodNum,NMC,a2a
d7d8369282bb2870b748ad1a89930cd63e79735a,5,161,43,118,0,0,0,1,2,0,1,1,0.798943353,272,1,1,68,47,21,2271,1746,525,34,22,12,100
3ae4fb01ca2dd157bc5370a32a43c1a389be1b52,2,180,73,107,0,0,0,1,3,0,1,1,0.895757024,287,2,2,80,55,25,2341,1827,514,39,25,14,100
6f0b3db27fcef3e9d71754fbcf042fb94de95415,5,345,171,174,1,0,1,1,4,0,1,1,1.612596102,435,3,3,134,96,38,3797,2786,1011,65,49,16,89.18918919
c299c624870e05f60a208880eb7e0369d17c4a91,2,12,7,5,0,0,0,1,5,0,1,1,0.74248757,315,4,4,69,68,1,2015,1993,22,31,31,0,100
c45272e1312150dc9753f76ae93c2dde2dac6d8e,7,168,23,145,2,0,2,1,6,0,1,2,2.272962989,588,5,5,162,135,27,4449,3819,630,77,65,12,88.88888889
fdf8224104342fb6d047b13f9ced200229d4705e,30,1319,998,321,11,0,11,2,7,0,1,6,4.116518534,849,0,0,199,172,27,6442,5254,1188,116,87,29,27.5862069
9bc37c8bf58e906b1145f34a83db1cf883bc1ba9,5,86,51,35,0,0,0,1,2,0,1,1,1.71580288,641,1,1,145,138,7,4524,4358,166,72,69,3,100
574f3bdd14e71a1484eeb86b519ad9d2a74cde1f,3,37,31,6,0,0,0,2,3,0,1,1,1.340406214,529,6,6,105,103,2,3644,3619,25,49,48,1,100
be6432ebf1fe40c5ae0b4778f587ba352e32e65e,5,86,20,66,0,0,0,2,4,0,1,2,1.860491462,361,7,7,82,69,13,2754,2387,367,46,40,6,92.43697479
2b7c5c94754f8e80bb44fb2a8c1d0a9740d54310,12,315,43,272,2,0,2,2,5,0,1,4,2.306487472,791,2,2,201,161,40,6453,5140,1313,107,86,21,92.30769231
6bc297ec78295b5912385c340fa9bdb99567e748,7,23,23,0,0,0,0,2,6,0,1,4,2.043205331,679,8,8,142,141,1,4298,4255,43,76,76,0,96.66666667
f4d9bec5b5d00fbcbcf9a2d28ecf211b378df11a,7,61,16,45,0,0,0,2,7,0,1,4,2.626350563,693,9,9,154,148,6,5037,4694,343,77,73,4,97.52066116
af2642ccb415e4b1d09239c3ada8426de72749a1,15,308,247,61,2,0,2,2,8,0,1,5,3.152436936,746,10,10,155,147,8,5219,4892,327,87,81,6,81.53846154
5c32b40a466db43cd51efeddc38315f603e9b340,12,356,61,295,2,0,2,2,9,0,1,5,2.673800414,937,3,3,254,197,57,7487,6190,1297,126,100,26,85.9375
29bdd1e6e31bf69eab39e880e7e1a5b4f1d25d85,3,113,68,45,0,0,0,2,10,0,1,2,0.599319017,600,4,4,133,125,8,4203,4013,190,65,62,3,100
ff78a131aa676cfa32ffdb25e081cbcfef3fc11d,13,193,84,109,0,0,0,2,11,0,1,5,2.601644335,1012,11,11,222,209,13,7592,6855,737,107,100,7,89.25619835
75d0699e242b9c0e6be695fa8a6cb6da62dafc42,7,131,84,47,0,0,0,1,12,0,1,2,2.539879636,920,5,5,220,215,5,6202,5941,261,109,107,2,95.79831933
4ca75824192112bdd4d02ae4fc879c191f855804,9,57,31,26,0,0,0,2,13,0,1,4,2.940535796,1129,12,12,240,235,5,7651,7577,74,113,111,2,100
8234ceba5d78f48641a0467b7869c8d3cce16c54,3,27,43,16,0,0,0,2,14,0,1,1,1.478126436,544,6,6,118,121,3,3361,3516,155,66,67,1,100
9708b403016070dcffadb88b385ec98df818dd1e,13,153,55,98,0,0,0,2,15,0,1,4,2.999067615,1160,13,13,273,249,24,8311,7705,606,138,125,13,97.39130435
0c0bd1ed2641248aff484b84476a9bbfc269aeab,17,155,100,55,0,0,0,2,16,0,1,5,3.113796302,1504,7,7,338,317,21,10421,9762,659,167,155,12,71.96969697
5a8c22d6a4b11459ece805d4422b43d7712ea89d,9,252,113,139,1,0,1,2,17,0,1,2,2.586792117,1237,8,8,311,289,22,8862,8245,617,146,135,11,89.08045977
fb0a1affcf0eeb43a9f743443d0e5642b5131c95,5,104,25,79,1,0,1,1,18,0,1,2,1.818454857,850,9,9,196,179,17,5950,5636,314,85,78,7,97.08737864
9d8ffc74e707b3f65bf9a5c20523915e931054e1,10,298,129,169,1,0,1,2,19,0,1,6,2.656273114,849,14,14,197,172,25,6738,5816,922,106,95,11,98.13953488
e3c885618f8b703197e129f291444049f1f60121,14,339,94,245,2,0,2,1,20,0,1,5,2.791816487,1539,10,10,364,343,21,11749,10409,1340,171,160,11,98.2300885
e2990e4149c84ece28e1aa97747945b27c732288,7,149,51,98,0,0,0,1,18,0,1,4,2.089309489,785,11,11,181,168,13,6484,5840,644,79,74,5,98.27586207
d07cf12e89f0dfd9771fa0ac08215facf4dfd422,12,451,278,173,1,0,1,1,21,0,1,4,2.972761732,1645,12,12,381,358,23,12409,11596,813,178,165,13,94.11764706
88012e03c1ffc90d8c71ea1942f186cfd1c42db3,1,1,3,2,0,0,0,1,1,0,1,1,0,98,15,15,17,17,0,707,721,14,10,10,0,98.37398374
f7eb39e0f7b01c7c73e1f6068ba53bb27fd0087d,5,119,1,118,0,0,0,2,15,0,1,3,1.902549864,394,0,0,91,72,19,3763,3140,623,47,36,11,96.28099174
5ff26d2d5abc62fb81696f522d3f4b8ecdb7ee5f,4,26,34,8,0,0,0,2,22,0,1,2,1.732914564,486,13,13,107,112,5,3166,3187,21,56,56,0,100
702d30c1e869a0885606934d68c6fb0fa6cc0684,10,367,112,255,0,0,0,1,23,0,1,5,2.357104951,1213,14,14,290,244,46,9467,8225,1242,140,117,23,94.3231441
1c1ff9e53fec5fa8a48f642b2dd30fe9afde0e6c,5,108,5,103,0,0,0,2,24,0,1,3,2.139564608,875,1,1,218,202,16,6745,6105,640,119,108,11,99.54545455
cb50fdeab414dd43c73bb17ed0d617d45f35b2ad,2,9,14,5,0,0,0,3,17,0,1,1,0.932111568,264,2,2,68,69,1,1659,1669,10,43,44,1,100
164182cd8be2edecc1732caf2c1d4dcc2f6b1af9,9,82,33,49,0,0,0,3,25,0,1,5,2.914358203,1500,15,15,333,320,13,10652,10336,316,159,156,3,98.06763285
6eae027551dba008803d227ca797459b2ad4a52f,15,254,75,179,1,0,1,3,26,0,1,7,2.934904412,1931,16,16,427,396,31,14260,13508,752,196,183,13,93.30357143
5fe896457837de78aa0adb1602b3c502939cc22c,3,14,9,5,0,0,0,1,27,0,1,3,1.474041717,750,17,17,143,142,1,5573,5557,16,64,63,1,100
00c45d84cfaaf15fd358f47520f3815ea459a4da,4,14,10,4,0,0,0,3,23,0,1,4,1.692215752,1031,18,18,216,214,2,7537,7477,60,97,97,0,100
b52a7788628de987242b636826bb114d2237e6ed,9,197,72,125,0,0,0,1,28,0,1,6,1.998836229,1527,19,19,313,313,0,11583,10715,868,145,141,4,100
0c1028cfdd27f04de76d3cbed455112beb259784,9,34,17,17,0,0,0,1,25,0,1,5,2.359046271,1457,20,20,290,285,5,10731,10603,128,134,133,1,100
0b97937ef00269cf16f67152166c946c4ea89955,4,148,45,103,0,0,0,3,22,0,1,2,1.463869462,531,3,3,121,106,15,4867,4164,703,56,54,2,99.60629921
e853abcd4fb42b4c3f221f098e1a1935dbbe60d4,7,35,22,13,0,0,0,3,29,0,1,4,2.348463765,1368,21,21,294,292,2,9534,9504,30,135,135,0,100
8d9dc5d310479d0b471fa39e5458e58688d28ab2,13,67,36,31,0,0,0,2,30,0,1,4,3.232752538,1738,22,22,394,389,5,12072,11903,169,200,196,4,98.06949807
df2e59dd0092a55a34cb0a0e1a3a7aaac063e566,11,815,10,805,6,0,6,1,20,0,1,4,2.584718284,303,23,23,181,80,101,5425,2119,3306,104,43,61,90.59233449
34cfd9829644f1ce32e64ea5d7442f75ce9625ef,9,320,191,129,2,0,2,1,31,0,1,4,2.001307535,1724,24,24,348,347,1,12722,12434,288,165,165,0,93.24324324
b8f29fad784e84b932fade540933dafaa1b8e587,15,1406,34,1372,7,0,7,3,8,0,1,5,3.23703759,647,25,25,324,123,201,10171,4380,5791,168,67,101,93.7694704
178cd6fece4a5214112cfc8bcecba1fc23830b15,14,293,109,184,1,0,1,1,32,0,1,6,3.2896522,2043,26,26,448,425,23,15619,14434,1185,226,214,12,94.28571429
bb671d1117d45b365606bcb85706d06c9057da4e,15,138,190,52,0,0,0,2,33,0,1,5,3.450779896,1921,27,27,406,410,4,13514,13479,35,200,204,4,93.33333333
d2726fe8bb99f9a46d93d2bdf13dfb2a24e1a570,21,1094,424,670,2,0,2,1,31,0,1,6,3.623866059,2616,28,28,603,511,92,22778,17934,4844,277,261,16,94.44444444
26d15107a46260a41822f1e13f3d573b3ba0834f,4,238,7,231,2,0,2,1,4,0,1,2,0.88448758,382,29,29,124,104,20,4131,2762,1369,49,39,10,95.32163743
8c4b6090f3a72259daaa840fdd2ec713a2dc5e79,5,139,90,49,1,0,1,3,34,0,1,2,1.542258243,868,16,16,181,177,4,6371,6178,193,88,84,4,95.83333333
1adde6ee88853e2b97b8a52bb5fce27ffa800470,5,318,31,287,1,0,1,1,5,0,1,2,1.196808877,668,30,30,195,162,33,6588,4689,1899,81,70,11,97.8978979
7980f128694570709de82b8d106da078ff31c3cb,8,36,53,17,0,0,0,2,35,0,1,3,2.385816928,1243,17,17,256,257,1,8341,8463,122,115,116,1,89.96539792
db25532947f66868a89a648ea2d69ace78e64284,2,2,2,0,0,0,0,1,1,0,1,2,0,220,18,18,46,92,46,1520,2866,1346,23,46,23,96.58119658
74b9484dd0786d5a41ee6288f43fc031edd11250,13,131,89,42,1,0,1,1,36,0,1,5,2.972631136,2330,19,19,441,443,2,17048,16935,113,193,191,2,80.8
8311ffb7b12c03ea02edb81e64adb6911d7ce8fb,2,7,10,3,0,0,0,1,29,0,1,2,0.873981048,273,20,20,50,50,0,2204,2241,37,27,27,0,89.86486486
21ef561b07e46d907cf26fd5b353b13ea73fdc5d,12,287,29,258,0,0,0,1,37,0,1,4,2.157128401,1974,31,31,441,400,41,15555,14174,1381,194,177,17,95.07692308
f6a96a8b14ab95a6b03692abc6f97b629f7c6d04,9,174,57,117,0,0,0,1,38,0,1,3,2.045965274,1957,32,32,452,443,9,14439,13624,815,192,185,7,99.04761905
a749f1a2a1b73161b53ad1e04a871142f6aa6460,13,66,42,24,1,0,1,1,39,0,1,4,2.965620909,1946,21,21,405,426,21,13679,14428,749,178,193,15,88.60294118
18d3f645cd228c1132df48751d6550a2889dda8f,21,2184,129,2055,2,0,2,1,40,0,1,7,1.441035829,3346,33,33,920,622,298,33201,25006,8195,419,297,122,83.00395257
59d956ed35dfe423b96c49157bf49a3fbe4f10be,10,547,5,542,6,0,6,1,10,0,1,6,2.520053791,82,22,22,64,11,53,3281,516,2765,43,8,35,74.80916031
a2b2c892c1f8c67a0f6ceeba4381703ce3d96fbf,22,196,84,112,0,0,0,1,41,0,1,7,3.604600774,3929,34,34,738,722,16,29366,28707,659,358,352,6,80.42168675
24f021188dbe464a2434902c75afa78f821d53ef,9,183,91,92,1,0,1,2,42,0,1,6,2.178714177,1736,23,23,347,333,14,12715,12359,356,161,150,11,89.20454545
0ff9f1fbde35d40c3087bcf8e34a56a0f12966ef,7,66,29,37,1,0,1,1,43,0,1,4,2.039880636,777,24,24,159,157,2,5238,5154,84,80,78,2,98.66220736
d7a21c346a9b7352999aa2f12ad8536f6d6e273f,5,31,15,16,0,0,0,1,44,0,1,2,2.274565473,1183,35,35,264,262,2,8194,8121,73,110,108,2,100
971eb83036dbe498a34fc180afb578b51d55197a,4,156,83,73,1,0,1,2,33,0,1,2,1.639862502,647,25,25,90,86,4,5725,5430,295,45,39,6,89.36170213
65cc1f726f9f3935a065078b309a7b733a927720,4,20,11,9,0,0,0,1,34,0,1,3,1.437436633,689,26,26,91,90,1,5805,5725,80,46,45,1,95.76271186
dc52cfd384bfe72b68fe51aaa6039cc065d9cc2c,19,321,57,264,1,0,1,2,45,0,1,10,3.442623845,2533,27,27,544,507,37,19776,18275,1501,266,248,18,99.15254237
dc52ae96cf18f2a1891f5ff32008a90440c43a4e,10,87,57,30,1,0,1,2,46,0,1,4,2.52224902,1707,28,28,377,377,0,11897,11798,99,177,177,0,88.88888889
77940a04d429f64b3eba5c7d752fdd0d769d13c6,12,97,39,58,1,0,1,1,47,0,1,8,2.785911866,1287,29,29,263,259,4,9629,9446,183,134,130,4,80.61538462
9c59708578b89aa5998eaa7332b18e753f81c514,14,153,123,30,0,0,0,2,26,0,1,7,2.684832421,1686,30,30,316,313,3,13193,13083,110,170,167,3,85.63968668
fe8dddd2561f7fe18eeac03945ad860c65c71d02,13,393,38,355,5,0,5,1,37,0,1,7,3.174327985,628,31,31,133,104,29,6424,4793,1631,89,66,23,90.53117783
4ca25432be326b6e313c2898b2ba55d3adc69644,5,94,74,20,1,0,1,1,38,0,1,3,1.84156039,517,32,32,92,93,1,4094,4125,31,44,42,2,98.03439803
f66720fb34d1cd7446b207a9124bca47900fe75c,4,43,30,13,0,0,0,1,6,0,1,4,1.402992469,544,33,33,122,121,1,4309,4180,129,47,47,0,99.26650367
1eed4744c68860907db9ff3feab93a7ca825e1e9,19,618,87,531,3,0,3,2,48,0,1,6,3.530730926,2647,36,36,603,544,59,20711,18312,2399,282,252,30,91.26213592
d4f047eeb6524b985313bbc0583e0e73b2db4812,18,467,139,328,6,0,6,1,49,0,1,8,3.769546404,1582,34,34,327,301,26,13011,11670,1341,156,142,14,90.84821429
dd4bdf4ab53c63d977a9a35d0214520c18e02064,20,519,226,293,0,0,0,2,50,0,1,8,3.178695764,3349,37,37,705,676,29,25064,23591,1473,354,337,17,95.18828452
027a35c3f3da8f4575009bb9d9ad36df7acda3ea,16,193,296,103,0,0,0,1,41,0,1,5,3.521715876,1293,35,35,225,233,8,9125,9496,371,119,126,7,95.13274336
33154366ffa76260371e23a59d01e54fac3ba657,5,85,74,11,1,0,1,1,18,0,1,4,1.869048876,291,36,36,57,63,6,2213,2417,204,30,34,4,99.06542056
29a58781dc7338aea37ec5ee09541f8112d320c8,5,30,18,12,0,0,0,2,45,0,1,4,1.598594097,975,38,38,194,191,3,6951,6880,71,90,89,1,100
dab7c4915da02cf5849aba6fe2c6561f050e5cfb,8,85,54,31,0,0,0,2,19,0,1,4,2.649923783,604,37,37,107,102,5,4785,4569,216,53,53,0,99.76635514
d9e70b26990c6b99d4565edf0d2ab3a9aba4e090,31,1027,117,910,4,0,4,2,51,0,1,9,4.012412306,3934,39,39,880,773,107,32017,27094,4923,419,365,54,96.92671395
5113566945ae57742e9b9a527a461b903e86b33c,92,455,576,121,0,0,0,1,1,0,1,15,6.087836706,9941,38,38,1884,2208,324,68262,175628,107366,933,1104,171,12.76595745
89b7ac834b7185f984476ffe4642c1c0ace0de03,1,84,0,84,1,0,1,1,1,0,1,1,0,0,39,39,5,0,5,229,0,229,3,0,3,91.12709832
7b2cb0c0ce0b6e7cb5918facba74a25831ff1916,11,31,96,65,0,0,0,1,2,0,1,5,2.659259327,618,40,40,97,104,7,3869,4074,205,57,62,5,87.97169811
6513b30a03f4618591d13bbd75da2e07620eb33e,8,29,26,3,0,0,0,1,3,0,1,4,2.592786715,537,41,41,73,78,5,3934,4154,220,55,57,2,94.53302961
4f7908de899757c49fbe232ebeccfa53a2d4f466,7,30,30,0,0,0,0,1,3,0,1,3,1.818716207,554,42,42,83,82,1,4079,3628,451,51,47,4,95.44419134
8fa8d9580e24d329da42bf3e5879232791a5f45e,19,24,25,1,0,0,0,1,2,0,1,9,4.15328861,3363,43,43,619,612,7,24375,24208,167,297,301,4,96.78800857
71be759679d997a78cfd6160b057a21e623c62a3,8,40,49,9,0,0,0,1,3,0,1,5,2.21433372,1526,44,44,323,324,1,10290,10288,2,178,179,1,100
2dfbd5eca52892fd246db09ad46bb1e1c1800783,17,334,95,239,0,0,0,2,4,0,1,6,3.54475769,3537,40,40,729,697,32,25533,24239,1294,342,329,13,95.92668024
77294b5a2b460d8432f3e280b1f0b27ac32782c5,2,7,0,7,1,0,1,1,1,0,1,2,0,39,45,45,5,5,0,221,209,12,3,3,0,93.17697228
ffdaa41f127d58c8d493d7c36ff06802fcea0ba0,41,130,140,10,0,0,0,1,5,0,1,12,4.947455526,6459,46,46,1215,1215,0,45132,45402,270,581,581,0,97.74266366
2dc75ed86fd50c43bde9d28a18c77a6d52ca84d3,1,0,5,5,0,0,0,1,4,0,1,1,0,16,47,47,0,0,0,80,117,37,0,0,0,100
ad28c9ab5565b2268129dda69aa6319e3005cb65,20,312,148,164,0,0,0,2,6,0,1,13,3.33192497,2781,41,41,504,483,21,21784,20681,1103,265,252,13,99.3166287
c3ab0d559b18cb064a89081d622471472133457e,94,8,5,3,0,0,0,1,1,0,4,16,1.727248606,10111,42,42,1934,2256,322,70435,178036,107601,956,1128,172,21.89473684
4619aca4dc6d1c20a4f0bdde45f8ee012c72e0ce,17,119,112,7,1,0,1,1,2,0,4,10,3.362516202,1729,43,43,292,315,23,12591,14793,2202,155,168,13,94.76635514
6875471f8249febf4e3b6e82266248aa6f48319a,0,0,0,0,0,0,0,0,0,0,0,0,0,0,44,44,0,0,0,0,0,0,0,0,0,100
fcf2e8a38d43da16925bbf7c922bce52d6a9f26c,0,0,0,0,0,0,0,0,0,0,0,0,0,0,0,0,0,0,0,0,0,0,0,0,0,100
6196ca4c0f80edd27777908a0ad33a76264450c7,15,181,73,108,1,0,1,1,3,0,4,6,3.440733333,1856,45,45,401,383,18,13072,12551,521,189,183,6,97.06422018
efb9e639a7d0e96b62146549b2cd77e0ab7bd396,8,229,28,201,2,0,2,1,2,0,2,4,1.687613243,794,46,46,135,121,14,7365,6174,1191,59,53,6,94.65020576
505b930daf5a82fe7eaa48007547a8e61714f234,0,0,0,0,0,0,0,0,0,0,0,0,0,0,0,0,0,0,0,0,0,0,0,0,0,100
3c934d8c2d78f8cece74739d9b60894806cabd8a,16,66,53,13,0,0,0,2,4,0,4,9,3.272868381,1894,48,48,373,369,4,13548,13499,49,189,186,3,100
db3cca9da4effa64f7d3b8dfbe71efbff2d1ce1b,5,124,88,36,0,0,0,2,5,3,3,3,1.382307368,600,49,49,112,103,9,4772,4601,171,46,39,7,99.3227991
a3116367c05272658084096a3ec88b62a5aee84c,14,197,193,4,1,0,1,2,5,0,3,5,3.206249979,2139,47,47,421,422,1,14845,14563,282,193,192,1,95.59471366
d13ae2fc9285bdae55f91dc87e11fc65cab19599,10,194,211,17,1,0,1,1,6,4,2,3,2.422910553,1863,48,48,397,401,4,12282,12402,120,183,184,1,90.61135371
0737c1ec155e69a918370a23e558c7a9b80e7779,2,13,12,1,0,0,0,2,4,12,1,2,0.795040279,356,50,50,72,71,1,2701,2704,3,36,36,0,92.15686275
1c5ec24f67e0b8640dea419a5c4ef74788957e6a,7,120,18,102,1,0,1,1,7,5,4,5,1.663239964,997,49,49,219,212,7,7310,6735,575,84,80,4,97.43040685
07dd83598fe09505ab1c67ff118bb90ec4f1669e,16,277,68,209,1,0,1,1,7,10,4,9,2.127924844,2371,50,50,431,410,21,18282,17071,1211,205,201,4,91.77489177
b4dc7b32764486fb58004f41756d7df6981db333,15,173,111,62,1,0,1,1,8,4,3,8,2.945437831,2408,51,51,429,426,3,17427,17474,47,211,208,3,97.81181619
dc84cbb70f9e9c6af7d03369f855abcff47a239c,6,54,19,35,0,0,0,2,6,18,1,4,2.159844824,886,51,51,154,150,4,6477,6199,278,77,75,2,93.34637965
ad725b028561b741c15869ef1cec96afd0ca6dcf,12,331,294,37,0,0,0,1,9,20,3,7,2.0565415,1878,52,52,378,378,0,13517,13125,392,176,176,0,94.42231076
698857d6b5fb586fe32b86c41eed7b1753521492,11,933,0,933,11,0,11,1,1,0,1,2,3.365665397,0,52,1,102,0,102,4696,0,4696,76,0,76,93.19148936
f8954d50c32d52621324c88c299d2c9ed243dd56,26,251,136,115,0,0,0,1,10,53,4,10,4.060774109,5030,53,0,961,961,0,37132,36479,653,424,422,2,95.16441006
b938243542c273ef683c9cf8c399b4a7cbd445ff,16,89,52,37,0,0,0,2,11,33,3,9,3.509162722,2646,53,1,497,493,4,19200,18930,270,246,243,3,99.0619137
000211660c9762926b3244edd89c3b20c8828e2c,14,257,39,218,1,0,1,1,9,4,2,7,2.896367521,2812,54,1,538,521,17,21827,20439,1388,273,265,8,98.68913858
38bcf0e565c189eebace87ffecfb2264722ea6b0,7,154,103,51,1,0,1,2,6,29,3,4,2.539378689,783,54,2,141,131,10,5683,5305,378,87,80,7,95.42124542
5cb9183863226596832a2f82c89fc7a3b9edba49,11,113,20,93,0,0,0,2,12,21,4,6,2.860187191,2298,55,3,474,456,18,16732,16159,573,229,218,11,100
6281040d450b48209c9a08c82552e6253e43aca4,5,51,18,33,1,0,1,3,7,52,1,3,1.485772591,600,0,0,117,116,1,4078,4011,67,63,62,1,99.64157706
fc898dfad460ad002a23d3a0b12722a3de219ef3,26,1006,405,601,6,0,6,3,13,27,3,10,4.142928399,3547,1,1,723,668,55,27998,25213,2785,360,319,41,93.09309309
58b06967cfc9e8b8ec66c05769dc40bc9309d890,28,566,381,185,1,1,2,1,14,23,3,14,4.335796572,4589,55,1,819,811,8,35013,34169,844,417,405,12,92.35382309
965667030e4ea60ae83c65168c9bc33e450e8525,8,13,18,5,0,0,0,1,8,40,3,5,2.682639027,1187,56,1,195,199,4,8832,8861,29,106,106,0,99.46524064
7b8401bc82683fdb98eccd7af4fcc0bae0eac157,1,1,1,0,0,0,0,1,5,62,1,1,0,413,57,2,40,40,0,3335,3335,0,14,14,0,100
15884e8270cdcbe1d07f95f2accc27cbacf0cfd8,21,36,36,0,0,0,0,1,5,1,1,5,4.194385683,1580,58,3,182,125,57,12428,14577,2149,109,43,66,82.56578947
5b8a0d8fd89fbd540bf90cd518c2fd8e900f4926,18,173,75,98,1,0,1,2,15,0,3,9,3.270195549,3242,2,2,613,601,12,23894,23362,532,304,293,11,99.69604863
2012d521e540da8b87c92025f081623b48ad13ff,12,269,28,241,1,0,1,1,16,0,2,7,2.075549127,2380,3,3,481,460,21,17726,16427,1299,243,231,12,98.33585477
1fe655b34bb8546db9901700fdca05832437c43f,19,169,206,37,1,0,1,1,17,5,2,7,2.660724413,2618,4,4,431,425,6,19203,19444,241,227,224,3,88.6627907
6cf4be6675e23ce93aaa3e9d1a72d29aa5bad9e6,3,8,5,3,0,0,0,3,13,9,1,2,1.57662122,368,59,4,68,67,1,2450,2427,23,39,39,0,100
68535e07ae186d437096646980fe13d9ae2e45ea,10,783,674,109,2,0,2,1,15,26,2,5,2.497982384,1321,60,5,247,242,5,9801,9596,205,124,118,6,92.3566879
a3c0a23f3538b6c9460e2e8f3afe79748de27ea7,12,414,29,385,5,0,5,2,18,20,3,5,2.75707118,1546,61,6,324,300,24,12652,10897,1755,143,127,16,90.84249084
5fc0febe25e5c5e4215d38c0b3c553d5384b009e,5,85,0,85,0,0,0,2,4,35,1,2,2.321928095,164,56,0,28,28,0,1059,1059,0,27,27,0,100
50f4e1ac4a32672ed0268507c206e8ff5657acb1,6,106,38,68,1,0,1,2,14,13,2,4,1.596808562,620,57,1,86,82,4,4923,4509,414,44,40,4,97.46376812
4d692043ceea82bbcb69a06dd84e14c033d66fa9,31,607,955,348,2,0,2,2,19,58,4,8,4.313447882,2782,62,3,471,499,28,18047,19270,1223,242,266,24,90.64748201
f91ed282b6d9ef0c97409d33f39ae26e4c8b8509,7,205,75,130,0,0,0,2,20,31,1,4,1.161593577,1642,63,4,340,316,24,12420,11778,642,158,144,14,100
2d8e62c3274ad054a1c95dbf63226c92214bac1c,7,52,67,15,0,0,0,2,21,6,4,6,1.987979751,1097,58,2,188,190,2,7418,7553,135,91,93,2,96.84210526
7ee1718699ea62dad7710fc0f8fe5deea3e1e1dd,6,7,4,3,0,0,0,2,15,10,3,5,2.368522528,658,59,3,86,86,0,4956,4923,33,44,44,0,99.31271478
4ca6912a8322c5b08cb435ef0b687f0d388f9687,14,497,49,448,4,0,4,1,22,7,2,4,2.653819408,1840,64,5,417,362,55,14624,12699,1925,184,154,30,95.71917808
faf9bc7c0ab273c181af79ffbb7b55d648d73f64,12,139,108,31,0,0,0,1,18,47,4,6,2.904444815,1983,65,6,325,323,2,15242,14977,265,152,151,1,96.37305699
ca2db3c3538857a35ee366683f2d4412b0896286,9,240,125,115,0,0,0,1,16,23,2,6,2.877947295,1028,5,0,158,149,9,7621,7406,215,105,96,9,100
e934933008fbdaca8802a6a7bb7519f20b6d4589,24,928,220,708,6,0,6,3,11,6,5,11,3.734553355,1688,66,5,381,298,83,15518,12056,3462,204,161,43,89.04299584
adb9be185e91a4e0868dcdbd17847d95b5230dbc,2,2,6,4,0,0,0,1,5,11,2,2,0.954434003,214,60,3,27,27,0,1482,1528,46,19,19,0,99.42396313
cfee4f77f705ea880c7d92938c446d39adde0ec6,8,543,0,543,6,0,6,1,2,2,3,4,2.413155179,150,61,4,63,20,43,3863,1312,2551,40,14,26,83.47953216
98c02594843d184535191bf8ae5900464983faf1,18,249,60,189,2,0,2,2,23,31,4,10,3.604123281,2914,67,5,541,525,16,22141,21103,1038,254,245,9,77.85714286
54292faa80e036fe172265378914b149cd4f023b,4,0,123,123,0,0,0,1,2,0,1,1,1.65864198,274,62,4,17,21,4,1128,1415,287,11,15,4,95.40412044
3ee16b42d4ceccbc5926465bb6d52eaccdf853b8,14,272,63,209,6,0,6,1,10,8,3,8,3.425817149,1231,68,6,172,153,19,9978,8766,1212,81,71,10,94.68085106
0a4085423686212280ffc0c3ca0b96f3abeb39dc,12,258,136,122,2,0,2,3,20,34,5,8,2.984084124,1784,63,5,359,340,19,13490,13257,233,194,176,18,92.13973799
0cea77ace4360d570ec5d7c22fda7eb645143687,8,183,12,171,2,0,2,1,12,0,2,3,1.831133623,638,69,7,126,112,14,5136,4256,880,66,56,10,91.33627019
76bb3c8cfa9b1884d771e82c17997f899ecca55b,2,187,35,152,0,0,0,1,3,2,1,2,0.451622822,162,70,8,38,26,12,2316,1192,1124,20,15,5,100
d7be281f5be5c5feaf3fb3b0c16d835de1e44582,7,59,51,8,0,0,0,2,13,17,3,3,2.237810196,985,64,6,201,198,3,6603,6502,101,103,101,2,97.72036474
9cc94ae104bced8e5939de8709b49723c1fd8e02,4,28,9,19,0,0,0,3,14,1,4,4,1.93051489,554,71,9,110,108,2,4558,4434,124,64,62,2,100
ed87fa5697c50535b5150680f02e1932200aa8fd,8,140,27,113,1,0,1,3,24,0,4,7,2.244168066,1154,65,7,219,209,10,8681,7983,698,107,104,3,96.81818182
3b088f5d233c20fcb203fea432ce8e15934c728f,14,85,26,59,1,0,1,3,15,6,3,7,2.827695655,1062,66,8,179,126,53,8747,9536,789,122,66,56,81.55802862
e3fea4057700798320ce8004ab1d968332dc5419,0,0,0,0,0,0,0,0,0,0,0,0,0,0,67,9,0,0,0,0,0,0,0,0,0,100
b9c3c4584e96e201edc53ac19ca604598712d7eb,7,70,165,95,0,0,0,2,16,3,4,7,2.530370381,532,68,10,80,76,4,4297,4510,213,42,44,2,84.82972136
8d12cf75386a0c6a98fb35c8e99ca5188921b9cb,5,29,64,35,0,0,0,2,3,0,2,4,1.8040541,370,69,11,33,40,7,3175,4157,982,11,13,2,98.41726619
1e5668cb0d9fed9311ab52cba2b4a17651942b2b,7,16,11,5,0,0,0,1,21,23,3,6,2.620604061,1403,72,9,236,236,0,10412,10384,28,111,111,0,100
b91ef192f96150782e5c0af024202a568d91f9de,30,216,133,83,0,0,0,2,25,10,7,17,4.424812194,3811,70,12,578,570,8,29333,28639,694,290,286,4,97.37991266
2d64633ebe2a26af6928ac71e394cbb37f88ad40,13,37,35,2,0,0,0,3,10,14,5,10,3.485560719,1441,73,9,217,217,0,11041,11080,39,124,124,0,91.53284672
14fbfd3f53a179d89b7439b7f957bee7e585141c,7,49,57,8,0,0,0,2,12,3,3,6,2.425364009,740,71,13,89,90,1,4824,4884,60,47,47,0,94.46870451
8405919fec2ad012666abeb2ce1c2bc77bdf5893,7,126,72,54,0,0,0,1,14,16,4,6,1.951815831,746,72,12,111,101,10,5617,5205,412,58,54,4,100
0017f4dba354f3cbc3b371be961a1c92b201506b,14,355,87,268,0,0,0,3,26,21,4,9,2.263453327,3681,74,10,823,780,43,27811,26369,1442,354,335,19,98.26589595
8121f502a7b85bf96cbc681479bc195225a1346f,2,99,22,77,1,0,1,1,5,1,1,2,0.98571404,57,73,13,9,6,3,710,485,225,8,5,3,95.86305278
b75cbb99bb5ffe8253f94a69e420e2bb6c9fdcc8,6,100,63,37,0,0,0,2,11,0,3,5,0.940070456,1389,75,10,222,218,4,10275,10065,210,86,85,1,100
317ba9d395c39295dda8b1c4bf243d8bcd1d5413,8,71,53,18,1,0,1,3,19,0,6,7,2.727760636,848,74,14,132,134,2,6350,6378,28,70,71,1,99.43422914
66c3effd0b8967a3c37656f53fc7dea6d36b6cb0,8,67,70,3,0,0,0,2,27,31,2,5,1.986056138,2028,75,15,359,358,1,15099,15117,18,160,160,0,100
bdea1b077d453484127c87f9e944cfb5be778564,10,91,63,28,1,0,1,3,28,1,3,6,2.911070349,2129,76,16,391,394,3,15129,15154,25,176,175,1,99.71910112
1a74a3f20730542101119d4e7ccfe055b2f98914,7,87,54,33,0,0,0,3,29,0,3,6,1.90254259,1244,77,17,216,211,5,8686,8594,92,99,97,2,100
36eed7d875e3bb7ace8a4afea6fd12072d250162,3,7,11,4,0,0,0,2,13,2,2,3,0.614369446,1145,76,10,192,193,1,8132,8147,15,68,68,0,100
199c9d015a665f28a0bd496e4bd9dac57544d3c8,15,269,74,195,4,0,4,1,22,0,6,10,3.636726976,1411,78,18,213,197,16,11388,10767,621,127,114,13,92.98998569
1e1f2a32ac3a4d8189533f55051f84741eaed92b,0,0,0,0,0,0,0,0,0,0,0,0,0,0,6,1,0,0,0,0,0,0,0,0,0,100
4d41f3dcf3a676788d9ddf6aba950d0edeb15ba3,2,5,3,2,0,0,0,1,10,1,2,2,0.811278124,203,77,11,31,31,0,1325,1304,21,17,17,0,100
520ddf6ef9fa80ded8524618ff64a3cf884ddcce,0,0,0,0,0,0,0,0,0,0,0,0,0,0,78,12,0,0,0,0,0,0,0,0,0,100
8033ec423fa21d1804ff71bd9f26bba6b743c484,3,27,19,8,0,0,0,1,8,7,1,2,1.421911507,550,79,13,102,101,1,3599,3496,103,41,41,0,98.83211679
f28498893513e3fb1fdb75a59551c1a13839c8f4,6,174,87,87,0,0,0,1,14,16,2,3,1.561985354,633,80,14,121,97,24,5209,4604,605,56,49,7,98.39181287
04992114b0209fefadfb4c6cc1d2b99d87a26fa8,10,219,139,80,2,0,2,3,23,0,6,7,2.943737227,1132,79,19,168,164,4,8789,8541,248,103,100,3,95.93837535
e80f161ee77bc42ee9e5d7a338d4ac1916b86e60,6,20,9,11,0,0,0,3,11,1,3,4,2.403034464,809,80,20,121,119,2,5503,5466,37,66,65,1,97.60638298
9db6775af061371b6711bdb841ddb9db2ce6c4ed,8,62,114,52,0,0,0,3,24,11,3,6,1.974489594,1133,81,21,162,168,6,8653,8942,289,86,92,6,100
d3a9c00b02f090f0c1c76a92a947253de520e11b,8,354,85,269,0,0,0,3,14,17,3,5,1.123001034,1067,81,14,221,181,40,9157,7648,1509,112,96,16,97.22589168
c94ef67096b84e3eb64c3cbe7d3bf9f07b7e617d,5,169,102,67,1,0,1,1,10,8,2,3,1.230199773,746,82,12,130,124,6,5513,5340,173,64,58,6,98.65229111
3e5dd889c9ca7c720ece79803aa5071bb20efda1,2,33,20,13,0,0,0,3,30,25,1,1,0.23181305,723,7,1,150,150,0,5081,4924,157,57,57,0,100
af892c263e2187778ace5d57e29e9c2358d161c8,9,122,59,63,0,0,0,2,31,36,1,3,2.791887271,1739,8,2,355,350,5,12280,11854,426,194,191,3,100
24eb2ba97dfcfae56ebd3a3b259d0732d75112fd,0,0,0,0,0,0,0,0,0,0,0,0,0,0,0,0,0,0,0,0,0,0,0,0,0,100
844012cf74ea35e42b19b4dbe4567f16808d9bf9,4,52,1,51,0,0,0,2,3,97,3,4,1.756965645,185,82,12,36,36,0,1377,1379,2,19,19,0,100
367d0c2d4096886d442510e852364f819d16a5bc,1,1,1,0,0,0,0,1,3,0,1,1,0,6,83,13,0,0,0,43,41,2,0,0,0,100
9933d90d69ee7fd6244794b7588109e1a6ea07ad,0,0,0,0,0,0,0,0,0,0,0,0,0,0,84,8,0,0,0,0,0,0,0,0,0,100
6c763c834ac29970cf1e445ec7c64cdbe50fbaba,8,45,28,17,0,0,0,3,19,23,3,6,2.581145964,980,85,6,170,168,2,6811,6679,132,101,100,1,100
98e89d2ff147f5db69ae6c506da3bb5ede98e7a9,57,236,390,154,0,0,0,3,32,37,7,21,5.231955995,9183,86,7,1563,1563,0,63742,65273,1531,756,756,0,96.19565217
fb2b8f38802e54779711cf1985c4ed0baefc7223,4,32,7,25,0,0,0,1,13,0,1,4,1.263079134,885,87,8,179,173,6,6603,6441,162,69,67,2,100
2a20deb310eee42a01bd13bd3b9d2ee3830878f4,28,700,58,642,1,0,1,2,16,3,7,17,1.317773876,3577,88,7,699,628,71,28100,24497,3603,346,305,41,97.96437659
df89f5b1daa38592092e64bcca7ae70f1c07cba2,0,0,0,0,0,0,0,0,0,0,0,0,0,0,89,8,0,0,0,0,0,0,0,0,0,100
a89d9726698c3498af9b60c36c7670e46bad8746,0,0,0,0,0,0,0,0,0,0,0,0,0,0,90,9,0,0,0,0,0,0,0,0,0,100
df4e2f71f98a36f3f347aa2499e86b40ddc95593,0,0,0,0,0,0,0,0,0,0,0,0,0,0,91,10,0,0,0,0,0,0,0,0,0,100
f4bb9252ddaa68a36df7e392605a84ae517d2df4,0,0,0,0,0,0,0,0,0,0,0,0,0,0,83,0,0,0,0,0,0,0,0,0,0,100
6ba71ec0511bceb797d2aa37fdb370a2d4c66911,0,0,0,0,0,0,0,0,0,0,0,0,0,0,84,1,0,0,0,0,0,0,0,0,0,100
37590605c5578da472bfd31a5241b0ec09f80075,4,194,20,174,1,0,1,2,14,59,2,2,0.840428669,634,85,2,136,119,17,5263,4287,976,53,48,5,99.76019185
8a784a682df5a2c11f5c804456437e876bffe3bf,17,242,192,50,1,0,1,2,25,55,6,11,2.222470294,2347,92,0,356,375,19,17534,18193,659,174,187,13,98.68735084
c250e628cc40d83f784eff89e52afcf31ebd2cbd,6,228,10,218,2,0,2,2,16,21,1,4,1.488797695,763,86,3,103,79,24,6798,6103,695,49,34,15,95.55555556
0c15145e9f115ab37bc4c0e1e58abdf7222f9a49,9,195,65,130,0,0,0,3,12,42,1,4,2.447583443,1593,87,4,248,239,9,12720,11822,898,124,120,4,100
98605d8f946cfa4b822e3ac46c69f748f0094c9e,3,0,13,13,0,0,0,2,33,158,2,3,1.57662122,592,93,1,125,125,0,3978,4068,90,47,47,0,100
993dd606045eb758e6db1b6ef14680fb49e0529f,16,57,54,3,0,0,0,3,17,83,6,10,3.900309399,1985,94,2,212,211,1,16257,16249,8,103,102,1,92.80487805
77233ec6a9dffba0e4a71012ab392e7f54877a69,9,138,64,74,1,0,1,2,34,119,3,4,2.712099582,2172,95,3,470,460,10,14748,14638,110,188,181,7,82.78931751
5512d95849258233298a5c8edab3f568ce7dafd1,5,28,20,8,0,0,0,3,35,0,1,1,1.864786979,1632,96,4,353,350,3,11098,11081,17,134,131,3,100
60bfbc60ce982e60892e5b811c9d29298724d62b,9,1314,16,1298,8,0,8,2,2,10,2,4,2.055505049,462,88,2,180,71,109,7308,3168,4140,101,41,60,96.65551839
ba9af18c9817f54ad9a59081dafeb033ee4f5483,10,45,10,35,1,0,1,3,28,29,3,5,2.080906885,1850,97,5,377,375,2,12500,12443,57,151,149,2,82.26857888
9e58be717db680a8a31beee224f8aff9e2a32266,5,101,142,41,1,0,1,1,8,85,1,2,1.36810212,1348,98,6,340,342,2,9173,9226,53,143,145,2,94.7309417
2383689f49d0321835462e4a5e9684f0cc3f0df2,15,109,21,88,1,0,1,2,36,58,5,10,2.108515916,2400,99,7,468,460,8,17007,16747,260,228,222,6,99.31034483
31018be0bd56e149c946ee1c19b8a17dac6459a5,11,189,152,37,1,0,1,3,13,50,6,9,2.102249614,2014,100,8,458,451,7,13934,13696,238,202,201,1,97.81105991
9095c18d459b6cf9594bff4e7e897d9db94371d2,14,149,61,88,0,0,0,3,14,59,3,6,2.803571787,2995,101,9,617,601,16,19876,19659,217,280,276,4,93.50490196
8ebc647883ce2c3e596a334e28ce3dd1fbbeaa79,17,78,52,26,0,0,0,2,37,0,5,10,2.980044732,2988,89,3,570,572,2,20451,20370,81,277,280,3,98.95833333
07846af57d491ac08eeaa10a539c39703ee29ec3,8,214,12,202,1,0,1,3,14,54,2,5,0.696714091,650,90,4,149,114,35,5718,4693,1025,72,52,20,93.38235294
28c5aedfddfed15f4706bddfb65bae248efdf901,2,84,2,82,1,0,1,3,13,0,1,1,0.21832103,199,91,5,64,49,15,1681,1411,270,22,19,3,95.14661274
f5b238dd2e4f5cf1fd1e652f498b7516052a4854,13,153,133,20,0,0,0,2,22,37,2,6,2.680779904,1678,102,10,314,313,1,11885,11823,62,137,138,1,99.64093357
fc2a75ad14e1e2b3d9e201c1a148320bbf1e2288,14,1331,46,1285,2,0,2,2,28,42,3,5,1.613229676,2437,92,6,402,371,31,28451,18793,9658,196,184,12,95.08032129
401ae434d16d4edcb8ae4870c37e3bd7ee945ad7,0,0,0,0,0,0,0,0,0,0,0,0,0,0,93,7,0,0,0,0,0,0,0,0,0,100
28a077932abd8862c8d605e77b014ed13d2ae229,8,83,144,61,0,0,0,2,17,68,4,7,2.190734463,966,103,8,118,127,9,6414,6675,261,71,78,7,82.38341969
247ddf984b3e8789bc0c12a1c3fde5fb230aa352,15,67,67,0,0,0,0,3,38,76,2,5,3.424538454,2502,104,9,467,467,0,17237,17237,0,257,257,0,99.3993994
8bbb7fd68bd08ad400bef2717ddb0093ecd26b73,6,12,12,0,0,0,0,3,9,19,2,2,2.459147917,746,105,10,85,85,0,5956,5956,0,37,37,0,100
0124abc01465ebf9a3966e19d766a70bfa81ee3d,1,61,69,8,0,0,0,1,2,0,1,1,0,106,106,11,19,20,1,605,712,107,19,20,1,100
69c3155722eea4247993e8fd39a8cebce95c88e4,3,13,14,1,0,0,0,2,30,61,1,1,1.31056738,633,107,12,145,145,0,4373,4384,11,71,71,0,99.3993994
a2484fa081ffa5f3dedc3bb728ea8a5d3057c582,8,106,82,24,1,0,1,2,39,22,1,4,2.215503388,2065,108,13,395,396,1,15234,15170,64,166,167,1,100
4bd72b11ba8eb57360e307db1d7838c729f67e40,9,150,65,85,0,0,0,1,40,52,2,5,1.652083901,1944,109,14,424,418,6,14169,13946,223,197,191,6,100
dd0b631a69927db0dfd7acd1a002380909203773,9,10,9,1,0,0,0,3,41,9,1,3,3.155565013,2115,110,15,457,457,0,14283,14270,13,204,204,0,82.92046936
c36810ed8dbd0e202f98ba57bd5730e7edff6863,78,148,160,12,0,0,0,3,30,27,5,18,5.985459696,10419,111,16,1772,1287,485,75042,60920,14122,904,648,256,86.40192539
22f3ee0b46a5485deafa84939eb5290938b5552b,39,158,158,0,0,0,0,3,31,0,5,13,4.789819397,6341,112,17,1070,1070,0,46067,46067,0,513,513,0,99.49622166
56e9b719003e7d7024b05d9edec5a95937b3d3b3,9,59,21,38,1,0,1,2,43,0,4,7,2.625879706,1629,113,18,277,277,0,11800,11727,73,141,141,0,99.24623116
673a28278346fb641f7c1e81c20bc37168be33f0,9,34,42,8,0,0,0,2,21,0,4,6,2.835888648,2012,114,19,375,376,1,13619,13656,37,167,168,1,99.49811794
a38e2f71ef0e84cb0af9a394544274e0dd56bcd9,10,142,196,54,1,0,1,2,44,0,5,9,2.583510745,1515,115,20,240,245,5,10094,10389,295,115,120,5,98.87640449
eaadf8e66a98e2bc5e254af96a56f6d8f6d9800f,10,71,82,11,0,0,0,3,12,0,1,3,2.789990182,2008,116,19,396,393,3,14201,14246,45,169,165,4,99.501868
8dbb64fbae8f85170b4e1494cc9b1d4fcd98b513,3,22,13,9,0,0,0,1,8,7,2,2,1.228017925,352,117,14,55,53,2,2704,2633,71,31,30,1,99.5
594605829133f98d51b16d42fd0596fa26bde6d2,9,105,59,46,1,0,1,1,15,37,2,6,1.79683677,825,118,15,148,147,1,6152,6050,102,96,95,1,99.75062344
f58b5ef8f8f96ad640ff1b6b2d707f21712ec87a,7,61,43,18,1,0,1,1,10,8,2,4,2.212064087,517,119,16,80,81,1,3724,3800,76,52,53,1,96.71132765
bdd516434a39714632dc4e563ed055348ef84c4f,4,15,2,13,0,0,0,2,45,15,1,3,1.851226816,761,9,0,156,156,0,5122,5103,19,71,71,0,100
7e71a2e0e8ffb01a2168fabdf1d2f66f6ba7c4b9,358,27445,27233,212,179,0,179,1,46,5,14,71,7.84803426,18464,10,1,3081,6124,3043,132712,319568,186856,1603,3393,1790,30.37475345
336874fa36cd040df2d698bfc1030983ab3d0331,6,145,50,95,1,0,1,2,2,5,2,4,2.272261191,1032,120,10,157,146,11,8600,8331,269,78,69,9,99.58018472
0fed3078dd04c799067e856fb191fb0244a0f544,12,112,24,88,0,0,0,2,3,0,3,9,2.745183941,1807,121,11,331,321,10,14199,13711,488,158,149,9,99.66499162
9c44237880ae2c772d58f036708b0bd3f6b013a8,3,4,5,1,0,0,0,2,2,45,1,2,1.392147224,539,94,0,110,110,0,3554,3556,2,55,55,0,100
d16c5c649311c8af3340c3373593821ba67d467f,7,159,33,126,0,0,0,2,2,56,4,7,2.353061582,762,122,0,106,84,22,6182,5779,403,84,62,22,96.875
813db4b7847891bb76164fd663a732927d7d25a4,0,0,0,0,0,0,0,0,0,0,0,0,0,0,1,1,0,0,0,0,0,0,0,0,0,100
349f29ceefa452cb5212d2aae05e0290de3bbb88,0,0,0,0,0,0,0,0,0,0,0,0,0,0,2,0,0,0,0,0,0,0,0,0,0,100
58ab69a808597e2971b5e1f261c7d3dc19097e7b,0,0,0,0,0,0,0,0,0,0,0,0,0,0,95,0,0,0,0,0,0,0,0,0,0,100
16eb8cc6be5dfe06ab3cdd67250af16bd790f6ff,68,671,435,236,3,0,3,3,4,60,7,24,5.551121132,8657,96,1,1489,1461,28,64014,62840,1174,799,783,16,94.02228977
e1620e804c5be0fa735065631d45f2f6d8db4502,19,228,137,91,2,0,2,2,4,30,5,11,3.721950316,3495,97,2,680,668,12,24906,24627,279,323,313,10,91.74852652
5565425f0e4ebc450051340522702465b37d97c6,7,119,7,112,1,0,1,3,5,0,3,5,2.168875479,1950,98,3,357,343,14,15123,14568,555,156,152,4,95.463138
bcb806d1c1ca30214eb16a324d822088aaf6be37,5,115,80,35,2,0,2,3,5,12,3,4,2.070826598,371,123,0,48,46,2,2741,2580,161,39,38,1,95.15695067
3dcda9c1c8409845f324416c1fac6d4628bdff40,3,8,16,8,0,0,0,2,2,123,1,1,1.477334467,78,99,4,6,6,0,499,599,100,6,6,0,94.48398577
e2276879983e5fcb6942452e4037abc57d95a6ab,1,5,5,0,0,0,0,3,4,17,1,1,0,196,100,5,31,31,0,1428,1426,2,14,14,0,100
c7c4d114007f755202c7d92629e42d870105ff69,26,78,95,17,0,0,0,3,6,40,4,7,4.349440799,1845,124,1,229,230,1,14238,14415,177,149,151,2,98.51301115
d7fb566c4a0571b92354f9bfb57cdb0a3cd315e4,27,425,396,29,5,0,5,1,7,18,6,17,4.244963017,2782,125,2,478,482,4,19462,19910,448,276,275,1,86.37362637
e0a90d788b583cdf5658ee246f0b7b00eae957b7,2,12,12,0,0,0,0,1,2,0,2,2,1,36,126,3,4,4,0,262,282,20,4,4,0,100
f04ac8590e8f5f9dcd479087282696b3e574c5ac,0,0,0,0,0,0,0,0,0,0,0,0,0,0,11,0,0,0,0,0,0,0,0,0,0,100
718fa9ea3e1b1a3f4f88150b7433857fa1ed1f1e,24,253,203,50,2,0,2,1,8,2,5,16,4.129463006,2108,127,4,350,345,5,14643,14524,119,196,194,2,81.4479638
8ac50a721505076dc3a7f7dc5416ed27a3273e8a,17,126,98,28,1,0,1,1,8,9,6,15,3.844498846,1333,128,5,224,225,1,9612,9626,14,137,137,0,78.14009662
392fa51415047b6e265a73d4ef175f1a468535b7,8,54,27,27,0,0,0,3,8,67,2,4,2.718971905,2010,101,6,341,341,0,15619,15335,284,161,161,0,97.0856102
fdbbdf98c0d5db82ba6fc2e78893bfd006040abe,17,63,64,1,0,0,0,2,9,4,5,11,3.864509563,1573,1,0,219,213,6,11827,11023,804,123,125,2,93.93939394
5a94eac05810309436e316616fc40181aa892ae8,0,0,0,0,0,0,0,0,0,0,0,0,0,0,102,4,0,0,0,0,0,0,0,0,0,100
46116d412add72d761ebd6a9325362dc19227459,23,413,310,103,2,0,2,2,10,1,6,17,3.783649071,2625,129,6,447,446,1,19751,19638,113,234,229,5,97.61363636
6adf89d481cc424716b12aa120e89b2a0fe921fb,18,90,83,7,0,0,0,4,10,33,5,11,3.781501443,3028,2,1,501,500,1,21824,21767,57,238,237,1,100
b5a07be08446f6c7148329b6b44a69199d62a49f,26,494,334,160,0,0,0,3,11,45,5,11,3.583340666,5413,103,4,938,890,48,41774,40517,1257,454,414,40,99.66139955
4e5d0d7952484b7ca880b7ce4b7e9f557ba08654,29,958,250,708,7,0,7,4,10,18,6,17,3.959814579,3208,104,3,684,612,72,26499,22453,4046,343,304,39,94.55709712
615e767247063434c94baf3ab69cae937611ab75,3,13,10,3,0,0,0,1,6,3,2,3,0.840491401,393,105,4,59,60,1,3212,3263,51,36,37,1,100
6a755e66f89a8e100403cb6af5eb08b9ead3c324,24,160,174,14,0,0,0,3,12,1,3,9,3.097971015,5382,106,5,916,915,1,40042,40213,171,439,438,1,93.57798165
f1716ac43e9dcb49ce3be8628cfb0e849bedc8ce,47,257,289,32,0,0,0,2,13,80,6,16,5.167070655,8451,130,2,1669,1663,6,57717,58068,351,826,823,3,98.56297549
a25143eedb84a3da5ffba5d475314eca41a7ae48,14,149,65,84,0,0,0,3,14,45,6,7,3.093786674,2384,107,4,505,494,11,17146,16539,607,216,213,3,99.31682323
dc182838bfabcb5839aee5e60a2851ffaf5fffaa,1,5,5,0,0,0,0,4,5,8,1,1,0,151,108,5,27,27,0,1010,1010,0,13,13,0,100
717e46d4974efd5e0581cb99903f48b52bc624cd,3,29,37,8,0,0,0,4,10,19,1,2,1.525813168,470,109,6,51,51,0,3186,3088,98,31,31,0,100
80b28c711a01693a239e1b6fe92f3f7c1d723324,0,0,0,0,0,0,0,0,0,0,0,0,0,0,110,7,0,0,0,0,0,0,0,0,0,100
e84e7e4443d45be9a5340ba99a992b54dc917b02,5,11,22,11,0,0,0,3,6,21,1,3,1.825594187,1146,111,7,252,252,0,7663,7753,90,109,109,0,100
f970468b97582831c67036c0eb08e72c00bedf92,16,62,761,699,0,0,0,4,15,98,4,7,1.568101113,3565,112,8,648,666,18,19846,24832,4986,282,289,7,99.82847341
183c64d51a788532b75335066c2558e68b2ee349,1,2,2,0,0,0,0,2,5,0,1,1,0,49,113,9,14,14,0,377,361,16,6,6,0,100
ebe62d25411ac62e74b49b14e4ad6535f29eb70b,0,0,0,0,0,0,0,0,0,0,0,0,0,0,131,1,0,0,0,0,0,0,0,0,0,100
768d7caa46f48a0851322f6f88cb599bdd5c7e52,0,0,0,0,0,0,0,0,0,0,0,0,0,0,132,2,0,0,0,0,0,0,0,0,0,100
930f4c019e3d8acc81376182c941ef887cc8a865,0,0,0,0,0,0,0,0,0,0,0,0,0,0,114,7,0,0,0,0,0,0,0,0,0,100
48fbe431a8bcd8dc1b66706306b43767aa414218,0,0,0,0,0,0,0,0,0,0,0,0,0,0,115,7,0,0,0,0,0,0,0,0,0,100
4010e7c47cc98bdbc95edd12c19bd34a3f877815,0,0,0,0,0,0,0,0,0,0,0,0,0,0,116,8,0,0,0,0,0,0,0,0,0,100
67f25fec2d8b8a99132230c8c90a837b45acbac8,0,0,0,0,0,0,0,0,0,0,0,0,0,0,117,9,0,0,0,0,0,0,0,0,0,100
43ad0def61944b108bb4f2a474a60a4c566d9821,75,922,673,249,6,0,6,3,16,18,7,23,4.603371462,10135,133,2,1883,1853,30,72462,71517,945,901,894,7,94.12322275
771e8adc40c36f310feac445beab1cff287dc69d,75,673,922,249,1,0,1,3,17,0,7,23,4.603371462,10362,134,3,1853,1883,30,71517,72462,945,894,901,7,94.12322275
42fff2b266a7841e075cc2202fe4530a4c4cab61,14,842,49,793,6,0,6,1,18,13,5,9,3.050909532,1591,118,10,394,315,79,15015,11044,3971,198,153,45,93.38919926
24f5cc769f6db591d9baa105579ba41725943fe8,4,23,25,2,0,0,0,3,19,0,2,3,1.76242701,1203,119,8,239,240,1,8340,8307,33,112,112,0,92.24880383
e913cf8c42ec202462f999e08835e884de79d148,0,0,0,0,0,0,0,0,0,0,0,0,0,0,135,4,0,0,0,0,0,0,0,0,0,100
81cefd8e109bf6e35599fd349279b28a8483299b,0,0,0,0,0,0,0,0,0,0,0,0,0,0,120,6,0,0,0,0,0,0,0,0,0,100
9bd8cbd6b4d7a6746ee967697d20bcf62a1afaa1,0,0,0,0,0,0,0,0,0,0,0,0,0,0,121,7,0,0,0,0,0,0,0,0,0,100
43bc6ebf4f415ecf23317ef4c38fa6c58afde29a,80,940,745,195,6,0,6,3,20,0,7,23,4.841380635,10512,12,0,1918,1915,3,74981,74203,778,931,929,2,86.76190476
ac55b5f186ffdec1dd97620eb06d9a939891ab1e,0,0,0,0,0,0,0,0,0,0,0,0,0,0,0,0,0,0,0,0,0,0,0,0,0,100
0af97352b05e5d8f163cb1c7ec9ba94c75971c6a,0,0,0,0,0,0,0,0,0,0,0,0,0,0,13,1,0,0,0,0,0,0,0,0,0,100
06fd2e441bf72de3744f5409446079df009f1f6a,0,0,0,0,0,0,0,0,0,0,0,0,0,0,122,5,0,0,0,0,0,0,0,0,0,100
2373a4a08e5805af3291acae64c2efccd9f528d4,23,398,266,132,0,0,0,3,21,46,3,8,3.620133049,5323,123,3,995,970,25,40293,39469,824,435,421,14,95.12195122
5ebe83e872b33c4a650e810f43f07fa93eee908d,0,0,0,0,0,0,0,0,0,0,0,0,0,0,136,0,0,0,0,0,0,0,0,0,0,100
b2c6913826a238b6f1f693c6cce648b5f5301155,0,0,0,0,0,0,0,0,0,0,0,0,0,0,137,1,0,0,0,0,0,0,0,0,0,100
13fdb9ee6cb89a2bfa3533ab7955b33951de491b,13,300,118,182,1,0,1,3,11,25,2,6,2.862055549,2904,124,2,583,558,25,22819,21876,943,248,238,10,80.96885813
ec615f3ac0d8d953adbabc6bc5e020fcf58a9f38,0,0,0,0,0,0,0,0,0,0,0,0,0,0,138,2,0,0,0,0,0,0,0,0,0,78.33859096
d18785a3d9e4aa090293b0f7f9a05e3dc6e27e9e,0,0,0,0,0,0,0,0,0,0,0,0,0,0,139,3,0,0,0,0,0,0,0,0,0,100
3bf0b50d9d0704fcb878f2764dbe301e0dc89df3,0,0,0,0,0,0,0,0,0,0,0,0,0,0,140,4,0,0,0,0,0,0,0,0,0,100
af1c0d77acbc4463afdeff6a440350b124f38c0b,0,0,0,0,0,0,0,0,0,0,0,0,0,0,141,5,0,0,0,0,0,0,0,0,0,100
88bb447352fb722a6a58116a79aa138a71c0e79a,0,0,0,0,0,0,0,0,0,0,0,0,0,0,142,6,0,0,0,0,0,0,0,0,0,100
642a22c166851dd81e6f96449239e88af72e64a0,0,0,0,0,0,0,0,0,0,0,0,0,0,0,143,7,0,0,0,0,0,0,0,0,0,100
52c4b6412df7daba82445db289f7b41e2216b4a6,0,0,0,0,0,0,0,0,0,0,0,0,0,0,144,8,0,0,0,0,0,0,0,0,0,100
6eb4f8278048b518dfe261e9d4ae93b1db003aa1,0,0,0,0,0,0,0,0,0,0,0,0,0,0,145,9,0,0,0,0,0,0,0,0,0,100
2fbbe0aa9df31e5e982b235071e0b438f0241453,12,450,24,426,2,0,2,3,22,58,2,5,2.418841453,2764,125,0,590,539,51,23369,20517,2852,266,247,19,89.05660377
341456e04493fa014deac8cae803d78cb7f247a8,28,378,235,143,1,0,1,3,23,103,5,12,2.807299067,4798,146,8,855,829,26,36062,35694,368,389,369,20,93.99061033
e6419972c8c2119f7ce48ad80cd09918d51e5725,11,50,20,30,0,0,0,3,24,51,3,5,2.544271195,2629,147,4,587,583,4,18642,18437,205,260,260,0,99.73935708
291f51b4282ff8d5d64f593614215e43b0f99b0e,17,79,102,23,0,0,0,4,25,55,7,11,3.196494131,3604,126,1,539,539,0,28379,28577,198,255,253,2,95.43726236
06002e67a3476a491e4fc0f1638123f5957c452e,41,826,186,640,13,0,13,1,26,59,6,20,4.777370781,4323,127,2,781,747,34,33563,31437,2126,404,381,23,80.13777268
ddb82cd190f91997d37b6937db1630a96737112c,4,47,5,42,0,0,0,4,13,91,4,4,1.607320682,624,128,1,121,114,7,4357,4182,175,51,48,3,100
466fc2c3a8fc984b3f94e939045fc4d8a7b0ae0c,38,423,227,196,3,0,3,4,27,124,7,14,4.645386482,4570,129,0,792,774,18,35109,34020,1089,436,421,15,92.44558259
a5b84af2de1e3311e96ebdf81f2a1155976cace4,10,178,174,4,0,0,0,3,21,150,3,8,1.954128082,1884,148,0,410,406,4,13035,12918,117,196,194,2,98.45758355
237be5d10b389fd4f0b7829bb95e88ec94e8b72f,7,41,42,1,0,0,0,3,28,233,2,5,1.663097795,1530,130,0,289,289,0,10559,10747,188,147,147,0,100
d45275123fd0bc9dd88a965067408882a21c5367,4,18,18,0,0,0,0,3,16,111,4,4,1.111155201,567,149,0,106,108,2,3779,3729,50,46,46,0,100
9ed2652d298f5b9f77f8d866bbc829f215418be9,1,1,2,1,0,0,0,3,7,0,1,1,0,73,150,1,7,7,0,446,456,10,4,4,0,100
89e64f2125eb2d1692b395df1f4ac6028d0ad266,0,0,0,0,0,0,0,0,0,0,0,0,0,0,131,0,0,0,0,0,0,0,0,0,0,100
fb702de7cbccbaf0a2aa9dd1badb04f74194d73b,13,282,53,229,0,0,0,1,29,159,4,8,2.868814756,2888,132,1,631,595,36,21809,20228,1581,296,282,14,83.62877998
1e7a06ef1877e062e749adbc298e5f7a2851c990,6,46,21,25,0,0,0,3,13,218,3,3,1.337679229,562,151,0,127,122,5,3864,3711,153,61,57,4,99.56101844
e2bdc2478f45832a12582a0f94f32735047f151c,13,218,166,52,1,0,1,3,30,78,4,8,3.12212334,2072,152,1,451,440,11,14876,15101,225,219,207,12,99.82517483
812d7dbeb5361911e269fa68995a2a7179cdf6be,4,229,1,228,2,0,2,1,31,9,1,3,1.751657432,1149,133,2,267,250,17,8978,8092,886,110,96,14,99.22077922
0235de0ececb0c647858ede3228d25f4928df712,10,60,39,21,0,0,0,1,18,115,3,7,2.996581429,1030,134,3,184,179,5,7778,7640,138,112,108,4,100
3e0ad68a0897c622b00e85af0b7c06ed1a80fc12,2,54,34,20,0,0,0,3,19,17,1,1,0.214509834,837,153,2,180,182,2,5886,5776,110,77,71,6,100
c0c3a3748c83517348c7d65016c8224029d30f90,13,86,119,33,0,0,0,3,23,246,2,7,3.334340173,3394,154,2,641,642,1,26264,26406,142,319,317,2,92.24353628
704072c5c4df67704ba0df38e965857672551fd7,28,151,161,10,1,0,1,3,24,194,5,12,4.019889502,4215,155,2,511,511,0,35724,36070,346,261,257,4,99.59579628
ee262d7e3daefe323900146beb460b20b1a72869,21,185,105,80,1,0,1,4,32,203,3,11,3.328293521,3973,156,3,765,758,7,29527,29112,415,384,379,5,96.57534247
e46aee2c87e85fe7317f2e807cdf97da0be31ddc,7,172,48,124,1,0,1,1,20,107,2,5,2.398527845,940,157,3,159,144,15,7783,7048,735,66,62,4,97.97421731
fd230c448b88becb79a216cd0cc0571a3ab9b0c4,19,45,40,5,0,0,0,4,33,45,4,11,3.822869497,3960,158,3,588,586,2,32665,32646,19,288,286,2,100
4dbe99bbd1c5fc7e2d9a6eba4d6df5726b68a9c8,9,157,16,141,2,0,2,3,34,61,3,5,2.323433064,1784,135,0,353,342,11,13961,13272,689,171,163,8,98.88682746
c2032801a21bbe518989af7796c3ab0e408d7ef0,9,16,157,141,0,0,0,3,35,0,3,5,2.323433064,1869,136,1,342,353,11,13272,13961,689,163,171,8,98.88682746
4ed8f72716a931835a28dbd62ec5898a97d99450,9,157,16,141,2,0,2,3,36,0,3,5,2.323433064,1784,137,2,353,342,11,13961,13272,689,171,163,8,98.88682746
9ce1783d30726b940193e1926659fefdbe2a2cdb,22,165,74,91,0,0,0,1,37,146,6,11,3.974206284,2715,138,3,501,479,22,20217,18760,1457,279,268,11,96.03686636
86383d689389bb3ccc9336f97bac1b66caa3f867,21,165,197,32,0,0,0,3,31,133,4,7,2.658211718,3437,159,2,545,561,16,25591,25634,43,286,284,2,96.85251799
298c1a2de173c0e2284fc08ef2f953a5fee86e2d,26,422,25,397,7,0,7,1,38,151,6,15,3.987918729,2400,160,2,440,402,38,18775,16729,2046,231,210,21,95.33861038
a783abd0d253d2082c5db6ed8ef485486ebb3c7a,27,290,119,171,1,0,1,2,39,174,7,16,3.518948244,3940,139,4,744,730,14,28641,27546,1095,399,389,10,95.97902098
be4c414e05d39c34148782a8860df2695170dc19,10,132,50,82,0,0,0,3,33,202,2,5,2.580247413,2189,161,0,453,444,9,16578,16033,545,230,220,10,98.60990443
7a5c3ea12a84a99bd78bd22e869e5b2a938693e7,4,68,0,68,0,0,0,1,2,48,3,3,2,41,162,1,5,5,0,246,246,0,5,5,0,100
96c470d884423f0997ac06073b53a541be856d11,3,51,18,33,0,0,0,3,13,112,2,2,0.779625736,201,163,2,42,37,5,1446,1293,153,34,29,5,100
55764cc24c5dc5a35df29a8c23fcdf787c1bb8a3,18,50,53,3,0,0,0,3,34,166,6,13,3.895767043,1858,164,1,302,302,0,12958,12902,56,183,184,1,97.03459638
2a781c220e0b9fe564cfa130b18fb952ece90a1e,5,205,112,93,2,0,2,1,40,105,2,5,1.951266066,853,165,2,183,178,5,6468,5987,481,74,73,1,99.44968553
7edcd52b0c90a2af9b9e25e84f71adf0d2c42506,17,197,110,87,1,0,1,3,16,217,6,12,3.521575044,1594,166,3,241,227,14,11482,11027,455,171,159,12,97.55571531
630ad7f4d0ca83e729c33d4a4c8f4a3682280a9b,0,0,0,0,0,0,0,0,0,0,0,0,0,0,3,0,0,0,0,0,0,0,0,0,0,100
9591cbca0bea7d42ddb54e493f3c3445788baa31,0,0,0,0,0,0,0,0,0,0,0,0,0,0,167,2,0,0,0,0,0,0,0,0,0,100
091d2fcb9db72f9f8531e2b2bc73927cd043c79f,0,0,0,0,0,0,0,0,0,0,0,0,0,0,140,0,0,0,0,0,0,0,0,0,0,100
6d0d114ff4a8709dd568b5227dbc6c78cbcd8d1f,0,0,0,0,0,0,0,0,0,0,0,0,0,0,168,3,0,0,0,0,0,0,0,0,0,100
30cc776701561112d3761c4dcd143424897c4129,0,0,0,0,0,0,0,0,0,0,0,0,0,0,169,2,0,0,0,0,0,0,0,0,0,100
22b70e9c4f7d1fc3895d38cde66c5e6fa1654d7e,7,82,40,42,0,0,0,3,18,269,1,4,2.537823502,1410,170,3,202,203,1,11270,11045,225,97,98,1,100
830bd615dbcaa1db7c47b6f65bc68adbffc91289,0,0,0,0,0,0,0,0,0,0,0,0,0,0,171,4,0,0,0,0,0,0,0,0,0,100
8a40ee4bccc23c37027829a9cc17838200650a0d,28,1462,47,1415,9,0,9,1,41,138,5,10,3.710937168,3383,172,5,767,612,155,31781,23819,7962,422,326,96,90.01426534
b7d089a1ab279bcc5c8832131305134bbcb967d2,1,1,0,1,0,0,0,3,16,125,1,1,0,272,173,6,53,53,0,1847,1843,4,24,24,0,100
42273af454d368293e467518431c16f7c3c248aa,3,147,11,136,0,0,0,3,20,43,1,2,1.364803259,588,141,1,112,96,16,5347,4341,1006,52,48,4,100
daee0b3615d4e583c3b0db4edfb00ebc8811b0ae,2,35,19,16,0,0,0,3,21,6,1,1,0.764204507,562,174,7,98,94,4,4505,4384,121,42,42,0,100
7919c20d63fb85d7e96184bd6eb1a0c9ff2dac2a,2,19,35,16,0,0,0,3,22,0,1,1,0.764204507,575,175,8,94,98,4,4384,4505,121,42,42,0,100
7f17943166b7c57ad0202aa796cf2a9271695a90,2,35,19,16,0,0,0,3,23,0,1,1,0.764204507,562,176,9,98,94,4,4505,4384,121,42,42,0,100
564e89ee4285e5dc2c8b7fa48a66f63a692a4cce,10,35,16,19,0,0,0,3,16,143,5,6,2.992793669,832,177,10,148,146,2,5722,5531,191,89,89,0,99.76833977
86e744c1f1d50a2b3530dfe568def4eb33aa6e05,10,204,48,156,0,0,0,2,24,239,4,7,2.57218635,1060,178,11,202,174,28,8629,7788,841,102,89,13,100
830569ed20e8d00dcaf2f857a2bda2c993cc5f44,2,5,5,0,0,0,0,4,17,54,2,2,0.721928095,407,179,12,86,86,0,2618,2636,18,38,38,0,100
e914e7afac36a40663b58b6d33e77900e9d1ec1b,12,208,60,148,0,0,0,4,36,338,2,6,2.345352594,1322,142,1,236,206,30,11487,10410,1077,149,129,20,91.99491741
dfeb671f04dc5fd091011476861c67cc8972d42d,10,535,0,535,7,0,7,1,7,0,1,4,3.09850018,204,180,11,85,42,43,4249,1438,2811,55,34,21,91.51590767
543ee0eb8db6eac663274be8d3c0a9dd054e65cf,0,0,0,0,0,0,0,0,0,0,0,0,0,0,0,0,0,0,0,0,0,0,0,0,0,100
5d4bb423581bd6858411dd4037dcadee752155cc,1,13,10,3,0,0,0,1,1,0,1,1,0,27,0,0,1,1,0,296,284,12,1,1,0,98.77078814
77ffa18baba92bcea22e83533628fdf1020f68e1,14,107,110,3,0,0,0,4,37,232,6,10,3.154196187,1941,181,12,251,246,5,15727,15958,231,138,133,5,94.37086093
2fb731f916c9888b6d7dcc348eee05a5887a316e,3,155,1,154,2,0,2,1,16,13,2,3,1.187403291,335,4,0,77,68,9,2852,2135,717,38,32,6,99.68963377
a7b29658ff7c656cb566680fa3c9cc10da5f1d0a,7,240,6,234,4,0,4,3,23,43,3,6,2.280617565,598,182,8,139,120,19,5108,4083,1025,67,60,7,99.44615385
79c880d9326850e970d6c07ccfd9f3128d17a7e2,0,0,0,0,0,0,0,0,0,0,0,0,0,0,5,1,0,0,0,0,0,0,0,0,0,100
f574e576c7098d563eea279596920178f7f5c288,1,5,1,4,0,0,0,4,17,8,1,1,0,348,183,9,70,68,2,2280,2251,29,32,32,0,100
c804236529b889a85d8c0aed4f4358a1c46dbbfa,0,0,0,0,0,0,0,0,0,0,0,0,0,0,184,10,0,0,0,0,0,0,0,0,0,100
5de0fa6473bc186926840154e7cf534b3f9839b1,9,84,70,14,0,0,0,2,24,99,2,4,2.661039341,496,185,7,82,78,4,3793,3505,288,48,43,5,99.87745098
1f07109d71c683455af484e16d3966b18d415c45,18,195,95,100,0,0,0,2,38,121,5,10,3.65432136,2816,1,1,484,471,13,22343,21622,721,257,247,10,99.57575758
874e48b78f97533bc6898946dbb1aca10235abd9,0,0,0,0,0,0,0,0,0,0,0,0,0,0,186,6,0,0,0,0,0,0,0,0,0,100
1a74e13ea8eb614cdd62f3d87d4926717ca4be92,2,18,0,18,0,0,0,3,10,253,1,1,0.309543429,47,187,6,5,4,1,439,306,133,5,4,1,99.76062238
8f0a3ed50aa7a347558551ab5ce3a8bc2e8e92a0,28,245,153,92,1,0,1,3,42,121,5,12,4.028045582,4414,188,7,800,794,6,32378,31831,547,420,416,4,99.64179104
1028c19e2c5a6ce8e6009a7e2b29bcb3db0e9c81,1,19,19,0,0,0,0,4,12,79,1,1,0,139,189,8,32,32,0,1081,1100,19,21,21,0,100
c29ba46c85026003401ab9e02f44077acb21771a,1,24,24,0,0,0,0,5,19,3,1,1,0,254,190,8,36,36,0,1979,2002,23,23,23,0,100
9a8daa1d5cdceb4e58d56dbca435e361c19dc107,1,1,47,46,0,0,0,3,6,719,1,1,0,466,191,9,72,77,5,2622,2809,187,38,41,3,100
c1b23fdb0bfe5d3e9937d60f0baa43772737f002,8,81,92,11,0,0,0,3,43,203,1,4,2.651871717,2175,192,6,388,394,6,16476,16235,241,178,180,2,100
2b8467ea9e06a972be87b0da95768755c5864773,2,35,17,18,0,0,0,3,15,227,2,2,0.866725613,530,193,7,112,112,0,3633,3522,111,47,48,1,99.82132222
b9e9e18dd94a2c9b3d1308c553a3e3022b2d5fd1,1,1,1,0,0,0,0,3,11,90,1,1,0,121,194,6,15,15,0,904,904,0,6,6,0,100
c97136fc1d1e99150dcea240c6862d4c8796d17e,0,0,0,0,0,0,0,0,0,0,0,0,0,0,195,7,0,0,0,0,0,0,0,0,0,100
99e409b66bb28d1a93a1382014e70bd5e2d6af0e,3,47,5,42,0,0,0,3,12,280,3,3,1.382498693,466,196,8,94,81,13,3738,3420,318,78,65,13,100
ce3afb08fd3a5f00a46347ab4be3e7fc6958448f,1,2,2,0,0,0,0,4,19,18,1,1,0,350,197,9,69,68,1,2322,2322,0,32,32,0,100
83e5d99e509835318d7d794d5bab83e37670e088,0,0,0,0,0,0,0,0,0,0,0,0,0,0,198,6,0,0,0,0,0,0,0,0,0,100
f7f97e0506447f5d9f6be100e91017871af9762b,3,78,2,76,1,0,1,3,11,173,2,3,1.181290899,255,199,7,48,43,5,2140,1761,379,31,29,2,99.702558
7872f32962b5fdb5229be6bfc36eb73ec01ff79f,9,648,109,539,1,0,1,3,27,70,4,5,1.919545602,1290,200,6,303,217,86,12244,9557,2687,161,116,45,96.57910812
fac475dbb2b70efbde9b0ec0be60231e2e17bfe6,0,0,0,0,0,0,0,0,0,0,0,0,0,0,201,7,0,0,0,0,0,0,0,0,0,100
abc1538fb0ba6ae9d761ea7189d9ba9b723444d4,0,0,0,0,0,0,0,0,0,0,0,0,0,0,202,8,0,0,0,0,0,0,0,0,0,100
7f57773b8ab62e11b6307cef2acf594b44b03e97,13,267,114,153,5,0,5,1,44,105,5,8,3.344080863,2053,2,0,400,399,1,15321,14882,439,200,199,1,98.06973848
00f80b446faa61310f58d9986aa9bdcea56ac970,5,78,24,54,0,0,0,1,45,201,2,4,2.081416951,1321,3,1,271,262,9,9520,9152,368,106,103,3,99.9382716
7a955ef438af44de89f031c49ec1bb763361d06a,1,5,3,2,0,0,0,5,46,4,1,1,0,790,203,4,173,171,2,5654,5613,41,67,67,0,100
46084224605791a34632b03483c5abf656cf6c8f,7,39,15,24,0,0,0,2,20,209,1,3,2.649144568,912,204,4,168,166,2,6518,6356,162,94,92,2,100
d022b687f2c0c4fd23a6383dd8f27cad10363273,1,2,2,0,0,0,0,1,2,151,1,1,0,70,205,5,10,10,0,636,636,0,4,4,0,100
de25e8130176d8d347acc82ef9fc16881837f80c,5,64,16,48,1,0,1,1,47,58,2,4,1.911604301,1149,206,6,226,224,2,8128,7923,205,105,103,2,99.81504316
1f4b5727b5b536cd10a51f8378358386e2a798da,0,0,0,0,0,0,0,0,0,0,0,0,0,0,207,7,0,0,0,0,0,0,0,0,0,100
8cac9d54f1e3e713afe41c170da59a41efd81334,1,8,3,5,0,0,0,5,14,44,1,1,0,139,208,5,27,26,1,1013,974,39,19,19,0,100
bc435ad49b4d81708b873005688f3dd65f3523a1,1,6,4,2,0,0,0,6,15,18,1,1,0,144,0,0,28,27,1,1026,1013,13,19,19,0,100
5b4bc0e7d12e1b2a465774c133e04150b91fcbd9,2,9,1,8,0,0,0,3,48,82,1,1,0.970950594,978,143,0,222,220,2,6892,6857,35,94,93,1,100
7b3a9a6f5f8e8075727d84e3ddeae7b594eda89c,1,14,1,13,0,0,0,4,6,33,1,1,0,89,209,5,9,9,0,693,590,103,5,5,0,100
9f93037a965970d0de1db7920ac498901886c45e,1,9,3,6,0,0,0,5,7,8,1,1,0,101,1,1,11,9,2,739,693,46,5,5,0,100
0f7169db51ba15108c265b1e937e9daeaa085045,1,13,9,4,0,0,0,6,49,10,1,1,0,805,2,2,175,175,0,5781,5777,4,68,68,0,100
c16cb1c6598855c47737dff46d4b07a580a37a32,2,52,13,39,0,0,0,4,20,74,1,1,0.655942076,377,210,2,49,44,5,3400,3140,260,18,17,1,100
2d99e61728402ccf848f4c47a38ac15d6275344d,13,279,146,133,1,0,1,3,50,137,2,8,1.688777842,2394,211,2,431,396,35,18106,16425,1681,240,210,30,86.39652677
dd15f2a29ba408f690821f97d4372b32d813346d,0,0,0,0,0,0,0,0,0,0,0,0,0,0,3,3,0,0,0,0,0,0,0,0,0,100
1beef8741160aa471a3b5af4c677875296f0a0aa,11,167,171,4,1,0,1,3,51,147,3,7,3.164165162,1829,4,4,335,332,3,13146,13146,0,153,152,1,85.96739901
2d53656837d9d56792bc62a062dc1481aaab3024,13,78,64,14,0,0,0,4,52,307,4,11,3.262453613,2190,5,2,383,379,4,16487,16383,104,198,197,1,100
cb7e6d42904ed91d960c8dd8c9e49d0f0461c228,2,2,2,0,0,0,0,3,26,76,1,1,1,593,212,2,104,104,0,4629,4628,1,40,40,0,100
326acb087949498be31ce00e0c0bb0fecc32c1a7,4,103,5,98,1,0,1,3,53,82,1,4,1.804108448,1354,213,3,268,254,14,10784,10127,657,110,105,5,99.76261128
2ca8b934bf55c57f55108524189c6a7789cb35c3,2,2,2,0,0,0,0,3,27,0,1,1,1,593,214,4,104,104,0,4628,4629,1,40,40,0,100
415bb3ed7fa7363e77ae4fd66195e5960a0cf479,1,7,3,4,0,0,0,4,23,2,1,1,0,294,215,5,40,39,1,2433,2414,19,13,13,0,100
bb5c258c308acb04bf0daf412f89a3da8400f694,4,12,11,1,0,0,0,2,21,92,1,1,1.850347023,660,216,5,123,123,0,4593,4565,28,54,54,0,100
3e69b13a2bfd55c56e0c5f2d310601dcfc46731e,7,380,56,324,2,0,2,1,10,110,2,3,2.327105189,712,217,5,143,110,33,7169,5117,2052,79,61,18,99.64580874
4104860b9a1b79b997df4e39c3c70c7008422da4,20,359,146,213,1,0,1,1,54,231,4,8,3.724275049,3715,218,6,779,743,36,27752,26202,1550,399,381,18,92.15070644
8fd74ede411196a2b762b6ed741eccb30248e81c,14,346,49,297,1,0,1,4,55,110,4,9,3.22470141,2546,6,1,496,460,36,20435,18463,1972,244,225,19,99.90583804
cbfa28a0232d969521f5d905d3d22c3b0a8ab402,11,189,75,114,0,0,0,3,56,285,4,5,2.149296339,2320,7,0,461,439,22,18061,17572,489,248,235,13,100
1185121ab57cb64f14947510f7e7ebafe8c6ef54,8,83,6,77,0,0,0,1,30,161,3,6,2.375794455,982,219,0,166,159,7,8120,7524,596,88,82,6,99.95300752
b47ba4266c1ecb308130530e4d34ad08e209924b,14,26,26,0,0,0,0,3,57,299,6,8,3.690260391,2213,220,1,395,395,0,16003,16003,0,195,195,0,99.81220657
288ea4f427f3670ebcbe8027587fbcf2a4d56986,4,90,9,81,1,0,1,4,25,26,3,3,1.488326828,690,221,2,93,85,8,6180,5769,411,44,36,8,99.71883786
9494b75c1ef285fb8a292118de97ccc37cc5b89c,1,10,1,9,0,0,0,3,19,148,1,1,0,282,222,3,54,53,1,1984,1947,37,23,23,0,100
f2fed3a4d88b353f22df9a4b88445842ca9a9577,7,48,7,41,0,0,0,3,21,254,2,4,2.332628556,1012,223,4,197,193,4,7368,7095,273,106,104,2,96.49947753
d87875e5c9288ea5ab6e5e864f9e4735605ca0f0,0,0,0,0,0,0,0,0,0,0,0,0,0,0,224,5,0,0,0,0,0,0,0,0,0,100
05fb38bf1e169e30a59c511682159964b47ec8c6,0,0,0,0,0,0,0,0,0,0,0,0,0,0,225,6,0,0,0,0,0,0,0,0,0,100
00f64b4c17dfa2f5bd57d25aec5c5eb24c1bb535,11,193,52,141,0,0,0,4,58,126,3,7,3.106196241,3024,226,4,603,580,23,23205,22227,978,256,248,8,97.17253318
c692bf201d01a67e2c85efcd625e0bf80c96758b,9,209,45,164,0,0,0,4,43,70,3,5,2.854461833,2159,227,4,409,381,28,17228,16273,955,238,226,12,99.71973094
e37ab2ee164fab84172513a72aa7175826b8dfd0,6,344,90,254,2,0,2,1,12,201,3,5,1.820585013,680,228,4,147,135,12,6465,4832,1633,75,65,10,99.55431755
6c97d0603ae8c12776b87b419ac5e66adafcccc5,11,73,45,28,0,0,0,3,33,154,3,6,2.938845947,1855,229,4,356,352,4,13187,13010,177,206,202,4,100
4309324418d90f8a86160456019f04e9e66bb2cb,7,93,7,86,0,0,0,3,59,85,2,5,1.594702589,2103,230,5,418,408,10,16113,15513,600,186,182,4,100
bbc79cf4621536d212ee1caffaabb54eba4263a6,0,0,0,0,0,0,0,0,0,0,0,0,0,0,1,0,0,0,0,0,0,0,0,0,0,100
55fffd96b8b1c31e1a4b9549b26657c881eea02e,3,32,4,28,0,0,0,4,13,604,1,2,1.362492021,765,0,0,146,142,4,6031,5815,216,75,74,1,100
5e3269bb2c0d95b011097ad71124a2d2796739fc,5,39,18,21,0,0,0,6,16,128,2,4,2.144906082,806,1,1,154,148,6,5614,5392,222,65,62,3,98.2373678
ba83ce132769591f302e5f780117cc03130b4870,2,3,1,2,0,0,0,5,15,446,2,2,1,334,2,2,42,42,0,2985,2993,8,17,17,0,100
451e8551b7f8aea23a969d6bccb8a56b5937c7f7,13,173,232,59,0,0,0,5,60,171,3,8,2.516084473,3572,3,3,675,680,5,25340,25606,266,328,330,2,100
09bb6cd1692b6506a3f9db805f911e277c627a80,7,106,78,28,0,0,0,4,45,69,2,4,2.025613151,1854,4,4,331,322,9,14483,14262,221,160,154,6,100
fef6574c2887d99d1f04618ade6dec1c67eeb6bd,7,73,39,34,0,0,0,2,34,36,4,6,2.493136754,1683,5,5,271,264,7,13304,13076,228,131,127,4,99.9377335
d7d7061803b1bfa8890982153db82fcadde7e777,0,0,0,0,0,0,0,0,0,0,0,0,0,0,2,0,0,0,0,0,0,0,0,0,0,100
5016d5d7af93936a1dc9065806dde423219a3345,0,0,0,0,0,0,0,0,0,0,0,0,0,0,3,1,0,0,0,0,0,0,0,0,0,100
cf1e6a3c8732cbaaf2d5b55a95c88011147bb127,19,124,67,57,0,0,0,4,61,402,4,9,3.475542863,4438,8,0,829,820,9,32807,32305,502,390,385,5,97.34826164
038ef310cab0043a630bcf00f490ec334e358b5e,4,100,2,98,1,0,1,2,11,254,2,4,0.663899848,397,4,0,60,48,12,3583,3118,465,30,24,6,99.55232233
c3407a2206e5f9acac20efbc6998ae19164df5ce,11,42,48,6,0,0,0,4,62,264,2,7,3.317604846,2131,0,0,360,361,1,15992,16005,13,168,169,1,97.95680093
0a68fc2ee8df8ed42dfc79baec55aca5c8829625,0,0,0,0,0,0,0,0,0,0,0,0,0,0,5,1,0,0,0,0,0,0,0,0,0,100
1b753aebac1598dd4140229c0ce7db88d75fcdb2,0,0,0,0,0,0,0,0,0,0,0,0,0,0,1,1,0,0,0,0,0,0,0,0,0,100
ccc380119edb31631943b91b1f2f0fa70fc3bf86,8,150,10,140,1,0,1,7,30,126,3,4,2.577446963,1328,2,2,230,210,20,11080,10262,818,130,119,11,97.62892709
137415c2d864f5243709f9d9b52dfdfb87978350,0,0,0,0,0,0,0,0,0,0,0,0,0,0,0,0,0,0,0,0,0,0,0,0,0,100
ca1c7dfd13191f39a918e60ca3f85fdab52e72ff,0,0,0,0,0,0,0,0,0,0,0,0,0,0,1,1,0,0,0,0,0,0,0,0,0,100
4d14160995063ea9d126cc5c5ca823e0e3d956ae,0,0,0,0,0,0,0,0,0,0,0,0,0,0,6,0,0,0,0,0,0,0,0,0,0,100
ca1106caf8f48daffba2f2f2bac2409ab64cabff,2,19,6,13,0,0,0,5,63,351,1,2,0.989587521,1219,0,0,259,257,2,8846,8758,88,106,106,0,100
ac79be6b25f3f87810015a07badcf20683cd87da,11,82,84,2,0,0,0,6,64,265,2,7,3.055693861,2170,1,1,408,404,4,15569,15508,61,204,203,1,96.33767846
a620c5d7a8e011e29259da6d54af59549d497edd,12,90,101,11,0,0,0,5,62,124,2,8,3.193433004,2529,7,0,472,478,6,17787,17936,149,235,236,1,96.33767846
67bb9fcd4495eb4fa79c128a0abda3578d9a2947,12,101,90,11,0,0,0,6,64,292,2,8,3.193433004,2514,8,1,478,472,6,17936,17787,149,236,235,1,96.33767846
4d00b24ddf9be560679dbe2ec6d6e0a36f4adc13,1,1,1,0,0,0,0,9,65,30,1,1,0,876,3,0,190,190,0,6495,6496,1,75,75,0,100
a3a833290b15d0f74a27c03bf87a14bb380fb260,9,126,37,89,1,0,1,3,66,115,4,8,2.396841192,1751,4,1,341,331,10,13057,12673,384,173,163,10,96.21822691
c213a19691d38f0f28e58d3138f7c6b33689d235,8,88,3,85,0,0,0,6,21,282,2,5,2.633054923,1493,5,2,306,293,13,10943,10560,383,142,136,6,100
a4fd89473d1849ac2b81a0d1bd7f60537630621a,1,2,2,0,0,0,0,3,4,325,1,1,0,78,9,0,17,17,0,494,478,16,16,16,0,100
c2423179b8390a7ece679465e50b9abd47b4686d,4,66,22,44,0,0,0,9,67,211,3,3,1.444995612,1273,10,1,262,256,6,9773,9507,266,114,112,2,100
0236eea307fef8f8829b19dfef8919fb665f42fc,5,74,21,53,0,0,0,4,22,10,2,3,1.959432684,1232,6,2,267,258,9,8914,8621,293,124,120,4,100
ce88606a1c94622255ccadb1fdd474e48793e712,8,165,8,157,1,0,1,6,68,77,2,6,1.953432661,2267,11,2,483,467,16,16882,16057,825,223,212,11,99.88545246
1bc5d2a8276d849857f8bfcd84e39d33e1e75670,3,14,2,12,0,0,0,3,10,867,1,1,1.561278124,111,12,3,28,25,3,813,767,46,25,22,3,100
151c2aeed9fd9ebd7d86dc8ceacbd8580f4a9520,2,8,0,8,0,0,0,5,18,107,1,2,0.954434003,269,13,4,44,43,1,1764,1721,43,32,31,1,100
6a2c3d58df27efaa10bc00c7c8a76730ef8bde64,0,0,0,0,0,0,0,0,0,0,0,0,0,0,7,3,0,0,0,0,0,0,0,0,0,100
e4a016fb039094a55ca802b6d9d26012d49099e7,0,0,0,0,0,0,0,0,0,0,0,0,0,0,14,5,0,0,0,0,0,0,0,0,0,100
86db875aa622fb5432c6048894eafc54c236a7c1,7,149,41,108,0,0,0,3,69,252,2,3,2.380125746,2236,15,6,459,445,14,17458,16703,755,237,228,9,97.41176471
67db67efd4a32b1ec3054571c0a8d885f4db882b,8,183,11,172,1,0,1,6,70,22,1,5,2.19828466,2198,8,2,465,449,16,16612,15791,821,221,209,12,99.69751966
0b73e892afc99562ba15df0518303e918dce3c08,0,0,0,0,0,0,0,0,0,0,0,0,0,0,9,3,0,0,0,0,0,0,0,0,0,100
05812468f7c85b38ff7391e361c27a76929cf48a,2,16,0,16,0,0,0,6,21,65,1,2,0.988699408,411,10,3,77,74,3,2881,2804,77,37,36,1,100
9533febc04745bc259c3ad7abc1882cabf9f35b1,1,6,0,6,0,0,0,9,71,30,1,1,0,931,11,3,201,199,2,6931,6896,35,78,78,0,100
e6fd4949e0e3ae092acf28c988de2c570d639781,0,0,0,0,0,0,0,0,0,0,0,0,0,0,16,2,0,0,0,0,0,0,0,0,0,100
c6c9ddf4d6f692d73b1693dc0746e21f70941876,1,4,0,4,0,0,0,5,16,40,1,1,0,212,17,1,43,42,1,1522,1499,23,43,42,1,100
acd507e6e2a5520682aa6ba37c5042a377f01cd0,33,426,236,190,1,0,1,5,72,335,6,15,3.310341698,5876,18,2,1004,971,33,45687,44184,1503,507,485,22,96.72774869
ef48512da368f7d52ffddd3a8f02890bbdff2b39,13,953,0,953,13,0,13,1,1,0,1,4,3.619109049,0,12,0,55,0,55,2276,0,2276,45,0,45,97.9020979
89b1a1cd9b12623f031845881e3df069dcafe249,6,152,33,119,4,0,4,6,23,13,4,6,2.15938194,404,13,1,57,58,1,3300,2999,301,26,27,1,98.84353741
09b099c71d4f112e4c7802cab1b48f2b84e0620b,26,274,166,108,1,0,1,1,35,336,7,15,3.829335745,2563,14,2,400,356,44,20225,17837,2388,241,221,20,97.85522788
2ce10dc1a88b7657c7d63e02774459afd8724c4d,6,254,12,242,3,0,3,1,36,140,2,4,1.979175638,429,15,3,106,82,24,3846,3084,762,66,51,15,99.47054931
6369d4e65eb3d733d101786b6c79ca600bdace77,1,4,1,3,0,0,0,5,12,420,1,1,0,284,16,4,69,68,1,2038,2009,29,38,38,0,100
50588bde3e3d39757f1893c1451ba9a30d66459f,15,123,72,51,0,0,0,5,24,504,7,11,3.086045223,2062,17,5,368,361,7,16038,15465,573,247,241,6,100
eca35312cef825c209c14b3dff3bc2b94311ef14,26,254,207,47,0,0,0,3,73,275,6,14,4.140554844,6053,19,0,1112,1105,7,46389,45791,598,568,572,4,99.20582396
b1c6d650394b1113192e4e757d8eca81606d2bab,11,61,28,33,0,0,0,3,74,258,3,6,2.190417525,2520,2,0,505,497,8,20016,19835,181,266,263,3,100
357ba82937a757e70e32555423cc8b9edd69271b,3,14,14,0,0,0,0,7,22,27,1,3,1.470142979,644,3,1,119,119,0,4706,4682,24,59,59,0,93.77382465
25d4a59151e6bdbd2cc90ee51e9c22c8bfed4b31,1,2,2,0,0,0,0,3,3,311,1,1,0,80,4,2,5,5,0,616,616,0,4,4,0,100
974919e5e099b80fd85a4ba1bb745db369519b75,3,42,53,11,0,0,0,2,25,15,2,2,0.587666086,189,5,3,33,36,3,1056,1128,72,27,25,2,100
ed8e60dad83ae733fe6c6c3752e82f1fee72c12e,29,162,169,7,0,0,0,2,20,300,2,6,4.464066832,2344,6,4,373,92,281,17549,7612,9937,188,51,137,95.10447761
523fb63832e574fac0a3b8cc65f548e91940dba5,6,578,0,578,5,0,5,1,2,6,1,4,2.18583326,27,0,0,54,7,47,2952,157,2795,36,6,30,95.39508111
3b9d50deddcb2dc846b62ab63dd668f45c8b6536,105,288,288,0,0,0,0,6,75,377,8,32,6.26085537,16909,0,0,2913,2913,0,126458,126814,356,1528,1528,0,100
d16c7dd2571fab11427c0b1ab7112363befe7f92,5,51,11,40,0,0,0,5,24,5,1,2,1.285888233,1104,7,5,171,167,4,9375,9065,310,85,84,1,100
021ee857f5b24d5d8a8ad40fe917803869b0bb75,10,95,53,42,0,0,0,7,76,244,4,8,2.178207732,1976,8,6,376,370,6,15306,14899,407,197,195,2,91.45673604
9d65b502c5b48c8fff8debe5d65cedd10740f973,4,21,6,15,0,0,0,7,25,14,2,4,1.772958306,721,18,0,134,133,1,5288,5187,101,77,76,1,100
a0843f4c2745ef0812107b48a52d2ca083a02eaa,0,0,0,0,0,0,0,0,0,0,0,0,0,0,19,1,0,0,0,0,0,0,0,0,0,100
e35d954e34adb4417dcc96c563df79b559768897,8,90,109,19,0,0,0,7,53,26,2,4,1.862121596,1882,9,5,313,323,10,14278,14372,94,186,182,4,96.87712152
f6814c6b46a54a787983a4245121ee35a9cad0b8,0,0,0,0,0,0,0,0,0,0,0,0,0,0,1,1,0,0,0,0,0,0,0,0,0,100
bbfb8754d136a5404e8c2a813a7468d94165d80c,6,132,108,24,0,0,0,6,77,27,1,2,1.353720581,2716,20,2,572,566,6,19546,19426,120,234,226,8,100
b0dc99205ff6394f4f7698b443a5b2989947bcf5,1,3,3,0,0,0,0,4,4,43,1,1,0,442,21,3,67,67,0,3031,3031,0,40,40,0,100
c3845bc3f3044f513347d8fec220e4e289a0ea5b,5,31,32,1,0,0,0,7,78,23,2,3,1.228111423,2098,22,4,446,446,0,15075,15033,42,184,184,0,100
9b84d79cf9b305aff99b65c782ad340671a58c87,5,162,141,21,0,0,0,6,79,38,1,2,1.266807289,1489,23,5,321,319,2,11445,11005,440,154,149,5,89.6705751
737db65432f41de9f0931781f462ac3e2ee5a763,13,343,34,309,2,0,2,6,54,124,3,8,2.657028979,3433,24,6,663,650,13,29243,27309,1934,356,344,12,99.67875172
59de6bd6ba92fa24c7efdce0feffb814693c268e,10,706,32,674,6,0,6,1,3,28,1,5,2.7446426,226,0,0,103,33,70,5631,1536,4095,72,22,50,93.01227573
a82cd7b126f432cb2851e61155042c9f9ecfdb79,18,558,72,486,3,0,3,7,80,48,4,8,3.131343941,3682,25,7,798,737,61,30329,27056,3273,421,384,37,96.67565139
9b2d7b65cf271e2b3b3616d427edf2688586a56c,5,6,6,0,0,0,0,8,55,297,2,2,2.29248125,1266,6,0,241,240,1,9643,9638,5,139,139,0,98.11827957
940a169bac12b10eb636d62029dddbc9fad420ff,8,317,54,263,2,0,2,1,33,4,2,6,2.124396659,1424,26,7,296,264,32,12213,10667,1546,167,151,16,99.75810353
9774c5cb10dc14b280c8f5bafd852c0581ca0845,21,166,134,32,0,0,0,7,81,87,5,14,3.809549911,4687,27,7,815,813,2,37099,36862,237,425,424,1,92.66055046
48d6a2a421a8b44f4080bad0ef4c004cbf7b456d,21,1314,555,759,4,0,4,8,26,41,2,9,3.713218126,1396,1,0,302,213,89,15072,10931,4141,212,148,64,93.59413203
ca0a1271d1ed73987c8910fc2cfacb1b1b18585e,4,29,18,11,0,0,0,11,82,45,2,3,1.530434323,1980,28,8,422,419,3,14931,14867,64,192,191,1,100
4bd32cda3909dad92a618cbe7e194d62979978d5,2,78,16,62,0,0,0,1,34,20,1,2,0.704576713,775,29,8,129,129,0,6852,6401,451,71,71,0,100
a82ced5ddb405fb5e12fb5c94c3d21aca65b9660,16,133,139,6,0,0,0,6,83,23,2,6,2.953371428,4853,30,8,837,839,2,38211,38271,60,389,389,0,98.43978547
60d0bc163182a52b5e0cb380d33e706a35e13d30,16,135,142,7,0,0,0,7,84,0,2,8,3.038059062,4649,31,8,832,829,3,36726,36705,21,400,393,7,95.6864808
ce783995f6612fa76f24a59c23e5964a4bf434a1,4,203,9,194,2,0,2,1,32,23,2,3,1.45484727,422,32,8,102,89,13,3661,2866,795,51,46,5,99.71014493
8ef7b4852163456eb5db6c5bbb8440d9c3cb36b0,2,53,29,24,0,0,0,7,22,9,1,2,0.659375881,302,33,8,54,50,4,2451,2345,106,32,25,7,100
39916f231499351c35dce64a1b5434ade1a5cf5f,22,334,123,211,1,0,1,6,85,57,6,12,4.005032373,3263,34,9,582,549,33,26034,24486,1548,301,280,21,99.30795848
f7dea20f19a7432b32cedda0fa4b8e7bd648ee66,1,5,5,0,0,0,0,8,20,1,1,1,0,161,7,1,33,33,0,1005,998,7,12,12,0,100
aa38160890a0ffb7b8a3b0a7b709e12156c1a737,6,39,28,11,0,0,0,5,86,236,1,4,2.289001118,1764,20,0,367,363,4,13003,12842,161,179,177,2,100
2272086a5aebb65a7b0bfe1de59087641b96609f,3,44,2,42,0,0,0,5,9,594,1,1,1.565340216,274,35,10,86,73,13,2037,1781,256,47,43,4,100
ce5f48c41e4666f96dfd1444845f1f9a1e0cf0bc,17,398,251,147,3,0,3,7,35,91,3,8,3.322021683,2415,36,10,292,287,5,20638,19859,779,149,141,8,93.83209595
0b7337083600f584624384c05bf5b6236e0f9dbe,17,249,396,147,0,0,0,7,36,0,4,8,3.323094315,2495,37,11,287,292,5,19859,20638,779,141,149,8,93.83209595
cce03d04bb7ff7670345bbd1e1574c0fdd0d6751,17,398,251,147,3,0,3,7,37,0,3,8,3.322021683,2415,38,12,292,287,5,20638,19859,779,149,141,8,93.83209595
85d8e025ffe332dc1329fbecd41d841fbc136db8,23,1790,385,1405,14,0,14,2,6,1,1,10,3.891556552,1352,0,0,303,193,110,15872,10614,5258,207,136,71,92.68292683
c59425465d531b57f17fdba35b1567076e4be306,16,302,67,235,1,0,1,7,57,166,2,7,2.947897234,3059,39,12,588,557,31,23841,22565,1276,310,294,16,89.90486258
e308cf599c3f08e12b4781288e9dc0b4eadb777d,4,51,12,39,0,0,0,1,2,4,1,4,1.187397704,436,1,1,60,56,4,3476,3255,221,42,39,3,100
b901b3a5a95a0128569d3a660fd0af24a7ee83e4,24,585,1125,540,1,0,1,2,7,23,1,11,4.112552655,1964,2,1,241,281,40,13116,14435,1319,142,190,48,97.99121155
4d723a2c73b353f5228b067635383e03a697f563,18,354,80,274,3,0,3,6,30,71,2,6,3.545041217,3066,40,13,596,559,37,24212,22875,1337,273,251,22,88.51351351
1d2ebee02d9e97763936ebd9b8b7cbfded514a1e,10,205,34,171,1,0,1,7,38,20,2,9,2.683826263,2575,41,14,491,470,21,20672,19547,1125,276,263,13,88.22368421
27c2dfe6e30fb51f209e57ee9d40c14bb5c14f9a,9,27,12,15,0,0,0,4,34,250,5,6,3.00184709,1584,42,13,240,239,1,11748,11649,99,125,124,1,100
8055e5d6e4b885b05aee302cd5f99fa1622e63c3,14,246,144,102,0,0,0,3,58,312,3,5,2.931904428,2591,43,12,408,400,8,22224,21503,721,213,205,8,100
380baa9fd200af3fb09c038d21d8ab4c20fd4123,9,134,51,83,0,0,0,8,87,54,3,7,2.340819757,2054,0,0,387,376,11,15651,15330,321,203,193,10,91.38634047
00fa4a276259b5fe91f3971db2fba606446727ed,1,0,1,1,0,0,0,5,8,4,1,1,0,103,44,9,18,18,0,544,549,5,17,17,0,100
da8a0b494029ed4a94429eca126b11a780da34aa,0,0,0,0,0,0,0,0,0,0,0,0,0,0,45,10,0,0,0,0,0,0,0,0,0,100
1d07b18eda61318c14661691051079f943a8ee29,3,64,12,52,0,0,0,7,27,24,2,3,1.060665546,745,46,9,163,152,11,5451,5124,327,98,91,7,99.77963861
cce89d0594c223c9fac80654f9bc9b35832197ab,0,0,0,0,0,0,0,0,0,0,0,0,0,0,47,8,0,0,0,0,0,0,0,0,0,100
079ad4876bd92e6acd43667c5ade610311a5e4c1,3,52,8,44,0,0,0,6,28,15,2,3,0.674679923,966,48,9,157,155,2,7878,7523,355,77,75,2,99.95590829
f9785690a0c8ee90582a8d91de562f19fc803d20,0,0,0,0,0,0,0,0,0,0,0,0,0,0,8,0,0,0,0,0,0,0,0,0,0,100
7255747a2b6b423a47ee82dd80728e52c7a05d6b,1,1,1,0,0,0,0,11,88,13,1,1,0,934,49,9,195,195,0,7223,7223,0,76,76,0,100
2c40f8a0d50b6dc9e083df01e9f78b5c1ff85921,1,1,1,0,0,0,0,11,89,0,1,1,0,934,50,10,195,195,0,7223,7223,0,76,76,0,100
6f3419ad8bc54b4732309f8981482b8726ec428d,1,1,1,0,0,0,0,11,90,0,1,1,0,934,51,11,195,195,0,7223,7223,0,76,76,0,100
d28b6493f89887c0b65c5a49a54c63ff2aa033cd,5,60,154,94,0,0,0,2,5,55,1,2,1.579141688,142,2,0,12,15,3,966,1032,66,5,8,3,99.64695499
5c37675fa38f54a7171b4581ba3148652f7f55c1,55,0,0,0,0,0,0,1,1,0,1,10,0,3149,52,10,285,550,265,27651,57640,29989,156,110,46,82.43105209
16cadb68b8bd157e92662ab1ed427463a8e2ee91,0,0,0,0,0,0,0,0,0,0,0,0,0,0,53,11,0,0,0,0,0,0,0,0,0,100
1e8b234478c61db323c7149a8b14d8435be6cd82,5,167,62,105,1,0,1,6,91,31,1,2,1.656208229,1622,54,12,338,328,10,12439,11979,460,154,148,6,99.87908102
8fb860315fa8bc2150836ae98c0503fb28187873,1,7,3,4,0,0,0,5,5,114,1,1,0,54,9,1,5,4,1,534,487,47,2,2,0,100
a0f19ceb2a70644ce31ce6d92ef228bb10127b07,3,3,3,0,0,0,0,2,3,22,1,3,1.584962501,483,3,0,64,64,0,3552,3552,0,36,36,0,99.75845411
3fde3d2ac7c48c93d2dd1b18c560cee1d918046e,11,189,58,131,1,0,1,1,59,88,5,6,2.678385636,1769,55,12,310,295,15,14589,13997,592,212,201,11,94.46366782
5b8bbee83ac5513e9d2f7de239875f33b33b7afd,0,0,0,0,0,0,0,0,0,0,0,0,0,0,56,13,0,0,0,0,0,0,0,0,0,100
df538e50531379488e768bc640721b00f4a43e6f,4,15,28,13,0,0,0,9,92,52,2,3,1.559352796,1371,1,1,272,273,1,10489,10567,78,131,131,0,100
2fb45da948230ca2bc194ed8e41440d1b7b0bcb8,0,0,0,0,0,0,0,0,0,0,0,0,0,0,57,13,0,0,0,0,0,0,0,0,0,100
96a3b1bfeda319e8543da3dbcd2afadd5468a803,11,275,173,102,1,0,1,6,93,71,3,6,2.559837768,3507,58,14,712,692,20,27196,26678,518,354,336,18,93.81261049
68bb4c9189659da48f2069f3f96754914bc20d30,7,96,142,46,0,0,0,1,40,272,3,6,1.251712315,933,59,15,136,132,4,7287,7443,156,63,61,2,99.49206349
51a306cb60f77036fc84ddfa42746d61d740c234,0,0,0,0,0,0,0,0,0,0,0,0,0,0,60,14,0,0,0,0,0,0,0,0,0,100
1dd3d0bffdddf571d5de3b38b6c998b7e26fe10a,0,0,0,0,0,0,0,0,0,0,0,0,0,0,61,15,0,0,0,0,0,0,0,0,0,100
8136a972c178528d06f22a0dfdc6e42c3ce17c44,2,17,1,16,0,0,0,7,31,30,1,2,1,570,2,1,115,112,3,4216,4117,99,79,77,2,100
b600fc21df1c3b72be1702e2bf57295cdcf55220,18,263,75,188,0,0,0,1,94,101,4,8,3.314561897,4819,62,15,898,869,29,38542,37097,1445,463,453,10,99.80879541
0b22e0935a95aea1eb70d38e713526d71d71df45,5,246,137,109,0,0,0,1,33,371,2,2,1.063186235,1095,63,16,246,230,16,9002,8382,620,112,94,18,99.55357143
d4ec63a0b93c5fd64d0c9b769e99f723d43e43b8,14,76,84,8,0,0,0,1,95,130,5,10,3.161118269,2734,64,12,534,514,20,21331,20231,1100,279,274,5,98.72286079
6b63986de09d602dd8619f808496226ec1c5a3cd,0,0,0,0,0,0,0,0,0,0,0,0,0,0,3,0,0,0,0,0,0,0,0,0,0,100
a1edeabea016ff7c55d4459fdb96c70a0ff132c7,6,127,28,99,1,0,1,1,34,364,3,3,2.170555652,1302,65,8,238,220,18,11540,10864,676,115,109,6,99.80867347
959d493c0eacce6712bffe39924bd0440d11a6b0,15,75,470,395,0,0,0,1,96,119,5,9,3.52137223,3865,66,9,658,714,56,27483,29954,2471,356,387,31,91.92650334
609773e03c96f733829a93cc5bbcc3febd25408d,7,185,168,17,0,0,0,1,42,34,3,4,1.87852909,1578,67,9,240,228,12,12498,12319,179,119,111,8,99.95054402
9296a3bc0b79cf73a6576e0b4c0b981d1ea3b221,4,111,66,45,0,0,0,11,97,138,1,1,0.959945974,1736,68,9,366,360,6,13364,13005,359,160,157,3,100
a56bfcebd5bc44582a51fb0679a14fb5802f8702,1,15,4,11,0,0,0,7,29,77,1,1,0,395,69,7,78,78,0,2777,2678,99,35,35,0,100
d72d9c6eb8cb32fa4058b5ab5710e9cd45e2653d,12,338,61,277,0,0,0,1,98,244,3,7,2.626512972,2817,70,8,570,533,37,23828,21911,1917,332,309,23,99.55621302
046782430a9aee3094869ca2b63bcf0194c70e93,12,558,379,179,4,0,4,3,4,69,1,7,2.962844688,881,4,1,141,151,10,7773,8536,763,89,99,10,98.97008337
27a8cbb49db95327d1c70b8665944510083de3d4,1,13,14,1,0,0,0,7,30,3,1,1,0,406,71,8,78,78,0,2780,2777,3,35,35,0,100
bef9a72e32ee93adf3d532c2397e01e098afff59,23,800,271,529,9,0,9,1,37,75,6,13,3.628878506,3073,72,8,569,549,20,24843,23368,1475,318,304,14,98.83608147
087652d47704dc8b9edf7d28f8e6268af1364b1b,29,194,102,92,0,0,0,3,62,128,5,13,4.42298121,4168,73,9,668,666,2,33540,32303,1237,417,415,2,99.03846154
74a3a7ce2db6b50bf8d1c6d57dee38a44461795f,16,107,63,44,0,0,0,1,99,134,3,5,3.216614136,4055,74,10,762,754,8,30300,30114,186,401,398,3,100
3b0be0287f2c15de90552a6a83b58251a0eab8e8,7,349,35,314,2,0,2,1,36,0,3,4,2.157178888,1277,75,11,263,224,39,10374,8807,1567,155,132,23,99.56793087
00274fa39073e359433005c96097efaa24024702,12,251,85,166,1,0,1,7,64,61,4,7,2.788667501,2365,76,11,451,425,26,18300,17350,950,256,245,11,99.43127962
cb68b56c2cb02ff3953b146d1029156941f33d3a,13,339,189,150,1,0,1,1,65,279,4,8,2.746953664,3133,77,12,501,479,22,25359,24543,816,254,234,20,99.81282171
76e89911ad8591cd16a460095cbb22a8a5625347,3,28,5,23,0,0,0,7,37,65,1,2,1.234388884,792,78,13,145,142,3,5446,5356,90,69,68,1,100
c038d2e215620d312407e14843949f6873cd7b04,11,261,34,227,1,0,1,1,23,134,2,4,3.000320211,1343,79,12,245,213,32,11285,10066,1219,140,120,20,87.50681942
09cc126d7364fdfc23cac4d82af1fc84310c3884,10,375,16,359,5,0,5,1,7,40,1,4,2.581063768,316,21,0,50,29,21,4626,2487,2139,32,24,8,96.35653871
5a8495eb287339a528b153396da6cd8c79c676b5,2,24,0,24,0,0,0,6,11,67,1,1,0.249882293,299,22,1,42,39,3,2715,2544,171,29,28,1,100
a8c4ca056b3b3bfb0537da9da725198db5b818e1,0,0,0,0,0,0,0,0,0,0,0,0,0,0,0,0,0,0,0,0,0,0,0,0,0,100
b7b7e7e0e270531cbe916faed47e38b5e0b21dc3,0,0,0,0,0,0,0,0,0,0,0,0,0,0,23,2,0,0,0,0,0,0,0,0,0,100
5ae2490deee1cb30347d2c2ec492010a4567a181,12,443,1,442,11,0,11,1,2,6,1,3,3.120969125,73,5,0,60,14,46,3266,464,2802,36,14,22,85.43123543
52c10915f752a09576707c274e0858f595f8e185,0,0,0,0,0,0,0,0,0,0,0,0,0,0,6,1,0,0,0,0,0,0,0,0,0,100
29850741e635d31e49274dec610f106c001b11f0,0,0,0,0,0,0,0,0,0,0,0,0,0,0,7,2,0,0,0,0,0,0,0,0,0,100
32a04999d84935d02c9107263f00baee9f039245,11,192,5,187,0,0,0,1,2,11,1,2,3.457207537,349,8,3,46,46,0,2800,2800,0,22,22,0,100
61bae7d81ee6439b891d852496004e8cd98ea981,0,0,0,0,0,0,0,0,0,0,0,0,0,0,80,0,0,0,0,0,0,0,0,0,0,100
36fa43436906e818182935585d960cca2407e678,2,8,7,1,0,0,0,9,45,150,1,2,0.836640742,501,81,1,95,95,0,3430,3430,0,55,55,0,100
e5692f3d7d59cdaed6ff4967c4595119996ea48c,1,5,3,2,0,0,0,4,11,408,1,1,0,18,82,2,2,1,1,142,157,15,2,1,1,99.78757302
f614d713d9fcf1a906991faeb51c01ae445c4f90,1,535,536,1,0,0,0,2,2,2234,1,1,0,584,83,3,13,13,0,4779,4779,0,5,5,0,100
d1ace258929b6771502c1f9f8a37903c63171b5c,1,2,2,0,0,0,0,1,3,62,1,1,0,65,9,0,7,7,0,411,414,3,2,2,0,100
aa6ed83a1940dec05f021c3340b316d3f7bce00a,5,75,24,51,0,0,0,2,5,256,1,5,2.078656323,739,10,1,116,109,7,5754,5393,361,68,64,4,100
d0648a520a24ba2a9df6a6d7c3716cfdc3581b82,1,10,4,6,0,0,0,3,4,285,1,1,0,135,0,0,20,20,0,984,910,74,8,8,0,100
f283ffacb771130c70bdebb61d020fbc0c2aca46,2,12,12,0,0,0,0,7,25,251,1,2,1,207,24,0,24,24,0,1737,1751,14,13,13,0,100
447ccfb1f152a605c10e06f940df17bc5de6ea37,6,185,49,136,0,0,0,3,6,147,1,6,1.862450396,820,11,2,139,120,19,7342,6404,938,67,66,1,100
dbe103eecc5cae0778917e29f77d543cf8888496,8,13,17,4,0,0,0,1,66,279,5,6,2.806238929,1788,84,4,293,294,1,13970,13929,41,163,164,1,100
b91700193cc9d153f300a81e1b15bb6e650dcf37,2,14,0,14,0,0,0,7,100,187,1,2,0.749595257,1015,25,1,202,200,2,7843,7812,31,82,81,1,100
386f70284277a87214115e31bc92752b443bd2e6,7,290,104,186,1,0,1,2,6,92,1,4,1.925521084,730,12,1,117,102,15,6358,5432,926,49,41,8,99.84076433
29921d2840aa887f55ae650c544147dd8f60fedd,2,17,17,0,0,0,0,8,25,953,2,2,0.873981048,348,85,1,74,74,0,2730,2750,20,41,41,0,100
a0f98c1eb8d1f755433a669c0ddbff0d9601b97c,4,7,24,17,0,0,0,4,101,282,1,3,1.767293487,1486,10,0,306,308,2,10887,11021,134,163,165,2,100
59aa6f3c82440d6b9af06690d6ddf2cb5922ea6e,8,62,52,10,0,0,0,5,102,459,3,5,2.224549025,1841,86,0,385,383,2,13363,13307,56,162,160,2,99.78802332
55030b233bb0a98449141a3a731020960e4403e9,8,43,43,0,0,0,0,8,46,355,2,5,2.642081,1639,87,1,248,250,2,13038,12962,76,120,122,2,100
04fd22f0ab357818853bbcfdf180f867dc1aa5c8,2,3,2,1,0,0,0,7,103,42,1,2,0.970950594,1019,26,0,202,202,0,7837,7828,9,82,82,0,100
35838f032a4096d78843130fa1435bcddf5ce961,0,0,0,0,0,0,0,0,0,0,0,0,0,0,0,0,0,0,0,0,0,0,0,0,0,100
5680cf5fbb03362c65f0514adf104a5e29ea9b57,19,562,170,392,1,0,1,1,46,218,5,11,3.214789815,3746,88,2,741,669,72,29268,27038,2230,415,373,42,96.40776699
03c5fd82044612d71c021c0c8a7a15999d28f170,16,121,80,41,0,0,0,1,67,287,4,7,3.569602583,3043,89,3,586,575,11,22406,22178,228,352,347,5,100
29fe5017cb1a6c01fdf34f96829db04b86a2ef40,1,0,1,1,0,0,0,4,8,19,1,1,0,293,1,0,45,45,0,2254,2267,13,27,27,0,100
74b491cc76aa5e26029c3f6d77c1210809ecc110,13,273,74,199,0,0,0,1,43,253,5,9,2.620516447,2015,90,4,392,368,24,15754,14320,1434,252,234,18,99.95527728
c779f7a585227f5d57e2d21e130627d540b91d69,5,50,17,33,0,0,0,2,47,171,1,4,1.382585728,1122,0,0,198,196,2,8724,8483,241,114,113,1,100
c4330f2ef9f8b89e9819e364e41547bd8e230bf2,2,32,4,28,0,0,0,3,10,154,1,2,0.997772472,503,91,4,110,105,5,3432,3290,142,60,57,3,100
1fc5acedda4dbd7c62fe73c8656c792871f4661f,1,14,6,8,0,0,0,10,33,314,1,1,0,385,1,1,72,71,1,3005,2970,35,48,48,0,100
1240266c25ee2a9a3b23d08451a1194c900041df,5,21,18,3,0,0,0,8,104,249,1,1,1.946417661,1955,27,0,404,404,0,13833,13776,57,164,164,0,100
b6cb1dd2f5732bd731fc0e671900086a5b4b6713,2,144,4,140,1,0,1,1,2,169,1,2,0.244765082,104,1,0,28,11,17,1782,805,977,13,7,6,99.91079393
97c152bb2fbabf462d32e6ebb05dfb30f4ed9a18,6,109,25,84,1,0,1,1,38,54,3,6,1.446149164,1214,92,3,166,163,3,10497,9871,626,85,82,3,99.64554719
66d082600d494feb6e9e0b521bba47e2d7c77961,11,219,100,119,0,0,0,6,105,545,2,4,2.215129239,2336,93,4,471,454,17,16964,16174,790,231,215,16,99.86784141
d1bc34f14fa07bb5b260ed5d90050870e1777f81,1,17,0,17,0,0,0,1,2,1,1,1,0,126,2,1,17,17,0,991,991,0,6,6,0,100
9984f3129834ed4daaca0274a96525bee5773440,4,116,7,109,2,0,2,1,48,26,4,4,1.445369533,744,3,0,167,162,5,5598,5099,499,86,83,3,99.78021978
8fed3689c7b6b6d94fd1b808dd018855f2b21f1f,3,9,8,1,0,0,0,9,68,128,1,2,1.289608558,1246,4,1,194,194,0,9872,9844,28,111,111,0,100
6bdfb587763d9e6faeeaf8918b8b6316c4cb7fe0,14,544,50,494,1,0,1,1,106,169,3,8,2.570869364,3689,94,2,756,702,54,28850,26273,2577,401,381,20,99.42579505
ea61c0d5d1a702d1fca6d642be2e2170735b9b85,0,0,0,0,0,0,0,0,0,0,0,0,0,0,95,3,0,0,0,0,0,0,0,0,0,100
66d79c3af427b4bae58802c9d6e5761fc0f6fea2,0,0,0,0,0,0,0,0,0,0,0,0,0,0,96,4,0,0,0,0,0,0,0,0,0,100
8620e09b952b88a68a6912d26e53aa308a3c3b8c,6,63,28,35,0,0,0,5,107,115,2,3,1.940317041,2655,97,5,541,537,4,19172,18909,263,224,223,1,100
4c7028a64e2e5253cf678d5cb02c9dca15adbfeb,9,199,90,109,0,0,0,1,49,255,4,4,2.293818817,1273,98,4,240,223,17,9761,8723,1038,150,141,9,99.82332155
64f822f2da52a804cd9b7fecef992aa1b3f626ee,9,90,199,109,0,0,0,2,50,0,4,4,2.293818817,1423,2,0,223,240,17,8723,9761,1038,141,150,9,99.82332155
b51ec8850b8d340602e0a7f11bc73d1be5eef110,0,0,0,0,0,0,0,0,0,0,0,0,0,0,99,5,0,0,0,0,0,0,0,0,0,100
9dcb75a94eacae49b4fed7f7105b97deee4aba51,8,183,4,179,0,0,0,1,39,302,2,3,2.786810122,2494,100,3,475,450,25,19160,18046,1114,235,219,16,100
d7111524924623650a01e6bd1011eea79058b9eb,6,70,15,55,1,0,1,1,108,134,3,3,2.005530023,1876,11,0,375,372,3,14301,14041,260,168,167,1,99.77836879
fe2b15d2f1eb5dfb6a957414e8dc42e863027266,1,4,1,3,0,0,0,3,5,41,1,1,0,104,5,0,14,14,0,726,717,9,4,4,0,100
1698e7345b3894f26d3758bffe496443006b356e,2,11,12,1,0,0,0,2,5,238,1,1,0.998635964,413,13,0,69,68,1,2946,2969,23,28,28,0,100
4a1697abe988e4a9d29e8f6c00c11f39e8a17e5e,2,2,2,0,0,0,0,2,3,225,1,2,1,149,14,1,17,17,0,1039,1031,8,6,6,0,100
cbdf7bda1ad749c846af8aba5afeac28efb96c65,1,99,48,51,0,0,0,2,4,0,1,1,0,126,15,2,26,17,9,1366,995,371,8,6,2,99.86743261
912365d94c212d5226390ed5a784ea4362646522,0,0,0,0,0,0,0,0,0,0,0,0,0,0,16,3,0,0,0,0,0,0,0,0,0,100
f76d77938cf5069e55e96a48d571de29fd5d2805,0,0,0,0,0,0,0,0,0,0,0,0,0,0,17,4,0,0,0,0,0,0,0,0,0,100
c01c5e9cce712fc5f6500bb5c27f80193eec7fbe,4,119,9,110,1,0,1,1,3,251,1,2,1.861990328,264,18,5,45,37,8,2326,1944,382,32,25,7,99.73486522
2e7211f5c0c97c90744689d9f64e5ea81cfcdd93,18,261,165,96,1,0,1,1,109,250,5,9,3.433289085,5414,12,1,1089,1077,12,39513,38901,612,546,539,7,99.69135802
e157ce542479011902410f6d76c71027123df5d3,9,199,90,109,0,0,0,2,52,44,4,4,2.293818817,1276,101,1,240,223,17,9770,8732,1038,150,141,9,99.73707274
c7b35c3f43fd52bf7669f19fc86c1b05b71bef0e,19,526,103,423,4,0,4,1,110,98,5,11,3.709376038,4861,13,1,953,906,47,37857,35546,2311,525,505,20,95.03642987
21d7526217795b6477e814365c216c9597c226ee,9,132,177,45,0,0,0,2,111,41,3,5,2.29229922,3554,14,2,680,689,9,24932,25097,165,322,324,2,100
34197939571287dd0b81896499b028b82a29b0fa,52,212,238,26,0,0,0,1,112,127,4,15,5.053550485,12209,102,1,2027,1977,50,91458,105062,13604,999,892,107,93.60465116
5f59dea55fd6e3e85085781eeae4f793332d80de,2,136,12,124,1,0,1,1,5,20,1,2,0.970154614,172,19,6,41,26,15,2056,1366,690,14,8,6,99.65551181
21c979895c8e9f12ba6b88717de5511e46eece2c,1,22,0,22,0,0,0,4,9,457,1,1,0,48,103,2,10,8,2,460,319,141,9,8,1,100
d5cd3f6c69082f42cb1a36d2c9a5a27f1d99a836,6,117,109,8,0,0,0,5,43,0,1,4,0.878193442,1210,104,3,237,233,4,8191,7905,286,136,136,0,100
de557a713d4834cc6343d474ac64e122d9c8267f,2,6,11,5,0,0,0,9,30,36,2,2,0.787126586,720,105,3,120,121,1,5161,5190,29,46,46,0,100
e493b60b795ce0ec41affbb5052d7c6a3255dfff,3,48,12,36,0,0,0,1,41,85,1,2,0.74758468,812,106,4,170,164,6,5423,5217,206,75,74,1,100
346c024d1ce91b5c3b154f3bed58d8d1bfac6c64,9,105,33,72,0,0,0,2,44,32,2,6,2.720726062,3141,28,0,598,586,12,22909,22356,553,335,330,5,100
4b613c1e2e91e91de7a84dc378a2e67da7fb092b,5,89,52,37,0,0,0,3,54,90,3,4,1.595660949,1263,15,0,272,265,7,8770,8481,289,151,146,5,97.82501236
ee1e3a5e06335721920743bd187c33628357a003,4,37,10,27,0,0,0,7,47,116,2,4,1.062795181,1108,29,1,214,209,5,7937,7700,237,131,130,1,99.18699187
231b35c23d44a0afb889f0c6bb5ba9194b3cf398,4,259,176,83,1,0,1,4,55,53,1,1,1.21301092,587,16,1,119,115,4,4652,4082,570,65,60,5,99.84439834
b98fac8804193408b316f8af5983feb557da0cba,25,1251,108,1143,11,0,11,2,13,126,5,16,4.281386332,2120,0,0,419,317,102,20313,15388,4925,243,163,80,96.85230024
ad6949f0e50ab00dcf8fbcc3e11331a114bc6826,10,268,60,208,0,0,0,2,8,327,2,6,2.104086096,1621,4,0,380,342,38,12363,11274,1089,178,166,12,96.28857381
c31cf5c49292be9665c4959cf5db14b068521e02,4,35,2,33,0,0,0,11,113,75,2,3,1.93051489,1707,107,2,340,334,6,12696,12514,182,179,175,4,100
4ee34383eb81f565b6cf06072170f2c130c51e8e,5,307,83,224,3,0,3,1,3,101,4,4,1.820551891,323,108,3,70,40,30,3720,2760,960,37,20,17,93.74257426
be131d6b5a24bc87a709f4f93692d965a549c5cf,0,0,0,0,0,0,0,0,0,0,0,0,0,0,20,0,0,0,0,0,0,0,0,0,0,100
8a7fac921405baf3bfff0fc4fe41aadec2c5abeb,7,79,41,38,0,0,0,2,56,141,4,5,2.52481583,1470,17,2,264,256,8,10879,10702,177,142,137,5,100
971c970a036993f0dedc6721cf52b5f0ca4531e7,4,62,11,51,0,0,0,9,31,36,3,3,1.43730869,796,109,4,120,114,6,6280,5896,384,67,65,2,96.68049793
300d9c53c4b77e16ddd5d68dcf6c792d52a94a02,5,21,14,7,0,0,0,3,114,69,2,4,2.084052365,2112,30,2,391,391,0,15498,15487,11,164,164,0,100
008c0093fed0cfd7e53b7d455621e1ec794d6f38,1,5,2,3,0,0,0,2,3,48,1,1,0,336,110,3,63,62,1,2302,2283,19,29,29,0,100
3c41936730062e27cbe5097f90b38a7ed01efad3,6,43,26,17,0,0,0,2,115,119,3,4,1.818260196,2702,111,4,474,471,3,20062,19954,108,209,209,0,100
f7a394c9786e27b8aca9a9eedde967b8d4620643,2,20,67,47,0,0,0,1,2,98,1,1,0.479832024,258,112,3,31,36,5,1280,1512,232,17,20,3,100
be68f8490cc063827c9f1a55d16caf269a44bbbc,4,26,2,24,0,0,0,8,48,64,1,3,1.65539623,1190,113,3,202,198,4,8890,8796,94,122,118,4,100
6d7afecf4ec547815e283602f6ba2bac73b165cc,3,12,6,6,0,0,0,11,116,43,2,2,1.571541672,1633,114,4,322,320,2,12192,12163,29,141,141,0,99.83086681
9d7c7a38a97b4a93704259d4e837cf6fed74c856,4,60,6,54,0,0,0,2,25,20,2,3,1.674774276,1383,115,5,214,208,6,10547,10328,219,109,105,4,100
5dc6eeee0d4029facd5e7e09c2e51482fc4bfb46,2,10,26,16,0,0,0,12,58,2,1,1,0.943601631,564,116,6,111,113,2,3945,4050,105,59,61,2,100
e08f2d13e44befd136655f4936a01dca704dc3b1,3,6,12,6,0,0,0,11,117,2,2,2,1.571541672,1625,117,7,318,320,2,12058,12087,29,139,139,0,99.83086681
051fe4e657d542f88c0dabbbd5a90908295f8964,9,105,47,58,0,0,0,2,49,52,2,7,2.041103019,3026,118,8,502,490,12,22485,22125,360,258,252,6,98.24847251
937f68d5a2e6fd21ba344ebab9259b6ffe9a292c,5,16,8,8,0,0,0,11,118,29,3,4,2.18215013,1819,31,0,345,343,2,13400,13350,50,150,150,0,99.84270547
43ab53c3940b6ac745188f9c38d904635d37cb80,1,18,7,11,0,0,0,3,13,148,1,1,0,333,32,1,33,31,2,3032,2960,72,24,23,1,99.88193625
5f778e206fcb31aa292393519e51139e59240c68,9,46,18,28,0,0,0,9,119,231,4,5,2.947731628,2977,119,8,524,518,6,22739,22526,213,239,238,1,100
23373189a74d6fbe736490350dfc1cd489064b99,1,7,3,4,0,0,0,4,8,90,1,1,0,320,120,9,69,68,1,2157,2147,10,45,44,1,100
87557f7496581524dae43ea6c6a062d479b387c4,0,0,0,0,0,0,0,0,0,0,0,0,0,0,9,0,0,0,0,0,0,0,0,0,0,100
b5b0ff2d1eed13045c069239ceb5f676e21736e8,3,178,51,127,1,0,1,9,120,53,2,2,1.576706674,1419,121,8,297,272,25,11276,10685,591,133,120,13,99.92132179
eb3feb5af57a13173be58b9ba18c382ce4a5da5b,13,157,158,1,0,0,0,2,121,174,4,5,2.663591681,3936,122,8,716,712,4,29564,29504,60,374,371,3,99.44946913
0d11cd47e8b63108e2c3987c23407cd4d4e24da1,20,476,90,386,5,0,5,2,10,76,4,11,3.550383433,2055,1,0,330,300,30,16728,14928,1800,177,164,13,97.71801141
74da30734d08b49946e84779b7485427a33620d7,1,113,13,100,0,0,0,2,6,185,1,1,0,223,3,0,53,36,17,2411,1798,613,14,10,4,99.95773457
c2a6a24a9ff85cc24132f5d5db40391bd36fbe70,28,1639,106,1533,11,0,11,8,13,183,2,13,3.897912551,2398,2,1,515,331,184,26462,18334,8128,293,202,91,98.42753931
0ddf4ba5bf0ff8a0b0404e121f6fed6fe2dfc6ca,14,461,316,145,2,0,2,1,122,245,3,7,2.617692489,3664,123,1,680,677,3,27551,27953,402,317,312,5,99.05982906
2f126074ce79af1b584931a934c4b266057eacc6,1,2,1,1,0,0,0,1,2,191,1,1,0,314,124,2,70,70,0,2139,2135,4,38,38,0,100
d4f5c9ded9ea4dc1a8acbec9a5e24f5e2f3bc6b6,1,17,0,17,0,0,0,2,2,5,1,1,0,136,125,2,16,16,0,1198,1198,0,8,8,0,100
7c7cd28879291a53da955c2827bda5b0f93bb46f,4,35,31,4,0,0,0,1,123,53,2,3,1.680509235,1826,126,3,360,360,0,13619,13556,63,195,195,0,99.82905983
d0edef3b9eeed61ab8f1aea8ceb0aa01e258179a,0,0,0,0,0,0,0,0,0,0,0,0,0,0,0,0,0,0,0,0,0,0,0,0,0,100
96351eb9e32bb5bb25dac0446854e5f45a308f15,4,51,117,66,0,0,0,2,7,133,2,2,1.348897588,1226,18,0,192,201,9,8840,9281,441,92,97,5,100
08aa862d00ad5dd9ecc5a39ee4899358b6f12a55,1,2,0,2,0,0,0,4,7,174,1,1,0,168,33,0,23,23,0,1212,1186,26,16,16,0,100
5dc4e717c8540b275cc2af33ab100c2a6ec21fc2,0,0,0,0,0,0,0,0,0,0,0,0,0,0,10,0,0,0,0,0,0,0,0,0,0,100
81644ccf3b29524a6139d47a6f0ae035c15efd9f,7,185,1,184,1,0,1,2,31,579,2,5,2.136803725,986,6,0,185,169,16,8292,7238,1054,131,125,6,99.8292787
499f1d83707a88482c9e1341dd841200cc7e7d88,2,27,36,9,0,0,0,1,17,173,1,2,0.631263018,413,127,1,57,55,2,2978,3033,55,24,21,3,100
7ef5115318ba05a5263377a19edfd11c43f34316,0,0,0,0,0,0,0,0,0,0,0,0,0,0,34,1,0,0,0,0,0,0,0,0,0,100
4c11031456493bcc544a8157c7dc2616941245db,11,149,112,37,0,0,0,2,124,121,3,7,2.612419587,4283,128,1,766,762,4,32320,32233,87,370,366,4,98.13387424
2739b4e42399b6a47f79c7b4bc7b23ca77702896,0,0,0,0,0,0,0,0,0,0,0,0,0,0,129,2,0,0,0,0,0,0,0,0,0,100
f401c7a3d21ba2ce6fc735891ae9e22ea5628c8d,0,0,0,0,0,0,0,0,0,0,0,0,0,0,3,0,0,0,0,0,0,0,0,0,0,100
021165f2142bc1d1a0351b3cddf724272541d720,0,0,0,0,0,0,0,0,0,0,0,0,0,0,1,0,0,0,0,0,0,0,0,0,0,100
30bafb7a7fc91febfc3bf5b08a97f06d7f4ef810,14,393,4,389,4,0,4,2,125,160,2,5,3.164865594,3209,7,0,637,613,24,25383,23249,2134,291,271,20,99.65291169
2386b1abb7eaff0b8ac081e0ac70480d4e9d15bc,4,71,23,48,0,0,0,5,12,455,1,3,1.696777171,561,2,0,92,84,8,4388,4180,208,58,54,4,100
0793e9b513ff7393c197b1c13e15d22205495edd,2,9,0,9,0,0,0,7,34,344,1,2,0.503258335,457,231,0,83,82,1,3526,3509,17,59,58,1,100
48239a7a2df06af3c3b4fb61932b83a8c205d7fd,1,16,10,6,0,0,0,9,29,91,1,1,0,223,232,1,42,41,1,1583,1532,51,16,15,1,100
78e95b9b079e84908ca3f5506d71b2aefa227990,10,104,47,57,0,0,0,2,62,480,6,8,2.156201409,1674,233,2,252,246,6,12887,12629,258,145,143,2,100
741d8bd4fbb1c9642dd054e72cae0c7afb180170,8,235,33,202,0,0,0,5,10,162,1,4,2.159782897,1889,4,0,311,281,30,16169,14868,1301,145,138,7,100
0f25304fee7aed4d2841dff344bf8d3f5d5da48c,0,0,0,0,0,0,0,0,0,0,0,0,0,0,21,0,0,0,0,0,0,0,0,0,0,100
73f906ce93ed7e8e0ff4572ddd31abcaf35b3832,0,0,0,0,0,0,0,0,0,0,0,0,0,0,0,0,0,0,0,0,0,0,0,0,0,100
1ceeb2990a782c65bc920abe700740a7c95626f7,1,1,1,0,0,0,0,5,14,31,1,1,0,301,19,0,47,47,0,2318,2318,0,27,27,0,100
67ba9cd875f72705d4177e72db7bc8df5539a91c,0,0,0,0,0,0,0,0,0,0,0,0,0,0,35,0,0,0,0,0,0,0,0,0,0,100
be9a98457c07bd729e5598aa61632f24a7372c54,2,17,2,15,0,0,0,5,15,29,1,2,0.981940787,374,36,1,59,57,2,2997,2890,107,32,32,0,100
c8f2c7a2f1c9de71b38d837d5b010793c53ce51b,8,155,0,155,1,0,1,2,42,135,2,5,2.271584906,1269,8,0,177,165,12,10430,9665,765,89,80,9,99.88479263
c9308f64d14c49d4edd9eb116853de7c46794ed9,6,68,53,15,0,0,0,8,126,167,1,2,2.010097343,2617,130,0,510,507,3,19326,19264,62,235,233,2,100
0b70002bddae994f63f8d2a068b86474c361619e,0,0,0,0,0,0,0,0,0,0,0,0,0,0,20,1,0,0,0,0,0,0,0,0,0,100
126db115902a1b4aeb7921ff1002045eedc7c4b7,16,55,240,185,0,0,0,1,125,200,3,7,3.351289641,4410,36,1,729,746,17,31819,32753,934,345,356,11,99.88479263
950962dc917f5d7ba00ed0f5b73c86c566bf6972,0,0,0,0,0,0,0,0,0,0,0,0,0,0,37,2,0,0,0,0,0,0,0,0,0,100
ac158584b7c094254d3276b0e130e7cb39a251b1,16,240,55,185,1,0,1,2,126,128,3,7,3.351289641,4260,39,4,746,729,17,32753,31819,934,356,345,11,99.88479263
1b2fcd9ce2447cffbe657ddf444dd943f9a085b8,5,112,38,74,1,0,1,1,32,305,4,5,1.95752103,1031,131,1,202,190,12,7765,7454,311,150,144,6,99.77002683
c564743fff6271b6d3a827997b72f3bb5be64b04,8,149,21,128,0,0,0,2,49,166,2,7,2.325296169,2291,132,2,377,361,16,18498,17685,813,236,225,11,99.57918898
af8a5bcd3c58b3a263ec6cf836633f839905aa6d,4,11,3,8,0,0,0,8,53,102,1,3,1.483831707,1391,21,1,268,267,1,10093,10033,60,163,162,1,100
cff085c4ff7ad49dd65f8e77549494584b3ebc51,17,402,74,328,1,0,1,2,11,117,2,6,3.417745897,3858,22,2,646,618,28,30421,28515,1906,324,300,24,99.92360581
201fc850274896588e8da14fe0f939263bc80495,1,1,3,2,0,0,0,12,63,90,1,1,0,324,40,3,70,72,2,2243,2254,11,38,38,0,99.73272241
fb56bcbe7e058619458ad8bc7fc5cde3f3b8ffec,4,32,26,6,0,0,0,3,10,8,2,3,1.551768794,821,23,3,132,130,2,5320,5426,106,73,71,2,100
bd5277ece3bc5c71ad055080adf01310ddda4c5e,0,0,0,0,0,0,0,0,0,0,0,0,0,0,11,0,0,0,0,0,0,0,0,0,0,100
5dd466a04595a7b8223a2c97f52193cec9c1b538,0,0,0,0,0,0,0,0,0,0,0,0,0,0,2,0,0,0,0,0,0,0,0,0,0,100
ecef287d0e23650e91a024f777d253653c2ba630,0,0,0,0,0,0,0,0,0,0,0,0,0,0,22,0,0,0,0,0,0,0,0,0,0,100
5b6edb9adbdd2c62dad3a9992a5ac96dfe110d68,4,11,13,2,0,0,0,8,54,16,1,3,1.531919636,1395,133,2,267,268,1,10079,10093,14,162,163,1,100
2d487ae51552ac7417c59882c9ed4011db03249a,0,0,0,0,0,0,0,0,0,0,0,0,0,0,3,1,0,0,0,0,0,0,0,0,0,100
63cd2fb981933aba137ba39bfc07e389166f5863,10,197,91,106,1,0,1,3,127,39,2,3,2.454000149,2995,9,0,539,532,7,22628,22238,390,234,229,5,97.17806041
89abd1399a3413555f85cdda541587f824ac0200,0,0,0,0,0,0,0,0,0,0,0,0,0,0,23,1,0,0,0,0,0,0,0,0,0,100
004ac670fea8cc6798b8c7d7631050382f8d0d76,3,13,4,9,0,0,0,8,128,16,1,2,1.16608706,1790,134,1,350,347,3,13270,13210,60,163,162,1,100
699792d56ca3828351b9e72cf983562eb8c11b21,7,269,20,249,2,0,2,1,129,57,2,6,1.909520394,1677,10,1,339,320,19,13497,11931,1566,146,127,19,99.21907111
42a09d17c04321277d805e9a4eacc383ec691578,17,127,489,362,1,0,1,3,126,73,3,9,3.331624961,4515,12,1,770,798,28,30819,32821,2002,356,380,24,97.5147929
3f446aaf27704b0bf929bd39887637a6a71b4418,20,536,130,406,3,0,3,3,129,70,4,11,3.534454126,4768,135,2,878,846,32,36772,34497,2275,428,402,26,97.47534517
b49974df21a089dfd7b97db826fee409d384fcf3,2,1,10,9,0,0,0,10,130,16,1,1,0.439496987,1434,136,3,288,290,2,10723,10775,52,124,125,1,100
1053da1013638cee8b44d9ac6b0570c49cac50e7,10,28,40,12,0,0,0,1,50,308,3,6,2.688414858,2279,137,4,285,289,4,18120,18217,97,144,144,0,100
5bb587b2193848c45049bd6f7e836b699f42f81c,1,2,1,1,0,0,0,4,9,332,1,1,0,323,138,4,70,69,1,2174,2157,17,45,45,0,100
b9314825150cce323b092e31c90620dc757111e3,16,116,274,158,0,0,0,3,16,307,6,10,3.274724818,1015,139,5,140,155,15,6637,7440,803,109,112,3,99.51120163
9cbf1efaf0c58c4702caa724f2e602839386c607,23,172,138,34,0,0,0,6,11,337,1,9,3.234944824,3276,140,6,495,485,10,23974,23939,35,247,237,10,99.63280294
d11320db65ce26b40994959c8a72c8f69556ad81,3,126,17,109,1,0,1,1,15,207,2,3,1.349941801,276,24,0,49,40,9,2196,1699,497,31,24,7,98.39440099
f36acabc58d6ed0146a9998150b5d7a038bdda7d,1,9,2,7,0,0,0,2,3,3,1,1,0,84,11,2,8,7,1,576,543,33,6,6,0,100
ef12b1f2125bae534e07899395c8f14e94a648b5,8,37,43,6,0,0,0,3,56,34,2,3,2.594394685,1608,12,3,238,239,1,11849,11806,43,125,126,1,99.83429992
ced7dbfea404523ebc6b415d2e42979c2ac6b351,9,174,62,112,0,0,0,3,131,110,3,4,2.226282507,2478,13,4,466,451,15,18801,17836,965,242,234,8,97.06362153
99c33e0b1eabd15f44e08f5e1f42597f3ef4328c,7,37,22,15,0,0,0,3,11,222,5,6,2.708457079,821,141,7,93,93,0,7002,6858,144,50,50,0,99.79911611
510206dc54d334e5adf26c350a2dde27cbcda020,16,16,21,5,0,0,0,4,12,543,1,7,3.867521353,1442,0,0,186,186,0,9910,9962,52,85,85,0,97.01834862
c76ab77da3c501cf51dd0c21d9b66ca484556ab4,6,63,53,10,0,0,0,3,64,78,5,6,1.124783598,1584,25,1,279,279,0,11172,11100,72,145,141,4,100
55cbfbbca68aca531bc261786a34499fce4de700,1,31,18,13,0,0,0,4,9,351,1,1,0,224,14,4,40,39,1,1787,1666,121,20,20,0,100
9c1638dbe6ef31246d780331b0cc8d27a8dc0c60,9,67,23,44,0,0,0,10,65,77,4,6,2.627679726,1923,26,2,300,294,6,14558,14217,341,162,157,5,100
ad6d7c3ea63e6b728ae5121582d02e2709311e91,2,61,38,23,0,0,0,4,18,6,1,2,0.561028486,743,15,4,146,142,4,5166,5092,74,66,63,3,100
2fd6c04dd12f4da9b23f4e4c5c0dd24134b42c17,5,28,6,22,0,0,0,5,26,210,2,3,1.87180358,876,142,7,168,165,3,5909,5721,188,98,96,2,100
debf50acc42d0d39b8d5e3396ec7eba2ebabf963,4,8,8,0,0,0,0,2,3,305,1,2,1.905639062,222,143,8,49,49,0,1569,1566,3,36,36,0,100
d6d58d0f52b66c10c364ff1115fe252bd36acf62,5,42,10,32,0,0,0,7,36,146,1,4,2.107314466,1742,144,9,327,321,6,12025,11859,166,179,174,5,100
bc85807da993745d86d17ea463c6dce8fdb2e1e5,4,133,8,125,1,0,1,1,11,352,2,3,1.214651873,444,145,10,80,71,9,4015,3163,852,48,42,6,99.9272198
3eba6c2ebc524a4bec05b5836ea49d8aa31a8e7c,0,0,0,0,0,0,0,0,0,0,0,0,0,0,4,0,0,0,0,0,0,0,0,0,0,100
fe030bd3e97ef98c1b034d01a0c875065b073169,8,240,28,212,1,0,1,1,132,239,3,5,2.112174385,2481,146,10,504,470,34,19425,18154,1271,290,265,25,99.67485549
368849c0e420db5684618385b14f5932892de40e,0,0,0,0,0,0,0,0,0,0,0,0,0,0,147,10,0,0,0,0,0,0,0,0,0,100
f80757d3df3ce15022118095cd5f623b1c89d559,3,21,26,5,0,0,0,9,133,12,2,2,1.196526694,1941,148,10,389,391,2,13948,13956,8,165,167,2,100
bb569c2397dac094a28c9f729c235c6334ec0ce9,35,127,112,15,1,0,1,3,46,366,5,11,4.805825246,5604,149,11,551,551,0,45751,45816,65,291,291,0,97.17425432
343405df39fb0664be189e0691c19b5f4af67750,0,0,0,0,0,0,0,0,0,0,0,0,0,0,0,0,0,0,0,0,0,0,0,0,0,100
577dc9e57fa8da32af778c0c6dbc43c9be758543,0,0,0,0,0,0,0,0,0,0,0,0,0,0,234,0,0,0,0,0,0,0,0,0,0,100
4b8b03793aad36a45d6439ca5c6f22c81ee3b756,0,0,0,0,0,0,0,0,0,0,0,0,0,0,0,0,0,0,0,0,0,0,0,0,0,100
f40dad9b1504bff82a9f3559bb0f0ddf7205d6f0,5,20,14,6,0,0,0,8,54,69,1,4,1.89427387,1541,27,1,262,260,2,11205,11175,30,139,137,2,100
3f85a2abc3493b1f70e0841f8152001875b1f96a,6,152,4,148,2,0,2,1,59,75,1,3,1.687376088,843,28,2,162,155,7,6836,5866,970,106,99,7,98.76084263
e2cbcc1b5538f50a2ec80facefe08f307fd05683,12,326,171,155,3,0,3,3,66,171,4,7,3.197722252,1842,29,3,287,281,6,14386,13807,579,168,162,6,96.37161085
005aa6ab0f7a9051bb4c4a47660bca29ec70aa20,0,0,0,0,0,0,0,0,0,0,0,0,0,0,150,8,0,0,0,0,0,0,0,0,0,100
073137602c68559fc6395629c10298f5d055f068,2,6,9,3,0,0,0,2,14,48,1,1,0.721928095,238,151,5,38,38,0,1526,1547,21,22,22,0,100
2a247b154a3ab2976beb0c8b58dc8b957742d70f,0,0,0,0,0,0,0,0,0,0,0,0,0,0,41,0,0,0,0,0,0,0,0,0,0,100
a2ce5211003069548de749e5296210d2ccea2bf5,0,0,0,0,0,0,0,0,0,0,0,0,0,0,4,0,0,0,0,0,0,0,0,0,0,100
0ea2d2e6bf93a33027e20ef280a77e87dddb351e,1,2,0,2,0,0,0,1,5,1151,1,1,0,86,152,4,5,5,0,643,617,26,3,3,0,100
adaf422abfa1340ca24a0bec53a2de87778ff9d5,1,1,0,1,0,0,0,5,6,50,1,1,0,52,153,3,5,5,0,264,262,2,5,5,0,100
45e279f438e81d6dbc92b55f8505b251cf7f52b4,13,118,22,96,0,0,0,3,46,157,3,9,3.200910435,2933,30,3,479,471,8,21341,20653,688,231,223,8,99.55770004
5b4a6c4d58877d5eb5b1189f2c484622da9e0b38,0,0,0,0,0,0,0,0,0,0,0,0,0,0,235,0,0,0,0,0,0,0,0,0,0,100
86afb3afbe10918505dc0e8c9f3d2ec0443ed9a1,0,0,0,0,0,0,0,0,0,0,0,0,0,0,236,1,0,0,0,0,0,0,0,0,0,100
216806550f761b639abbb7f5ebe1988ce804a0f6,1,4,6,2,0,0,0,2,8,77,1,1,0,336,154,4,62,63,1,2296,2304,8,37,37,0,100
ee332dc37b941b634766fd7d4fb16a763965d498,4,38,27,11,0,0,0,11,134,510,3,3,1.238215833,1827,155,5,360,363,3,13184,13083,101,142,142,0,100
a421d1481170f41ddaf5bdd3b43ec545648ec868,1,6,4,2,0,0,0,2,9,0,1,1,0,334,156,6,63,62,1,2304,2296,8,37,37,0,100
425ed52f99efb976efd919aa72e9b171cab3869a,1,4,6,2,0,0,0,2,10,0,1,1,0,336,157,7,62,63,1,2296,2304,8,37,37,0,100
c532f814bf5865621a180365e7e73a911b3fd609,22,147,229,82,0,0,0,2,27,1675,1,5,2.449667038,2479,158,8,544,570,26,16763,17094,331,257,265,8,100
ce699ba3f36b034ff283a21de2645f98bb92a876,6,449,17,432,2,0,2,2,13,27,2,4,2.075823302,493,31,1,128,60,68,6151,3634,2517,70,38,32,99.31726908
c0721c1fe6ba1dc19e8d8bb8bb3c13382c945704,2,79,4,75,0,0,0,4,20,130,1,2,0.987292732,401,159,8,68,58,10,3521,3005,516,28,22,6,99.79943843
260dbaad18267be3c5b32d297af1ccdb63dfd693,20,103,89,14,0,0,0,2,18,1287,1,6,3.860077534,1439,160,8,212,210,2,11068,11126,58,142,138,4,100
47f2aeafd9672f2d1b43bc868daecd3eee07c1ab,8,54,57,3,0,0,0,5,21,868,1,3,2.177305881,1946,161,9,452,453,1,13504,13506,2,217,218,1,100
3d26ae9ee6b02e2b3a64f1cff0b4b97763362919,3,10,1,9,0,0,0,1,18,64,1,3,1.435371391,576,16,0,110,109,1,3974,3901,73,53,52,1,100
22ceab231cc6af7059e921bec2ff1570c1743ac2,1,13,0,13,0,0,0,9,39,440,1,1,0,382,162,8,63,61,2,3126,3022,104,28,28,0,100
3f7d416c9d0c6018c0329a3cf2b576d1f6673e83,0,0,0,0,0,0,0,0,0,0,0,0,0,0,163,4,0,0,0,0,0,0,0,0,0,100
1402eb81dbd3f5ab388d9b9bab63c235a0ee190d,1,2,2,0,0,0,0,4,13,108,1,1,0,120,164,5,20,19,1,758,745,13,8,8,0,100
79d6004dc19cdfff141751e373169f2af315265f,1,37,2,35,0,0,0,9,40,20,1,1,0,394,165,6,69,63,6,3413,3126,287,29,28,1,99.08403027
284db7f50f59bbbac11c11f6f2ed847fedb59472,7,40,25,15,0,0,0,3,48,292,2,3,2.264439076,2219,42,0,302,300,2,16824,16685,139,160,158,2,100
64c53ee376d03449ca020a90bb16b19c8b9fb15e,2,35,6,29,0,0,0,2,7,454,2,2,0.534943699,354,32,0,87,82,5,2539,2351,188,45,43,2,100
d8976d79eaa2e522fc8fd6531deff7d4ac635c53,0,0,0,0,0,0,0,0,0,0,0,0,0,0,43,1,0,0,0,0,0,0,0,0,0,100
2a548e97b367a63c48c85a961bbc91e91b8c1344,2,19,8,11,0,0,0,7,30,99,1,2,0.999010271,645,44,2,118,118,0,4340,4340,0,61,61,0,100
1c07496263bf342067bbcce36db879f1c70e803e,2,24,1,23,0,0,0,3,35,239,1,2,0.634309555,582,45,3,95,92,3,5006,4815,191,57,56,1,100
0268f4c87a932b42a561afbfec306f53d7c72e90,1,4,1,3,0,0,0,4,15,5,1,1,0,569,33,1,106,106,0,3784,3759,25,49,49,0,100
66774b5e4a4f655bd81a55686db9578fe60773a2,3,80,2,78,0,0,0,2,135,529,3,3,0.86405108,1454,34,0,300,291,9,11200,10636,564,131,129,2,98.92430279
92dac6e764266e1fe741d021619bf7ea7f88846a,3,77,4,73,0,0,0,2,51,226,3,3,1.527906707,578,35,1,120,110,10,4697,4158,539,62,59,3,100
fd7091c7bdf40bf9a06f61cfd6bd7eac43332223,2,4,3,1,0,0,0,6,136,480,1,1,0.985228136,1285,17,0,269,268,1,9517,9520,3,110,110,0,100
99540743ed60b7f15e7df0ceb937b9fca7fd66be,7,222,37,185,0,0,0,2,137,421,3,4,2.375805333,2774,36,2,575,543,32,20494,19376,1118,241,223,18,99.95987159
e51d531081c60a755bfaadaa2ada6f77b24bfaf8,3,105,7,98,0,0,0,4,19,258,3,3,1.09844899,720,18,1,100,89,11,6417,5747,670,65,59,6,99.12315664
90cd4747d3dddcdb3ca0878f997c056414784c7c,1,7,1,6,0,0,0,4,11,271,1,1,0,408,19,2,74,74,0,2707,2682,25,39,39,0,100
f0151b857a51532b28e4480b7a1971c5fde6c01b,1,3,3,0,0,0,0,3,4,309,1,1,0,64,46,0,10,10,0,421,420,1,9,9,0,100
1ccfa669a6a7acf4aa1f02e1a9edd143f164ec2d,3,37,0,37,0,0,0,1,20,141,1,3,1.08132478,614,20,2,125,122,3,4483,4194,289,63,60,3,100
38d55c471d4cb6118a98943d6b8d8abd34a67a0a,26,258,301,43,0,0,0,4,138,215,2,11,3.835874551,6133,21,3,928,931,3,46674,46481,193,448,450,2,99.13249211
5e858b53fe5cd31c18c195fb92e7318e6f2d8318,9,329,29,300,4,0,4,1,39,66,2,5,2.575198812,1943,37,0,398,376,22,14352,13021,1331,211,195,16,97.00574241
d783bc43eb74f31cecc4dda171fbbf876230306e,5,384,0,384,2,0,2,1,10,137,3,3,1.644697495,196,38,1,51,16,35,3017,1044,1973,29,12,17,99.78586724
d29857353a1bd57f9131d76afb23d92fab4ced68,0,0,0,0,0,0,0,0,0,0,0,0,0,0,3,0,0,0,0,0,0,0,0,0,0,100
b5528afc1fc5f3238b61e3dbc247b91cad0f7865,5,132,15,117,0,0,0,3,28,95,3,4,2.030456833,729,22,4,107,98,9,6261,5455,806,73,67,6,100
2218f276adf11c0f8f04b2085e72f1c11a4ee56d,4,68,4,64,0,0,0,3,139,104,2,3,1.416545639,1913,23,3,378,370,8,14772,14303,469,173,169,4,100
c7db0a278a6006136f5bcd54e6e8cd5e595ca456,0,0,0,0,0,0,0,0,0,0,0,0,0,0,4,1,0,0,0,0,0,0,0,0,0,100
de0ac3334f5a84f685db93c23ad078befb64da56,15,532,16,516,7,0,7,1,140,153,4,9,3.324742012,3172,166,0,681,621,60,25811,23277,2534,339,300,39,98.9001692
46f255cbf81fda3d4556c8fe1086f91e05d6aa3f,1,4,4,0,0,0,0,2,8,22,1,1,0,307,167,1,72,72,0,2148,2146,2,36,36,0,100
3ba7e315eda4c173e99b07285d7e2d368c999a6a,0,0,0,0,0,0,0,0,0,0,0,0,0,0,5,1,0,0,0,0,0,0,0,0,0,100
80804b297acfe3285e6697c4bbd518d3c563b1e4,0,0,0,0,0,0,0,0,0,0,0,0,0,0,6,2,0,0,0,0,0,0,0,0,0,100
9144be8e9e1ef298f5e4badd1c6f4dbf17dc7e29,6,75,38,37,0,0,0,3,141,75,2,5,1.93229115,2117,39,0,404,396,8,15893,15617,276,175,174,1,100
3c23c33007301fcab724fcac1dc67f4452c6dd99,0,0,0,0,0,0,0,0,0,0,0,0,0,0,7,2,0,0,0,0,0,0,0,0,0,100
339625cfb6f92e5ae3ade6ea9c6e502ba62d4206,0,0,0,0,0,0,0,0,0,0,0,0,0,0,0,0,0,0,0,0,0,0,0,0,0,100
068f20c5118526290e4ecbcdb2551b92564d5696,1,1,1,0,0,0,0,6,9,396,1,1,0,150,47,0,26,26,0,936,936,0,21,21,0,100
a320ae0c27bab8bb4fe4099f3196214e5b8de8f5,5,102,173,71,0,0,0,4,17,309,2,2,1.847654328,998,40,1,178,181,3,6163,6211,48,81,84,3,95.66691786
2e2bfb47b596f954eab7346686d9f8aa709f068f,2,196,9,187,1,0,1,1,5,2,2,2,0.445362238,93,41,2,35,16,19,1320,492,828,27,8,19,99.93155373
701aab7640883012a26de90e1801d8ee48c2761b,6,113,6,107,0,0,0,2,17,180,3,6,2.02999091,576,24,0,96,85,11,4603,3814,789,65,57,8,92.75037369
7c01837f7226f06a334a6066a55c3b136b174319,22,117,70,47,0,0,0,4,73,377,7,14,3.385292475,5431,42,3,840,828,12,43628,43299,329,526,520,6,100
636239f9c546782683bdb77f26c275f45a39af27,1,7,2,5,0,0,0,6,7,540,1,1,0,82,0,0,11,11,0,670,640,30,5,5,0,99.23817161
7c5b30d825e598ceaa4bd309c4d66d4ba40bf83e,2,10,10,0,0,0,0,1,1,0,1,2,0.970950594,99,8,0,8,10,2,648,940,292,7,8,1,99.37670432
4834e459f78746a52e88740dedd31933ad146312,1,50,50,0,0,0,0,8,24,1490,1,1,0,265,43,0,29,29,0,1864,1879,15,17,17,0,100
cfd7c06079a7e14ae0684f8a0482bd74b9b3fb47,6,17,9,8,0,0,0,6,29,659,1,2,2.516943567,1263,5,0,221,221,0,8688,8684,4,107,107,0,100
0756da1a3e7c9a334f1e4c2f302e288712d0e186,4,40,43,3,0,0,0,7,20,1943,1,4,1.127931666,708,44,1,99,98,1,4837,4797,40,64,63,1,100
cf8c27e0504800973c6def20da7a9f717ee51879,1,1,1,0,0,0,0,8,21,29,1,1,0,319,25,0,49,49,0,2433,2433,0,27,27,0,100
1eb0ece983104afd9375a9d9a24ff3474df485d2,4,140,8,132,1,0,1,1,142,142,1,2,0.919440692,1474,26,1,309,302,7,11755,10826,929,137,130,7,99.14263445
0ee5be166ca4de3a2635b975b85909021de7c2b7,1,5,1,4,0,0,0,10,37,104,1,1,0,393,48,0,74,73,1,3058,3030,28,48,48,0,100
2c8d5501f606a913a83a3ecbdd4c0498a2432c1c,0,0,0,0,0,0,0,0,0,0,0,0,0,0,0,0,0,0,0,0,0,0,0,0,0,100
a1785b7d8b90c420e82fa7db21195c1bed051a6f,3,53,14,39,0,0,0,7,13,539,1,2,0.756519032,1340,24,0,208,201,7,10546,10305,241,73,72,1,100
9752b5a77f9c203e5b7fd9c5b18243d7bb2db662,1,2,1,1,0,0,0,13,68,205,1,1,0,340,0,0,74,73,1,2433,2416,17,41,41,0,100
a14a1d7215f9f4aecafcd8384824eec6dfcf7d51,10,153,40,113,0,0,0,1,74,290,4,6,2.63253937,1835,45,1,321,308,13,13778,13003,775,179,171,8,99.10436137
490b689369a8a570512097d798d38a97fcc3d7b1,0,0,0,0,0,0,0,0,0,0,0,0,0,0,27,2,0,0,0,0,0,0,0,0,0,100
c2e855db82b3027241d387b404bd56b51279cfbf,1,2,1,1,0,0,0,3,10,18,1,1,0,165,46,1,25,25,0,1218,1209,9,18,18,0,100
417d0aa959be32bd2ba687ed901855a129ea4d82,247,2312,6708,4396,6,1,7,0,126,116,11,69,6.96012315,35685,0,0,5162,5619,457,230813,256683,25870,2815,3118,303,87.18244804
4ffe135e3b71dbfe0dd030a9b87288e9ad6c43ea,246,6531,2289,4242,30,0,30,1,142,471,11,68,6.961396362,31910,2,1,5613,5183,430,256515,231989,24526,3122,2830,292,87.05564142
dfed6644e17b9189bd6adb574ff9761d7b9541b5,0,0,0,0,0,0,0,0,0,0,0,0,0,0,3,2,0,0,0,0,0,0,0,0,0,100
5ca1cdb675f47d9d0d343910aa7a01ab656e0bb6,0,0,0,0,0,0,0,0,0,0,0,0,0,0,4,3,0,0,0,0,0,0,0,0,0,100
1bcaa40e6658a4b4ca979e203f14a4319d34de75,0,0,0,0,0,0,0,0,0,0,0,0,0,0,5,4,0,0,0,0,0,0,0,0,0,100
363e8053ca983142e9c83c50864fdf015b536b93,0,0,0,0,0,0,0,0,0,0,0,0,0,0,6,5,0,0,0,0,0,0,0,0,0,100
00b4ff06eea52aac8b59b4f16bca2383331a3a11,0,0,0,0,0,0,0,0,0,0,0,0,0,0,7,6,0,0,0,0,0,0,0,0,0,100
3e58a8dc247e7b3bdbc27f3c1b303fa9235668a5,0,0,0,0,0,0,0,0,0,0,0,0,0,0,8,7,0,0,0,0,0,0,0,0,0,100
64586b105ef6d116d775ea395d023056f152f3f4,14,220,63,157,0,0,0,1,74,282,5,9,3.09920664,3339,28,3,554,533,21,25547,24500,1047,271,261,10,99.06542056
7a31c5552de183a26b4711d75c8ef28f8e8d04e6,2,25,2,23,0,0,0,9,36,189,1,2,0.99107606,641,47,2,124,121,3,4612,4519,93,96,94,2,100
1e909dfcd493e32f3a5c47a5533f745715e5669a,1,2,13,11,0,0,0,4,16,3,1,1,0,250,48,3,38,41,3,1818,1913,95,21,21,0,100
7c5ce2a5a071f66d55b440372e92b11a1d9e5009,0,0,0,0,0,0,0,0,0,0,0,0,0,0,0,0,0,0,0,0,0,0,0,0,0,100
d9075bdcacd6970f2902f2bf187dce1a31fbccd4,0,0,0,0,0,0,0,0,0,0,0,0,0,0,9,8,0,0,0,0,0,0,0,0,0,100
76963af68b704d08136fb7275e8528b2549f7e03,0,0,0,0,0,0,0,0,0,0,0,0,0,0,10,9,0,0,0,0,0,0,0,0,0,100
894988d98864115932d71f32d8b76cdacf94f397,0,0,0,0,0,0,0,0,0,0,0,0,0,0,49,1,0,0,0,0,0,0,0,0,0,100
df24fb937ffcb6448f434b92c100d2ed479fea83,1,2,5,3,0,0,0,10,38,140,1,1,0,358,49,4,39,39,0,3013,3025,12,20,20,0,100
e9683cf43573d31c6ea768e0b750f5e455098ef6,1,10,0,10,0,0,0,9,25,77,1,1,0,257,0,0,30,29,1,1943,1864,79,17,17,0,100
a611ccf1b2ac29f3c6e732ab530e6e4f4f08c014,4,36,18,18,0,0,0,2,45,467,2,4,1.974937501,1163,1,1,111,111,0,9992,9893,99,50,50,0,100
d5a3e05937d6b05b82d023148102de3d7bc9898c,7,67,9,58,0,0,0,2,26,1361,3,6,2.109866626,745,50,5,92,85,7,5851,5415,436,50,45,5,98.90880748
c42b44cfe1577b97dcd490860780e81e19e48106,7,113,45,68,0,0,0,1,71,88,2,4,2.448242137,1219,51,6,198,186,12,9298,8784,514,102,97,5,98.12085483
44b6bd4376149a194bade2ddf30406f744cd48a4,2,20,3,17,0,0,0,10,143,185,1,2,0.987692509,1560,2,2,321,315,6,11979,11885,94,127,126,1,100
14927c7527afe13efb949065bbac0042ad82932f,35,293,200,93,0,0,0,1,144,486,5,13,4.547387609,10308,52,7,1942,1924,18,72863,72400,463,986,968,18,100
a252941431168b9d9986165faa9db6ca022a0567,1,1,1,0,0,0,0,8,23,0,1,1,0,280,3,3,50,50,0,2008,2008,0,19,19,0,100
07534d1d8f186dca62ef60112ee42909d9152feb,1,1,1,0,0,0,0,9,24,0,1,1,0,280,1,1,50,50,0,2008,2008,0,19,19,0,100
61447d17f1288b18b56b7c240adcf8732b995f65,1,1,1,0,0,0,0,9,25,0,1,1,0,280,29,3,50,50,0,2008,2008,0,19,19,0,100
cac3336a7718c630134e1ccc2d18b8e2837c0049,0,0,0,0,0,0,0,0,0,0,0,0,0,0,50,2,0,0,0,0,0,0,0,0,0,100
babc3d3ffae4f623b5a7b804b4b7c7ec29db3830,3,180,0,180,2,0,2,1,8,135,2,3,1.234497797,69,53,8,35,15,20,1162,394,768,23,9,14,97.94041927
2816ea6762be18da4b35ee3024338514a32ac413,3,50,23,27,0,0,0,4,145,85,2,2,0.932262946,1904,4,4,377,373,4,14530,14357,173,168,166,2,100
3b87d6978036bd285353f456a953a7a98ac2a00f,1,2,2,0,0,0,0,9,27,6,1,1,0,267,54,9,30,30,0,1949,1949,0,17,17,0,100
56e2073515804cc70f64b215f971d547070ed38f,5,17,12,5,0,0,0,3,10,802,4,5,1.771437029,644,0,0,123,122,1,4276,4253,23,69,68,1,100
92fabbccb98c5e33aa76031aeed214a3f55b0498,1,5,1,4,0,0,0,5,9,273,1,1,0,147,5,5,9,9,0,1328,1306,22,7,7,0,100
8cf9ff4d34391ef99ccf14210d95161d3cb35a8d,1,13,3,10,0,0,0,11,36,17,1,1,0,212,1,1,17,16,1,1813,1763,50,10,9,1,100
8eacbd45cc6d8b68f6f4ef63195cc0118c1878a6,1,2,1,1,0,0,0,4,11,9,1,1,0,307,6,6,72,72,0,2151,2147,4,36,36,0,100
7b9da6b93f01a93177d8f0dbc18326cc5420dddb,2,4,1,3,0,0,0,4,75,102,2,2,0.970950594,835,7,7,136,136,0,7026,6981,45,88,88,0,100
a6d917135f1cefea3ed993fa305741c65deb1408,0,0,0,0,0,0,0,0,0,0,0,0,0,0,2,2,0,0,0,0,0,0,0,0,0,100
35a242edbd7d075a8f0fb9092543511c203ae5e2,1,5,0,5,0,0,0,11,39,24,1,1,0,398,8,8,75,74,1,3086,3058,28,48,48,0,100
36b9af3a74828209eb3f4eb0b10aff9193228b8a,2,8,0,8,0,0,0,4,146,34,1,1,0.543564443,1320,9,9,263,261,2,10009,9961,48,107,106,1,100
07605f1eab5a8275610416486fc7e09a09e16a37,1,2,2,0,0,0,0,9,28,26,1,1,0,267,10,10,30,30,0,1963,1949,14,17,17,0,100
8263087b57518bc29a020b544ab805db90b49c08,1,11,7,4,0,0,0,5,17,318,1,1,0,408,11,11,42,41,1,3553,3524,29,28,28,0,100
a3a411ba15c7e3582bf8012e597b8f8d0521f82c,1,5,1,4,0,0,0,4,6,356,1,1,0,207,12,12,26,24,2,1356,1311,45,16,16,0,100
b228283b03cc890a1721524dfa42d2bdbca6de1a,5,55,13,42,0,0,0,5,147,182,2,3,1.900919967,2736,0,0,555,545,10,19350,19123,227,244,240,4,100
1720b1fde3ccaa149cfa98d142dd758e41f0b211,3,5,615,610,0,0,0,7,21,1215,1,3,0.13477652,641,51,1,24,91,67,1403,4464,3061,21,61,40,99.76589934
463b76314b9899acbd1918b51d59f1eea485776c,1,3,3,0,0,0,0,1,3,62,1,1,0,74,55,5,10,10,0,379,376,3,7,7,0,100
3596a589707fa8f7947af50ada582b12ec15b650,8,66,20,46,0,0,0,5,148,28,2,4,2.285120224,3915,1,1,770,762,8,28755,28530,225,363,360,3,100
0cb5c9a1b9a00c7fb14776b8e860607bc04d2138,4,57,18,39,0,0,0,2,9,1619,1,3,1.441022055,302,3,2,57,56,1,2710,2351,359,37,37,0,99.84387198
800f2f10f6ba007c8217ad75aaeedacaa18df306,5,509,0,509,5,0,5,1,1,0,1,4,2.126847424,0,0,0,27,0,27,2158,0,2158,14,0,14,99.49455677
b3cfec0e4b1870ca2fca117990426a9046721a3d,6,107,8,99,0,0,0,3,5,621,1,2,2.36562469,273,13,7,45,34,11,2290,1892,398,39,31,8,95.73999266
82f3fe42b0afcf7342f7800b0ec789515f0ba133,1,6,1,5,0,0,0,13,149,16,1,1,0,1159,14,7,238,237,1,8780,8764,16,89,88,1,100
60643005d0a6faaa25c1810fac9fcb68cda88c3b,1,19,7,12,0,0,0,13,150,0,1,1,0,1163,15,8,241,238,3,8869,8780,89,89,89,0,100
8fdf86f11838d7c0ab356f9388650b270b0bb291,1,7,1,6,0,0,0,5,12,61,1,1,0,308,2,1,72,72,0,2178,2151,27,36,36,0,96.84844193
7a67f135334d6174fa0f35c395ea544403959864,0,0,0,0,0,0,0,0,0,0,0,0,0,0,1,0,0,0,0,0,0,0,0,0,0,100
00f1747a1915f42fd256e9a5b7b8e0131cd06c2c,0,0,0,0,0,0,0,0,0,0,0,0,0,0,2,1,0,0,0,0,0,0,0,0,0,100
20bebaf596536d7f69c4dce964e01ecd25aae78c,1,2,15,13,0,0,0,7,20,632,1,1,0,167,16,3,13,15,2,1279,1322,43,12,13,1,100
31d8fda76ed534e8929483fae3a0e9cb5f0fa23d,1,0,1,1,0,0,0,6,13,14,1,1,0,312,3,2,72,72,0,2162,2178,16,36,36,0,96.84844193
a3215c0d563a787c119a6ba374578db09c2187dd,5,13,13,0,0,0,0,6,17,231,2,4,2.16197818,1185,17,4,145,145,0,9246,9258,12,81,81,0,100
10e4136837b19be75bfd593928bd9151dbdab3c0,3,30,22,8,0,0,0,1,5,60,2,2,0.911751759,382,56,0,46,46,0,2921,2809,112,26,26,0,99.8603352
b7e11bf39409dd469ad20a081d1c91c7cb4edfb4,1,1,1,0,0,0,0,4,5,948,1,1,0,109,18,4,21,21,0,697,697,0,6,6,0,100
20c86cd00b718a9bb4686bcff11bf44ee3e10112,20,145,116,29,2,0,2,5,65,175,5,13,3.170203623,4219,19,3,651,649,2,31700,31692,8,325,323,2,99.58144402
2cf546d063b6fc573b9e5b7dc99ba5a1387ab663,3,54,19,35,0,0,0,8,15,224,1,3,1.113988952,867,20,4,126,123,3,7172,7000,172,54,53,1,100
a2f3895396a81ee6e31d6fd1a8a6c8a7bf121dd6,0,0,0,0,0,0,0,0,0,0,0,0,0,0,1,0,0,0,0,0,0,0,0,0,0,100
f11d9342ceeba1c5afa64d3c97b522a1882031c0,4,36,12,24,0,0,0,5,20,324,1,1,1.814945589,1616,3,1,341,338,3,10916,10802,114,158,156,2,100
b3241eaa6a9768a9378041722b9f38b0392f1d64,3,16,6,10,0,0,0,4,52,55,3,3,1.288649765,1107,21,5,233,231,2,7406,7355,51,89,88,1,100
01c6b144d85341a18950215bd63b35e0c1991bba,0,0,0,0,0,0,0,0,0,0,0,0,0,0,4,3,0,0,0,0,0,0,0,0,0,100
6ab75ae9da4b380056279b02f208dc9b1329325b,5,31,0,31,0,0,0,4,66,43,2,3,2.035801333,1172,22,6,222,214,8,8747,8630,117,142,137,5,100
91aaf6e010cc29ea8b8b11954f839c8b9668452b,8,68,73,5,0,0,0,7,50,240,3,7,1.535223027,2468,237,0,376,373,3,18560,18484,76,217,215,2,100
374be2ae5f9a7ef4c9c6fc3ba4696264362bad56,5,56,11,45,0,0,0,7,67,34,2,5,2.270112275,1710,0,0,312,304,8,12476,12105,371,184,181,3,99.93045897
965bcec41ccc36056f029becb743d8f24b420d76,21,659,557,102,0,0,0,2,46,286,4,13,3.56687978,5107,23,5,647,628,19,41494,40955,539,288,286,2,99.86096628
9375d21daf6bb5e10199685257e1bb571ca32d4d,1,52,0,52,0,0,0,7,33,26,1,1,0,97,238,1,17,15,2,680,615,65,16,14,2,100
79bf2aa51c3f55ddafd4b32515c689dc57ac4142,1,2,4,2,0,0,0,7,14,3,1,1,0,160,24,5,10,10,0,1462,1498,36,8,8,0,100
201e1ef88fcd99bc6c449799ea8d1807df6265b4,3,11,4,7,0,0,0,4,6,1609,1,2,1.530124965,593,25,6,75,74,1,4352,4337,15,42,42,0,100
674189573ba9e5cd5106f5dea85d3f7a31660c0b,0,0,0,0,0,0,0,0,0,0,0,0,0,0,4,0,0,0,0,0,0,0,0,0,0,100
50490661d22bee2a360cac07fac198f5bd5c8ebd,8,52,35,17,0,0,0,3,151,253,3,5,2.683516584,2746,239,1,549,549,0,19998,19940,58,277,277,0,100
81b4b8007590f6bbf3d96b94aa0f5634c04c5652,1,8,7,1,0,0,0,2,11,21,1,1,0,151,26,3,12,13,1,1151,1156,5,8,8,0,99.82596589
32e3eed403937e21704bc2a80e2b56864a3f1b13,1,3,2,1,0,0,0,13,152,1,1,1,0,1175,27,4,241,241,0,8873,8869,4,89,89,0,100
4443f6dec20da8e45da8e8223ad1bb2452b541ff,1,3,0,3,0,0,0,9,26,164,1,1,0,280,28,5,51,50,1,2019,2008,11,19,19,0,100
117e502f37b7ec7f0d26a28bba469a2a6cd55bd4,1,1,1,0,0,0,0,4,7,134,1,1,0,211,29,6,26,26,0,1357,1356,1,16,16,0,100
1024b3382f7862d47527a85b77e4936249e4183c,1,1,3,2,0,0,0,7,27,57,1,1,0,503,30,7,111,112,1,3213,3220,7,47,47,0,100
32bc9e47db819e3c79a7bebfd2a96f2941bd794d,0,0,0,0,0,0,0,0,0,0,0,0,0,0,52,0,0,0,0,0,0,0,0,0,0,100
b2d367fa9a9313c7bae3ca5a02c652a8804b97e1,1,14,5,9,0,0,0,13,153,15,1,1,0,1176,31,8,240,241,1,8892,8873,19,89,89,0,100
72a510999f0a39533b81a44bd4065b03660efec5,1,5,1,4,0,0,0,11,38,65,1,1,0,218,32,9,17,17,0,1835,1811,24,10,10,0,100
6add5871b6de8064d5340a5b0fcdf5dac12a6dd4,1,22,17,5,0,0,0,13,154,0,1,1,0,1178,33,10,241,240,1,8914,8892,22,89,89,0,100
bf7361f5a3d1c114c3a5561e25e6329fdbddf900,0,0,0,0,0,0,0,0,0,0,0,0,0,0,0,0,0,0,0,0,0,0,0,0,0,100
0cc6aca13497f638a3ad1e2224fe614b750d2a5b,3,88,4,84,0,0,0,3,9,94,2,3,1.571156409,908,34,10,196,188,8,7114,6536,578,106,98,8,99.55387783
5916ffe8b8a5672f40a37ffd428a946d5c4c7f98,2,28,14,14,0,0,0,11,53,375,2,2,0.276195428,678,35,9,142,140,2,4504,4442,62,59,58,1,100
e53cd95fadb3ff6ce85346becc0ce642a1220d51,0,0,0,0,0,0,0,0,0,0,0,0,0,0,57,0,0,0,0,0,0,0,0,0,0,100
4d6decb8a1907e2ede49c5b8780fe0389f8a4a24,7,167,116,51,0,0,0,5,22,1403,1,3,2.090603607,464,53,1,51,47,4,3517,3065,452,37,35,2,100
9d6e0d861907e50f085034f0ea12e089c7fcbe00,0,0,0,0,0,0,0,0,0,0,0,0,0,0,58,1,0,0,0,0,0,0,0,0,0,100
bf8d297c34aa44ad3faaad6d609f422cf7bb4293,0,0,0,0,0,0,0,0,0,0,0,0,0,0,59,2,0,0,0,0,0,0,0,0,0,100
8acf988f72f604a59ca83ef80a7e7c0f4be6077c,1,8,3,5,0,0,0,10,69,62,1,1,0,675,36,2,137,135,2,5034,5020,14,78,77,1,100
86f66e21e1521164a87ca3ae5b60d090db214416,1,13,9,4,0,0,0,5,12,1744,1,1,0,164,37,2,28,26,2,1067,1057,10,13,13,0,100
4db4f804aa90f9900cda08c79b54a45f80f4213b,1,1,0,1,0,0,0,14,155,63,1,1,0,1183,0,0,241,241,0,8925,8914,11,89,89,0,100
d5e4a56c0f3b47e34720e0435254c9231dac9afa,0,0,0,0,0,0,0,0,0,0,0,0,0,0,54,1,0,0,0,0,0,0,0,0,0,100
94e043a78b346f4c50eda2543f50c9ab5c34a7de,6,484,0,484,6,0,6,1,1,0,1,2,2.438066623,0,1,0,26,0,26,2222,0,2222,16,0,16,99.52830189
63fc4e0f2aaef83e7679c34514e80b65cf1e7f87,7,1,1144,1143,0,0,0,6,10,2433,2,3,1.720492291,725,5,0,10,110,100,650,4363,3713,2,57,55,95.62433298
ab075f32a288473ad6d5ccf0f331f637481553b3,3,28,17,11,0,0,0,8,51,152,2,3,1.172253928,1067,1,1,126,124,2,8504,8484,20,75,74,1,100
f54923b4488284165c86698b8e76172b748aa2c6,3,13,0,13,0,0,0,2,156,1647,2,3,1.52623491,1274,1,0,247,246,1,9657,9595,62,94,93,1,100
346a32be2d6676bacd9f19a1c9ed9c8a4e111395,10,637,0,637,10,0,10,1,1,0,1,5,3.15520426,0,2,1,46,0,46,2496,0,2496,35,0,35,99.0990991
85a6fda466276948c1bb040d97190a456765708c,6,123,4,119,0,0,0,11,70,654,2,4,2.065438487,1900,0,0,299,294,5,15851,15136,715,147,144,3,96.35087719
45636823ac8e24621935e586f9b85919eef84973,1,1,1,0,0,0,0,3,4,1281,1,1,0,92,0,0,22,22,0,581,577,4,20,20,0,100
85281b201d42a4031a2ecd32cbee6636fa459265,2,13,1,12,0,0,0,10,52,70,1,1,0.863120569,592,38,0,80,78,2,4559,4450,109,49,49,0,98.66536458
b89d7c1d726932be1ece458af658c93453601699,1,1,3,2,0,0,0,2,3,836,1,1,0,119,39,1,19,19,0,1030,1045,15,4,4,0,100
aab414f2af73809168657beb17419be87b0aa259,10,482,3,479,8,0,8,1,23,44,2,6,3.161464753,492,3,1,99,73,26,5750,3661,2089,67,43,24,99.68102073
c48b0e4507208f0ffa4618efd33bd98a8f9b4649,1,2,1,1,0,0,0,2,2,775,1,1,0,78,40,2,7,7,0,488,477,11,5,5,0,100
349c365e81d76b210df7a97704217178e3f7f826,15,554,0,554,14,0,14,1,11,138,4,8,3.761112234,26,4,2,31,3,28,1600,217,1383,25,3,22,98.84157796
ed02db73d1de140bd00c5a9139e78070ecaaa060,16,228,39,189,0,0,0,9,157,290,5,11,2.834636557,6063,2,1,1060,1045,15,46911,45793,1118,556,549,7,100
d4d1c96768955cd6addf5c1fdea1302226b22227,3,97,2,95,1,0,1,1,7,556,2,3,0.223736417,252,0,0,46,43,3,2387,1594,793,27,25,2,95.9737293
a0203d46f23a75605d920dc39683c4e393c46750,2,77,29,48,0,0,0,4,9,1096,1,2,0.313812964,381,0,0,63,61,2,3797,3270,527,44,44,0,100
a59b571be196969cb0f0a1b8f6362df525245c7b,5,55,4,51,1,0,1,7,17,93,3,5,1.42564981,720,1,1,103,100,3,5688,5509,179,51,49,2,99.65562914
5b72ac7391b340758eaf69d124675e812db8f9e0,2,5,3,2,0,0,0,3,4,22,2,2,0.811278124,164,2,2,26,25,1,1433,1425,8,8,8,0,100
1af09806518c40a401948af5352a3192f183c8d3,18,770,66,704,9,0,9,1,2,8,4,8,3.619695304,300,5,2,74,19,55,3890,936,2954,63,15,48,96.53998866
f55f3863f8523d50f2782ce3eb7b6477cf5f02f5,6,304,1,303,3,0,3,1,3,19,4,6,1.627146268,137,6,3,38,15,23,2578,905,1673,27,12,15,99.20294298
37ea6e81e5f3d0a65bddc854002addd5337ed4d9,1,2,1,1,0,0,0,1,2,3,1,1,0,69,7,3,9,9,0,532,532,0,5,5,0,100
3e3e61cf4552b393d332ff78162aca3e1bd3222b,4,73,4,69,0,0,0,11,76,790,2,4,1.416082152,1293,41,0,236,226,10,10660,10192,468,138,132,6,100
de0e0223a8cf1344126b6edc5bd6286b1cff72c7,4,136,10,126,0,0,0,6,158,152,1,2,1.760535915,2117,42,1,413,395,18,17162,16267,895,164,162,2,100
052e109bf33bedaf6754c6a26f55c2eb1d9dbae9,5,94,19,75,0,0,0,6,159,20,1,2,1.78914663,2905,43,2,560,553,7,22797,22402,395,246,243,3,98.34920635
3a98407f0039c5d45806c557037ea6af00c69608,3,27,2,25,0,0,0,6,74,40,2,3,0.830602115,835,44,3,132,128,4,6880,6792,88,69,67,2,100
48f1f5e42e4f4e8021a7cbb2eed46a0c2cb041c5,3,39,0,39,0,0,0,4,9,856,1,1,1.49946672,390,45,4,63,53,10,2799,2569,230,30,30,0,100
ea949f17513c628a9f1ba582209ec7757e9cf4fa,2,11,1,10,0,0,0,6,29,0,1,2,1,651,46,5,89,88,1,5761,5644,117,32,32,0,100
81b65fb560f3b96be0c9b6ad0ac578d75c959a9c,0,0,0,0,0,0,0,0,0,0,0,0,0,0,11,0,0,0,0,0,0,0,0,0,0,100
0a720b50090dbfe789895e593c2277038d5f7204,2,8,9,1,0,0,0,5,20,244,1,1,0.936667382,969,60,0,212,213,1,6502,6517,15,108,108,0,100
0d964950e8fdf6887e53e8eb53695a14d29314c9,1,1,1,0,0,0,0,6,13,401,1,1,0,216,1,0,22,22,0,1774,1770,4,12,12,0,100
cf9ed0864615e82083f6be5f4f958563dbf242ad,1,4,3,1,0,0,0,5,7,881,1,1,0,112,2,1,17,17,0,795,797,2,8,8,0,100
6dd51454994a843fde10933d2ec3daedd6fb36de,5,5,5,0,0,0,0,7,73,440,3,5,2.321928095,1196,3,2,228,228,0,8873,8873,0,122,122,0,100
61f038b6bea2934e910e8504df0d8c79d6d34799,1,4,0,4,0,0,0,8,28,236,1,1,0,501,4,3,111,111,0,3242,3213,29,47,47,0,100
a4cedc2514f62683fef4f1ab20c67848f4c336e6,1,8,5,3,0,0,0,8,16,272,1,1,0,651,3,0,110,110,0,4800,4793,7,37,37,0,100
5bf143000368b8c10353fe092f25b6d3124df69a,1,13,7,6,0,0,0,12,50,312,1,1,0,433,4,1,53,52,1,3611,3539,72,18,18,0,100
07543a44c00e680cec24c1f18d9aa625b09f6e5e,60,124,67,57,0,0,0,10,160,358,8,19,5.694769273,12875,5,2,2050,2048,2,96603,95714,889,1049,1049,0,97.21102151
07278cd31891275d408257d21ac623ce39a1b993,2,4,2,2,0,0,0,2,3,1207,2,2,1,306,6,3,30,30,0,2426,2399,27,16,16,0,100
a7ab5e6fb4dd38a36fafa60e871f025b75843141,4,147,2,145,2,0,2,1,161,87,2,3,1.863384848,1400,7,4,292,277,15,11285,10564,721,120,112,8,99.82905983
a79281ca2452028228582ddde143e5350df9203d,3,38,23,15,0,0,0,11,75,103,2,2,1.006634797,1772,61,0,377,373,4,12271,12213,58,170,168,2,100
b559f48c870a7ca3391d77e3c602eccc68eb5b7f,7,253,4,249,4,0,4,1,162,101,3,7,2.532210596,1836,8,4,386,371,15,14827,13778,1049,159,151,8,97.87031151
50594a565cdd7d98dbf0f8c19aaf8e169154c7a4,1,12,5,7,0,0,0,9,30,5,1,1,0,503,2,0,115,112,3,3298,3252,46,47,47,0,100
9b1d2c18f5677f3d443344e69f98e6c3ac953835,1,40,38,2,0,0,0,5,9,1018,1,1,0,337,9,5,57,57,0,2492,2488,4,18,18,0,100
5b435ec1c749d20b1e147798fca43ed764620e2b,2,11,1,10,0,0,0,8,31,167,1,1,0.979868757,589,3,1,127,125,2,3972,3939,33,53,52,1,100
11689cd536b05bde323c9c6c6b57a8e82a60b680,10,36,62,26,0,0,0,2,2,38,3,4,3.256033583,597,240,0,62,66,4,3404,4098,694,49,43,6,99.07820398
9ffceabd770fd52f2b1ad9a227f651c47ea8c104,9,69,45,24,1,0,1,1,76,66,4,6,2.707641714,816,241,1,121,108,13,5211,3895,1316,71,60,11,95.88452088
2d72fbf1a3e6ea044ced410d60d5fcc20595ee77,6,185,75,110,0,0,0,2,4,127,4,6,1.4955888,375,242,2,46,34,12,2766,2126,640,34,25,9,99.39873418
ff5635819e94feff813cfed30519b3bb26a37cf8,1,28,6,22,0,0,0,12,50,69,1,1,0,510,243,3,67,63,4,4443,4299,144,25,23,2,100
86300a172a6b3e90ead5117122abfd3e3221894d,4,68,7,61,1,0,1,1,36,64,1,2,1.694562366,196,244,4,19,18,1,1056,990,66,16,15,1,96.82862962
6f835c1d42c7fcfcca8d2c5e1309c477269a64fd,11,175,83,92,2,0,2,3,77,87,4,7,2.688211784,2376,245,5,332,329,3,19760,19354,406,148,145,3,99.86512004
449a272debc1a3aebea6ecbd40ac6356d23ba855,16,170,94,76,2,0,2,4,78,296,4,7,3.370339479,2876,10,0,338,336,2,23308,22858,450,190,188,2,97.52155172
f78403a08700db47af7204da2f9ce46c2febc0ff,37,203,132,71,2,0,2,4,79,159,5,17,4.426456313,7580,11,1,1007,1005,2,61066,60540,526,491,489,2,94.88260084
a8075e3d6ae8610ce5e0c731cdca303f73d25839,7,181,114,67,0,0,0,16,80,5,1,2,2.244759469,635,246,5,103,104,1,4355,4116,239,61,62,1,95.76910462
7878ddf40b8c730f31ec7205b2a1b4fc64c6f0c7,4,43,14,29,0,0,0,3,4,67,3,4,1.645593161,415,47,0,43,41,2,2770,2479,291,31,30,1,99.68494014
88327daff3261cb3e2929d7fbcbba1ec51d67a34,18,201,234,33,1,0,1,2,14,70,4,7,3.609353878,1013,247,5,90,91,1,5524,5390,134,74,75,1,99.14853359
694fe6f5985db3a2ffb1608f08b78769f0ba5abf,8,192,46,146,0,0,0,4,6,23,4,8,1.903859852,615,12,2,78,57,21,4501,3588,913,54,44,10,99.14583992
f5ebbb7225288e2c2ba75d30acadef57660250e7,7,31,11,20,0,0,0,4,22,160,2,4,2.496468544,2645,0,0,477,473,4,19644,19538,106,252,251,1,100
e99f0d4b4fcf187ec3623fc550ecfa8d4df80cc7,9,161,158,3,0,0,0,4,17,55,5,7,2.217214661,783,248,5,94,91,3,4678,4681,3,61,58,3,98.56733524
6cd9f979164f24d9bb73c9e8a71239df71686c92,20,44,49,5,0,0,0,4,163,512,6,11,4.034407303,4059,249,6,723,724,1,28295,28301,6,369,370,1,100
a80fc6cf47eed1aaa977577c8e12ed23d5c949a2,1,8,3,5,0,0,0,12,53,25,1,1,0,438,13,3,54,53,1,3678,3643,35,18,18,0,100
9141f74fe894bf06cc095675d856d85feb2baafc,11,249,39,210,3,0,3,4,9,6,3,6,3.056487471,598,250,7,86,62,24,4431,3541,890,55,37,18,99.58506224
ad3cd5ae6c731d2f797890614a4f7bbcaa3ae818,1,39,6,33,0,0,0,4,10,1,1,1,0,222,14,4,37,29,8,1867,1657,210,20,17,3,100
c8c83609894cecfafab555a8f7c7a46ebd2d0833,1,1,1,0,0,0,0,5,6,482,1,1,0,85,0,0,13,13,0,559,559,0,11,11,0,100
746de17bc873bfc75a8809b5ddf59a282ae930e7,5,39,29,10,0,0,0,2,164,283,1,4,1.966506601,1922,1,1,352,352,0,14495,14439,56,136,137,1,100
72b3ab5c2e8a03bc9a5c5ea6b0bb1b736c0d1a20,14,191,190,1,1,0,1,4,11,13,2,5,3.391267758,735,251,7,85,73,12,4327,4021,306,58,47,11,99.40081993
4e8940daf2f818c4e5d64c627bc971110edff62b,17,184,121,63,0,0,0,4,12,7,4,7,3.341901782,1309,48,1,145,151,6,8257,7562,695,99,107,8,99.49286846
e00bc493c989d56db8c8dd0f4438f9639bbfb8d6,6,78,4,74,0,0,0,13,43,400,2,4,2.337409387,844,49,2,136,127,9,6514,6048,466,90,82,8,98.88428435
6ed64ee285a9469064a7cd2f368e8147a6bc6cbd,2,9,9,0,0,0,0,4,14,3,2,2,0.764204507,501,252,5,66,66,0,3687,3662,25,38,38,0,100
da56f4f0b637d750e34ec0f3625c5e3b21409ee6,1,73,64,9,0,0,0,4,15,1,1,1,0,294,253,6,43,41,2,2254,2249,5,28,24,4,99.3956743
c498bc147ff0cd2f71bfe1158fa01f64c3d3f221,5,197,28,169,3,0,3,1,2,50,3,3,1.982630487,247,15,3,38,29,9,2154,1592,562,27,18,9,92.84149014
af358415cc8ebc70665d73e5fc4812b7cb669c75,11,153,46,107,2,0,2,2,8,375,4,7,2.698813044,430,254,6,38,32,6,2355,2033,322,32,28,4,99.61767205
865a6cab64313e6702d557c385ecd328abd43692,7,36,59,23,0,0,0,2,16,37,3,5,2.022418669,849,255,7,96,97,1,5466,5512,46,70,70,0,100
cca0e6cab13c900219996782472e7086326df120,4,67,33,34,0,0,0,2,17,1,2,3,1.228972459,657,256,8,84,80,4,4905,4584,321,56,54,2,92.77777778
f939700549fa67d3e0cdea7103941822db9d0d55,7,117,47,70,0,0,0,2,18,2,3,5,2.131350176,964,257,9,125,111,14,7074,6602,472,82,76,6,100
e5861fafd7606d89199b98e8ffb16e7c7a223114,10,179,74,105,0,0,0,2,44,57,3,5,2.188372011,1353,258,10,187,189,2,9564,9183,381,124,126,2,96.20679107
e0958c9842f0236fa7b996efcc8121d1047274e8,1,3,8,5,0,0,0,2,2,4,1,1,0,345,16,4,31,31,0,2200,2242,42,16,16,0,99.97141224
12af614ad2c6ebf9bbcda9a49b4984c61f0fd2c2,9,94,53,41,0,0,0,2,45,7,4,7,1.923812058,1385,259,11,190,182,8,9377,9260,117,129,119,10,91.57858848
f5e771d85266d58dadfc2b5d4bf546dcf7982061,3,29,6,23,0,0,0,3,38,84,3,3,1.527747365,804,50,2,138,136,2,5858,5715,143,119,117,2,100
c77c183c31d7d09b497c4f6500dc230fe5d82f43,2,11,6,5,0,0,0,2,22,2,2,2,0.873981048,714,17,4,89,89,0,4959,4894,65,57,57,0,92.19445395
536d6400fb4f0064bbaf43257f7fec04f538df34,1,10,10,0,0,0,0,11,39,142,1,1,0,253,260,12,47,46,1,1701,1709,8,18,18,0,100
fbdcccc771ac886f93b5ff756e14d2d6c1cb8085,2,21,4,17,0,0,0,8,165,231,1,2,0.634309555,1381,4,0,280,279,1,10383,10332,51,112,111,1,100
9f5fd11aa6ed33a7f439e92a21fc0a78b4254b23,4,90,0,90,1,0,1,1,31,221,1,2,1.178671939,598,0,0,141,130,11,4425,3935,490,65,59,6,99.9136939
c16a811cc3472767d923f52aa40bddca707ef49e,3,38,10,28,0,0,0,10,166,378,1,1,1.05204405,1714,5,1,343,341,2,12811,12642,169,142,142,0,100
daa7afba3ce0b76b5fd9ec31dc49320fddaeb965,1,5,5,0,0,0,0,4,23,4,1,1,0,349,51,3,52,52,0,2564,2577,13,33,33,0,100
9357fdb8a8344b0bbda3f38291380f18f6be00d0,7,97,30,67,0,0,0,9,167,369,1,3,2.444836237,3437,261,11,687,677,10,25442,24992,450,348,341,7,99.77123248
715bc0f9eaf885febf0f2fc0a817f800eb314151,5,240,14,226,0,0,0,3,24,11,3,4,1.905295683,892,52,4,138,104,34,7569,5866,1703,86,72,14,98.46923756
a475808f41b5dcabde85341d3c065591fbde7d94,6,61,39,22,1,0,1,3,25,11,3,5,2.236023324,1003,262,11,128,128,0,6965,6913,52,77,78,1,99.93902439
43a042a8bbe123bcb5e567af0aeced12eb299290,48,124,80,44,0,0,0,4,168,478,7,18,5.209778788,13810,6,0,2492,2490,2,98382,97950,432,1186,1186,0,100
ab1ac87c7d83d63233915522e078c9e191a3b381,8,60,24,36,0,0,0,3,82,259,3,4,2.758949179,1450,53,5,218,215,3,10024,9803,221,133,130,3,90.89659911
1429bf128a735102745737cdf0c456c24c2baace,12,187,143,44,0,0,0,11,169,89,2,6,1.434745578,5675,263,12,1058,1051,7,41365,41277,88,530,525,5,100
f0460f8e0b9c2041251b9199ef3d4bfd82488bcf,6,59,17,42,1,0,1,3,27,0,3,4,2.235860564,1124,54,6,150,146,4,7963,7831,132,95,93,2,90.75458872
31381b69f87587fd34fc252ba5732b741cdbd2b8,4,20,27,7,0,0,0,3,28,0,3,4,1.756854612,987,55,7,130,132,2,6865,6916,51,78,79,1,98.71134021
189ee94471afdef8bd6c8b1fb419309230bfaa24,6,19,30,11,0,0,0,3,16,7,3,4,1.950562456,746,264,13,72,72,0,4614,4689,75,55,55,0,98.62621637
6e9db1a92263e9a1f28eb644436df4d683f5ace8,1,3,1,2,0,0,0,14,48,4,1,1,0,420,18,3,78,78,0,3213,3213,0,50,50,0,100
7172da0b965e295da815c2ce32deebe06c6e16ea,7,41,40,1,0,0,0,18,170,91,3,3,2.538322072,3125,265,13,602,602,0,23382,23392,10,289,289,0,90.76660988
311229c5428cfa62d6db2d3dc56973a2b8833678,12,191,85,106,0,0,0,3,83,199,4,7,2.957943981,1942,266,14,332,314,18,14228,13624,604,207,194,13,98.14674735
0e2ddf80ae77882c9924b90939e736e8e31905f9,15,51,91,40,0,0,0,2,171,515,5,10,3.176559794,3721,267,15,604,607,3,29287,29249,38,301,303,2,99.7829233
f4c2cec00854e290855c1187687e4e7d123d036c,2,10,7,3,0,0,0,3,30,2,2,2,0.787126586,823,19,4,115,114,1,6004,5960,44,63,62,1,91.18899443
6aa4d58656fb35855724eb8085d897a7bc16d363,3,17,17,0,0,0,0,4,31,6,2,3,1.011699293,559,56,6,88,89,1,3981,3969,12,50,50,0,91.18899443
05eaa70128dfa12dcfed459684983267cb079e92,2,2,1,1,0,0,0,3,12,145,2,2,0.918295834,168,57,7,17,17,0,1282,1269,13,15,15,0,100
d2896437e8a28d89de92618ca4041fb5e89ab674,4,167,121,46,0,0,0,3,40,4,3,3,0.959628212,1401,268,16,218,211,7,10502,10151,351,169,158,11,100
4021164b64752d909d4caba93b0bb3b74f87449e,1,6,9,3,0,0,0,4,33,1,1,1,0,463,269,16,80,80,0,3529,3592,63,46,46,0,91.18899443
87813c54884e5dce0580d5c23a6b05c807868a29,68,197,153,44,0,0,0,3,172,354,9,33,5.867522946,16332,270,17,2871,2871,0,118524,118098,426,1497,1497,0,99.18576598
f91ef63809b21ed65445f4a60d8005ce0a1af8ca,3,86,25,61,0,0,0,3,35,2,2,2,1.275307818,996,58,8,143,134,9,7728,7290,438,89,85,4,99.4047619
19b13541bc25b07479beb2572870f74a2ec43131,0,0,0,0,0,0,0,0,0,0,0,0,0,0,5,0,0,0,0,0,0,0,0,0,0,91.73387097
32c8653be1d743d3fb41a6037c23ecb5214113c6,2,434,370,64,1,0,1,4,36,0,1,1,0.998553286,491,271,16,88,85,3,4229,3816,413,50,48,2,91.41544645
a43f36a1590aee59b612d6775131ebb1fc7262aa,11,143,64,79,0,0,0,4,37,35,3,5,2.35382447,1032,272,13,147,135,12,6987,6733,254,99,88,11,100
b0929519d72abf88bb07055d346b4ba92f1d3603,8,190,4,186,2,0,2,1,81,259,3,5,1.900439358,1061,20,4,184,168,16,8777,7793,984,122,113,9,96.56377402
a05416545a4b0d1fe3f9e2d19f1f4fd5c1d772f5,6,145,35,110,1,0,1,3,45,33,4,5,2.330343376,1490,59,9,235,219,16,11736,11117,619,131,124,7,99.85367281
32016e4a40ae44bb3c3718880327bfb085bff509,5,69,117,48,0,0,0,5,46,256,4,4,1.564731624,1149,273,14,197,208,11,8410,8714,304,107,107,0,100
cba931fc5bdf9ada4b9d6c223eb2bf87d4c62000,1,1,0,1,0,0,0,4,39,3,1,1,0,193,21,4,21,21,0,1435,1429,6,16,16,0,100
f8f67055a9755c32a97e79ab8f307ba3c7f09c7b,9,133,45,88,0,0,0,3,40,710,4,5,2.813456479,1446,274,14,226,212,14,10911,10212,699,153,144,9,99.76669583
ffedbba1141d636749d60bf3967f576bf71ea485,6,119,65,54,0,0,0,3,26,6,3,3,1.926820904,1066,275,15,168,159,9,7512,7009,503,128,124,4,98.48175182
190b0f7107b4ff1d801535e798d988412616a773,4,193,2,191,1,0,1,15,173,12,1,2,0.501203048,2474,2,0,517,492,25,19774,18749,1025,240,228,12,99.88286969
6f49943a5f8b169f090fb5f6c6f3b8cbeae344a3,16,244,127,117,0,0,0,3,174,212,6,8,3.142370041,5231,276,15,937,923,14,39359,39023,336,505,491,14,98.82697947
dc6059064b783686d72a3d2b8bf42bc374db095b,8,203,67,136,2,0,2,1,19,246,3,3,2.588918927,654,277,16,82,61,21,5295,4137,1158,57,43,14,99.23484403
913f5a4ad54ddc948f49eca8907bb13ea67a6e35,5,48,17,31,0,0,0,3,36,14,4,5,2.011766358,1159,60,9,188,180,8,8427,8219,208,116,114,2,99.50292398
2adccb06a5a82d9d4da6547a6e64b1686607c047,7,66,28,38,0,0,0,1,48,0,4,5,2.077161525,1634,278,15,262,253,9,11665,11474,191,158,153,5,100
15d2646476e63287b452651ce4a2088af0dda1f7,12,33,47,14,0,0,0,5,56,189,4,9,3.360438737,3198,279,16,588,590,2,21260,21294,34,294,294,0,100
375b738d8f9d0cd5364daf9bd257f1e784bccf18,2,31,23,8,0,0,0,3,3,1172,1,2,0.380946586,99,280,17,26,22,4,760,713,47,16,12,4,100
0a934cf45f51569fb5f60a36563fdab84fd608d1,11,138,153,15,1,0,1,3,175,493,4,6,2.894977796,3018,281,18,512,520,8,21825,22049,224,252,253,1,99.56647399
6887001ef8ac750b5280e2745cfb5303d10bc949,12,233,36,197,2,0,2,3,176,12,3,7,3.131056998,4442,282,18,827,808,19,33695,32682,1013,412,399,13,99.68454259
507f09dfabbfd9eb25852d1bd24fbff9377909bc,4,295,211,84,1,0,1,3,24,1,1,1,1.139429341,760,283,18,121,88,33,6019,5519,500,92,59,33,99.65576592
83c613c6c2b287ef7767629081e1a1d024766d01,7,147,93,54,1,0,1,1,82,163,3,3,2.209273697,1545,284,18,270,265,5,11746,11469,277,185,184,1,99.79850317
2b83c9935baaac6c4dbd96ddd0cfc4d0c944df6a,9,119,37,82,0,0,0,1,49,7,4,6,2.359529779,2379,285,17,406,398,8,17955,17255,700,231,227,4,99.97124784
0a9ae9ae7176a0ec7d5749868005225a0644b1ca,7,88,60,28,0,0,0,1,38,2,4,4,2.223300862,1385,286,18,233,230,3,10278,9995,283,156,153,3,100
7c124b1c143e7208a4e8cdb7291b7599c21ac40a,8,198,38,160,0,0,0,1,50,8,5,6,2.579928823,1668,287,19,295,282,13,13293,12464,829,170,162,8,93.00330033
3b8f66d339f90be9be27ff358af90d17962e0a68,1,6,1,5,0,0,0,19,177,14,1,1,0,1328,6,0,273,272,1,9978,9959,19,102,102,0,100
1ec750d3d30a510dd69fba8b3a689e4adc96827b,14,300,77,223,2,0,2,1,51,21,4,8,3.44802751,1578,288,17,224,200,24,12216,11119,1097,141,121,20,91.44338807
bc9d7615d8ffa30e79a36b9fd1950af38f0f6a49,25,55,43,12,0,0,0,5,178,216,3,6,4.542454529,6957,289,18,990,990,0,55277,55088,189,488,488,0,99.95414947
bcc392ca4fedcb47202aaf775e31fa867c63b218,5,22,9,13,0,0,0,9,179,8,1,2,2.180973899,2910,290,18,584,582,2,21322,21189,133,278,277,1,100
e61333d16fe50de0cef4c9fe603f7776cf3e7e9c,19,161,93,68,0,0,0,5,180,75,3,9,3.584186014,7139,291,19,1310,1297,13,52840,52463,377,666,655,11,88.01410106
c3a1d5667c6943fef25ff3bbc937aee30f44a5af,16,221,212,9,0,0,0,3,181,84,2,6,3.145829481,5648,292,20,989,987,2,43445,43103,342,489,482,7,93.91129032
5ee32b57ae929cc60f2217bbb09314d594ffb2f8,10,224,219,5,1,0,1,15,182,235,2,3,2.201236473,3332,293,20,659,658,1,24089,23988,101,350,347,3,90.83715119
faa38bee9495094de10b64f2e6149ea5476164fc,7,38,56,18,0,0,0,3,183,229,3,6,2.256181086,2189,294,20,387,389,2,16227,16417,190,176,176,0,100
ebabdbf570b50af0d868a5f4e5acf6fe5adc4876,18,144,164,20,0,0,0,5,85,50,4,9,3.744353483,4930,295,20,581,580,1,40388,40537,149,313,312,1,91.0403397
06721577c75a95640d486b3ab8720359425fe8bc,23,134,145,11,0,0,0,8,86,116,2,6,3.7481418,5395,296,20,665,666,1,45030,45004,26,368,370,2,99.66955803
ccca25a7137b9bb65aa9514539381af05492856f,65,85,127,42,0,0,0,5,61,324,7,18,5.300572403,9871,297,21,1075,1075,0,79278,79388,110,615,615,0,88.4856483
aa56a315f2bbd67f9cde0c010c482fef829c4f63,15,217,177,40,1,0,1,2,184,22,5,7,3.15785071,3728,61,1,647,645,2,27110,26976,134,358,354,4,95.95687332
9a3589f9bbe74bfd612e33abe9b0313f719d776f,14,215,102,113,1,0,1,6,185,826,5,10,3.090320385,3702,298,20,730,723,7,26897,26649,248,340,333,7,98.37595024
4573fb7a39a9ad988c027c962aefe7afe4ad8268,1,1,1,0,0,0,0,19,186,0,1,1,0,1345,4,0,269,269,0,10067,10066,1,102,102,0,100
7557104b2f94dad8c63799808fe81ffbe09bd97e,22,240,164,76,2,0,2,4,187,0,3,9,3.564926226,7097,299,21,1244,1250,6,53617,53099,518,626,628,2,94.1031941
d15a3e452e55fce2062b53658cd3bee14f898a47,3,55,18,37,0,0,0,2,32,0,1,1,1.130115235,785,62,1,123,117,6,5940,5695,245,93,90,3,100
4cc6f5378966762e8a0889662fc01e3d1b8ae9b8,0,0,0,0,0,0,0,0,0,0,0,0,0,0,0,0,0,0,0,0,0,0,0,0,0,100
02caace296f4414de3eda9f4469dbd806ca594b1,1,12,2,10,0,0,0,6,11,1116,1,1,0,810,6,0,204,204,0,5790,5679,111,74,74,0,100
feed58a86822fdeef0bee8fe8ee4ff2f7a0f9aef,21,90,82,8,0,0,0,8,188,2,3,10,3.926299274,7152,300,19,1093,1090,3,55705,55812,107,548,545,3,96.57020364
f35d4f5e2a73e077d91f29a8d9526592db5fac83,1,1,1,0,0,0,0,10,25,64,1,1,0,426,2,0,78,78,0,2787,2787,0,39,39,0,100
fbf03863fee64857d78f2855db47d8a704ee441b,18,91,65,26,0,0,0,3,189,0,2,9,3.66652239,5959,301,19,940,941,1,46825,46767,58,448,448,0,96.4617584
ef95e2cad987d66cc094f4f5966f2594ab78d04d,19,143,115,28,0,0,0,11,190,39,2,8,3.587709815,7394,302,20,1225,1224,1,57061,56864,197,655,652,3,96.49749821
04ff37ef6fdef100cb7a424ba9f7b438aec2c9ba,7,310,0,310,2,0,2,1,26,121,2,4,2.296411344,709,22,0,121,92,29,7266,5389,1877,83,64,19,90.1863354
39480bf96f9f3df3a0a5b38a987b7eb89f8ef85a,1,7,3,4,0,0,0,3,4,19,1,1,0,90,0,0,7,6,1,733,717,16,7,6,1,100
86dd7fa68081e33428ed65dfdb613032b1378560,11,283,180,103,2,0,2,3,191,956,3,7,2.580459383,3220,303,20,632,630,2,22689,22376,313,288,285,3,89.87664823
66768c430a220f30e4069ed80687ab30e0718d2e,8,123,57,66,0,0,0,4,43,140,3,4,2.232164006,3196,63,2,565,551,14,25011,24509,502,329,322,7,100
3569b13d684ec1ac50f3a6d4c7560d5711ef22af,13,237,83,154,2,0,2,3,192,0,3,6,3.14163883,4677,304,21,922,916,6,33809,33257,552,471,465,6,99.76275208
c95d9a4cca08cc3c8561208064ae2f6951817f58,4,191,95,96,1,0,1,6,66,62,2,2,1.627176548,697,305,21,156,145,11,5005,4606,399,79,68,11,96.12739776
7849eee948c47d5a1763fc4d2cb85de164c8f98c,7,305,48,257,1,0,1,15,58,488,2,3,2.009727698,706,64,3,136,101,35,7144,5422,1722,77,62,15,92.19674556
28bafa1556c25a82db0e2838cd438e80dcd135fc,1,25,15,10,0,0,0,2,2,1,1,1,0,104,306,21,17,17,0,1044,928,116,6,6,0,100
5edc9532b14f1916aff851f78946e5148c9de768,2,11,0,11,0,0,0,2,13,4,2,2,0.684038436,476,65,4,85,83,2,3944,3862,82,41,40,1,100
365746f01368a8b3fe894f93831803dc9739c0e0,4,388,226,162,1,0,1,1,8,10,1,1,1.687692359,416,23,1,51,39,12,4288,3443,845,29,19,10,96.72505712
e5a052c18766293b94cc89e3a34a469193009537,19,223,146,77,1,0,1,3,193,1,5,12,2.35406406,5753,307,22,1068,1144,76,41556,43306,1750,575,603,28,99.50669486
96b13321bbd5f31eb6b6d9d247e29f0efcc1a448,2,3,8,5,0,0,0,4,27,8,1,2,0.945660305,190,24,2,22,22,0,1163,1201,38,19,19,0,100
80d857b7418855c4653487e8fe7fe77dccbb3afd,9,443,385,58,2,0,2,1,40,0,2,4,2.088080132,1274,308,23,248,278,30,8236,8960,724,111,132,21,97.64492754
8a92491be43c9b7c0b4871e466efb3ef66dfb139,1,10,3,7,0,0,0,8,17,9,1,1,0,348,66,5,82,81,1,2480,2429,51,40,40,0,100
002b2ec4d638d50d882eddfb8e3209abfba0dcc5,1,6,2,4,0,0,0,8,18,0,1,1,0,355,67,6,83,82,1,2497,2480,17,40,40,0,100
6c7f1d1c31c3c01e7d09eddb64bd9736af9ba18b,14,276,135,141,1,0,1,11,194,6,2,8,3.133470968,3841,309,22,639,626,13,28976,28402,574,397,386,11,92.44960711
edcf1d694f248cfaad8fe132c98a81435051825e,8,105,35,70,0,0,0,11,72,26,2,7,2.09101541,2150,3,1,350,346,4,16554,16109,445,208,204,4,100
be9a0c1d8987f849ca00ac9a4107d9402b9ab7cb,6,41,17,24,0,0,0,4,14,95,1,2,1.540489276,1135,68,7,161,156,5,8929,8789,140,98,95,3,83.92996109
efca97e57ddf0f4b5980982140433f16fda7dfde,10,79,84,5,0,0,0,2,15,0,1,3,2.645647433,1674,69,8,227,223,4,13074,12995,79,127,130,3,100
d3e28626a12c09496eff459b8b63b158ee4d975d,15,152,101,51,1,0,1,3,195,18,2,6,3.205329496,5221,310,22,950,951,1,37802,37618,184,495,495,0,85.48793662
79223f89054109d2c499d81a149e60c15fc90453,4,168,59,109,0,0,0,2,16,0,1,2,0.530421675,825,311,23,141,129,12,6952,6389,563,88,75,13,100
4a03d196b167d5e98a1719df7765aded7f562f12,13,83,48,35,1,0,1,1,84,53,3,5,2.992521022,2736,312,24,492,490,2,20145,20026,119,263,261,2,99.61432507
582bf58cf8e37611d49e0147fc5a7166d910426f,3,96,51,45,0,0,0,3,8,0,1,1,1.334941509,409,70,9,65,61,4,3653,3285,368,33,31,2,100
4e32dd78758b811f0773e55976d8a9628767e085,9,50,83,33,0,0,0,3,74,219,2,4,2.666390988,2067,313,25,242,245,3,16857,16999,142,134,135,1,99.94544463
6e940698b30b5a6a2e3970b81cbf23c981dd03b9,17,68,63,5,0,0,0,2,196,28,6,10,3.631156783,4786,314,25,789,789,0,35174,35113,61,464,462,2,88.31258645
eb3aef5fdc4f8674cec3fb8f8eacfe4040fe883f,3,38,16,22,0,0,0,5,16,1,1,2,1.45846685,575,71,10,79,75,4,4731,4556,175,45,44,1,100
b305a4a580084244fb822ca19ca721f009afcc15,14,34,48,14,0,0,0,4,63,8,3,8,3.238273427,3623,315,25,458,461,3,30260,30427,167,259,262,3,100
a562d9e02289131da2cda98ecf547f7694e0a024,8,241,1,240,5,0,5,1,197,31,4,8,2.336434548,1733,0,0,343,332,11,13346,12499,847,149,141,8,99.20486436
544d0e6ec9c7d7b0fa0081a8e00f16fac278c109,23,159,128,31,1,0,1,2,198,62,3,12,3.356421433,8722,316,24,1447,1447,0,66946,66749,197,707,707,0,98.70967742
5fff9c597f44d2731605e23a758f00030700c5f8,7,127,52,75,0,0,0,5,17,164,1,2,2.214665829,1073,72,11,154,149,5,9182,8617,565,85,83,2,100
e1e446f6340e9ac09a6c7d01c1c080bf250e03fa,1,11,3,8,0,0,0,16,62,3,1,1,0,464,0,0,87,85,2,3597,3557,40,53,53,0,100
a055ed52e77e144a1adc9e89449275f82b36682a,10,123,141,18,0,0,0,12,63,17,1,6,1.909832193,2948,317,23,561,566,5,20368,20452,84,304,307,3,87.17948718
17a2198b0016a66494da4344d218593ed2c4d7de,11,125,84,41,1,0,1,6,75,177,1,6,2.514295773,1553,318,23,279,278,1,10488,10245,243,164,160,4,99.6070025
5412d3d1b82d739a899bdab017d7ceb0ec45f01a,10,158,96,62,1,0,1,1,199,15,2,7,2.305177056,3520,319,24,708,705,3,25086,24840,246,303,301,2,99.92846924
89c886f2976c5af8a43c3509433b6842ddf2360b,5,36,22,14,0,0,0,9,45,11,3,4,1.829068186,1148,73,12,186,185,1,8909,8847,62,142,141,1,100
c5eafb923440f3ad4b786bfe8ff64e57a2be08c4,16,83,124,41,0,0,0,4,200,51,4,10,2.793507187,5336,320,24,1020,1034,14,37632,37903,271,479,490,11,97.90364104
a8bddc5af3ba4b4c7db48de3b45f267993e51dc7,19,22,44,22,0,0,0,1,32,3,4,7,2.479447002,1688,321,21,201,204,3,10450,11909,1459,172,179,7,89.91138378
12c43030c98dfac15d114f5da7abc51335ec0085,13,371,258,113,3,0,3,3,77,323,4,8,3.16096093,1939,322,21,358,344,14,13540,13086,454,197,187,10,92.4094155
f69a355a765c89329a214317ed97b3f4c723cd23,3,30,14,16,0,0,0,8,25,47,2,3,0.530406078,692,74,11,112,111,1,5716,5523,193,64,63,1,100
1c0646d46fba1647ceddc3bcd30d09dd67b46476,14,186,70,116,2,0,2,2,29,41,5,10,3.376039224,1702,75,12,251,242,9,12930,12456,474,151,148,3,95.86609181
e19894d8097ca075ea76bdb3504ad51507686b08,15,362,197,165,2,0,2,2,47,13,4,8,3.08900792,4190,323,20,668,646,22,32399,31686,713,351,328,23,99.33499584
b4b18ca6632b6399fc6d5372b8340d34f1ad66b7,13,154,86,68,2,0,2,3,201,33,4,5,2.910884866,2966,324,20,524,528,4,20831,21103,272,238,240,2,99.0615512
f51196455679443be438a1ddb04bd6860f4ad6dc,16,110,98,12,0,0,0,3,79,20,4,7,3.321026879,2824,325,19,495,512,17,19505,20470,965,300,310,10,98.78419453
cfa6c4f70e8dc296c921b7c8b33511d58270ab39,23,216,139,77,2,0,2,5,48,17,3,11,3.605285131,6137,326,19,1058,1052,6,45074,45068,6,568,562,6,97.56361668
c714affca4da0637b877a53bc21e21f3583204ae,13,223,155,68,1,0,1,11,202,7,3,8,1.94449003,4853,327,19,807,867,60,37296,39180,1884,387,421,34,94.36619718
d26861eca140288bc8e75757e738ab5d128522d2,19,336,54,282,2,0,2,2,55,28,6,9,3.475498333,3649,76,10,610,586,24,28854,27107,1747,406,387,19,95.85779517
195c572024fc5fd88d00c3c0985c01215d2719aa,17,200,132,68,1,0,1,5,65,8,3,11,3.259046765,4651,328,19,781,781,0,35091,34812,279,419,416,3,98.44895657
2ddf0dbb27f78727d5b93546445d2112e5612e15,1,5,0,5,0,0,0,12,43,22,1,1,0,521,4,1,117,116,1,3458,3408,50,49,49,0,100
01b8a85d0aedf0ca555bdd83d203893140d8d212,18,167,0,167,1,0,1,3,203,622,7,10,3.801263184,4629,77,8,814,793,21,34261,33369,892,428,413,15,99.94686504
b6c9888b1c828029cf39cb48dd2d100b17668fcc,5,45,19,26,0,0,0,2,17,13,1,4,2.084978908,818,78,9,112,109,3,6716,6495,221,70,69,1,90.95682614
0a1b63d5b5f18e23e4ad52a361e1811730ba8207,12,81,48,33,1,0,1,6,204,24,3,6,3.238970475,3910,329,19,614,613,1,30423,30323,100,295,294,1,99.87055016
46279423107a66c1f22f36fb374a66081d44cb27,11,59,20,39,0,0,0,6,25,2,3,7,2.298017972,1631,330,18,255,318,63,12086,13271,1185,179,217,38,93.41781063
5a4141a20d6025d1071f836b711a2ec373c4f7a7,11,351,24,327,3,0,3,10,205,16,3,6,2.859543174,3310,79,7,620,575,45,27276,25339,1937,292,272,20,99.73066564
cb648e007d08f35f0eebfa785136efd99e5ec044,8,134,32,102,0,0,0,3,86,199,4,5,2.344470396,2194,80,8,401,392,9,17077,16702,375,240,231,9,100
5cb7e31fba285fc729826b7086795c9e3682aa9a,1,17,13,4,0,0,0,12,59,1,1,1,0,477,81,9,80,80,0,3981,3964,17,34,34,0,100
c219b9841eaa239c965faa850c2cf9685f8d42b9,15,143,49,94,0,0,0,10,206,18,5,9,3.133885656,4704,82,9,865,857,8,35081,34345,736,435,430,5,99.35459377
79fd5afde2b4cd92ef86ebea7a047204d981a2a2,17,250,20,230,0,0,0,3,207,352,6,9,3.590439244,4818,83,10,855,819,36,35918,34346,1572,467,449,18,100
379122af36caa059295eef4ac693c68e8b74a397,9,140,63,77,2,0,2,13,88,11,2,5,2.562247994,2448,331,13,350,347,3,20594,20282,312,194,191,3,99.81252343
ead7504ee1f499cd70cf2a0adc9c6bf5deeacb17,4,47,339,292,0,0,0,2,44,42,2,2,0.961741754,700,332,13,52,99,47,3168,4403,1235,37,86,49,87.80918728
07fa7a3a69f18df5bc92cb6dd784d3001b6cf7d1,4,17,12,5,0,0,0,3,66,19,2,4,1.819852846,1168,333,14,223,221,2,8953,8882,71,116,115,1,100
ae7ba946538102d40cf0cb784cef22b414959a9f,4,15,8,7,0,0,0,6,12,36,1,2,1.804895651,417,0,0,45,43,2,3491,3451,40,22,22,0,100
2aeb237fe77da9e49ba2976f4a64822634bcd38d,2,1,8,7,0,0,0,12,67,6,2,1,0.764204507,649,334,13,120,120,0,4799,4862,63,57,57,0,100
ab0cd356c0888e36642a5ef4f7b9c05d85f4447e,2,7,2,5,0,0,0,16,89,15,1,2,0.918295834,319,84,10,65,64,1,2149,2109,40,34,34,0,100
918c7c3b1c1593c0e70fef0a960766edb256932f,16,69,36,33,0,0,0,2,45,58,4,6,3.581245728,1834,85,11,246,243,3,12833,12555,278,163,161,2,94.15784079
f0d0e734b32d6dd69b0058934f7492385a8bb551,1,1,1,0,0,0,0,5,11,66,1,1,0,76,335,14,11,11,0,576,576,0,9,9,0,100
c9c2c2ff6c4b72953c01725227807b7ba0036bde,1,5,42,37,0,0,0,2,19,0,1,1,0,396,86,12,58,67,9,2945,3161,216,30,34,4,100
b6fbb50e22cd04001690f473ebb15f74a8b09e32,1,7,1,6,0,0,0,2,10,2,1,1,0,143,336,13,15,14,1,1117,1085,32,11,10,1,100
074a495eda03392ad7a02d0ca799f96843fae5f4,2,20,5,15,0,0,0,2,20,54,1,2,0.970950594,507,87,12,71,70,1,4150,3998,152,41,40,1,99.86028641
841a04c37416510abc87fd150d35bb511c6b7cb7,7,216,25,191,1,0,1,1,46,21,3,5,1.981068188,958,337,9,144,120,24,8401,7272,1129,94,80,14,93.21682464
82fe707581f7c5ece463154ede5c2b34c3e294dc,1,5,1,4,0,0,0,20,208,27,1,1,0,1425,88,9,280,280,0,10714,10702,12,103,103,0,100
35f17fa5a0a7066f667e7e7a346cb849e3ebd858,8,246,57,189,0,0,0,6,209,65,1,3,1.945089571,3437,89,10,642,611,31,26662,25526,1136,279,274,5,100
402579eb0abe17f829cb7f529d80a6e95cd4091e,3,132,129,3,0,0,0,10,82,14,1,2,0.545416267,1069,338,7,178,174,4,8325,8282,43,87,80,7,100
72a9d0fb9aa6faf1edbf04701884972b88521301,3,180,137,43,1,0,1,1,210,1,1,1,1.284402487,1841,339,8,368,368,0,13816,13756,60,151,146,5,99.87218814
544590d51b9ce9d8814958f8852a3c0d9d1ca67a,8,32,35,3,0,0,0,21,211,739,3,4,2.715375154,2146,2,0,397,397,0,15930,15935,5,181,181,0,98.3248731
b9c137d33320c36a0fd9a85da0455c46872ea94d,0,0,0,0,0,0,0,0,0,0,0,0,0,0,25,0,0,0,0,0,0,0,0,0,0,100
c2bfd76bd05fc18f5713766e286424e8add6e53d,1,5,2,3,0,0,0,4,7,126,1,1,0,82,1,0,8,7,1,547,534,13,1,1,0,100
ba24a235934d09974b90d906ad16e0167988f8fd,1,74,4,70,0,0,0,12,61,76,1,1,0,484,340,2,92,80,12,4494,4019,475,40,34,6,100
17bc4949b6293760661369eb959a162986661957,1,13,5,8,0,0,0,16,84,36,1,1,0,347,0,0,71,69,2,2542,2497,45,41,41,0,100
eb66796de745d3c70bc18dc707222af53a84ea5b,19,443,78,365,1,0,1,14,67,279,5,14,3.266031943,3630,7,0,639,576,63,29364,27173,2191,386,350,36,99.89878543
162ae0f083191353382666d6bc7034c84450c7ec,3,21,1,20,0,0,0,10,42,76,2,3,1.539484757,1184,90,0,198,195,3,9321,9155,166,138,136,2,100
7b5825ff8d9f51218e2406e3410b4a83247867c4,1,0,1,1,0,0,0,2,2,149,1,1,0,209,3,1,50,50,0,1188,1199,11,31,31,0,100
d823e8fca5db60669ba24b30ddf90953114740b3,0,0,0,0,0,0,0,0,0,0,0,0,0,0,4,1,0,0,0,0,0,0,0,0,0,100
f5890c35599cfd4da9c5a76bf1fba2e186b1138b,0,0,0,0,0,0,0,0,0,0,0,0,0,0,8,1,0,0,0,0,0,0,0,0,0,100
0bdf24f3e307246e5dcaefac03e41c9fb69a6ef1,0,0,0,0,0,0,0,0,0,0,0,0,0,0,9,2,0,0,0,0,0,0,0,0,0,100
7d0ecb19c692619a992cd7c07adb3d64fbde9ca0,1,2,2,0,0,0,0,2,2,195,1,1,0,138,10,3,23,23,0,896,909,13,13,13,0,100
9d1b711f9d4606145e19a28270b0c50b04dc869b,0,0,0,0,0,0,0,0,0,0,0,0,0,0,11,4,0,0,0,0,0,0,0,0,0,100
acdc20971850f9b9c7779276b8d7bf1527dca05d,1,2,0,2,0,0,0,2,2,146,1,1,0,133,5,2,23,22,1,789,779,10,13,13,0,100
bccc6b8e5909ce464979319269a92cc6b57d76fd,1,1,1,0,0,0,0,7,21,135,1,1,0,565,91,1,139,138,1,3885,3879,6,71,71,0,100
05ef7de0587627c8c9665af3d8265bfd1ceb38d8,1,5,3,2,0,0,0,2,3,131,1,1,0,126,26,0,28,28,0,850,850,0,24,24,0,100
aa6c5ff4bad6425a7e1dd10a1f3e4f2f93f4050c,0,0,0,0,0,0,0,0,0,0,0,0,0,0,12,4,0,0,0,0,0,0,0,0,0,100
371fbfe36bee450fdac8cc9ecc0c91f1fd142859,2,113,3,110,0,0,0,5,44,160,2,2,0.506125214,720,1,0,134,128,6,5683,5039,644,56,54,2,100
87bd1fd1df9f02e83b973291d507ad002bd9d3f4,0,0,0,0,0,0,0,0,0,0,0,0,0,0,13,2,0,0,0,0,0,0,0,0,0,100
855cc20d870fa6597a79e5c7ab7efb4a9c9b260c,0,0,0,0,0,0,0,0,0,0,0,0,0,0,341,0,0,0,0,0,0,0,0,0,0,100
a6913a5e2d445229fafd0546248d0f0ee9f12d33,0,0,0,0,0,0,0,0,0,0,0,0,0,0,342,1,0,0,0,0,0,0,0,0,0,100
50bbd63ec079542086e3af2fac9d7a8fb84b20a7,0,0,0,0,0,0,0,0,0,0,0,0,0,0,92,0,0,0,0,0,0,0,0,0,0,100
07d781495b2ebb9f17e5010cf8bd44a87a30c278,0,0,0,0,0,0,0,0,0,0,0,0,0,0,14,1,0,0,0,0,0,0,0,0,0,100
9fc6a1163b993177fd884bba4212326bb6abbf73,47,119,49,70,0,0,0,5,45,398,8,27,5.208884452,9910,15,2,1652,1653,1,71178,70599,579,814,814,0,100
1ce8621b295678c780ad7adaf5621d8114fdefc3,0,0,0,0,0,0,0,0,0,0,0,0,0,0,2,0,0,0,0,0,0,0,0,0,0,100
b5418485c4224fe5f254cf1dd4652e99460b81d4,0,0,0,0,0,0,0,0,0,0,0,0,0,0,16,3,0,0,0,0,0,0,0,0,0,100
bb142e862479e66d124e1c3238cafa04d3c40bf7,0,0,0,0,0,0,0,0,0,0,0,0,0,0,93,1,0,0,0,0,0,0,0,0,0,100
b3d9200ea11721a2711fd06c43c9aa8fe9e0fdb3,3,18,1,17,0,0,0,2,11,136,2,2,1.557431962,258,94,2,28,26,2,1848,1751,97,18,17,1,100
f62698b59c9e450e998f7e2647738efb112c2400,2,24,18,6,0,0,0,5,9,818,2,2,0.998363673,205,0,0,39,41,2,1516,1491,25,17,17,0,100
99f7933f6be25f0598dc43ca9066efe923e266ac,2,49,0,49,1,0,1,1,9,64,1,2,0.475431646,83,0,0,16,13,3,638,499,139,8,6,2,99.8990154
cec6b2191881c12c21ea93518d1ac18cbe894d9d,1,14,3,11,0,0,0,3,3,1674,1,1,0,54,1,0,11,10,1,320,245,75,11,10,1,100
fbe430cf6b57c16aa21a54f5d68b128bca33adfc,2,5,1,4,0,0,0,4,23,120,1,1,0.650022422,947,0,0,179,178,1,6944,6919,25,95,94,1,100
f0942d0ace4f717cf7732c1f0916b777c4f5a244,0,0,0,0,0,0,0,0,0,0,0,0,0,0,17,0,0,0,0,0,0,0,0,0,0,100
5fba786bdbd20adfab957f7ab8f35cb8c5ad6e26,2,8,12,4,0,0,0,4,9,172,2,2,0.970950594,353,0,0,43,43,0,2457,2491,34,24,24,0,100
cb73327319ac2410fa5da27fee6b5e3ef70aafee,0,0,0,0,0,0,0,0,0,0,0,0,0,0,1,1,0,0,0,0,0,0,0,0,0,100
dd0fad479ca9b9a67cd0856999729179fa1fd49d,2,13,8,5,0,0,0,6,212,144,1,2,0.791858353,1663,3,0,288,287,1,12786,12739,47,109,109,0,100
2f33a165a6b066f85ca2334d4e3a10d9366b69e7,0,0,0,0,0,0,0,0,0,0,0,0,0,0,18,1,0,0,0,0,0,0,0,0,0,100
dc0b68b4c0b8c187a08f669422a2cd099d7be0b7,0,0,0,0,0,0,0,0,0,0,0,0,0,0,1,1,0,0,0,0,0,0,0,0,0,100
f60fb15d6af72007f9ee8d5067e0701d67434ea8,2,33,4,29,0,0,0,4,9,347,2,2,0.494182935,233,5,0,43,40,3,1520,1454,66,21,19,2,100
bd3f36bd324257d5898d59f203f7d19c1405a26c,0,0,0,0,0,0,0,0,0,0,0,0,0,0,62,0,0,0,0,0,0,0,0,0,0,100
80f6e4b3825860bf50f1253a4ee2cc5240bd194b,6,64,22,42,0,0,0,13,213,232,1,4,1.964357785,3247,2,0,522,518,4,26150,25807,343,239,238,1,100
ecc6c7d16c79a2bf2bf2d31cf5f1b57f1a9b56b1,0,0,0,0,0,0,0,0,0,0,0,0,0,0,19,0,0,0,0,0,0,0,0,0,0,100
43915d258b6abab857d067669ed2ef11948cf410,0,0,0,0,0,0,0,0,0,0,0,0,0,0,20,1,0,0,0,0,0,0,0,0,0,100
37c3b13de094d31a6c674666cab07edf169d0663,1,9,3,6,0,0,0,8,14,17,1,1,0,268,0,0,17,17,0,2274,2235,39,7,7,0,100
52a52ed2c7f75cfbbfa81f7ce8fd18b01c54b66b,1,3,9,6,0,0,0,8,15,0,1,1,0,271,343,0,17,17,0,2235,2274,39,7,7,0,100
da012a625996f0eecde5c1dd094ca243cb5ca283,1,9,3,6,0,0,0,8,16,0,1,1,0,268,1,1,17,17,0,2274,2235,39,7,7,0,100
b971c2a7d1b6800942723237de8c10290a70e1da,1,9,11,2,0,0,0,16,69,20,1,1,0,529,2,2,67,66,1,4578,4545,33,24,24,0,100
00f0c8586cbf70e292ece73768db93f3b7888885,1,2,2,0,0,0,0,17,85,287,1,1,0,355,1,0,71,71,0,2546,2542,4,41,41,0,100
ff8aa668f1a0569ba5e6b0f30dbd51a673913344,1,7,0,7,0,0,0,9,11,188,1,1,0,104,3,3,15,15,0,819,771,48,8,8,0,100
1ae7b18bf42bdd16f07b7339f7680257bfec768a,0,0,0,0,0,0,0,0,0,0,0,0,0,0,344,1,0,0,0,0,0,0,0,0,0,100
4e7898812dea82a61fdf178b68f177521684f517,2,33,5,28,0,0,0,2,43,330,2,2,0.926819064,695,95,0,121,116,5,5308,5088,220,113,111,2,100
9b1717fa152e7de58edee5e64ab4ff181147c3f6,3,52,32,20,0,0,0,4,13,312,1,1,1.357130501,498,96,1,77,74,3,4284,4133,151,37,36,1,97.37022639
8bfe8a22bdf6a9ba4a7d2118fe21104e4920f823,2,7,4,3,0,0,0,2,22,99,2,2,0.684038436,863,97,2,153,153,0,6631,6593,38,125,125,0,100
9577d564eeac36cf449843d34b7010b33d634818,1,8,11,3,0,0,0,9,16,543,1,1,0,173,4,4,40,42,2,1185,1191,6,15,15,0,100
040bc52e19a5e36f5710ccd4fc1981e862e691e8,3,66,0,66,1,0,1,3,44,436,2,2,0.592411886,360,5,5,88,84,4,2844,2500,344,53,50,3,99.9581765
363dd07f37742285fdfffcb7168bcbb2b21896a9,1,16,3,13,0,0,0,18,86,47,1,1,0,355,0,0,73,71,2,2635,2546,89,41,41,0,100
921ae6e2088cd49eb3c3cf3d25df7ba436a75674,2,3,2,1,0,0,0,3,16,525,1,2,0.970950594,235,98,1,33,33,0,1460,1455,5,26,26,0,100
d65ca26a0291fc6067f860eff4ff3092d25c0aec,4,49,42,7,0,0,0,10,214,198,3,4,0.99295847,2192,6,2,400,399,1,16364,16320,44,174,174,0,100
a7315511bddcc12dc4acea25f2d0d71608a8591c,6,50,11,39,0,0,0,5,87,293,3,4,2.268590773,1443,1,0,254,249,5,10216,9977,239,181,177,4,100
526b254cef8d383a80c0faa0fab3fd99708a06b8,2,15,5,10,0,0,0,6,7,667,1,2,0.970950594,113,7,0,21,17,4,821,766,55,14,14,0,100
a606fd2ec0714ff078e6eb9f579bc0c9c965699c,0,0,0,0,0,0,0,0,0,0,0,0,0,0,6,0,0,0,0,0,0,0,0,0,0,100
4bef7f8a4f54acfccabf4e6b8404525db4ef9d82,0,0,0,0,0,0,0,0,0,0,0,0,0,0,7,1,0,0,0,0,0,0,0,0,0,100
9b57296a38ecb87cb74eb7895e6e9f1e201d70c1,5,34,8,26,0,0,0,7,31,688,2,5,2.146120432,895,21,0,148,144,4,6499,6399,100,90,87,3,100
3f4f5ffc6d34ac906d71feea0d9c6f845663e138,7,90,27,63,0,0,0,4,37,793,4,7,1.991394711,1655,0,0,273,267,6,12906,12532,374,211,207,4,100
03f3b68a77c34c25cd513080372d61d073ae0fa7,1,7,0,7,0,0,0,3,5,751,1,1,0,72,345,0,10,9,1,425,411,14,7,6,1,100
616637b5316e09af1fceb1751487580fa9313a22,1,2,2,0,0,0,0,5,5,396,1,1,0,72,0,0,10,10,0,375,375,0,4,4,0,100
5e444084307dce717816dd16c7942d785fd3e9d1,0,0,0,0,0,0,0,0,0,0,0,0,0,0,22,0,0,0,0,0,0,0,0,0,0,100
cc5f2e58bcfdf2232dad5b9f89745489aadd4f80,11,265,23,242,0,0,0,14,215,556,3,5,2.893602508,3899,8,0,713,685,28,29753,28479,1274,311,305,6,100
f0d75c1ec5d2fcad187beaddb6a22e10a5ea1368,1,42,32,10,0,0,0,15,47,40,1,1,0,555,0,0,124,123,1,3778,3650,128,49,49,0,99.97909699
da4fd87a17a6364f9420902a533b7cdfba40958c,12,77,23,54,0,0,0,3,90,1227,3,3,2.462121381,2523,346,0,469,459,10,18489,18132,357,273,270,3,100
ebcee8f1d07d143201a8366cd169b65acbebdfd2,1,0,12,12,0,0,0,10,38,783,1,1,0,413,347,1,70,72,2,2656,2730,74,36,37,1,100
7a852736de1588bc645f86a92a1d6b4d37b21e2b,1,1,1,0,0,0,0,6,17,57,1,1,0,823,1,1,157,157,0,6200,6196,4,85,85,0,100
519acad397a10541a5f3fdf376cb44886c22febf,1,2,8,6,0,0,0,23,216,75,1,1,0,1457,348,2,278,280,2,11016,11048,32,103,103,0,100
ec708666d449971601c1fb58bef41cfdcd05b729,0,0,0,0,0,0,0,0,0,0,0,0,0,0,349,3,0,0,0,0,0,0,0,0,0,100
dcd395c3b629cd2ae4092a3b04085ae986b00f60,2,16,1,15,0,0,0,4,23,420,2,2,0.997502546,514,350,2,89,87,2,4109,4027,82,57,55,2,100
c7d4b6a16009884146c839e1c0e1e27a005d9cec,5,42,37,5,0,0,0,2,7,1893,3,3,2.030894959,997,0,0,164,163,1,6843,6812,31,130,129,1,100
837b063a4e11edd241759c7b967af44120b25f60,3,61,2,59,0,0,0,7,20,100,3,3,1.506368609,1666,1,1,332,320,12,12802,12421,381,223,217,6,100
b735bb520c1e11cf3d19328f3fc31765c4aea5e3,2,19,22,3,0,0,0,10,217,94,1,2,0.712064055,1766,2,0,300,299,1,13695,13664,31,112,112,0,100
b98ff4065811b0d3aeaa747b4d05df958ee8ef07,2,63,2,61,1,0,1,1,6,120,1,2,0.805125007,75,351,0,15,10,5,656,425,231,9,7,2,99.95821145
64a4f0ac2426d1d2c61806f262767a84b425aa38,1,9,3,6,0,0,0,8,19,62,1,1,0,843,63,0,164,163,1,6402,6368,34,87,86,1,100
a6c07100d9155f2bed137bebce05e6da17d73328,0,0,0,0,0,0,0,0,0,0,0,0,0,0,5,0,0,0,0,0,0,0,0,0,0,100
0e380739f9eeb240c4ad2cf4ba5264cf03cf4b05,1,8,12,4,0,0,0,25,218,86,1,1,0,1453,2,0,277,279,2,11032,11047,15,103,103,0,100
d62117a2163d9c3027a6b5f7b18da36fb4e4a0ab,6,52,32,20,0,0,0,4,48,215,3,3,2.353496189,1186,3,1,237,234,3,7710,7558,152,102,102,0,100
1970565bac3d39737079b779a73838753d8b7ec9,1,13,6,7,0,0,0,25,219,5,1,1,0,1450,3,0,277,277,0,11038,11032,6,103,103,0,100
bba47a5602bbbab496ca55f4761eefbeda5fd30e,4,19,5,14,0,0,0,3,12,991,3,4,1.680155967,602,0,0,66,64,2,5021,4883,138,43,41,2,99.97911445
637f4b2d623a7aee2f20750e3c2c719d637207c2,1,24,0,24,1,0,1,1,1,0,1,1,0,0,6,0,1,0,1,47,0,47,1,0,1,99.95824635
1dec9dcebfc87833be1c2dc9a127b03eaf62f129,2,56,11,45,0,0,0,5,13,4,1,2,0.980467931,203,0,0,30,21,9,1741,1524,217,25,19,6,100
8fb9f7a64228a442af0a539614b03aa951ce1240,4,385,2,383,3,0,3,1,2,0,1,3,1.87492319,23,7,1,32,1,31,1412,47,1365,20,1,19,99.8125
5507ca9813de6dff8084829e97102150c55f3b56,3,359,0,359,3,0,3,1,1,0,1,2,1.454885637,0,8,2,38,0,38,1601,0,1601,22,0,22,99.81323926
a136a626451c44c592397ebdcb28d9c634b4ef55,2,26,7,19,0,0,0,7,68,658,2,2,0.684038436,704,352,0,113,110,3,6086,5930,156,59,57,2,100
ad22fbf8ce4a581b721755442400d036b51235d2,1,2,1,1,0,0,0,8,22,839,1,1,0,565,1,1,139,139,0,3898,3885,13,71,71,0,100
ba7b24b71c0df104f98f40f2b75c4daca7b9cf67,3,141,15,126,1,0,1,1,2,2,1,1,0.753252787,220,9,3,43,34,9,1863,1324,539,24,18,6,99.91723567
0c2533c1ceb2f1347b0ae3d276725391c78f2bf0,1,114,0,114,1,0,1,1,1,0,1,1,0,0,0,0,11,0,11,510,0,510,7,0,7,99.81404959
b0a958664ac15534b6e977ad8370bcb2196ede54,5,97,97,0,1,0,1,3,24,433,4,4,1.509098016,689,353,1,97,115,18,5418,5647,229,53,56,3,99.91742362
2739eb6883458395aef1f901e3e4b6825f02d658,4,89,9,80,0,0,0,3,6,354,3,3,1.612118315,518,354,2,86,76,10,3616,3204,412,52,48,4,100
d98c7be27c0648d261955b83d2b375e6fd2ab9d1,2,7,3,4,0,0,0,5,20,568,1,2,0.721928095,910,1,1,171,170,1,6776,6740,36,94,93,1,100
8fe94ff903b5fb14409b69598c88e477c81307b2,2,3,7,4,0,0,0,5,21,0,1,2,0.721928095,914,355,3,170,171,1,6740,6776,36,93,94,1,100
77e5e7406436586c85ded0b5038a06d0b43864d7,2,7,3,4,0,0,0,5,22,0,1,2,0.721928095,910,2,2,171,170,1,6776,6740,36,94,93,1,100
2e556547f382664113f9eee9e7b8b08daba9a1f6,1,6,0,6,0,0,0,5,14,27,1,1,0,176,2,2,19,19,0,1307,1276,31,14,14,0,100
2c86489025fd6e769d0098d6df30faa00cb1c9a7,1,147,0,147,1,0,1,1,1,0,1,1,0,0,3,3,14,0,14,830,0,830,9,0,9,99.95872885
4fbda52079b76e457f878e8d908f0bfedf94e436,2,2,2,0,0,0,0,13,34,679,1,1,1,509,356,4,74,74,0,3824,3824,0,36,36,0,100
2ad0389037dd56dda2a609040ec68aa3cb6bdbd0,2,14,2,12,0,0,0,5,15,315,2,2,0.896038233,307,3,1,37,37,0,2162,2105,57,25,25,0,100
b8fca7e90f6216b6bfcb666b3e5175d60bcafa75,3,3,28,25,0,0,0,11,63,720,3,3,0.993099939,935,357,2,141,149,8,7195,7386,191,78,82,4,92.6764635
10a8311b9ef425fa841a3b520cec5420b92797c5,3,81,91,10,0,0,0,2,12,877,2,2,1.510847494,301,358,3,32,32,0,1977,2114,137,18,18,0,91.60104987
2027c15e0533edd8057899fa0da82345447e4b20,2,14,12,2,0,0,0,1,6,657,1,1,0.779349837,198,359,4,23,23,0,1394,1351,43,13,13,0,99.92972593
a00a66d6afdf1d23f24113aa28d3331f9e06e55b,1,5,3,2,0,0,0,5,10,4,1,1,0,129,1,0,19,18,1,820,812,8,11,11,0,100
802f00e192fad5416bfd548ce29a796afbee73ee,7,80,18,62,0,0,0,25,220,477,4,6,2.264786274,2372,360,4,409,401,8,17873,17505,368,186,181,5,100
eb1ea9feee179139cc7e8a9faed2be3159e722d3,2,66,9,57,0,0,0,5,16,34,1,2,0.665273523,267,4,2,43,30,13,2150,1815,335,31,25,6,99.98243765
fb062dd90146ad54c5ab4d6f459c05d20b7f0322,1,14,2,12,0,0,0,4,26,5,1,1,0,400,5,2,63,63,0,3352,3294,58,34,34,0,100
dd909fc2770684466d317e2b9764a229e6eae151,1,15,9,6,0,0,0,8,23,63,1,1,0,566,361,5,139,139,0,3970,3898,72,71,71,0,100
1f4ec88041856c5e92a3f6f2e27a2b180c8403e3,6,292,95,197,2,0,2,1,3,28,1,3,1.950812936,401,4,0,69,53,16,3249,2408,841,47,33,14,97.63839033
6fef0f72aa5e811a4f5f717def2bff65ab65fac4,1,17,1,16,0,0,0,2,4,1714,1,1,0,74,23,0,11,10,1,553,379,174,8,7,1,100
3ec14c966816634a3f058bd90fa507e1d5300898,1,1,1,0,0,0,0,8,14,943,1,1,0,105,0,0,3,3,0,965,965,0,1,1,0,100
1453c4dec30daddc2d86472a45faa659e01b9b20,0,0,0,0,0,0,0,0,0,0,0,0,0,0,10,0,0,0,0,0,0,0,0,0,0,100
8866b83ca0818595f627f3adf584ea21a19a8d2e,1,2,1,1,0,0,0,5,16,1053,1,1,0,311,24,1,30,30,0,2888,2866,22,15,15,0,100
0e62cbb80b2e2e788e25a798437b8683829219ac,1,1,1,0,0,0,0,9,14,671,1,1,0,170,2,1,22,22,0,1445,1449,4,12,12,0,100
9c369f3f53250685897dcfa9d01f94c9a906433e,1,1,1,0,0,0,0,9,24,816,1,1,0,133,0,0,24,24,0,777,779,2,11,11,0,100
87e2d96bbbc426ba33f68353961abd4cfb8518f8,2,14,1,13,0,0,0,3,18,1644,2,2,0.566509507,482,0,0,81,80,1,4126,3971,155,48,47,1,100
076b83cde9518f461a89978ce0f3d3ea46d8c030,2,9,1,8,0,0,0,5,23,148,1,1,0.881290899,371,6,3,58,57,1,2693,2653,40,32,32,0,100
2faf8721265ae2f9c3551c0d487ae50619e19ee0,1,9,5,4,0,0,0,4,27,18,1,1,0,412,7,4,64,63,1,3387,3352,35,34,34,0,100
a7555cfc143093aba76b4b148e890406b25241f5,6,42,6,36,0,0,0,11,35,562,2,5,2.472819715,1719,4,0,327,320,7,11908,11731,177,226,220,6,100
96b5c92cd24e2fc183865c2088690e72c7a3f1d7,0,0,0,0,0,0,0,0,0,0,0,0,0,0,362,5,0,0,0,0,0,0,0,0,0,100
f349fdf2488e254d0fa2eeb17bbaf44de2b0932d,2,33,0,33,0,0,0,5,17,332,1,2,0.884963636,244,8,4,39,34,5,1739,1500,239,30,26,4,88.39599675
478749ced9832aa389fe1c2349305102fc49e41b,3,32,21,11,0,0,0,2,44,664,1,1,1.382065748,1339,0,0,270,267,3,9980,9842,138,124,124,0,100
e7509ea246b114ba9684ec371d35991063092b2e,1,29,15,14,0,0,0,2,2,37,1,1,0,78,3,0,9,7,2,539,416,123,7,7,0,100
0d8e70bb7197df7a8f71611c774718a322b3e0ff,2,28,6,22,0,0,0,6,28,24,2,2,0.936667382,934,3,1,168,165,3,7283,7157,126,137,135,2,100
cea19a648b93124354e3c57729b3888a65253a7e,10,332,1,331,4,0,4,1,221,427,3,5,2.455559817,2907,5,0,573,540,33,23437,21680,1757,277,253,24,91.33264817
beb3e3ded54432ae23a80e35b5abb1e5d466b08e,2,13,10,3,0,0,0,5,33,546,1,1,0.886540893,332,9,3,44,44,0,2255,2215,40,31,31,0,94.24438289
3ef7f1d6ed675da073134a7ee86b9a476a27f73e,0,0,0,0,0,0,0,0,0,0,0,0,0,0,363,1,0,0,0,0,0,0,0,0,0,100
94db58b9fc5a855beba51fdd04e31f899ef96abc,3,53,7,46,0,0,0,1,222,27,2,3,1.312555988,2093,6,1,394,390,4,16188,15697,491,215,212,3,100
56a8e1730059fdc4e50544e85b09318851f1a492,13,203,29,174,2,0,2,1,223,275,4,8,3.131892115,3273,7,1,571,568,3,25593,25416,177,278,279,1,99.39854384
05cac191b8482168804a0e7a29144e744eb2aa8e,2,28,28,0,0,0,0,11,49,242,2,2,0.991703308,889,1,0,145,147,2,6488,6479,9,58,58,0,100
8f3b68449bd5626b9e864d3ff993e575be429256,1,15,1,14,0,0,0,5,17,120,1,1,0,223,10,0,34,30,4,1689,1605,84,19,18,1,100
3d06ad6bbae2f05dd259c2f86b15add3c441db59,3,22,0,22,0,0,0,6,35,458,1,2,1.544024096,563,8,2,83,80,3,4428,4267,161,44,42,2,99.87301587
74159d445ad5f5bf3113f1d850fa4ea6c1020811,0,0,0,0,0,0,0,0,0,0,0,0,0,0,0,0,0,0,0,0,0,0,0,0,0,100
805a495383d586d6141b2962250a8185e3021057,4,43,8,35,1,0,1,1,91,383,3,4,1.65949033,550,9,2,96,94,2,3969,3907,62,51,49,2,99.93642721
b57be797fe97c00abc0e3d7353d30e1b2961714d,8,85,8,77,2,0,2,1,35,533,3,6,2.662101475,678,10,3,80,76,4,4990,4733,257,40,40,0,99.84137056
b53c51d2d7510525b693aaff6a9f4afe1ced6602,1,1,0,1,0,0,0,10,25,122,1,1,0,133,25,0,25,24,1,779,777,2,11,11,0,100
f0190f57137a5caeffd28d4a5b265e37c74eac17,3,42,0,42,0,0,0,11,224,743,1,2,1.231724487,1955,11,4,340,335,5,15573,15194,379,144,140,4,100
e296b5632e523a8626310eb999cb33aeb22ddaa9,2,8,3,5,0,0,0,4,12,202,2,2,0.684038436,411,26,1,46,45,1,3494,3497,3,25,24,1,100
6e7faaefb653a73e2e7b970ce678ff41d31f8171,0,0,0,0,0,0,0,0,0,0,0,0,0,0,364,0,0,0,0,0,0,0,0,0,0,100
2368243cb0e2eef0fbad37ab3733bfa5bd54bad7,0,0,0,0,0,0,0,0,0,0,0,0,0,0,365,1,0,0,0,0,0,0,0,0,0,100
394b47313216f0892ca36a1b17d0081cb212bee1,2,191,0,191,2,0,2,1,1,0,1,2,0.999822034,0,12,5,16,0,16,765,0,765,14,0,14,95.29938444
7a066f9c8e55542b90a06746cb1c01ad4b998e36,1,10,0,10,0,0,0,5,29,104,1,1,0,425,11,1,67,65,2,3516,3453,63,35,34,1,100
8dc6493b0bd320834b87af4c7b362590a63ebdc0,5,66,16,50,0,0,0,1,92,28,3,4,2.046142382,651,13,5,109,105,4,4886,4468,418,61,59,2,97.36603088
f47997461e2faee04ec68b76cc49eaaf72017f38,10,83,37,46,0,0,0,2,30,827,5,6,2.840969402,1961,366,2,291,284,7,14881,14715,166,189,183,6,89.31765909
0026645c40655ff7760d8c4ed81437bdca3f1d31,0,0,0,0,0,0,0,0,0,0,0,0,0,0,367,3,0,0,0,0,0,0,0,0,0,100
96e73841f2004edc359893148df4aa027af5d01d,6,107,40,67,1,0,1,4,50,129,4,4,1.853764294,1857,368,4,381,373,8,13374,13112,262,171,165,6,89.98068566
7776209f0bf3ad541105dcf57792fc14af79221c,0,0,0,0,0,0,0,0,0,0,0,0,0,0,369,5,0,0,0,0,0,0,0,0,0,100
b07ee7219d75b0ae57463fd703eef494b1eb1beb,8,1,619,618,0,0,0,2,16,454,4,6,1.52388425,1174,370,6,77,172,95,5076,8363,3287,54,99,45,96.67882511
51bfa17f598c57aa5a0cc6839cb3b7e12e01d18d,4,111,6,105,1,0,1,11,225,27,2,3,1.461762314,2391,14,3,426,412,14,19351,18763,588,196,186,10,99.96113486
29dbfb9468cd28e72d3872cf374ca6297c9fa52f,4,199,56,143,0,0,0,18,226,23,3,3,1.938063893,2639,371,7,516,498,18,20627,19750,877,293,279,14,99.90300679
6fb2e547ff0d08be41de49a269ae3dd4c47c8149,87,0,9495,9495,0,0,0,3,27,2095,3,19,5.799837532,6875,372,8,16,946,930,815,47547,46732,6,516,510,88.56856355
d41d0930c49c4cfcd8cd709519329e22fbbe61b4,17,209,27,182,2,0,2,9,227,41,5,11,3.525964792,4729,15,2,787,770,17,36980,36105,875,373,364,9,98.01097394
c681cdab4a181748c811ec62e92f05355d7a1d40,5,153,1,152,1,0,1,2,228,383,2,3,1.30088663,2525,16,1,479,462,17,19914,18918,996,217,202,15,99.93373095
c2376fd4dc3c75cd60d5460940e04f3410499398,4,16,19,3,0,0,0,2,229,323,2,3,1.637315866,2311,17,2,405,404,1,17826,17862,36,163,164,1,100
075cae92207335b62f3f8df3c57deed78c3980a8,3,90,4,86,1,0,1,5,44,373,1,2,1.502960762,319,12,0,50,40,10,2868,2332,536,39,32,7,99.86759351
ffee9d0f438030b3711b67ffee330720315ff226,3,12,4,8,0,0,0,2,18,549,2,3,1.298794941,299,13,1,44,42,2,1855,1780,75,32,31,1,98.01488834
a838ac4bfc1076f54d4a5aa639b0e77259266b4e,4,102,9,93,0,0,0,4,12,1211,2,2,1.630296593,386,18,2,104,86,18,2550,2093,457,59,45,14,100
3ff0fa101bd44ac56e41478ca106e2a9bc642c3a,4,13,106,93,0,0,0,4,13,0,2,2,1.603526721,443,373,0,86,104,18,2093,2550,457,45,59,14,100
cf7795eccfc0fb7db348a74e2467e5824d9c4318,4,102,9,93,0,0,0,4,14,0,2,2,1.630296593,386,19,3,104,86,18,2550,2093,457,59,45,14,100
069f9d89879bb03636d31bbdad924ffa4578194e,12,584,195,389,6,0,6,1,4,68,1,3,3.36498804,625,20,4,102,76,26,5147,3612,1535,73,47,26,85.27633851
0e822bb8c03e5945bd02e9b1c5d072657c89a516,1,9,159,150,0,0,0,6,12,1344,1,1,0,820,374,1,189,204,15,5094,5790,696,68,74,6,100
d58146078389fed9c914a113ee0e85197d4e8b1e,5,175,82,93,2,0,2,1,5,660,1,5,2.053693041,129,21,5,18,9,9,1507,1016,491,14,6,8,99.50248756
507121c0bbb2702074cb6099d2a625990443ca95,2,6,6,0,0,0,0,27,230,41,2,2,0.918295834,1879,0,0,365,365,0,14188,14188,0,147,147,0,100
c37cc56c6895762efcf643cd5b17d7a8c811f201,3,92,2,90,1,0,1,1,2,4,1,2,0.543281489,89,22,6,16,8,8,784,424,360,14,7,7,85.80060423
ab82638e785d664792c82efe125c2b81b4424d64,2,28,8,20,0,0,0,12,36,160,2,2,0.88797632,1173,0,0,230,227,3,8493,8358,135,171,169,2,100
1f2e83001b82b9560e6a45c107fa9fa5854e0f73,1,1,0,1,0,0,0,5,45,24,1,1,0,238,14,2,28,28,0,1906,1891,15,19,19,0,100
e767c1532a690138f5b7559ffd6b9e08f65eedf9,3,180,11,169,1,0,1,5,46,36,1,2,1.061147772,665,15,3,113,94,19,6268,5363,905,72,54,18,99.9238965
51d3aefaf72560cf0e8b57d721139bc2f2db8fe1,2,274,35,239,1,0,1,4,4,536,2,2,0.874461426,64,375,2,49,11,38,1517,320,1197,43,11,32,99.47009841
a6c75898d2c45ad971e69b7233bb89118fa1eb49,9,51,15,36,0,0,0,5,67,564,3,6,2.943463873,2007,23,6,389,383,6,15242,14942,300,217,213,4,100
a4ffad20dfcc3f61d723e835db9aac075286deb3,0,0,0,0,0,0,0,0,0,0,0,0,0,0,24,6,0,0,0,0,0,0,0,0,0,100
cbf31291ba113a8ea437a5c92c6987fa14b9604d,1,2,1,1,0,0,0,14,46,229,1,1,0,267,4,0,50,50,0,1807,1807,0,18,18,0,100
f163cd3c7436cf085eee6190965ee04f32d09f0b,7,163,31,132,0,0,0,5,47,261,3,6,2.403859505,1171,376,2,197,172,25,9229,8344,885,130,117,13,99.0512334
96db7f6801738c1c1036f205d925be02e219426c,4,70,22,48,0,0,0,13,37,928,2,2,1.789412306,1397,0,0,268,259,9,9954,9717,237,193,188,5,100
26582bf4de6ce9cd2e61e69a1c235298f4635fe7,1,137,26,111,0,0,0,5,19,18,1,1,0,240,16,0,54,35,19,2522,1773,749,27,19,8,92.67648169
da5d86892b20039c0d514686d834cc4298e6f4cd,13,515,78,437,3,0,3,1,95,376,5,9,2.716862908,1599,377,1,309,270,39,13863,11082,2781,188,157,31,93.80780056
c8463634bd635e3b2bf78206a7e45892bb6ec20c,1,9,11,2,0,0,0,14,47,29,1,1,0,268,378,2,50,50,0,1786,1807,21,18,18,0,100
e07bd375c277e51c61ad6c7a4a12d03c8325e76d,6,145,96,49,0,0,0,4,89,243,3,3,2.150157345,1685,25,0,358,342,16,12453,11909,544,184,186,2,90.94405594
6742a4eff7430d41807dcdecb7d0254142ccb974,4,273,4,269,2,0,2,1,32,152,4,4,1.581249257,595,379,2,115,96,19,5619,4694,925,68,61,7,99.85435479
77f21ae82879120afdb1638a9cd0f3679ccbede1,3,36,10,26,0,0,0,27,231,98,1,1,1.191603637,2571,26,1,499,491,8,19616,19402,214,212,211,1,100
a81dd18884a5963c6d6c667da07a77a3d517378f,5,131,62,69,1,0,1,8,16,1338,2,3,2.061171289,406,380,3,72,66,6,3010,2760,250,34,32,2,90.68078669
0dcd2c1822e42cc20832730575ca0916ac1dea16,2,347,280,67,1,0,1,1,232,1,1,1,0.995942929,1559,381,4,301,296,5,12362,11897,465,114,110,4,90.90608466
79222481b53302041a6e6417739f5c91e7119a1a,0,0,0,0,0,0,0,0,0,0,0,0,0,0,382,5,0,0,0,0,0,0,0,0,0,100
aaab9f037eba05ed2bb6c63c2e9444c77e416706,0,0,0,0,0,0,0,0,0,0,0,0,0,0,0,0,0,0,0,0,0,0,0,0,0,100
7167fafe75f8c50798561a135405caa984edc7e3,2,59,55,4,0,0,0,2,90,25,1,1,0.127418512,653,2,0,111,111,0,4868,4851,17,50,50,0,100
33a54ea8a2cc94a8fb9bbfdbb753e41dfc2ee41a,4,21,585,564,0,0,0,3,34,841,3,4,0.165112007,1721,383,3,204,298,94,10608,13306,2698,103,131,28,100
993dfa354c8ce2338af537ab043cc6ec86063fcd,5,194,9,185,3,0,3,1,3,194,2,4,1.811810988,156,27,0,32,21,11,2011,998,1013,18,10,8,92.26248776
6571b8db1419b71ddcdca80a5d6e7e79aff75c97,2,154,0,154,2,0,2,1,1,0,1,2,0.655023991,0,28,1,7,0,7,1112,0,1112,3,0,3,92.29268293
4906c8b296aa8cc9a67c0736ff48a038de1a0393,4,35,13,22,0,0,0,5,48,620,2,2,1.685704868,755,384,0,133,132,1,5500,5373,127,76,75,1,99.82764564
0838be8e6715f59bd86967c53902fc1abb6bbd11,3,11,4,7,0,0,0,10,39,406,2,3,1.370950594,890,385,1,169,166,3,5947,5894,53,99,98,1,100
bdad083683e281b68b386d30be0b82fd529f913f,3,16,6,10,0,0,0,13,61,550,2,3,1.528504079,1415,0,0,269,268,1,10620,10539,81,156,155,1,100
afc7334a2342e36a0c14f58d5f1775fb3e400e66,0,0,0,0,0,0,0,0,0,0,0,0,0,0,27,0,0,0,0,0,0,0,0,0,0,100
48c93005806bd452aac84ea15ab88c92656b8484,0,0,0,0,0,0,0,0,0,0,0,0,0,0,29,2,0,0,0,0,0,0,0,0,0,100
dddb3fdaf93f5addc46a3a1fd2d4f4910a7e1b3e,0,0,0,0,0,0,0,0,0,0,0,0,0,0,28,1,0,0,0,0,0,0,0,0,0,100
9395b12cb3dedc78991c5f8a261430996c058047,0,0,0,0,0,0,0,0,0,0,0,0,0,0,29,2,0,0,0,0,0,0,0,0,0,100
a0a812d11b72fae8201404b298f318bfcecb6ba1,2,12,0,12,0,0,0,27,233,186,2,2,0.979868757,1387,1,0,271,270,1,10432,10398,34,112,111,1,100
29ebff2c7406c22791d80fdb372afd04e1b631e5,2,25,19,6,0,0,0,3,234,63,1,1,0.875663392,1623,30,3,302,302,0,12422,12395,27,115,115,0,100
a9c63015503c2785f56e138453ccab1b074c62e7,9,389,56,333,5,0,5,1,2,63,2,3,2.855384009,350,30,1,41,27,14,4922,2842,2080,31,21,10,99.51939581
ff1a989130956c2baf18fff4db45d64a73c42337,0,0,0,0,0,0,0,0,0,0,0,0,0,0,31,4,0,0,0,0,0,0,0,0,0,100
fc61c29ed5e64d8f1e44455aa965c827fc73c96c,0,0,0,0,0,0,0,0,0,0,0,0,0,0,31,2,0,0,0,0,0,0,0,0,0,100
9518fa5f8d29e6e895281398f948f410c03aa021,0,0,0,0,0,0,0,0,0,0,0,0,0,0,32,5,0,0,0,0,0,0,0,0,0,100
afd33f77c5e080022ff86725f66c66ae4d9e8d06,4,38,23,15,0,0,0,8,96,936,2,3,0.950369305,1333,386,0,185,184,1,11576,11404,172,93,92,1,100
decad693db2b0238efed72e53c511cbc83bc9aa0,0,0,0,0,0,0,0,0,0,0,0,0,0,0,387,0,0,0,0,0,0,0,0,0,0,100
ec82b04df5a997fda14adfaf4f1a6548ad9a0081,5,65,9,56,1,0,1,4,6,1663,2,3,1.412081022,258,0,0,37,33,4,1970,1712,258,30,29,1,99.86334131
3c4e6f15521d6c0219956225c78154967856adab,3,205,5,200,2,0,2,1,15,75,2,3,0.799698887,143,0,0,34,17,17,2100,949,1151,8,3,5,99.82964225
4879f1b677b5bcaf802f6349dc463c0334b197e1,5,174,10,164,0,0,0,11,235,226,3,4,1.428947716,2657,3,0,496,478,18,20980,19906,1074,208,201,7,100
aa777961a4c9eab5537bf0dfdc7ba81f06307233,0,0,0,0,0,0,0,0,0,0,0,0,0,0,32,0,0,0,0,0,0,0,0,0,0,100
c1032750ae2d28b7504a2a9f6b917e290927b576,7,39,24,15,0,0,0,7,37,1198,4,5,2.111731088,1890,388,1,311,311,0,14501,14522,21,156,156,0,100
995dce9fe3cfb3c43b6646efba7204d8ef8ace24,7,167,18,149,1,0,1,6,91,807,3,4,2.156467198,1090,33,1,162,146,16,9075,8305,770,95,86,9,99.93201903
75af736d0d20c44b5d47a458b0c7b33387a75a6d,7,69,50,19,0,0,0,5,97,704,2,3,2.316573897,1261,389,2,195,193,2,9092,9004,88,117,114,3,97.44755245
9e2217b7f0ee7b76c5c2a3d0cf2bf50c0caf902a,6,17,14,3,0,0,0,2,47,963,2,2,2.234247591,1157,390,1,155,156,1,8790,8798,8,101,102,1,100
461b97441e40f1f2e4f071ce706a2d4704036bc4,1,14,3,11,0,0,0,12,53,635,1,1,0,146,4,0,21,17,4,999,970,29,13,12,1,100
6f2c532a8d4a1612a3331f9ec1559b63954ce13f,1,3,3,0,0,0,0,3,3,1155,1,1,0,187,5,0,32,32,0,1022,1019,3,15,15,0,100
bd83e7d7fd41540c8bda6bd92a52ac99ccec2076,1,4,0,4,0,0,0,9,25,123,1,1,0,245,6,1,40,39,1,1869,1859,10,21,21,0,100
db3623a22e39a7957d9985fc9fe6784fe977f070,3,31,13,18,0,0,0,1,16,609,1,2,1.548810267,346,1,0,40,39,1,2626,2472,154,12,12,0,100
14e114ca1ff357f5516f6c7f9f453470498e0ae8,3,48,25,23,0,0,0,5,49,674,2,2,0.538596444,756,391,2,112,107,5,6218,6063,155,70,66,4,99.56803456
494aa253eb6dc93573b41761900d52cecee6b171,2,6,0,6,0,0,0,15,45,339,2,2,0.650022422,516,34,0,109,108,1,3716,3688,28,59,58,1,100
aeec3096bc11cfcacfe1bbcc208cf4d61f648644,10,212,42,170,0,0,0,11,236,414,3,5,2.553206024,4582,35,1,874,851,23,36638,35642,996,427,412,15,100
ec01dac548279b9c938dc5e2b7949b6cec29d306,0,0,0,0,0,0,0,0,0,0,0,0,0,0,36,2,0,0,0,0,0,0,0,0,0,100
c320f93c5a510f07933536e28e507ef9c3ba3531,2,32,11,21,0,0,0,5,37,230,2,2,0.910348062,976,392,2,173,169,4,7691,7533,158,102,101,1,100
49a591f515996b84f66e5e09dcbed87321560208,1,22,14,8,0,0,0,9,24,649,1,1,0,572,5,1,139,139,0,4022,3970,52,71,71,0,100
daaa0f448d280ff10f98ecee6fbdda27cedaae50,35,51,72,21,0,0,0,12,237,1010,5,17,4.635823555,8127,37,3,1233,1233,0,61417,61224,193,642,642,0,100
54ae6e97757a3a07a324f2541e97e7d1c35144a6,3,30,2,28,0,0,0,6,50,117,1,2,1.208538233,720,0,0,98,90,8,5657,5449,208,67,63,4,100
53a3eaa9618f7323ccac3864a9bc86cdec883762,13,154,82,72,0,0,0,6,238,346,4,6,2.787018259,3763,393,3,627,613,14,28890,28467,423,313,305,8,100
85ca5680c1548a9b0cefb0cc48859b296131a187,7,139,19,120,1,0,1,2,71,89,3,6,1.656208896,1629,0,0,268,257,11,14163,13442,721,149,143,6,99.92816092
d674f988dfbe618aadc35e3b7e860e94670a15b1,1,1,1,0,0,0,0,6,8,13,1,1,0,61,0,0,3,3,0,383,383,0,3,3,0,100
ca6c0819e8a491453fab87c849d8d75e9c687e1b,0,0,0,0,0,0,0,0,0,0,0,0,0,0,394,3,0,0,0,0,0,0,0,0,0,100
3955dfedb085f0f71f7c0b039bba51f4772be23d,1,15,8,7,0,0,0,5,21,360,1,1,0,340,17,0,57,54,3,2602,2558,44,27,27,0,100
43d0275ac9515924468c24e528d4226dc7b79190,11,80,25,55,0,0,0,3,239,517,3,5,2.849734337,4277,0,0,820,811,9,32183,31779,404,399,397,2,100
f0146f8f0ab192c96079dfbb2fdbee7e7488c361,10,115,32,83,0,0,0,6,240,97,4,7,2.479149233,5122,7,0,895,880,15,41084,40409,675,450,441,9,100
6d2580f69fdefa87e23f633e0f3a2c8fbc6a1d68,8,147,6,141,1,0,1,19,241,329,3,6,2.59716421,3156,38,2,589,571,18,25327,24449,878,254,245,9,99.74901398
a69f3fb9aca07264274f46d2b4986188b3f0fb1a,1,4,2,2,0,0,0,3,4,1534,1,1,0,110,0,0,12,12,0,658,653,5,5,5,0,100
b8f050eab1d8a1922f158a6142f86c10f395e79a,2,2,1,1,0,0,0,30,242,10,1,1,0.918295834,2293,1,1,452,451,1,17673,17657,16,198,198,0,100
8d5c50e0082f8c21b79c44791b4186ed6d9c602c,1,10,4,6,0,0,0,19,74,4,1,1,0,586,8,1,74,73,1,5212,5145,67,28,28,0,100
bc190b3038d1f4ce156f1a0d8b3f1f0ff236d22d,1,66,64,2,0,0,0,9,29,183,1,1,0,360,9,2,29,29,0,3686,3680,6,12,12,0,100
e52710a6c7b36a3b4a481269dd1077f00b77b7a5,3,12,5,7,0,0,0,7,53,23,3,3,1.332820405,1050,0,0,175,173,2,7869,7827,42,81,80,1,100
09d55fc5293a2cbce9f0c841993075c45bd05a09,15,193,44,149,0,0,0,5,243,673,3,8,3.32361231,4575,10,3,747,721,26,36655,35761,894,356,340,16,97.0521542
f66530cde1449d5a2cc3d20633263e5f1109cf94,5,22,14,8,0,0,0,11,244,39,3,4,2.125767785,2864,6,0,515,515,0,21744,21663,81,215,215,0,100
77b7a7b9cf6ccce080e950f849c328d698b0e008,0,0,0,0,0,0,0,0,0,0,0,0,0,0,1,1,0,0,0,0,0,0,0,0,0,100
f773ac4f0dfe477befd86b2ef2a9606f4301996a,1,8,5,3,0,0,0,5,6,1736,1,1,0,208,2,2,39,39,0,1077,1063,14,18,18,0,100
bc37ab504c2c429f3a858a4e847dee969455f1d5,2,31,8,23,0,0,0,7,22,196,2,2,0.995727452,578,0,0,118,116,2,4386,4224,162,81,78,3,100
7e695606aefa3c5d3c7741d1128db24ecfba9502,7,94,49,45,0,0,0,2,22,951,5,6,1.702042829,1133,39,1,188,181,7,8732,8248,484,123,116,7,100
4157bba768aca3d177fa114663893b41b1fea8a6,2,18,1,17,0,0,0,3,15,336,2,2,0.998000884,946,2,0,190,187,3,6756,6641,115,157,155,2,100
593e1756d8d1fc005482eda443915bffa7d6084f,2,18,9,9,0,0,0,7,23,4,2,2,0.876716289,597,395,1,120,118,2,4464,4386,78,82,81,1,100
d3a0f9491f17462555c8fe522cbdc2ea4c88ef3b,3,124,0,124,0,0,0,1,32,204,1,2,1.057853768,1237,40,2,194,186,8,11775,10557,1218,122,115,7,100
95243a7ac501567d5c76dfaadf59b69a4a28fa03,0,0,0,0,0,0,0,0,0,0,0,0,0,0,3,3,0,0,0,0,0,0,0,0,0,100
3db8f9eac82efedd51322a0d213300c9a0940bb6,1,1,1,0,0,0,0,6,16,103,1,1,0,157,0,0,23,23,0,1059,1059,0,13,13,0,100
d9aa480c53a69141aeb5bb7f3279ed843c12f322,2,55,17,38,0,0,0,7,17,818,1,1,0.710676854,473,396,1,111,106,5,3585,3373,212,56,49,7,100
34867f25afc1329d722253e94e008f7616b9eb39,13,183,38,145,2,0,2,3,98,695,6,7,2.352185268,2637,397,2,469,457,12,19652,18998,654,253,243,10,97.25540846
9bbb4401b832a69035bf0b186bb9525bf6aadeb9,3,11,3,8,0,0,0,12,245,61,1,2,1.492614068,2365,33,0,409,409,0,18441,18408,33,182,182,0,100
485c7eccd036ea9afb3750ba77ab325bc76b0037,2,53,11,42,0,0,0,13,22,47,1,2,0.997180399,495,3,0,96,87,9,3763,3438,325,73,66,7,100
1009a6c385373b3280cc9066e02ce050911627f8,7,271,184,87,1,0,1,11,29,835,2,6,2.017109884,535,398,2,86,67,19,4324,3773,551,56,46,10,98.33163092
38a01cdc39b32e69c6c89c8423904842bf7d3cb8,12,93,75,18,0,0,0,13,246,592,3,6,3.056522967,5302,1,0,955,957,2,40597,40507,90,476,475,1,100
92088ff621ca44f29818b1df71e232284602a88e,0,0,0,0,0,0,0,0,0,0,0,0,0,0,1,0,0,0,0,0,0,0,0,0,0,100
5dd3c1db093bb06e462afbd0df4b8b215bbd8bf3,5,120,9,111,1,0,1,4,57,603,4,4,1.893343657,910,399,3,205,196,9,6409,6006,403,80,76,4,99.83697424
8b69f748e1d5495c7f860c790323f65cd9594ce0,0,0,0,0,0,0,0,0,0,0,0,0,0,0,2,1,0,0,0,0,0,0,0,0,0,100
fafca0a287b28fd27eced7371afd5bfad5bd06fe,11,178,31,147,0,0,0,14,62,539,3,6,2.712891745,3381,11,0,520,500,20,26386,25062,1324,338,329,9,100
ef23b839b31fb24bc0f74156a6414f69f2b73a2c,2,4,33,29,0,0,0,10,55,0,1,2,0.571354974,336,400,4,38,42,4,2081,2384,303,16,17,1,98.57408555
713aa38fe2c996f7961d8f8c03e13db898927e9b,2,45,0,45,1,0,1,1,11,49,2,2,0.15374218,77,3,2,20,18,2,644,453,191,13,11,2,98.6935867
323bd1017afdbe03f70cccb172412e6fab221797,1,36,15,21,0,0,0,7,13,82,1,1,0,149,401,5,34,34,0,958,1001,43,30,30,0,100
e5ee38ab0d38f5e785880a504d39c671c1b4d533,3,97,7,90,1,0,1,1,31,1114,3,3,1.531499507,312,402,6,65,57,8,2476,2076,400,42,36,6,97.15945771
971e547acb6e5c623bb0e60cc243a77eb75c64c6,1,18,6,12,0,0,0,2,3,141,1,1,0,129,34,1,17,16,1,1120,1062,58,6,5,1,98.47138287
e49687aba20cad70c576900f1be59bb8fcd55d10,4,66,5,61,0,0,0,23,247,34,3,3,1.517063686,2831,4,1,565,555,10,21751,21313,438,328,319,9,100
3568b8673521a585f5f6fa1918aa787b268ed9f6,0,0,0,0,0,0,0,0,0,0,0,0,0,0,41,0,0,0,0,0,0,0,0,0,0,100
07d6065cd8aa65a0fb09036da871aaef6175603e,0,0,0,0,0,0,0,0,0,0,0,0,0,0,42,1,0,0,0,0,0,0,0,0,0,100
8267e87ac42bb32323555e18db1a11dd6d930a6b,1,8,2,6,0,0,0,8,17,457,1,1,0,146,5,1,22,21,1,952,908,44,14,14,0,100
d205e8264ce73578c78ed5d5a78e4255d274492a,0,0,0,0,0,0,0,0,0,0,0,0,0,0,43,2,0,0,0,0,0,0,0,0,0,100
ebb39e840e6d13245f76a044c1d60bafc7ca44cf,21,381,174,207,1,0,1,1,248,307,5,9,3.184287435,5881,403,3,1017,986,31,45153,44128,1025,518,501,17,99.60531037
3e77a112ac59deb498403999a04bb8f9232e6da4,0,0,0,0,0,0,0,0,0,0,0,0,0,0,35,1,0,0,0,0,0,0,0,0,0,100
48da6bdca48dfe666506bc0cb8ecf8661166ce4a,1,25,0,25,0,0,0,9,12,115,1,1,0,139,36,2,25,21,4,881,742,139,23,19,4,100
0c647c60b353d4b33d1c79ce127bbbb9802b206b,21,156,137,19,1,0,1,5,67,208,4,12,3.911551493,3515,404,4,453,452,1,28122,27835,287,276,275,1,99.82091691
6a7ac63e9deadc76214f5099e5766be362637cf7,21,139,158,19,0,0,0,5,68,0,4,12,3.899218273,3588,405,5,452,453,1,27835,28122,287,275,276,1,99.82091691
eaf9541af05af06e9e0077572c8544c4485b1503,4,36,3,33,0,0,0,5,58,62,3,2,1.298334394,1068,6,2,232,225,7,7335,7199,136,95,91,4,100
62edc69ebc46d7ac2871fb815c2f86ab4c3e933f,1,6,6,0,0,0,0,18,74,3,1,1,0,548,37,3,101,101,0,4171,4171,0,62,62,0,100
f65a7b65cb64c332d9356eb013976db44077b38f,6,200,0,200,0,0,0,5,97,124,3,3,1.39863425,2166,7,3,481,443,38,16667,15408,1259,218,204,14,96.03509912
74905dfdb942a722caf32f78c2f5afedf9cc8095,3,11,4,7,0,0,0,9,30,14,3,3,1.399581231,534,406,5,59,58,1,4231,4163,68,49,48,1,100
da4f01e6ad4773246a509d8633efa4b151e686eb,22,167,154,13,1,0,1,5,69,3,4,12,4.000498531,4098,407,6,592,591,1,32121,31896,225,347,346,1,99.85145573
e0333b48c0ee14353db9645177bd941d2e782d4c,10,187,65,122,1,0,1,4,53,141,4,8,2.554901131,1195,408,5,144,132,12,10098,9710,388,113,102,11,99.43266647
06846f09209e978348299d3814e61ae93566b8b0,1,14,14,0,0,0,0,14,49,180,1,1,0,265,409,6,49,50,1,1839,1794,45,17,18,1,100
117b333114daf37e3d7a31919e49f8fdc0d9e201,12,504,35,469,3,0,3,1,249,12,5,7,2.354675724,4650,8,3,983,936,47,36623,34094,2529,505,474,31,96.97953881
874475e8fca5d4ea7b07f2f2c7b7fb3cb4caae5b,30,261,228,33,2,0,2,14,250,262,6,18,4.442945291,7958,410,6,1252,1254,2,61169,60952,217,654,655,1,96.78559949
df18d0b03e49575b97745dbf4b759cc4022bd562,2,20,0,20,0,0,0,11,37,401,1,2,0.721928095,600,44,0,69,66,3,5489,5288,201,33,31,2,100
1f13165a64291f983c52447ae8a045c952808e36,3,50,0,50,0,0,0,11,38,108,1,2,0.794309555,880,45,1,152,146,6,7562,7152,410,78,72,6,100
ab9fc535dc6f48ba1d93687fc46022989beb6b0a,15,286,26,260,0,0,0,1,251,434,5,9,2.946729437,4733,9,2,845,817,28,36469,34693,1776,497,477,20,99.05795033
b7b87340b9ef5197fd751dd1a5dd1f9b68b8ffab,10,125,159,34,1,0,1,9,23,403,3,5,2.67609576,716,411,5,69,69,0,5047,5255,208,55,51,4,99.66777409
93f2f748a9a2fa08011f469af43428ceb00bbf96,8,28,35,7,0,0,0,15,63,53,2,3,2.549407431,2537,10,2,355,355,0,19300,19421,121,198,198,0,100
a04bf69cacec68e81c39a4f5db92e9eb73dd0cb7,12,54,26,28,0,0,0,16,64,908,2,6,2.769329514,3566,0,0,676,674,2,26309,25986,323,358,356,2,100
8fbe434efad64436e5505f5a03a4ef048a425a0a,16,260,168,92,0,0,0,15,40,471,5,10,3.344262713,2489,412,4,297,289,8,21390,20490,900,228,219,9,96.47930821
9230867d19953583b817c7b56ccd4a933fb3835a,5,191,161,30,1,0,1,1,38,21,2,3,1.541265078,2104,11,2,397,396,1,15937,15861,76,269,267,2,99.93021633
31eff226ded5a0d8d1d64a50661a6c6260da84ef,11,60,21,39,0,0,0,8,252,22,3,5,3.118222961,4935,1,1,945,940,5,37303,37095,208,466,462,4,100
ee8a99641b0861d4bf0a31d37a59a0f8a0d0af89,19,36,28,8,0,0,0,1,1,0,3,5,1.605167615,1010,413,3,136,209,73,6517,19152,12635,104,133,29,97.29636049
89853ea72bf8357d1a6983b8b52419d0ec6ccf1e,1,12,9,3,0,0,0,33,253,3,1,1,0,1504,7,0,294,293,1,11503,11489,14,117,117,0,100
c4448bfb3ec2032475cc105a19caa60c4d244632,11,821,7,814,10,0,10,1,2,1,2,3,3.179574921,42,414,3,85,2,83,3782,190,3592,71,2,69,98.86519945
16ba152c7e45a0c3b3c96e3d400837408c69e921,3,23,2,21,0,0,0,10,62,47,2,2,1.182966195,1417,12,1,293,291,2,10233,10040,193,202,200,2,100
3bc72c6f383b723f545c52c25e3ea2ea5be0aac1,1,5,1,4,0,0,0,2,3,755,1,1,0,92,1,0,9,9,0,476,474,2,7,7,0,100
289db3ae64e8cf620eba882468dda661af0439bc,9,87,41,46,0,0,0,4,36,1241,3,6,3.051769919,906,0,0,112,108,4,6508,6207,301,76,72,4,100
79e6378ed1f65a2e508b8136f8e8c421062c5482,0,0,0,0,0,0,0,0,0,0,0,0,0,0,415,2,0,0,0,0,0,0,0,0,0,100
9df2c89335cc94858e9e5395e2ac955b631cb36e,9,125,83,42,1,0,1,1,26,316,3,4,2.004318241,808,416,2,93,91,2,5763,5519,244,60,58,2,99.69167523
af9b214ab1e63e1a755c900dce3fd2524510cea9,0,0,0,0,0,0,0,0,0,0,0,0,0,0,417,3,0,0,0,0,0,0,0,0,0,100
84a2997df4917f127217387fbb81dfa63db1c035,0,0,0,0,0,0,0,0,0,0,0,0,0,0,38,0,0,0,0,0,0,0,0,0,0,100
99d8add2bb0caf953b2b5d3c8468c69edf0651c0,7,172,11,161,1,0,1,2,254,41,3,5,2.361351192,3605,13,1,668,659,9,28981,27740,1241,317,310,7,98.7473904
99eee5a56d7aee4cd60a5b383e23ae8da2b9904a,1,0,2,2,0,0,0,10,14,90,1,1,0,243,0,0,30,30,0,1575,1593,18,18,18,0,100
2a3482ed1c90c2332faa852883c168f2608da1ad,12,217,54,163,0,0,0,1,20,1965,3,5,2.623533785,1367,418,3,198,174,24,11001,9871,1130,122,106,16,93.52543579
2753f3d6207a88f5a5f193a28371286db4e8b398,3,26,8,18,0,0,0,15,45,87,1,1,1.340406214,851,14,2,158,155,3,5939,5759,180,78,76,2,100
bd5b4e7b33fb1775bfb2baf39530c50b5e05fe84,1,0,2,2,0,0,0,7,37,29,1,1,0,435,1,1,62,62,0,3509,3527,18,35,35,0,100
b5921bcbfa2df9e8d69ffe397f6f1ce541fcead1,0,0,0,0,0,0,0,0,0,0,0,0,0,0,39,1,0,0,0,0,0,0,0,0,0,100
77a990651d16d0857665281d777983085e180575,32,121,112,9,0,0,0,5,55,855,3,12,2.855551204,5862,419,4,544,543,1,49821,49694,127,308,308,0,93.44370861
cf0dce981cb3dccb0501e7648f348b6f8634c1f2,15,141,43,98,0,0,0,2,38,449,4,9,3.147219819,1946,420,5,268,252,16,14496,13854,642,163,154,9,99.13766554
75a1071a3c62a5a1a09c356cc1cdf281cc506baf,0,0,0,0,0,0,0,0,0,0,0,0,0,0,11,0,0,0,0,0,0,0,0,0,0,100
7c104be47d2a94af856c1215a69d58f6831fec71,1,2,2,0,0,0,0,8,21,227,1,1,0,236,15,2,50,50,0,1657,1657,0,46,46,0,100
b8117f41481f5f5861566a68bb1ea4dc7c60320c,8,106,68,38,0,0,0,1,20,1120,3,5,2.755054853,1176,421,3,177,171,6,8357,8006,351,107,105,2,97.53274444
4a2a34c7b1c2657ef178c1e137ad114dc2f18ff2,44,180,232,52,0,0,0,3,77,401,4,11,5.06271344,8576,422,3,787,792,5,72907,73192,285,446,454,8,99.87929994
e87e16dd25865239edf8e50478539357b779519f,0,0,0,0,0,0,0,0,0,0,0,0,0,0,2,0,0,0,0,0,0,0,0,0,0,100
a221c2ed56d4c3799a7ddc8d8c52617974f716f6,1,13,22,9,0,0,0,10,27,185,1,1,0,581,423,3,139,139,0,3992,4029,37,72,71,1,100
c1e124d05ee2a5b392721a5fb7b7b0339073a949,5,30,24,6,0,0,0,2,255,514,4,5,1.866661868,3167,16,1,571,570,1,24543,24484,59,321,320,1,100
3e68daa5adfd293403df34233a71e27e3605ecda,1,4,2,2,0,0,0,5,9,831,1,1,0,11,424,2,1,0,1,97,84,13,1,0,1,100
88d83e278ffc45e08b64421435d5ba90af4ed3ac,0,0,0,0,0,0,0,0,0,0,0,0,0,0,17,1,0,0,0,0,0,0,0,0,0,100
8f1a99d7c591e24050bddf7113af7cbcd70d255b,0,0,0,0,0,0,0,0,0,0,0,0,0,0,46,0,0,0,0,0,0,0,0,0,0,100
5912ce555904168ee87d7553e40c522031f96702,5,77,0,77,0,0,0,2,3,139,3,5,2.087110125,280,0,0,40,35,5,2142,1646,496,32,27,5,99.96982498
28e1ea6c9ab8da4b2977a17df0423b3329945640,7,326,152,174,0,0,0,3,99,506,2,5,1.324753945,1032,18,2,173,152,21,8356,7059,1297,83,72,11,100
918c8d81ea25bd31cc96374feb26e90cb57d0f61,1,5,5,0,0,0,0,15,46,101,1,1,0,607,425,1,120,120,0,4288,4288,0,56,56,0,100
f2447cfe0b94ad5f9e72dff1623fa90b6f42f4f5,3,116,39,77,0,0,0,15,43,731,2,3,0.944842754,710,426,2,84,74,10,6356,6010,346,48,42,6,100
9724a24af8d5a982526d3925cbc6409828112ee9,2,7,2,5,0,0,0,2,2,161,2,2,0.99107606,254,0,0,44,44,0,1688,1618,70,38,38,0,100
729d3dce220f352a720cbe38d0762399b6e55f06,10,373,103,270,1,0,1,1,38,591,4,7,2.64922868,1730,12,0,296,261,35,14540,12776,1764,182,163,19,99.66877447
499a79375a58bb37718abe2176f8df279b66d521,3,62,16,46,0,0,0,7,19,164,3,3,1.419471496,570,2,0,77,74,3,4362,4126,236,42,41,1,100
96b2f267e81959d345725a5dc840725b32fd1b2b,0,0,0,0,0,0,0,0,0,0,0,0,0,0,19,0,0,0,0,0,0,0,0,0,0,100
9d1e9895666936d911758d04b4ea3f8386694abe,1,25,16,9,0,0,0,1,2,926,1,1,0,57,427,2,7,9,2,314,255,59,5,5,0,100
2e9012f1954855fd5544b7d37cd16aab9660c184,3,10,6,4,0,0,0,6,51,446,1,2,0.868392729,543,428,2,66,66,0,4266,4225,41,40,40,0,100
46501e58423a43c5068835fbd95289f622e4cfab,2,12,12,0,0,0,0,33,256,71,2,2,0.918295834,1768,429,2,351,350,1,13352,13341,11,137,137,0,100
1c00461b93a2d259bf810713b00a9791a6bd292d,3,96,52,44,0,0,0,4,41,232,1,1,0.651257096,1368,430,3,318,303,15,10239,10063,176,154,143,11,100
fda585051c2036acb91bd33c05d1fd28114ebf81,2,12,10,2,0,0,0,23,257,41,1,1,0.266764988,1892,20,1,376,376,0,14362,14333,29,161,161,0,100
82cb5ee66d93675cbd746887e4aa7278b6fee759,1,1,1,0,0,0,0,16,42,2,1,1,0,986,1,0,206,206,0,7664,7664,0,102,102,0,100
cd9ec69bc9010ed3142e6ebafed49745a7fd61ef,2,13,19,6,0,0,0,4,43,126,1,2,0.625262405,1208,3,1,244,246,2,9242,9317,75,133,133,0,100
ff05bac1bc7c103f396b82dedec0af817bbb96e5,5,97,10,87,0,0,0,2,7,419,1,4,2.096487465,408,21,2,59,48,11,3591,2906,685,31,27,4,90.8129544
684a19aa1af4c467de2be068234170a6a2ba292f,6,43,3,40,0,0,0,33,258,377,3,4,2.505376053,2076,47,0,404,397,7,15074,14917,157,200,197,3,90.8129544
77a9949f98d6c80a8c1466887763d44fb64c9ccc,4,39,13,26,0,0,0,2,44,1307,2,3,1.460372187,1351,431,0,288,283,5,10184,10007,177,149,147,2,99.90982867
2b1b1b57f01dd629147ea1c956721520761e9126,7,965,1,964,6,0,6,1,14,115,3,3,2.074324966,349,48,1,198,95,103,6704,2398,4306,89,40,49,99.58083832
1b3c61d5dbcdb2b1ac5fd49a624a6cb88ab04744,1,2,2,0,0,0,0,11,28,189,1,1,0,572,22,0,139,139,0,3992,3992,0,72,72,0,100
c2d103ef9d3d9d7d2c199b8e28c7709f64ea71e9,3,18,4,14,0,0,0,10,101,118,2,3,1.177022555,699,23,1,123,120,3,5058,4996,62,64,62,2,100
d45dccc09c34d9dc51c52c6b14b468b2641692c2,2,22,4,18,0,0,0,3,6,164,1,2,1,344,24,2,43,42,1,2582,2464,118,19,19,0,100
c62c9e22557bb55173f0668fd196ee51fb1f73be,1,1,1,0,0,0,0,4,4,1292,1,1,0,152,25,3,27,27,0,854,852,2,24,24,0,100
71a9fdffa9ab49d6f4f39402ff3873423021c107,5,32,5,27,0,0,0,2,259,482,4,5,1.997748297,1775,49,1,321,317,4,13549,13299,250,138,135,3,99.91052789
c2181e5fab51254452db094693d5bddbda78d5ba,1,2,2,0,0,0,0,4,10,358,1,1,0,137,26,4,23,23,0,897,897,0,23,23,0,100
8c16c28351576b893564c5cc621c7d069b1de14a,1,32,36,4,0,0,0,16,45,78,1,1,0,997,432,0,209,207,2,7704,7731,27,104,103,1,100
9f3134af3c8211e96800ded7c046f4b34dddf168,1,2,2,0,0,0,0,2,2,363,1,1,0,140,50,1,29,29,0,875,879,4,14,14,0,100
a3a631ce137f5165d35dae8a8470811b58b7b5a3,8,65,41,24,0,0,0,4,260,380,3,4,2.506975646,3908,433,1,748,746,2,28898,28812,86,340,338,2,100
05815777c6a61453699a0b269530c66d52e5ebcb,0,0,0,0,0,0,0,0,0,0,0,0,0,0,40,0,0,0,0,0,0,0,0,0,0,100
7626a7ea0c7cf2ebe4ba9518996b598d617804e9,2,34,43,9,0,0,0,33,261,32,1,1,0.294615206,2509,434,2,505,507,2,19233,19299,66,220,222,2,100
e852362f30fc57a8123f1dbcb98d3870d5e186e8,1,6,1,5,0,0,0,2,3,38,1,1,0,140,51,1,30,29,1,905,875,30,15,14,1,100
1a19b08906034da1c0f7387e0e0c6f47cd7f9883,1,1,6,5,0,0,0,2,4,0,1,1,0,144,52,2,29,30,1,875,905,30,14,15,1,100
5038b4ca1b7611d96c2eaf824eadab592e714fb5,5,91,15,76,0,0,0,12,262,202,1,2,1.591550746,3378,0,0,647,636,11,27084,26546,538,298,292,6,100
d4126cf818d5c8f14bfd989ad6037a815c103538,1,6,1,5,0,0,0,2,5,23,1,1,0,140,53,2,30,29,1,905,875,30,15,14,1,100
18eacaed31e4965a9c400d86409a88fea21fc18a,1,27,23,4,0,0,0,3,5,30,1,1,0,138,1,1,27,26,1,1054,1035,19,13,12,1,100
dd488f8b29fd1647da15c9609778f6ba97ddc4e0,0,0,0,0,0,0,0,0,0,0,0,0,0,0,6,0,0,0,0,0,0,0,0,0,0,100
c4f54dfe88d1b574a03688f16a592cf0d59d13a9,11,94,64,30,0,0,0,2,29,748,3,4,2.993213244,2843,435,0,473,473,0,21593,21316,277,244,244,0,99.5215311
ca9fdd29e15b81464fd20d73a1d070a050bae30c,1,14,9,5,0,0,0,20,64,84,1,1,0,628,436,1,137,137,0,4430,4348,82,58,58,0,100
4bb35f022688105dedec483aca6fe77f84a75f3e,3,106,35,71,0,0,0,3,5,765,2,3,0.993475751,394,2,1,55,47,8,3427,2771,656,30,25,5,99.91009889
4ba1e71a3a0c0110421c459d7c2d116c0bed10ea,1,1,0,1,0,0,0,11,22,142,1,1,0,160,2,0,17,17,0,1247,1237,10,3,3,0,100
d838c56772568211b9af617d78c5182af641faac,3,24,13,11,0,0,0,16,77,478,2,3,1.315700144,1281,3,1,241,241,0,9369,9330,39,129,128,1,100
655db36c68a4c46a59150b548e76f2e92c33bf84,4,39,19,20,0,0,0,4,78,438,3,3,1.837705994,1196,437,2,211,208,3,9652,9386,266,126,125,1,100
3a19630a8fe17e055f820b712450123201641421,1,7,3,4,0,0,0,8,22,360,1,1,0,315,3,2,31,31,0,2962,2918,44,15,15,0,100
ad063af0189ba24426e65dbdf67d9d25359e8ea6,1,3,0,3,0,0,0,4,6,367,1,1,0,105,4,2,7,7,0,758,739,19,6,6,0,100
4afe4b2ded83da451cd1ed7154d45639d3ab2623,1,4,2,2,0,0,0,8,20,921,1,1,0,148,41,0,25,25,0,890,876,14,16,16,0,100
fdd7c5c98beaeed6aa33261752554575282e1a43,7,63,37,26,0,0,0,4,65,435,3,4,2.41860579,2207,438,3,446,439,7,15830,15768,62,227,225,2,100
212690e215f24eb5d48eff138ec24f3abe8da508,0,0,0,0,0,0,0,0,0,0,0,0,0,0,5,3,0,0,0,0,0,0,0,0,0,100
ea76d62dc5773ffcb7f141401309d94d7ea5a97c,1,6,5,1,0,0,0,8,16,376,1,1,0,122,0,0,12,12,0,1023,1010,13,5,5,0,100
eafffcb040287d082167d8a4ae6ce18a16b6906c,0,0,0,0,0,0,0,0,0,0,0,0,0,0,1,1,0,0,0,0,0,0,0,0,0,100
b5f9c0f503ae5ec5765cd3e0758aa9b9e5448980,1,7,0,7,0,0,0,2,2,1431,1,1,0,53,2,2,4,4,0,319,277,42,4,4,0,100
8caed1331878908eecd7ddc758fbb19ed496072b,1,4,3,1,0,0,0,9,17,5,1,1,0,123,6,4,12,12,0,1052,1023,29,5,5,0,100
bf415182ff04848c4c14b759d43c668e95920517,0,0,0,0,0,0,0,0,0,0,0,0,0,0,3,3,0,0,0,0,0,0,0,0,0,100
8a4d60c4f3e1d69ade974c4705384219faa62e03,1,3,1,2,0,0,0,10,15,437,1,1,0,241,439,2,31,30,1,1588,1575,13,18,18,0,100
69263c884573b87eada10bdd269c9e9d31fb2e94,7,529,5,524,5,0,5,1,66,48,2,3,2.437697914,746,440,3,198,156,42,8104,5213,2891,95,67,28,98.83093525
1ca77a1ca3736fab666094ef79048d338d966554,1,1,1,0,0,0,0,10,16,8,1,1,0,243,27,0,31,31,0,1592,1588,4,18,18,0,100
ed7e547b8ba3a8435d132fe097d8db9f434f5cf0,2,12,8,4,0,0,0,10,263,218,2,2,0.721928095,1823,7,4,320,321,1,14648,14557,91,136,136,0,99.940012
601d01deb517e7d7093fcafd91589aa14c2dd72d,1,40,41,1,0,0,0,18,51,508,1,1,0,369,8,5,75,75,0,2755,2750,5,29,29,0,100
edbfbb3cd984e0735bc1c946c6d8c9b1a4b750ef,0,0,0,0,0,0,0,0,0,0,0,0,0,0,9,4,0,0,0,0,0,0,0,0,0,100
bde35c6662489a6198fa7960bed767f152e4d180,0,0,0,0,0,0,0,0,0,0,0,0,0,0,10,5,0,0,0,0,0,0,0,0,0,100
05c0db0444eaade1b18e49465c3cde2ea5336485,1,13,3,10,0,0,0,18,52,13,1,1,0,368,11,6,79,75,4,2814,2755,59,29,29,0,100
34a0740901e02b26298aac06295d4552169be788,1,4,1,3,0,0,0,34,264,13,1,1,0,1516,4,0,298,298,0,11625,11599,26,118,118,0,100
917671cf35cec5357f078158873d98a13d29157c,9,64,46,18,0,0,0,5,67,825,4,7,2.511330764,1630,441,2,282,275,7,11447,11306,141,138,137,1,99.85034421
cf62b4298ad778fbe1dff8478899883aa91a2234,2,45,3,42,0,0,0,20,68,215,1,2,0.738284866,873,28,1,193,189,4,6439,6070,369,108,104,4,99.97011357
9a3f7e333e87b0107d9a1eb860a41a8d882d67a1,2,5,4,1,0,0,0,13,43,376,1,2,0.99107606,539,0,0,93,93,0,3589,3568,21,59,59,0,100
ee642b0b537629108227864f3458daf20950b9bc,6,234,93,141,0,0,0,2,265,98,2,3,1.212526937,3696,12,5,699,673,26,30053,29220,833,332,318,14,99.97009569
bef892426333a2b6dc0088797a57a6e80d549cec,0,0,0,0,0,0,0,0,0,0,0,0,0,0,2,0,0,0,0,0,0,0,0,0,0,100
050dc44b6224054dda01553f5cc9a69a7e32b2da,1,10,6,4,0,0,0,3,7,3,1,1,0,286,13,6,55,55,0,2073,2061,12,27,27,0,100
5a8bdef821c24bda579859e3bd3dacd9b0792b7d,0,0,0,0,0,0,0,0,0,0,0,0,0,0,3,1,0,0,0,0,0,0,0,0,0,100
60962832c4d409d50dd1e28f653658d20c6c232c,6,9,11,2,0,0,0,4,50,2402,3,5,2.370950594,665,442,1,111,111,0,3933,3925,8,82,82,0,100
6692234535bc45ff60c8e54c7164b0d18093e5c6,2,2,1,1,0,0,0,8,43,365,1,2,0.918295834,642,14,7,53,53,0,5883,5877,6,37,37,0,100
d495846f0b754a67594cc48f5559ca36838fd700,0,0,0,0,0,0,0,0,0,0,0,0,0,0,29,2,0,0,0,0,0,0,0,0,0,100
4089b0e6e86ad600b81cc19378ee242e8db84ff0,1,1,1,0,0,0,0,34,266,27,1,1,0,1520,30,2,298,298,0,11626,11628,2,118,118,0,100
b517002c7735dc9fb826914e29f8b015bb6e2281,5,69,20,49,1,0,1,1,17,245,3,5,1.854409204,447,443,1,75,74,1,3375,3175,200,38,37,1,99.85034421
438a941f4bb7718610894af8e0b2b2d6127fac39,5,18,18,0,0,0,0,16,103,182,2,4,1.916445381,1966,15,3,286,287,1,15333,15333,0,142,143,1,100
0b42e9445bb64d9ba600b8ce7ac0f92e9fca293c,3,46,20,26,0,0,0,13,51,51,1,2,1.555749685,1677,5,0,280,279,1,13992,13707,285,161,160,1,100
f70bf4fef0c919978408ceaf5ae569ff164e6136,9,69,28,41,0,0,0,2,267,777,4,7,2.799797026,3049,6,1,525,520,5,23634,23218,416,233,231,2,99.0184414
46046cbb99676ad33f9349da946ede02f3826fd8,1,1,5,4,0,0,0,2,3,4784,1,1,0,8,16,2,0,0,0,34,43,9,0,0,0,100
436b7d264e40f076519f2854bba13d710c5296a5,0,0,0,0,0,0,0,0,0,0,0,0,0,0,4,0,0,0,0,0,0,0,0,0,0,100
a9036487c5f09e8f1132be9655eb54a177573e7c,1,3,3,0,0,0,0,4,8,2513,1,1,0,244,17,2,26,26,0,2011,2021,10,10,10,0,100
8d4329a72f7a91e2cf2706f064351efba65c8e03,1,1,1,0,0,0,0,20,69,87,1,1,0,643,42,0,139,139,0,4447,4456,9,58,58,0,100
29d032dde65cfb441e7c912b1621cfff6c266674,2,5,5,0,0,0,0,2,3,103,1,1,0.970950594,177,18,2,20,20,0,1226,1226,0,12,12,0,100
60587b63a4401cc6160907d33fb5cd89dbbdc724,1,3,0,3,0,0,0,20,70,12,1,1,0,643,31,0,141,139,2,4463,4447,16,58,58,0,100
12d80f534e02299cb59cc7b25b9e24e55fb97318,1,17,4,13,0,0,0,10,17,145,1,1,0,243,444,0,32,31,1,1690,1592,98,19,18,1,100
a29d3d825fe0630e45e427dbf9f15173a960d2b9,1,5,1,4,0,0,0,2,6,332,1,1,0,84,32,1,8,8,0,529,476,53,4,4,0,100
19725221286da5d56d7dd9efc4070b48d6f8ae6d,1,5,5,0,0,0,0,6,9,85,1,1,0,290,33,2,37,37,0,2263,2263,0,9,9,0,100
9f3334650570ea331f87c83c0f1fa22da8e322e7,1,1,0,1,0,0,0,5,23,549,1,1,0,151,19,0,12,12,0,1196,1189,7,8,8,0,100
f82f302a43d693856766419a379556179ebcaa5f,1,3,3,0,0,0,0,21,71,76,1,1,0,646,4,0,140,141,1,4455,4463,8,58,58,0,100
3cd375839ac26882c7209ddee80e38a5a7776a7c,0,0,0,0,0,0,0,0,0,0,0,0,0,0,0,0,0,0,0,0,0,0,0,0,0,100
90fd0625ff16b4a967ad94010080be59aef2049c,0,0,0,0,0,0,0,0,0,0,0,0,0,0,1,1,0,0,0,0,0,0,0,0,0,100
565d111496382bef810dea8c4547410ebbd57bdc,2,13,23,10,0,0,0,10,21,1511,2,2,0.88797632,328,5,0,48,50,2,2123,2154,31,25,27,2,100
1b45527295118254fb5ec81bb295d73ddda81a95,4,102,97,5,0,0,0,3,268,607,3,3,1.41713154,2005,6,1,345,352,7,15593,15321,272,153,155,2,100
b49a79317fbc1fcb68448bd603df6f6bf9d18808,2,35,17,18,0,0,0,4,39,728,1,1,0.98285869,483,445,0,72,68,4,3965,3842,123,43,40,3,100
ec1cfc559c0ae71ba8240852eaa5fc2ab1c28c9e,4,39,2,37,0,0,0,3,72,1071,3,4,1.437775065,1833,1,0,335,332,3,13879,13656,223,216,213,3,100
8adc4ffc7bd0b97c75286e3ed991dcbf3cd7907a,3,36,0,36,0,0,0,6,52,551,1,2,1.328469066,862,18,0,126,123,3,7121,6877,244,88,85,3,100
4d204899ae1f26375028b78779785453fe3b9496,3,3,7,4,0,0,0,7,12,2046,2,2,1.370950594,305,34,0,50,50,0,1930,1954,24,25,25,0,100
58e89cb7e1d50fb00f5798bba419f07d9aee4f0b,2,48,13,35,0,0,0,6,53,28,1,1,0.715322053,722,19,1,102,97,5,6167,5924,243,63,59,4,100
85e5e20fd9b4d9aba0b330397385ba89b88d23e0,1,4,0,4,0,0,0,8,12,635,1,1,0,256,5,0,57,55,2,1820,1786,34,20,20,0,100
ada2c1cc0b80ea01f65f1debfea12818373243e2,9,58,33,25,0,0,0,4,48,611,2,4,2.63639472,2148,6,1,394,391,3,14851,14703,148,187,185,2,100
5c7fce404e84c02c3e1405ab4001058e20c17255,3,5,1,4,0,0,0,2,54,803,1,2,1.584962501,626,35,1,81,81,0,4740,4701,39,44,44,0,100
5c47d3b4cafffa8e2bc21276f302d70efbbed5a9,2,15,9,6,0,0,0,24,269,242,1,1,0.918295834,1939,446,0,376,374,2,14962,14900,62,161,160,1,100
45772bb7ec79bced76e546375c3acecce0ca4563,2,4,4,0,0,0,0,7,270,835,1,1,0.954434003,1684,1,0,320,320,0,12906,12913,7,135,135,0,100
0b796893520381ee25de2ab5b5983d671e8e65f2,2,16,1,15,0,0,0,17,55,82,2,2,0.873981048,968,7,0,192,189,3,7032,6952,80,157,155,2,100
90399598396af414c0de8252231fc171debb6bb2,3,236,108,128,1,0,1,5,24,574,2,2,1.262570306,556,20,0,102,89,13,4676,4099,577,56,43,13,92.97597043
95b51e512ffa3d0798607b82f8b474649413f2bd,3,26,8,18,0,0,0,3,3,851,3,3,1.548565226,253,0,0,42,40,2,1652,1538,114,32,32,0,100
ea6faa47a05a081708e192630dd5fac08a4d47b5,2,7,4,3,0,0,0,21,79,494,2,2,0.845350937,706,8,1,127,127,0,5345,5335,10,77,77,0,100
f3a5d4de627ec7d4884ad4ecaeb7347fdf5a41ef,2,45,24,21,0,0,0,12,73,277,1,1,0.473572925,778,0,0,162,158,4,5593,5470,123,70,68,2,100
c8f4c46b06c85cf4ab950d33fc447eb01f71e953,3,33,36,3,0,0,0,6,52,579,1,1,1.515719126,1372,36,0,316,317,1,10013,10058,45,158,156,2,100
f9584b8c29d933b3833a6f26b69b557e6ceec607,2,55,3,52,0,0,0,1,6,596,2,2,0.66319684,239,447,0,32,27,5,2045,1711,334,17,15,2,99.77621483
a6719dc63eb90cc6bdc622a0824101945e746475,1,3,3,0,0,0,0,36,271,62,1,1,0,1569,37,1,297,297,0,12211,12204,7,118,118,0,100
c1fd4e5dc015fc8b3e4b6b18d41eeab2b9e81284,2,7,11,4,0,0,0,3,53,290,1,1,1,1081,448,1,226,226,0,8168,8179,11,118,118,0,100
9095c895bf72113f99cc3c0b3c084987688e2c5a,9,264,37,227,3,0,3,1,7,950,1,2,2.159056235,417,0,0,71,54,17,3284,2333,951,45,33,12,99.74659487
c3f78faed7bdb213b547b6edbff153e021ab6f18,3,15,1,14,0,0,0,36,272,384,2,2,1.198192411,2642,9,0,530,526,4,20472,20394,78,253,251,2,100
670a4ee71a48a74154044370c20cda5ff6932f6e,1,4,2,2,0,0,0,23,74,53,1,1,0,682,449,2,146,145,1,4702,4694,8,61,61,0,100
9be3f02a0f06e96347839555b7b2ce1cd5b9f384,3,63,9,54,0,0,0,21,80,223,2,2,1.024034595,989,450,3,203,196,7,7658,7397,261,119,112,7,100
b06f82a94d563830fe747f47bad3298cd22ee04a,0,0,0,0,0,0,0,0,0,0,0,0,0,0,451,4,0,0,0,0,0,0,0,0,0,100
1b54bfab05e4f1775ea82b58c8140c4b2b6beb8c,2,48,28,20,0,0,0,36,273,20,1,1,0.239873825,2508,452,4,499,495,4,19604,19507,97,222,222,0,100
88405b037ac9db4471603dfdd8ddc7c542f0229c,14,371,23,348,2,0,2,2,274,585,5,8,2.799573527,4489,38,0,876,844,32,34774,32711,2063,532,512,20,99.71446701
4e5443a4f2e76af060c3725663de3ae73603c50d,2,2,1,1,0,0,0,36,275,0,2,2,0.918295834,2293,39,1,441,441,0,17530,17531,1,260,260,0,100
1dc6c352491ab958717a9a7c935bf83cee07d8e5,2,1,2,1,0,0,0,36,276,0,2,2,0.918295834,2293,453,4,441,441,0,17531,17530,1,260,260,0,100
a483bd4bf015b5b368215e0d622ff43ed317b0c7,2,2,1,1,0,0,0,36,277,0,2,2,0.918295834,2293,40,2,441,441,0,17530,17531,1,260,260,0,100
b8ce6d1f6ea37ed3ff9f6e888d2357fe48490567,2,5,4,1,0,0,0,20,78,489,2,2,0.918295834,1274,0,0,220,220,0,9916,9886,30,89,89,0,100
979b38a7ab09493689bf167e04e521ed18d76d0e,2,19,14,5,0,0,0,11,18,317,1,2,0.994030211,513,7,0,89,89,0,3576,3510,66,40,39,1,100
05f39221102abc00b2934e279da872d06f6a1811,2,31,16,15,0,0,0,17,49,427,1,1,0.944087018,1179,21,0,259,258,1,8391,8317,74,129,128,1,100
be28b3907f4fee8957fb2824770e4925364d0a8f,1,42,8,34,0,0,0,12,31,4,1,1,0,586,0,0,145,140,5,4221,4101,120,76,73,3,100
1e07944d92af101a2327b6742aac6cbfa1350ee8,1,2,2,0,0,0,0,13,39,570,1,1,0,240,10,0,41,41,0,1670,1660,10,25,25,0,100
ba4ed31c30346744cc9001d3cb683caf993943fa,1,19,17,2,0,0,0,21,81,72,1,1,0,569,11,1,104,104,0,4459,4398,61,64,64,0,100
0e136f39123dc65a07a41c7146ea0e91f0fe1fa7,3,138,14,124,1,0,1,14,45,475,2,2,0.921924814,471,454,0,92,77,15,3488,3010,478,48,41,7,99.87265202
d461a01a53e7e130f0ec4143e75b316012137b62,1,1,1,0,0,0,0,24,76,53,1,1,0,685,41,0,146,146,0,4732,4732,0,61,61,0,100
bd98fa3ac097b32f78f060ee1d2c6fe33c7f4c8b,14,369,27,342,1,0,1,13,278,649,4,8,3.032658125,6110,42,1,1158,1113,45,48754,46592,2162,649,619,30,99.87281399
fe1cbbba8893323448544deb9368bd714a210529,7,105,39,66,0,0,0,4,78,208,5,6,2.356476119,3311,455,1,677,662,15,24869,24497,372,423,413,10,100
317bed004b0bdc82db99780609c3ee83082dcfa4,6,56,18,38,0,0,0,2,54,795,2,4,2.447514417,1494,1,0,211,204,7,11586,11339,247,125,119,6,99.9364676
7ace05ca981d6af94e21899b672dd357f3843b6a,3,21,4,17,0,0,0,11,15,1179,1,1,1.131314689,423,2,1,64,61,3,3062,2986,76,50,47,3,94.67494283
2e4e75bdc9671d9ac03eae50ce02ff4aa48ced1f,2,39,32,7,0,0,0,7,55,14,1,2,0.816811428,650,22,0,86,86,0,5141,5091,50,47,47,0,100
43c4e00b8e960079dc2cb86fbaba516cfa60df18,1,16,1,15,0,0,0,5,7,284,1,1,0,357,456,1,73,70,3,2490,2393,97,36,36,0,100
ba8e62cd2f22593af22317ea7c1cc5a0b08a23b3,15,323,94,229,1,0,1,16,279,798,4,8,3.160700884,5188,457,2,941,912,29,40223,39263,960,495,470,25,92.41661422
4c8ef9db16e32d13a1eb07fce12a7563b830a2da,6,121,76,45,0,0,0,15,79,460,2,5,2.246377844,2052,458,3,319,303,16,15740,15442,298,136,131,5,100
b712ab5beb699852c3c220befcb2e695302bbd6c,8,64,31,33,0,0,0,9,99,1460,2,2,1.403919554,1233,459,4,264,254,10,7386,7324,62,185,182,3,100
de71745b1dd085cfe8552483fc14f9e817738faf,0,0,0,0,0,0,0,0,0,0,0,0,0,0,43,0,0,0,0,0,0,0,0,0,0,100
4858b4229eb3d15dafafc7d3d7f05935fe3d7b38,1,102,95,7,0,0,0,36,280,14,1,1,0,1593,460,5,307,302,5,12450,12450,0,123,120,3,100
121a081fb506748acc6244ee83e128cc6cad2ad9,18,21,20,1,0,0,0,2,106,947,6,14,3.945983639,2678,44,1,464,463,1,18636,18625,11,256,257,1,100
b7ffa1ba1e3e7cecd9ea687f72425c2ffd5b1c34,4,33,1,32,0,0,0,5,80,31,3,3,1.566883817,1170,0,0,244,238,6,7862,7691,171,121,119,2,100
639f1bf0bc1d4b8c72e22cfcd50f3f1d2b7df641,6,129,39,90,1,0,1,2,14,2996,2,3,2.369515569,289,461,5,62,48,14,2052,1627,425,50,41,9,99.94089835
87adca4318a289d68fbf3a035894113e6bf9aaac,0,0,0,0,0,0,0,0,0,0,0,0,0,0,462,6,0,0,0,0,0,0,0,0,0,42.91300098
eab143a577210e051c5c284969243fa88f1fef93,1,2,2,0,0,0,0,12,31,48,1,1,0,732,45,2,147,147,0,5307,5307,0,145,145,0,42.91300098
