CommitID,NMF,TotalAddLines,TotalDeleteLines,LC,FileAdd,FileDelete,NAD,NDEV,NUC,AGE,NS,ND,Entropy,LT,EXP,REXP,CommitComplexity,LastCommitComplexity,CFC,CommitTokenCount,LastCommitTokenCount,NCC,CommitMethodNum,LastCommitMethodNum,NMC,a2a
a44121e3ecafb3288650bfc1139c233a3d980839,0,0,0,0,0,0,0,0,0,0,0,0,0,0,0,0,0,0,0,0,0,0,0,0,0,100
ced84c8dbb23aba17b93a3455b796a6621714bbd,66,6269,2204,4065,19,0,19,2,2,0,2,13,4.919330342,6756,1,1,1439,1169,270,63383,43288,20095,631,463,168,88.27930175
b4a10bdc73e47e8a6a6b9634d0825a394596820b,66,2202,6267,4065,0,0,0,1,1,0,2,13,4.920009084,9625,0,0,1169,1439,270,43288,63383,20095,463,631,168,88.27930175
6a92db4be1416b70b095410a0dcada97f05702bb,0,0,0,0,0,0,0,0,0,0,0,0,0,0,1,1,0,0,0,0,0,0,0,0,0,100
a1d6293708dd7d3e375e2642e96cd6bae0cc0172,4,15,5,10,0,0,0,2,2,32,1,3,1.921928095,752,1,1,146,146,0,4951,4871,80,63,63,0,100
7e540f48f4abe29531a32f2a728bd3e39258602c,2,4,2,2,0,0,0,2,2,42,2,2,0.918295834,592,0,0,99,99,0,4084,4054,30,32,32,0,100
ecd006eb24da9e4b34aa2787c8854ef5975747fc,9,468,460,8,0,0,0,2,2,36,1,1,3.003824898,716,2,2,121,121,0,3369,3369,0,71,71,0,100
ee8dd8f1051c967c1d5d024356a29b6da4a467de,1,16,1,15,0,0,0,1,2,54,1,1,0,221,2,1,39,37,2,1694,1604,90,5,3,2,100
8511d545f1c02752270887efbbe6e8733eedaae3,5,33,26,7,0,0,0,1,3,47,1,4,1.809877096,1500,3,2,321,320,1,10862,10764,98,106,106,0,100
5b8edb0bc19f770d1cd73be98033b2e70fe0c982,4,325,15,310,1,0,1,1,4,31,2,4,1.314990421,983,4,2,250,223,27,8547,7077,1470,85,73,12,99.71014493
a3276d890bbd369b0ac8552a050dae894c21c4f8,10,416,14,402,5,0,5,1,4,34,2,5,2.343547487,780,3,0,177,131,46,7301,5488,1813,81,51,30,98.27833572
14956a71d9acf41094c2654c86b6dc7a3caf865b,0,0,0,0,0,0,0,0,0,0,0,0,0,0,5,3,0,0,0,0,0,0,0,0,0,100
bf5a56513b3da5b3e529c02a5c7e3af13f52b0e1,1,5,1,4,0,0,0,2,3,47,1,1,0,328,6,4,78,77,1,1880,1861,19,24,24,0,100
68ae18630f90cb2714fe25e2d3de16a5f9a186cc,4,80,6,74,0,0,0,2,4,56,2,3,1.826660568,853,7,5,166,156,10,5886,5481,405,62,62,0,100
d13f9cd2884b60eb86d2a2759ba0934da5609887,0,0,0,0,0,0,0,0,0,0,0,0,0,0,8,6,0,0,0,0,0,0,0,0,0,100
ff7a5c1e6a01e2bda96ffb20e97f5b560cacbb89,1,4,1,3,0,0,0,2,2,104,1,1,0,44,0,0,8,8,0,173,158,15,6,6,0,100
c0aa63bdc913ae89035985842b05fecc79da6448,48,1602,106,1496,6,0,6,2,5,65,2,9,4.12628448,4574,4,1,930,750,180,32042,26397,5645,485,359,126,93.5483871
6d970266390c530b55b9a4f156536652312229a5,3,306,2,304,1,0,1,1,4,4,1,2,0.135498864,225,0,0,99,41,58,2854,1158,1696,46,17,29,99.44979367
91373c004ead334f8932cfd320208673a5c8eda1,1,8,4,4,0,0,0,2,4,8,1,1,0,335,5,2,61,61,0,2693,2683,10,23,23,0,100
58f38d59dee540eb3a4f348e3451190dacbc9d55,0,0,0,0,0,0,0,0,0,0,0,0,0,0,6,3,0,0,0,0,0,0,0,0,0,100
eba8163b132b519c2e583103c4ce5be7bf47eb5d,1,1,1,0,0,0,0,2,3,9,1,1,0,117,7,4,15,15,0,817,813,4,5,5,0,100
c8b0a87a557084fda1c60677c198dbe48742cfc7,1,15,1,14,0,0,0,2,2,116,1,1,0,90,1,1,21,18,3,579,523,56,13,10,3,100
5299eab429d3bdf359860760f11fc6ed69fed1a0,2,45,9,36,0,0,0,2,5,73,1,2,0.133039649,678,8,5,141,136,5,4745,4557,188,36,36,0,100
da14fbb9ae1873fbcf8c578aaf450414e1b0232e,3,96,171,75,0,0,0,3,5,55,2,3,0.81564187,666,2,2,116,110,6,4030,4461,431,40,37,3,100
0aa259fe20ea5fa40348a08dde0a219413966b7b,1,7,0,7,0,0,0,1,2,126,1,1,0,49,9,5,7,6,1,215,173,42,6,5,1,100
944e4197df7c05328a31a75a0f9e0eaa408e2464,0,0,0,0,0,0,0,0,0,0,0,0,0,0,3,3,0,0,0,0,0,0,0,0,0,100
92a9b7e241f32272810ded8f6b4b43d0672f4d32,3,48,0,48,0,0,0,2,5,61,2,3,1.099483982,596,4,4,110,104,6,4598,4346,252,43,41,2,100
24facb615784fc82a905ee8f7828c1903d87c311,49,2572,819,1753,6,0,6,2,6,100,2,13,3.529550614,6535,9,0,1298,1175,123,47654,42279,5375,541,510,31,90.90909091
c1e5e8fdec31010729f8646058663080f0a781a8,1,36,0,36,1,0,1,1,1,0,1,1,0,0,10,1,0,0,0,33,0,33,0,0,0,99.11167513
5031fb6fbd69c3e6c1a017b6bcca373b6b190cef,1,0,1,1,0,0,0,1,2,0,1,1,0,113,11,2,19,19,0,752,754,2,3,3,0,100
e6f403d14b7d5cda1ba4fd88a73e2c64bc175f39,4,109,9,100,0,0,0,1,4,8,1,1,1.292537759,943,12,3,197,188,9,5460,5278,182,60,59,1,100
169de063a74da75f7564cfa73562f0a74ee3a8cf,2,0,171,171,0,0,0,3,4,28,1,1,0.976161457,142,13,4,0,0,0,0,0,0,0,0,0,99.48979592
adf3c9f9d66be6101dcb0bb0b83b44a3edb608d4,2,13,15,2,0,0,0,2,6,63,1,1,0.905928216,516,14,5,98,99,1,3780,3794,14,46,46,0,100
3886fbda1a1d839c926f789b2c9dbc62081690a3,1,6,7,1,0,0,0,2,5,20,1,1,0,222,15,6,48,48,0,1279,1309,30,17,17,0,100
ddb4549e5fb15ae123caa28451313ac5a0cbf133,0,0,0,0,0,0,0,0,0,0,0,0,0,0,16,7,0,0,0,0,0,0,0,0,0,100
819f40ba97ec4c550caee9988641ca8ba7edfe33,84,3066,2574,492,8,0,8,2,3,183,2,14,5.392029826,8845,2,0,1425,1468,43,52916,53675,759,584,631,47,85.41666667
401b1da62f958e706f55ed7df2b82133cd13e397,85,2688,3081,393,3,0,3,2,6,52,2,14,5.438221961,9130,10,0,1493,1436,57,54407,53213,1194,638,594,44,87.7688172
8ad6ca4c9a6b88afcf16f8b2ddc78c964ee72bfd,1,3,4,1,0,0,0,2,5,0,1,1,0,399,11,1,28,28,0,3155,3152,3,21,21,0,100
c2b478d341d42de3bfcd2da51c520fc807094678,0,0,0,0,0,0,0,0,0,0,0,0,0,0,5,0,0,0,0,0,0,0,0,0,0,100
243ab4e809ad0b2c1f25f934c685d6806894e8e0,1,14,0,14,0,0,0,2,7,72,1,1,0,473,17,2,108,106,2,3306,3276,30,32,32,0,100
f892a707aa64a007aa8c2024d029e2952989c663,89,3153,2771,382,8,0,8,2,4,144,2,15,5.490364188,9996,3,1,1601,1672,71,60185,61784,1599,648,698,50,90.86419753
2cdb4de34e4ffae394615c14cc360405492a04d3,89,2779,3155,376,3,0,3,1,8,51,2,15,5.495681174,10128,18,3,1673,1605,68,61667,60267,1400,699,652,47,90.86419753
88ab07c32f72aa9b339500a761ba4b043f085ddc,1,2,1,1,0,0,0,1,3,18,1,1,0,63,12,2,11,11,0,318,318,0,7,7,0,100
771a861d8f68f8a8575866b2b37803814894c114,108,5771,2956,2815,42,0,42,1,9,57,2,18,5.871246,8976,13,3,1694,1316,378,70481,49897,20584,868,628,240,77.25674091
22a5cc6c4a0f85cea0522b686924dcef5e855e9e,0,0,0,0,0,0,0,0,0,0,0,0,0,0,19,2,0,0,0,0,0,0,0,0,0,100
c359ad197726eb95502c1d20cfdaf1c92a858ba6,27,137,199,62,0,0,0,2,10,0,2,14,4.113844015,4052,20,3,725,723,2,25836,25714,122,372,372,0,100
933a2a11b19592c1fbfc9fe1bb36f16e7bdea5ae,3,54,3,51,0,0,0,1,3,87,1,1,1.584962501,751,21,4,158,149,9,4361,4151,210,43,43,0,100
9a26c9b011d9e9af179d46b6e9a737fe63815751,2,7,7,0,0,0,0,2,3,10,1,2,0.985228136,481,22,5,78,78,0,3295,3300,5,28,28,0,100
d7929756dcefa2d0ca8485041b03ab81367f12a4,118,3969,3969,0,0,0,0,1,11,78,1,24,5.897076613,12096,14,4,2063,2063,0,70621,70621,0,1019,1019,0,100
debcf490b7c75443e15ee04c0fe2fc81335f4595,15,330,135,195,2,0,2,2,6,18,1,3,2.761606317,1453,23,4,226,203,23,10309,9524,785,116,103,13,95.46891465
4689a16a4bed09533a7720383e3b13aebf3aeab4,1,1,3,2,0,0,0,2,12,17,1,1,0,347,24,5,71,71,0,2145,2149,4,27,27,0,100
fd7b8828adc1737e81323c4bb735d5a53285cdfe,32,355,329,26,0,0,0,2,13,27,3,15,4.488556687,7460,25,6,1329,1333,4,45913,45514,399,434,436,2,99.89177489
ccfcc47c2c4d4953e09450b05212e32a9dc53b1e,1,0,0,0,1,0,1,2,4,0,1,1,0,0,26,7,0,0,0,0,0,0,0,0,0,99.78308026
83d488447211146e0a41b05e4731e0edaa6142a5,23,155,260,105,1,0,1,3,14,26,1,12,3.179832798,3949,27,8,722,733,11,23449,23794,345,302,300,2,94.00785855
9f4f5d2d9aada34cea69228156147865a8806133,14,61,35,26,0,0,0,2,15,7,3,11,3.558785662,2725,28,9,450,452,2,16345,15993,352,208,209,1,100
c63f745ee0a0931b816abd6458a626d040f24422,1,0,1,1,0,0,0,2,7,17,1,1,0,233,29,8,33,33,0,1487,1498,11,2,2,0,100
fb572fa2f4ee219ca5a72edb3b8b74427e7b3cb6,0,0,0,0,0,0,0,0,0,0,0,0,0,0,30,7,0,0,0,0,0,0,0,0,0,100
feceb6e5b451e0b9c76bbc2ad702830cadaddba5,1,5,1,4,0,0,0,2,4,20,1,1,0,453,15,0,65,65,0,2041,2031,10,52,52,0,100
c7ea9f6991660ccade06ec375ccb5cd71b3d4300,0,0,0,0,0,0,0,0,0,0,0,0,0,0,16,1,0,0,0,0,0,0,0,0,0,100
f5eb02dd48e3772d6f97764c9940413b45ffeca3,5,12,45,33,0,0,0,2,16,25,1,4,2.009240773,779,17,2,133,141,8,4513,4726,213,66,66,0,100
0366fdca03901d9a407fe842b38199379092fe34,15,116,0,116,1,0,1,2,5,41,1,1,0.990848367,2013,31,8,238,228,10,14801,14265,536,103,98,5,91.25840538
b007c63a619e8625dc10f82bf3fc70f90ede6cf9,209,9679,11896,2217,27,0,27,2,5,90,3,30,6.953746296,20317,4,0,2968,3198,230,108434,119275,10841,1251,1513,262,74.85436893
74b6df8d5ebd3975006c3204cc54b0bd2b9d34dc,209,11898,9681,2217,52,0,52,2,16,36,3,30,6.95391084,18621,18,3,3234,2861,373,121621,103464,18157,1510,1234,276,74.85436893
ba5413316c2683c0054e57d477e537f5c8a5d2fe,2,75,0,75,1,0,1,1,4,20,2,2,0.634309555,413,32,8,65,59,6,3686,3294,392,29,24,5,99.79381443
00037a719d5828e973b75afb751e6cf5cbad5e9f,0,0,0,0,0,0,0,0,0,0,0,0,0,0,33,9,0,0,0,0,0,0,0,0,0,100
3194ca1a339c1b3286556ee442cf9109bdaccb3c,213,10361,11971,1610,30,0,30,2,5,90,3,30,6.990714435,20372,5,1,3067,3204,137,111077,119667,8590,1285,1518,233,71.45969499
1f03de90c55ab5c92945da639c049bb087a2c011,213,11973,10363,1610,53,0,53,2,16,36,3,30,6.990875691,19077,19,4,3240,2960,280,122013,106107,15906,1515,1268,247,71.45969499
3f4d0d0967c91fd85ef2256e8038bf1257623628,139,5903,3794,2109,9,0,9,2,6,26,2,20,5.97540413,13676,6,2,2293,2141,152,90076,84551,5525,1069,1060,9,85.68443051
858911a4e1781ad2e42c1172437140ebfd6746c3,139,3792,5901,2109,3,0,3,2,6,42,2,20,5.975531374,15153,20,5,2141,2297,156,84419,90158,5739,1060,1073,13,85.68443051
ecd46eaf971a4356913fd817ae029e4149f00442,0,0,0,0,0,0,0,0,0,0,0,0,0,0,21,6,0,0,0,0,0,0,0,0,0,100
c0537568f44270da18462d216818ba097a2d4763,13,57,54,3,0,0,0,2,7,17,1,1,3.443020718,2226,22,7,238,238,0,16384,16269,115,111,111,0,100
992aae8da889bacf1d34d727f8b42b3030120b1b,144,6822,3833,2989,13,0,13,2,6,26,2,21,6.052618715,13728,7,3,2390,2146,244,94184,85033,9151,1121,1064,57,84.88612836
579d199f1069f3e59d62b797958fa99cae4f4fd1,145,3830,6836,3006,3,0,3,2,7,41,2,21,6.056644894,15894,34,5,2150,2402,252,85568,95005,9437,1070,1130,60,84.88612836
3f96f9ea9b744f6583e8558fa5ca18cc32f765aa,1,27,1,26,0,0,0,2,8,27,1,1,0,232,23,8,36,33,3,1698,1487,211,3,2,1,99.69167523
eb2d5d9afe92ace84e2fb0c07e8a5f9cbda1f4a3,6,471,5,466,3,0,3,1,5,29,1,5,1.708665738,167,35,6,106,27,79,3689,1104,2585,65,24,41,92.45647969
0415f03dfe1fcf13e32a11b54c0d1f6ce7688767,1,16,14,2,0,0,0,2,6,62,1,1,0,366,36,7,74,70,4,2636,2604,32,23,23,0,100
ac6a6144c6193dbb02748d8d7846d7122b624053,0,0,0,0,0,0,0,0,0,0,0,0,0,0,24,9,0,0,0,0,0,0,0,0,0,100
b649672a5518a9bceace645092ba125c7d25ff14,5,663,1,662,3,0,3,2,3,93,2,3,1.825571046,122,25,9,86,25,61,3694,699,2995,46,17,29,96.33699634
3998587f9d2b76966e689098fdbcfc39917b17e1,2,2,2,0,0,0,0,1,2,0,1,2,1,320,26,9,49,49,0,1739,1739,0,21,21,0,100
d9418877b7cb6042af1d02d3c70558d09ac0a221,1,31,1,30,0,0,0,2,7,104,1,1,0,221,27,10,51,48,3,1444,1283,161,17,17,0,100
10b873027d9c19f3f3c5d3a290c37bb64a86e8d7,164,7643,5701,1942,16,0,16,2,6,26,2,24,6.394752526,15623,8,1,2447,2435,12,96689,96310,379,1185,1226,41,86.08156028
588d123b105a75bd531859c97a77353a07c10235,165,5792,7623,1831,11,0,11,2,8,28,2,24,6.412380443,16727,1,0,2439,2448,9,96794,96731,63,1229,1186,43,83.37975859
b87ca8c93cf78be0d1818b69ff36263a9ef017a7,0,0,0,0,0,0,0,0,0,0,0,0,0,0,37,1,0,0,0,0,0,0,0,0,0,100
080304cc66baa9e080d2c88908b0ba21eed73eea,42,462,135,327,0,0,0,2,17,73,2,15,4.637745155,6310,38,2,1123,1111,12,42693,40426,2267,478,478,0,100
ec488149296a1dfa069f2c0ccb74e91cd1aaa4b1,176,7887,6247,1640,17,0,17,2,6,29,2,27,6.530087724,17849,9,1,2821,2807,14,108454,110458,2004,1343,1381,38,81.724846
e6162f0937855bf8a33d6dfad3855eb4a390ad50,176,6238,7871,1633,11,0,11,2,17,23,2,27,6.533306831,18624,39,2,2809,2822,13,110368,108496,1872,1381,1344,37,81.724846
6cf04a3cf3ac363168e38cc184fee9603daf00da,5,329,136,193,0,0,0,2,10,49,2,5,0.693346096,1368,28,1,272,243,29,9722,8716,1006,104,93,11,87.40310078
8696874af04eaca9425638c61033b2052cbed586,1,1,1,0,0,0,0,2,5,2,1,1,0,421,29,1,68,68,0,2390,2392,2,41,41,0,100
37dec9c4cf044ecf00229c44e1eee989ac27faf9,3,62,10,52,1,0,1,3,12,8,1,3,1.328469066,712,30,2,134,129,5,5019,4880,139,63,60,3,94.97797357
78dca28e829f939e1aa9fa33a1c25ed6f998ceff,4,89,4,85,1,0,1,2,10,57,2,2,1.903049624,912,31,3,146,137,9,5269,4857,412,86,83,3,98.35119538
f491ad663e5aff909fd6845469148cd065321d3d,26,624,397,227,0,0,0,1,18,88,2,11,3.085925033,4806,32,4,851,850,1,32161,30917,1244,351,347,4,95.25423729
894743595f0e0018ceb8ead8a94cff4abd41413f,10,1335,0,1335,10,0,10,1,1,0,1,2,2.931327059,0,33,5,118,0,118,4051,0,4051,72,0,72,95.66613162
3f4eb84c1e302a636f8938986899195bb3f706c2,193,8030,8321,291,16,0,16,2,6,28,3,29,6.666331769,19942,10,1,3036,3123,87,115455,122314,6859,1441,1556,115,85.64013841
b6e175b265435980254eed8c0b41ea6fadabe500,13,289,48,241,0,0,0,1,7,94,2,3,2.903351097,1580,11,2,242,211,31,10345,10386,41,150,118,32,86.45294726
6d0fac95b28b5205ebd99c125ab932c7812d4c67,193,8291,8303,12,21,0,21,2,18,15,3,29,6.68602201,19623,34,6,3119,3068,51,122179,115456,6723,1549,1474,75,81.56329652
9bffa8e424c3d3a20a8fc37ccc8a296fa1ca1292,223,10640,8860,1780,42,0,42,2,7,24,3,29,7.015360559,20279,12,3,3208,3180,28,120043,124082,4039,1603,1586,17,81.18234804
1deaf5e896f04f86e2f95ce10a8ed9a975307c12,223,8854,10629,1775,26,0,26,2,18,15,3,29,7.019369263,20968,40,3,3177,3212,35,124025,120125,3900,1585,1607,22,81.18234804
6f1e48d59e54dd331d1dc10b2a71891ec5a2768c,1,4,4,0,0,0,0,2,5,26,1,1,0,119,35,7,21,21,0,805,805,0,3,3,0,100
6419f94ff71ed3f3ecee949723a81f4db6f10607,244,12590,8878,3712,63,0,63,1,7,24,3,36,7.179047388,20284,13,4,3423,3181,242,128847,124100,4747,1756,1586,170,78.61089187
495f7394e3a8f8c64e1ec1fda7fc5ea10b83f0e0,244,8858,12570,3712,26,0,26,0,18,15,3,36,7.180518333,22261,41,2,3177,3427,250,124025,128929,4904,1585,1760,175,78.61089187
63148d07dc3f73259793011debed7086fcb4c9e8,22,982,148,834,5,0,5,1,14,35,2,13,3.72503192,2850,36,8,525,442,83,22351,18891,3460,268,219,49,93.04812834
ab0637a80e6b1aa37b9e7308868935f5e61d6c7c,249,12583,9737,2846,63,0,63,1,7,15,3,38,7.22315374,20882,14,5,3415,3264,151,128739,127560,1179,1748,1635,113,78.34710744
2f958780ac2d7a6a0bb3bde64201558cf4d7a981,260,10562,12996,2434,40,0,40,0,18,15,3,39,7.316470563,23193,37,9,3475,3601,126,133508,133870,362,1705,1803,98,74.81542248
3dfb0b1013e397624927e364844db304be740f54,271,14839,10616,4223,71,0,71,1,7,7,3,40,7.416523306,22166,15,5,3743,3495,248,142450,134063,8387,1854,1728,126,66.48841355
6e175c6b20531a8d7939205fe6173252af34c70e,271,10594,14912,4318,39,0,39,0,18,15,3,40,7.418540047,24939,38,10,3486,3748,262,133732,142735,9003,1709,1859,150,66.48841355
2d7cea67554177d00732a36c6676c3760c768bb1,3,19,2,17,0,0,0,2,7,44,1,3,1.267770216,470,39,9,89,87,2,3010,2861,149,51,51,0,100
1f8f5959ec24f5aae57419a9047477337bd0693b,282,17773,10689,7084,82,0,82,1,7,7,3,40,7.483670545,22206,16,6,4126,3508,618,158033,134436,23597,1958,1732,226,70.49924357
8e3b66a17c532c63b2ec36f17af9d68628a924b1,3,579,3,576,2,0,2,1,4,2,2,3,1.078644235,35,17,7,78,3,75,4008,154,3854,21,3,18,98.81744272
5514f6050c4401f10ddfdbd39c4b6fff64efd6e8,15,793,181,612,5,0,5,1,6,35,2,9,3.325743677,1928,18,8,384,338,46,14641,12634,2007,181,141,40,93.99717514
24dd0e92a0cd329321eee2646c4bea4403d70727,289,10790,19070,8280,39,0,39,0,18,14,3,40,7.533821003,28310,40,9,3504,4252,748,134489,164179,29690,1711,2021,310,69.16967509
dddedebe86a8e39f94917e516201f433923bbd6a,0,0,0,0,0,0,0,0,0,0,0,0,0,0,41,10,0,0,0,0,0,0,0,0,0,100
54c0613d76b3cd365377b57389bd60e5aaac9ea8,2,68,1,67,1,0,1,1,10,18,2,2,0.189278431,512,42,2,103,101,2,4153,3664,489,35,33,2,99.8427673
409623a1509ff7d684efb90b317395cd436bfac1,4,1658,7,1651,3,0,3,1,11,14,2,3,1.288424281,257,42,10,299,36,263,10871,1716,9155,43,3,40,99.45355191
8f0c90aa7fecae92769cf9b0cad3b6b7dc40f4f7,1,0,1,1,0,0,0,2,2,0,1,1,0,116,43,3,18,18,0,606,613,7,5,5,0,100
99f8dd8abe718a4e8dd3422b4a6b153f78ba63e5,40,1682,1373,309,3,0,3,2,19,61,2,11,3.728373946,7296,44,4,1087,1045,42,52161,50155,2006,477,458,19,87.79884584
830244f5519c04c186fbde3560f4a61cab635655,0,0,0,0,0,0,0,0,0,0,0,0,0,0,45,5,0,0,0,0,0,0,0,0,0,100
15a03d394227a7c6d95d4dc9f06727db196d420a,1,3,9,6,0,0,0,2,8,1,1,1,0,114,46,6,17,17,0,933,951,18,5,5,0,100
087bb57260ed1c59f7db486ef92491148e42be4a,2,33,1,32,0,0,0,2,6,38,2,2,0.322756959,103,47,7,12,11,1,842,567,275,10,9,1,100
45f5885daaaa3b699910147fe413e779fda06e77,23,2437,23,2414,11,0,11,1,17,42,2,11,3.396271358,2094,48,8,768,391,377,28359,13212,15147,266,174,92,86.67157585
c63979ccff74ed9f6d772ad653a8502c529baf6a,1,3,4,1,0,0,0,2,13,3,1,1,0,337,49,9,59,59,0,2417,2418,1,5,5,0,100
c5956a79d0b4ba1a5a5afe23f004f05851e75a97,3,16,8,8,0,0,0,2,9,9,1,3,0.658351422,702,50,10,108,108,0,4986,5013,27,53,53,0,100
bcebbc526c1e044033c25e239b7b1ff7891ec869,5,29,6,23,0,0,0,2,3,30,2,5,2.150863536,503,51,10,79,75,4,3234,3137,97,42,40,2,100
d551cbb326dd2c7ab006dd5e4575f10cb18c8144,312,19758,16169,3589,88,0,88,1,7,8,3,42,7.585892656,26338,19,4,4314,4275,39,167032,165048,1984,2050,1920,130,72.49373434
d2b46760ae779dd559323aff3324a87bc31760e7,312,16088,19858,3770,57,0,57,0,19,3,3,42,7.590680106,28770,52,10,4259,4320,61,164683,167374,2691,1901,2056,155,72.49373434
4f7773ba7ba723ac9d10f7255cf36eaa21ed9998,1,10,5,5,0,0,0,2,20,17,1,1,0,438,53,11,84,84,0,2767,2760,7,35,35,0,100
57979b54da0b605f8a560c7818635a3fb28eec04,6,284,24,260,2,0,2,1,8,18,2,5,1.214249975,778,54,12,155,125,30,6698,5408,1290,75,58,17,96.61835749
02846c00bddf09e64c2f61e39815064cf71c3644,320,20944,16454,4490,95,0,95,1,7,8,3,42,7.640329331,26494,20,4,4449,4305,144,172521,166430,6091,2120,1937,183,68.96551724
70b015a47fe19eca3f60286e3539995cde072246,320,16383,21025,4642,59,0,59,0,20,2,3,42,7.644462124,29600,55,13,4289,4455,166,165986,172863,6877,1918,2126,208,68.96551724
31e4f1b8c0482cbce52d9bb8e8532ba9c6b9abee,329,21838,16474,5364,102,0,102,1,8,8,3,43,7.670110582,26548,21,4,4504,4303,201,176497,166577,9920,2154,1935,219,67.66169154
b87a811e538c6f29e2d0758d9cb258a1f023a24e,329,16412,21958,5546,59,0,59,0,20,2,3,43,7.674376873,30234,56,14,4290,4510,220,166134,176839,10705,1921,2160,239,67.66169154
b57d3fd9c2353c21d3793b5eeeff222970bbedbd,4,85,51,34,0,0,0,1,2,32,2,2,1.591428803,406,57,15,52,52,0,3441,3188,253,23,23,0,95.04573171
d1fbb4bd2856d74546a7a32e21644ec925784122,2,59,1,58,0,0,0,1,2,44,2,2,0.687315093,1165,43,0,239,230,9,8415,8053,362,35,34,1,100
0352a55c6da0cc3a6de0fd379dff3c92e19d8e8b,2,52,2,50,0,0,0,1,3,0,2,2,0.228538144,1213,44,1,248,239,9,8725,8415,310,36,35,1,100
3a2d3519c857b7b070977481804cc11e5075ab75,330,22030,16680,5350,102,0,102,1,9,8,3,43,7.672255827,26704,22,3,4531,4322,209,177431,167650,9781,2158,1940,218,67.80523256
4ad82d3f700713559c99225822940e68bb1073ad,332,16596,22173,5577,59,0,59,0,20,2,3,43,7.680579069,31953,45,2,4583,4812,229,175562,186223,10661,1962,2203,241,67.80523256
993abd8af08d0d442822cc57f201f7c6b372a66d,1,3,3,0,0,0,0,1,4,14,1,1,0,1096,46,3,225,225,0,7829,7829,0,29,29,0,100
8e5bc40b43cd2158b24eea80af0c485426f193a4,3,64,16,48,0,0,0,2,7,57,2,2,1.523195879,591,47,4,60,55,5,4407,4156,251,41,38,3,96.94779116
ef85e100e1fdd8005091231b8f2f602d66c80772,2,24,14,10,0,0,0,1,6,2,1,1,1,224,48,5,35,31,4,1419,1421,2,18,18,0,96.91558442
1c7e2fc92a59fc6793d9809de7070e4857b24427,2,24,8,16,0,0,0,2,8,27,2,2,0.954434003,578,49,6,57,56,1,4210,4133,77,32,31,1,100
541259efe2511225567d0ba4c7faab74926944f4,1,7,1,6,0,0,0,2,5,30,1,1,0,243,50,7,39,38,1,1396,1378,18,13,13,0,100
433dd71e6de29a268c92825f74bd6e3b0c5d1ab2,345,24255,16791,7464,115,0,115,1,9,9,3,44,7.704016679,28311,23,1,5060,4608,452,195686,176497,19189,2294,1983,311,66.9630643
76dcb17d604491cffa21bfa1269ec1545ecd054c,346,16769,24388,7619,60,0,60,0,20,2,3,44,7.715442127,33468,58,2,4601,5066,465,176282,196028,19746,1968,2300,332,66.34746922
e7aeda25fe2b38f3c22fb80f3a8f9d031a47370b,1,2,2,0,0,0,0,2,9,0,1,1,0,404,51,8,29,29,0,2980,2990,10,23,23,0,100
c9845ac9b5c2c123eaace130ec5de56bdaf17847,4,17,53,36,0,0,0,1,21,43,1,4,1.170185159,1337,59,3,244,250,6,9105,9277,172,72,73,1,100
4093359dda9b6d39b778a695e97303225b5844a6,3,45,3,42,0,0,0,2,6,124,1,2,1.335137438,423,52,9,68,63,5,2445,2292,153,26,23,3,99.5308835
0c8983aec5cfcbec76ace31610d2018e7f4e7a74,19,303,462,159,1,0,1,2,10,53,1,1,3.953640324,2445,60,4,256,264,8,16749,17631,882,121,142,21,96.92780338
189f1749081f777012cde9624e0ca91f6ed2c9bb,11,78,20,58,1,0,1,2,10,100,1,4,1.952111796,1761,61,3,319,311,8,10927,10610,317,155,149,6,93.81898455
3c63ebeca4b399ec62bd0db7e1f49e17a3733921,3,48,8,40,0,0,0,2,11,69,2,3,1.21785896,696,53,10,82,76,6,4901,4732,169,48,47,1,100
8904438e8f18d4f3fbdf42adb3492aa9990874c4,2,28,3,25,0,0,0,3,15,90,1,2,0.770629069,556,54,11,117,113,4,3656,3507,149,62,62,0,100
b9c0180be1aa33ac7ee34cb37b3cfc178377f301,358,25955,16994,8961,123,0,123,1,9,8,3,44,7.7797714,28528,24,2,5268,4659,609,205014,177607,27407,2409,1994,415,69.09518214
5ab0ea3e8e0bc9d900271efbe0928a40d1bcaebf,358,16886,26086,9200,62,0,62,0,21,2,3,44,7.785591534,34879,62,4,4633,5273,640,176897,205299,28402,1965,2414,449,69.09518214
060e98fe055c106dd55ea779aa5678aea12d39b1,359,26295,16992,9303,124,0,124,1,9,8,3,44,7.782538818,28528,25,3,5314,4659,655,206707,177607,29100,2417,1994,423,66.32191338
a2cd4c8948eb9261ddfd0b55c1b742f146c25b41,359,16887,26426,9539,62,0,62,0,21,2,3,44,7.788292715,35087,55,12,4635,5319,684,176917,206992,30075,1965,2422,457,66.32191338
e061f06f2d56c14eb7edbe9c2f2c7fad6c9724d9,1,4,1,3,0,0,0,2,6,0,1,1,0,191,56,13,32,30,2,1260,1240,20,9,9,0,100
e9c035c3ea29237f2098fc1484bfff6093601da2,361,27022,18478,8544,126,0,126,1,10,0,3,44,7.813335411,28534,26,4,5183,4669,514,205280,177804,27476,2319,2000,319,66.52694611
96a1a8a0cbc434844c093223e124b0d777808ad5,361,18518,27176,8658,75,0,75,0,21,2,3,44,7.815549887,34606,57,12,4648,5189,541,177653,205622,27969,1970,2325,355,66.52694611
8b473971fadc6ef087c654e52ab6ab1442dde25a,0,0,0,0,0,0,0,0,0,0,0,0,0,0,58,13,0,0,0,0,0,0,0,0,0,100
31cc2b1c08fd98a1a7afe279e2ee38e14076a364,3,31,5,26,0,0,0,1,15,30,1,3,0.803071727,905,63,5,169,169,0,6623,6593,30,38,38,0,100
066bec044cf7918024dd1b47849e0a04a34421ca,366,27589,18629,8960,131,0,131,1,10,0,3,45,7.837177446,28641,27,4,5248,4680,568,208617,178550,30067,2360,2005,355,63.45646438
bdf092116f346351f62de2e0117b8b7d759fe8ee,75,5987,198,5789,22,0,22,1,9,31,2,19,4.889527505,6854,28,5,1726,1217,509,65960,40451,25509,824,571,253,90.45848823
545d6baaf280a323379b4a757045022d34c732bf,31,674,292,382,0,0,0,2,11,0,2,4,3.726323604,3377,29,6,651,588,63,18875,17027,1848,301,272,29,99.93710692
66104f89f23f6a3cb0cdbe0035fa0a321b2ca8d5,42,2504,2504,0,0,0,0,1,12,29,3,12,4.477437569,8334,30,7,1430,1430,0,46829,46829,0,580,580,0,100
6e3fd709da09f2ad14713d5ee02ae949f1a20d45,19,2610,408,2202,0,0,0,1,10,8,2,5,1.759235036,2589,31,8,612,449,163,26519,14283,12236,244,183,61,98.26410415
3ddbfb832adf1940374ba32ad6c7bbf932255c27,3,230,0,230,2,0,2,1,8,1,2,3,1.144229934,75,32,9,46,16,30,1645,589,1056,38,16,22,97.2972973
4cc5bf4d53d2f8c826a8234381f134c4136869f9,33,3026,1130,1896,9,0,9,1,11,32,2,11,4.069889248,4764,33,10,837,687,150,47687,34583,13104,424,349,75,90.75425791
c9071e333e029cbd091dc1fd173c60eae9bc67f2,10,303,189,114,0,0,0,2,13,25,2,3,2.115448894,1592,34,10,240,220,20,8606,7968,638,135,123,12,99.81167608
e2a8f91a4f646047eaa1749910764608ac2b80e4,15,232,259,27,1,0,1,1,7,10,2,6,3.035273941,2795,35,11,382,382,0,19466,18945,521,193,194,1,90.57692308
865f5f9f1068602110fede8c37247aac019c2c01,1,22,0,22,0,0,0,2,8,8,1,1,0,716,36,12,101,98,3,2948,2871,77,79,76,3,100
79904584108c1c32a864aebad6faf4b51fb87452,13,262,109,153,0,0,0,2,10,53,1,4,0.908028228,2183,37,13,488,439,49,13514,11963,1551,191,160,31,93.84203481
efff68d335434b41494604598fdd14a27f1126f6,6,1916,36,1880,2,0,2,1,9,5,2,3,1.313919971,1364,38,14,382,126,256,23320,11476,11844,120,82,38,88.77216021
e21a1f2951337996bff39b1c32f020239a5b336a,48,202,4210,4008,0,0,0,2,9,222,2,11,4.843265773,5846,39,15,352,831,479,16560,37627,21067,157,373,216,86.09656777
0a1bb636d1531747fe921496ad22d94a43838783,8,80,72,8,0,0,0,1,11,10,2,3,2.64626303,3668,40,16,495,496,1,23339,23445,106,200,200,0,100
aaab42dddad4c7152ad595fe2a7542cbf667d935,22,592,603,11,1,0,1,1,10,47,2,13,3.697290599,3024,41,17,408,407,1,17186,16745,441,208,217,9,89.56857695
ed2409532ed6743ed82a07db84dcf6e53f4a4d0e,11,2058,312,1746,2,0,2,1,12,15,2,6,1.930324205,2206,42,18,657,420,237,25278,14265,11013,208,129,79,90.92198582
ded7bd765bc97b6af998b65bab3d9221a7b5fce2,2,35,10,25,0,0,0,1,7,2,1,2,0.996791632,689,43,18,92,88,4,3666,3479,187,41,41,0,100
f1e3e3262e568420a1c893ec79d248401755345f,20,4274,1008,3266,4,0,4,1,14,6,2,6,2.597622482,4956,44,18,1027,862,165,48582,32934,15648,308,237,71,95.72158365
fee0f2c3f9c9cd12e4bf40ca424b745e2741cd6e,6,33,24,9,0,0,0,1,11,2,2,3,2.314520926,1710,45,18,229,227,2,9430,9419,11,149,149,0,100
3f54d899be023f0382abff189079f4ec8d0f09eb,416,23101,45889,22788,114,0,114,0,21,2,3,47,7.890649811,45639,59,2,4719,6488,1769,180513,286094,105581,2005,2847,842,57.22972973
d608efb2979ee28615a29cb36704241fd084309a,416,45955,23128,22827,179,0,179,1,14,1,3,47,7.891147922,28967,46,19,6492,4752,1740,285963,181888,104075,2845,2038,807,57.22972973
ffb864b1bf4ce873f70012db6bd97829afeaf55b,94,227,389,162,0,0,0,1,13,7,2,14,5.961732205,16752,47,20,2325,2106,219,112507,103941,8566,990,928,62,82.76539974
b45cc49b4b6ba7fb07224ee98e02a7ffe06ae15f,414,23104,45735,22631,113,0,113,0,21,2,3,43,7.885619157,45526,60,2,4722,6489,1767,180759,283624,102865,2006,2842,836,55.03122831
ac4e323281c247f8edd9aa4af40a27b154e7f112,415,45764,23142,22622,177,0,177,1,14,1,3,43,7.887478506,29021,48,21,6504,4756,1748,283829,182183,101646,2854,2040,814,55.03122831
09290b02bcc5dc41d89f0a5c1ffe08c9e6ecb3d9,1,51,73,22,0,0,0,2,13,3,1,1,0,367,49,22,70,71,1,2549,2556,7,34,33,1,100
70ea5d06877e1c7e2c3a398e92261504c3f6343f,120,148,110,38,0,0,0,1,15,4,2,14,6.822825996,21102,50,22,3068,3077,9,135837,135457,380,1418,1423,5,93.49865952
106cd728fc32e710611d01c7c1573e5415b5fbad,2,3,2,1,0,0,0,1,10,14,2,2,0.721928095,682,51,23,139,139,0,4059,4038,21,46,46,0,100
a01533fd51624c20f4cc854bf7c2d6b4308fcc1e,4,95,24,71,0,0,0,1,7,0,2,3,0.909142868,1489,52,24,217,202,15,11596,11297,299,92,91,1,96.95922598
42a0384e358e314f59edb1cdbbd5173bbb569348,2,3,17,14,0,0,0,1,15,9,1,2,0.468995594,560,53,22,123,124,1,3576,3663,87,73,73,0,100
47e738d6a9a320c7b6abace48aeef35b88cd262b,1,1,0,1,0,0,0,1,11,2,1,1,0,423,54,23,68,68,0,2559,2552,7,23,23,0,100
0f9ab3fffe28ec45ce2e04f867c597c788e861f7,8,535,10,525,3,0,3,1,14,0,2,4,2.140214657,2500,55,24,437,353,84,20055,17214,2841,251,221,30,93.92156863
2e0b52307830e6bebf5e905f14d0addfd165d858,420,23211,46429,23218,115,0,115,0,21,2,3,43,7.909615625,46084,61,2,4723,6601,1878,180813,287677,106864,2007,2886,879,55.29411765
faf1756f531aec29b4a49e5a3100b7cf9ae53b1c,420,46485,23254,23231,182,0,182,1,16,1,3,43,7.909823739,29022,56,25,6604,4756,1848,287510,182188,105322,2886,2040,846,55.29411765
a0670ff9bcae6c0d34cc3523966f3c8ddcae2e9e,420,23205,46442,23237,115,0,115,0,21,2,3,43,7.909551674,46096,62,3,4723,6604,1881,180799,287782,106983,2007,2886,879,55.29411765
517c67507a7a7a3f3113f04f3c46e89015481e59,1,4,1,3,0,0,0,2,9,18,1,1,0,315,63,4,82,82,0,2092,2076,16,35,35,0,100
6a206f7330c68636e9658a3bf17bb9c0098e11b8,420,46497,23251,23246,182,0,182,1,16,1,3,43,7.909459844,29022,57,23,6603,4756,1847,287585,182190,105395,2886,2040,846,55.29411765
c42e2b56700373e60d6be0673eea293490cd7a1d,8,49,293,244,0,0,0,1,14,9,2,5,1.83642493,3291,58,24,406,409,3,23128,23368,240,190,193,3,100
987df943dc84ff64cd1d204c2f9d96db0d6acc99,420,23448,46422,22974,115,0,115,0,21,2,3,43,7.909733904,45912,64,5,4729,6600,1871,181989,287617,105628,2008,2883,875,56.19781631
a27423e9bffcbc31306cdd7347f856f115fa0d92,434,48441,23490,24951,196,0,196,1,16,1,3,45,7.969072072,29040,59,19,6784,4729,2055,294087,183100,110987,2966,2008,958,54.18559377
1794b7a84bf15bd45247170f8fb0c3f42e506b1c,3,17,9,8,0,0,0,1,8,25,1,2,1.548580607,1096,60,18,181,178,3,8178,8137,41,69,68,1,100
ecb9983009e3c6dfbeb510b71ea3e57119b7e746,8,386,137,249,2,0,2,1,9,103,2,5,2.466558291,1151,61,19,286,265,21,8250,6794,1456,89,76,13,99.51159951
c3d78e79c6c759302948b6675858a5a9280f9dec,436,23447,48655,25208,115,0,115,0,21,2,3,45,7.980359118,47439,64,0,4729,6808,2079,181989,295974,113985,2008,2980,972,53.97543633
5c7430ed96ed086175c7f0a300d6df53c95a2e56,444,49530,23489,26041,206,0,206,1,16,1,3,45,8.009160102,29040,62,12,6886,4729,2157,299266,182999,116267,3033,2008,1025,55.59610706
e8d6dc6ce452072a737b2112bdda0c25f31b1bf6,444,23447,49488,26041,115,0,115,0,21,2,3,45,8.008888091,48073,0,0,4729,6886,2157,181989,299630,117641,2008,3033,1025,55.59610706
ed13599edac2c374ab25b74c67f2e087f18d2bac,2,137,0,137,2,0,2,1,1,0,1,2,0.988864204,0,65,3,3,0,3,565,0,565,3,0,3,92.72131148
f89d926ae53a407f38c65b0b9aaca95bc024dd19,2,124,3,121,1,0,1,1,22,60,2,2,0.87044411,404,1,1,89,75,14,2897,2512,385,43,34,9,94.864397
3c81fd04e6c091d156d4b940b931e098d2efa51e,1,4,2,2,0,0,0,2,15,77,1,1,0,524,66,1,103,103,0,3808,3826,18,31,31,0,100
70483b3a1368256b037882c530721f4cae8236fc,38,3122,0,3122,38,0,38,1,1,0,1,2,5.043402562,0,67,2,210,0,210,12668,0,12668,145,0,145,86.59734258
37c84cea2c48430147a52cf23f37e7f0a6a6b751,485,49514,26914,22600,206,0,206,1,16,1,4,48,8.143469237,30813,63,1,6886,4956,1930,299417,196599,102818,3015,2165,850,53.40710542
d106770946d27d77fdf083ca4b005100234e52b1,486,26977,49472,22495,157,0,157,0,23,1,4,48,8.147179199,48043,68,3,4970,6886,1916,196141,299781,103640,2177,3015,838,53.11496468
a3ead3e114f66bfe56732366cc7c2a8a7f13a1dd,486,51193,26915,24278,206,0,206,1,16,1,4,48,8.100389572,30889,64,2,7170,4970,2200,309447,197151,112296,3058,2177,881,53.83631714
8bae455a0cd4383fb7959cbbe973c5c537c9a969,69,1214,614,600,1,0,1,1,13,72,2,11,3.299797508,13279,65,3,2290,2256,34,87548,84177,3371,793,784,9,91.68765743
2725a7168b5882f90e36719fb000f24d5a5b33c2,8,347,36,311,0,0,0,1,15,40,2,4,2.116269789,5078,66,4,763,724,39,34316,32531,1785,246,239,7,100
3c7ca4fa8a077033538a59171d8a173388699ffe,494,27376,52065,24689,161,0,161,1,23,1,5,49,8.120156043,50183,69,4,5005,7259,2254,198372,315483,117111,2191,3090,899,54.22360248
06841eb7fd7e493adefef17e0908f0ce87c8fa9c,495,52087,27441,24646,207,0,207,0,17,1,5,49,8.121868419,31306,67,4,7243,5038,2205,314633,199777,114856,3074,2224,850,54.22360248
f93ba26348d2edec785c2b8e370a59b70603951a,495,27505,52049,24544,161,0,161,1,23,0,5,49,8.121522135,50206,70,4,5026,7259,2233,199012,315513,116501,2197,3090,893,54.22360248
efee830bd3aba5e3503442ad8ea18f9d6b1bdac1,2,53,4,49,0,0,0,2,14,118,2,2,0.58515699,674,71,5,71,64,7,4915,4691,224,27,26,1,100
95a308b1a380e67cde0715bcdc2fbae7f1dbbab4,1,67,14,53,0,0,0,2,7,164,1,1,0,140,72,6,27,25,2,1102,917,185,4,4,0,100
92c7bd383db0522a51d6c816dbfbde446782a9a1,492,51806,27657,24149,204,0,204,0,18,1,5,49,8.114365005,31444,68,5,7231,5068,2163,312312,200796,111516,3043,2231,812,53.74677003
f611fe75e452a59d7eafa19828ad87856e6fc84f,29,1476,89,1387,8,0,8,1,19,54,2,10,3.960603406,3561,69,6,764,621,143,28885,23713,5172,332,251,81,87.80626781
b49a3cb22e41f829d128e4ee0ddb543b9a9d9e76,2,3,233,230,0,0,0,2,8,62,1,1,0.170895224,439,70,7,35,64,29,2054,3491,1437,8,18,10,100
8c5a15c048dc55f1c8fae19ecf2c10445fd217c0,7,175,18,157,0,0,0,1,17,22,2,3,2.135669286,2229,71,8,343,325,18,14114,13202,912,194,188,6,100
ad8866b8074945de143146121827b741d6959e9b,503,28575,53239,24664,165,0,165,1,23,0,5,50,8.156775768,50889,73,7,5111,7378,2267,203933,317784,113851,2230,3135,905,52.05167173
359e3f0aadb664be357caf77049d1c66cd315fe6,504,53449,28616,24833,213,0,213,0,20,1,5,50,8.161919341,32029,72,9,7403,5144,2259,317944,205308,112636,3155,2263,892,53.25177077
03196afe596a3c95c3b9f3ce6aa12d79394fbf7f,504,28579,53412,24833,165,0,165,1,23,0,5,50,8.161706303,51018,74,6,5111,7418,2307,203933,318769,114836,2230,3170,940,53.25177077
47ae9f104e50d9353a905dadb2e677acdc0fbddd,504,53446,28613,24833,213,0,213,0,20,1,5,50,8.161644594,32029,1,0,7403,5144,2259,317948,205308,112640,3155,2263,892,53.25177077
f90407b5c60078b13a8facbeb67eacffd1913260,0,0,0,0,0,0,0,0,0,0,0,0,0,0,2,1,0,0,0,0,0,0,0,0,0,100
ffed5bd8f270c5af03a56726f8c4057ba075f0d1,500,30205,53004,22799,165,0,165,1,23,5,5,50,8.185053387,50962,75,6,5078,7390,2312,204353,319468,115115,2209,3154,945,53.25177077
5709af90fe63f99142281ad78480542c2dd8aab1,0,0,0,0,0,0,0,0,0,0,0,0,0,0,76,7,0,0,0,0,0,0,0,0,0,100
59b7509a891a38c4279120c890448438b7441c5d,500,52606,30246,22360,212,0,212,0,21,1,5,50,8.182162519,33894,73,6,7196,5078,2118,320577,205703,114874,3194,2209,985,49.06275469
371873b914b80446e3fa21a743adb7942ff1d24b,2,15,2,13,0,0,0,1,13,13,1,2,0.936667382,725,74,7,232,222,10,4558,4400,158,50,50,0,100
c9d01d2acc7f68a24243f5f7932495ea29a94ca6,3,94,22,72,0,0,0,2,15,35,2,3,1.56646849,954,0,0,211,186,25,5358,4911,447,52,49,3,100
761cd1ebbfb9beb3534ddbd2398cce1032963571,27,317,165,152,0,0,0,1,19,14,2,6,2.106926292,8066,75,8,1058,1056,2,55736,54589,1147,394,392,2,100
98335a545d03503ddcc29b7928ee57e679df5d38,1,13,8,5,0,0,0,3,18,22,1,1,0,810,1,1,127,124,3,3697,3635,62,98,96,2,100
7e473d164bb8149d5558d29c5f46219f5b9b27fc,2,131,5,126,1,0,1,1,10,20,2,2,0.923119984,348,2,2,88,74,14,2603,2179,424,37,28,9,99.85074627
328e74e39b0fa5be55fdc7273c559d07e438be7b,4,38,9,29,0,0,0,2,20,15,1,3,1.916534517,618,3,3,111,109,2,3688,3639,49,49,47,2,100
18a0a9dff2a17455b73d2438f76704b6fb8a46a7,1,2,2,0,0,0,0,2,10,3,1,1,0,312,76,8,39,39,0,2495,2477,18,17,17,0,100
4f9fdd344ba380be9e8da1ef0caff2abbbfba3c3,499,30076,52834,22758,164,0,164,1,23,5,5,50,8.173821692,51045,77,7,5067,7261,2194,204151,323752,119601,2200,3223,1023,49.3083808
e94af59b1ee3b64781bb21e6eb8f664e3d044ad6,499,52919,30113,22806,212,0,212,0,21,1,5,50,8.174502403,33825,77,9,7251,5067,2184,322891,205501,117390,3209,2200,1009,49.42731278
6a85af7c124af67f8d81390d28a72dae531f1fba,18,447,304,143,0,0,0,2,19,65,2,9,3.135151832,3976,78,10,568,530,38,29662,27618,2044,212,198,14,95.93165175
349039f26245155600d4cacfabdce4729c1487e1,3,38,2,36,0,0,0,2,22,21,1,3,0.772558571,1403,3,2,253,244,9,10115,9904,211,94,91,3,100
ada8065f47e499d13e9cee18f280ff469f9651b5,1,253,0,253,1,0,1,1,1,0,1,1,0,0,4,3,16,0,16,1575,0,1575,7,0,7,99.69395562
34c1d26d1a3fed288780b235b8e9a09725c0bfb7,2,175,8,167,0,0,0,2,8,1,2,2,0.481005021,429,4,4,60,56,4,4296,3263,1033,27,25,2,100
ed32eaca49543a7dfc29bcc0f5b398cf69bcbb77,2,312,0,312,1,0,1,1,19,3,1,1,0.078232465,817,5,5,159,127,32,5128,3697,1431,116,98,18,99.69512195
340fbf263c910d3f5c84186c1d7d8dd8b767472b,501,30070,53787,23717,164,0,164,1,23,5,5,50,8.181280592,51761,78,5,5067,7369,2302,204151,330230,126079,2200,3272,1072,50.69958848
4a3446a21f58e92e43c8ed3a33a6dc04eaebbc07,501,53851,30107,23744,214,0,214,0,22,1,5,50,8.180988922,33825,79,10,7354,5067,2287,329384,205591,123793,3253,2200,1053,50.69958848
4974049abd07ae75464882c6137facefaa45e510,501,30070,53814,23744,164,0,164,1,23,5,5,50,8.180751107,51787,79,6,5067,7373,2306,204151,330429,126278,2200,3272,1072,50.69958848
bd5b87e9af87418a20d3d29e8aa2e16b1ab79777,0,0,0,0,0,0,0,0,0,0,0,0,0,0,80,7,0,0,0,0,0,0,0,0,0,100
71a50082e38128823c3fe8c4a4ec52a6b71e7c97,0,0,0,0,0,0,0,0,0,0,0,0,0,0,81,8,0,0,0,0,0,0,0,0,0,100
84fb9c76399cdd1bcb0620f869126638bd221dd7,501,53858,30107,23751,214,0,214,0,22,1,5,50,8.180908525,33825,6,6,7355,5067,2288,329468,205591,123877,3253,2200,1053,50.69958848
39fa36f10bed6be745d2600aa1fb11123c35d24d,501,30070,53821,23751,164,0,164,1,23,5,5,50,8.180670552,51794,82,9,5067,7374,2307,204151,330513,126362,2200,3272,1072,50.69958848
a189e2421abe9dd98ddc80a40d2d7232294db72b,529,58103,30237,27866,242,0,242,0,23,1,5,50,8.277099328,33825,7,7,7866,5067,2799,352112,205951,146161,3463,2200,1263,52.30642504
12ec8a571526d98028c3835fd490e5e1e7e7eb04,1,8,4,4,0,0,0,1,5,47,1,1,0,252,80,11,68,68,0,1847,1848,1,18,18,0,100
18a1807e56459831d97591f5034fc94dc2036ea6,529,30180,58050,27870,164,0,164,1,23,5,5,50,8.276334207,55140,83,10,5067,7888,2821,204151,353321,149170,2200,3485,1285,52.30642504
5b800ea0b64fb4320dab065014c84659f3013fb9,0,0,0,0,0,0,0,0,0,0,0,0,0,0,84,11,0,0,0,0,0,0,0,0,0,100
ae466bb6285c1656d27ac0b2add855df093b4c06,530,58120,30237,27883,242,0,242,0,23,1,5,50,8.277041847,33854,81,9,7886,5069,2817,352545,206032,146513,3466,2202,1264,52.30642504
451b8f363a688c73b23c003acb18049c014ec8d3,3,46,5,41,0,0,0,2,18,33,2,2,1.092482292,2256,8,8,409,403,6,13332,13155,177,66,64,2,100
ec3a217d5ba9405cf206332d1802e1045bb5e331,1,58,1,57,0,0,0,3,20,17,1,1,0,820,9,9,132,127,5,3899,3712,187,102,98,4,100
14beb059d514585bec8ff18afd21d5893f20a792,7,173,50,123,1,0,1,2,9,31,2,5,2.169675491,1188,10,10,230,225,5,7962,7530,432,96,93,3,99.5423341
526cf36ec31da04c12e114062325d9f3af642183,3,18,5,13,1,0,1,2,10,69,1,2,1.353448505,327,5,2,71,71,0,1977,1965,12,26,26,0,99.07264297
83b76d7e1d1b4af547f833cee5e520ac77933515,2,39,1,38,0,0,0,2,11,244,1,2,0.769192829,345,6,3,71,66,5,2254,2050,204,19,19,0,100
3ddd0266b512cd93b1e5452762a40f54381b655c,15,104,52,52,0,0,0,2,11,189,2,8,3.498392857,2018,7,4,323,314,9,12685,12338,347,172,170,2,100
4b10358d708e44188246057d928b7720ffb4602d,3,53,20,33,0,0,0,1,7,87,2,3,1.113121352,365,82,9,56,52,4,2565,2389,176,27,27,0,100
cad0625413efbf8f733a4d1ef4836cd98a74a3ed,0,0,0,0,0,0,0,0,0,0,0,0,0,0,8,5,0,0,0,0,0,0,0,0,0,100
d9acf5eba4a215f7a66f31026b5fed4cb5738722,531,30126,58366,28240,163,0,163,1,23,5,5,50,8.276978995,55453,85,8,5069,7941,2872,204232,355235,151003,2202,3498,1296,51.71261487
605ea80fb2b6613af14c5691bda1f11befafa3e0,531,58451,30094,28357,243,0,243,0,23,1,5,50,8.27668989,33854,9,6,7924,5069,2855,354782,206212,148570,3480,2202,1278,46.2962963
1d43e049077d22e7e5bddc76f43df302769d39d0,3,49,5,44,1,0,1,1,5,79,1,1,1.426573285,416,10,7,80,74,6,2620,2438,182,34,33,1,99.88901221
8e88ceafd6416130bd79cab2ecc37438f88d1ca6,1,0,3,3,0,0,0,3,10,18,1,1,0,757,83,8,95,91,4,7953,7487,466,26,24,2,100
624e4bc284ec612fd2edbf46b22afc1aa3e5e4fe,9,27,50,23,0,0,0,1,24,67,2,4,2.734032766,3044,84,9,409,412,3,21778,21944,166,218,220,2,99.72283814
db6c05b21ebd2af410b0ba2fcbf4e01cc9b4724e,37,841,478,363,1,0,1,2,25,100,3,13,3.198281584,7750,11,8,1155,1106,49,53288,51289,1999,545,529,16,99.05817175
958cec17b2b7db0cfcac394c69074b0a07e62e4d,3,157,5,152,2,0,2,1,12,1,1,3,1.182865126,306,11,10,63,49,14,2951,2267,684,18,14,4,99.5584989
1a94f5b83ae1653b4fa74c9b2606f4bacc677c02,2,24,8,16,0,0,0,2,17,25,1,2,0.69621226,489,12,11,104,99,5,3532,3396,136,32,31,1,100
687e8c71f97f3eb0137b1c6c132377848c3889ba,135,580,876,296,0,0,0,1,26,24,2,23,6.338229778,27046,85,9,3670,3210,460,187232,161192,26040,1560,1343,217,76.74190383
0f50b8fdfd09e094a78aa5cdb7aa4fa14ee5d499,1,124,0,124,1,0,1,1,1,0,1,1,0,0,12,9,10,0,10,519,0,519,9,0,9,95.98662207
9b4441ab78a7e07dc1c0ff320d9056c64ebe210e,2,78,0,78,0,0,0,2,7,46,1,1,0.477071306,428,13,9,66,48,18,1680,1369,311,50,32,18,100
40afe4367a5141eb9c80c42f5c59335f91df1ee3,3,179,29,150,1,0,1,1,2,0,2,3,1.118480017,132,14,10,37,24,13,1379,677,702,19,13,6,98.43014129
dcaffe95f8acafcfa6dae4c165f04738dd46b42a,532,29412,58374,28962,163,0,163,1,23,5,5,51,8.279736284,55888,86,8,5061,7985,2924,203823,360938,157115,2198,3511,1313,52.82392027
912c8e5d285ae02fcd2c3af0cf2d5b7da251cf9f,533,58459,29381,29078,246,0,246,0,27,3,5,51,8.279149676,33808,13,10,7996,5065,2931,361249,206074,155175,3514,2200,1314,52.82392027
0163cf54e2c44bd711f3e9c2f66f7f27d55eea85,3,113,61,52,0,0,0,3,23,20,2,2,1.21766266,1175,15,11,174,174,0,5977,5669,308,121,119,2,91.2202381
f1cf4972b3a79efacd7dc3d7bff7eff17f6f13b3,1,4,4,0,0,0,0,3,3,13,1,1,0,91,16,12,8,8,0,618,618,0,4,4,0,100
b0e4f2cbf67138696be88612874ecb12e8190870,4,184,4,180,1,0,1,1,9,8,1,2,0.767229817,765,14,11,165,135,30,5798,4962,836,45,38,7,99.90654206
8345716f3ae9f4d2ddbddf13044dddb9270bbeff,3,26,8,18,0,0,0,2,28,4,1,3,1.56140279,803,15,12,153,150,3,5411,5307,104,69,67,2,100
88dec1ea992a5c070a7e2d0be0309fab76ff90c7,1,24,0,24,0,0,0,3,24,3,1,1,0,906,17,11,133,131,2,4517,4296,221,104,102,2,91.29574679
dfe99d28e408904fc397f82d86c9224cc301d750,21,1173,41,1132,4,0,4,2,25,26,2,9,3.644486984,5602,86,6,916,747,169,45606,39639,5967,491,408,83,89.81527708
3a1bf0d21c29b2afc7ee43834b85a15ba25c6b5e,7,109,21,88,1,0,1,3,29,24,2,4,2.342841147,2301,16,11,352,340,12,14081,13833,248,205,199,6,90.01482946
2ed6f2957488809c8ef1500a44d890ddd8b653c9,4,76,4,72,0,0,0,3,23,16,2,3,1.731462735,2653,87,6,504,491,13,17609,17165,444,93,88,5,94.59071326
4f14e7a2dc4814071ee229f19e954cf765cadf31,7,300,236,64,2,0,2,3,15,14,2,4,1.982747941,1652,88,7,338,316,22,11805,11144,661,80,68,12,99.77688532
8e5be0abb67830e8bf6c1d54e412f9bdbbd0e176,2,5,5,0,0,0,0,2,3,16,1,1,0.970950594,227,89,8,30,30,0,1849,1834,15,5,5,0,100
16cc2ff4aa21a8a00d9abea08a70be836afd9053,1,2,4,2,0,0,0,1,2,21,1,1,0,95,90,9,15,15,0,764,784,20,8,8,0,100
c1ab3965657338545515d14badedb9c54adb2a72,1,49,9,40,0,0,0,1,3,11,1,1,0,841,91,10,128,127,1,6827,6844,17,37,35,2,100
5238c02ffc7f43f42e8384aaa2e07fe0dd16ff1a,2,30,4,26,0,0,0,3,12,35,2,2,0.602430802,906,92,10,135,129,6,9019,8850,169,36,36,0,99.86642921
32ce2bbee4d2a89a8a95f284b8e3d05dd373b236,1,1,1,0,0,0,0,1,3,3,1,1,0,306,93,11,49,49,0,2290,2290,0,14,14,0,100
33dce6e8a678e3e8443fab5ec7c7db136327cdbb,540,29329,60078,30749,162,0,162,1,23,6,5,52,8.304021288,57316,65,0,5069,8254,3185,204083,370576,166493,2201,3635,1434,53.06365259
51884748e21c9c7744c4390a7b66fa51f1fc24c8,540,60703,29387,31316,253,0,253,0,29,3,5,52,8.301748632,33822,94,11,8352,5069,3283,373976,206153,167823,3693,2201,1492,51.46794488
98bd230c46c0fa57f14c8b19ebb050b966742546,60,1804,341,1463,4,0,4,1,19,13,2,15,5.068488211,10320,95,9,2008,1824,184,75601,68347,7254,835,759,76,94.75571493
306c874a57eb65bad198514cc267a419fa0d426b,70,4078,721,3357,8,0,8,1,9,8,2,10,5.302683606,11179,96,10,1931,1472,459,96811,79698,17113,743,621,122,88.6036961
fd647e761a05ca9c98d8583918a005127d466ddc,1,5,0,5,0,0,0,3,30,30,1,1,0,406,17,1,84,83,1,2966,2936,30,36,36,0,100
b06c2f4165260a84551fc8d8bccb906e722a2b18,1,11,0,11,0,0,0,3,10,51,1,1,0,86,18,2,21,19,2,572,506,66,11,10,1,100
c100f0f2313821525ba77af43585110e781952da,1,2,2,0,0,0,0,2,2,51,1,1,0,263,19,3,33,33,0,1702,1700,2,16,16,0,100
8b788671f1ed15e44fb4d47a3459d6d9f5da3db4,3,12,9,3,0,0,0,1,5,40,2,3,1.35666952,1149,97,10,176,177,1,8536,8515,21,51,51,0,100
cf288dbbbc41890fb0ab60837870fdc761e3a6f6,1,2,2,0,0,0,0,1,6,0,1,1,0,870,98,7,128,128,0,6834,6834,0,37,37,0,100
6a2f41620e234f0db89f7e875f1009077f37510e,2,0,36,36,0,0,0,3,28,26,1,1,0.650022422,1458,99,7,191,194,3,8098,8284,186,133,135,2,100
38003a2e7c7dd473e070912d185a4ea8293c0a96,2,20,1,19,0,0,0,3,17,8,2,2,0.958711883,1347,100,8,158,156,2,10652,10506,146,54,53,1,99.63746224
52a8437172ebe3dbe586be6882111c48dee7985a,2,132,0,132,0,0,0,2,5,15,1,2,0.487917993,1120,20,3,168,156,12,9696,8614,1082,60,57,3,99.93954051
a5222ddcf13e6840f4807c322364c489710f8c99,4,110,26,84,1,0,1,1,22,16,2,4,1.604044037,3083,21,4,540,527,13,21359,20880,479,106,102,4,99.3452381
0e2bb54d08c7ca66763f93a1116712f8237eca63,3,165,1,164,2,0,2,1,31,7,2,3,1.125573664,411,22,5,109,84,25,3967,2966,1001,47,36,11,99.05992949
b9468e1fdd975c111b1a3929a137ddf9d88fcf46,16,788,17,771,7,0,7,2,7,8,1,2,3.631607296,1710,23,6,397,287,110,15429,11832,3597,138,114,24,98.42840512
314c2b4bfb8ee794e42c7d5d149b0aaa7abc0457,1,1,1,0,0,0,0,2,8,0,1,1,0,879,24,7,130,130,0,6907,6907,0,37,37,0,100
b6c2dff86ea89df46428d43ffeb9f040156ddd57,23,1262,356,906,9,0,9,1,32,76,3,13,3.856951353,3601,25,8,697,617,80,23917,22125,1792,323,268,55,88.82294758
e377ca1176d3f6dc1664246c78e80cacb40ce5ac,2,16,25,9,0,0,0,2,4,20,2,2,0.801469893,282,26,9,44,48,4,1668,1702,34,15,14,1,100
fdd9a7c25c11c8df33687fd18136ebe3d5c57463,2,26,21,5,0,0,0,3,23,35,1,2,0.983939395,2084,27,9,445,431,14,13229,13119,110,74,74,0,100
8320b8fa146598d6799cbd7944295c5f3d813c51,1,18,0,18,0,0,0,3,29,29,1,1,0,979,28,8,150,147,3,4858,4786,72,119,117,2,100
ab3380d440d342bc60f17d39b61b4a503996177a,3,6,0,6,0,0,0,2,9,36,1,1,1.251629167,1147,29,9,165,164,1,8952,8923,29,45,44,1,100
2011054e9d54a26cedac36d789231274ffbf7b69,2,76,1,75,0,0,0,3,8,93,1,1,0.173781323,281,30,10,16,11,5,1024,639,385,15,10,5,100
edec6749f17b0b1f41de28b38ac977cb4f36e810,2,20,22,2,0,0,0,2,7,12,1,1,1,270,31,11,34,34,0,1988,2028,40,7,7,0,100
34f31f5de3a454642bec39017c16131b518a9ef3,1,3,1,2,0,0,0,2,7,35,1,1,0,339,32,12,58,58,0,2507,2509,2,15,15,0,100
db97703572c84c4dd7706d2d8b55e0d7a92c9815,1,4,0,4,0,0,0,3,4,97,1,1,0,175,33,13,38,37,1,1262,1245,17,13,13,0,100
12e4dcdc7bb33a1a42032eb233df1042dce39577,4,142,15,127,1,0,1,1,33,53,2,3,1.10433669,558,34,14,119,104,15,4618,3784,834,61,48,13,98.95606786
b4ea5e68c12092152c9e8c63d691863f5f107326,1,1,1,0,0,0,0,3,24,15,1,1,0,1943,35,15,394,394,0,12071,12065,6,53,53,0,100
8bd847926aaff022b39826af7e1f0583cd99b6ce,1,12,3,9,0,0,0,3,34,0,1,1,0,416,101,0,86,84,2,3052,3015,37,37,36,1,100
0cb76a2ce0253ceb8e64a955164046338071e1a8,1,2,1,1,0,0,0,3,35,0,1,1,0,424,102,1,87,86,1,3072,3052,20,37,37,0,100
c450477b27c92d4aaf6599da180c88ebaf86e718,1,1,1,0,0,0,0,3,36,0,1,1,0,425,103,2,87,87,0,3076,3072,4,37,37,0,100
a57578829d32c7fd4dc555f1de1d4db8ed0d23b8,3,25,7,18,0,0,0,2,12,81,2,3,1.5,857,104,3,172,168,4,6053,5931,122,70,70,0,100
4ae38f5a80801097566197b236f465a4593b2cee,4,36,7,29,0,0,0,1,3,147,1,2,1.876440128,477,105,4,110,106,4,2685,2599,86,89,86,3,100
4f38bf62111abb892744e3fb7a9dab6b7f23d0b3,1,1,1,0,0,0,0,2,2,41,1,1,0,83,106,5,14,14,0,538,536,2,4,4,0,100
0aec8bb740a0bb889e865433db6c45b05ecd134c,3,8,4,4,0,0,0,3,16,26,2,3,1.554585169,950,107,6,188,186,2,6832,6791,41,73,73,0,100
58255485b2a58aaaf03d96d211604352808094cc,8,378,36,342,0,0,0,2,30,91,2,5,1.887332471,4841,108,7,577,523,54,35403,33594,1809,254,243,11,100
25cd3b32249fe3df6c0e690c7b8f859ea35eebfa,1,1,1,0,0,0,0,2,9,137,1,1,0,250,109,8,36,36,0,2031,2031,0,9,9,0,100
90eeb6a1ad1f75aa7e2d338bfe65d9e8189e07bd,44,3010,105,2905,11,0,11,3,37,61,2,14,4.036371429,10574,36,6,1641,1340,301,86177,76217,9960,735,603,132,96.06046725
91a2b67ed0b54d68cdd15101184090ba99bc95f1,2,200,0,200,2,0,2,1,1,0,1,2,0.985815037,0,37,7,14,0,14,544,0,544,12,0,12,99.66297545
ea624cc141fd8f17cd54da527623f5adab251fae,2,19,4,15,0,0,0,3,13,101,2,2,0.426228657,880,38,8,118,116,2,8760,8662,98,34,34,0,100
9ace4b9e3601c1553b8060aabea71bdbc4d2ed43,6,60,21,39,0,0,0,3,20,52,2,5,1.523587039,1984,39,9,434,434,0,13222,12868,354,167,166,1,100
538ce2870c14cd6143e7cd2788128443a5d6fd8e,3,38,6,32,0,0,0,2,14,60,2,2,1.348587896,1129,40,10,135,135,0,10381,10663,282,35,37,2,100
0536d30c63e7a0f827f14f489bf718e8f4f9ce29,7,83,132,49,0,0,0,1,38,69,2,5,2.136362173,1702,110,9,248,263,15,12230,12622,392,116,122,6,99.95192308
6c96dfd28141d8d2b31d29c97a4b94aea3a1b737,1,92,0,92,1,0,1,1,1,0,1,1,0,0,111,10,8,0,8,546,0,546,3,0,3,99.71098266
a3c13260f6f78981a16837a66cb9aaad19b1fca1,6,862,67,795,0,0,0,2,13,112,1,2,2.239661198,1292,41,11,226,155,71,14492,10219,4273,119,83,36,100
b844bc3e5cee09373aefbe1ca8f94cf0f6aa38b3,2,0,273,273,0,0,0,3,15,172,2,2,0.785658025,946,112,11,93,124,31,7590,8589,999,24,36,12,99.85507246
df96648302c8b0b98cc8bf1b9abfd279ab0d3f22,3,23,4,19,0,0,0,3,39,10,1,3,0.979023172,791,113,12,151,149,2,5625,5519,106,58,58,0,100
0e03ba32f27bbccfdeb639e503822f98761dcd40,10,53,15,38,0,0,0,3,18,51,2,2,2.491732153,1543,42,6,226,236,10,10448,11077,629,66,66,0,100
fb1bbb499fa03b9f5ffcf6e4e6056a94318563e3,7,711,32,679,2,0,2,3,10,48,2,3,1.084327009,611,43,7,165,118,47,8517,4331,4186,78,61,17,99.7105644
aca4b028f43659a2f41b4b926d82f40cc0f76e09,562,26886,70202,43316,144,0,144,1,23,6,5,53,8.352095639,65506,87,0,4993,9697,4704,201575,427865,226290,2150,4201,2051,46.77520351
027dd94822acd13cd3d858c3ae7c9dc03379c37c,562,70250,26934,43316,281,0,281,0,39,0,5,53,8.353180779,33328,114,8,9651,4993,4658,425128,203645,221483,4155,2150,2005,46.77520351
3355e3bbe5627a095448be225d5b44fc09c06556,1,16,7,9,0,0,0,2,8,23,1,1,0,1031,44,8,123,124,1,8519,8504,15,39,39,0,100
0a3e2c6a4592ef53fced830ea0c4b642e153d84d,2,136,53,83,0,0,0,3,40,59,2,2,0.147927238,691,45,9,124,114,10,4362,3979,383,45,42,3,100
68c13dddd3eb4171c6ae0484d56a6d62ea8aa97d,1,9,6,3,0,0,0,3,7,8,1,1,0,199,46,10,42,41,1,1418,1390,28,14,14,0,100
f11ee59665157def0af7eb6d31f7cde942fa25ca,29,364,377,13,0,0,0,3,25,231,2,3,3.100124895,6298,47,11,859,846,13,40375,40333,42,329,326,3,99.75926818
cf7d3bfc63002e426c9a013496c26f5859c58e26,1,32,6,26,0,0,0,2,2,23,1,1,0,75,48,12,10,8,2,601,546,55,3,3,0,100
e58f6fe2fb5e3ea7b16180ec62c0c2f9bdfa6d33,12,600,53,547,3,0,3,1,18,54,2,6,2.587290113,1534,49,13,335,278,57,11354,9085,2269,141,116,25,97.49638902
0a9fc968bade16eaf4411d86bf04312d46e122f0,16,29,40,11,0,0,0,2,21,60,1,5,3.806717968,2638,115,6,526,526,0,15700,15700,0,211,211,0,100
bd9521b46a73e8b717f00ffeda69d10a1e46a294,3,68,32,36,0,0,0,3,19,58,2,3,1.000107614,558,50,14,94,91,3,3509,3221,288,45,44,1,99.9518768
97eb1d1b27bb7f7fdd4a2c37cd4ea171be0a6efb,3,83,18,65,0,0,0,2,4,123,2,2,1.545882127,322,51,15,59,43,16,2420,2187,233,29,29,0,100
dcfa776fab81c0ffbcf46709f6284732c6821256,2,32,10,22,0,0,0,3,31,33,2,2,0.276195428,1360,52,16,215,215,0,7764,7496,268,134,134,0,100
a0b7bc3850771f2444b64d0ae726243e15ee4905,4,155,3,152,1,0,1,2,6,242,3,3,1.040200824,2321,53,17,421,409,12,14983,13995,988,79,75,4,99.42279942
0b8fea7a2deefc6f64a7a34ea9597f571422bba4,3,21,2,19,0,0,0,3,32,8,2,2,0.840491401,1272,54,18,187,185,2,6665,6601,64,145,143,2,100
dfc6af123a60d14027dfccf387096a938ef62801,564,26564,70825,44261,142,0,142,1,23,7,5,53,8.36368207,66132,88,1,4992,9812,4820,201544,432498,230954,2150,4239,2089,46.74593242
ff10c315f1389a0377b2fe5b6ad9b4cd98881744,564,70940,26624,44316,283,0,283,0,40,0,5,53,8.363569684,33321,55,15,9772,4992,4780,429972,203614,226358,4197,2150,2047,46.74593242
fb19a4dd0a03779eb2d7c189c15b85f2fd2d4920,2,148,55,93,0,0,0,2,11,44,1,1,0.139777792,1073,56,15,187,170,17,8677,8081,596,67,63,4,100
740394acee9fbf0be9691276221e9a7e55907061,36,900,1018,118,3,0,3,1,19,69,2,7,4.597958353,4449,116,6,778,788,10,28295,27194,1101,218,237,19,98.47182426
4db860a7779001d0cec52612673bf70500a62647,1,12,3,9,0,0,0,3,34,3,1,1,0,1147,57,16,168,167,1,5974,5955,19,129,129,0,100
761bb8e74cde69396e3bf88ea30df666c0b21d3f,3,10,6,4,0,0,0,2,7,88,1,3,1.298794941,863,58,17,205,204,1,5622,5592,30,76,76,0,100
d95715891d76b5971e905f8ba9781a01a41de865,4,53,15,38,0,0,0,3,35,11,2,3,1.157053122,2568,59,17,481,459,22,16246,15097,1149,200,197,3,100
7a801fe57c13207ed8b7166584ec48da240b45b3,5,80,6,74,0,0,0,3,36,7,2,3,1.405765944,2578,60,18,505,494,11,15743,15240,503,209,206,3,100
e26dd94d6667f228d6f6709f1488ec6689d25f92,1,20,9,11,0,0,0,3,20,147,1,1,0,543,61,19,104,101,3,3828,3781,47,31,31,0,100
0875a46e1d8967c95a432de2c52e9e3259892af1,1,41,0,41,0,0,0,3,37,0,1,1,0,1161,62,20,169,168,1,6437,6120,317,131,130,1,98.94009217
93ef0c8a506df0b5c34acb734b2ce8e859f80cc4,2,2,4,2,0,0,0,2,6,98,1,1,1,188,63,21,23,22,1,1142,1143,1,10,10,0,100
379be407d2d198fe985d9971c607f5309ed729cb,1,2,0,2,0,0,0,2,11,9,1,1,0,519,64,22,71,71,0,3289,3283,6,16,16,0,100
0ca83888a92ef6162fcf09247ff2303470c44fa0,14,277,177,100,0,0,0,2,21,38,2,4,3.264831673,3385,117,4,534,460,74,26220,24869,1351,162,147,15,96.61636946
56ba22d65da3e00a8a1ad3d83f4eba5514754001,1,29,19,10,0,0,0,3,26,28,1,1,0,1712,65,23,366,366,0,10495,10409,86,52,52,0,100
bd8e7cba26e65820df5e9d50a59909da507c9013,1,8,4,4,0,0,0,3,41,30,1,1,0,468,66,24,100,99,1,3463,3439,24,42,42,0,100
45409770c5e8dba208e210023f73da8e3b60b65b,7,262,27,235,0,0,0,3,38,57,2,4,2.040106675,6162,67,25,868,838,30,43774,41935,1839,281,276,5,98.89423077
0d9051748c28aa0760a93acf6f4c6c220b6de0f0,2,16,3,13,0,0,0,1,3,148,1,1,0.485460761,321,118,4,62,60,2,1960,1901,59,35,35,0,100
f74538296ea3384e78a8c7f00abbb65686b42864,4,91,0,91,1,0,1,2,13,5,1,1,0.849159044,1577,119,5,264,259,5,12336,12010,326,87,83,4,96.36275461
b28cd21e374ce482a6262abc806809691612b836,1,1,1,0,0,0,0,1,4,3,1,1,0,279,120,6,57,57,0,1647,1647,0,30,30,0,100
0c20a488e8c6b3bcbca32d950b6091f6d1c79e58,2,51,22,29,0,0,0,3,39,5,2,2,0.644694044,2079,68,24,388,385,3,12784,12684,100,174,173,1,100
f1c5ca1658c664822af511ee4c2f0288c2432b22,2,12,1,11,0,0,0,3,40,3,2,2,0.619382195,1575,69,25,230,229,1,9608,9581,27,147,146,1,100
9839f18ff7512d034b0d15b88b62296bc793d37c,8,19,23,4,0,0,0,2,21,75,1,5,2.70477894,1991,70,26,336,338,2,13529,13518,11,122,122,0,100
f486ce290e99dcea19fe22dcbaa595e4bd03cec7,1,7,0,7,0,0,0,2,3,60,1,1,0,288,121,7,57,56,1,2240,2220,20,13,12,1,100
1bb8c22e0f2ca7f3e4f6b1c1fa793e6de05dcda9,1,1,1,0,0,0,0,2,9,60,1,1,0,118,71,27,12,12,0,838,838,0,3,3,0,100
ad5e45ba3f890bd99272a4d90641a319f93bc87f,3,26,5,21,0,0,0,2,15,3,1,1,1.461720594,1589,122,7,268,262,6,12146,12081,65,87,85,2,100
0f8218b219872d0a26b28bef51eed27fb780696a,2,4,2,2,0,0,0,3,15,5,2,2,0.918295834,1607,72,25,180,179,1,12921,12897,24,65,65,0,100
bb549c3c224f0df9085ed44c3e66ae22f3bb60c1,16,763,8,755,3,0,3,1,42,144,2,9,2.58890756,3356,73,26,666,609,57,27625,22863,4762,303,280,23,99.71590909
cae29aaa86e5253cb3fdca4c4b07cf6295d112c2,12,3277,0,3277,12,0,12,1,1,0,1,2,3.139279001,0,74,27,450,0,450,18097,0,18097,119,0,119,89.44530046
f320f417c402152868543afddba060b0d15e4b08,4,565,0,565,4,0,4,1,1,0,1,2,1.915114615,0,75,28,76,0,76,3309,0,3309,37,0,37,87.27929374
ecf4cd084f975822889404fbef5f9c2376b89a3d,2,4,0,4,0,0,0,2,43,1,1,2,0.811278124,919,76,29,178,177,1,6917,6873,44,59,59,0,100
8e86bd54eba669067d3a4d53a55194470974f34d,3,25,12,13,0,0,0,2,10,34,1,1,1.433781265,361,123,8,50,49,1,2899,2797,102,15,15,0,100
61e21591688395380c6439fa2c43f561e96d5ce2,1,3,1,2,0,0,0,2,17,2,1,1,0,436,77,28,76,75,1,3363,3346,17,16,16,0,100
455a6a02414c88cdfafeb07e05594fd00d643177,2,353,8,345,0,0,0,2,9,156,2,2,0.981940787,1643,78,29,330,297,33,14466,13141,1325,50,48,2,93.87857501
47f8af67be9fa8589e17f976f351a480fa04d25e,4,400,21,379,1,0,1,1,28,12,2,4,1.072750751,1983,79,29,461,411,50,14544,12314,2230,85,69,16,84.3062201
a2d44a6934375ebf0b3c52a8bd1822187487ef22,1,121,0,121,0,0,0,2,9,23,1,1,0,109,80,29,15,7,8,1259,643,616,14,6,8,100
f6d209a84d813b91ee3ca64b326c88133773c8df,2,6,0,6,0,0,0,3,10,240,1,1,1,248,81,30,36,34,2,1670,1656,14,18,18,0,100
9396e3368d91d60add564511179a8fd6c82befb3,1,2,1,1,0,0,0,2,9,186,1,1,0,106,82,28,25,25,0,655,640,15,21,21,0,81.408308
fb597586d44c922d4e9fbc63759042261eadd3ac,39,2703,144,2559,0,0,0,3,29,50,2,8,1.785784925,9652,83,27,1796,1504,292,81304,63946,17358,528,456,72,82.95096716
d9fe6fd29b3b583bf57b1971494e27523be4a50e,3,77,18,59,0,0,0,3,26,69,2,3,1.52152841,1366,84,28,298,294,4,9879,9374,505,80,78,2,100
d7cfc9038dea43f4689670bf01e0e5ffb710f6ee,2,16,6,10,0,0,0,2,11,28,1,1,1,272,85,22,36,34,2,2154,2080,74,7,7,0,100
28ec4c9ae1f5011f1d585886ecc3b3c8f2977945,1,15,7,8,0,0,0,2,5,30,1,1,0,99,86,19,18,16,2,848,819,29,8,8,0,100
ad5fd0e09fe5a626326c2412ac2d6df0baac542a,592,26898,79741,52843,146,0,146,1,23,7,5,58,8.342510841,72783,66,0,5042,11042,6000,203406,488746,285340,2176,4585,2409,52.49597424
f9c7748ce2b40fc5318fdfdb6ddc71b58b7aa640,2,161,0,161,2,0,2,1,1,0,1,2,0.846148782,0,67,1,12,0,12,839,0,839,5,0,5,99.11660777
b036746dc75e15e1fcc0228bd79b8c4008d651f9,2,103,0,103,2,0,2,1,1,0,1,2,0.984646827,0,68,2,5,0,5,391,0,391,3,0,3,99.38864629
369999e3de27b8a73fd3c164e7c7d2b3c4c805d2,596,80287,27199,53088,307,0,307,0,43,1,5,59,8.353387711,33831,87,15,10988,5059,5929,488477,206706,281771,4522,2184,2338,52.08226221
899d598f46df6f1010be9725f1b03a9b90beddba,2,341,0,341,2,0,2,1,1,0,1,2,0.976792116,0,88,16,35,0,35,1510,0,1510,19,0,19,99.78142077
41c1e32454c4f644461aac15eee2a2cb759ee45f,9,1110,64,1046,1,0,1,3,41,19,2,4,2.185873453,8689,89,12,1462,1325,137,69222,62748,6474,438,398,40,99.74536195
ec041961ee6275391c887bda6c62c80fdd3c09b1,1,2,1,1,0,0,0,2,10,3,1,1,0,253,90,13,32,32,0,1689,1682,7,8,8,0,100
bf7d4bdc4990e0e30a2dd91433c2aa3572cb1cda,601,27708,81638,53930,152,0,152,1,23,7,5,61,8.348988768,74049,69,3,5069,11260,6191,208493,498543,290050,2187,4656,2469,51.74002047
f2ef4272db6719cd82d3f6ff5d99c4aa08510fbd,2,117,0,117,2,0,2,1,1,0,1,2,0.995727452,0,70,4,8,0,8,485,0,485,3,0,3,99.57081545
895e5b335552d9ff72d8ca76e07f6d135bbc76f0,2,344,0,344,2,0,2,1,1,0,1,2,0.991179737,0,71,5,20,0,20,2063,0,2063,4,0,4,99.57446809
0c40dbb67523bf59deef9a2b5edf49a94260f49d,2,204,0,204,2,0,2,1,1,0,1,2,0.999722648,0,72,6,14,0,14,845,0,845,11,0,11,99.57805907
e7fde2c76a57c9f2c84fe328021158687c37d8c6,607,82085,28424,53661,310,0,310,0,43,1,5,61,8.366338408,34820,91,9,11192,5111,6081,498655,213956,284699,4593,2205,2388,51.65058405
7c7cbbd508f05263a42b9bb8b5fb5e9c1dc4034a,2,2,2,0,0,0,0,2,14,103,1,1,1,371,92,10,80,80,0,2275,2272,3,30,30,0,100
c73a286692b2a365258f192d844d6c0e99d90944,3,19,4,15,0,0,0,3,24,34,2,2,0.912316303,992,93,11,153,152,1,7782,7637,145,73,72,1,100
a573639bf465c5079c77f27895caa67861054cc1,1,0,2,2,0,0,0,2,21,2,1,1,0,167,124,0,26,26,0,863,872,9,15,15,0,100
1ee7274acc7c9b7f4f169e1ba1bfae0310eb5fff,3,140,29,111,0,0,0,3,31,14,2,3,0.660614262,6166,94,9,884,870,14,49293,48616,677,191,188,3,100
c86eebd5b9372d4f6c97a5a17fd2c979215156ae,1,35,1,34,0,0,0,2,10,60,1,1,0,189,95,8,18,15,3,1437,1259,178,16,14,2,100
98f7f8ab6bb32158adc2eaca9e12798056ff81fc,32,733,379,354,0,0,0,3,29,129,2,6,2.137924597,8051,96,9,1449,1404,45,60405,57337,3068,440,425,15,95.08696979
32ce4a02fce772d3b660af8f533643d681a78cd0,607,28180,82354,54174,158,0,158,1,23,7,5,61,8.36193266,74718,73,4,5111,11355,6244,211886,504792,292906,2205,4689,2484,61.04883907
d542a4e7e9ca1034d6bae7e291711b590888e640,607,82414,28235,54179,310,0,310,0,43,2,5,61,8.363666344,34819,97,8,11256,5111,6145,502759,213956,288803,4614,2205,2409,61.04883907
0ee0c561eb3023008fde63cdfa8443318e90717e,4,167,96,71,0,0,0,3,26,44,2,4,1.16813891,1864,98,7,276,271,5,15178,14730,448,105,101,4,100
2db8e125a886acae2f0154aa50c6f5b884d3db37,607,28185,82435,54250,158,0,158,1,23,7,5,61,8.362147931,74772,0,0,5111,11361,6250,211886,505282,293396,2205,4693,2488,61.04883907
d5d7d1a83adf85a6c925b4ad8d0d8ce34745c55f,607,82485,28235,54250,310,0,310,0,43,2,5,61,8.363290648,34819,0,0,11261,5111,6150,503207,213956,289251,4618,2205,2413,61.04883907
8d173e4df6f7a32e3235f677be2843c42453de9e,607,28185,82435,54250,158,0,158,1,23,7,5,61,8.362147931,74772,89,0,5111,11361,6250,211886,505282,293396,2205,4693,2488,61.04883907
ed4f022e889b88583e8ea5ae5c1ad6e20f5cedef,2,171,0,171,2,0,2,1,1,0,1,2,0.831474388,0,74,1,13,0,13,898,0,898,5,0,5,99.49790795
da25b8f5fc2cb17284a67fc9ff8818d306454943,609,82492,28406,54086,310,0,310,0,43,2,5,61,8.368347622,34950,125,0,11262,5124,6138,503241,214854,288387,4618,2210,2408,61.00679185
7a2bfd46af855007f6b54e5129250031efadd343,2,52,41,11,0,0,0,3,16,276,2,2,0.981152234,807,126,1,110,108,2,8431,8161,270,27,26,1,99.9737395
ad486b91279ac8a99392fb6316a8055441e731ab,73,6211,0,6211,73,0,73,1,1,0,1,4,5.955639909,0,99,5,418,0,418,20772,0,20772,188,0,188,84.48515126
5201043647f21269c0c6a0ffc9d493d9163119ec,3,20,10,10,0,0,0,3,27,56,2,2,1.429473298,924,100,5,131,130,1,7634,7566,68,48,47,1,100
6b3aa71f71d8579a8a83880773f05ad3716bc806,9,231,50,181,0,0,0,3,43,40,2,6,2.287615049,10350,101,6,1677,1658,19,77780,76470,1310,465,460,5,100
6b38a49174da7150cc0d9363add4ca0527d0a972,9,812,70,742,2,0,2,1,17,59,1,4,2.350707337,2155,127,2,503,389,114,19030,15825,3205,178,152,26,97.13004484
5af696996675a8698646d9e5cbee208ae33add7c,9,217,175,42,1,0,1,3,33,52,2,6,2.17508228,9780,102,3,1388,1386,2,78157,77983,174,311,309,2,99.93932039
133fc1c8d097eddea8ac2349701131db53242cbb,7,123,61,62,0,0,0,2,18,49,1,2,2.325387244,2246,128,3,360,353,7,16975,16748,227,93,90,3,100
fe0ab7779c976207416ce5cb174e695a773b809c,1,17,0,17,0,0,0,1,2,39,1,1,0,40,103,4,6,5,1,297,195,102,3,2,1,100
c016761cd5741fa8a5806e4e0271cbdd318b7233,2,47,0,47,0,0,0,1,34,34,2,2,0.550984443,2169,104,5,486,480,6,14688,14416,272,74,71,3,100
e7ab129d6b815d4b8a6485c34d2a489a361da13c,7,687,0,687,7,0,7,1,1,0,1,1,2.706933625,0,105,5,67,0,67,3402,0,3402,22,0,22,99.54723815
c16f58afbeca63cb4689b1d69076d4545dd44c20,0,0,0,0,0,0,0,0,0,0,0,0,0,0,129,2,0,0,0,0,0,0,0,0,0,100
448cf11871c5d76bbf27df06a7ae156b04b22132,31,1296,18,1278,3,0,3,3,44,150,2,4,3.624541542,7704,106,4,1475,1294,181,54826,49036,5790,612,530,82,99.76047904
554ed3606182057d52f594d18c64d9e18bb874d4,3,127,16,111,0,0,0,3,45,0,2,2,1.299259518,2359,107,5,318,307,11,17568,16610,958,198,195,3,100
ce4145c57addff089f20fef2b4ce99742afc63be,0,0,0,0,0,0,0,0,0,0,0,0,0,0,108,6,0,0,0,0,0,0,0,0,0,100
c81ee36d07127426b83a44e9b62f38d0ee656640,1,40,0,40,1,0,1,1,1,0,1,1,0,0,109,7,2,0,2,84,0,84,2,0,2,99.85105749
3603ffb29ade8660f4143dc91d5b71f106ff832e,1,7,3,4,0,0,0,2,14,155,1,1,0,385,130,3,76,74,2,2331,2309,22,30,30,0,100
85ec3edad727df85d8ab9e2a9a10a7057475de49,5,218,56,162,0,0,0,2,17,169,2,4,1.480926362,1115,110,8,203,170,33,9997,8347,1650,70,66,4,94.52380952
3ce86bc0b721c273afff2286b11b8949c8c3759d,6,197,87,110,0,0,0,1,46,63,2,3,1.900534697,2667,111,9,358,353,5,20040,19273,767,214,212,2,99.94044074
3e8c06562220549c7654dbd9568c5bd2896ed145,645,25315,89116,63801,110,0,110,1,23,6,5,61,8.424690715,80811,90,0,5117,12126,7009,212535,543275,330740,2208,4961,2753,52.39139974
e0f1c5fcfc6ca69ffbe7df5c14274124d38a87f1,645,89619,25274,64345,347,0,347,1,46,4,5,61,8.428134356,34903,112,2,12126,5117,7009,542065,214425,327640,4961,2208,2753,52.39139974
67168ab0496d54eb55d2cd45a966c7b2c54fc7f7,0,0,0,0,0,0,0,0,0,0,0,0,0,0,113,3,0,0,0,0,0,0,0,0,0,100
f2ff7d78cd3fa9e4c2ff7125ecc017dde4171cff,0,0,0,0,0,0,0,0,0,0,0,0,0,0,114,4,0,0,0,0,0,0,0,0,0,100
bb1ca777e4114edc30fcfae73da718cfa7df3ce1,5,1075,51,1024,1,0,1,1,47,44,2,3,1.612717799,4225,115,4,1018,887,131,34162,27589,6573,294,253,41,99.94047619
c906655c9042d535487040e5dc4b2241f3a6a72f,2,48,1,47,0,0,0,1,21,2,2,2,0.40790598,633,116,4,225,218,7,5155,4768,387,39,36,3,100
5f509bee35015cd577cee566eea2e871d66eb366,4,328,5,323,1,0,1,1,48,74,1,2,1.856685897,2084,117,5,274,250,24,15189,13505,1684,186,173,13,93.82171227
4fec3ec895850967fa749a1a2aa4082f5de69d83,6,434,19,415,1,0,1,2,31,68,2,4,1.645249194,2528,118,6,647,611,36,19980,17384,2596,145,137,8,99.62077013
2c0de108871aa5ca4d23022927664c1b4973f71d,17,3245,63,3182,10,0,10,1,16,66,2,7,3.138651156,1918,131,0,621,286,335,34065,14139,19926,261,133,128,94.9879952
6ebdc89083125c301e5a09717769b8f404cb73ca,3,29,5,24,0,0,0,3,17,400,2,2,1.56140279,813,119,7,108,103,5,8387,8227,160,29,29,0,99.90763547
2bee4ad199c36be7d356092ac66178bad6f5e1ff,5,18,12,6,0,0,0,3,37,194,1,5,1.441946032,3854,132,1,816,815,1,26430,26353,77,161,161,0,100
a03d578e7f8ce7ce0181de080b3598c3eb771d10,3,586,0,586,3,0,3,1,1,0,2,2,1.54245456,0,133,2,62,0,62,2543,0,2543,32,0,32,95.14294497
47e7fd0333c9f9ed233698770c55d7b95d718ac0,0,0,0,0,0,0,0,0,0,0,0,0,0,0,134,3,0,0,0,0,0,0,0,0,0,100
d56bcb56e51e4dac1c9679dd146e187a3ae94964,4,15,14,1,0,0,0,2,14,141,2,2,0.925598236,2047,120,3,346,346,0,14397,14319,78,93,93,0,100
909a44805773860c9c980f0ac2597bd62e8bf690,2,20,0,20,0,0,0,2,13,211,2,2,0.286396957,1288,121,4,158,156,2,11097,10916,181,48,47,1,99.87696094
b1c1490937b9d49d5bc1251e736f5b79d5fdada6,33,1413,605,808,0,0,0,3,33,332,2,6,3.801130554,5976,122,3,1049,932,117,47336,43422,3914,413,385,28,93.93203883
28fb2820fd949b8d00495743b4ab76c0b6a92eb5,2,367,0,367,2,0,2,1,1,0,1,1,0.971268483,0,123,4,45,0,45,1796,0,1796,18,0,18,94.97767857
4e52213bd44ee5d3f0169b8d79ec17746482b88d,13,765,52,713,1,0,1,3,22,215,2,8,2.471038764,3204,124,2,664,585,79,28627,25279,3348,214,187,27,99.6833216
129b7e46e8ad8415d10721b8c9b9350ee3a7fbd2,2,63,1,62,0,0,0,3,34,118,2,2,0.337290067,1001,125,3,133,130,3,9143,8746,397,37,36,1,100
e62532996cfe36eabce2eb16cecff2c73479bf47,4,25,4,21,0,0,0,2,44,355,1,3,1.368551705,840,135,0,171,168,3,5606,5456,150,81,80,1,100
24d4d7137bf389d0c640a4d194af73a1d3c36fbf,3,57,12,45,0,0,0,2,14,187,3,3,1.319089932,1362,126,3,256,252,4,8424,8190,234,86,85,1,100
e0ff70133fc1672015f139bb2359239632a00851,23,1541,4,1537,3,0,3,1,45,237,2,10,2.920658533,7116,136,1,1626,1404,222,58558,49363,9195,543,469,74,88.19095477
1488b22ce313803d012c8ace36c3b12f930ee309,5,38,7,31,0,0,0,2,18,450,1,3,2.238883156,779,137,2,158,155,3,4575,4501,74,55,53,2,100
a542699c8b1456e3587d8b48af0270066fda52f2,0,0,0,0,0,0,0,0,0,0,0,0,0,0,2,0,0,0,0,0,0,0,0,0,0,100
97d61a86602da082f78c3d0f04a4eb927c6690b6,4,11,5,6,0,0,0,2,20,66,2,3,1.882856064,1727,217,3,292,294,2,15018,15042,24,86,86,0,100
6d345886b5d387e6ed8041267286d3cfe5a4a422,3,6,6,0,0,0,0,4,39,181,1,3,1.584962501,3639,0,0,839,839,0,24180,24180,0,124,124,0,100
2507263c72b8654da1a3d98fa0ee74dc3c4f7c1b,0,0,0,0,0,0,0,0,0,0,0,0,0,0,1,1,0,0,0,0,0,0,0,0,0,100
4adc07555d69121bddff5a365abeed1c71405fc8,1,186,0,186,1,0,1,1,1,0,1,1,0,0,213,1,20,0,20,619,0,619,9,0,9,99.70824216
fb1344c0a9ac4ece606854f9a4c7947f5fc5916c,5,48,35,13,0,0,0,1,13,302,1,1,1.441611144,830,218,1,101,98,3,5570,5470,100,37,37,0,90.40125885
bb27d5bac68dbec1d30acf1246c0ae087160daa4,10,119,84,35,0,0,0,2,21,79,1,5,3.101164782,4014,219,2,647,637,10,30086,29878,208,186,185,1,89.45676631
81656501c5e893149340079136d3d13bb0d0841a,77,5165,1960,3205,5,0,5,2,49,238,2,26,4.725075467,20792,220,3,3988,3698,290,152164,142125,10039,1375,1217,158,89.76966796
eadc1d03b6eb815d6d61b0a74daaa7e2e8aaf85a,2,49,1,48,0,0,0,4,23,0,2,2,0.242292189,1882,2,2,247,243,4,15375,15114,261,73,71,2,100
db8aaef7ebdcf909addda4c3c4a945b14eea0815,1,868,867,1,0,0,0,3,10,2,1,1,0,804,3,3,218,218,0,4825,4825,0,17,17,0,100
0ffbd18c29015ea9cb8ecf93c7590db3a13a9763,2,72,1,71,0,0,0,3,6,466,2,2,0.913661787,244,0,0,35,32,3,2085,1735,350,16,15,1,100
da8b7ad7b97d16ca060cc65114d0412ed64a972b,2,170,202,32,0,0,0,4,41,10,1,2,0.231338872,2585,4,4,575,574,1,17381,17244,137,94,94,0,100
9f8a035f229046376dda37b59423a7cfcdd536bc,7,511,7,504,2,0,2,2,9,82,2,5,1.959002337,1241,1,1,289,223,66,10882,9258,1624,123,79,44,94.92102818
a5cb4752c8d14b5e001fc8056f809af45e606fbe,0,0,0,0,0,0,0,0,0,0,0,0,0,0,0,0,0,0,0,0,0,0,0,0,0,100
8a51bf577d5471be4a69848ebd2801486c6830b7,1,1,1,0,0,0,0,3,9,21,1,1,0,172,2,2,24,24,0,1132,1123,9,6,6,0,100
44f6c1f0ef08c46573deee7ed7a9beb4a0ba390e,6,92,9,83,0,0,0,4,35,60,2,4,1.689266157,2488,5,5,366,357,9,22346,21836,510,101,99,2,98.25414997
8b14c7b67e2a137eeb839373cda09e9b06cc478c,1,22,3,19,0,0,0,4,24,18,1,1,0,564,6,6,105,103,2,4068,3948,120,31,31,0,100
756e4dbb44aa1e634c2e8362f45481c3f2bc730b,1,3,3,0,0,0,0,3,15,129,1,1,0,307,3,3,57,57,0,1924,1924,0,25,25,0,100
5a98df93a2f3807891845264e3c2424462ec23e9,1,17,2,15,0,0,0,2,3,1077,1,1,0,48,4,4,6,4,2,273,230,43,3,3,0,100
341201bd92417c802bc50c7d7a43affa77377bb8,5,94,7,87,0,0,0,3,36,119,2,3,1.986199165,2079,7,5,437,423,14,17383,16788,595,90,88,2,100
4b49e2a883ac5b5ffa09827adf53bfd02660dae8,1,2,1,1,0,0,0,3,6,26,1,1,0,194,1,1,43,42,1,1341,1324,17,4,4,0,100
2f80dc814a4a311271e15e96494f9dc1c546f900,4,84,36,48,0,0,0,2,47,131,2,3,1.678785613,943,221,0,176,169,7,6905,6629,276,70,64,6,96.86390533
1b4d2e35e3a03f5b994a9c6b31e0006ecaf87f65,5,209,1,208,2,0,2,1,16,42,2,3,1.517104373,515,8,5,83,68,15,4577,3373,1204,27,17,10,98.17978157
7f1bc3081b5a20ad4776d780bd40491e83d2befc,2,0,17,17,1,1,2,3,6,173,1,2,0,17,2,2,0,0,0,0,0,0,0,0,0,99.89247312
29e0401ab7e84d6d0b57e06021b1d4be1343af3c,3,176,9,167,0,0,0,2,48,43,2,3,1.337937992,1126,222,1,221,202,19,8613,7700,913,98,90,8,99.94617869
2b9036b7ad1a4a093f1824e780e9aae6de5295e1,4,150,13,137,1,0,1,4,18,80,2,3,1.422577564,408,5,3,75,64,11,3772,3166,606,38,35,3,99.94626545
209d5c3f37bfe1deae8aa8953a45a64be718d81e,110,1859,881,978,0,0,0,1,49,204,2,23,6.011789099,21019,223,2,3840,3688,152,142788,135877,6911,1357,1348,9,94.02017291
72930d47fc6af594f5fefd40e18aadfd01cf3b03,3,26,6,20,0,0,0,2,11,0,1,3,1.26273173,774,9,2,138,134,4,4974,4839,135,47,47,0,100
d8dbd3be9198ae9e1754b1b05ea0025f428fe586,13,568,349,219,4,0,4,4,37,87,2,7,2.904387014,4447,6,1,626,608,18,36178,35602,576,218,207,11,99.26565875
a7f89ae5f7b287bd4455eeac2c00270bb1ac0cd7,2,30,6,24,0,0,0,2,7,317,2,2,0.964078765,373,10,1,72,66,6,2792,2649,143,34,34,0,100
a86a034c2b58547b4e68c982af09934ab0356b01,27,666,297,369,3,0,3,3,50,76,1,11,4.284955397,9338,7,2,1857,1783,74,66164,63435,2729,482,451,31,96.66666667
c08afadf8ce05e319ae52311ddab43696d23e7d2,6,104,19,85,1,0,1,3,22,45,2,3,1.289558776,1750,11,2,293,285,8,15703,15154,549,89,87,2,99.92466097
055a9c10d246620072c16ef97e53c0622ddf518d,2,46,40,6,0,0,0,4,9,21,1,2,0.612742555,353,12,3,63,61,2,1943,1904,39,31,31,0,98.60441512
405bd40329b0651c96f7ff9d3179d92c41ec5a2f,2,54,4,50,0,0,0,4,50,83,2,2,0.986232535,1605,13,3,216,214,2,9927,9683,244,163,162,1,100
545321a91ff1e7078cee10332b007e2d02412d23,2,77,2,75,0,0,0,4,43,175,2,2,0.387743181,6254,8,2,912,906,6,51116,50664,452,187,184,3,100
bc00f73d8cf9fac01038696057abd3ded2179986,1,11,4,7,0,0,0,4,17,54,1,1,0,292,14,4,58,57,1,1879,1871,8,25,25,0,100
deece5ee3715203928e20ca90d9e4fd9d8f7935c,6,132,13,119,0,0,0,4,51,175,2,4,1.905778406,7926,9,3,1130,1120,10,62397,61587,810,377,375,2,100
d93c8ccea2c9b3629ef5717b22bf36f09ed7d4b5,3,47,1,46,0,0,0,5,35,55,2,2,1.158222676,1392,15,5,305,298,7,10208,9896,312,83,81,2,100
afb2ec1dc3d30a761756cf4840528b40a0b2e52d,1,10,0,10,0,0,0,4,15,3,1,1,0,457,214,0,84,84,0,3250,3197,53,7,7,0,100
3c14dbbd53873736f653317894a51b1238a095b7,1,3,1,2,0,0,0,4,21,335,1,1,0,351,16,6,83,83,0,2451,2451,0,30,30,0,100
b9246af9748d100c2a7109024b6823666f844bd7,14,421,151,270,0,0,0,5,52,29,2,7,2.662880813,5191,17,7,828,817,11,36829,35498,1331,376,368,8,98.8299532
f5258a2df16d9b4746436187bb566612fe8ea9f0,1,80,66,14,0,0,0,5,53,0,1,1,0,1565,18,8,212,210,2,9595,9515,80,163,161,2,100
3e891efd82e9b1db2b5875112c16d581c4b3eeb3,2,42,11,31,0,0,0,4,18,21,1,1,0.77170947,569,19,8,78,73,5,4135,3915,220,17,16,1,100
424f63fcaf3550a3f39eed944d3021105f9cf837,1,52,30,22,0,0,0,5,27,39,1,1,0,587,20,9,109,107,2,4192,4147,45,32,31,1,100
c09f1d2f907982c55bc3b62193355a848defc0da,0,0,0,0,0,0,0,0,0,0,0,0,0,0,224,0,0,0,0,0,0,0,0,0,0,100
e73aae332684c6b8c1b5cc38b8d571b26251363d,0,0,0,0,0,0,0,0,0,0,0,0,0,0,225,1,0,0,0,0,0,0,0,0,0,100
faf438db8c16f0331de29d8a3819a7e8fe014be9,0,0,0,0,0,0,0,0,0,0,0,0,0,0,226,2,0,0,0,0,0,0,0,0,0,100
d34e56cc2f35336e43e2617ac6210bd30bcad8ab,0,0,0,0,0,0,0,0,0,0,0,0,0,0,227,3,0,0,0,0,0,0,0,0,0,100
6a89f323a2049f63963df38b7e31a450727a6ef0,0,0,0,0,0,0,0,0,0,0,0,0,0,0,228,4,0,0,0,0,0,0,0,0,0,100
f884b5de6c8ff98768ee83fa10dccc7b26c1dfda,0,0,0,0,0,0,0,0,0,0,0,0,0,0,229,5,0,0,0,0,0,0,0,0,0,100
df72de90102df43f009c917a9dfd9283c7a8e7f1,0,0,0,0,0,0,0,0,0,0,0,0,0,0,230,6,0,0,0,0,0,0,0,0,0,100
215ff999ebae775d860ddd3592d65d9364f0691a,1,18,0,18,0,0,0,2,3,92,1,1,0,139,231,7,18,18,0,387,387,0,18,18,0,100
3436286560661805554fa686977a17e7ec02f762,3,22,0,22,0,0,0,3,52,51,1,3,1.494918848,1390,215,1,268,263,5,9279,9187,92,111,107,4,100
ac24210f301ca37aec881ae1fbcf48e0884483c7,0,0,0,0,0,0,0,0,0,0,0,0,0,0,232,8,0,0,0,0,0,0,0,0,0,100
4e737bed0bab1e200f5ca7e6ebeb3004959bd9b9,0,0,0,0,0,0,0,0,0,0,0,0,0,0,233,9,0,0,0,0,0,0,0,0,0,100
93ec77965d867121b87e3001c19df41a816cf60c,0,0,0,0,0,0,0,0,0,0,0,0,0,0,234,10,0,0,0,0,0,0,0,0,0,100
b70e49ccdbfa9bc106b50f34fbfb52ed41fb141c,0,0,0,0,0,0,0,0,0,0,0,0,0,0,235,11,0,0,0,0,0,0,0,0,0,100
f44ba0b927daff01b514c51fb5a03eb799df07ad,11,19,15,4,0,0,0,4,36,213,1,8,3.140968445,2687,21,5,614,614,0,16503,16503,0,262,262,0,100
066317781746dc47becab8369fa810f77cf6d78a,0,0,0,0,0,0,0,0,0,0,0,0,0,0,22,6,0,0,0,0,0,0,0,0,0,100
2d8d75b074540b0207e0ee7cf49484bdb2129adf,0,0,0,0,0,0,0,0,0,0,0,0,0,0,23,7,0,0,0,0,0,0,0,0,0,100
57b9c3f447dc0fd6f9f9f6cbb398debcbdf03c84,33,430,690,260,0,0,0,4,44,350,2,6,4.034226597,10837,24,5,1474,1500,26,80281,81685,1404,482,489,7,95.6454918
7ad5a11fe01742c8d59ca9b112634731c9becc9a,5,140,35,105,1,0,1,1,53,174,1,2,1.328400544,1205,216,1,241,225,16,8880,8354,526,66,63,3,99.8256538
50f9f5a047d170301c1d4c1ba60e3b16ee2669d6,0,0,0,0,0,0,0,0,0,0,0,0,0,0,217,2,0,0,0,0,0,0,0,0,0,100
1c20214223562849666784d3f8a70800835438fd,0,0,0,0,0,0,0,0,0,0,0,0,0,0,218,3,0,0,0,0,0,0,0,0,0,100
11a4d4fd783f6dfdc755ce4755b1e5e9108b3091,0,0,0,0,0,0,0,0,0,0,0,0,0,0,219,3,0,0,0,0,0,0,0,0,0,100
4636221423e06b823029d8d0672a414362d0d596,1,58,0,58,0,0,0,5,26,107,1,1,0,623,220,4,239,223,16,4705,4471,234,31,30,1,100
08748f69fe596b15dcc9ff76014ff603c85cefd7,3,390,117,273,1,0,1,3,27,143,1,3,1.32436503,1415,10,0,290,252,38,13058,11294,1764,62,53,9,99.31051465
ea64544b9a1123e7870da8c74a35e0c7cf02297f,16,2196,333,1863,6,0,6,2,54,243,2,6,2.93750183,2624,25,0,566,434,132,29742,19558,10184,213,149,64,96.72691744
59ffce189194434fdfc5fd730acfad84cb3ada64,3,1790,68,1722,0,0,0,2,25,55,2,2,0.958105749,2250,26,1,440,258,182,29641,20138,9503,158,125,33,100
b9365010279360c7216e72fd076c69d7ea8eee6b,34,869,71,798,2,0,2,5,24,153,2,7,3.672551383,7370,11,1,1352,1262,90,56930,53267,3663,492,460,32,97.18676739
bc1f2754d2e38d360643c838740972c073c8f655,71,6725,992,5733,16,0,16,3,55,199,2,23,4.839524816,16816,12,2,3105,2454,651,143672,116131,27541,1327,1006,321,88.37478311
e260e3b484d64c3e68669a20211bb099f1236768,2,343,0,343,2,0,2,1,1,0,2,2,0.79348538,0,221,0,24,0,24,1485,0,1485,17,0,17,99.84962406
0ff5bd85189b6294306674ebc540935b4c10b584,4,85,4,81,0,0,0,3,16,210,2,3,1.149637315,1029,13,2,198,182,16,7953,7220,733,77,73,4,88.8238573
01cb59f91e7af7f2451f6914cc25ce8d22023a22,1,12,12,0,0,0,0,2,2,2,1,1,0,122,27,2,20,20,0,930,930,0,15,15,0,100
d22c383d5f117b22d85d77494edc4059173de07d,0,0,0,0,0,0,0,0,0,0,0,0,0,0,0,0,0,0,0,0,0,0,0,0,0,100
1181771f043f7ef188230bae7d5accbdc82571c2,4,355,0,355,4,0,4,1,1,0,1,2,1.866368208,0,236,0,37,0,37,1745,0,1745,11,0,11,99.7406639
db254349a26b9f0c0d7836c0bffcad26e721c41b,0,0,0,0,0,0,0,0,0,0,0,0,0,0,1,1,0,0,0,0,0,0,0,0,0,100
8eb3141159eec1181db9bcbfbc58a9a2b8ed9605,30,1880,121,1759,4,0,4,4,24,181,2,11,3.28820004,7789,237,1,1366,1173,193,60231,53108,7123,638,554,84,97.00239808
966713f8bdaf4ee7c27952b2e8be82cf09f8d1c3,2,143,0,143,2,0,2,1,1,0,2,2,0.835276757,0,238,2,11,0,11,559,0,559,8,0,8,99.91075413
fe2d62c2fcd1dcf80603b11851ad6818946be1eb,2,61,21,40,0,0,0,4,56,32,2,2,0.989245297,1132,222,1,192,190,2,8319,8168,151,98,97,1,100
88d241d51f35a74db4e4eefab18faefef1c7773a,2,135,2,133,1,0,1,1,7,177,2,2,0.520057983,103,3,0,35,28,7,1335,579,756,18,13,5,99.9554764
c74be531f627a9ada51fece94f57069d94706d0f,7,92,10,82,0,0,0,1,57,247,2,4,1.958746657,2297,223,2,475,466,9,16137,15648,489,182,175,7,96.21276596
60ace697bde43cd0f178f88e6239e173e15fb7fe,3,64,2,62,0,0,0,1,7,150,2,2,0.905160414,519,224,2,90,87,3,3610,3299,311,46,43,3,99.93894994
4e73719bda21fe21117c6d6edfa86f2db45cdfef,15,1092,29,1063,3,0,3,5,29,176,2,8,2.301955041,2956,225,3,535,416,119,28988,20978,8010,203,161,42,96.60486933
987bb117238c0b1d85cd2d8dc0033feff7b43e14,8,0,8,8,0,0,0,2,6,812,1,5,3,648,28,0,115,115,0,3670,3670,0,46,46,0,100
0ebd53b4ba32537f5db7b1ba59ab137afd2486ef,0,0,0,0,0,0,0,0,0,0,0,0,0,0,29,1,0,0,0,0,0,0,0,0,0,100
1309184cebd067190d5fe372220687276529f40f,3,11,3,8,0,0,0,4,9,280,1,1,1.148834854,838,4,1,87,85,2,6852,6757,95,30,30,0,100
20b08c0e050e914531fb0d82ab9ee08344cf8aa8,1,48,0,48,0,0,0,5,27,161,1,1,0,3928,14,0,364,359,5,34390,34148,242,121,118,3,100
7512a33a5a5582b47a1b45b2b60380a1a5e710eb,1,1,1,0,0,0,0,1,2,9,1,1,0,208,226,4,42,41,1,1634,1628,6,19,19,0,100
96db683e56267e384198b89c5e8d46c1109f61b5,18,525,166,359,0,0,0,3,58,24,2,7,3.505010935,7765,239,2,1189,1142,47,55943,53985,1958,398,385,13,100
ecf28ea6b3ad59b89fa5b04b07486e1a7945b0fb,1,8,6,2,0,0,0,5,59,0,1,1,0,744,240,3,160,160,0,5424,5415,9,67,67,0,100
a5664bfcc37acc0b44aa6b2a0ab6f8d740e91096,1,6,0,6,0,0,0,2,6,275,1,1,0,97,227,5,17,16,1,664,638,26,4,4,0,100
75c505aabb45fb0842c1e5c72c1d2cbd1bb55203,14,2283,16,2267,2,0,2,1,29,234,2,3,2.449697334,2086,30,2,535,359,176,27032,12981,14051,209,153,56,96.01602493
3257ddf1238007e2dc4505c1729d1c71f258c017,2,6,1,5,0,0,0,4,10,26,1,1,0.863120569,391,241,2,30,29,1,1700,1682,18,23,22,1,100
6e7f78af2c9e955f5cac52df40877c4ec5060c8a,3,15,5,10,0,0,0,4,21,122,1,3,1.368995594,730,15,1,122,119,3,4672,4607,65,42,41,1,100
5ffc65b73550bd71062b72ad0c9f5c8d525f960c,21,3522,155,3367,3,0,3,1,30,112,2,4,2.215831476,3919,31,3,771,563,208,51349,28012,23337,352,245,107,94.34362479
fc761529645260c43f4a4c8b4729268c70c47841,1,9,0,9,0,0,0,5,55,99,1,1,0,1576,32,2,213,212,1,9659,9621,38,164,163,1,100
0799aac6c7a59714d7e5e30d5948afaf457e781a,1,0,2,2,0,0,0,1,3,40,1,1,0,208,228,2,42,42,0,1614,1634,20,19,19,0,100
bff2452da03cfd94c85e9ac6052b6829f660207e,1,24,0,24,0,0,0,4,18,39,1,1,0,510,242,3,43,41,2,3585,3447,138,35,34,1,100
66678c1bf66b9a2acc32720bbd57d712914a2fae,6,129,39,90,0,0,0,2,8,97,1,4,2.446932752,910,243,4,191,180,11,6278,5870,408,93,89,4,99.94334278
03704746f7483377b66121b4092b723a1988fb41,4,53,12,41,0,0,0,2,26,98,2,3,1.829508713,908,16,1,131,129,2,6971,6716,255,42,41,1,100
a37406815b6f765d302f7f4a698eb34ffaa4e69f,4,467,7,460,2,0,2,1,30,89,1,4,1.234507652,1449,244,3,298,250,48,12840,11403,1437,95,60,35,88.66506314
20e9ec1afe839c28f5129d6aec63d9a6e8506bf7,0,0,0,0,0,0,0,0,0,0,0,0,0,0,229,1,0,0,0,0,0,0,0,0,0,100
5c22eeeacdcaebd66f0d13bd62913db6de01739c,0,0,0,0,0,0,0,0,0,0,0,0,0,0,245,4,0,0,0,0,0,0,0,0,0,100
b533fe2dd4243b15be7e1253be47ff3997bca43f,1,50,0,50,0,0,0,2,4,501,1,1,0,1098,246,5,235,226,9,8170,7854,316,30,29,1,100
e165256a0745a43fd4e2dde3f52f9c138eccea32,3,643,237,406,0,0,0,3,27,372,2,3,1.184652892,2632,17,2,659,586,73,22775,19892,2883,87,81,6,100
1cf5cd4efab16c9ec00273c7c016bf22aaa0a527,0,0,0,0,0,0,0,0,0,0,0,0,0,0,247,6,0,0,0,0,0,0,0,0,0,100
0a2ef2e2084b02c2f1c999ab2bd431d740f5a503,3,36,31,5,0,0,0,2,23,50,2,3,0.919834488,967,230,2,146,141,5,9083,9062,21,34,34,0,100
e189223ab618ef0823ce2c92b8e98a279cbb2e7f,0,0,0,0,0,0,0,0,0,0,0,0,0,0,248,6,0,0,0,0,0,0,0,0,0,100
b7a5eb54158fcbb96d1175d29afb89bde90db534,17,1949,0,1949,17,0,17,1,1,0,1,5,3.774284377,0,231,3,120,0,120,11233,0,11233,53,0,53,98.41822208
1115630ff0918291dda8c85cf5fcfa9084be1056,0,0,0,0,0,0,0,0,0,0,0,0,0,0,249,7,0,0,0,0,0,0,0,0,0,100
8e98ad88099446cc05e32e1a5e5ef7c3df7a1b27,0,0,0,0,0,0,0,0,0,0,0,0,0,0,250,8,0,0,0,0,0,0,0,0,0,100
e5398095fab3b1d6cd0d2662d35e0446055ac608,1,27,21,6,0,0,0,4,21,72,1,1,0,499,33,1,91,90,1,3550,3514,36,8,7,1,100
3baa64b08f8b001af130b8568aee404e79c4f8a1,7,196,27,169,0,0,0,2,11,223,2,5,2.530705159,2707,18,2,418,409,9,18064,17494,570,158,156,2,90.2077996
814f33b9754ec489d87834bed0ac3b07dc3ffdc8,0,0,0,0,0,0,0,0,0,0,0,0,0,0,19,3,0,0,0,0,0,0,0,0,0,100
3fe19b4f20574c88a58819d45ee1635467647bfe,0,0,0,0,0,0,0,0,0,0,0,0,0,0,251,7,0,0,0,0,0,0,0,0,0,100
0621e115a8a0e58efc65c037b747ed0cb7044962,0,0,0,0,0,0,0,0,0,0,0,0,0,0,252,8,0,0,0,0,0,0,0,0,0,100
e4f21fedfeae29ab9bef2b2570ae8bdf10f4aff9,7,253,20,233,0,0,0,5,22,115,2,2,1.312773723,2910,20,3,357,344,13,21481,20645,836,138,135,3,100
2b85d6c68500ee375fb0af15d770c8be212e8c50,1,2,0,2,0,0,0,4,22,23,1,1,0,504,253,8,91,91,0,3558,3550,8,8,8,0,100
4663d0b71ebe14a99a4d3def0f62513f8f427994,2,99,7,92,0,0,0,2,4,376,2,2,0.274250641,262,254,8,48,36,12,2660,1976,684,16,14,2,100
a7cd736df4452ad414c9f4ac7f487bb2767efdff,2,30,0,30,0,0,0,3,31,32,2,2,0.353359335,1510,5,0,241,238,3,12306,12115,191,56,55,1,100
de47c35cb565575d5bf38e0da7d7f1575c553450,3,106,1,105,2,0,2,1,45,90,2,3,1.025525098,2244,232,2,550,542,8,16339,15985,354,75,71,4,97.13563606
920135fc05c7abad35eb482e4a60558326db1203,4,90,20,70,0,0,0,3,32,82,2,4,1.748249293,1944,6,1,333,323,10,15283,14835,448,117,114,3,100
819df4c14b5bcd82696a21adce56031dcaa18647,36,2198,413,1785,4,0,4,4,60,128,2,8,4.156119353,11125,34,1,1710,1546,164,92530,83582,8948,689,622,67,88.03959307
90d3a7c46c483d4466f45745b9712327a053a0d6,0,0,0,0,0,0,0,0,0,0,0,0,0,0,255,4,0,0,0,0,0,0,0,0,0,100
e77dfeaacdb99c57a641b835a0ed9cae913ea892,43,267,143,124,1,0,1,3,56,408,2,14,4.665021763,15610,233,1,2637,2620,17,118694,118160,534,892,889,3,99.89952273
f75bfeaa8f4b031cbf6de9312a549c1fad19ec80,5,104,11,93,0,0,0,6,24,230,2,3,1.937069764,1765,7,2,285,275,10,12812,12199,613,107,103,4,100
a85c3626a0cbbae359d05685481f562240fa2c71,0,0,0,0,0,0,0,0,0,0,0,0,0,0,256,5,0,0,0,0,0,0,0,0,0,100
e0708a3712926d6e5881d4cffbb8e556f025d97b,24,2089,276,1813,4,0,4,1,32,107,2,6,2.68553162,7499,35,1,1256,1101,155,69949,60491,9458,400,321,79,89.68187526
230146104b432451a82d6d9c0a5ee6eada0babad,0,0,0,0,0,0,0,0,0,0,0,0,0,0,257,4,0,0,0,0,0,0,0,0,0,100
ffe611d6861b246964437e57e4713a0945ec3efe,9,563,39,524,3,0,3,1,33,169,2,6,2.375274958,2338,234,2,452,399,53,19888,17234,2654,121,100,21,99.60238569
bebed5575fd598d3b43cb9d9cd3144451d7bcb7a,6,459,1,458,5,0,5,1,2,121,1,2,2.581070792,39,258,5,33,1,32,1856,177,1679,17,1,16,99.81824791
408e47dd0226ccb1f511214df3d2609013dfbbed,0,0,0,0,0,0,0,0,0,0,0,0,0,0,2,0,0,0,0,0,0,0,0,0,0,100
3d721e303b6e28e5af7a2df1a563e5d7600af382,11,1420,64,1356,2,0,2,4,33,6,2,5,1.501146036,3919,36,2,771,660,111,36795,28953,7842,229,181,48,95.9528362
b69406572c332617e0a0c25e813c627364bbf7c2,1,8,8,0,0,0,0,5,24,12,1,1,0,351,8,1,65,65,0,2168,2180,12,28,28,0,100
bbbb04f277dc1522f9517749827959dc870ae1eb,4,43,4,39,0,0,0,3,25,17,1,3,1.530673063,737,21,0,144,139,5,4524,4412,112,59,57,2,100
ce8596cc819be6b81af84e982bcad56c15a8c58a,3,182,30,152,2,0,2,1,29,15,2,3,1.481349189,700,37,2,272,260,12,5542,4943,599,42,36,6,99.92902768
9782b404c440e4a7afd05607397826a49eb3fecb,2,36,2,34,0,0,0,3,34,44,2,2,0.689201985,1606,9,1,254,250,4,13007,12775,232,60,59,1,100
3db5db32c292b5ca182ca29853b11ea6f49cd5c4,2,15,4,11,0,0,0,3,35,532,1,2,0.831474388,1507,10,2,272,269,3,12062,11964,98,61,61,0,100
42dceb8a3ed860e6fd6a9348b5140e115c09ec43,7,51,3,48,0,0,0,2,27,184,2,3,1.211750753,2054,11,3,314,310,4,14235,13802,433,97,96,1,99.95744077
bb1e4ffa653b1c4878eb6ef1dc676ac02b62192a,2,22,0,22,0,0,0,1,3,32,2,2,0.684038436,996,38,2,120,118,2,8122,7990,132,59,58,1,100
07073a22dfe1f14196fe97ff23b9710ee2cc2139,6,99,26,73,0,0,0,4,25,178,1,4,1.820062091,2065,39,2,361,349,12,14350,13875,475,81,80,1,100
6cbbdd5127da2ab0dce06e99048df76201e84d8a,3,22,0,22,0,0,0,6,36,243,2,2,1.022629779,2228,12,4,296,293,3,17929,17747,182,90,89,1,100
4ddb4c1097824185fc8af454d46a485b4c33de1a,1,1,1,0,0,0,0,3,6,11,1,1,0,179,235,0,21,21,0,1263,1259,4,13,13,0,100
a49558eb5b4971f32d3d670f8e7034b7034d972b,4,31,17,14,0,0,0,1,25,59,1,4,1.023899573,1195,40,3,211,205,6,8345,8252,93,33,33,0,100
3b875dd7386fb274d839dfa106398b57caf9c15e,2,143,9,134,0,0,0,5,57,67,2,2,0.561752608,2283,41,3,483,475,8,15619,14581,1038,209,201,8,100
5207b513d5f193c6997bd3df83fee39aa3be5221,5,42,0,42,0,0,0,5,61,96,2,5,1.62537855,2749,13,1,468,463,5,17338,17074,264,172,170,2,100
fa3f90504f164579409045b50f253639a281dea1,36,2715,110,2605,8,0,8,1,62,150,2,15,3.958103494,11238,259,0,2653,2330,323,93168,79240,13928,802,704,98,90.88196905
1386885faaa86adbf6caa6460bf18684c46301cb,13,1232,0,1232,13,0,13,1,1,0,1,6,3.632899328,0,14,1,105,0,105,6438,0,6438,31,0,31,94.39400817
0787a58609fae402e2037e0aced256a27434f826,4,331,5,326,1,0,1,4,13,335,1,2,1.174476086,635,42,2,148,100,48,7046,5182,1864,55,39,16,95.59027778
07a1fc4455309b48bb9dbecc310b7acdb76acfc6,6,85,42,43,0,0,0,5,63,25,1,3,1.932161079,2519,15,2,448,440,8,17196,16915,281,138,134,4,100
b7dcd91d609a26f6a0e9dc87144e6201b3537c77,4,40,24,16,0,0,0,3,10,334,2,3,1.201509375,580,22,0,57,57,0,3931,3815,116,32,32,0,100
70991322a72f50ae671d79787239d2f0030f4566,25,496,902,406,0,0,0,2,64,86,2,7,3.183274249,12909,16,3,1785,1870,85,99857,104128,4271,645,668,23,96.66265268
c1d108711ab35442ec9111bfe8ea9a06f7c37e05,3,45,4,41,0,0,0,3,25,202,2,2,1.189801182,1279,17,4,198,193,5,12387,12047,340,48,46,2,100
2ec15ae61ea6cae2125b6f3d21471246e5e366f0,108,32825,0,32825,108,0,108,1,1,0,1,9,6.154144186,0,236,0,4039,0,4039,184223,0,184223,1309,0,1309,91.71543526
99aa026e4d30a39715996b12d0d891a2915a2a88,6,477,9,468,2,0,2,5,37,231,2,4,1.324374086,6190,237,1,890,837,53,53064,50437,2627,208,199,9,91.2460733
efb4bc75f59958d9fbd4f6eca6b9ea4e6157efa8,4,129,33,96,2,0,2,1,2,18,1,2,1.907001754,121,18,4,18,14,4,998,619,379,8,5,3,90.6911706
d0476c715d2592ff215080068250dc9bf1524d81,3,14,70,56,0,0,0,3,13,202,2,2,0.916228154,573,19,4,91,102,11,3526,3804,278,31,31,0,100
85e8d694a814fdefd0d06587270d9a4df09552f5,22,1815,300,1515,5,0,5,4,38,134,2,10,2.912686624,7447,23,1,1363,1170,193,63711,54733,8978,481,431,50,96.5648855
7c7e1363660b46b641f9f0eab5c7c3bf2c822bbc,1,0,0,0,1,0,1,2,3,0,1,1,0,0,24,2,0,0,0,0,0,0,0,0,0,99.96605567
89d2ebf770746bd6de4933979e19f881b95ea7b4,12,296,46,250,1,0,1,2,26,328,2,2,2.826984265,3500,260,0,663,610,53,30020,28459,1561,219,207,12,99.96605567
7e9e0b656219b269866220e1879619864cf5f392,2,145,0,145,0,0,0,2,8,304,2,2,0.859182449,372,20,4,49,38,11,4072,2972,1100,20,18,2,99.91518236
7e0021f1c15fd8ba8a53942101b7505b0df8234c,4,220,148,72,0,0,0,1,39,16,2,4,1.535760928,2710,25,2,451,439,12,21752,21335,417,104,95,9,99.94918699
89bb3e65b79d1761a98c3e9255bfd0f7c6a94536,1,2,2,0,0,0,0,5,27,51,1,1,0,529,21,5,98,98,0,3719,3714,5,8,8,0,100
d13851b7fbcd574363500df3428033f87d5a4c44,0,0,0,0,0,0,0,0,0,0,0,0,0,0,2,0,0,0,0,0,0,0,0,0,0,100
96f3befd746407a833bd1f515b5b95e144b577c6,1,2,2,0,0,0,0,2,2,62,1,1,0,1015,0,0,229,229,0,6025,6033,8,68,68,0,100
6c9adca47842af20a4bb4df9bc85e3213ee28966,2,45,1,44,0,0,0,3,19,78,1,2,0.258018669,631,26,1,134,127,7,4199,3945,254,58,57,1,97.44973939
fed41d90453fc306713cb781f4e26fe5819fba17,2,53,8,45,0,0,0,2,40,71,2,2,0.990479974,1861,27,2,311,305,6,15627,15378,249,62,61,1,100
ed09d2df65e724490866fe25ee3e4f4f94161e3a,18,1936,75,1861,2,0,2,1,34,178,2,3,2.122827652,3770,22,1,817,669,148,39511,23081,16430,314,242,72,99.91728701
aae86bbd13565290ee3f1b8dfb9fd787f27c6e47,8,514,145,369,3,0,3,1,41,105,2,4,2.468017292,2366,23,2,414,390,24,20245,18679,1566,106,93,13,99.87618655
c53c0f245f5681d319d9d8fe727053ecffaa8926,8,277,61,216,4,0,4,1,23,135,2,5,2.691249653,1177,24,2,248,239,9,8038,7168,870,90,86,4,99.67023908
8d2e6b178d491b8bc75c6ca65ff0ef8f2e46d91e,6,577,51,526,1,0,1,4,25,74,2,5,1.745543189,2628,28,2,421,376,45,23047,20495,2552,131,117,14,94.30651484
571b91d45ec3cf5e6c8ae9460a52b4cfb822d450,4,91,29,62,0,0,0,2,28,374,1,4,1.609844217,734,25,3,140,126,14,5241,4923,318,47,47,0,100
b7b61b0aeb65e0a2f58d2f32d1c6702804384817,0,0,0,0,0,0,0,0,0,0,0,0,0,0,3,0,0,0,0,0,0,0,0,0,0,100
20632fa1f92318596c4c1ea40ffc13adf2ea3d2d,0,0,0,0,0,0,0,0,0,0,0,0,0,0,261,0,0,0,0,0,0,0,0,0,0,100
35e3e4a42d4835d9843f9e62467d0cd515a60d81,0,0,0,0,0,0,0,0,0,0,0,0,0,0,262,1,0,0,0,0,0,0,0,0,0,100
9fc7cd78a2309d6dfc12045138f49e8001c156e9,0,0,0,0,0,0,0,0,0,0,0,0,0,0,263,2,0,0,0,0,0,0,0,0,0,100
9812475541bc440114d981fe490d5513eedd81cc,0,0,0,0,0,0,0,0,0,0,0,0,0,0,264,3,0,0,0,0,0,0,0,0,0,100
b0043527c0e3c878b501c0b235d4d49e6830338e,0,0,0,0,0,0,0,0,0,0,0,0,0,0,265,4,0,0,0,0,0,0,0,0,0,100
e4f3bc3e3649f23ce07850717009f043f8125d98,1,2,1,1,0,0,0,5,28,65,1,1,0,529,26,4,98,98,0,3726,3719,7,8,8,0,100
47d0facbd65b70993d6e95aabb5b66001a67b0be,4,46,3,43,0,0,0,2,42,50,2,3,1.411155386,2208,266,5,366,359,7,17972,17700,272,73,72,1,99.93179881
b917020e1ddd560bd6db12f26a0a0cd18e26dad0,3,70,1,69,0,0,0,6,26,54,2,2,1.090979664,624,267,6,107,97,10,5253,4814,439,46,44,2,100
25fa30c56cb79f66348d664141d9278b366f43d1,3,68,3,65,0,0,0,4,10,50,2,2,0.765307389,1165,29,3,158,156,2,8067,7787,280,51,50,1,100
eabf790be2f934e6dd909b05ddf5b4a3f55f75d2,0,0,0,0,0,0,0,0,0,0,0,0,0,0,4,1,0,0,0,0,0,0,0,0,0,100
0783f298ceaecbfd47dbf176ed785fdb9070c636,2,33,1,32,0,0,0,2,4,135,2,2,0.322756959,331,268,7,52,49,3,2802,2603,199,9,8,1,100
322b458026820f406d34f9893d67517dc1dabe4b,2,365,0,365,2,0,2,1,1,0,1,2,0.913661787,0,238,0,54,0,54,2245,0,2245,23,0,23,93.50370659
8744e988bd46c58a5838121e4bb0c30a7d51d153,6,9,9,0,0,0,0,3,43,659,2,5,2.413833864,2304,269,8,401,401,0,18292,18292,0,109,109,0,100
0449c83ed33358b7fcd55d7b7e981e1bedbd68b0,0,0,0,0,0,0,0,0,0,0,0,0,0,0,270,9,0,0,0,0,0,0,0,0,0,100
31d40f0af017bcd8fce31ad5d5a4454e69bf53ac,0,0,0,0,0,0,0,0,0,0,0,0,0,0,271,10,0,0,0,0,0,0,0,0,0,100
4fd89fb9a66eb88cb7714affb73b5498de59c5b6,3,317,253,64,0,0,0,1,20,143,2,3,0.252071626,1044,30,2,199,182,17,7013,6562,451,68,64,4,100
d74f7a3da03c4902f5b1dd06c9f6ccf936cb635c,0,0,0,0,0,0,0,0,0,0,0,0,0,0,272,11,0,0,0,0,0,0,0,0,0,100
6a57d4445e9951c0507579833ff09dc35a3ad14b,5,61,16,45,0,0,0,2,5,22,2,4,1.63700833,776,273,12,111,104,7,5131,4854,277,36,35,1,99.93158495
db260381e977d3ae7bb91c769ce417d14777f8d8,2,20,1,19,0,0,0,2,44,45,2,2,0.591672779,2127,239,1,339,338,1,17702,17518,184,74,73,1,100
f9b314353d5e84da37717b0110b430024e089420,1,1,13,12,0,0,0,3,15,44,1,1,0,229,240,2,52,54,2,1341,1417,76,23,24,1,100
c7c110e69cd6fd68c636ba446e8bd6bca6853668,3,89,11,78,0,0,0,5,49,260,2,3,0.366446264,6415,31,3,923,920,3,51339,50731,608,203,202,1,100
3e84ebde6e0b54e6926aa4e251abaa53d6c80428,2,48,0,48,0,0,0,5,24,199,2,2,0.811278124,1172,27,2,171,166,5,7768,7535,233,78,76,2,100
857f2b6fc521ca5bd9586d785f54b3eca9f28c42,0,0,0,0,0,0,0,0,0,0,0,0,0,0,274,13,0,0,0,0,0,0,0,0,0,100
393c36f92112eecdd0ae3825d0c4df36da0a53af,2,141,1,140,1,0,1,3,7,228,1,1,0.908618598,108,32,3,14,4,10,1189,725,464,6,3,3,98.08830223
60a14047423b00e9a3aa21ceb4b9e872ed5b9d9a,3,36,1,35,0,0,0,3,14,683,2,2,1.335267044,870,33,4,161,156,5,5860,5603,257,75,74,1,100
c9a54ffd96cdaa937ac70c704225bb2df660007e,1,3,1,2,0,0,0,4,14,20,1,1,0,79,34,5,14,13,1,400,378,22,10,10,0,100
51660970fad35ab77f9089f48dc1519f8a74aba7,2,291,0,291,1,0,1,1,2,67,1,2,0.125312309,1014,1,0,223,216,7,9427,7085,2342,73,67,6,95.05711775
7136c7a622f0987fd772594a4cb842f713713ab6,0,0,0,0,0,0,0,0,0,0,0,0,0,0,241,3,0,0,0,0,0,0,0,0,0,100
00203ef15a5f965d8c33d7fdebbbdeb8a80be465,1,155,0,155,1,0,1,1,1,0,1,1,0,0,275,6,9,0,9,1218,0,1218,3,0,3,99.95751912
7b40e54b7a56566525798b2fd92df92d0b871122,1,38,2,36,0,0,0,5,29,66,1,1,0,332,28,1,53,50,3,2640,2445,195,7,7,0,100
5ffccb0fb58614d864ab9a5571796787b7567fa2,5,861,67,794,2,0,2,3,25,319,2,4,1.273287766,652,29,2,199,115,84,8182,4099,4083,63,40,23,97.93834675
d2593b211879c49c40d32cc77faa430422847189,5,39,45,6,0,0,0,6,30,166,2,2,1.914749413,5635,30,3,593,594,1,46362,46538,176,196,195,1,99.96341017
c4148ef4a7b19305efdc0494875939f940c2fafb,3,300,5,295,1,0,1,3,8,272,2,3,1.023772921,824,276,2,184,132,52,7922,6449,1473,72,54,18,99.96338338
b2c4aba0ca554b157aabab2ad56d9aa50797116a,2,146,15,131,0,0,0,3,7,242,2,2,0.969478706,2047,35,2,266,256,10,14586,13997,589,91,86,5,100
d1088670349609dddb0c54f5894e5cdb975c751c,2,12,0,12,0,0,0,3,34,62,1,1,1,1027,31,3,199,197,2,7050,6986,64,43,43,0,100
dbf2952d744d343ad91422325afca737a59db94a,1,4,6,2,0,0,0,5,30,23,1,1,0,363,32,4,53,53,0,2634,2640,6,7,7,0,100
7c49b11b66624ca75a22753060d0ac038be3d17e,23,779,689,90,0,0,0,2,3,152,1,5,2.7511181,8818,2,1,1818,1772,46,62985,61696,1289,521,529,8,100
23102e67c9ddcedf1d268235790527a7f540c30d,11,183,229,46,0,0,0,2,3,60,1,4,2.113104931,6091,3,2,1631,1633,2,39371,39359,12,355,353,2,100
ae99b6522f2806feb1a1a3532f4905a62551b1ea,3,41,21,20,0,0,0,3,9,219,2,3,1.220375637,612,33,5,74,72,2,4567,4396,171,34,33,1,99.8716303
573374db067b20e2c419d57f110fee4ac59bccce,2,20,12,8,0,0,0,3,11,232,2,2,0.896038233,359,34,6,46,45,1,2317,2280,37,26,25,1,100
502609a35a832f616063f727e3c7a8a69c45a9f6,17,368,231,137,0,0,0,2,4,20,1,4,2.487124613,7771,4,2,1662,1628,34,54798,53813,985,455,452,3,100
79db8b56efacfe7f229c3e0ccba73a1dc11a576d,7,1131,0,1131,7,0,7,1,1,0,1,2,2.640812918,0,5,3,57,0,57,7461,0,7461,31,0,31,99.74340176
75dba0353241d9b9d097cf949d5729e5eef8d417,2,44,15,29,0,0,0,2,2,386,1,2,0.843161957,130,277,2,18,16,2,906,789,117,14,12,2,100
fa751bd519976df8909cd4288c34c91ba08cbed8,0,0,0,0,0,0,0,0,0,0,0,0,0,0,278,3,0,0,0,0,0,0,0,0,0,100
3848831eb44dffc1ebcc210691f28c1ad52abd89,1,7,0,7,0,0,0,3,9,285,1,1,0,178,242,0,37,37,0,1321,1310,11,11,11,0,100
d25579979db1b559f81ecfe953a49802e89f194b,0,0,0,0,0,0,0,0,0,0,0,0,0,0,279,3,0,0,0,0,0,0,0,0,0,100
89256e31ef9d2d8905c8d389dfcfd2f98910f682,0,0,0,0,0,0,0,0,0,0,0,0,0,0,280,4,0,0,0,0,0,0,0,0,0,100
52e60af7ce315dd8ffb7480261bd86885df3a22a,1,27,10,17,0,0,0,2,2,26,1,1,0,181,35,6,44,44,0,932,924,8,17,17,0,100
24d156f61a052cb2f9c11b9cf6645e4cc1f554c6,0,0,0,0,0,0,0,0,0,0,0,0,0,0,36,7,0,0,0,0,0,0,0,0,0,100
75be1fd0802212db995160a96bb3da0078433ea3,2,38,1,37,0,0,0,2,12,208,2,2,0.477071306,772,37,8,133,130,3,4983,4769,214,41,40,1,100
f83af4430dbdbb38011056d57731435e184a8b70,1,1,1,0,0,0,0,5,13,0,1,1,0,374,38,9,84,83,1,2371,2367,4,28,28,0,100
1d7e6a032037bbec89f9b85a93d640b43335212b,2,8,1,7,0,0,0,6,58,189,2,2,0.764204507,1823,39,10,248,247,1,11464,11440,24,188,187,1,100
6e3cb3fd1fd87c16bdb1f8b967e378fb7d729143,93,778,5715,4937,0,0,0,2,5,112,1,9,3.974636634,24767,243,1,2714,4224,1510,167114,195135,28021,1009,1290,281,99.37694704
cd806beee13df3656e35264abb76e64e0b0b9845,8,166,217,51,0,0,0,1,26,827,1,6,1.952356632,3140,281,5,454,459,5,23772,24036,264,124,128,4,99.96324881
56bc6f188b3614e008e52f9726275ce06bfa7bae,2,2,2,0,0,0,0,2,8,837,1,2,1,359,282,6,88,87,1,2165,2161,4,48,48,0,100
3a6f56520ce3564caab00628906e1fc79cbce4e7,4,29,7,22,0,0,0,2,29,744,1,4,1.941187299,1295,283,7,254,242,12,8635,8455,180,60,60,0,100
804ded38d4e8e00d1065d8c9d3139c5d68a66ff1,0,0,0,0,0,0,0,0,0,0,0,0,0,0,40,9,0,0,0,0,0,0,0,0,0,100
b5c7b2ec340ac69b95e1772db7f14dac5fed9bfa,2,91,16,75,0,0,0,4,45,63,2,2,0.999432878,2108,244,2,347,345,2,18007,17526,481,77,75,2,100
c0045b34cd76eddc9ffbe003c84d0d972ce04096,6,2324,44,2280,2,0,2,1,6,2,1,4,1.578233765,2391,245,3,708,494,214,29071,16039,13032,216,157,59,99.92652461
c385c3298b889395b39fa592904ffd1cbf7d5d08,5,5,5,0,0,0,0,3,8,515,1,2,2.321928095,659,284,8,124,124,0,4233,4193,40,63,63,0,100
4d80656aa6b20bfc2da254d92f9981e7410c77ee,3,16,13,3,0,0,0,5,26,284,1,3,1.113043276,1123,285,9,187,187,0,7053,6971,82,72,72,0,100
a0d39db015b43ec975198e653f86f9064d07ab5a,2,36,1,35,0,0,0,6,59,274,2,2,0.303374836,1740,41,10,232,228,4,11187,10964,223,177,175,2,100
40cbad12120a72f16505cd3019a5b9013a3d7c66,1,137,0,137,1,0,1,1,1,0,1,1,0,0,42,11,25,0,25,796,0,796,16,0,16,99.96332967
a9dd49eb6a86b95f41ab1af87c0d8cde98d98083,1,22,0,22,1,0,1,1,1,0,1,1,0,0,43,12,2,0,2,123,0,123,2,0,2,99.94507506
21e4fc8d59f9c1616c4e6b186ec931eb58f4c109,2,34,0,34,0,0,0,1,2,0,1,1,1,132,44,13,27,27,0,919,919,0,18,18,0,100
cda03036bc185c24018b58f31597d0ba9707f0f4,4,7,5,2,0,0,0,2,39,179,2,2,1.79248125,2371,45,14,288,286,2,20037,20015,22,101,101,0,100
524b5227898fadfad4b363309817dd67648add33,8,358,29,329,1,0,1,3,13,269,2,4,2.262593157,3355,36,0,530,496,34,24415,23011,1404,196,185,11,97.59812537
adb16420cd90ac159d3c60880615b7f8d8205e86,33,45,43,2,0,0,0,6,21,336,2,8,4.907962016,7439,286,9,1395,1395,0,47784,47734,50,562,562,0,100
3ace7be5d6725751b8f3b7bacdaa45b4459f5e54,7,93,97,4,0,0,0,1,3,14,1,2,1.407213139,955,246,4,105,100,5,7452,7283,169,41,47,6,99.8953756
ffa928bd1f3060c68d767b81d3e2c3a0abe7b7d8,42,105,105,0,0,0,0,3,32,547,2,13,4.781162301,9327,287,10,1966,1966,0,61002,60904,98,527,527,0,100
855f05670d9bc7348c45d941c4be48e326b53514,3,3,3,0,0,0,0,4,22,1,2,2,1.584962501,2614,46,15,229,229,0,18657,18657,0,112,112,0,100
5331eaabb31378dd411dfc2e9c0a14f2e98b199d,0,0,0,0,0,0,0,0,0,0,0,0,0,0,288,11,0,0,0,0,0,0,0,0,0,100
2e35dc7de27b6a41008209366dd83babaf083bb7,5,53,0,53,0,0,0,5,65,123,2,5,1.934628007,2989,247,5,517,508,9,20261,19940,321,210,207,3,100
7cac6ec02956bbd2b33690e39ece319e5ba6f5ea,9,669,14,655,2,0,2,1,46,105,2,7,2.080536606,4537,248,6,848,758,90,38221,34772,3449,283,249,34,99.87460815
6f452c3a09d99fc189e9116bf2d5f5b7388e6259,21,36,44,8,0,0,0,2,50,419,1,14,4.08369497,8320,289,12,1788,1788,0,54883,54989,106,349,349,0,100
6df052a93b301adbddfecbb67acd78f88c98fbbf,2,61,1,60,1,0,1,1,7,55,2,2,0.637387499,238,249,7,54,49,5,1983,1770,213,21,19,2,99.95826377
d3d1b3f68a44df1a37549a394c031c5747a1d02a,0,0,0,0,0,0,0,0,0,0,0,0,0,0,250,8,0,0,0,0,0,0,0,0,0,100
c9ab5ad46475deb0c2d527a91f9e40fefad4700b,3,67,2,65,0,0,0,2,8,5,2,3,1.520375095,702,47,13,129,115,14,4758,4367,391,38,37,1,100
495f1b983fb2a8c980a8f920d2d8e79e2aa0fe41,0,0,0,0,0,0,0,0,0,0,0,0,0,0,251,9,0,0,0,0,0,0,0,0,0,100
f249dba1e9bbb78f4719985bd29fa97e2f230368,0,0,0,0,0,0,0,0,0,0,0,0,0,0,48,13,0,0,0,0,0,0,0,0,0,100
c66b252e43a8cbbee7fbff1f657d87b644158493,35,69,38,31,0,0,0,2,31,443,2,18,4.908633959,9568,49,14,1651,1651,0,61859,61827,32,503,503,0,100
4193dd2749268958d30cf23064263209e75e3b80,71,126,36,90,0,0,0,2,66,366,1,20,5.70032764,18201,50,15,3481,3481,0,123832,123249,583,1105,1105,0,100
734d4e29bd9cc21009369bd867996054b36b1dad,19,2,60,58,0,0,0,2,67,94,1,12,3.924451185,8112,290,13,1396,1397,1,60478,60775,297,436,436,0,100
dd2cd3df3e7f5ea5e04d6edb5bbefcad7fa1ec68,12,16,16,0,0,0,0,5,51,109,2,7,3.452819531,6922,291,14,1341,1341,0,48802,48786,16,323,323,0,100
b648a07949941a9b1f350dcabc7a98bd3b602408,0,0,0,0,0,0,0,0,0,0,0,0,0,0,292,14,0,0,0,0,0,0,0,0,0,100
c4ed5bd9b82b3bbb995d3c27be7fbf6bcba98107,11,4,37,33,0,0,0,1,52,219,2,9,2.807102614,6447,293,15,1263,1263,0,41586,41808,222,208,208,0,100
45caaca39da2ab9bcbf2dfbcb44c10a4992be4ac,11,48,54,6,0,0,0,4,26,254,1,7,2.59803343,2375,294,15,416,418,2,15826,15905,79,125,129,4,100
bbdaa39b79dc542ad7e69f8ee92a9034d2831c4f,11,1372,27,1345,2,0,2,3,20,87,2,4,2.134158444,2115,252,9,587,389,198,20553,14027,6526,215,160,55,99.39368597
204aacc64eb620dec1aa1175989ec159d143a56e,1,33,41,8,0,0,0,6,53,5,1,1,0,2361,51,16,546,544,2,15895,15864,31,72,71,1,100
6982de4a6f64f4dfc9db85312f5f19567910fdea,13,72,93,21,0,0,0,2,68,96,1,10,3.396650698,6253,295,14,1397,1407,10,41870,41848,22,294,298,4,100
def516103700f2f9a9c4bdf18888eb461dfb61f3,3,1,12,11,0,0,0,4,33,9,1,3,1.419556299,977,296,15,180,182,2,6741,6804,63,56,56,0,100
021a79354809056ffff5358a162b3d9df3c1a047,13,694,288,406,0,0,0,3,50,193,2,7,2.70330086,6254,37,1,978,944,34,49190,47205,1985,302,271,31,99.59796868
95bdde3ec0849f1d3aa4f3a1fc4ca85dca8c6fd5,7,927,0,927,7,0,7,1,1,0,1,4,2.535001661,0,38,2,83,0,83,3084,0,3084,38,0,38,99.40488842
a3e2b928c4c96ec4ac96dc0f9ea03660a2cc73c0,2,61,0,61,0,0,0,3,16,289,2,2,0.409073139,771,39,3,133,128,5,6161,5895,266,40,39,1,100
0f7466aac22a2c94410e1a79335d9fa6eaff6442,18,126,490,364,0,0,0,2,34,124,1,10,1.495573275,4600,297,13,870,913,43,25453,27456,2003,400,401,1,100
86b05c903cea6b312978f2750aa8bf5978c3ceea,14,24,23,1,0,0,0,4,55,144,2,11,3.077172641,8494,298,14,1783,1783,0,60169,60115,54,421,421,0,100
7493377df2a9d97da3accad99f2a43a9ec557ab6,2,200,2,198,0,0,0,4,10,281,2,2,0.974319721,1673,40,4,168,150,18,11981,11093,888,80,70,10,99.81016663
0ba56dff0caca9c95c7040aba89cd647b1e23ff1,2,271,6,265,0,0,0,4,11,13,2,2,0.987091159,2372,41,5,328,294,34,17317,15981,1336,112,106,6,100
8e8aeb148236938aa5a0028fd5cf8b8c9efc6234,2,142,62,80,0,0,0,1,7,40,1,2,0.936667382,1714,253,7,331,317,14,11853,11425,428,97,96,1,100
d533f69e94217a992412cad344bd18a4c75cd575,3,40,15,25,0,0,0,4,7,162,2,3,0.957189087,604,254,8,91,89,2,4599,4425,174,22,21,1,100
085f7c77c6faac4952cd79c58cf599004f707061,2,61,0,61,0,0,0,3,17,10,2,2,0.680793775,817,42,6,138,133,5,6417,6161,256,42,40,2,100
5964ce236beaa535c8e1f24deafcd76677ca23d0,6,233,93,140,1,0,1,4,52,15,2,5,2.159645127,4130,43,7,612,595,17,33250,32462,788,141,136,5,99.93689525
b491d62feb74c1e1d5e8cc34a80d3f8ecb99acb4,4,298,111,187,0,0,0,2,33,18,2,3,1.413262435,2676,44,7,377,356,21,21327,20302,1025,100,98,2,100
a3bd0adb49c5036408b2973c01a34d7537b8d37b,11,37,50,13,0,0,0,3,69,197,2,9,3.053401722,3733,299,12,712,712,0,23754,23757,3,214,214,0,100
b48062d53a5a1dc9018ad400513cbd15de11f0ca,2,60,17,43,0,0,0,2,3,780,2,2,0.934646644,300,255,6,51,48,3,2359,2116,243,25,25,0,99.97898277
3af741d2de0357bd776e68bdde56ea53fd44bd7b,0,0,0,0,0,0,0,0,0,0,0,0,0,0,256,7,0,0,0,0,0,0,0,0,0,100
4c9ab45224ed2db0d7ae3a73122d3d90cfcec028,106,6962,573,6389,37,0,37,2,8,12,1,11,5.393809723,19219,257,8,3051,2531,520,188061,156420,31641,1068,869,199,84.18627213
44a622f8cc460734deb293bef1ebbcebc8e6dd49,2,485,0,485,2,0,2,1,1,0,1,2,0.949957011,0,45,8,55,0,55,2242,0,2242,22,0,22,99.77070794
059aa469202b9a98b78004f65dc358693371239f,2,83,38,45,0,0,0,5,35,52,1,1,0.888248047,937,52,5,164,158,6,7288,7032,256,30,29,1,100
a4e4c4c8d3749424ef04310230af4b7f3e2967e7,1,30,0,30,0,0,0,5,10,504,1,1,0,173,46,9,27,21,6,1427,1319,108,20,14,6,100
19ed33dcab3caafbd6dca9c0aeac755cfd90cc3d,6,430,11,419,2,0,2,3,8,0,1,2,1.216485543,1835,47,10,336,323,13,17438,14552,2886,118,109,9,100
3f979a89e7c3c60bbfa96adcd612b52d4aa83858,18,3630,39,3591,5,0,5,1,9,8,1,7,2.488866915,6262,258,6,1436,1252,184,72430,44043,28387,493,411,82,85.89211618
c030c5e4df744f3ec80216e632235be7bbb4fb1a,2,134,2,132,1,0,1,1,6,29,2,2,0.543564443,165,300,4,36,23,13,1633,1081,552,17,14,3,99.96471418
07bdb8c28b4740e9806bb7c46b8cae3b4b89d351,0,0,0,0,0,0,0,0,0,0,0,0,0,0,301,5,0,0,0,0,0,0,0,0,0,100
5ab976032700eeccb85df2d7513633c3eac16049,18,2002,14,1988,8,0,8,1,36,36,2,6,2.988265428,2845,53,1,845,558,287,30131,19261,10870,305,212,93,95.76852316
5ec700ed43bf87d91bc7b52950c72868d0f27880,63,3528,506,3022,8,0,8,2,33,252,2,9,5.113729936,8750,54,2,2229,1705,524,69358,55184,14174,766,612,154,93.62398759
7886cc4ab0d8706fd4beb3ec0b7817ce5c01227f,0,0,0,0,0,0,0,0,0,0,0,0,0,0,302,5,0,0,0,0,0,0,0,0,0,100
2f927c23b57dfa9c46f4c04f3a9fbe95a09c7436,0,0,0,0,0,0,0,0,0,0,0,0,0,0,303,6,0,0,0,0,0,0,0,0,0,100
e830eeae5b31b51498a68f6d20c87844bfe81904,0,0,0,0,0,0,0,0,0,0,0,0,0,0,304,7,0,0,0,0,0,0,0,0,0,100
1a0b140b37f45c0b09b58d10d7de6840ff3276ca,3,18,1,17,0,0,0,5,37,44,1,1,1.529428332,1265,259,4,216,216,0,9286,9192,94,42,42,0,100
f6ca637bba3a774ac13fd1a55edd5eda1026810f,5,392,0,392,5,0,5,1,1,0,2,3,2.039474938,0,260,5,30,0,30,1479,0,1479,18,0,18,99.79358229
8e04dff48fe298ba58c5fc7b1dbbf7b79ace7ebf,5,361,272,89,0,0,0,4,34,59,2,3,1.65556394,3321,55,3,471,457,14,23348,22275,1073,153,154,1,100
f3f3126d87d75acfc530fe1b2e311c1456535934,12,130,110,20,0,0,0,5,70,210,2,6,3.036327756,5366,305,5,805,790,15,38170,38313,143,395,392,3,97.10034338
ab33ae58ef726b560ff2e19d3aa007ef3e985734,68,11961,284,11677,36,0,36,1,10,24,1,10,4.558913993,9945,261,6,2927,1646,1281,128294,76249,52045,1220,580,640,92.09786742
7290257f81fc5d51d1f904d8a036fd304d4409d6,3,133,79,54,0,0,0,6,61,152,2,2,1.467994508,5946,48,3,644,634,10,47327,47287,40,312,308,4,100
5f6dddb125f1943d81e7f7c64e33f76f76277c8a,0,0,0,0,0,0,0,0,0,0,0,0,0,0,262,4,0,0,0,0,0,0,0,0,0,100
3f76a83071125976cd0503ac917e05e3c0f3d733,2,137,2,135,1,0,1,1,9,21,1,2,0.108650459,1094,263,5,240,237,3,8466,7655,811,80,76,4,99.97124784
4a50c6b4ffb21eda5ef89ccf47dde97ec4058647,1,73,49,24,0,0,0,4,38,21,1,1,0,662,306,6,134,129,5,5303,5146,157,26,25,1,100
337f5fb5038215ac2396e47aa1c1146f25083f07,3,60,38,22,0,0,0,2,6,722,2,2,1.26107693,1425,307,7,286,280,6,9968,9765,203,43,42,1,100
35ada1f1b8bafbf197174481b8b79ffa2ea290cf,3,512,29,483,1,0,1,1,9,10,1,3,0.724900862,2159,264,5,498,463,35,17086,14502,2584,173,164,9,95.22613065
aa8875af39ea2c20a88c50a9e33e4109ce686f7c,1,5,0,5,0,0,0,6,62,15,1,1,0,1782,265,6,236,235,1,11201,11187,14,180,179,1,100
49c6768fc1be75aa252446700c8d168f6c676869,0,0,0,0,0,0,0,0,0,0,0,0,0,0,308,8,0,0,0,0,0,0,0,0,0,100
87cce5aa91d590fc04a5be2bc8dc008d760db9d2,3,114,20,94,1,0,1,1,5,46,1,2,1.197002196,816,266,7,229,227,2,6468,5914,554,58,57,1,99.96539792
a469100d879efc356b514aab2a0fde27fb0c0abc,2,95,1,94,0,0,0,2,2,176,2,2,0.200622324,603,309,4,105,90,15,4685,4130,555,25,23,2,100
c61e9ee61ba046b9de9719b48af24341395eaee4,2,269,1,268,1,0,1,1,3,70,1,2,0.492046046,120,267,6,35,10,25,2213,746,1467,11,6,5,94.64199517
b090e01b7c8a80f50448a5b95f712de4f42279bf,2,73,0,73,0,0,0,3,5,350,2,2,0.805804911,1034,268,7,132,121,11,8745,8368,377,62,60,2,97.61762954
47790091c79b5a81d245893829ef4a8a69a025e2,2,38,7,31,0,0,0,4,13,38,2,2,0.970950594,2707,310,5,343,341,2,18478,18345,133,113,112,1,100
23759a79c9cf27cbba24639c1127deb0177caf4e,5,129,3,126,1,0,1,1,37,124,2,3,1.232763613,2724,269,8,440,430,10,20699,20043,656,118,111,7,99.91154356
f91f785628ebfe1816b96f30560e9d5281fb02b0,0,0,0,0,0,0,0,0,0,0,0,0,0,0,311,6,0,0,0,0,0,0,0,0,0,100
cf2c6cd13fc2af64be3da61cd4e531e465ecff74,8,130,85,45,0,0,0,1,11,76,1,4,2.387838941,5169,270,9,1209,1205,4,34261,34250,11,397,394,3,100
14bb336b26def4ad822d39292a73e694ae220f9f,2,68,3,65,0,0,0,4,14,2,2,2,0.655444445,2732,312,6,348,343,5,18811,18478,333,114,113,1,100
b408e2517df9b3b140bdb541f49b676d9c4488ba,2,32,3,29,0,0,0,6,53,110,2,2,0.994693795,2523,49,0,342,339,3,21017,20891,126,84,83,1,100
b84b889829fd34172d9332ebb8564e0c2a58c0d3,2,77,0,77,0,0,0,4,15,2,2,2,0.481225664,2783,313,7,353,348,5,19227,18811,416,115,114,1,100
95f98f81714a4cc47dbdefdc6320379e79018ea1,0,0,0,0,0,0,0,0,0,0,0,0,0,0,0,0,0,0,0,0,0,0,0,0,0,100
1ca02d3f22ecb72afdad420327d18f3db56ea749,4,182,126,56,0,0,0,5,16,22,2,3,1.915047217,3211,271,8,428,426,2,21627,21416,211,152,149,3,100
bfaa751e5c834cccbc89c34556a6d1e8706671af,68,3936,268,3668,4,0,4,4,71,194,2,17,3.621148174,24581,56,0,4308,3803,505,206073,183493,22580,1506,1370,136,94.26177679
3dd42920dfa732e600512ebdc281bdd5390001df,0,0,0,0,0,0,0,0,0,0,0,0,0,0,314,8,0,0,0,0,0,0,0,0,0,100
cab985432dd01a68b342a1a5ea58b4b0d2befd4b,7,3581,27,3554,6,0,6,1,5,10,1,3,2.548793937,173,1,1,528,35,493,22572,1323,21249,112,20,92,95.58019929
03ccf91d9ce13d0d814fe6042cd9d43633201f0c,4,1471,43,1428,3,0,3,1,5,18,1,2,1.809780905,401,2,2,219,77,142,13306,2927,10379,63,33,30,99.9088423
0f4ec249bb2fc42d1675d3dcebf86b890dd81aba,2,9,4,5,0,0,0,2,2,391,1,1,0.995727452,291,315,9,63,63,0,2199,2141,58,28,28,0,100
ac60cca4e1175d550f52676171d2156b3c90c76c,2,17,1,16,0,0,0,2,6,66,2,2,0.764204507,625,316,10,117,114,3,4650,4546,104,34,33,1,100
52ee637c49120ba7f71ab6d7d3b793f66c619c69,6,235,62,173,1,0,1,3,6,58,1,2,1.63968183,2223,3,3,215,211,4,19113,18098,1015,83,79,4,99.9696694
b0fb363461b91fe8fc30a98ad565cc233786e6ba,3,25,6,19,0,0,0,2,36,44,2,3,1.238278588,856,317,11,119,116,3,6786,6665,121,38,37,1,100
082384cae5ef2bba8c7280cd4db0e8ffc1095e56,0,0,0,0,0,0,0,0,0,0,0,0,0,0,318,12,0,0,0,0,0,0,0,0,0,100
6481ea7d74e9ac335b854bc3f7e6a14be1d486c4,13,745,29,716,4,0,4,1,7,31,1,6,2.286460171,3738,4,4,710,617,93,32487,28983,3504,197,155,42,96.07255284
ba07d5b2ce43481222ffdcf99bb4170ed1bfa4a9,2,30,1,29,0,0,0,1,40,10,2,2,0.708835673,1889,57,1,224,220,4,16428,16229,199,75,74,1,100
8b92fad2d119400ff564236540bc05cb13a103e5,9,73,15,58,0,0,0,1,56,19,2,3,3.0117345,4970,58,2,892,883,9,36181,35586,595,233,232,1,100
23c4f0d2013f8e5779f1f5d0e8e7c1a1b39b1a07,1,6,0,6,0,0,0,4,10,14,1,1,0,186,59,3,22,22,0,1373,1338,35,13,13,0,100
30b0cab58d94b90375d32a3d7c1ef40710796077,3,122,65,57,0,0,0,1,4,8,2,3,0.936681816,1992,60,4,279,278,1,17615,17208,407,78,77,1,100
18842a50b43f7d63ca12b4837e55b42f0313f61a,19,6096,115,5981,11,0,11,2,12,8,1,6,3.185424821,4623,5,5,1662,889,773,71053,33338,37715,429,270,159,95.75632116
7db6f1b88e7d7e4d092d88f5a288d126edef2b95,1,1,1,0,0,0,0,5,55,17,1,1,0,1799,319,10,302,302,0,14984,14984,0,55,55,0,100
78822feb85ed575434a9f9bbca6d259127941329,5,62,10,52,0,0,0,4,26,159,2,5,1.187679854,1090,320,11,173,166,7,7861,7458,403,54,53,1,100
cb4cfcd478f07dba8d3c421c3fd841396f852c47,2,30,2,28,0,0,0,1,11,12,2,2,0.448864489,1657,61,5,161,160,1,14858,14637,221,77,76,1,100
f01017f099d21216cf83e4fbea3a8855d104fbce,4,599,3,596,1,0,1,1,13,9,1,3,0.119142603,3553,6,6,818,776,42,26561,23072,3489,283,266,17,99.97052756
41aa1b49b5d7a5cb96385500639d793153dc8659,5,98,5,93,0,0,0,1,39,10,2,2,0.752239728,2678,62,6,351,347,4,21733,21035,698,139,135,4,100
0330d06733f664cf9728516cdae1dc5a105c7dc8,2,20,1,19,0,0,0,6,64,633,1,1,0.702466551,1883,63,7,246,244,2,11807,11686,121,184,183,1,100
0e0a87df1f0005d3bfd715c64e61d3bc341da452,0,0,0,0,0,0,0,0,0,0,0,0,0,0,321,12,0,0,0,0,0,0,0,0,0,100
e291339db66a7112f198b8021489e8b520cca856,1,3,6,3,0,0,0,4,10,123,1,1,0,309,322,12,49,49,0,2126,2149,23,16,16,0,100
9e117e43115fe8e0a560c278961860fc41dc175d,3,120,55,65,0,0,0,4,57,217,2,2,1.051300535,2678,323,13,561,559,2,17283,16808,475,87,85,2,99.92639482
8457037cea03a0c5732c80c53080352b37428eda,11,1294,93,1201,8,0,8,1,35,29,3,7,2.996323424,1563,272,1,591,449,142,15662,10428,5234,169,99,70,99.75055026
ffb6c7b9306116af31e08bf064cc691542e509da,0,0,0,0,0,0,0,0,0,0,0,0,0,0,324,11,0,0,0,0,0,0,0,0,0,100
3a99460a6eab155751e516265d897f520b73018d,1,10,1,9,0,0,0,4,31,39,1,1,0,304,64,8,59,58,1,1831,1802,29,21,21,0,100
c1277492ece23c0a9adce20e0c529a49a01e4ab7,2,25,0,25,0,0,0,6,65,14,2,2,0.904381458,2446,325,12,367,364,3,15810,15660,150,206,205,1,100
29a4916dd8a850ebdd3ac707a91339f66b8fdbef,6,104,8,96,0,0,0,2,5,535,2,4,2.584499645,718,326,11,89,89,0,6276,6276,0,45,45,0,100
9618e81db220a9762ec75af529fafb057328be3c,2,69,2,67,0,0,0,5,56,225,2,2,0.507935356,2192,65,8,318,314,4,16918,16422,496,63,61,2,100
d6ef87f5eef8ec9e1ca562732fe5944347b834c3,1,29,24,5,0,0,0,5,37,33,1,1,0,385,66,9,61,58,3,2865,2839,26,7,7,0,100
18cd8ccf0f2ef23d864ebbc684bd0b35d148be73,2,69,3,66,0,0,0,5,17,44,2,2,0.581321499,2895,327,10,364,357,7,19833,19499,334,118,116,2,100
a04bfaad15e3f9077e93ae73cea1d23226501acd,7,202,10,192,1,0,1,1,37,312,2,5,2.064115423,2314,273,1,362,344,18,18138,16817,1321,139,131,8,89.25689307
d9cdcbe5cfc4c10a3186f6a9a89cb31d937f15bf,0,0,0,0,0,0,0,0,0,0,0,0,0,0,328,11,0,0,0,0,0,0,0,0,0,100
908e5c36292bf726aeb9c3bf5b5b593aef9308a4,0,0,0,0,0,0,0,0,0,0,0,0,0,0,329,12,0,0,0,0,0,0,0,0,0,100
be815edd65dcda8a84486a04387f83ec18cd9878,7,128,19,109,0,0,0,6,57,113,2,3,2.240048655,3087,330,11,490,482,8,25239,24494,745,136,133,3,100
645074277843e438ee64d9345f6dc578fc5d4fb6,2,20,8,12,0,0,0,2,5,26,2,2,0.591672779,245,331,12,30,29,1,1576,1470,106,22,21,1,100
044210b08533c70509aaf8cfb42042c85c37a06e,1,48,46,2,0,0,0,5,11,136,1,1,0,197,332,13,28,27,1,1419,1427,8,20,20,0,100
b3fc7567feaa4fdeeba97e305b0edc0d5d748f3d,3,23,7,16,0,0,0,4,7,87,2,3,1.549397853,1013,333,14,139,138,1,6781,6727,54,58,57,1,100
6daa33565f585e7d61877de1b03bfe7551aee40f,2,23,2,21,0,0,0,1,7,42,2,2,0.634309555,1446,67,8,107,106,1,13771,13614,157,64,63,1,100
d275c33bc83985fb67da6e20e04567a622ee25ae,3,174,15,159,1,0,1,1,11,55,1,3,1.123571722,1555,7,2,291,274,17,12506,11384,1122,99,96,3,99.96050553
64f1ecfd34fe631f041c5d1d8609275482c94f39,1,208,0,208,1,0,1,1,1,0,1,1,0,0,8,2,8,0,8,1364,0,1364,5,0,5,100
39983fe34ce96412405279c103aeb7ac9ad94fb2,1,1048,0,1048,1,0,1,1,1,0,1,1,0,0,9,3,100,0,100,5391,0,5391,20,0,20,98.02487198
3711247d59a298b502124e8ec9a70c6dabbaa0bb,8,56,2,54,0,0,0,3,22,235,1,2,2.587514946,2228,334,13,482,475,7,13593,13225,368,157,155,2,99.60697198
8dcafca5f46d804d6abdfb52ea5ad5873181e136,1,27,0,27,1,0,1,1,1,0,1,1,0,0,335,14,0,0,0,16,0,16,0,0,0,86.18545043
b07e93a2c1370294ff3e22dfdaead077473d74c5,4,52,1,51,0,0,0,3,58,128,2,3,1.340289217,2544,68,6,419,415,4,20276,19961,315,127,124,3,100
e18c5bcbcb37cd80e76d13803da573a432a7641b,7,200,156,44,0,0,0,1,41,45,2,3,2.165387587,3412,69,7,547,536,11,27436,27184,252,139,134,5,100
eeee5af16f3f36e42fe709978eaad13e78262910,4,668,30,638,2,0,2,2,7,38,1,2,1.240708902,1030,10,3,211,138,73,11922,8163,3759,70,54,16,99.7286579
dcee7a3219d0a51edf7f258a72ad4f121f8eac43,4,61,7,54,0,0,0,2,42,153,2,3,1.721072796,2351,70,2,448,441,7,18383,18030,353,79,77,2,100
00a1dcf4ce3af98410d2d6f6d6fd41ab5c71ac02,0,0,0,0,0,0,0,0,0,0,0,0,0,0,336,2,0,0,0,0,0,0,0,0,0,100
48e841a3489ad4f4fc8828ad8db41a162e5b3035,0,0,0,0,0,0,0,0,0,0,0,0,0,0,71,3,0,0,0,0,0,0,0,0,0,100
2abd052b2352ce50c8185cc97c85b176bef60334,4,83,11,72,0,0,0,5,59,53,2,2,1.306811308,4901,337,3,703,697,6,36310,35995,315,214,213,1,100
6c465b77d915341d3b975369ffb5462d43083091,0,0,0,0,0,0,0,0,0,0,0,0,0,0,338,4,0,0,0,0,0,0,0,0,0,100
d41f21a0862d19deeae503624969feceaa27b115,30,97,1859,1762,0,0,0,1,30,464,2,10,3.431711454,5563,50,0,653,786,133,29357,33783,4426,299,427,128,92.81425891
2f66361300c25d9e5ebd2e63b6e2c63898a56034,0,0,0,0,0,0,0,0,0,0,0,0,0,0,72,4,0,0,0,0,0,0,0,0,0,100
ac4d58d8d6628423debe97a3be9cdd096176fb4f,3,57,3,54,0,0,0,1,9,28,2,3,0.98159126,2104,73,5,288,283,5,18656,18269,387,89,88,1,100
8784cf14a3da8ebc39692ad5a56225e075386341,22,2976,0,2976,22,0,22,1,1,0,2,5,3.879275948,0,274,0,299,0,299,12050,0,12050,125,0,125,99.17019475
05638844517d45e2115a3a0f848ed283fbb5dd99,5,29,0,29,0,0,0,4,14,60,1,1,2.318369254,1519,74,4,324,319,5,8943,8794,149,99,99,0,100
3c390eedc02eeec4ee3cc5abd87ab9d14819e326,1,9,2,7,0,0,0,6,38,81,1,1,0,262,75,5,55,54,1,2050,1991,59,20,20,0,100
65cf8b2febb151bae330ab3c09d88dc8e6482f01,17,685,52,633,7,0,7,1,2,0,2,4,3.751990553,913,275,1,157,116,41,7026,5425,1601,94,56,38,99.61499833
8412ab5b46f90a79e9e9dcc08ec1d4947eaff115,15,125,30,95,1,0,1,1,23,304,2,3,3.000599936,2659,0,0,535,534,1,14665,14138,527,249,248,1,99.96664443
0535481fc1f9792fd733bb6073db9d6b3c6b4a3e,3,229,3,226,0,0,0,6,32,342,2,3,1.291565907,4162,276,2,418,393,25,36201,35368,833,176,154,22,99.96664443
6a25c987be8c93753775fa592451ecb54482da62,2,105,62,43,0,0,0,1,2,206,2,2,0.528671978,895,76,4,135,125,10,6768,6474,294,43,44,1,100
1874ed97af3bca4b512ef3b5fc4dad8dc25ccaed,2,19,1,18,0,0,0,3,13,109,2,2,0.468995594,648,77,5,86,85,1,4661,4548,113,39,38,1,100
3bf16090444347e94c0f359a2c81d264c589d226,15,30,125,95,0,0,0,2,24,0,2,3,3.000599936,2735,277,3,534,535,1,14138,14665,527,248,249,1,99.96662216
e20b9d4552f8f67dddea36b9244792276c652f48,0,0,0,0,0,0,0,0,0,0,0,0,0,0,339,0,0,0,0,0,0,0,0,0,0,100
aed1e6e4aeeaebe712c0e330c050ec1ef3d4d782,2,61,8,53,0,0,0,1,10,42,2,2,0.996208884,1949,78,4,242,238,4,17854,17492,362,72,71,1,100
75c89b6acd6060385f88dc5539a68226271bb696,2,8,61,53,0,0,0,1,11,0,2,2,0.996208884,1987,79,5,238,242,4,17492,17854,362,71,72,1,100
18a3b435eaed0ada811c95457d73c2efc20dfe4a,3,77,29,48,0,0,0,1,43,26,2,3,1.581698294,2745,80,6,408,403,5,23395,23047,348,96,95,1,100
85520a095e4bfecae100e2cf0be73ee12b469568,5,11,6,5,0,0,0,5,60,263,2,4,2.094856784,3625,81,7,516,514,2,29055,29005,50,196,196,0,100
be16fbdc056e57532cc9c4dafa6008ea663e49ec,2,41,4,37,0,0,0,2,6,768,2,2,0.764204507,491,0,0,71,68,3,3549,3270,279,25,24,1,100
c4ad5d6226847447cc79ef303165ec76b6e8305c,2,82,6,76,0,0,0,3,18,830,2,2,0.925685987,643,0,0,135,129,6,4696,4286,410,41,40,1,100
1cc47707d1f9afd58f062383e72681e75b5cc054,2,3,9,6,0,0,0,3,10,126,1,2,0.811278124,198,1,1,23,23,0,930,953,23,15,15,0,100
6200f321e8e27e9eb6ab2afb96ce5fce37700574,2,51,3,48,0,0,0,1,44,12,2,2,0.309543429,2154,82,6,242,238,4,19056,18745,311,90,87,3,100
36cdce7518d0154816d70f62d47f8b339e05eff7,2,41,2,39,0,0,0,3,33,170,2,2,0.693127415,2925,83,7,413,408,5,25733,25417,316,131,130,1,100
103e915908a6ebf391a1c0ca0d00804f8136ce7d,3,105,10,95,1,0,1,2,40,267,2,2,1.311533484,1431,51,0,262,258,4,11445,11053,392,65,62,3,99.94993324
99efaadcee687dbf60ee19bd57b9dc0827c3758e,1,6,2,4,0,0,0,5,41,80,1,1,0,694,2,2,137,136,1,5395,5384,11,26,26,0,100
f0b094d4e5f23a23a517873a3c555736c096f2c9,2,70,3,67,0,0,0,2,39,283,2,2,0.996613283,448,278,1,80,73,7,3952,3572,380,32,31,1,100
3c86aebfe3a62665f885cc727dc1de9d5256060e,0,0,0,0,0,0,0,0,0,0,0,0,0,0,340,1,0,0,0,0,0,0,0,0,0,100
d923ea8810eed5c1b80697706731005d7844941a,2,48,2,46,0,0,0,6,27,307,2,2,0.40217919,1226,3,3,174,173,1,8176,7871,305,82,79,3,100
39d4f3f873971623e8668041d92bd58d0b261448,1,11,1,10,0,0,0,2,2,1373,1,1,0,191,4,4,43,40,3,1229,1146,83,9,9,0,100
780138abecf99393106b946ef9574a94f1504990,2,73,4,69,0,0,0,3,10,304,1,1,0.80609147,657,5,5,90,83,7,4714,4177,537,32,25,7,99.98331665
8f4889bb60e4fa95a5b0253d361a33cb72c335ea,3,65,25,40,0,0,0,5,14,199,1,1,1.564607351,730,6,6,160,151,9,4821,4679,142,55,55,0,100
6f4d02131239686d877e1f34f886e09bcfb4cd2b,3,44,6,38,0,0,0,3,12,182,2,2,1.07832208,1166,84,2,187,183,4,9972,9761,211,57,55,2,100
084c0d06c88586e7d4a69bccd3403ff5a89e6dcc,2,14,2,12,0,0,0,6,10,29,1,2,0.988699408,377,7,7,87,86,1,2247,2199,48,32,31,1,100
e35265a9624be29278eb7e17674c380cf021acdf,3,358,109,249,0,0,0,6,36,628,2,3,0.898747298,888,279,1,334,290,44,7596,6144,1452,56,45,11,100
849390649cea6dbb8590bd1c096ba9b51817d8b4,2,72,7,65,0,0,0,4,18,302,2,2,0.990617497,863,8,7,146,138,8,6827,6417,410,47,42,5,100
02d485125b16a8924b332c556866bbe99e403b12,66,9099,260,8839,34,0,34,1,72,72,2,12,4.95410648,3565,280,2,1335,599,736,77759,22298,55461,606,278,328,88.65019692
f45ae496182a44c91cce7b34c01c9d2f7934afbd,1,4,4,0,0,0,0,6,22,24,1,1,0,599,9,8,50,50,0,4140,4140,0,40,40,0,100
741f18ac38559ab02702b42be401d6c385d1ac17,1,1,3,2,0,0,0,4,13,9,1,1,0,192,85,3,37,37,0,1017,1020,3,12,12,0,100
a50b86661b6d21899024f8149b5e942f6a0c9aa1,2,43,25,18,0,0,0,3,19,33,2,2,1,1035,10,8,184,185,1,6559,6507,52,54,53,1,100
391b4f875ebc7130dd0a03925aae1280b387ec03,2,31,7,24,0,0,0,4,11,194,2,2,0.991992403,339,1,0,48,47,1,2576,2445,131,22,22,0,100
2d71d8c3e2d8ce626e5ad28a4c7856b65f908cbb,2,30,3,27,0,0,0,3,73,144,2,2,0.845350937,953,341,1,176,172,4,6800,6691,109,82,81,1,100
c47f8b11a2447805cf4cc60a84cdb9d843332acb,2,107,1,106,0,0,0,6,19,177,2,2,0.99107606,2383,2,1,258,246,12,16289,15724,565,91,90,1,100
eebff2a86ad6410de9c40e320945931f822bb0f9,346,28941,10869,18072,63,0,63,4,74,346,3,51,7.075165514,78240,52,0,13822,11645,2177,681605,582577,99028,4536,3976,560,90.51414906
cc0273b03b12b02e46ffd313680589b8af593de9,3,76,69,7,0,0,0,2,39,213,1,3,0.957515869,1094,11,6,201,201,0,7988,7914,74,22,22,0,100
23f225b2880e4f9a00f06dec8a84ca122d873616,2,0,156,156,0,0,0,2,4,1788,1,1,0.904938259,56,53,1,0,0,0,0,166,166,0,0,0,99.87639061
35d66a043b87eca36a833129bc739f64c6e0773e,9,202,134,68,0,0,0,5,62,29,2,5,2.574348516,4166,54,2,672,668,4,30998,30696,302,183,187,4,99.97938144
a18157990d213480158b518d8ef4e33c637f73e6,6,54,10,44,0,0,0,2,16,233,2,2,0.98806367,1532,342,1,287,276,11,10799,10426,373,91,90,1,100
78a1d8337cf0bd22042f623eb18e5f94051f5a0e,3,71,13,58,0,0,0,2,40,99,2,2,0.649620782,977,343,2,163,157,6,8276,7896,380,34,32,2,100
2c8586502e582db4584897992e49a97151c11fde,13,18,9,9,0,0,0,3,19,0,2,6,3.482127207,2301,3,2,400,414,14,14409,14815,406,100,110,10,99.75257732
d66738185e00a85639bbddbcfb8758e2bfd60d0f,1,3,1,2,0,0,0,5,6,380,1,1,0,56,12,5,6,6,0,251,262,11,2,2,0,86.84987509
3fa39494c868a6c336038dacc42a3099d3900600,1,62,0,62,1,0,1,1,1,0,1,1,0,0,55,3,6,0,6,270,0,270,2,0,2,99.94941831
219d09003732578c0d4a4a8ac8c3c26bda497d03,20,199,127,72,1,0,1,5,44,1,3,12,3.258376709,6878,56,4,949,952,3,50039,50235,196,375,376,1,92.68292683
f01a90c6843def9d30153a02d8517364760c9569,1,4,4,0,0,0,0,6,34,12,1,1,0,4029,57,5,362,362,0,34548,34548,0,125,125,0,100
c4b9f482315f051b8dc010e7b6d2258ac81b05df,1,412,0,412,1,0,1,1,1,0,1,1,0,0,11,0,45,0,45,2370,0,2370,12,0,12,99.94900561
8086ef4e396a851a1ec76348741b435cf18f6bf1,4,70,39,31,0,0,0,3,63,9,1,3,1.585171459,3212,4,3,560,556,4,25220,25086,134,127,124,3,88.02003921
4543087ad2b630d749d5d3e99bdd4c910ba86e00,2,8,5,3,0,0,0,5,14,14,2,2,0.89049164,306,86,1,29,35,6,1730,2063,333,24,26,2,100
26ea8e259ca78dc51ccbf91f4b415d7d825318fb,2,138,8,130,1,0,1,1,5,7,1,2,0.705181972,149,12,1,47,36,11,2105,1318,787,9,6,3,99.27522411
6137a40ab7b27d3f3b9fe2509449d598fb2f7394,18,751,125,626,0,0,0,6,58,121,2,10,2.933210103,10000,87,2,1912,1801,111,78210,73555,4655,425,401,24,99.98087223
1246574aeeb56b4de681d2e053b55f480b7d0eda,2,6,2,4,0,0,0,3,11,8,1,1,0.954434003,177,58,6,30,30,0,1057,1057,0,9,9,0,100
aa7900e35f7b96aeab5fb10224e35220f04437a6,1,0,193,193,0,0,0,3,3,17,1,1,0,153,88,3,0,9,9,0,1127,1127,0,5,5,99.96172981
788880cdb00d24b286037ee5e1f8b70ac8a48a79,8,106,56,50,0,0,0,5,75,7,2,6,2.378300451,4345,13,3,654,642,12,33284,32553,731,218,212,6,99.08310574
973708baefe77be193a7553870007cd10100281b,28,615,287,328,0,0,0,6,76,48,3,13,3.845413572,7257,59,7,1160,1130,30,52740,50604,2136,448,440,8,99.44499504
bea14028e659c660c4735b22e2f1d4147734c2b4,3,92,14,78,0,0,0,2,35,16,2,3,1.508754573,1435,5,2,310,297,13,10400,9919,481,82,81,1,100
927773d17cb1d275f4390daaac367862e414bac1,5,53,12,41,0,0,0,5,64,30,2,4,1.575136463,2595,6,3,421,420,1,20808,20573,235,83,82,1,100
4c16f67b52f5c8e97abb6c279e411e075721b46d,5,47,26,21,0,0,0,5,42,26,2,4,2.051882977,2007,60,8,411,405,6,14095,13975,120,127,125,2,100
72f5075256686a1eab456146b3eb63558c80ac42,0,0,0,0,0,0,0,0,0,0,0,0,0,0,281,0,0,0,0,0,0,0,0,0,0,100
f4c811aed92d74756464510384f93161f7b34907,2,2,2,0,0,0,0,6,21,12,1,2,1,1102,89,3,299,299,0,7001,7001,0,49,49,0,100
1dfe9d26365bf6d4def5bb382de70353c196d832,1,193,0,193,1,0,1,3,4,22,1,1,0,0,90,4,9,0,9,1127,0,1127,5,0,5,99.96050553
7f1467f448958faad1dc7a7ce9ee86a1cc26801b,1,6,3,3,0,0,0,3,6,27,1,1,0,159,13,2,38,38,0,1399,1388,11,6,6,0,100
1176b1d713ed4650fb6a79c6488755dd03188638,41,2395,755,1640,11,0,11,2,77,28,2,9,4.417850677,7175,282,1,1065,896,169,71003,59413,11590,539,419,120,86.05848435
a1a813714b262538fd23c5ac831a8e833a74e274,5,845,242,603,0,0,0,2,15,111,1,4,1.858809564,4959,14,3,1127,1005,122,37321,33503,3818,358,342,16,99.89231101
1e9ce4d520646b455eab260d0d5e0d65dd4ff473,7,122,91,31,0,0,0,2,3,835,1,2,2.737991807,362,0,0,37,35,2,2247,2019,228,17,16,1,99.95687796
108b283b94becc9b07c4b5a6e20e69259e37016a,23,1530,823,707,0,0,0,2,5,58,1,2,4.384471769,13919,15,4,2339,2290,49,111889,109125,2764,433,411,22,99.18959266
b83489d7b3284101c70fdfaf168579544183081d,11,510,0,510,11,0,11,1,1,0,1,2,3.317899394,0,1,1,59,0,59,2995,0,2995,18,0,18,99.26563156
7f2658f4f8d8caeea6d5a1ad94509f6daade3f55,2,27,2,25,0,0,0,4,16,4,1,1,0.66319684,3154,16,3,708,703,5,20223,19937,286,231,231,0,100
3a11ac89cb527101b710ae0b82d700c6bfa7ca83,2,137,26,111,1,0,1,1,65,8,2,2,0.999755636,1812,7,2,315,306,9,15567,15070,497,59,55,4,99.95826377
a78d3512d761ec1a828015414e41dbb1e32e463b,2,35,0,35,0,0,0,7,24,187,2,2,0.951762676,732,8,3,69,65,4,5032,4784,248,46,45,1,100
34cf636aae0a30365f6072baa79455ed7f58b8c3,2,89,0,89,0,0,0,6,22,219,2,2,0.840980534,2471,9,4,257,249,8,16626,16032,594,105,104,1,100
45de4551cd76e4ab49f4bb58b0542eceeff8db23,0,0,0,0,0,0,0,0,0,0,0,0,0,0,17,4,0,0,0,0,0,0,0,0,0,100
93df340c03a981b93d884b393f9f09d739408984,16,42,53,11,0,0,0,2,66,86,1,9,3.305497732,6288,91,2,1303,1302,1,43486,43539,53,356,357,1,100
44764dc3220b2f17debcf59fe5c8fca41be1449f,2,27,9,18,0,0,0,3,18,32,2,2,0.811278124,618,92,3,137,133,4,4355,4229,126,40,39,1,100
e5c2e7e59c33535492ae64868c3ff9a2785bbc89,23,98,709,611,0,0,0,1,8,280,1,4,2.462361227,6564,18,5,617,668,51,52202,56562,4360,192,196,4,99.77054652
8171bd78e0ac813926d43bdff3f19f96c34b04f6,2,34,1,33,0,0,0,2,15,60,2,2,0.985228136,2023,93,4,248,245,3,18889,18622,267,76,75,1,100
4ee17f40740d8f304a9e15c9d76d8ef9bcc8227d,2,1,34,33,0,0,0,2,16,0,2,2,0.985228136,2050,94,5,245,248,3,18622,18889,267,75,76,1,100
c074d036aafb2a8a9486a04f76ca06059bcce6cf,1,6,27,21,0,0,0,4,10,6,1,1,0,191,61,2,28,30,2,1400,1543,143,7,7,0,100
24fc0d134bc32ad1a79b9f6507dec9d0b567d2b8,3,37,4,33,0,0,0,2,23,8,2,2,1.441656984,4349,95,6,464,461,3,34100,33833,267,170,169,1,100
344ac781a15d447fdc4f6c6ec680b3d1e5d075cb,43,6773,248,6525,17,0,17,6,44,9,2,8,4.120821079,5239,96,7,1288,743,545,84047,43865,40182,619,383,236,90.2334547
9e6f8087796ee35dd44be1fd2e0349128706f75c,10,136,46,90,1,0,1,5,67,57,2,5,2.651948448,3450,14,0,541,531,10,26660,26137,523,145,143,2,97.57204447
13e6b190251feafb655b263a5af13cf5eb2201f3,2,20,1,19,0,0,0,1,10,22,2,2,0.702466551,310,15,1,63,63,0,2293,2282,11,21,21,0,87.81486791
864910a0890edd6ec9f94f9ddfcd40b9cacbb714,6,499,75,424,1,0,1,6,36,92,3,4,1.871558466,2038,62,2,389,353,36,15035,13364,1671,147,129,18,99.87277354
13fe1444f40dd96e1b082a293215f45d5712e680,0,0,0,0,0,0,0,0,0,0,0,0,0,0,283,2,0,0,0,0,0,0,0,0,0,100
6cea5af3a3b32bdb423b66c2bfd54a08f9935baf,2,680,0,680,2,0,2,1,1,0,1,2,0.478250164,0,284,3,61,0,61,2130,0,2130,27,0,27,99.92743106
d7166d9f626b28765d638d6bbb84891c50a140ab,6,67,59,8,0,0,0,4,42,118,2,2,1.240735691,1674,63,3,234,238,4,13301,13576,275,45,46,1,100
a36d04c51b00d5ac2fcf71030b373733cf3fdb8a,0,0,0,0,0,0,0,0,0,0,0,0,0,0,285,4,0,0,0,0,0,0,0,0,0,100
f1dac012647bce328892856df56d773f47aaab21,1,1,1,0,0,0,0,3,8,80,1,1,0,91,97,8,14,14,0,624,624,0,3,3,0,100
c76a374c571869599e1a5e3378791731d8f4c793,2,25,0,25,0,0,0,4,43,127,1,2,0.970950594,679,10,3,128,122,6,5224,5065,159,30,29,1,100
338737009ff7d2e2b08bb52dbb091b37859ea7df,2,44,1,43,0,0,0,3,7,318,2,2,0.970950594,1090,98,7,140,132,8,8970,8734,236,63,62,1,93.11790393
557a135269842aeb73436e874a6605440e0289e9,6,1462,0,1462,6,0,6,1,1,0,1,3,2.367289429,0,2,2,147,0,147,6269,0,6269,55,0,55,99.76502182
e84d3f336bc48b8d65f737ffc3e165f56f5daec1,8,264,8,256,3,0,3,5,37,22,2,5,2.675578618,1323,11,4,202,179,23,10890,9573,1317,81,72,9,99.86642177
cca9eca7dfefa24892de890d4e1df83086ee053a,4,10,17,7,0,0,0,4,25,168,1,1,0.973128405,1156,99,8,256,256,0,6781,6807,26,86,86,0,100
33ca73effb19e0fc1bd67331f1f8c4c179ecbe41,2,41,13,28,0,0,0,5,10,147,2,2,0.950956048,1009,3,3,155,151,4,8262,8065,197,57,56,1,100
186f36ba22b438e077fb63e72a9d50ae9cab06f3,11,506,262,244,0,0,0,2,17,115,1,5,2.329569091,7446,19,5,1632,1581,51,52686,51459,1227,583,577,6,99.96662216
30716dbf65c178ba94cc69431f6d6306025d62a4,67,2046,7532,5486,2,0,2,2,7,131,1,4,5.626211558,26952,20,6,2937,3690,753,180317,222739,42422,747,792,45,99.02389768
6f44ca247f8d496bc2d043175fa1c3fdb16a8934,2,0,1282,1282,0,0,0,2,4,388,1,2,0.33995091,1065,21,7,0,119,119,0,7817,7817,0,31,31,99.88119484
1199dfe4adf807723104395322a1d5780c56f6d2,4,65,4,61,0,0,0,4,17,182,2,3,1.508010374,685,64,3,130,116,14,4859,4585,274,37,34,3,99.8980632
0894ef1c524de97622e786ceb449ffeb2dcebe6f,1,11,6,5,0,0,0,4,6,18,1,1,0,195,100,9,29,28,1,1300,1268,32,13,13,0,100
8be96160e79871cd65e3bf8c49b588751b07ecc0,0,0,0,0,0,0,0,0,0,0,0,0,0,0,65,4,0,0,0,0,0,0,0,0,0,100
e77a8a8883b0ee63a0aaa6d4ffaaf6114bf78f39,0,0,0,0,0,0,0,0,0,0,0,0,0,0,344,0,0,0,0,0,0,0,0,0,0,100
662fc382f150205a443811fa1375d5d7fc5ddf59,2,212,1,211,1,0,1,1,9,18,1,2,0.18512476,669,22,6,227,216,11,5657,4684,973,53,49,4,99.91505267
c03ffa8c633df70cd9012dc35d718c683a02f9e2,0,0,0,0,0,0,0,0,0,0,0,0,0,0,345,1,0,0,0,0,0,0,0,0,0,100
341f9c47898be90c15aea92d065542a65dd0382c,0,0,0,0,0,0,0,0,0,0,0,0,0,0,346,2,0,0,0,0,0,0,0,0,0,100
ef15980567c5ba53bd1848ece6e27231aff87825,0,0,0,0,0,0,0,0,0,0,0,0,0,0,4,2,0,0,0,0,0,0,0,0,0,100
42af795f864860502efa7d6697b581cc3683f3f2,2,110,7,103,0,0,0,4,34,39,2,2,0.659850979,529,66,5,95,85,10,3550,3105,445,52,45,7,100
3315919a925cc7b0fcfdf34624e614c0e0f7fe6a,4,88,33,55,0,0,0,6,29,59,3,3,1.137669711,1664,67,6,246,242,4,14913,14682,231,81,81,0,99.93206522
6384e08743191b904e0503e1bbe598ceadbc5714,0,0,0,0,0,0,0,0,0,0,0,0,0,0,68,7,0,0,0,0,0,0,0,0,0,100
f24759e7e07a260bc85c3cbdbfcfb6bb16bb6eeb,17,850,964,114,0,0,0,1,11,42,1,6,2.950491673,5419,23,4,706,736,30,50038,49819,219,260,254,6,98.87770259
e6bafd2729133d7d2b9c5e4d896daf75a46d3c98,0,0,0,0,0,0,0,0,0,0,0,0,0,0,347,3,0,0,0,0,0,0,0,0,0,100
e482bd3664b9bb9624674e5ade75b261bd2a04a9,19,2093,0,2093,19,0,19,1,1,0,1,6,4.2382498,0,286,3,95,0,95,6982,0,6982,63,0,63,99.28218217
bae23a71fd56a29a652e74bd603a71d58fb4b18c,0,0,0,0,0,0,0,0,0,0,0,0,0,0,24,5,0,0,0,0,0,0,0,0,0,100
dc9e98668db8d740b8476e5f840757b987eb04c1,16,1388,113,1275,2,0,2,7,68,118,2,9,2.353090814,7261,16,0,1477,1309,168,59816,52798,7018,472,422,50,97.88538155
6632ed7d42fdaf1c4c91bf9eb4d49d05599f1fba,3,28,0,28,0,0,0,6,25,571,2,3,1.287054028,1671,101,3,279,275,4,12009,11809,200,58,55,3,100
9bea4976e7a8a448761dfa429a37a3c3f18fa4a7,1,9,5,4,0,0,0,6,49,0,1,1,0,815,102,4,157,155,2,6298,6252,46,39,39,0,100
8e0a5f690c85708f8df66f78cbe2f0a6f604d92a,2,96,33,63,0,0,0,4,78,101,1,2,0.471448094,1391,103,5,296,290,6,9650,9522,128,123,118,5,100
165c261edc91acd22040d0dd0367d2c238dcb3c6,3,29,211,182,0,0,0,2,7,30,1,1,1.524786582,1268,25,6,220,253,33,10024,10923,899,25,29,4,100
d7012357277203b1c31ec9fa31480bd06fa07ef5,4,13,8,5,0,0,0,6,31,189,1,1,1.956066972,1283,69,5,156,155,1,9764,9724,40,88,88,0,100
57185da8d0291d6512ba5a365909f1445fdbd34f,2,13,4,9,0,0,0,2,4,463,1,2,0.936667382,150,0,0,14,12,2,976,908,68,9,9,0,100
0070e2d23ac56c4a9d1dbfead0c21589ab39a9d0,8,569,0,569,8,0,8,1,1,0,2,2,2.721548117,0,5,1,66,0,66,2496,0,2496,37,0,37,99.74855791
b9ee53288dbb695ad103450b7c437424a417d03b,10,312,302,10,2,0,2,1,13,50,1,5,2.871096348,2595,26,3,510,525,15,18975,18913,62,184,187,3,99.70457903
a434a5e291bca6a0095b27eb786ca04110f383b4,1,251,0,251,1,0,1,1,1,0,1,1,0,0,27,4,23,0,23,1687,0,1687,6,0,6,99.97044044
afb3e3dba276219b70c4bfe3657fecd8408a2253,1,49,0,49,1,0,1,2,4,143,1,1,0,0,70,4,2,0,2,122,0,122,2,0,2,98.42088806
0b151edc7d75955c1e855cf5a4ef103b5b9bed0b,2,48,24,24,0,0,0,2,38,101,2,2,0.41381685,350,71,4,60,61,1,2363,2149,214,24,24,0,99.88377885
888b56f62902198b7764c64a76ab0c28b5575fef,4,231,18,213,1,0,1,2,6,8,1,2,0.825822332,1104,28,5,230,210,20,9370,8008,1362,72,67,5,89.33658171
163c8d44cf2a77ff71d48a1d60992f4ddef1b88d,12,332,56,276,2,0,2,5,50,53,2,4,2.970697977,3008,12,0,531,499,32,24551,23069,1482,147,135,12,99.84946237
2abd54751d0d03834765c378d0e27a86aa286b45,1,4,4,0,0,0,0,4,13,4,1,1,0,329,29,6,68,68,0,2437,2445,8,23,23,0,100
4825af51e35e0adb2ff9eddb30178f3e9cf69dfe,2,3,2,1,0,0,0,5,35,88,1,2,0.970950594,352,104,3,61,61,0,1960,1960,0,23,23,0,100
af0580bfe5ad3262c8cffcff93222bf9b07ab3ff,1,2,2,0,0,0,0,2,4,0,1,1,0,30,105,4,0,0,0,88,88,0,0,0,0,100
c3d0db567cd9696f4e1a5e23aace23db5559ee31,22,193,186,7,0,0,0,6,67,212,2,4,3.691556934,17688,106,5,1370,1376,6,159541,159092,449,828,829,1,95.53739786
638b9f5a63ce9902d72f10ce1c7f05b04595b765,1,53,24,29,0,0,0,5,14,9,1,1,0,329,107,6,70,68,2,2499,2437,62,24,23,1,100
0d9792f7388043177be7f0cc81f61ae163cbf457,0,0,0,0,0,0,0,0,0,0,0,0,0,0,287,1,0,0,0,0,0,0,0,0,0,100
628b9cf16bfaa2ad94e3574f2fa1f6be3ac622d8,2,166,19,147,0,0,0,3,16,530,2,2,0.995252549,575,72,3,111,93,18,4498,3840,658,47,44,3,100
49b80c1b9965145df5ecdddb0b6a0be9e46a2230,11,185,4,181,0,0,0,2,3,108,2,4,3.459072505,352,1,1,49,49,0,2803,2803,0,20,20,0,100
0da98fcf179eb54706abbc0c1cf6893825698cb7,4,13,8,5,0,0,0,4,13,67,1,3,1.890920994,916,108,7,163,162,1,6557,6507,50,55,54,1,87.12328767
441b528efb958a1db128a5e4ff915f77db4b7fb9,30,886,188,698,2,0,2,1,79,321,1,2,4.228385216,3252,288,1,606,605,1,20178,19109,1069,245,244,1,99.58888341
05ae0b1c0c5e3f36eacbb35d26ce47e0c29f5817,3,29,35,6,0,0,0,5,69,80,1,3,1.166461644,3754,17,1,574,573,1,30235,30326,91,122,121,1,100
a853544fa0db43ff9955c838f3c6b99ed2092cab,2,23,0,23,0,0,0,6,30,92,1,1,0.987692509,579,73,4,75,75,0,4071,4030,41,20,20,0,100
7220d02cc9cfea6e894ea821e92c284787dadb41,1,2,1,1,0,0,0,7,70,2,1,1,0,1961,109,5,336,336,0,16152,16141,11,58,58,0,100
c6efb7ac3aba0f492b4e4938b37c9469d5f28c3a,167,32899,0,32899,167,0,167,1,1,0,1,21,7.020939426,0,289,2,3269,0,3269,136574,0,136574,1647,0,1647,94.48602413
076c4ab19f039ce56ca88e91a628551b91534bce,2,37,17,20,0,0,0,2,7,157,2,2,0.935711051,1003,110,6,120,119,1,8566,8429,137,47,46,1,100
c57a0ef3a3f5bf58512f0e58dc0ea236b2c01f2b,2,112,31,81,1,0,1,5,39,11,1,2,0.824840968,254,13,1,58,52,6,2065,1633,432,26,21,5,99.9713877
c122610e3ec5a7730fde1f6c458b02ef5c09b779,64,1362,177,1185,3,0,3,1,18,159,1,9,3.602254398,16981,30,4,2257,2143,114,143288,135554,7734,817,778,39,97.96334012
d903c785d982ce2ecb434521f0a6b82af6c8bfcf,7,504,308,196,1,0,1,1,42,106,2,4,1.854109766,3712,18,1,530,513,17,28876,27525,1351,192,181,11,99.89643438
8d6dbd6863e4ae5319cf78206a9430fa738f7e2b,1,6,4,2,0,0,0,3,8,0,1,1,0,284,111,7,68,67,1,2048,2040,8,8,8,0,100
bc686f9459f78f268681dbc7ae66991acfd79243,5,942,249,693,2,0,2,1,10,6,1,3,1.825010884,839,31,5,223,143,80,10848,6699,4149,70,62,8,88.43930636
e9ac0c8789a0382e743b95d539a52cec8d44233e,0,0,0,0,0,0,0,0,0,0,0,0,0,0,14,2,0,0,0,0,0,0,0,0,0,100
d526db2363447faa217325511183799dbe0587af,0,0,0,0,0,0,0,0,0,0,0,0,0,0,348,0,0,0,0,0,0,0,0,0,0,100
09b3fcecd941840e21076c5204c8e6fb62e36c37,9,581,111,470,2,0,2,1,19,75,1,7,2.372781632,4590,32,3,1062,1004,58,33347,30692,2655,371,340,31,99.85052317
84c20018687a1954adfe684185ac9f037a1b7e19,0,0,0,0,0,0,0,0,0,0,0,0,0,0,112,8,0,0,0,0,0,0,0,0,0,100
8dd48e4e5a0dbb219f5a3afb4da1a2320b3fc5de,3,198,0,198,3,0,3,1,1,0,1,2,1.582838245,0,290,3,16,0,16,829,0,829,5,0,5,99.86947604
e34f9f52cac1ce58af1029a33bf56736c9617a92,2,36,9,27,0,0,0,1,3,35,2,2,0.764204507,727,19,2,130,123,7,5910,5814,96,41,41,0,100
1c22dcae839fe5d4b349fdbcf2276e0d09546d6a,0,0,0,0,0,0,0,0,0,0,0,0,0,0,2,0,0,0,0,0,0,0,0,0,0,100
724a583745aa4e43e48dffffda20aa69a642f0af,5,131,46,85,0,0,0,6,20,136,2,2,1.491282363,1652,74,0,179,173,6,16902,16396,506,85,83,2,100
61c2cca3a90b2ae2c5f5e3ca2b20153a467036a7,0,0,0,0,0,0,0,0,0,0,0,0,0,0,3,1,0,0,0,0,0,0,0,0,0,100
3cf50c1adc091540f190eb1f706720c3087264ec,1,22,0,22,0,0,0,7,25,161,1,1,0,650,75,1,54,52,2,4550,4433,117,42,41,1,100
dae54182ac38cbbae7e290aaac663b0bd17a862e,3,195,9,186,1,0,1,1,59,239,2,3,0.423081896,2696,6,0,632,610,22,18828,18046,782,127,105,22,99.92555369
107a56ccf2131c42eaf35998e648bcf3a93924bc,1,9,4,5,0,0,0,4,9,561,1,1,0,126,113,1,22,20,2,1021,981,40,7,7,0,100
78e288fbe4e80cf14887d178ecccd498dd68fc8d,2,283,158,125,0,0,0,8,29,111,2,2,0.536359651,1343,0,0,197,178,19,9197,8580,617,85,84,1,100
a3d429f61772068c980a0ab273e946a6fe31398e,7,251,71,180,0,0,0,2,38,643,1,1,2.024635157,1330,0,0,372,372,0,8700,8486,214,70,70,0,99.9255814
c8e406b3e896ee6cbc5ba28117dc517e880f2a4c,0,0,0,0,0,0,0,0,0,0,0,0,0,0,0,0,0,0,0,0,0,0,0,0,0,100
5431572f32fc34e0af7cea252d84a07e4e1564ee,5,234,45,189,0,0,0,7,37,207,2,3,2.145152797,2497,1,1,406,380,26,18057,17039,1018,154,140,14,100
872d7015e6eaa1b529a8f5724bbd3bcaef6b8398,0,0,0,0,0,0,0,0,0,0,0,0,0,0,0,0,0,0,0,0,0,0,0,0,0,100
c5c157ebfd33c2c3cb0e7f6af50d24591701dd1c,77,1004,272,732,0,0,0,6,41,316,1,2,6.029272916,26652,0,0,2811,2738,73,213146,209387,3759,1261,1192,69,99.96279762
8786af6d816f0fd4692dd72456c50d48f548f081,1,3,4,1,0,0,0,8,38,15,1,1,0,564,1,1,101,101,0,3973,3973,0,8,8,0,100
10df09fdedecd1b14df5879299e014a2b282cbfc,0,0,0,0,0,0,0,0,0,0,0,0,0,0,0,0,0,0,0,0,0,0,0,0,0,100
896f4cd0458bef4a772181f8c2e21db4d8183e16,0,0,0,0,0,0,0,0,0,0,0,0,0,0,0,0,0,0,0,0,0,0,0,0,0,100
58d99b5dac053ca41a82992cdaaec9d60021d954,0,0,0,0,0,0,0,0,0,0,0,0,0,0,1,1,0,0,0,0,0,0,0,0,0,100
9f24d82f7152650b6482db8ad57a2df7b64f9ad9,2,90,0,90,0,0,0,10,31,18,2,2,0.918295834,1553,2,2,229,216,13,10427,9921,506,100,96,4,100
7b5b692e78f1bfdca6ab802767446e1f9bbe9a34,3,132,18,114,0,0,0,9,80,37,2,2,1.368674968,1782,3,3,318,304,14,13994,13110,884,150,145,5,100
ab3ddddfcd945fe3da86e624a7f62e04a2f78877,42,106,115,9,0,0,0,7,46,382,2,5,4.976963277,10964,0,0,2123,2123,0,70341,70241,100,766,765,1,100
af3adb89ab175152ed38d515c20001aad16d8ccf,1,8,4,4,0,0,0,8,22,20,1,1,0,585,1,1,76,76,0,5072,5088,16,32,32,0,100
490b3d5aaee7890a762ddaebd87d55f716f86d29,2,49,2,47,0,0,0,7,15,317,2,2,0.977417818,580,2,2,68,63,5,4477,4189,288,27,26,1,99.98140573
3071aea8a1c8cc5897d06ebb8abce84f17f13e3c,0,0,0,0,0,0,0,0,0,0,0,0,0,0,3,3,0,0,0,0,0,0,0,0,0,100
87cbd8847a6e2286556cb6eb349df4a0beecae6a,4,365,41,324,1,0,1,8,51,33,2,4,0.953059842,3718,2,2,530,476,54,27595,25547,2048,165,142,23,99.1637884
af1ee9b13a947e2fd470bcc48bc7a3885d2b14d9,2,39,0,39,0,0,0,3,46,58,2,2,0.619382195,372,4,4,71,66,5,2927,2698,229,25,24,1,100
a2668825768c24a78ce940507b17fd56ef02184f,0,0,0,0,0,0,0,0,0,0,0,0,0,0,5,5,0,0,0,0,0,0,0,0,0,100
dd508f6848bfc4a5ba07a05c812c7c3954008018,3,70,21,49,1,0,1,7,68,37,2,2,1.333798766,2088,6,6,290,284,6,13267,12987,280,196,189,7,98.18938982
6387dddae2c7b806029c8113db9b5a30df6ff061,8,75,37,38,0,0,0,2,19,382,2,3,2.106045668,2304,7,7,273,272,1,18528,17955,573,125,124,1,100
bc3b3855136793019f8aef2aefde3cb665a1814e,3,128,21,107,0,0,0,6,20,97,1,3,1.194089524,2681,0,0,597,581,16,18777,18202,575,189,184,5,100
a762578bbf86f4c9694d1b74e72089875ac9831e,5,109,22,87,0,0,0,4,31,570,2,3,2.120567963,1803,0,0,264,252,12,16924,16306,618,81,78,3,100
6d26134d129d15050b7737fd029240d786a46085,1,0,9,9,0,0,0,5,22,627,1,1,0,189,4,4,38,41,3,1244,1309,65,10,10,0,100
fbdf3541e9029bbbd00f43eb2d100c57fccf9091,6,195,18,177,1,0,1,1,14,153,1,2,1.793526052,1235,1,1,280,264,16,9821,8853,968,110,94,16,99.85256174
8859cef813e1d1ae4e05d789c139936131a65ac3,2,5,1,4,0,0,0,4,4,2,1,1,0.918295834,119,8,7,17,15,2,743,715,28,5,5,0,100
7427b3228e0b54bd60ea65c968e5ba562f6bc854,0,0,0,0,0,0,0,0,0,0,0,0,0,0,9,8,0,0,0,0,0,0,0,0,0,100
eaf97f87bbf4776636b478d72f9150f808b38199,0,0,0,0,0,0,0,0,0,0,0,0,0,0,5,5,0,0,0,0,0,0,0,0,0,100
734b90e01997e4b755d0d3cd8b83af131c6ee431,4,99,72,27,0,0,0,7,81,36,2,3,0.868318946,2102,10,8,353,355,2,15146,15133,13,115,113,2,100
2e7c016759b602df984a047d0d7d71ba56ede8b3,4,8,6,2,0,0,0,9,52,56,1,3,1.863120569,2139,11,9,393,393,0,15036,15025,11,119,119,0,99.77761305
b61b3ccda0d60fcff0f43708c48f28f9b54deda7,3,0,53,53,0,0,0,5,82,149,2,3,0.365791974,1906,12,10,344,354,10,12491,12728,237,145,150,5,100
5b6886f11280f9652954073e4d254a7d443d029e,1,1,1,0,0,0,0,4,5,3,1,1,0,96,1,0,15,15,0,531,531,0,4,4,0,100
704e69f722b99d67c2aa7fa28187b1f539b4abb3,2,0,4,4,0,0,0,2,2,626,1,1,0.811278124,201,2,1,51,52,1,1248,1279,31,26,26,0,99.90650711
0c948e9b5af02756c8a4a1329a87745b8add22c2,2,199,4,195,0,0,0,9,45,115,2,2,0.565621989,1013,2,0,170,144,26,9407,8288,1119,46,40,6,100
64e45964880cd984263107abe01f6d8b513971d2,2,11,5,6,0,0,0,11,33,47,2,2,0.896038233,1628,0,0,230,229,1,10560,10462,98,101,100,1,99.92496717
66d58cb39a6ce573ccb35d5278cfa423ace72ba9,8,240,13,227,1,0,1,1,71,95,2,6,1.903558339,5240,13,3,849,835,14,42077,40923,1154,245,236,9,99.68248039
e35b7136ba145f8560a0cc4ca70f5eec28457826,1,257,0,257,1,0,1,1,1,0,1,1,0,0,1,0,25,0,25,1600,0,1600,10,0,10,99.96283909
e8def8f2b9220fa17ac171bad006e977da8f05d1,2,136,8,128,0,0,0,8,26,300,2,2,0.710676854,3126,3,0,396,385,11,21702,21016,686,131,129,2,100
efe549a140c7bf11f1cb23af6bc4c907394c6912,0,0,0,0,0,0,0,0,0,0,0,0,0,0,4,1,0,0,0,0,0,0,0,0,0,100
54a9f50f604e492a934b7baec8baa64395662264,0,0,0,0,0,0,0,0,0,0,0,0,0,0,3,1,0,0,0,0,0,0,0,0,0,100
db88524fda9015c8f9ae234813b1a7f6ac653686,2,7,1,6,0,0,0,6,21,182,1,2,1,748,1,1,178,175,3,4849,4814,35,46,45,1,100
8675ae02b83f8dc184ef0909cd80c7c61d4e685f,2,10,2,8,0,0,0,1,21,106,2,2,0.811278124,267,14,1,55,54,1,1658,1607,51,25,24,1,99.88857939
ff250ba6fd7f17df14d022d42c15ae2ad1856f16,0,0,0,0,0,0,0,0,0,0,0,0,0,0,15,2,0,0,0,0,0,0,0,0,0,100
25a08892b9412b56fdf92490b22bb848388b1f43,4,132,8,124,0,0,0,5,83,50,2,4,1.617233289,3002,16,3,564,546,18,21454,20805,649,174,170,4,100
826b37fc6d76b996c929b31dd705ba2b3811bd39,0,0,0,0,0,0,0,0,0,0,0,0,0,0,1,0,0,0,0,0,0,0,0,0,0,100
0cc9198b9ca64d53eef1650690eb4d32f8658d61,0,0,0,0,0,0,0,0,0,0,0,0,0,0,4,2,0,0,0,0,0,0,0,0,0,100
7429a6bf639562cf02234a7ab9b0bd75e7c457f7,8,42,13,29,0,0,0,2,31,364,1,4,2.564603274,1229,1,0,194,190,4,8028,7858,170,59,57,2,100
6dd08121a3aecdd0dabde31d9ba52e6e9a418f97,0,0,0,0,0,0,0,0,0,0,0,0,0,0,17,4,0,0,0,0,0,0,0,0,0,100
91010ad452ef3770806395c599f0bc4e79876dfc,0,0,0,0,0,0,0,0,0,0,0,0,0,0,5,2,0,0,0,0,0,0,0,0,0,100
b81915c8f6ea47ed48b796f0f5a8b2b85893e4fb,0,0,0,0,0,0,0,0,0,0,0,0,0,0,18,5,0,0,0,0,0,0,0,0,0,100
db5b08d3b32e145daedf4699dc16e513a04f12ab,1,1,1,0,0,0,0,7,27,0,1,1,0,254,19,6,56,55,1,1724,1715,9,18,18,0,100
66a8d71e6cf48905bd69f2096ef0705e2e8f0fcd,3,2293,2125,168,2,0,2,1,27,7,1,1,1.47516468,2403,5,2,235,224,11,16614,15836,778,106,97,9,99.88866209
ed54dd7460c3d7516b1c1663faa6c1881e63ad56,4,233,17,216,0,0,0,2,8,1354,2,2,1.954971114,812,6,0,118,92,26,7517,5930,1587,64,56,8,100
9ea0649cf4712beb2f3860d4c2d97f374305b2d9,1,1,1,0,0,0,0,2,2,11,1,1,0,613,20,6,63,63,0,3884,3884,0,33,33,0,100
ffe1f7f167a11ad21030789add4efa2051f6a5c6,4,466,1,465,3,0,3,1,18,37,2,4,1.660784049,347,2,1,133,72,61,4480,2112,2368,56,33,23,99.87034636
e5e8c5e6e80bdd72ff200b3c60956bc9cda1d784,0,0,0,0,0,0,0,0,0,0,0,0,0,0,3,2,0,0,0,0,0,0,0,0,0,100
0f7945dab071c6af7eee4aad5b0a183649c45b0c,0,0,0,0,0,0,0,0,0,0,0,0,0,0,6,3,0,0,0,0,0,0,0,0,0,100
2ec5e8112342159c65db16fc118472ca5380b328,2,0,2,2,0,0,0,3,3,7,1,2,1,103,7,4,17,17,0,488,488,0,12,12,0,100
e0d6559d8895a7c0de9f475f4af6b25a0099bba8,44,3544,2,3542,43,0,43,9,32,2,2,2,4.861268987,1158,21,7,513,180,333,27696,11543,16153,153,39,114,87.78809219
53fdbbb5abeb846e1c26a08b6e35ed1de529b80b,19,2625,878,1747,4,0,4,3,84,112,2,7,3.324652121,8852,8,5,1788,1502,286,77403,68509,8894,567,412,155,98.60651214
ce4ee2183fa6d84b165b928edc81b474deebcef9,0,0,0,0,0,0,0,0,0,0,0,0,0,0,22,8,0,0,0,0,0,0,0,0,0,100
c558408b789711bf7e377787485d13fa431a297c,12,80,122,42,0,0,0,3,6,216,1,1,1.982205066,2146,6,3,177,191,14,15694,15670,24,62,64,2,100
cad87eaae29215e3fd639f2e0d09824e086e8dfc,1,1,1,0,0,0,0,6,40,205,1,1,0,235,7,1,49,49,0,1500,1500,0,21,21,0,100
e635a65b1650951c88291db0b3210dd6cf6f4338,1,1,1,0,0,0,0,6,24,3,1,1,0,406,9,4,56,56,0,2607,2607,0,13,13,0,100
43446a2f35ecfc79f124f701debe263e4ee23b75,27,140,520,380,0,0,0,7,85,427,2,15,3.777242879,13816,10,5,2008,2012,4,101602,102882,1280,646,650,4,98.63783177
1a3a15b4e752aac4f54d10295bd8eb353f522a27,0,0,0,0,0,0,0,0,0,0,0,0,0,0,11,6,0,0,0,0,0,0,0,0,0,100
2e962e59b7238d535959e40f1128d04a645fa810,3,13,1,12,0,0,0,6,12,210,1,2,1.448815636,426,23,7,65,61,4,3493,3345,148,16,16,0,100
84a3f9dcfe840a170b15adb684e4d855802434f8,2,39,12,27,0,0,0,3,4,396,1,2,0.847861745,141,2,0,19,16,3,1102,904,198,10,7,3,100
c0497d15b2e9082e4396588927ec767b130429a7,1,2,2,0,0,0,0,5,14,419,1,1,0,191,4,2,37,37,0,1017,1017,0,12,12,0,100
2e407953f231550947438540b9644725de2636c6,2,50,5,45,0,0,0,5,35,58,2,2,0.845350937,889,24,1,94,92,2,6582,6333,249,54,53,1,100
95f847d9285b8280c301930f01831b8fdc6888c2,1,1,1,0,0,0,0,5,18,0,1,1,0,535,25,2,36,36,0,4157,4157,0,19,19,0,100
d9e4f7e90c5bba75098e56818aed352527a5a8cc,14,538,64,474,1,0,1,1,74,80,2,3,3.175411347,5331,12,0,1017,926,91,42789,40105,2684,374,340,34,96.09044493
daeb762576ed87ea34651b5abfcad3402c721c29,0,0,0,0,0,0,0,0,0,0,0,0,0,0,2,0,0,0,0,0,0,0,0,0,0,100
7084b21009621ac1a01ee655265b1e6bf87a8efb,3,37,4,33,0,0,0,4,48,162,2,3,0.907186006,561,13,1,89,84,5,4093,3859,234,21,20,1,100
4c9808fab84dcc9e05c030894eeba87e24ba190a,41,1822,250,1572,9,0,9,2,86,332,3,15,3.801472865,13543,1,0,2239,2056,183,113173,106844,6329,696,634,62,99.4802945
4165b174b7a7ea448f2adead7756035deb514162,0,0,0,0,0,0,0,0,0,0,0,0,0,0,2,0,0,0,0,0,0,0,0,0,0,100
8fd6159424659aa8441700036280edeaca65752c,0,0,0,0,0,0,0,0,0,0,0,0,0,0,3,1,0,0,0,0,0,0,0,0,0,100
f29baa338160a796dc7a09cb83c1097daf3798b1,0,0,0,0,0,0,0,0,0,0,0,0,0,0,26,2,0,0,0,0,0,0,0,0,0,100
96644af492274bf7e47119f538f529202245db5a,42,161,49,112,0,0,0,8,41,571,1,1,4.814661541,6473,2,0,1210,1210,0,39716,39716,0,446,446,0,100
09d3088cca31be824845f0878a2113145b0d149c,0,0,0,0,0,0,0,0,0,0,0,0,0,0,3,1,0,0,0,0,0,0,0,0,0,100
60c843a6c7986237e7660eaa2a85066a23d18c24,2,22,10,12,0,0,0,4,19,399,2,2,0.954434003,1619,27,3,126,127,1,15424,15328,96,87,86,1,100
19d6786d5fc7c9652f001295a843c67b0c6bd9be,3,146,23,123,0,0,0,2,29,55,2,2,1.530984636,517,2,1,121,109,12,3953,3313,640,52,43,9,99.9570139
98222bd3fd2d93c286548575a003c8afcd3c5241,8,211,19,192,1,0,1,1,49,39,2,4,2.505724091,2550,14,2,494,465,29,19551,18628,923,173,156,17,99.62782708
165409dea5af06b6e8b3b3f53de396006c1a74b0,0,0,0,0,0,0,0,0,0,0,0,0,0,0,4,2,0,0,0,0,0,0,0,0,0,100
0888b55cebd969a614a9ca09e05c914482305b80,2,28,1,27,0,0,0,4,8,337,2,2,0.893571102,1125,28,4,143,140,3,9159,9014,145,64,63,1,100
3475dcffef4335e2de38fb56071e7dadf6ba345e,3,67,9,58,1,0,1,1,50,4,2,3,1.305906241,729,15,3,96,92,4,5878,5597,281,32,30,2,99.97141224
acdd9fd416f1264770b5473c49437c012e7b4e9e,11,995,10,985,5,0,5,1,87,91,2,8,2.624491137,3569,29,3,695,616,79,27825,23563,4262,281,265,16,99.81452418
f36d241cccbefa547e3b0ea91d1c94935cd3a8e9,3,68,4,64,1,0,1,1,51,4,2,2,1.108446892,755,16,2,98,95,3,6096,5812,284,34,31,3,99.95727713
20d051257bc88cdbba87f078f09492f72ecde96b,2,2,2,0,0,0,0,6,42,36,1,1,1,395,8,0,74,74,0,2516,2516,0,42,42,0,100
2240dfb98abb6a75bf0eb249b501e073766647ed,3,38,20,18,0,0,0,1,43,10,2,2,1.335360598,988,17,3,139,140,1,7502,7414,88,33,32,1,100
193c88c7ec4edd07dff8b0b2c6aa0db1af44af58,3,15,1,14,0,0,0,5,18,963,2,2,1.329434003,683,30,4,133,130,3,4342,4262,80,61,59,2,100
e3b9e2ee7a66d51191a7dbd3afbebaaf246ae48f,1,24,0,24,0,0,0,3,6,245,1,1,0,201,3,1,28,25,3,1209,1061,148,22,21,1,100
ccdf15f24fc03e2f07c4f2d7b6ab7de20d0f463d,2,488,0,488,2,0,2,1,1,0,1,2,0.961662929,0,3,0,56,0,56,2360,0,2360,16,0,16,99.9430848
878d6a2fdf17b8c97d203d98d1da1a92f866058d,0,0,0,0,0,0,0,0,0,0,0,0,0,0,31,4,0,0,0,0,0,0,0,0,0,100
4cc4bd5c951063d2040f486becf1f057911a8bc8,0,0,0,0,0,0,0,0,0,0,0,0,0,0,18,4,0,0,0,0,0,0,0,0,0,100
d89938ae49669df5ed8ccfa45a95f9cc3cff8cc5,2,139,5,134,0,0,0,8,56,98,2,2,0.986040032,1252,3,0,194,179,15,8896,7916,980,53,49,4,100
3dd5f347c1363a7c1a00392b8ea991f34840e71d,1,73,3,70,0,0,0,8,69,216,1,1,0,1773,4,1,225,224,1,11359,11209,150,167,167,0,100
50eebefa3619a47e2b5e4baf4efd94af89d97335,4,31,21,10,0,0,0,5,14,164,1,4,1.305743333,635,19,5,102,99,3,4567,4519,48,33,33,0,100
89dd5c120f97410eddaeb0e0b75e7bb95e9c11e2,1,229,0,229,1,0,1,1,1,0,1,1,0,0,20,6,9,0,9,1419,0,1419,8,0,8,96.01523188
554a5b028ce248e82d46b5e06a8051905ba2cf51,3,44,0,44,0,0,0,7,27,637,2,2,1.265501316,954,4,2,76,73,3,7605,7335,270,54,51,3,99.98696899
0a1cd5da05c3778b3aab1efd34e94825c0cf4538,7,153,66,87,1,0,1,5,30,348,1,1,2.559304652,1840,5,3,401,396,5,11055,10783,272,126,125,1,99.86970684
1da3b42f1aee040484fc65bb435fbb8f07b9c69b,2,8,1,7,0,0,0,4,15,255,1,2,0.99107606,269,21,6,41,39,2,1959,1935,24,20,19,1,100
2114dba316e7c99a21fbe463d59aa389141a97ba,1,7,3,4,0,0,0,1,2,23,1,1,0,167,4,1,18,18,0,1082,1037,45,6,6,0,100
1c82b83a96b0e8425089769078c4f3a6e6d77b9d,134,7627,5673,1954,35,0,35,10,88,57,2,16,6.158030238,18883,32,4,2893,3898,1005,164948,271420,106472,1327,1958,631,93.60932476
6e673d1cf176d752a9384df10d7801bdd7c19645,2,194,0,194,0,0,0,10,44,219,2,2,0.525197868,1491,6,3,358,334,24,11163,10464,699,104,98,6,100
00744156639d522806d7b35eaa945b1c0271488b,13,876,25,851,4,0,4,1,89,153,2,9,2.20015463,6219,22,7,1113,1060,53,51372,47175,4197,360,330,30,99.61229576
c88c61404d12e6d29c522d2004294d572718b4f8,6,1242,803,439,0,0,0,2,2,414,1,3,2.15946926,781,5,2,168,147,21,7844,6269,1575,60,55,5,99.94432071
95d64b6ce840f8aecdda9d10b0e8b403f377c824,2,632,0,632,2,0,2,1,1,0,1,2,0.970205318,0,6,3,57,0,57,2706,0,2706,27,0,27,99.93037181
7495a82425f78d8b7a403e53b779032da31db705,0,0,0,0,0,0,0,0,0,0,0,0,0,0,23,8,0,0,0,0,0,0,0,0,0,100
88841cd831a856ecf01752a38cdd74d8c557da42,2,30,0,30,0,0,0,4,43,150,2,2,0.353359335,492,24,9,67,66,1,3613,3425,188,31,30,1,100
aa5b640bae5f14f56e66d177dd0d5b446154c606,2,47,0,47,0,0,0,5,9,171,2,2,0.488908591,361,3,0,55,52,3,3097,2808,289,11,10,1,100
37d3f9142e748b02a03749c49841a743b794d3d4,101,1086,1233,147,0,0,0,1,90,0,2,11,6.272073119,16915,33,4,2625,2654,29,123671,122664,1007,1168,1165,3,99.24989582
79e8587111bbc2c571ad9c49833e1a6850d60c8a,1,61,21,40,0,0,0,10,44,27,1,1,0,575,7,4,106,103,3,4597,4281,316,10,9,1,100
9c9c3b099fa410650d1cbef4a401af5716674ccc,1,37,13,24,0,0,0,12,37,30,1,1,0,828,8,5,163,163,0,5167,4951,216,52,52,0,100
1eacd9d33b7b4031e8d1e2302f48a286504a4b68,1,3,4,1,0,0,0,1,2,30,1,1,0,299,34,5,9,9,0,2001,2014,13,8,8,0,100
314cf7c1eb8de6d87fe9d8f8135c906b6dc6873b,5,159,12,147,3,0,3,1,15,67,2,3,2.265605541,223,35,6,45,36,9,1893,1328,565,25,20,5,99.84762432
0322751a0391e9207488fdfc05c96c4771d01af5,0,0,0,0,0,0,0,0,0,0,0,0,0,0,25,10,0,0,0,0,0,0,0,0,0,100
1663bbb3fb92a7666ec8d320e47963a268362436,4,863,0,863,4,0,4,1,1,0,1,2,1.8024444,0,36,7,65,0,65,2995,0,2995,30,0,30,99.8341396
ed5f7d74404c7ad783cf39a86f42f24dff98fc65,1,12,2,10,0,0,0,1,3,2,1,1,0,107,37,8,20,19,1,781,725,56,4,4,0,100
ef3f39802ff56657b7bea2d87d6a2e226a44a574,2,305,0,305,2,0,2,1,1,0,2,2,0.996577629,0,38,9,31,0,31,1781,0,1781,13,0,13,98.09730905
645666c071a15cd580fe4306d9a5875c294f5a18,3,0,820,820,0,0,0,1,3,3,1,1,1.242384937,526,39,10,0,47,47,0,3934,3934,0,27,27,99.86605947
f00b268142ff3d2922f61b34b59350d22ae2ee69,3,852,0,852,3,0,3,1,4,6,1,1,1.226981703,0,40,11,49,0,49,4124,0,4124,28,0,28,99.86605947
9be7155c839dfeffc194c01f9169a791f20f11b0,1,9,0,9,0,0,0,9,21,14,1,1,0,368,26,9,80,77,3,2302,2258,44,36,35,1,100
2d764cced132dd4a8cd14acc56c5e95fa04883da,1,79,0,79,1,0,1,1,1,0,1,1,0,0,27,10,4,0,4,329,0,329,3,0,3,99.97324057
9ec0f5f6371dd115ae6deca324c7737a1b889ed1,2,21,1,20,0,0,0,8,28,179,2,2,0.574635698,1030,28,11,161,160,1,7410,7250,160,70,69,1,100
e73bdfa3d9fc386bf973b3a4b4272479a46f8ebf,167,0,32899,32899,0,0,0,2,2,334,1,21,7.020939426,21736,5,0,0,3269,3269,0,136574,136574,0,1647,1647,94.86851457
8a4835a1e4bc9f6fbbd95594a32ff38210775763,9,627,10,617,6,0,6,1,48,99,2,5,2.326254576,1882,7,2,352,269,83,18076,14972,3104,81,65,16,99.8032092
a3517f209af4a8a920ae109c79bd7a4aa1c04097,8,39,22,17,0,0,0,4,22,406,1,1,1.892903937,2254,8,3,450,445,5,14582,14514,68,151,150,1,100
49faf50a45929747ea1f485c30bdf5d4e1016fa8,17,2412,976,1436,4,0,4,4,57,179,2,3,2.879901529,2920,41,9,825,529,296,30209,19977,10232,215,159,56,98.05575411
2c2f34582fd33cf37848551c867c0d3e8fe981ca,2,168,0,168,1,0,1,1,16,4,2,2,0.371232327,313,29,8,69,49,20,3249,2207,1042,23,16,7,99.97287768
7d71ce3f394c4b5a8e49d79fa07813b1a6b612ee,2,49,2,47,0,0,0,7,53,169,2,2,0.238684511,589,30,9,83,79,4,4512,4198,314,18,17,1,100
e0f3f7baa304b2c1639b7ed0ea75f67ed1715e45,5,35,8,27,0,0,0,5,9,725,2,2,1.696451672,778,4,1,119,118,1,5366,5163,203,40,39,1,100
4d670778b418482a88c9d987e0e8fe7795f1cfd4,0,0,0,0,0,0,0,0,0,0,0,0,0,0,31,9,0,0,0,0,0,0,0,0,0,100
c26234dc707259e1ebd622ba658cdaff6d791591,0,0,0,0,0,0,0,0,0,0,0,0,0,0,32,10,0,0,0,0,0,0,0,0,0,100
5d739504efaee608020b069b47c3c2147380d9cd,1,1,1,0,0,0,0,2,3,8,1,1,0,968,42,9,267,267,0,6321,6321,0,32,32,0,100
4b2e6f7ce28082f9e6e2b3764f0eb6c4c78c68a9,8,193,140,53,1,0,1,7,31,116,1,3,2.507771429,2164,9,2,495,494,1,13831,13771,60,188,183,5,99.91866612
0679ad9bf92dd4d295a59b42bf69b2fd6152c2df,1,404,0,404,1,0,1,1,1,0,1,1,0,0,10,3,19,0,19,1442,0,1442,13,0,13,99.97289973
82fb11cad2faad480547281900acfbba021fa46d,7,981,0,981,7,0,7,1,1,0,1,4,2.468162026,0,6,1,78,0,78,3934,0,3934,61,0,61,95.91539023
87e36f6def53158c63d57b59db22f18504117152,1,36,4,32,0,0,0,4,6,899,1,1,0,178,11,4,30,27,3,1207,1096,111,4,4,0,100
5870c96301de0d19ba9383582b92c756f7d93a78,0,0,0,0,0,0,0,0,0,0,0,0,0,0,12,5,0,0,0,0,0,0,0,0,0,100
22283b538a119719bc8179bc2492a59512663128,0,0,0,0,0,0,0,0,0,0,0,0,0,0,33,7,0,0,0,0,0,0,0,0,0,100
f847a51aff30e2238c0964cda980c5d81c08d699,1,46,0,46,0,0,0,1,2,90,1,1,0,32,34,8,0,0,0,125,116,9,0,0,0,100
c780f11a2dd94c2584e2fb2f9c1945de6a15c67f,5,167,13,154,0,0,0,2,91,42,2,4,1.723760209,3379,35,9,638,616,22,24776,23670,1106,218,213,5,100
5fc7943db0a9d83ea619cc47a937fefb159051d7,52,1236,2469,1233,2,0,2,10,92,63,2,9,3.118688802,18484,43,2,2480,2414,66,136286,146362,10076,930,965,35,94.33299165
1be7c37b647563f0f5b54e5d7c08f22c42a0dab5,1,0,10,10,0,0,0,10,46,8,1,1,0,656,36,7,112,115,3,4832,4934,102,10,10,0,100
361ead3ff18ca2f0a50e1f3b5ab5fc0f154af4cd,3,3,3,0,0,0,0,5,11,12,1,1,1.584962501,842,13,6,188,188,0,4808,4808,0,67,67,0,100
62a577b9cc69d07b681b6dd0959204e01e2d6cde,3,15,11,4,0,0,0,5,93,114,2,3,0.773228349,2401,44,3,420,419,1,17644,17612,32,129,129,0,100
148fefaa22f9645b8e6c7ec5bf3aef10394e6936,26,312,9,303,0,0,0,1,4,44,1,1,4.643427006,1751,45,4,340,317,23,10716,9409,1307,159,135,24,100
ecc77e166b57d53d22c5783f21ec75361f837776,25,25,74,49,0,0,0,1,5,0,1,1,4.641933514,1943,46,5,337,337,0,10390,10565,175,157,157,0,100
6766126f94c4b87c68012e6f514bb6e3214871e1,31,1010,34,976,5,0,5,2,78,455,2,13,3.665523733,9623,14,7,1922,1823,99,73806,68973,4833,747,687,60,98.77919321
50309c9c0dcba4274f9a6e0b4564b7be66794353,0,0,0,0,0,0,0,0,0,0,0,0,0,0,15,8,0,0,0,0,0,0,0,0,0,100
c7fa8aa7113a375aab5feb42e4a9e7f182f18f48,6,49,31,18,0,0,0,2,35,881,1,5,2.243461905,579,7,2,84,84,0,3049,2962,87,40,40,0,99.94832041
4b7cdbb08b5bb80d722592ada4391c1bd385eff5,8,203,12,191,0,0,0,2,2,416,2,2,1.88036357,435,5,0,106,66,40,3889,2496,1393,52,37,15,100
e597af49990fcab9a3ffca1670f0f0cbb285b6ec,2,76,2,74,0,0,0,3,8,93,2,2,0.343519741,698,37,8,156,151,5,5504,4883,621,75,70,5,95.38093226
cc108c777b5bc5d8e04a12688dc91e94d2ac61ac,0,0,0,0,0,0,0,0,0,0,0,0,0,0,4,0,0,0,0,0,0,0,0,0,0,100
cb71bf66c68ccc8d51fabe449804eb05d21b74f5,6,876,2,874,3,0,3,4,10,0,2,3,1.656292569,642,47,6,187,66,121,10069,5023,5046,108,34,74,98.99745623
80778ad30e1dbc2025fbc12030954cda075e3393,1,10,1,9,0,0,0,1,6,0,1,1,0,124,48,7,22,21,1,932,891,41,4,4,0,100
4e8043680f3ccca5db3e81e1d9d3b3a162011d3b,3,1366,0,1366,3,0,3,1,1,0,2,3,1.468364553,0,49,8,153,0,153,6657,0,6657,67,0,67,99.47659203
7c9fa6ca06d41053f97e43ace7fb4cd2154eabb3,1,3,0,3,0,0,0,1,7,0,1,1,0,129,50,9,22,22,0,962,932,30,4,4,0,100
b5eeb0d60a1fa753cb0c0b89e9478519e83b0788,1,2,2,0,0,0,0,1,2,0,1,1,0,442,51,10,41,41,0,3021,3029,8,36,36,0,100
d9c405a0543ea6d55e3718897be684c8b225fb4d,5,12,16,4,0,0,0,1,8,0,2,3,2.128085279,1101,52,11,150,137,13,7965,7740,225,76,79,3,99.88338192
6b3539166afb62f384c549c832d2da072d243cb1,20,845,96,749,4,0,4,7,94,37,2,13,3.032288742,9641,16,9,1611,1528,83,79602,75506,4096,485,442,43,88.82627596
7ec635dbbd6356b50098ee7c706a702180813232,9,1098,45,1053,1,0,1,1,80,107,2,4,2.108371729,4020,38,9,841,697,144,36904,30661,6243,253,211,42,86.75258504
be5096d904f4903904a6e65fdeba9b8bc8aeba71,2,297,0,297,2,0,2,1,1,0,1,2,0.782039287,0,6,1,39,0,39,1721,0,1721,13,0,13,99.87176199
03ae1ba39a2d47656649ff32ab07e1c040279180,16,360,235,125,1,0,1,1,81,39,2,10,3.436532892,6990,17,10,1048,1040,8,55384,55105,279,295,289,6,94.46920052
6d9afd10f25dc630e946b0ad654f2371c81c1862,2,656,0,656,2,0,2,1,1,0,1,2,0.503766255,0,39,10,88,0,88,4249,0,4249,28,0,28,99.94636632
a63eeae4fa9256ed4712f319dc974628249cc8db,1,0,3,3,0,0,0,10,82,0,1,1,0,2028,53,12,352,352,0,16669,16707,38,61,61,0,100
e18b11171798f613b991507743351a8a565a6a26,5,530,0,530,2,0,2,1,9,27,2,5,1.451020841,227,54,13,93,36,57,4530,1377,3153,33,12,21,98.93603047
178449c70a63a630b4c2c9b8336f05e625701475,5,1462,0,1462,3,0,3,1,10,2,2,4,1.154570202,258,55,14,179,51,128,12282,1725,10557,69,11,58,99.08256881
c1110d8a980b5797a80e94078ca48379fd366a06,1,1,2,1,0,0,0,9,29,12,1,1,0,783,56,15,75,71,4,4853,4565,288,24,23,1,100
641c3b1e798820a5f981b8ed51adb75d3ddb3a0a,2,84,17,67,0,0,0,4,21,12,2,2,0.240473407,1621,57,16,140,127,13,16234,15611,623,91,83,8,100
e76f24f235db3ff1a1932af8cd9680a3343d7cf2,0,0,0,0,0,0,0,0,0,0,0,0,0,0,58,17,0,0,0,0,0,0,0,0,0,100
1119d19c6a2da4b1b4b4b8cd7c5dda6d4a7f4bf1,1,19,26,7,0,0,0,1,4,19,1,1,0,149,59,17,26,29,3,1141,1183,42,7,7,0,100
47ee3171e8bddc2235734d099100a30a9176e1da,3,257,947,690,0,0,0,1,8,146,2,2,0.19459759,1077,60,18,66,59,7,4543,9849,5306,31,24,7,100
85444d44338926ccaeceb484b712d379af4638f7,0,0,0,0,0,0,0,0,0,0,0,0,0,0,61,19,0,0,0,0,0,0,0,0,0,100
4d2b8864ff748c1895d515a0e9733636104f99d8,1,1,1,0,0,0,0,1,3,73,1,1,0,297,62,20,9,9,0,2001,2001,0,8,8,0,100
9349dc9b58939d4559a2c983feeaa88d8e6b2a00,15,355,166,189,0,0,0,7,60,362,2,4,2.622911503,10801,18,9,1801,1803,2,78993,78383,610,478,468,10,100
659f37fa3c284e536859b7e3e3dbb0fa9d53af5f,6,155,75,80,0,0,0,4,95,46,2,5,2.351515501,3355,40,9,604,595,9,23711,23202,509,237,232,5,100
18c4ab20f7274a178aa0eecf3c2c775ba3ccec70,6,306,239,67,0,0,0,1,57,10,2,3,0.830271773,2216,19,10,413,405,8,15756,15412,344,171,166,5,99.88384099
30be4ab1bb65fe9a7b4e74503253c1bf07286f6c,9,1463,326,1137,4,0,4,4,39,157,2,6,2.294887498,1615,7,2,612,465,147,18132,11342,6790,149,89,60,94.94201481
ed9999976d4875cc8c7f2e717f439c37cb28ddb1,2,387,10,377,1,0,1,1,83,4,2,2,0.971244523,2025,41,10,395,352,43,19234,16669,2565,69,61,8,99.96940961
be44829185c944cbb10622d86580ee8676c28b3b,3,28,14,14,0,0,0,2,47,7,2,3,1.142610782,1754,42,11,305,302,3,13260,13133,127,108,108,0,100
bec9a2503b2e60b1ae50f10ff3fae95d7afd07e4,2,2,2,0,0,0,0,5,23,0,1,2,1,613,43,12,157,157,0,4025,4025,0,37,37,0,100
c29adf6bb929885395038fc5cce31270d445f0b1,8,291,9,282,1,0,1,11,37,127,2,2,2.269731348,2228,9,0,324,309,15,21920,19886,2034,115,102,13,91.77008491
e4d36c4e607b79b396086a7d0a4e359656aceaf5,2,8,3,5,0,0,0,1,48,4,1,2,0.684038436,793,63,21,139,139,0,5940,5895,45,14,14,0,100
dd09892770333827f4b0384813c4f09032d39211,2,2,3,1,0,0,0,1,49,0,1,2,0.970950594,798,64,22,139,139,0,5931,5940,9,14,14,0,100
76add5e50af54bb77abaa5ab3d839f56e17ea9d8,3,29,34,5,0,0,0,8,19,123,2,3,0.652128189,575,5,0,67,65,2,4424,4424,0,25,25,0,84.50583391
a7b3e11c1f43643416268c3e1f69f5d9a159edbd,1,0,83,83,0,0,0,3,3,578,1,1,0,71,65,23,0,2,2,0,517,517,0,2,2,99.96638655
38d4910bd64cc0ca1c1e62ba1d56007715677bec,0,0,0,0,0,0,0,0,0,0,0,0,0,0,5,1,0,0,0,0,0,0,0,0,0,100
3cd959085c08225195750b7efbe9096dec5a9bed,0,0,0,0,0,0,0,0,0,0,0,0,0,0,10,1,0,0,0,0,0,0,0,0,0,100
8303da6ae2d50334fa66a2c9abcf6b4ed81b568d,0,0,0,0,0,0,0,0,0,0,0,0,0,0,11,2,0,0,0,0,0,0,0,0,0,100
aca0737e64de93675f2ae4a29a44b44b6e62672e,11,2956,10,2946,8,0,8,1,13,34,2,4,2.587308648,475,8,2,749,71,678,20990,3554,17436,117,21,96,79.3196753
ead88904a4bf57e4258dcc3431441cdcc123283d,2,85,2,83,1,0,1,1,4,8,2,2,0.269055303,176,66,23,35,33,2,2081,1548,533,9,7,2,99.95456611
ff9708a774260277a1a489f2773020439b1dfddc,1,7,0,7,0,0,0,10,50,5,1,1,0,658,12,3,115,115,0,4980,4917,63,10,10,0,100
d9dc5e99d12c5ec90a7d9c44dfadc3bdb9b47b3f,7,167,86,81,0,0,0,2,96,48,2,7,2.422869072,4379,20,9,871,860,11,29985,29600,385,228,228,0,99.95458674
af7e1990ade6d2bad3a0edfa959945f0a238c003,4,64,10,54,0,0,0,2,97,4,2,4,1.637618156,2347,21,9,409,402,7,16691,16414,277,164,163,1,100
361288ddc564fd9fb29d557ad12c5e047f5422dc,0,0,0,0,0,0,0,0,0,0,0,0,0,0,13,4,0,0,0,0,0,0,0,0,0,100
da2815a0864a9139a5bbf19b63a4e52820d78897,2,36,0,36,0,0,0,5,20,230,2,2,0.41381685,892,67,24,117,115,2,6465,6293,172,53,52,1,100
87e68e664d87917efefd82adf4d89564314b950b,1,1,0,1,0,0,0,5,13,557,1,1,0,159,68,25,24,24,0,801,794,7,16,16,0,100
4886188692842d67a5593f3677b75062cfca776b,6,21,15,6,0,0,0,2,98,38,1,4,2.202292438,1882,22,9,329,327,2,13901,13854,47,149,148,1,100
2915897ad57781b725963970660ffd1734a239a3,2,282,0,282,2,0,2,1,1,0,1,2,0.999092728,0,23,10,32,0,32,1325,0,1325,14,0,14,99.95460735
225290dae3619ab5fa56e80f380d65bca6963f25,1,41,31,10,0,0,0,7,27,2,1,1,0,404,44,8,58,55,3,2636,2587,49,13,13,0,100
1bf236617370c8bd95277261eb2f38ffe2639e5a,2,234,36,198,0,0,0,1,84,12,2,2,0.953748988,2343,45,9,416,395,21,20583,19234,1349,74,69,5,100
5b68bfe494ed42a9f6e1056605dd65f0ae0c06b8,0,0,0,0,0,0,0,0,0,0,0,0,0,0,8,3,0,0,0,0,0,0,0,0,0,100
205f4d7080b544a57c1f9b1230628c76de800e96,0,0,0,0,0,0,0,0,0,0,0,0,0,0,9,4,0,0,0,0,0,0,0,0,0,100
4cc9da7b63f4cd881eb9cc9b50fb1befa1a92e64,2,4,3,1,0,0,0,3,4,4,1,1,0.985228136,678,69,26,38,43,5,4799,5219,420,20,22,2,100
55d6dfb22e00de38b091ff4ecac9bea402bc2ae2,2,9,4,5,0,0,0,5,6,18,2,2,0.995727452,799,9,0,109,108,1,6442,6398,44,38,38,0,100
fe3d1dda3ecc980fbca7bc5713522677079f27cb,6,426,96,330,0,0,0,1,8,32,2,3,1.241251218,1131,70,27,180,118,62,11911,9656,2255,66,54,12,79.58602355
d154944f6e12aaf6e98657e7051a2edb08e6b1aa,0,0,0,0,0,0,0,0,0,0,0,0,0,0,10,1,0,0,0,0,0,0,0,0,0,100
f8006d2ecbf5ab92e3e9231867fa22672a2815ef,8,229,72,157,0,0,0,1,5,50,2,5,1.961918049,2821,71,24,441,408,33,29683,28678,1005,137,129,8,100
72c5fbca488d7772dba335bca6e58738b674ec83,1,9,4,5,0,0,0,3,3,17,1,1,0,69,72,25,9,8,1,404,361,43,1,1,0,100
e777d06712b6d94d455063078b72672f0c262104,2,19,8,11,0,0,0,11,38,14,1,1,0.950956048,875,24,8,106,102,4,6640,6495,145,65,63,2,100
e0f853a3137eb8b084cd44dc47eb4eb7078f39aa,29,218,505,287,0,0,0,1,9,30,1,4,2.16545001,3821,73,26,637,665,28,23783,25074,1291,216,258,42,97.67403223
25641fdbcc4d11bdd5024ede4475fc3fbd68f52a,1,12,8,4,0,0,0,3,6,8,1,1,0,378,25,7,15,15,0,2633,2626,7,13,13,0,100
28627309a6aa38306e1581e4e321dcb5205a2abf,0,0,0,0,0,0,0,0,0,0,0,0,0,0,14,5,0,0,0,0,0,0,0,0,0,100
c418a1880ebd6c2589a22a6cd28848dc227bbc99,0,0,0,0,0,0,0,0,0,0,0,0,0,0,46,5,0,0,0,0,0,0,0,0,0,100
a2d9724a19525b56be1e0835cfbaef8582059b67,2,166,18,148,1,0,1,1,4,22,1,2,0.879958151,270,26,6,24,10,14,2736,2029,707,12,8,4,99.96619337
12886c2b454ea40bdd49401f7b80186d9f5ad2b5,1,39,12,27,0,0,0,1,2,80,1,1,0,290,27,7,20,19,1,1535,1442,93,14,13,1,100
b286c289736c12fd4a8026d08defa1bf1618e88e,0,0,0,0,0,0,0,0,0,0,0,0,0,0,74,7,0,0,0,0,0,0,0,0,0,100
cf5a0fcde6749476ca65be2b5ff229f1c34ba708,2,378,34,344,0,0,0,1,46,28,2,2,0.973988605,1505,28,6,339,311,28,10630,9302,1328,85,73,12,99.9831024
7d2f96ad32aec9a5d8127e11b88fa98ff883ccd5,0,0,0,0,0,0,0,0,0,0,0,0,0,0,9,0,0,0,0,0,0,0,0,0,0,100
2b76885027e089bde0458190991343221c107039,1,5,13,8,0,0,0,8,18,125,1,1,0,540,75,4,51,51,0,4011,4059,48,26,26,0,100
ef37d65a6634f4d3ccff1d56bec964d97834e3bd,7,391,6,385,2,0,2,11,39,50,2,5,1.837011465,1348,29,5,251,225,26,11902,9835,2067,102,84,18,99.84794729
2c3e60c95fca7d1b7e5e8fdd2a52994b0d6bbd0e,1,52,0,52,0,0,0,1,4,11,1,1,0,484,30,6,29,28,1,2687,2492,195,23,22,1,100
3dd8063a35dfee5f18e02a5410e52e401a366c2b,3,31,16,15,0,0,0,10,99,62,1,3,0.945086191,3585,76,2,653,652,1,28370,28287,83,165,165,0,100
3230362fb1d50cb91f8ad913d21c7afe8f4f0c70,34,454,387,67,0,0,0,3,100,211,2,15,4.134623318,11541,77,3,1964,1934,30,89874,89275,599,566,562,4,82.63973533
28c9698ea5cebbaf1c09ed85a23ac34837d5cdf4,3,44,4,40,0,0,0,3,101,12,2,3,0.685599851,3675,78,4,624,624,0,28885,28708,177,164,163,1,100
64537d3dc5dc8e05ad8810853b28ff81c7f6f909,0,0,0,0,0,0,0,0,0,0,0,0,0,0,15,1,0,0,0,0,0,0,0,0,0,100
edde6eb9e0e1e66baf7e11f0f411eb27c8d4803f,3,3,3,0,0,0,0,1,3,81,2,2,1.584962501,579,31,6,71,71,0,3556,3556,0,49,49,0,100
034171dfcb32347d142878e45e1845c61765f76f,2,51,2,49,0,0,0,4,15,232,2,2,0.563102824,744,32,7,112,110,2,4931,4681,250,37,36,1,100
0189cf0b14f8c9ce101869d3f784ba50fbc18a99,2,168,80,88,0,0,0,1,6,56,2,2,0.733075742,641,79,5,98,87,11,6819,6049,770,27,20,7,95.58991982
35b161de8a5d2f1c48e574108cc6638d59d6ef74,4,76,10,66,0,0,0,2,3,53,2,2,1.491063436,1898,7,0,550,542,8,14400,13869,531,74,73,1,100
8945eba470ea10f5013b18683fcc47c7b2f44a1e,0,0,0,0,0,0,0,0,0,0,0,0,0,0,16,1,0,0,0,0,0,0,0,0,0,100
5c89de541d5df0c1b5e13a064e9214466217d20f,2,25,0,25,0,0,0,5,12,631,1,1,0.942683189,185,8,1,32,30,2,1102,949,153,10,8,2,84.79131886
11093d013bb5907503753319e6567a6699a02723,3,99,7,92,1,0,1,1,8,27,2,2,0.578979254,276,80,6,67,60,7,2054,1681,373,27,22,5,99.97171946
4e9fe558defd415c0863554f8763863ba5f90010,17,595,100,495,0,0,0,4,22,45,2,4,2.608399855,5362,81,7,782,736,46,49281,46295,2986,281,261,20,100
0f7b649310c03826779daa944e877edd52325f19,4,163,16,147,0,0,0,12,61,96,2,2,1.654689282,2095,47,0,345,332,13,15823,14807,1016,118,113,5,99.98586373
b4e4e0987b3775905dd44ed3a99e480a527f6cef,2,134,10,124,0,0,0,2,3,42,2,2,0.852405179,816,9,2,136,111,25,7304,6426,878,20,15,5,100
335648f66f552b5650112e04217f450b170b75d0,4,65,28,37,0,0,0,7,21,178,1,1,1.640627246,1202,48,1,289,281,8,8128,7925,203,129,129,0,100
c796e0ef722b3062d97cae13660477b780543277,2,74,9,65,0,0,0,2,10,98,2,2,0.991501787,632,10,3,78,71,7,4957,4431,526,38,36,2,100
24609f4994e6ac4b25a61bdb51b05a847a29d2dc,5,96,16,80,0,0,0,1,11,48,2,3,1.574171972,787,82,8,146,135,11,6111,5636,475,50,48,2,100
5460ef36cf76040afd6262bf4cbcc63e922d41be,4,153,53,100,0,0,0,12,88,12,2,2,1.836463029,3971,33,5,709,700,9,32572,32175,397,177,175,2,99.98586373
d04fa8b20d11ddb103a3b2aec29c6f9a73f25cbf,1,42,0,42,1,0,1,1,1,0,1,1,0,0,34,6,9,0,9,127,0,127,2,0,2,81.83208702
fffe09eec3a8e6401dee1d22c55eeb1a87fafd45,1,1,1,0,0,0,0,10,63,3,1,1,0,904,35,7,180,180,0,6975,6974,1,43,43,0,100
ea00339bd13432f29ccdf82e14c3df5a316d9b7b,3,198,6,192,1,0,1,12,40,95,2,3,0.905636789,1696,36,8,248,221,27,11192,10250,942,99,96,3,99.95741056
5df5c034ebda9b6f68bea274390a446055c11c46,2,12,2,10,0,0,0,1,59,111,2,2,0.749595257,495,49,2,74,72,2,3541,3502,39,15,14,1,99.93611584
59a9aedfd9ae46a18666deb4eb884249025c1ab3,0,0,0,0,0,0,0,0,0,0,0,0,0,0,50,3,0,0,0,0,0,0,0,0,0,100
9f207f66fd348bad60c9186033a927b4f1ff9346,0,0,0,0,0,0,0,0,0,0,0,0,0,0,37,8,0,0,0,0,0,0,0,0,0,100
d24e45b7b6b44e6a4221af7cf4f8492312eaff51,1,2,0,2,0,0,0,13,41,0,1,1,0,852,83,8,162,162,0,5219,5207,12,52,52,0,100
b1103623a5bfbcaad0cc32a0cbf7265fb81d3df1,1,2,2,0,0,0,0,3,4,131,1,1,0,968,11,4,267,267,0,6317,6321,4,32,32,0,100
1c5a52f33a4642a2fb7883295ca849473cee2b59,4,38,5,33,0,0,0,8,102,703,2,4,1.202784744,1469,6,0,258,255,3,10926,10705,221,104,102,2,99.36682144
067613ad37050310799e053779334f4e2e221fac,2,154,8,146,0,0,0,10,35,198,2,2,0.959937718,1608,38,9,206,197,9,16059,15426,633,48,46,2,100
470aab20eeee288e0e3b14b6a3025f20096af732,1,3,18,15,0,0,0,2,2,1779,1,1,0,76,51,4,10,14,4,322,406,84,4,5,1,100
c65d6baa65cf5e4a56d6a902ad0e14826f1f6f74,1,1,0,1,0,0,0,5,18,494,1,1,0,1905,12,5,412,411,1,12024,12013,11,132,132,0,100
e2c337d73ca40c8c33eb1d0c6251d41df79a1dfe,7,202,11,191,1,0,1,8,103,53,2,7,1.607461229,2638,84,8,440,414,26,21727,20491,1236,173,167,6,97.62972454
47b57c559d61bbfd9895eb68b8573138c281e760,1,2,1,1,0,0,0,9,20,11,1,1,0,276,85,9,29,29,0,2212,2199,13,15,15,0,100
c4979e8dac823f915da071610bf2cbff576504b9,0,0,0,0,0,0,0,0,0,0,0,0,0,0,10,0,0,0,0,0,0,0,0,0,0,100
719aceddafaa964307e6ac39ce749c42a0cd65ec,3,108,68,40,1,0,1,1,3,597,2,2,1.45984981,99,15,0,18,15,3,876,442,434,8,9,1,99.95635094
42938a0a5fe4701697dae968081d08ac9c41fc2e,3,5,5,0,0,0,0,9,104,6,2,3,1.370950594,1729,114,0,309,309,0,13122,13122,0,117,117,0,100
3cb0898c8c34d959c1eb121e5a8a808baaa14021,43,255,0,255,0,0,0,3,5,1221,1,4,5.422968843,2362,115,1,321,321,0,13081,12995,86,109,109,0,100
079eacfd23e332be2598a7e9532887bcc5eed5ef,3,55,1,54,0,0,0,2,62,314,2,3,1.182750393,2902,4,0,562,557,5,18649,18454,195,107,106,1,100
e36c4a4b436d091ae10f005d5dff36d96614807d,1,1,1,0,0,0,0,4,11,116,1,1,0,649,16,1,147,147,0,4640,4640,0,70,70,0,100
f4fd5000f04308265a260115c8d86fbfa3201eb7,3,74,17,57,0,0,0,2,17,71,2,3,1.114908357,762,5,1,128,124,4,6132,5845,287,40,38,2,82.50703235
8a3589acd4a94dbdec9af4ff15fcf7f900d0dc87,2,0,0,0,2,0,2,3,3,52,1,2,0,0,6,2,0,0,0,0,0,0,0,0,0,99.94110718
f26175d105c62d41cd930d56df77ef922db5d25b,0,0,0,0,0,0,0,0,0,0,0,0,0,0,349,0,0,0,0,0,0,0,0,0,0,100
d6275108e2cf24b2b07c0638eb97398c71d9312e,8,97,15,82,0,0,0,2,89,78,2,3,2.766893993,4107,116,2,683,676,7,33511,32858,653,155,153,2,100
8f4c0067aba6205efed3c5816691c097db15500f,2,48,1,47,0,0,0,2,4,200,2,2,0.536359651,414,117,3,27,25,2,2931,2693,238,12,11,1,100
90d809ff46914b4274615c8a562408502270e5bb,0,0,0,0,0,0,0,0,0,0,0,0,0,0,350,1,0,0,0,0,0,0,0,0,0,100
0dc27ac0e11f4b5b868b78df7c3e28050640b246,6,498,11,487,2,0,2,2,105,94,2,4,1.842214145,4166,7,3,849,813,36,29281,27623,1658,211,192,19,99.85317868
c589d7aa8a9bd305d86ce87cf3d5aabeadd59a4c,2,1,3,2,0,0,0,7,51,255,1,2,1,1053,118,4,170,171,1,7550,7571,21,21,21,0,100
2934071f7a850b676034d9da6a6347f59f1f043f,3,118,12,106,1,0,1,5,22,28,2,3,1.266684412,1707,119,5,198,187,11,14116,13803,313,57,52,5,99.81024668
01715680f23782adf5e8eb10386066e2481d7d63,2,22,28,6,0,0,0,3,13,152,2,2,0.529360865,707,120,6,83,85,2,5283,5298,15,47,47,0,100
91c44fe372d6e10e8e18261b967febcff3cf27e0,2,5,12,7,0,0,0,2,2,188,1,2,0.522559375,421,351,2,38,40,2,2313,2392,79,36,36,0,100
703ba462601380531a63f9baf6bec58cbc625b97,1,1,25,24,0,0,0,4,23,75,1,1,0,1440,121,5,85,87,2,14455,14582,127,68,70,2,99.91263832
6f751334d05b9e032285897aedb571dcd30a17e4,0,0,0,0,0,0,0,0,0,0,0,0,0,0,352,3,0,0,0,0,0,0,0,0,0,100
a50baa2c430a134143a0c9fc9e4bc48ff6272444,4,153,48,105,0,0,0,2,47,48,2,3,1.667326802,2285,8,1,424,419,5,14150,13766,384,109,106,3,100
2d31ff83bea7f37adf00d4857cd0cc6baf2c8b21,5,302,0,302,5,0,5,1,1,0,2,1,2.182274412,0,9,2,25,0,25,1069,0,1069,16,0,16,99.8255814
de2111f9c21bd9065deff51ac46a8abf24af1659,6,302,45,257,1,0,1,1,11,471,2,4,1.426265891,625,10,3,123,94,29,4666,3627,1039,69,52,17,99.97098927
281aeb54823d4e8c0f6ace1a8f0798b07131f834,1,6,23,17,0,0,0,8,13,222,1,1,0,137,20,0,34,39,5,738,807,69,15,15,0,100
dd5852859987f05666350c819b2ba4a7d0a9b07d,2,20,7,13,0,0,0,3,7,70,2,2,0.918295834,472,122,4,76,73,3,3956,3832,124,23,23,0,100
9d1f91aff199ed039128b2b5f2983278d527ce77,4,64,2,62,0,0,0,11,25,389,2,2,0.653017946,1454,33,0,188,184,4,11750,11297,453,74,73,1,100
ad9a00c83d57cf213d65c24c06e8d8ef3f144a37,15,307,16,291,1,0,1,4,60,139,2,6,2.402559493,3569,123,5,572,533,39,30725,29037,1688,237,208,29,96.06725959
34082dad5f43a021a145df732200d629e3f5cd02,1,2,2,0,0,0,0,3,7,11,1,1,0,200,11,3,33,33,0,1209,1209,0,11,11,0,100
1b098b280cb2a6b147468ac1dbc69fb5d65b8dfc,2,37,1,36,0,0,0,2,4,120,2,2,0.967788463,1086,124,6,121,114,7,10480,10167,313,55,54,1,100
7cf9c76c816f778e8f84d7a769501eccc6a10878,1,6,5,1,0,0,0,10,52,46,1,1,0,665,76,0,115,115,0,4980,4980,0,10,10,0,100
9a451bcfb5305470d1fe42a5c031e984d9a510c2,0,0,0,0,0,0,0,0,0,0,0,0,0,0,17,0,0,0,0,0,0,0,0,0,0,100
d06cb4cc5aa71b6936e176b85c2694c0957104fc,0,0,0,0,0,0,0,0,0,0,0,0,0,0,12,4,0,0,0,0,0,0,0,0,0,100
995fe289f19ad02929ed53e9825db99a5e1e04ce,0,0,0,0,0,0,0,0,0,0,0,0,0,0,13,5,0,0,0,0,0,0,0,0,0,100
0919ec7abaeb5a4e3a6919951c085065256668a1,0,0,0,0,0,0,0,0,0,0,0,0,0,0,14,5,0,0,0,0,0,0,0,0,0,100
479d0fae369c0ddeeeee502f416cc0fc23d17f53,3,59,7,52,0,0,0,6,53,119,2,3,1.455064251,1224,18,1,191,186,5,9383,9024,359,43,42,1,100
f50191548ea7d5e3798bfee2adf8c1919f9341dd,0,0,0,0,0,0,0,0,0,0,0,0,0,0,19,2,0,0,0,0,0,0,0,0,0,100
809da838812d049882dcafba496613a064919252,12,103,6,97,1,5,6,2,6,319,3,8,2.840248873,931,353,0,136,136,0,7061,7126,65,56,56,0,99.83965794
fc7a436e86c10f0bdbe692f0871e5fb7273a8796,4,2023,0,2023,4,0,4,1,1,0,1,3,1.798845944,0,291,0,177,0,177,7566,0,7566,71,0,71,88.12834225
f736464328583487c38c284aa98d8435cf0bafa9,2,51,3,48,0,0,0,4,14,80,2,2,0.852405179,703,20,3,87,83,4,5594,5283,311,48,47,1,100
23036b93286c39b7d73f0c05d39da0e3bff3fc35,2,40,1,39,0,0,0,5,12,193,2,2,0.281193796,318,34,0,50,49,1,2212,2034,178,20,19,1,100
6ede01d30183669d5cb0b32f549542fadd5043c3,1,14,13,1,0,0,0,11,54,14,1,1,0,674,21,4,117,117,0,5052,5042,10,10,10,0,100
4ceca2397cc983e143dd2a4522f85754f9d9882e,2,141,32,109,0,0,0,2,5,210,2,2,0.973591433,1341,15,3,313,304,9,11054,10258,796,58,52,6,100
3d7aa1a8c173c7d6caf01cd996f955767a6bf466,1,50,0,50,0,0,0,1,2,62,1,1,0,94,16,4,15,12,3,1047,604,443,11,9,2,100
92bb87fdf8832ccb890d22963d98bb2ced8e7cff,2,17,1,16,0,0,0,5,23,155,2,2,0.503258335,682,125,0,54,53,1,5152,5042,110,31,30,1,100
8c09bc7bcde861057ad0cd77266a57f325c09381,0,0,0,0,0,0,0,0,0,0,0,0,0,0,354,1,0,0,0,0,0,0,0,0,0,100
7a0398680b8f36e9387bd1299609e1d18bc259ae,1,5,0,5,0,0,0,3,6,176,1,1,0,426,126,1,56,55,1,3594,3540,54,30,30,0,100
9ba0073a28307ec164e8a8b7a6da2315e2a0ef45,2,25,2,23,0,0,0,5,24,88,2,2,0.605186577,928,127,2,79,78,1,7671,7546,125,49,48,1,100
e7dad008b282aa842a7ac95401b01bd2324af6ca,3,32,4,28,0,0,0,5,25,111,2,3,0.944488534,858,128,3,82,81,1,6337,6201,136,41,40,1,100
8e72a313b2989132282ae6cdb61eca5637708c38,3,30,1,29,0,0,0,5,26,72,2,3,1.140045798,1257,129,4,188,185,3,9774,9606,168,56,55,1,100
2cfef7645e8c0428be4e810b317f2237f53ed1ca,3,44,8,36,0,0,0,5,27,73,2,2,1.295737801,1192,130,5,199,193,6,8675,8492,183,68,65,3,99.96438746
06a198c0a5bd578374dbef7bb3681f12286f613d,4,214,2,212,2,0,2,5,28,14,2,4,1.635142272,837,131,6,85,70,15,7410,6320,1090,40,31,9,99.85767657
4191ba6851d6685ae8876dced77d22f69f52ea72,1,6,2,4,0,0,0,4,13,12,1,1,0,172,132,7,33,32,1,1158,1147,11,11,11,0,100
361738cf154a246f404dd598d51feb43210bc3f7,1,0,4,4,0,0,0,5,7,230,1,1,0,354,133,8,69,70,1,2779,2804,25,23,23,0,100
c2e42190c558dc15b3a70f18c95d58878b62df8f,1,1,1,0,0,0,0,4,8,167,1,1,0,463,35,1,117,116,1,3377,3371,6,49,49,0,100
d810bcb865b3fc0caf1666ff9c02afb6cc29fcf2,2,33,0,33,0,0,0,7,64,178,2,2,0.439496987,6457,134,9,893,890,3,51275,51045,230,203,202,1,100
d5cc9b090edc0ee9a7deb325fdc9fc4070c014fe,1,6,0,6,0,0,0,3,4,194,1,1,0,189,17,3,45,45,0,1211,1211,0,10,10,0,100
5e83e563b4c84526971e28104c74171b140ed62c,3,683,0,683,3,0,3,1,1,0,2,2,1.548750889,0,18,3,56,0,56,2773,0,2773,25,0,25,99.91123735
7e1d9c3c997962acd88e0fc3a499de12f3f2f36e,1,3,17,14,0,0,0,1,3,40,1,1,0,132,19,3,11,15,4,949,1047,98,10,11,1,100
e98574787be4e99daa63fd2d38c635379d13088e,2,121,0,121,2,0,2,1,1,0,1,1,0.906880172,0,20,4,10,0,10,559,0,559,3,0,3,99.92910315
3e33d2cfa48261e81f7a78e8607656a0488a8a31,2,15,1,14,0,0,0,2,5,102,2,2,0.543564443,1117,135,1,122,121,1,10563,10480,83,56,55,1,100
bcc20cbed9992bc13531012de30aee463c964939,2,129,149,20,0,0,0,5,39,174,2,2,0.778387349,1079,136,2,102,101,1,7600,7664,64,65,63,2,100
ad5cb89d0b4587852aa28e89ba9d8908b7c4c32c,4,70,1,69,0,0,0,4,64,225,1,4,1.391623091,1846,292,0,356,346,10,14044,13723,321,131,125,6,100
d264848e12c3991fbaf61a41cb0881981c700245,2,37,1,36,0,0,0,6,15,741,2,2,0.398459274,652,137,2,99,92,7,4932,4639,293,24,23,1,100
2273672a7f2631e04882cd531e9ac15ed919d972,1,6,0,6,0,0,0,6,11,323,1,1,0,219,22,0,48,47,1,1124,1102,22,18,18,0,100
3b2baf4afaa84e22f1ab9e51c1f1113d85931a12,1,3,0,3,0,0,0,8,18,315,1,1,0,529,36,0,90,90,0,3444,3430,14,26,26,0,100
cb37ff346b9660640710d21288c9be293989cc1d,4,181,5,176,3,0,3,1,1,0,2,1,1.951496091,66,21,3,21,6,15,1036,430,606,12,2,10,99.75238769
84b1de559207ef928a88181060c80b1cc4c8fba2,0,0,0,0,0,0,0,0,0,0,0,0,0,0,355,0,0,0,0,0,0,0,0,0,0,100
27d642e9cd4f69eb05286ea86812e061236a269a,2,341,2,339,0,0,0,4,24,810,2,2,0.5763975,2377,138,3,500,423,77,20708,18300,2408,59,57,2,100
01d474f6a4e746615ad854cacaa537f2ebbc5d06,2,21,2,19,0,0,0,5,30,118,2,2,0.828055725,963,139,4,81,80,1,7599,7505,94,39,38,1,100
877ddb80f4db45333395c97da9653a11169028be,3,56,27,29,0,0,0,3,7,220,2,3,1.536334946,1015,37,1,163,153,10,8202,7879,323,28,28,0,99.94702455
7cd91763eaedb570dbf1cefbb5a7cc4c1991b1cd,106,3545,3317,228,8,0,8,4,106,560,2,19,5.473686233,28450,38,2,5424,5129,295,201874,197238,4636,1871,1784,87,88.60045147
5b49d4e7ad479eda46e0057dc57e8cddec3e1559,0,0,0,0,0,0,0,0,0,0,0,0,0,0,22,4,0,0,0,0,0,0,0,0,0,100
14dce18b8491e89984fad70417683d9da35861a2,6,227,1,226,2,0,2,1,14,171,2,3,1.56255381,411,23,5,88,61,27,3893,2661,1232,50,32,18,90.51767465
d4bf747393cd821096b7381e367e86d5da8f4bb7,2,43,12,31,0,0,0,5,31,41,2,2,0.970950594,904,140,5,76,75,1,6982,6816,166,35,34,1,100
9b231e13b799097874c6c54616f424aea9aae883,0,0,0,0,0,0,0,0,0,0,0,0,0,0,356,1,0,0,0,0,0,0,0,0,0,100
18ff82cd3b50a8ab3f144c96f60a61c02b6b22e4,0,0,0,0,0,0,0,0,0,0,0,0,0,0,357,2,0,0,0,0,0,0,0,0,0,100
9d5f3b123bdd9e9db514389b9d149f4f36042950,0,0,0,0,0,0,0,0,0,0,0,0,0,0,358,3,0,0,0,0,0,0,0,0,0,100
15b428abfd8dc7967655622066bf4ee633411148,32,684,644,40,0,0,0,3,107,141,2,10,3.479814214,8608,39,3,1806,1778,28,61668,61199,469,577,560,17,91.16261541
173ebfa75d6447dbd9fe90453ca1e474d2c2d184,0,0,0,0,0,0,0,0,0,0,0,0,0,0,359,4,0,0,0,0,0,0,0,0,0,100
4600dce020409cbef35db41f0e99b065a5647d13,4,188,40,148,1,0,1,1,2,10,2,1,1.511575151,246,24,3,51,31,20,2566,1565,1001,36,19,17,99.51967486
08bddfcad59826dd5408360b010befd69f89a270,5,573,566,7,0,0,0,3,19,525,2,3,0.625914053,2639,25,4,339,355,16,18472,18616,144,140,141,1,100
95dff2dfb58587bc93d50451d1f9af596352b10a,0,0,0,0,0,0,0,0,0,0,0,0,0,0,23,1,0,0,0,0,0,0,0,0,0,100
5934834b26e69aa32d22e50ba7240b10bb72179d,24,1205,2144,939,0,0,0,9,40,295,1,4,4.434472893,6029,7,0,1239,1455,216,32704,38454,5750,442,426,16,100
d4d75bc663cc17ac1236da14e259a5e96900b941,20,193,400,207,1,0,1,8,34,515,2,8,3.233931828,5952,40,3,970,979,9,43148,44177,1029,426,438,12,98.96867838
8e91f32bacdee10c13f2788cfb72c5b54250a63b,10,195,41,154,0,0,0,4,34,571,2,6,2.20464125,2800,141,3,403,385,18,20638,19738,900,152,145,7,99.86176935
54e8e77571e1097c2d2d528eee2acaa2740dcb04,4,246,48,198,0,0,0,1,9,55,2,3,1.009691667,819,26,0,149,123,26,7597,6585,1012,77,64,13,99.82230997
93d02c182fc0a6698cff5200e7274b0f3a987ba6,2,59,26,33,0,0,0,7,20,52,2,2,0.936667382,955,27,1,140,136,4,7127,6943,184,51,50,1,100
029fa6ae48bdbad2613453950d099e1c86ebe448,1,1,0,1,0,0,0,4,5,450,1,1,0,395,142,1,38,38,0,2896,2885,11,17,17,0,100
4e40075a7fcec3325acb12cecd2775b3a49490a9,20,2649,728,1921,7,0,7,1,108,178,2,5,3.47017197,4726,24,0,1122,909,213,42551,33741,8810,451,339,112,99.7235387
254eede552fafe929607da8a8eb00f2d3027f567,2,387,252,135,0,0,0,9,109,166,2,2,0.384736811,1618,8,0,275,266,9,12653,12043,610,115,110,5,100
c64620b162fca2419e927f675fc16d0dfa51b449,0,0,0,0,0,0,0,0,0,0,0,0,0,0,360,0,0,0,0,0,0,0,0,0,0,100
392b9d137019cb8195f00eb8e3755eb4219910c2,0,0,0,0,0,0,0,0,0,0,0,0,0,0,143,1,0,0,0,0,0,0,0,0,0,100
376d53c06c07c92fbda43e6e1b059dd3fc0a9b51,2,10,10,0,0,0,0,16,110,9,1,1,1,1867,144,2,356,356,0,13825,13809,16,100,100,0,100
a6ea9e28165174aa5cfc68a2e5e366aa2df5fb73,3,32,2,30,0,0,0,5,91,430,2,3,0.978015557,3276,145,3,491,489,2,26026,25849,177,116,115,1,100
4d6093e7c031c9a14e6071cb0622728f2920216c,5,129,13,116,0,0,0,5,34,177,2,3,1.797281271,1337,146,4,163,146,17,10297,9653,644,69,64,5,100
23d54a9532512a24dc44d25003905500813ef029,14,605,49,556,4,0,4,1,10,94,2,4,2.794038339,1956,28,2,459,382,77,16086,13822,2264,208,156,52,99.66489257
6a0a3041c12dabb2e741cd9d76cbc8f59367d001,4,58,16,42,0,0,0,1,4,32,2,3,1.126721318,798,25,1,98,94,4,5380,5101,279,50,48,2,100
26b6e55e3a9ae36cfbd89bb8b360711a29412eaa,0,0,0,0,0,0,0,0,0,0,0,0,0,0,293,0,0,0,0,0,0,0,0,0,0,100
7ef703a6e0009fdc8486799e21d1a3940768e200,4,35,7,28,0,0,0,1,8,70,2,2,1.723502489,852,29,2,147,143,4,6417,6300,117,81,77,4,100
3d8aa08c593cd1a0fd3cac236926c17b95e24091,4,77,13,64,0,0,0,1,5,0,2,3,1.153646853,835,26,2,100,98,2,5701,5380,321,52,50,2,100
2587b7298b2e720e8e9a6e4c6ec9bee07eef518a,2,120,4,116,0,0,0,2,2,924,1,2,0.879310353,373,147,5,75,61,14,2675,2130,545,30,27,3,99.98032271
363b6c91f54f4f64a570262f0f23b7ba41295115,0,0,0,0,0,0,0,0,0,0,0,0,0,0,148,6,0,0,0,0,0,0,0,0,0,100
9de4fe1cf6b6845c27dedf74c6a18ddd17d84fe1,9,351,85,266,1,0,1,1,2,784,1,2,2.157484743,445,294,1,60,42,18,4051,2966,1085,45,28,17,99.9606609
e8d4c51163ca11be86e85c92f33ec61704540ed5,1,9,1,8,0,0,0,8,21,654,1,1,0,188,30,2,27,27,0,1304,1273,31,6,6,0,100
1f9e3fc8e218cef838330c55c5ab9de48602d284,2,147,19,128,0,0,0,3,6,638,1,2,0.973025689,1322,149,6,271,258,13,10010,9519,491,48,44,4,100
dc455e4ea659b49a4f25220d0bd60d7b57802f0c,0,0,0,0,0,0,0,0,0,0,0,0,0,0,27,2,0,0,0,0,0,0,0,0,0,100
6afacb1241a7c4ff43a870de5deb20c4de490afe,1,2,1,1,0,0,0,1,4,6,1,1,0,389,28,3,18,18,0,2344,2335,9,15,15,0,100
2d3dfa55f9dcd7a5aa21aa836bee9c0287761225,2,80,0,80,1,0,1,10,36,171,2,2,0.721928095,1600,361,0,201,193,8,16005,15593,412,47,45,2,97.35530855
a2808f6f5271c3e90e2f4fd6304d027339f447b5,4,73,15,58,0,0,0,9,111,155,2,3,1.473048449,2027,150,6,363,354,9,15115,14650,465,144,139,5,100
04ff8df680ca4571a735b94cbd5a94028d43556b,9,144,78,66,0,0,0,4,21,203,2,4,2.13618497,3597,151,7,318,311,7,38622,38288,334,147,145,2,100
8d30e4aa04ca568ae8f3922eb979d41728bcebf1,4,70,3,67,0,0,0,4,48,89,2,4,1.093375284,2159,152,8,457,450,7,16374,15802,572,119,115,4,100
b536f14f34201146a9ee6fb349db1860cbc4cd5b,2,25,8,17,0,0,0,5,24,598,2,2,0.98337619,784,153,9,161,159,2,6572,6422,150,45,45,0,100
0c80180279c7e13a40d482fb850001c83f982515,1,18,0,18,0,0,0,5,35,38,1,1,0,912,154,10,61,59,2,6900,6810,90,41,40,1,100
274f6ade50745ae7b5b42aca25209252fbfe944f,0,0,0,0,0,0,0,0,0,0,0,0,0,0,295,2,0,0,0,0,0,0,0,0,0,100
0080199103652f460bf7d94bab3917c760a86862,1,9,0,9,0,0,0,3,6,854,1,1,0,263,155,11,79,72,7,1773,1671,102,30,30,0,100
776482aaefceedfa19e13e4b7b771aef9d06840a,0,0,0,0,0,0,0,0,0,0,0,0,0,0,296,3,0,0,0,0,0,0,0,0,0,100
b846e89734835ece5794c908eaa9b653512cface,3,16,11,5,0,0,0,6,66,247,2,3,1.049398525,1752,9,0,308,306,2,13739,13697,42,84,84,0,100
7c5bf4060941533a180dddf5df640683f6d50b90,1,1,1,0,0,0,0,2,4,3,1,1,0,105,156,10,22,21,1,602,594,8,11,11,0,100
34bb1a91deadafa9ea544792aa1ea54b809417c3,6,669,70,599,3,0,3,1,63,22,2,4,2.355997783,856,31,3,285,198,87,9177,6281,2896,73,57,16,99.23149016
7dcddd6895cd89d1b890ba290d28859e41528788,1,1,1,0,0,0,0,2,2,880,1,1,0,100,157,10,9,9,0,871,871,0,4,4,0,100
fc43123fb1dff08849c279e1d47707195d2754a1,5,232,13,219,2,0,2,1,13,12,2,3,1.672508175,870,32,4,187,173,14,7505,6277,1228,89,82,7,99.88732394
55382a7ef5ea4d8ca108d2adbc435e300a3fc659,3,45,11,34,0,0,0,3,112,307,2,3,0.850325905,1394,33,5,273,271,2,10123,9997,126,108,106,2,99.98123827
825c887faa11ae36667ee2e4f0b6953dd010a25d,3,60,8,52,0,0,0,5,36,39,2,3,0.732032405,1537,158,11,202,202,0,10952,10669,283,102,99,3,100
8b2ac4213014f8b5c8cc245845228fbb99ee9b65,14,3119,0,3119,14,0,14,1,1,0,1,2,3.418038219,0,159,12,489,0,489,14458,0,14458,136,0,136,99.40320776
078fb41b1a17dfb2612ca28cbff43968975c6363,4,79,106,27,0,0,0,7,92,276,2,2,0.881937142,4096,160,13,511,523,12,32326,32502,176,145,145,0,100
f9c51208c5b43a14efbb4e64e2aa68fa635e8eea,14,0,3119,3119,0,0,0,1,2,0,1,2,3.418038219,2312,161,14,0,489,489,0,14458,14458,0,136,136,99.40320776
666b37a8fa309f2827ef55592d703a2007fd7d20,15,3028,0,3028,15,0,15,1,3,0,1,2,3.524336639,0,162,15,501,0,501,14632,0,14632,139,0,139,99.36614467
cfd30de0e5ab8f07e0136d652f6094b035ca7590,13,529,61,468,4,0,4,1,15,153,2,4,2.999472875,1850,34,4,342,290,52,16131,14101,2030,191,162,29,91.74451859
3aedb83f7a480e1a1df3281ede0bd1bd7b4cd39a,5,300,10,290,2,0,2,1,39,178,2,5,2.109842332,668,297,2,164,144,20,4958,4068,890,61,52,9,99.80353635
2c896825dfa706a3b19aeb6fe5d6e3909ec35963,2,30,6,24,0,0,0,2,3,44,1,2,0.581321499,463,298,3,80,75,5,2824,2675,149,31,30,1,100
aec301064408850a1a51c042bdcd6d5277cd05ab,18,89,94,5,0,0,0,4,50,160,2,10,2.89460024,6991,163,6,1460,1465,5,52979,53093,114,371,371,0,100
fd5d7be4d05a28a380caeb026d5f36cac776a7bd,5,1336,8,1328,3,0,3,1,57,30,2,4,1.020703511,919,29,0,246,168,78,11710,6866,4844,84,32,52,99.8626104
c6c3d88141d61d12d21b9797e8c757b16e3d4781,1,9,8,1,0,0,0,9,40,200,1,1,0,329,164,5,54,54,0,2074,2066,8,36,36,0,100
64e052ad277c65df54879abd6f60b2891424ac4d,1,9,0,9,0,0,0,2,3,24,1,1,0,170,165,6,12,19,7,657,840,183,9,14,5,100
ac3edbeac7f26e7513930d888065b3bb4b04b6f1,0,0,0,0,0,0,0,0,0,0,0,0,0,0,166,7,0,0,0,0,0,0,0,0,0,100
2b3e7467e87989126013d86419512549813bf8b9,0,0,0,0,0,0,0,0,0,0,0,0,0,0,362,0,0,0,0,0,0,0,0,0,0,100
c0c3a302b73f81fccc687b6a2ff1e35012ed54be,2,115,9,106,0,0,0,6,12,642,2,2,0.375481142,1179,30,1,191,185,6,7498,6887,611,49,48,1,100
008b2e161451b42d41a5e9f58887f8bb2bd55992,0,0,0,0,0,0,0,0,0,0,0,0,0,0,31,2,0,0,0,0,0,0,0,0,0,100
01ea64802ef24726f95c2809c8a4decc337af96d,2,200,16,184,0,0,0,1,2,12,2,2,0.943601631,965,32,3,77,63,14,4969,4274,695,57,49,8,100
3b8631643fdd35b9d20df98643e12fe9b231def5,0,0,0,0,0,0,0,0,0,0,0,0,0,0,33,4,0,0,0,0,0,0,0,0,0,100
1d9a28ed04d7f4f6029d33504c04eeb0e98767c4,3,32,1,31,0,0,0,4,43,441,2,3,1.262883901,1580,34,5,265,261,4,11135,10938,197,89,88,1,100
da3072e732364d39b3bee61280f7772b32eec6c4,2,8,9,1,0,0,0,2,21,442,1,1,0.873981048,794,35,6,32,31,1,4577,4570,7,19,19,0,100
fad928be4a8c9b67918e28226589fbefe3e64bdd,1,1,1,0,0,0,0,13,35,162,1,1,0,944,36,7,65,65,0,5879,5881,2,51,51,0,100
12f2d5c7f41683a131ebfd3dcfc24ca74a82ce63,1,6,7,1,0,0,0,13,36,2,1,1,0,943,37,8,65,65,0,5882,5879,3,51,51,0,100
996d534ea560e15c1b714a40893f6c126f8b2b1e,2,22,0,22,0,0,0,4,5,322,2,2,0.439496987,1470,167,4,453,450,3,11722,11589,133,36,35,1,100
a39376fb21036b903bf20cd67395cf482e954ae3,2,22,5,17,0,0,0,5,38,134,2,2,0.380946586,1130,168,5,97,95,2,8335,8223,112,62,61,1,100
1aef46f30716e17c86f784452c4b7c2d795f64b5,2,54,3,51,0,0,0,10,37,364,2,2,0.297472249,1655,169,6,200,197,3,16273,15937,336,48,47,1,100
0fceb2408be026275e32ea4d8d664a9ef90ee0f4,25,52,49,3,0,0,0,3,35,495,3,12,4.362012008,7991,170,7,1277,1277,0,58398,58148,250,485,485,0,99.96078431
a558860572a17e79c3bc2e872d88073ec40fc175,2,23,0,23,0,0,0,5,39,14,2,2,0.558629373,1128,171,8,94,92,2,8369,8235,134,57,56,1,100
79778e5f535f3c0f16d4dcad686d8fea23783487,10,1233,77,1156,4,0,4,13,58,84,2,5,2.651432234,1885,0,0,464,327,137,19438,13922,5516,179,113,66,99.82377129
6eefab0f529f8b38a8196a4bb11fd1e3f058f2d1,8,367,102,265,0,0,0,4,42,55,2,4,1.690846296,3483,172,8,729,680,49,27370,25368,2002,197,189,8,100
0ba8ced37516a736b0ea57993534fcc8a301e730,2,205,52,153,0,0,0,2,4,64,1,2,0.983324201,488,299,0,105,80,25,3704,2824,880,36,31,5,100
86d80fb01e196eea96459bc7ef92c5805a271005,2,14,12,2,0,0,0,4,13,2,2,2,0.961236605,1141,173,6,204,204,0,9988,9950,38,56,56,0,100
b46f9eb7753334f25acc5a3561571f5582f883e6,2,20,0,20,0,0,0,1,2,82,1,2,0.721928095,348,174,7,61,61,0,2331,2276,55,21,21,0,100
f4dd32fe1137f88cad8a4af322c14ed34fb2a770,2,34,1,33,0,0,0,8,93,86,2,2,0.822404226,2998,38,2,438,434,4,24626,24412,214,97,96,1,100
b28209d40bd913f864d594117ac9c56d87dda351,3,32,29,3,0,0,0,1,62,180,1,2,1.360427919,1201,39,2,233,233,0,8285,8308,23,75,74,1,100
0a668cf8f48d35149d7950095648a96f97f387ba,0,0,0,0,0,0,0,0,0,0,0,0,0,0,175,8,0,0,0,0,0,0,0,0,0,100
89cda6f83fb8284b0f37bea05d4fa20763dd2131,5,119,143,24,0,0,0,6,67,357,2,3,1.189784931,2016,10,0,356,361,5,15575,15573,2,110,109,1,100
f02c5040d0552facf419a4a61784de1827c350ab,104,12363,2909,9454,13,0,13,6,113,276,2,23,4.097134041,40639,35,0,6636,5757,879,336916,305345,31571,2315,2010,305,92.96268932
950fcab9237f1f688b3a5b66ee5717cbfaad1ecc,2,0,0,0,2,0,2,5,11,0,2,2,0,0,36,1,0,0,0,0,0,0,0,0,0,99.92992292
19946f913bc000a7c5b5b1cf1e098d145c243ea8,2,81,9,72,0,0,0,6,14,8,2,2,0.309543429,785,40,2,162,161,1,5972,5664,308,81,79,2,100
e0478609abebe1bbb527a81771b12d0146ece3d6,4,55,28,27,0,0,0,5,18,194,2,3,1.29666443,1388,41,3,233,235,2,10432,10259,173,109,108,1,100
7b7696124984f946ca658d0d33052e4435236555,0,0,0,0,0,0,0,0,0,0,0,0,0,0,176,4,0,0,0,0,0,0,0,0,0,100
738f030a5965fd94a3826ab7eb9ac7811c2e3ee9,3,415,390,25,0,0,0,10,22,215,2,2,0.218425539,1070,37,2,75,74,1,6858,6692,166,36,36,0,100
2bd4f6ad456c50c5d11937d212cfc6e50b05022c,2,37,2,35,0,0,0,4,7,1028,2,2,0.477071306,649,42,4,104,102,2,5611,5364,247,28,27,1,100
cb95b8f40d883e455aac92fb6bcda6968240bfee,0,0,0,0,0,0,0,0,0,0,0,0,0,0,11,1,0,0,0,0,0,0,0,0,0,100
ac6c70b006b424254091077d623eb987f2489924,1,34,14,20,0,0,0,2,6,9,1,1,0,203,177,5,23,22,1,732,624,108,21,20,1,100
0519437985167808f6128d8f00b34472e5a33236,0,0,0,0,0,0,0,0,0,0,0,0,0,0,178,6,0,0,0,0,0,0,0,0,0,100
30d27eabb90b90f3ac41fe0706c1807b5a87a320,11,125,113,12,0,0,0,4,114,115,2,5,2.164755892,5691,38,3,716,710,6,43199,43113,86,322,319,3,100
66a091d9b8d48ae94bb2543c392d69917df6adc0,0,0,0,0,0,0,0,0,0,0,0,0,0,0,179,7,0,0,0,0,0,0,0,0,0,100
d16f263a419de2f317deecf836831003a29b8da0,16,522,49,473,1,0,1,1,51,190,2,11,2.200817827,8728,180,8,1861,1824,37,61117,57343,3774,476,454,22,99.96494918
941edea3e02bbde8dd2549851d18b983c5117299,9,128,33,95,0,0,0,2,43,216,2,2,2.770852368,4886,181,9,359,359,0,41565,40617,948,241,240,1,100
2033c013ac56015ec532627825435674ca311834,4,49,29,20,0,0,0,1,115,6,1,4,1.513626072,2187,39,4,497,492,5,15843,15704,139,146,146,0,100
f625edc45f24171d38f8cfdc369179d0da1c8446,2,221,0,221,2,0,2,1,1,0,2,2,0.868194607,0,40,5,31,0,31,1094,0,1094,21,0,21,99.75528754
36cc84a5adf8275252174fb07c0018cd9cab1ea0,1,0,2,2,0,0,0,2,2,339,1,1,0,384,182,10,46,46,0,2680,2693,13,21,21,0,100
805e8f009b1081751e13eeab0c68f26b233f438c,1,114,109,5,0,0,0,1,2,110,1,1,0,239,183,11,24,29,5,1011,1480,469,9,14,5,100
6219ca60cfcc8eabc5280b199141505fb05c08f2,1,1,0,1,0,0,0,2,2,340,1,1,0,243,184,12,50,50,0,1622,1615,7,15,15,0,100
5df3e5b8598bcb30470876293ae2b73a89cbf9c4,10,133,174,41,0,0,0,5,116,80,2,7,2.720294029,5055,43,5,767,780,13,34556,35002,446,284,288,4,100
26a42fccfc59c457e468bf8fe7affca9959c12ed,14,1211,2379,1168,1,0,1,1,117,8,2,7,0.884960535,8028,41,6,1441,1370,71,64720,60487,4233,524,471,53,99.93026499
0d4f7093e5f8f1bdddf016dba2221c0a9addd302,7,138,38,100,1,0,1,1,118,347,2,7,2.401602154,2176,44,6,363,356,7,14845,14160,685,167,164,3,99.96515679
5b64b8a67e9bd81fc73b7889ac7f5f8fcc743618,2,16,2,14,0,0,0,2,2,628,2,2,0.503258335,176,42,7,7,7,0,1738,1632,106,5,5,0,100
a24237548423553000d35f412003843f52425ab8,1,5,3,2,0,0,0,6,10,26,1,1,0,388,12,2,71,71,0,3119,3109,10,24,24,0,100
edac810f19c5ee3ea6bf16b87b974a35739517cd,1,1,0,1,0,0,0,7,20,584,1,1,0,235,185,11,30,30,0,1861,1854,7,10,10,0,100
6f6a8844c158a1060e9c366c4ef635025925f57c,1,6,0,6,0,0,0,2,7,19,1,1,0,221,43,8,24,23,1,751,732,19,22,21,1,100
d5a233dd4624e6e5483df1e53e85e111c3448d7b,2,33,1,32,0,0,0,2,3,586,2,2,0.430551867,180,300,0,19,13,6,1617,1412,205,14,9,5,100
18f297d0e45eeb8b93499ec01ca0f61550bf6e60,2,148,44,104,0,0,0,10,119,19,2,2,0.877437311,1534,186,11,271,249,22,12194,11443,751,109,106,3,100
0782d2b04f9767e6728d4e4692476d101c7e341a,2,21,0,21,0,0,0,4,9,574,2,2,0.453716339,1077,187,12,140,138,2,9312,9189,123,66,65,1,100
dd040400bc26e55eedb80c515f2e15d48188285e,3,28,20,8,0,0,0,4,8,11,2,2,1.251629167,613,44,9,65,64,1,3901,3867,34,39,38,1,100
41b6f3f1cc0e7b66c27ba5f3279ebdabc4d7bdb1,1,4,3,1,0,0,0,2,10,12,1,1,0,710,188,13,148,147,1,5488,5475,13,64,64,0,100
3ce577d8f31061c051ae02dc706d384c1781ad22,7,158,47,111,0,0,0,8,45,811,2,5,2.055719876,1333,13,2,279,256,23,9227,8516,711,98,95,3,98.28791055
58c82167f7fa332bdfc8f6270867187ff7071826,0,0,0,0,0,0,0,0,0,0,0,0,0,0,14,3,0,0,0,0,0,0,0,0,0,100
9de4eb08b9b44aa6cd4c77afbc5bfbff959294f7,0,0,0,0,0,0,0,0,0,0,0,0,0,0,301,1,0,0,0,0,0,0,0,0,0,100
e1da17c899b796fa3fd21eb1795a2f1df951c097,2,89,1,88,0,0,0,5,27,330,2,2,0.956457405,1721,189,13,153,140,13,17484,16729,755,95,91,4,100
169dd9774bd123f356e1a72cdfa2acd3442f0c3c,2,212,1,211,0,0,0,10,38,421,2,2,0.401517143,1798,302,2,249,227,22,18006,16974,1032,70,58,12,99.98247459
07fcc25ba42e3585b9d5f507fcdcfaa973d67d36,2,1001,0,1001,2,0,2,1,1,0,1,2,0.874722068,0,303,3,89,0,89,3879,0,3879,29,0,29,99.92994746
4f98e43043823801b74dcec3bf709c5c100eac00,14,248,122,126,2,0,2,4,11,114,2,2,3.201164168,1421,304,4,253,238,15,9973,9367,606,121,111,10,99.73757873
c98b502728d9e84cd02fe7d84c8697f9ee4eebd9,5,163,2,161,1,0,1,6,66,39,2,4,1.473656886,2621,190,10,330,312,18,21439,20552,887,120,111,9,99.94755245
976b07d4648044e7f40414ff9dfc7bd89dc92e7b,2,70,1,69,0,0,0,2,12,29,2,1,0.548486609,937,45,4,195,174,21,7286,6907,379,90,87,3,100
dfe37f0ecce213b043c3bbe685ff5f35a9870800,14,1583,879,704,2,0,2,4,60,56,2,5,2.02233432,5007,45,0,876,788,88,34373,31107,3266,312,284,28,90.51724138
1e1828477099608ce55a06483db844aa4c90154d,2,2,2,0,0,0,0,2,7,1315,1,2,1,253,191,6,60,60,0,1836,1836,0,24,24,0,100
24bae3a77d28ca995a30f66cf2cb2b2bc24ccb49,0,0,0,0,0,0,0,0,0,0,0,0,0,0,192,7,0,0,0,0,0,0,0,0,0,100
5a0236453efb39ce9d71bb6a260b0116b2165e4b,7,45,31,14,0,0,0,3,120,43,2,5,2.436033646,4616,193,8,840,837,3,32591,32447,144,259,258,1,100
4e447156aff5953c4cddf4943b40287926ff0685,2,2,3,1,0,0,0,5,18,23,2,2,0.970950594,1320,194,9,274,274,0,11034,11038,4,65,65,0,100
0d40ef0748a94c94d50ed92dd27b0c419cc262a1,29,2405,379,2026,2,0,2,1,95,341,2,12,3.072502696,14868,46,3,2651,2474,177,118085,110381,7704,871,803,68,99.91192014
95cf91245a826ada1aff2ae59a5dfb8c20e825fd,2,72,1,71,0,0,0,5,20,56,2,2,0.181166402,1047,46,1,168,162,6,8589,8137,452,84,82,2,100
b5e5d4552ed0a65f6dfb87cb914908a35ffe0abb,2,112,11,101,1,0,1,1,7,773,2,2,0.909950305,79,305,4,17,11,6,974,462,512,6,3,3,99.94135757
f732e95820ebc5cf8f9ffda0c829574cc630d083,29,2074,0,2074,29,0,29,1,1,0,1,5,4.641910576,0,306,5,215,0,215,8985,0,8985,79,0,79,98.70658335
b1c3ad37b2e8372a3a6316a77ec6ecc9877611b2,0,0,0,0,0,0,0,0,0,0,0,0,0,0,307,6,0,0,0,0,0,0,0,0,0,100
9386670315b9baf1eec3bcc98bfc95850fc6e234,9,53,43,10,0,0,0,3,10,68,2,1,2.702145541,1283,47,2,200,203,3,8617,8523,94,81,81,0,99.95675364
1aac754b4e43da03e8bce5944885d6e92874d27d,4,48,2,46,0,0,0,5,68,122,2,4,1.212283122,2057,48,3,354,349,5,15697,15433,264,132,129,3,100
612468b0f8d47200e9ad5371dea39b591e656630,47,385,199,186,0,0,0,3,121,402,2,9,4.060791034,7834,0,0,1520,1507,13,52280,51129,1151,578,564,14,96.80519481
29017c4824c1a0382757da9abe1552dfa5e2484b,1,158,0,158,1,0,1,1,1,0,1,1,0,0,1,1,17,0,17,739,0,739,9,0,9,99.97637609
8ed9e14c27effa86352c61b32b8ad5cc13501b23,4,71,44,27,0,0,0,6,96,21,2,4,1.111843167,4868,195,5,723,720,3,38409,38233,176,188,187,1,100
b8b8bba6d2e351448ca51dbcac4bf067e41f4604,2,16,0,16,0,0,0,2,10,38,2,2,0.337290067,481,196,6,38,37,1,4341,4236,105,32,31,1,100
47e05985d0da9a05f792e1067075b432567a33bc,4,35,7,28,0,0,0,15,122,29,2,3,1.801463832,2123,2,2,300,297,3,14222,14045,177,144,143,1,100
87b46935ecae2c61ddada93f7eb62bc84adecb79,2,8,4,4,0,0,0,5,6,56,1,2,0.650022422,296,47,2,33,32,1,1981,1957,24,15,15,0,100
20046a6419a097afbab7f9d0984e7d60cfc31a76,0,0,0,0,0,0,0,0,0,0,0,0,0,0,48,3,0,0,0,0,0,0,0,0,0,100
69c1d3131f64cac2f8c305e593db05f44c99bb7b,21,12,54,42,0,0,0,6,27,221,1,3,4.333881195,5976,49,4,1317,1317,0,37430,37714,284,455,455,0,100
8a627bd087d4a4bee0f6e0b889d561e40927f10a,0,0,0,0,0,0,0,0,0,0,0,0,0,0,197,6,0,0,0,0,0,0,0,0,0,100
b4f3e737303a7b902be5c12ddf3baf8feb42f17a,5,104,11,93,0,0,0,3,5,242,2,4,1.276433253,790,1,0,111,96,15,5734,5140,594,40,37,3,100
078fbcb43831f7b6159ab52b1ad6699050020a6e,3,38,10,28,0,0,0,1,5,12,2,1,1.298794941,424,3,3,79,75,4,2771,2632,139,31,29,2,97.27378943
6937248722d5810649a8c511a3149daaa6ec58c2,9,118,23,95,0,0,0,1,17,256,2,4,1.858174627,2471,4,4,456,448,8,17568,17263,305,165,158,7,100
ea1900be50ef4152365e3d7c48da970b584a5724,3,84,3,81,0,0,0,5,28,35,2,3,0.926938096,1397,49,3,269,266,3,10054,9792,262,103,101,2,100
86e389b095d2c5e6c41db63cce8dbde3269963bc,2,58,38,20,0,0,0,5,9,47,2,2,0.295181743,720,50,4,109,106,3,5885,5830,55,32,30,2,100
3eccef56b6cbeff6fdfa397fc405ed4dfeeded07,0,0,0,0,0,0,0,0,0,0,0,0,0,0,51,5,0,0,0,0,0,0,0,0,0,100
38b3049383b7b1267a954463fe7674846e0cace3,0,0,0,0,0,0,0,0,0,0,0,0,0,0,198,7,0,0,0,0,0,0,0,0,0,100
26e472739ffc9e026d6fde270e0b0c7a48eb9937,2,43,3,40,0,0,0,15,123,12,2,2,0.987692509,1952,5,5,282,277,5,13458,13258,200,131,130,1,100
5daf9c50131fb2cf2120a179f8a9d7878db70683,2,63,2,61,0,0,0,2,3,642,2,2,0.391243564,341,50,4,39,36,3,2656,2274,382,16,15,1,100
86915318fd9c5cbba886611cfe4d655321737d41,2,34,2,32,0,0,0,3,6,29,2,2,0.581321499,1626,51,5,141,138,3,6516,6403,113,102,101,1,100
6474a1497326fe7f043028fba09a7aac677dc76e,3,81,1,80,0,0,0,1,47,61,2,2,1.574712865,3808,52,5,309,298,11,28749,28424,325,208,203,5,100
ba63ac45600e359a76666aa1884a2be5f4075bfe,3,69,20,49,0,0,0,3,6,215,2,3,1.184858473,455,53,6,30,21,9,2642,2459,183,21,19,2,100
5acbc3111c94c925c39847c3969cc1f1de3ca528,4,464,31,433,2,0,2,1,124,26,2,4,1.811353712,1933,308,2,421,391,30,14740,13049,1691,150,132,18,99.92798502
e9c092c126f6096efd6556515a02015b64ad667d,0,0,0,0,0,0,0,0,0,0,0,0,0,0,309,3,0,0,0,0,0,0,0,0,0,100
6188c555a4e7a3440740a5ce4dc3d3cf831bf2b6,1,28,0,28,0,0,0,1,2,99,1,1,0,85,54,7,6,5,1,559,442,117,6,5,1,100
0fb102c85be8e7e07ac5592827b4190df103453e,2,29,1,28,0,0,0,5,7,22,1,2,0.353359335,300,199,4,35,33,2,2197,1981,216,16,15,1,100
5486f231b09aeff78a97a99a01934fe65f62e486,68,5420,0,5420,67,0,67,1,2,0,2,17,5.652761579,94,310,3,608,9,599,25628,577,25051,323,6,317,97.91343578
4b3aac61ed1f2cf1ac177a286395b77b01b4aca3,2,27,1,26,0,0,0,6,48,18,2,2,0.371232327,1279,200,5,110,109,1,9961,9799,162,67,66,1,100
5d6bf47b8e2a6ab39acfc9e018bd1f24c449813e,3,211,55,156,0,0,0,14,44,30,2,2,1.179691581,4227,55,8,584,569,15,32293,31792,501,269,258,11,100
c3853d09c7f6fff345e54f71a3b2272cc2be6404,1,3,0,3,0,0,0,13,61,62,1,1,0,743,201,6,133,132,1,5539,5518,21,12,12,0,100
0a88cc7a27039e2003a39a15f536e1cd9a8dc294,2,38,2,36,0,0,0,4,10,93,2,2,0.998195879,444,56,9,21,18,3,3059,2964,95,18,16,2,100
0b0c62ee562ad0b2c15dd303ea2718dd25d8f610,0,0,0,0,0,0,0,0,0,0,0,0,0,0,363,0,0,0,0,0,0,0,0,0,0,100
32d20ec6ca8523f9feced5acfcef117a6ca5552b,2,302,83,219,0,0,0,7,11,111,2,2,0.81840333,780,15,0,127,101,26,7901,6380,1521,47,38,9,100
c49c15eab688b5958d2d919695996c4861055007,2,416,58,358,0,0,0,7,12,0,2,2,0.932360884,944,16,1,168,127,41,9825,7901,1924,59,47,12,100
67afa4fc1a5465fb098596cd77b06b1aebbb528d,3,250,92,158,0,0,0,3,5,455,2,3,1.279372331,922,52,3,168,153,15,7410,6603,807,72,67,5,100
868f8c18cf52bc535e1baf3f0ace70b01e63b89e,4,96,6,90,1,0,1,1,52,574,2,4,1.625645938,1593,57,10,406,398,8,10609,10273,336,99,95,4,99.95856354
5d4e4c6d22ba80f231fe8bb65a6127d854e09d76,1,7,0,7,0,0,0,3,10,44,1,1,0,232,6,3,26,25,1,786,765,21,24,23,1,100
5badbcf249b53105f2d76ca364cf69b477aaa125,3,23,5,18,0,0,0,2,15,48,2,3,1.235348018,1471,7,4,164,162,2,8325,8227,98,79,78,1,100
be5f5e22ff334ca9e9045fe2e794fef2ac650b8f,4,410,59,351,1,0,1,3,62,21,2,3,1.236785166,2534,53,4,348,284,64,14925,13048,1877,150,121,29,99.97239094
f462e1f8fb9a85a2755af214693dbdfa71375b0c,0,0,0,0,0,0,0,0,0,0,0,0,0,0,364,1,0,0,0,0,0,0,0,0,0,100
895188c25c6d36f685ae08fc675a4264fffbebd4,1,18,3,15,0,0,0,7,28,40,1,1,0,1160,202,5,311,309,2,7530,7468,62,23,23,0,100
d15b485d73e92e7bc113549f88d6dbb39ea96910,5,154,3,151,2,0,2,14,67,24,2,4,1.784832406,2073,203,6,326,321,5,17695,16732,963,115,110,5,98.11894882
dec971585b8d69faf974623c562bcaf54923f875,2,29,4,25,0,0,0,4,8,210,2,2,0.684038436,1019,204,7,139,138,1,7629,7394,235,46,45,1,100
e90b8e7ad4c121e66f707c0eef7fa5b4ad210746,2,11,2,9,0,0,0,3,11,25,2,2,0.619382195,323,8,5,41,40,1,1278,1259,19,32,31,1,100
1eac404651918e0f6a2173c39fd4494b17f00df0,2,21,23,2,0,0,0,2,5,25,2,2,0.266764988,1283,58,9,124,124,0,7489,7489,0,50,50,0,100
09929615b9dd8cd1b8eadeeddd87502d1c4fc29c,2,72,31,41,0,0,0,1,7,14,2,2,0.689750175,3674,59,10,468,463,5,27370,26928,442,206,204,2,100
34632d8e94737cd8ef1144c9ddcae136b73f0a0c,1,12,0,12,0,0,0,2,3,143,1,1,0,73,9,6,6,5,1,464,385,79,5,4,1,100
8e22a44ccd4a15d32800ae377b6819d2522c73ff,2,24,0,24,0,0,0,3,8,8,2,2,0.738284866,1762,54,4,165,163,2,7148,7078,70,122,121,1,100
9608d8efb1532a7791c463e477a6848644b5d59f,12,331,47,284,1,0,1,14,46,27,2,5,2.771416147,6243,205,7,855,820,35,48342,46396,1946,416,400,16,99.84743412
0c00d8d8506f56ec647cb96b2bf473a4a168e2bf,1,14,0,14,0,0,0,3,12,5,1,1,0,245,10,5,29,27,2,851,809,42,27,25,2,100
fb22738fce8798d51f85197e2e3a615515326405,1,97,93,4,0,0,0,2,2,131,1,1,0,302,17,2,16,12,4,3204,3113,91,12,12,0,99.98612268
b7ad4e779fe0482332642c2f6babca2847f628ed,2,21,0,21,0,0,0,6,22,118,2,2,0.702466551,858,11,6,92,89,3,6788,6658,130,51,50,1,100
61922f268cc969a5041dc2a7ab6b152020fd5f79,0,0,0,0,0,0,0,0,0,0,0,0,0,0,12,7,0,0,0,0,0,0,0,0,0,100
0a633669715ebee7afd005c2a8ebab2dd436761f,0,0,0,0,0,0,0,0,0,0,0,0,0,0,206,7,0,0,0,0,0,0,0,0,0,100
57309d6cd7bc28fe0e6c9ad571360f8f3a2c3d2a,1,0,1,1,0,0,0,6,23,2,1,1,0,694,13,8,61,61,0,5645,5651,6,37,37,0,100
5056409cb05a1bfd68eb045751dad10e8c09a05c,1,11,4,7,0,0,0,9,42,140,1,1,0,334,207,8,56,55,1,2144,2105,39,37,37,0,100
260f434195692b5a19250234b2158bf297bbe7b1,2,15,12,3,0,0,0,3,10,682,2,2,0.918295834,513,208,9,104,104,0,3534,3547,13,42,42,0,100
c3ebf71494491468413cd8c315813f16fb18eeeb,2,91,0,91,0,0,0,5,28,288,2,2,0.152406999,1874,209,10,187,174,13,19215,18528,687,95,86,9,100
0646df78d43cb7f6d3f0700768a1a6da0c03beeb,3,50,12,38,0,0,0,7,125,105,2,3,1.261734037,2468,210,11,458,457,1,18686,18515,171,146,145,1,100
275906b1b08dd5dccf2ddf7e8acf747e63424ee9,1,14,0,14,0,0,0,3,13,10,1,1,0,257,14,8,31,29,2,909,851,58,28,27,1,100
c38bd1eb97b3dfbd648dfbb9946f3de1d78ae4b7,2,46,7,39,0,0,0,5,24,435,1,1,0.924457141,1317,15,9,103,101,2,10558,10358,200,55,54,1,99.97224535
a8fdb9b04dc26fde7d011afe5327b97d0ed1ff98,0,0,0,0,0,0,0,0,0,0,0,0,0,0,16,10,0,0,0,0,0,0,0,0,0,100
f2b95bd3a4303b914b6dd11f3e10d9f633f769bf,5,42,37,5,0,0,0,2,19,39,2,4,1.379031475,4580,60,7,738,738,0,32849,32841,8,266,264,2,100
bb8895d87738d61019e6ada54edb02a4af92d063,3,331,81,250,0,0,0,3,9,35,2,2,1.29023452,2045,55,3,236,189,47,10518,9242,1276,125,121,4,100
7f8aca931573c42a48af103e2b6c2131ea9ed39c,0,0,0,0,0,0,0,0,0,0,0,0,0,0,211,12,0,0,0,0,0,0,0,0,0,100
021e44622f08bdfbd4c87567c06b3b1df4618e88,3,32,1,31,0,0,0,6,49,231,2,2,0.760732746,2181,212,11,364,361,3,15830,15643,187,101,99,2,100
39b142013ee4aef895ae0cea2f8651fad4b03477,2,23,1,22,0,0,0,4,29,88,2,2,0.870864469,2743,213,12,511,509,2,21151,20993,158,61,61,0,100
e976079fa631400e1d8101b43d9b50f5c3681ac4,2,14,3,11,0,0,0,5,26,218,2,2,0.997502546,816,214,12,167,166,1,6779,6707,72,47,47,0,100
cdc5ebd6a60e145fd8f220189612fb448ff54a7f,1,0,1,1,0,0,0,17,126,12,1,1,0,1068,215,13,225,225,0,7712,7725,13,85,85,0,100
0258db20c54f5ee7e2c1cc946dde69ca3d0ac3b0,2,13,1,12,0,0,0,2,9,14,2,2,0.371232327,3286,61,4,350,348,2,24202,24166,36,198,197,1,100
a7345e769c69b0dd624e982564b15689abe945a0,0,0,0,0,0,0,0,0,0,0,0,0,0,0,311,0,0,0,0,0,0,0,0,0,0,100
67dd14c303bf7c6a088adcacfe0caf96892e1501,1,2,1,1,0,0,0,1,2,96,1,1,0,53,312,1,8,8,0,343,330,13,2,2,0,100
bb807eab0084d0e439a0aaa7c83eabbfd92f5e85,3,115,76,39,0,0,0,3,10,15,2,2,0.879895014,2252,56,3,246,236,10,10663,10518,145,131,125,6,100
790b4d1feb9addd00c3826ac4ebc4f7b710ebd2d,5,768,3,765,3,0,3,6,8,70,2,4,1.816973739,945,216,14,224,112,112,12174,8374,3800,90,40,50,99.902953
fe7d919a5441eb550ac9bac22593c411ddffbcf2,2,36,2,34,0,0,0,2,20,15,2,2,0.629249224,3494,62,4,483,480,3,25126,24955,171,207,206,1,100
d99d9c71be44c965b8d77981e46975489ce22343,54,2994,20412,17418,0,0,0,5,127,602,2,10,4.236947083,32125,17,10,1898,2864,966,140844,267682,126838,1049,1636,587,85.87282543
b8ebdbca4f5d45ad24fce0bc8ac9c938691558e0,3,847,1144,297,0,0,0,16,48,120,1,1,1.001003769,2100,57,3,215,259,44,12935,14476,1541,123,122,1,100
602793fe4fd9f8eb2b055f98fdee4e3eef1144f2,1,6,3,3,0,0,0,6,13,52,1,1,0,559,313,2,116,115,1,4383,4366,17,33,33,0,100
0fc578f66ad07cf5b02151f7e6e6d9cb22e3ab24,0,0,0,0,0,0,0,0,0,0,0,0,0,0,217,12,0,0,0,0,0,0,0,0,0,100
ced96483aab026ede64de81c8c866a218353fd67,1,70,21,49,0,0,0,6,6,164,1,1,0,102,63,3,28,19,9,728,558,170,18,14,4,100
4450371dcc77f0a57aa014e533e705c66a7f3b93,1,48,2,46,0,0,0,3,11,8,1,1,0,1603,58,4,106,103,3,5712,5580,132,102,99,3,100
3b1526e890828d4e71c3451b11bb8fdc1b6744db,1,6,10,4,0,0,0,6,9,7,1,1,0,907,218,13,102,102,0,8263,8301,38,36,36,0,100
34b713ffc7793b6fc6f670924b72ad371aa0a516,0,0,0,0,0,0,0,0,0,0,0,0,0,0,21,0,0,0,0,0,0,0,0,0,0,100
99bc4fcd79faea59f7b1ccd2864d3fb3fc6ee618,23,611,652,41,0,0,0,16,71,58,2,8,2.2914291,14837,18,8,1893,1841,52,101143,98474,2669,855,820,35,99.93459778
4587c8a377c78857fb0e4470d3b3733f1a311963,4,12,8,4,0,0,0,4,65,13,1,4,1.595461844,2055,219,14,357,355,2,14505,14499,6,87,85,2,100
3a6736fa10826dcc4667606be02d36eae28d120b,1,10,8,2,0,0,0,6,10,20,1,1,0,92,220,15,18,18,0,610,604,6,11,11,0,100
b6b96109aae779997a9cebbf986514996a7d609b,0,0,0,0,0,0,0,0,0,0,0,0,0,0,22,1,0,0,0,0,0,0,0,0,0,100
73f442f2f5e4ed9cb41fe0d45fcbe2df40ee1d7e,1,2,2,0,0,0,0,5,7,65,1,1,0,120,221,16,22,22,0,721,725,4,9,9,0,100
2a47dd55973d77685684e283efba342eb4334bac,1,2,1,1,0,0,0,5,8,53,1,1,0,189,59,4,49,48,1,1361,1347,14,6,6,0,100
a7949ab4d10b7fe00ab8127a30cf25646bd2e0a8,1,1,1,0,0,0,0,5,15,798,1,1,0,182,222,15,38,38,0,1370,1368,2,11,11,0,100
56f5bac45d1892b34df4224b7ec3a6540a6297a9,131,139,30216,30077,0,0,0,3,65,1095,2,16,5.898274977,35637,19,6,1753,5662,3909,97174,244756,147582,672,2081,1409,89.10435497
e83121fc2e836708f0479cdaa04ee2a5ef40bdc2,1,4,0,4,0,0,0,13,66,3,1,1,0,458,60,5,73,72,1,3382,3367,15,12,12,0,100
ad7ad5296c2b56d8ecf49e695d12131f271d347e,1,0,1,1,0,0,0,9,11,3,1,1,0,194,223,16,44,44,0,1321,1321,0,14,14,0,100
4fe621b03ef423edbe89eddae228f4e184b25f74,1,11,12,1,0,0,0,6,7,9,1,1,0,138,64,4,29,28,1,729,728,1,17,18,1,100
d153fcb3e9d04ce14e91070eeb74b024b42f143a,1,0,6,6,0,0,0,5,8,75,1,1,0,206,224,17,13,13,0,1379,1472,93,7,7,0,100
78c2501e2a18735ca43db6d8362d23403cbf3e65,0,0,0,0,0,0,0,0,0,0,0,0,0,0,314,3,0,0,0,0,0,0,0,0,0,100
cc293706b19c18cca304255f4d7ec0b187661a6f,8,227,20,207,0,0,0,3,128,55,2,3,2.402773567,3780,61,6,576,549,27,21920,20973,947,264,248,16,100
3caca70d64cbb9b34177a9350efceec9eef4955f,2,23,19,4,0,0,0,11,72,10,1,1,0.371232327,1977,20,6,232,222,10,10792,9596,1196,173,164,9,100
b8768bddd2e3b6b94799e92ca2e25b5345318910,2,99,77,22,0,0,0,5,9,7,1,2,0.684038436,320,18,0,34,35,1,2321,2100,221,17,16,1,100
43f15734ec7edeefe4a8bdf59180da23608cdc02,1,1,1,0,0,0,0,5,16,11,1,1,0,182,225,14,38,38,0,1372,1370,2,11,11,0,100
c0f0469964ebcf2fce7f315f951f9625b266cd73,0,0,0,0,0,0,0,0,0,0,0,0,0,0,315,4,0,0,0,0,0,0,0,0,0,100
cbe0fde123318c552df785e0489f3a0783bdd5c7,1,1,0,1,0,0,0,3,3,1172,1,1,0,132,226,15,24,24,0,580,580,0,19,19,0,100
a421d63514bb2bda2902c9ef97ee1f8daaee7d7d,2,26,7,19,0,0,0,9,73,158,2,2,0.32984607,1844,21,4,233,228,5,9297,9168,129,170,169,1,100
b4f95470c5e1e58b9db9380f8989321afad19ae6,2,60,1,59,0,0,0,9,97,64,2,2,0.514091279,3025,227,16,450,443,7,24808,24359,449,103,97,6,100
4bab5c73e786b1de6e19b1914bdf9e86819cc8f6,2,40,2,38,0,0,0,3,13,2,2,2,0.650022422,2087,62,7,208,207,1,9063,8958,105,124,123,1,100
69826e185ec430607dd278bed17e2ab500508877,1,10,0,10,0,0,0,3,14,2,1,1,0,1728,63,7,112,111,1,6098,6068,30,106,105,1,100
1f44b9d2ac09dcd87169b47e8b4b63f51e641ecb,9,248,88,160,1,0,1,4,10,276,2,3,2.680007103,2583,19,1,295,285,10,21692,20975,717,121,117,4,90.89769701
b2876e0110fa8c8d003bba23d977c38c7a13c4d9,3,34,8,26,0,0,0,1,8,128,2,3,1.142610782,904,64,8,97,96,1,5998,5843,155,45,44,1,100
daf36cc4d8c4d43b1c77bba83ce71fb27e51dc9e,0,0,0,0,0,0,0,0,0,0,0,0,0,0,316,5,0,0,0,0,0,0,0,0,0,100
d710a267e155664865514679c585d039ec0c6567,11,975,78,897,3,0,3,16,129,129,2,6,2.228915586,4011,65,4,674,593,81,31008,27324,3684,304,272,32,97.87234043
de81b06a149cb263741ad80550ffb9386c0973a2,1,1,1,0,0,0,0,1,2,2,1,1,0,274,66,5,19,19,0,1349,1349,0,18,18,0,100
7b3d7750421d3b32540259c843795bceb954f4d1,2,100,2,98,0,0,0,1,7,74,2,2,0.861262188,647,65,9,63,56,7,4780,4200,580,40,37,3,99.98554496
28c36b75f4ed6b881c58ad436006d5273644abcc,4,37,6,31,0,0,0,9,74,124,1,2,1.636674556,2720,22,5,302,298,4,14597,14427,170,231,229,2,100
0761307e05b792409ceadd91352c23505b6f96bd,9,86,75,11,0,0,0,5,130,52,2,3,2.512846361,9983,23,6,991,990,1,71405,71292,113,564,563,1,100
cde9780e796832d7a3a69f8d7e139010cd3385db,5,66,8,58,0,0,0,5,18,95,2,4,2.258978749,1986,228,12,597,585,12,14506,14164,342,81,80,1,100
692f232d7360f96a4f4eb5868fa5e19f77191beb,1,1416,0,1416,1,0,1,1,1,0,1,1,0,0,229,13,75,0,75,10210,0,10210,52,0,52,98.00796813
6a91447f4a337437b8c5bdc331e02c174ff972f6,2,50,1,49,0,0,0,2,6,603,2,2,0.139232999,478,230,14,84,80,4,4422,4002,420,30,29,1,100
e4c190b4e4deccc55b02cc2044354ad3fd9b9f0d,2,33,1,32,0,0,0,1,9,33,2,2,0.873981048,1202,67,5,255,251,4,8397,8308,89,65,64,1,100
57666a6886096918883b9c88bb5453c29f987d52,1,1,1,0,0,0,0,13,64,32,1,1,0,757,68,6,135,135,0,5603,5603,0,13,13,0,100
bd13f07cecbef85a2573d01ea4e3589bbfa4c671,2,7,2,5,0,0,0,4,18,228,2,2,0.99107606,2567,66,10,290,289,1,12086,12062,24,140,140,0,100
ac8d182e24e428b7ebb063cc8dd8b9bf8f0091a5,0,0,0,0,0,0,0,0,0,0,0,0,0,0,317,5,0,0,0,0,0,0,0,0,0,100
a807bfa787e4ac10ca841e5f6a10b1b63ba717c4,3,49,12,37,0,0,0,3,76,53,2,2,1.175117287,5292,69,7,565,562,3,34564,34392,172,353,352,1,100
ff21652dc80f432cd44fb3dabe019b2feb2d0481,4,16,43,27,0,0,0,4,22,83,2,3,1.063106265,2067,70,8,317,322,5,14757,14971,214,100,100,0,100
13352973f3b2b2fb2ae41642f6234c9a455f5740,2,30,11,19,0,0,0,4,13,147,1,1,0.281193796,696,67,8,161,157,4,5039,4894,145,69,69,0,100
91ef1407a68a5046421fa5a39c1da4956c3b3ef4,2,43,6,37,0,0,0,6,50,98,2,2,0.963335546,1593,231,9,177,175,2,11776,11539,237,96,95,1,99.78960024
fe3c18483c0ce87f921260e8281849c4cd35b4e3,1,1,1,0,0,0,0,1,9,26,1,1,0,390,68,9,97,97,0,2995,2995,0,19,19,0,100
0a431fadcdd442748de91257c45fc77b06bf203e,2,67,1,66,0,0,0,4,17,48,2,2,0.602430802,2027,69,10,187,181,6,8444,8119,325,137,135,2,99.95504271
43d6a10ed807c83d04d9f5a94a431a675ace85a7,5,410,71,339,0,0,0,5,41,254,2,4,1.556726972,1452,70,11,236,196,40,11428,9778,1650,102,88,14,99.97003296
9b7e00e77eb2e82521b212c492ae95fd308cc5bf,2,25,0,25,0,0,0,4,18,9,2,2,0.40217919,2168,71,9,216,214,2,9441,9365,76,128,127,1,100
0036c56f487b6c61b73e394a61c5a930c59d5371,0,0,0,0,0,0,0,0,0,0,0,0,0,0,365,0,0,0,0,0,0,0,0,0,0,100
7a9f839f476f210dba76eedc88a1a8facf56ed31,0,0,0,0,0,0,0,0,0,0,0,0,0,0,366,1,0,0,0,0,0,0,0,0,0,100
d0deda47ecc0041551c16a6d755866f7308d2cdf,10,164,48,116,0,0,0,11,131,64,2,4,2.289201705,8874,71,6,1064,1051,13,69487,68757,730,505,497,8,100
c3943435043d162aaf64832dfe9eb462a338b099,0,0,0,0,0,0,0,0,0,0,0,0,0,0,232,7,0,0,0,0,0,0,0,0,0,100
85646f5ace2664dd0dbedcda0d935f12cefe2a78,1,2,2,0,0,0,0,4,11,84,1,1,0,307,233,8,86,86,0,2063,2063,0,33,33,0,100
1f3a90a4e409b7d2002596da481340e1ad3150bc,3,15,5,10,0,0,0,6,19,95,1,2,1.236160254,2229,72,7,167,166,1,9375,9302,73,145,144,1,99.91011236
873aad85575a564cff77dc70c3fedf1f131f2200,0,0,0,0,0,0,0,0,0,0,0,0,0,0,367,2,0,0,0,0,0,0,0,0,0,100
93a35b6beb8fe031a1faa74ac14fb6e4ac64a1ff,1,2,0,2,0,0,0,4,8,1233,1,1,0,674,234,3,169,169,0,5980,5966,14,14,14,0,100
4a518f24a63f42f620fa641ad8701e3133de52e3,2,62,4,58,0,0,0,7,14,122,2,2,0.997348798,1194,20,0,173,169,4,10064,9842,222,62,59,3,100
a3dd2416a0f40033093747b7a71aaebd06190add,0,0,0,0,0,0,0,0,0,0,0,0,0,0,235,3,0,0,0,0,0,0,0,0,0,100
0153a11086161ef348567345723c9698e3a196e4,0,0,0,0,0,0,0,0,0,0,0,0,0,0,318,0,0,0,0,0,0,0,0,0,0,100
3694d5fecac4bc8f16d400e43b0388148d3fa0d7,0,0,0,0,0,0,0,0,0,0,0,0,0,0,368,0,0,0,0,0,0,0,0,0,0,100
f85102bf5bf79ac29a0b9f4ab8c4582fe48bc154,0,0,0,0,0,0,0,0,0,0,0,0,0,0,369,1,0,0,0,0,0,0,0,0,0,100
eb0fc169b0ed7e4fc67c8a68201b14a9590ffec1,0,0,0,0,0,0,0,0,0,0,0,0,0,0,370,2,0,0,0,0,0,0,0,0,0,100
54ec4625cd2890bf640539cde1cdd3dd78411257,0,0,0,0,0,0,0,0,0,0,0,0,0,0,319,1,0,0,0,0,0,0,0,0,0,100
90918994dac5cd359c3ee17d0fdaad024d2a4ef0,1,16,5,11,0,0,0,3,8,356,1,1,0,188,236,1,32,31,1,1333,1227,106,9,9,0,99.77568416
4a2aa437206e58c788f1dbeca5ea19c9b249cee5,2,130,6,124,0,0,0,3,12,124,2,2,0.478250164,515,320,2,109,104,5,4665,3534,1131,43,42,1,100
a5c5cad901703b692449319581f9ca3e709fa841,1,1,1,0,0,0,0,7,13,44,1,1,0,649,321,3,55,55,0,5604,5602,2,28,28,0,100
4db78e1119a2806f8a67a64edae98e948428199e,0,0,0,0,0,0,0,0,0,0,0,0,0,0,322,4,0,0,0,0,0,0,0,0,0,100
e5502413efd91bc6610e8d39493cd2a0f6ce8aa1,5,21,15,6,0,0,0,4,132,156,2,4,1.733181268,2634,21,0,517,517,0,19236,19201,35,154,154,0,100
559024840a044f4eeb842892ed8b733b2d3841a0,1,1,1,0,0,0,0,14,66,6,1,1,0,757,73,0,135,135,0,5604,5604,0,13,13,0,100
764913131efbb4936844e6f4b8b60a34665489f7,2,2,2,0,0,0,0,12,42,53,1,2,1,1047,74,1,208,208,0,7278,7278,0,78,78,0,100
c66170d68de18a6595617c3751e6d8de941f971e,1,6,6,0,0,0,0,4,16,143,1,1,0,874,75,2,187,187,0,6662,6662,0,70,70,0,100
58ec1a9162c4ed7bffa2f4f23a87b7af77941067,2,68,4,64,0,0,0,5,11,128,2,2,0.581321499,730,22,1,102,100,2,7191,6790,401,29,27,2,100
08f2fec79eaf14b4f18e07a177808075acf6bbc1,4,73,5,68,0,0,0,6,19,125,2,4,1.504419313,811,76,3,96,87,9,5695,5380,315,34,32,2,99.66051661
9ea987c146c09d5ed9d72ffab517fb601269c5a0,3,39,16,23,0,0,0,6,133,286,2,3,1.468560299,1819,77,4,315,311,4,13010,12944,66,123,121,2,99.98540572
a31ea71fd7ad2980cfc1b375d4861febc8d9dda5,21,566,74,492,2,0,2,4,134,376,2,10,3.581147914,8875,78,4,1738,1667,71,69899,67335,2564,552,517,35,99.91249818
82339f46bef83884f33d001628e00e5bd4fff7fa,2,2,0,2,0,0,0,2,3,1894,1,2,1,296,237,0,24,23,1,2165,2145,20,5,5,0,100
cd5fdf719d044171df7f048c8180f7d04eec7e83,3,175,125,50,0,0,0,11,135,186,2,3,1.502793836,2278,23,0,399,410,11,16525,16543,18,168,165,3,100
eada31d188e72a63f7e97e76696d5f24b1e86fae,0,0,0,0,0,0,0,0,0,0,0,0,0,0,323,0,0,0,0,0,0,0,0,0,0,100
eb0403d8ff673921cad98e4a48165f4a9cf26169,4,168,166,2,0,0,0,1,4,432,1,2,1.228425987,1098,238,1,282,276,6,8371,7774,597,68,62,6,100
ee8b0a7d24dacd1ff444c7f3d5a969231800cd9d,2,99,9,90,0,0,0,2,5,408,1,2,0.984109528,611,239,2,117,105,12,4328,3704,624,37,36,1,100
3b96a004302fc8a76b95d77a4a14e8bc00baa6a0,1,25,5,20,0,0,0,2,4,1509,1,1,0,186,240,3,25,23,2,1345,1255,90,10,10,0,99.98542699
4dde9f09326521bb5c6a43fde0b51bf85a4e007a,1,176,0,176,1,0,1,1,1,0,1,1,0,0,241,4,12,0,12,933,0,933,5,0,5,99.95629371
d551a122a10e22c75de3e52cbe031425f38ef5ab,1,3,2,1,0,0,0,13,70,236,1,1,0,971,2,0,204,203,1,7467,7429,38,46,46,0,100
21cc0ccb8ad7667065925d3fc1156ebb4c8f08ca,7,515,124,391,1,0,1,5,99,310,2,6,1.907497439,4677,242,5,886,835,51,39036,36642,2394,256,234,22,99.86903376
0ba6307abeea9ced38bf2ea846b73c08f7020d18,1,5,7,2,0,0,0,8,25,996,1,1,0,447,79,1,117,118,1,2975,3022,47,33,33,0,100
9c02b07669d9a3399ea3bee3f86403123a2527d8,2,18,1,17,0,0,0,4,5,22,1,1,0.485460761,272,80,2,26,25,1,1519,1427,92,20,19,1,100
772635cee81acfe0c99f596ed8d5f9168cb5706f,0,0,0,0,0,0,0,0,0,0,0,0,0,0,81,3,0,0,0,0,0,0,0,0,0,100
21829674350387f2a4b2e93da7428047473dced0,2,177,14,163,1,0,1,1,17,34,2,2,0.999980227,574,24,1,136,118,18,5228,4483,745,44,34,10,99.95639535
89a1f5cc97fdda62f8d1163ad7f9007a94bf2e94,2,1,14,13,0,0,0,13,41,662,2,2,0.353359335,1878,25,2,220,222,2,17216,17325,109,59,59,0,99.97093868
17f35d1a5d0def4777a27706f792f449e8715a24,0,0,0,0,0,0,0,0,0,0,0,0,0,0,82,4,0,0,0,0,0,0,0,0,0,100
5da48fdaaf0fdc951150bb026fc8123b3ca15c07,1,3,4,1,0,0,0,8,21,380,1,1,0,236,83,5,30,30,0,1830,1861,31,10,10,0,100
ccc4774af4e6722a56d41cf2d501a68e20e51b8b,1,10,6,4,0,0,0,7,9,83,1,1,0,141,84,6,29,29,0,717,727,10,18,17,1,100
512b53fb52453bf42124babf27c3e3f629e9f0c3,6,785,732,53,1,0,1,4,46,408,3,4,2.539087833,927,26,3,136,132,4,6238,6208,30,54,52,2,99.82573337
002cbd21ddbd445af0150e61bd713961ca1ff257,3,9,11,2,0,0,0,5,25,211,1,1,1.581290899,1190,243,6,67,67,0,7539,7564,25,50,50,0,100
403f58c2138ff90592ef0cbee42fd96cd929f5c9,3,86,22,64,0,0,0,6,51,224,2,3,1.132253769,1431,244,7,128,124,4,11001,10663,338,74,73,1,100
e23430ce3b3cc5ebc81f58a08d10d6fd40212861,30,2612,1351,1261,11,0,11,5,100,304,3,14,3.58669343,7110,245,8,1193,1064,129,56907,52052,4855,439,328,111,90.6696871
e302f65c25ebb49fbad7fbb8588663bce33a48af,2,17,8,9,0,0,0,16,51,202,1,1,0.904381458,1255,85,7,157,156,1,9216,9186,30,86,85,1,100
637fb18d4f7be3ce6144635b4fdc178c0477c9e2,1,2,1,1,0,0,0,6,10,224,1,1,0,189,246,9,49,48,1,1351,1345,6,6,6,0,100
f4211801bb8b05dbe9ed973ebcab408fdd75fd84,0,0,0,0,0,0,0,0,0,0,0,0,0,0,247,10,0,0,0,0,0,0,0,0,0,100
3f3a45097d3424c552a9f5cda703ad1ac9ee234f,3,85,0,85,1,0,1,10,101,72,2,2,0.912124267,3096,86,7,457,454,3,25343,24966,377,107,104,3,99.97236806
b48ce1f188d74c6502fcf322e713aafd9bf4795e,2,8,2,6,0,0,0,13,70,376,2,2,0.881290899,335,248,10,51,50,1,2678,2633,45,17,17,0,100
90e29ce725ac70a79fbd940ef695c76f2a001886,1,2,2,0,0,0,0,1,2,0,1,1,0,48,87,8,2,2,0,245,251,6,2,2,0,100
1e73a21771d8e9dd6f5578416041f2bcae2563fb,2,43,30,13,0,0,0,9,18,117,2,2,0.30642473,524,88,9,82,80,2,3746,3673,73,31,31,0,100
4e05577f97b69ac67b1e42de15908772b1498c46,3,0,0,0,3,0,3,6,37,6,2,2,0,0,249,11,0,0,0,0,0,0,0,0,0,99.91705834
3840f12a7ff945a933f25a2b64c26657604b171d,1,1,1,0,0,0,0,7,18,19,1,1,0,612,89,10,127,127,0,4747,4747,0,36,36,0,100
efe77055d7f84f8a54c937a179555d93372ce51f,7,181,86,95,0,0,0,7,47,188,2,3,2.502932757,5524,90,11,504,497,7,43871,42969,902,298,293,5,98.92852299
a1db8b891e80bc0ee6c049f6b7deeaf1bf27dd5d,2,139,0,139,1,0,1,1,19,17,2,2,0.908403365,914,91,12,209,196,13,7701,6978,723,84,78,6,99.93347525
0411ec74761caf0389dc46ea33b5ec33415db4c0,0,0,0,0,0,0,0,0,0,0,0,0,0,0,250,8,0,0,0,0,0,0,0,0,0,100
576b8a8b1d1373bf90c57c2daabf788dd299537f,1,33,0,33,1,0,1,1,1,0,1,1,0,0,251,9,1,0,1,64,0,64,1,0,1,99.97337593
a20056ddaaadf52f10d0858ef1316e2e69b5b28c,0,0,0,0,0,0,0,0,0,0,0,0,0,0,27,3,0,0,0,0,0,0,0,0,0,100
2f15399e3f76b762bd861a26b3ce3d3aa481397f,1,1,1,0,0,0,0,2,2,328,1,1,0,43,252,6,5,5,0,165,160,5,5,5,0,100
a2e3e7c039364116b6dbb410f7eed366dff22f1a,0,0,0,0,0,0,0,0,0,0,0,0,0,0,253,7,0,0,0,0,0,0,0,0,0,100
598dbd0ce9217d5bc8816ee518a370b854095e85,0,0,0,0,0,0,0,0,0,0,0,0,0,0,28,1,0,0,0,0,0,0,0,0,0,100
6c286691a66e87ae659aa1e4d6c9c2a3b98a32e7,0,0,0,0,0,0,0,0,0,0,0,0,0,0,371,0,0,0,0,0,0,0,0,0,0,100
a5a19af7d31d04e9923b8dce5d5cf68db697799a,3,102,46,56,0,0,0,5,6,324,3,3,1.427217949,706,92,3,133,120,13,5468,5276,192,77,72,5,99.98668442
a6ab754d28d18b243bc290a632d4d65b3d5a90a5,2,37,2,35,0,0,0,5,29,196,2,2,0.858230793,2017,254,4,209,205,4,19695,19449,246,108,107,1,100
9ecdc3f401935e79fe608411189f2dd39679c496,2,14,0,14,0,0,0,10,78,126,2,2,0.371232327,2728,255,5,415,413,2,16060,15999,61,240,239,1,100
bccd75b796da20fdfabb703e38a8e1a0ec9f0dd4,21,63,309,246,0,0,0,2,4,973,2,2,3.988571222,1258,29,2,120,178,58,5877,7101,1224,38,56,18,99.60127592
04c1e2c12dedd1566e7b83273f37fafb74de3078,0,0,0,0,0,0,0,0,0,0,0,0,0,0,93,3,0,0,0,0,0,0,0,0,0,100
ecb6ea72c25c126e725c89b0873d7064c9779a19,4,217,16,201,1,0,1,1,21,138,2,3,0.961798037,1712,256,6,351,341,10,12833,11906,927,122,112,10,99.97348184
e87ba2c789f24196d215c1ab9f005bf178f1a52b,1,13,12,1,0,0,0,15,43,65,1,1,0,1010,94,2,85,73,12,7199,6531,668,63,57,6,100
a885dde1dd926430ab69a77a35fe50a3e27656ce,0,0,0,0,0,0,0,0,0,0,0,0,0,0,95,3,0,0,0,0,0,0,0,0,0,100
a6fb859a01438a1a11f6bf0856e316350955b174,0,0,0,0,0,0,0,0,0,0,0,0,0,0,257,5,0,0,0,0,0,0,0,0,0,100
17ed90e7f4f0392f27145b77e4158605ab220115,5,82,19,63,0,0,0,16,71,250,2,4,0.707501917,1419,96,4,256,249,7,11388,11111,277,115,113,2,100
5171236d3521bd789e8c788933e5f27100f0b0e4,2,120,14,106,0,0,0,7,19,107,2,2,0.920763335,1261,30,2,189,182,7,10987,10351,636,66,64,2,100
e41fd1ea0ed4f81424f20b22f2605ac30db033ca,4,129,11,118,3,0,3,1,2,312,2,2,1.970911418,151,31,3,37,32,5,1436,1142,294,9,6,3,99.86763733
916278b289f5d977cda24c2372ebb052b9360266,1,1,1,0,0,0,0,5,13,529,1,1,0,305,324,0,69,69,0,1842,1842,0,26,26,0,100
61e8c3207edb0b8ff1fc8cb8179122ba75164b2f,2,15,0,15,0,0,0,4,16,347,1,1,0.996791632,381,325,1,47,45,2,1644,1594,50,36,34,2,99.98677948
d2d8749f7887ed1ab35a219740f68e2945d8cf74,3,126,6,120,0,0,0,2,5,102,1,2,1.181228449,939,326,2,231,224,7,7113,6572,541,54,49,5,99.92072929
fc8bba8e0c0ac888e6ddf4329d780411649b8246,1,21,2,19,0,0,0,2,4,587,1,1,0,300,327,3,113,110,3,1943,1856,87,17,16,1,100
ea1853b4e8cf2fee065c90c6c4444f8a26f9ba58,0,0,0,0,0,0,0,0,0,0,0,0,0,0,328,4,0,0,0,0,0,0,0,0,0,100
031b102c511c70c6d54ad9ada19555b3d26968d0,0,0,0,0,0,0,0,0,0,0,0,0,0,0,329,5,0,0,0,0,0,0,0,0,0,100
b7d689c9b9b49438a4da144e413a1c007a89bae9,0,0,0,0,0,0,0,0,0,0,0,0,0,0,258,4,0,0,0,0,0,0,0,0,0,100
b3b27e7822ad8f560a9813c44d33802c43757994,0,0,0,0,0,0,0,0,0,0,0,0,0,0,259,5,0,0,0,0,0,0,0,0,0,100
359fbb7131da206177a7e01a78685dde95ec551b,38,1210,98,1112,1,0,1,6,71,618,3,19,3.870887634,18107,260,6,3614,3389,225,141430,133790,7640,962,927,35,99.94720866
9b6a8e6313752dd7e20f1e5d2a043b3c51700989,0,0,0,0,0,0,0,0,0,0,0,0,0,0,330,6,0,0,0,0,0,0,0,0,0,100
73305065255083ab5a1b2026ea119ae2d06eb06a,0,0,0,0,0,0,0,0,0,0,0,0,0,0,23,0,0,0,0,0,0,0,0,0,0,100
e18428dc6488ea7b5e71afefc6ae0efcce12582e,2,42,8,34,0,0,0,6,52,185,2,2,0.970950594,1652,261,5,180,178,2,12158,11982,176,98,97,1,100
bad6a95f7349ca84c6a4e640b00936d34158dd61,2,2,3,1,0,0,0,3,22,233,1,1,0.970950594,1000,97,3,207,207,0,7448,7462,14,83,83,0,100
c001f375467a1c86e811b22541b7752f1b58b32e,0,0,0,0,0,0,0,0,0,0,0,0,0,0,24,1,0,0,0,0,0,0,0,0,0,100
6ece513241afb4cc8301fe3c048577f4e4f8474e,0,0,0,0,0,0,0,0,0,0,0,0,0,0,262,5,0,0,0,0,0,0,0,0,0,100
2e4658ccfa22be14c8961da21a59fa88cba4888e,2,88,29,59,0,0,0,7,21,22,2,2,0.900244872,1338,32,2,192,190,2,11215,11003,212,69,66,3,100
e60f17344b292b53bd1787ad79daddcf01dd65cc,0,0,0,0,0,0,0,0,0,0,0,0,0,0,331,7,0,0,0,0,0,0,0,0,0,100
ffde5b94e0ded05168d597641dd001f6b9493502,2,62,22,40,0,0,0,6,102,59,2,2,0.979868757,3475,263,5,484,483,1,27909,27755,154,125,124,1,100
9f875907732ad532227dd1a7db9b74ccf46d5ce0,0,0,0,0,0,0,0,0,0,0,0,0,0,0,264,6,0,0,0,0,0,0,0,0,0,67.72432617
a2d65315c099507b9c7f47d56f1dd48c2c1b0a7a,0,0,0,0,0,0,0,0,0,0,0,0,0,0,332,8,0,0,0,0,0,0,0,0,0,67.72432617
7090ad427a11eec158aeb1a32133acf6e94634e1,2,42,3,39,0,0,0,3,5,325,1,2,0.918295834,374,33,2,42,38,4,2429,2210,219,23,21,2,100
67f8dff0346152e3f839f2d4a3374e8a88771f92,2,32,1,31,0,0,0,14,42,359,2,2,0.98337619,1912,25,2,228,226,2,17848,17581,267,60,60,0,100
f151ad8bd329a7ad5687e48fe804b0d09777622d,0,0,0,0,0,0,0,0,0,0,0,0,0,0,333,5,0,0,0,0,0,0,0,0,0,100
ebad2fac88c0d73cf3df8ec7c8a87c08481241c8,1,27,1,26,0,0,0,13,68,126,1,1,0,461,265,7,80,73,7,3554,3417,137,15,12,3,100
df4db808ab53ff93c961f8fb67c2d329ddbcd333,2,176,0,176,2,0,2,1,1,0,2,2,0.930986542,0,34,2,10,0,10,828,0,828,6,0,6,99.93408042
2216a36ef370ac4d4c8fef5fde352868da758066,0,0,0,0,0,0,0,0,0,0,0,0,0,0,35,3,0,0,0,0,0,0,0,0,0,100
87bb938d0b41085083e1016d82d050caa4773d80,1,4,3,1,0,0,0,14,67,209,1,1,0,757,266,6,135,135,0,5613,5604,9,13,13,0,100
feb2fae4ae5ad1464d7d5393a981b36b24a696ab,0,0,0,0,0,0,0,0,0,0,0,0,0,0,334,4,0,0,0,0,0,0,0,0,0,100
25ff6b5e75f0b28362ba635104bd3292102d2029,0,0,0,0,0,0,0,0,0,0,0,0,0,0,335,5,0,0,0,0,0,0,0,0,0,100
0c3585c72f096678451e5e79ee5b1119e262d0e1,1,63,16,47,0,0,0,1,2,157,1,1,0,166,267,5,40,30,10,1403,1106,297,14,12,2,100
c7f465cc584f6618d32d52b4a29985b1fb61450a,1,22,10,12,0,0,0,7,22,38,1,1,0,633,36,4,131,129,2,4878,4821,57,40,38,2,100
4357662bde0a39e92b1bc0d46179bf5e5f35aa27,1,0,1,1,0,0,0,8,22,683,1,1,0,195,98,0,27,27,0,1297,1304,7,6,6,0,100
9e14f81c5c1eef657774722ee84bfe25cd8b70e9,0,0,0,0,0,0,0,0,0,0,0,0,0,0,268,5,0,0,0,0,0,0,0,0,0,100
09777694ed558c1eabd8ee3dd0800b45acee7444,0,0,0,0,0,0,0,0,0,0,0,0,0,0,269,6,0,0,0,0,0,0,0,0,0,100
f255f5def4d746710b81fd1cf2897c52c879b28a,0,0,0,0,0,0,0,0,0,0,0,0,0,0,270,5,0,0,0,0,0,0,0,0,0,100
9b1ee4d512d0b6ef51d36bc1f40e1f5338ef58f3,0,0,0,0,0,0,0,0,0,0,0,0,0,0,271,6,0,0,0,0,0,0,0,0,0,100
017704c34e6698358240091970bad2233bc596aa,0,0,0,0,0,0,0,0,0,0,0,0,0,0,0,0,0,0,0,0,0,0,0,0,0,100
033ed34f2dd0c85984b84d1d12371279e7563e7f,0,0,0,0,0,0,0,0,0,0,0,0,0,0,272,7,0,0,0,0,0,0,0,0,0,100
e148405d0007566aa31d49e9ec55b8bde785a063,0,0,0,0,0,0,0,0,0,0,0,0,0,0,1,1,0,0,0,0,0,0,0,0,0,100
17964708e0fc6adbc927dde2f7c2b7617fbdb2ac,2,2,0,2,0,0,0,3,9,268,2,2,1,729,336,2,63,63,0,4798,4789,9,40,40,0,100
b2b5df7f0f22cf272b3879e7a664630331396178,23,1404,210,1194,5,0,5,9,69,561,2,9,3.197378905,7325,99,1,1558,1426,132,57825,52630,5195,628,559,69,96.83867309
689ecec173dbd4977799c9f4f763cb5d2419f717,0,0,0,0,0,0,0,0,0,0,0,0,0,0,273,6,0,0,0,0,0,0,0,0,0,100
ec0795170bac2ef7d28e5af5d7cfdad981b1b9b0,1,0,0,0,1,0,1,5,11,180,1,1,0,0,274,7,0,0,0,0,0,0,0,0,0,99.96930632
5c8dcaed33fcf853f41cb2e7429535f49fd9aa20,0,0,0,0,0,0,0,0,0,0,0,0,0,0,275,5,0,0,0,0,0,0,0,0,0,100
c94b5566180e37b8fd961cd0f394af9a8d3d403c,2,19,12,7,0,0,0,3,23,662,1,2,0.962900415,841,276,6,162,159,3,6430,6393,37,48,48,0,100
2b176012329142ba382ac8108a34ea4e33011976,2,28,12,16,0,0,0,4,23,225,2,1,0.909736123,1229,277,7,237,234,3,9072,8962,110,108,107,1,100
0a1ad3e39f09fbf06fd833fb06669f209be32667,1,46,0,46,0,0,0,4,17,123,1,1,0,291,278,7,38,34,4,1160,1040,120,34,30,4,100
88c63816695611e56747c2788fba609441a9cff5,6,390,248,142,2,0,2,10,103,64,2,2,1.82504135,4847,279,8,616,615,1,39285,38297,988,180,179,1,99.93863148
6fada1d81d7efe03fb42ce8e3ce1528e81a3d953,0,0,0,0,0,0,0,0,0,0,0,0,0,0,280,8,0,0,0,0,0,0,0,0,0,100
141d9130e0500dd59c6cbed5f49f0b6f2d3a6659,0,0,0,0,0,0,0,0,0,0,0,0,0,0,281,9,0,0,0,0,0,0,0,0,0,100
a136ce1e8c044c8fb0c04cb7755ac0a9a6d6f221,6,61,10,51,0,0,0,1,136,275,2,3,1.806339196,4015,100,1,565,562,3,29624,29329,295,270,268,2,100
437da7fb6eecf9e2dd76f25873f72b4b2c036415,9,122,9,113,0,0,0,6,72,585,2,4,2.277868019,3269,282,9,592,576,16,24234,23575,659,238,232,6,100
0017948127f00d5a3ee05c498899e79296fc9964,0,0,0,0,0,0,0,0,0,0,0,0,0,0,283,10,0,0,0,0,0,0,0,0,0,100
58011ace563c2927fc798f23cbdfb6130ba3d8f3,0,0,0,0,0,0,0,0,0,0,0,0,0,0,284,11,0,0,0,0,0,0,0,0,0,100
7542227faf4120409c7c5cc5f783b30b487dc86b,0,0,0,0,0,0,0,0,0,0,0,0,0,0,285,12,0,0,0,0,0,0,0,0,0,100
118fc6b52cee1016ae71848a6118ad93cdadac64,1,1,1,0,0,0,0,2,2,36,1,1,0,217,286,13,27,27,0,1559,1559,0,19,19,0,100
3af598aed268b4afe8ff62a6155366e786f01aef,0,0,0,0,0,0,0,0,0,0,0,0,0,0,287,14,0,0,0,0,0,0,0,0,0,100
85a1bbc13ccae48778d585bf8c21ec492567f7a5,0,0,0,0,0,0,0,0,0,0,0,0,0,0,288,15,0,0,0,0,0,0,0,0,0,100
d23d1c14f7b9a74cb83bc3439d6a71f979eb4dbd,0,0,0,0,0,0,0,0,0,0,0,0,0,0,289,15,0,0,0,0,0,0,0,0,0,100
cd05d5ea4acb01eee7cb3593496533e623657938,1,1,0,1,0,0,0,16,48,402,1,1,0,930,372,0,181,181,0,5678,5669,9,56,56,0,100
4e3d324d566bc38ff6f891984b869395648c75c5,0,0,0,0,0,0,0,0,0,0,0,0,0,0,290,15,0,0,0,0,0,0,0,0,0,100
92bc1ca8656cb034c6a42596695259869e25d6b3,0,0,0,0,0,0,0,0,0,0,0,0,0,0,337,0,0,0,0,0,0,0,0,0,0,100
336b729901d8e5dff2e2369c1199bb7b40bc2f4b,1,22,2,20,0,0,0,5,10,458,1,1,0,129,101,1,9,7,2,872,771,101,5,4,1,100
ec4bdcff427e398dc945d31336b3b39a3b3d078d,10,1402,17,1385,2,0,2,3,104,290,3,8,1.188569795,5765,291,11,1199,1050,149,51291,44703,6588,381,319,62,93.6615566
87656036c25b30061fd78a285b4647d5b4c55a0a,2,81,31,50,0,0,0,6,31,158,2,2,0.543564443,3212,102,2,622,616,6,25126,24856,270,65,64,1,100
ef397c0036c001390d51b1692d4fde041ba789e0,3,57,9,48,0,0,0,6,69,282,2,3,1.299750173,2214,103,2,595,593,2,16783,16547,236,54,53,1,100
aa17bcb68c13ea1085f5053962a7b2219798b42f,1,1,0,1,0,0,0,5,7,45,1,1,0,158,104,3,27,27,0,983,969,14,9,9,0,100
b6167116158fb41dad9c76777e510d3b1721306f,1,16,0,16,0,0,0,5,11,17,1,1,0,147,105,4,11,9,2,952,872,80,6,5,1,100
06827befaaee73207dc47db79840e53961c4ea18,2,46,6,40,0,0,0,14,43,299,2,2,0.811278124,1925,106,5,234,230,4,17904,17627,277,62,60,2,100
f1018adf2c65f4170033c3a0d7b7d348393e9bbf,1,34,0,34,0,0,0,3,9,260,1,1,0,202,292,2,38,33,5,1407,1243,164,12,11,1,100
b186894d4d2f2f0d4ae3aa3396d82cc646205ad0,1,4,1,3,0,0,0,3,10,9,1,1,0,226,293,3,38,38,0,1447,1407,40,12,12,0,100
4336bb13f118f4f66240bd1a67c8e700c73f974f,0,0,0,0,0,0,0,0,0,0,0,0,0,0,2,0,0,0,0,0,0,0,0,0,0,100
ef3abb5a5a9de231a1583f59cabc7ad59fd4c3f4,1,8,0,8,0,0,0,4,18,96,1,1,0,333,294,2,39,38,1,1181,1160,21,35,34,1,100
f7d44cf7553be37dfa4f1be5999b279cc05ba4a4,1,1,6,5,0,0,0,10,79,246,1,1,0,1783,295,3,211,212,1,8746,8765,19,161,161,0,100
4fd9b35aa04abcaf4c996c09b99a4635642effbe,2,10,7,3,0,0,0,2,73,631,1,2,0.787126586,1034,296,4,219,218,1,7736,7724,12,50,50,0,100
eb3637cc56e48fdf45e5c1e07c6ec012e36544e0,0,0,0,0,0,0,0,0,0,0,0,0,0,0,373,0,0,0,0,0,0,0,0,0,0,100
fe68adbb5368682785d21b35d7e59a8928a46740,0,0,0,0,0,0,0,0,0,0,0,0,0,0,374,1,0,0,0,0,0,0,0,0,0,100
b59d0dabd3eadbda1ea00544f7a295b046979ba0,4,91,0,91,1,0,1,16,72,242,2,3,1.162432269,1190,297,3,199,191,8,10027,9602,425,93,90,3,99.97162316
b53556016447dbe94d4743f4e6a4b4bd559c0f05,3,49,3,46,0,0,0,6,9,487,2,3,1.17889905,1319,298,4,299,293,6,10347,10083,264,64,61,3,97.25843301
f7f49928172d123de243bc0fed55cb3648907943,0,0,0,0,0,0,0,0,0,0,0,0,0,0,3,1,0,0,0,0,0,0,0,0,0,100
1c9032093dceeb68f19aee28867ca1d070ac6661,28,381,669,288,0,0,0,16,74,474,3,11,3.014711266,11778,299,5,1201,1234,33,92245,92263,18,561,622,61,99.70633299
15d5225518d36a0fef483fd77e80c70c6c41e239,5,94,1,93,1,0,1,1,30,452,2,4,1.802467348,1139,300,6,214,206,8,8411,7978,433,104,98,6,100
d8c08df61de3d4089eeff95c25a39a9b0c3fb65b,0,0,0,0,0,0,0,0,0,0,0,0,0,0,301,7,0,0,0,0,0,0,0,0,0,100
4be7050cc130d78d505b23e3767e0b195a55156e,8,106,55,51,1,0,1,6,8,0,3,4,2.366064035,1528,302,8,192,187,5,10355,10145,210,96,94,2,99.96171516
ae9101daffebf5ee90a89458df56dfa51bb381ca,4,748,0,748,4,0,4,1,1,0,2,2,1.915747545,0,338,0,71,0,71,3608,0,3608,43,0,43,99.63411557
a4e7d1394aa589ec34810efb9ff8824f095ec017,2,12,2,10,0,0,0,3,70,938,1,2,0.591672779,880,375,2,155,153,2,6407,6313,94,18,18,0,100
8ec3f8955bb150c56d2631489412565f60bdf45b,2,4,4,0,0,0,0,2,2,8,1,1,1,229,303,9,37,37,0,1330,1330,0,27,27,0,100
0b42d1bd9c265c574edca801df1ff9bfb5236eb1,5,71,1,70,0,0,0,1,12,603,2,3,0.969738394,1074,304,10,159,149,10,7674,7225,449,90,82,8,100
00bfe5072bc4f40759ba6963285a882158814484,2,69,9,60,0,0,0,1,19,488,2,2,0.779349837,377,305,11,48,41,7,3287,3002,285,26,19,7,100
f2f42b492833495a5936af885a3d3e5eed135612,3,54,17,37,0,0,0,4,71,165,1,3,1.366793182,1453,306,12,275,266,9,10297,10064,233,83,78,5,100
627a5f1ab6abac226215bdd08ee28636c77a3771,1,1,2,1,0,0,0,1,6,3,1,1,0,267,307,13,22,22,0,2081,2099,18,22,22,0,100
1196fbc3bad56a83be356415f11052f8db4875fc,0,0,0,0,0,0,0,0,0,0,0,0,0,0,339,1,0,0,0,0,0,0,0,0,0,100
6c6c78d37631b18a5f50292db6d95cc32d40a3f6,5,33,22,11,0,0,0,1,31,124,2,5,2.03014397,1060,308,14,217,216,1,7215,7182,33,93,93,0,100
fa97869b182bad71a27167fd90868817159adc01,6,796,2,794,3,0,3,16,56,377,2,3,1.781164403,1027,309,14,273,182,91,11847,7869,3978,116,84,32,94.83449012
09ea8a5984f5787eda041733d1993213b98bfe0b,0,0,0,0,0,0,0,0,0,0,0,0,0,0,310,13,0,0,0,0,0,0,0,0,0,100
21799bb27ba4876ab90113ce8f425b496af3df05,0,0,0,0,0,0,0,0,0,0,0,0,0,0,311,14,0,0,0,0,0,0,0,0,0,100
dd14439c48fb55eb3b8a6fe06b50238ec95af19d,2,87,13,74,0,0,0,6,7,317,2,2,0.893173458,559,312,15,69,65,4,4650,3980,670,27,24,3,100
ff796b2739fcceb66825967eec6ca2cde83ae1e0,3,173,6,167,2,0,2,1,20,5,2,3,1.303556367,148,37,0,45,34,11,1642,927,715,28,19,9,99.92833596
afb78d7ead94bcb3e30eb39142b7e7705d9728d7,1,1,4,3,0,0,0,2,2,1530,1,1,0,292,38,1,59,59,0,1875,1896,21,12,12,0,100
39ebaeb548c410cd0f417f4efa9aac6cce4887a6,1,39,0,39,0,0,0,3,3,309,1,1,0,48,376,1,11,9,2,584,280,304,3,1,2,100
c88ceff3c411a2ca3dd86d95f42974c16e2cb725,1,0,1,1,0,0,0,1,2,23,1,1,0,109,313,10,9,9,0,747,753,6,7,7,0,100
a98aeafc83000f8e60174897006885001494f04e,2,19,21,2,0,0,0,4,20,529,2,2,0.286396957,2187,314,11,217,216,1,9424,9423,1,128,128,0,100
297414e4455e0cb09eebe42f5f8fbd73bcf011d2,1,186,122,64,0,0,0,15,72,36,1,1,0,776,4,0,143,137,6,5947,5769,178,21,14,7,100
1bfc46025e77f2b743d3bd3149e702891c2848ee,0,0,0,0,0,0,0,0,0,0,0,0,0,0,26,0,0,0,0,0,0,0,0,0,0,100
bedf2bba50efc5a86ed1cb788ef85ba4bfc9cb19,0,0,0,0,0,0,0,0,0,0,0,0,0,0,315,12,0,0,0,0,0,0,0,0,0,100
7a3219b0c725d1f5fb21f11ffb30aba6c4b95020,2,14,10,4,0,0,0,7,56,425,2,2,0.954434003,1813,39,2,340,340,0,14242,14192,50,83,82,1,99.98567746
5673ef1d4a87ef946c001dc38817759d988c672d,0,0,0,0,0,0,0,0,0,0,0,0,0,0,27,1,0,0,0,0,0,0,0,0,0,100
285d7162101135e96ff2245045fea9066059d502,0,0,0,0,0,0,0,0,0,0,0,0,0,0,340,0,0,0,0,0,0,0,0,0,0,100
43646c23b82e9080bbe3b643e1f3218918f46986,1,1,1,0,0,0,0,3,7,306,1,1,0,311,316,3,22,22,0,2633,2632,1,10,10,0,100
dd7d854d5b953152aaa9ef5583107922f8566aaf,1,14,6,8,0,0,0,2,3,1386,1,1,0,215,40,1,58,57,1,1728,1698,30,11,11,0,99.98567746
ef27d74c726891893f3959960b8dddf4ee48b625,1,2,1,1,0,0,0,5,16,63,1,1,0,149,317,4,29,28,1,974,968,6,7,7,0,100
ca8c5e42b8a3ce7f09fa8b83213d25de2f1708da,2,39,1,38,0,0,0,6,27,144,2,2,0.168660931,1228,318,3,185,184,1,9932,9594,338,89,88,1,100
95005bad446cf6cc36801802c641743c7d0fb6dd,1,8,8,0,0,0,0,17,137,204,1,1,0,1031,319,3,209,209,0,7379,7379,0,85,85,0,100
8a142dd8b6d2197932842ab5dc82e08bfcca7153,0,0,0,0,0,0,0,0,0,0,0,0,0,0,320,4,0,0,0,0,0,0,0,0,0,100
c5bc58a9362d400ae1151051671fb62af69970e7,2,2,0,2,0,0,0,2,2,1749,1,1,1,237,321,5,54,54,0,1381,1365,16,12,12,0,100
5b16815531431123a4cb939b8319fef9b774d837,0,0,0,0,0,0,0,0,0,0,0,0,0,0,322,6,0,0,0,0,0,0,0,0,0,100
9aabd963336cfa77bfa42c25afeba19dc385e26c,2,6,2,4,0,0,0,4,4,1021,1,2,1,309,323,7,53,53,0,2015,1947,68,16,16,0,100
fc9b63662d10fcf1a6c63d9b1a55cbf65ce3337a,3,7,3,4,0,0,0,9,20,876,1,3,1.370950594,786,324,8,135,134,1,5335,5295,40,40,40,0,100
566648fd703792eccaa7b5910009b1eb998cedab,1,2,1,1,0,0,0,1,4,104,1,1,0,111,325,9,13,13,0,785,764,21,8,8,0,100
1dee3633fc47cf2a6819b0360685f4d5031ae05b,2,59,6,53,0,0,0,7,48,259,2,2,0.805125007,822,326,10,111,106,5,6277,5969,308,47,46,1,100
0364214788c60bc6c0a24358007ad882662425f2,0,0,0,0,0,0,0,0,0,0,0,0,0,0,327,11,0,0,0,0,0,0,0,0,0,100
f13f70d21a655cbcf82ec4e658be324364434819,1,1,0,1,0,0,0,13,74,108,1,1,0,284,328,12,47,47,0,2174,2167,7,13,13,0,100
e75787222986952643d4aea75c3cf3df0c052ee3,22,1140,2616,1476,6,0,6,7,18,1123,1,1,4.413458413,2680,41,0,235,500,265,6830,16447,9617,102,190,88,91.61873459
ce985cb2a4bc6bdeb20a26d30446b28244ebc4ae,2,30,2,28,0,0,0,14,44,271,2,2,0.543564443,2221,107,0,281,278,3,19832,19658,174,99,98,1,100
32627977f398f3dcdf396dc48ccf3c929563ca68,1,12,0,12,0,0,0,5,5,672,1,1,0,119,341,0,23,19,4,771,689,82,4,3,1,100
727e37fcab3dd7b255c4e6d629a1829ab7ebdd5c,3,65,16,49,0,0,0,11,73,754,2,3,1.461827895,1580,108,1,225,223,2,12000,11692,308,60,58,2,100
05d010349e64ca86851b4b25901d0fc4ae12c001,1,27,1,26,0,0,0,7,19,72,1,1,0,629,42,1,37,35,2,6648,6533,115,26,25,1,100
f7e8c6c13494f9fb71ff4e2d57190512746cc954,1,1,1,0,0,0,0,2,2,104,1,1,0,92,329,8,9,9,0,551,551,0,9,9,0,100
3f1aea78669df20ed49beb0ccedca665b10391c5,3,76,2,74,0,0,0,4,138,323,2,3,0.405760164,1645,330,8,244,242,2,11576,11205,371,111,109,2,100
11fc0670203bd850deff0496a8bcb01469bcc405,0,0,0,0,0,0,0,0,0,0,0,0,0,0,5,0,0,0,0,0,0,0,0,0,0,100
be236b0add3c037649380b03cfe61aff4c5949c2,6,559,607,48,0,0,0,6,31,1256,1,1,1.400640725,2537,43,2,189,194,5,23818,24048,230,113,118,5,91.65977392
fbda850df01ac0cb0fd39740afe30bff3db970dd,5,12,8,4,0,0,0,7,13,0,1,1,2.170950594,923,331,2,87,87,0,7923,7906,17,32,32,0,99.79627474
7593c2a998366b5025abadf232bfe0f12641a44c,0,0,0,0,0,0,0,0,0,0,0,0,0,0,6,1,0,0,0,0,0,0,0,0,0,100
d827d57f613f8a7ee16405f2f8b6179d383bb783,2,8,1,7,0,0,0,6,13,2,1,1,0.764204507,358,332,3,35,34,1,2947,2923,24,12,11,1,100
99d5c76828deaaf69039a2eecd45c8cadeab8376,1,3,11,8,0,0,0,7,32,514,1,1,0,587,333,4,124,125,1,3912,3937,25,50,50,0,100
8135792f7894750333e090a21a9c8485ea8ae13c,18,244,188,56,0,0,0,16,71,431,3,7,3.170556376,6908,334,5,726,694,32,50308,49891,417,372,365,7,96.40364188
10ba8e9dc6684ef5d0c122f754a19d0fdc2ea45e,0,0,0,0,0,0,0,0,0,0,0,0,0,0,335,6,0,0,0,0,0,0,0,0,0,100
a1e576122e141ef2bc9119f1902d261b01c311bd,0,0,0,0,0,0,0,0,0,0,0,0,0,0,7,2,0,0,0,0,0,0,0,0,0,100
3092d36872df6cc0ec753aaac151853310197f7e,1,10,3,7,0,0,0,6,29,14,1,1,0,792,336,6,72,71,1,6534,6526,8,40,40,0,100
3da187e333143e35af1ec0e931157f0b40c91781,10,617,0,617,10,0,10,1,1,0,1,2,3.306846302,0,337,7,46,0,46,2523,0,2523,16,0,16,97.63589821
3da334ee1f2bf0b8cbebe623dfe0268adf9733a4,2,22,26,4,0,0,0,6,9,84,2,2,0.543564443,616,44,1,70,69,1,4636,4644,8,28,27,1,100
dc10aaccf36ffa689a7b5122a40db150a13df11a,1,18,0,18,0,0,0,6,10,184,1,1,0,655,338,8,43,42,1,5024,4903,121,19,18,1,100
b05db3d869334d7898bf842393dc7f447b9252bd,3,137,5,132,2,0,2,1,4,682,2,3,1.315536825,38,339,9,13,6,7,578,120,458,9,5,4,99.95690893
b5dd3b3b8a6b992c34b561b440257bbd1b840d9f,1,1,1,0,0,0,0,4,5,1,1,1,0,44,340,9,7,7,0,150,150,0,5,5,0,100
0931452f38cf47092de0e6cb60e0dc093e7a0274,0,0,0,0,0,0,0,0,0,0,0,0,0,0,342,0,0,0,0,0,0,0,0,0,0,100
332be9414d03a75e8ed5ffa20a4b5b9426fb25ad,0,0,0,0,0,0,0,0,0,0,0,0,0,0,341,10,0,0,0,0,0,0,0,0,0,100
12bd75bd3e851b717644407bbe1d82b036799bce,1,1,1,0,0,0,0,6,18,687,1,1,0,185,342,11,39,39,0,1403,1401,2,11,11,0,100
8becce1fe1b84b53e58d469d23b3978e9fef8e25,4,107,2,105,0,0,0,2,26,604,2,4,1.077664824,2269,109,0,514,502,12,17714,16795,919,154,145,9,100
db7b97a567b395393e3bb932ff0a6f56e63b934f,0,0,0,0,0,0,0,0,0,0,0,0,0,0,343,12,0,0,0,0,0,0,0,0,0,100
33950228b3d8a854e924d42dd857b2bcdaa0239f,2,19,3,16,0,0,0,16,58,801,1,1,0.902393283,1034,344,13,169,164,5,8285,8218,67,85,84,1,100
96ef8689a5fb94b6497130a916b48d55a03c3851,0,0,0,0,0,0,0,0,0,0,0,0,0,0,345,14,0,0,0,0,0,0,0,0,0,100
c64e566b9ed05e35cd7ce6d77038df522772c1b0,0,0,0,0,0,0,0,0,0,0,0,0,0,0,346,15,0,0,0,0,0,0,0,0,0,100
5d0ed461db76eb8943d7ffdaa15816e971b35df4,8,95,77,18,0,0,0,1,6,577,2,5,1.707224503,1707,347,16,226,223,3,11910,11784,126,112,111,1,100
67d890957db4d9a6a1c5c52bb2246ce0b7ffea8d,0,0,0,0,0,0,0,0,0,0,0,0,0,0,348,17,0,0,0,0,0,0,0,0,0,100
daa941ff39b21b27d469b2c14b0cee4e5027beff,1,1,3,2,0,0,0,3,3,1561,1,1,0,336,8,1,60,60,0,2386,2399,13,20,20,0,100
de4dbef9ed4bb1415f497d5c6bb32ecde0aee890,0,0,0,0,0,0,0,0,0,0,0,0,0,0,349,17,0,0,0,0,0,0,0,0,0,100
979cebc8426165c5f57c404c483d9f6183fa711e,0,0,0,0,0,0,0,0,0,0,0,0,0,0,9,2,0,0,0,0,0,0,0,0,0,100
f1964e5214062fa94a8fc032ff19377f7d1ea505,3,129,0,129,1,0,1,4,14,262,2,2,1.292303219,498,350,17,72,58,14,3447,2871,576,53,41,12,98.45339278
78ef8809f4fdf9cdc666e1f2850d4c2df9620495,1,17,17,0,0,0,0,2,3,449,1,1,0,153,45,1,32,32,0,1156,1147,9,6,6,0,100
54bb93bf2856d31d9d25c93e81233b1798b673e4,0,0,0,0,0,0,0,0,0,0,0,0,0,0,351,17,0,0,0,0,0,0,0,0,0,100
4f5b7712057568468e9020ad14dac9f903d6ec05,2,3,19,16,0,0,0,16,59,8,1,1,0.902393283,1043,352,18,164,169,5,8218,8285,67,84,85,1,100
e7f19a99b8410849d22747e83a22c398881e6555,0,0,0,0,0,0,0,0,0,0,0,0,0,0,353,18,0,0,0,0,0,0,0,0,0,100
e64f2360f3c06d32530e3793f2476aa019a32064,0,0,0,0,0,0,0,0,0,0,0,0,0,0,354,19,0,0,0,0,0,0,0,0,0,100
e887394e7ad717649f4ff58d797a9096d707e444,0,0,0,0,0,0,0,0,0,0,0,0,0,0,355,20,0,0,0,0,0,0,0,0,0,100
23edd961aea87811144f8e906afe2094142ccfd2,1,23,36,13,0,0,0,5,5,210,1,1,0,146,46,2,16,17,1,1176,1223,47,3,4,1,99.94588745
ead85ce17615391709c4224a75d8773201de92af,1,319,378,59,0,0,0,14,45,86,1,1,0,1890,47,3,222,222,0,17446,17569,123,60,60,0,100
014d47023e33bc884afc102a4fc444110a39ec06,2,26,3,23,0,0,0,16,60,8,1,1,0.999142104,1034,356,20,174,164,10,8346,8218,128,86,84,2,100
4b4a3b0999046cbb8ba2d60ab0ea700b85046f3e,0,0,0,0,0,0,0,0,0,0,0,0,0,0,357,21,0,0,0,0,0,0,0,0,0,100
e29ad8816833025f5a5751f70e60e64e6ee97e0c,0,0,0,0,0,0,0,0,0,0,0,0,0,0,358,22,0,0,0,0,0,0,0,0,0,100
e3d271c88da730932398529873a34deae4c3ede6,0,0,0,0,0,0,0,0,0,0,0,0,0,0,359,23,0,0,0,0,0,0,0,0,0,100
604ccfa163d662821671691fb3ace9d5bd1e8358,0,0,0,0,0,0,0,0,0,0,0,0,0,0,360,24,0,0,0,0,0,0,0,0,0,100
6dc5aafbaa40cb430f0656f530530b9556dcca95,0,0,0,0,0,0,0,0,0,0,0,0,0,0,361,25,0,0,0,0,0,0,0,0,0,100
78396357fbd183dd61ac01a1256d39458ae2b560,3,127,5,122,1,0,1,1,12,201,2,2,0.709782433,405,362,26,88,68,20,3360,2590,770,40,33,7,99.97295836
5e508321471e8886f89a5b9cc32d2b85cc79164e,0,0,0,0,0,0,0,0,0,0,0,0,0,0,363,27,0,0,0,0,0,0,0,0,0,100
7ec5199172a0bcaa7e42e6345c4a4ab04bb89fa1,16,315,102,213,0,0,0,6,27,1453,2,3,3.631982871,4076,48,4,866,835,31,26857,26162,695,261,256,5,91.63566212
0aa065e0e06a82784894e0f1f138866db2f8eb32,1,0,0,0,1,0,1,4,6,1556,1,1,0,0,343,1,0,0,0,0,0,0,0,0,0,99.97188642
6709d888136c2177bc133baff110a5b08235c3a6,11,1620,0,1620,11,0,11,1,1,0,2,2,3.03171173,0,49,4,315,0,315,8408,0,8408,136,0,136,99.17099902
e43eeb7f1444026b7010564c9d45bf86c5316b22,1,3,3,0,0,0,0,14,46,15,1,1,0,1842,364,22,222,222,0,17449,17446,3,60,60,0,100
c6cc70b16cf7e9b5f193e3d454694dbca5993cea,0,0,0,0,0,0,0,0,0,0,0,0,0,0,365,23,0,0,0,0,0,0,0,0,0,100
ca2ee74ffcfef3c656285928651aa99e5cf6891a,0,0,0,0,0,0,0,0,0,0,0,0,0,0,366,24,0,0,0,0,0,0,0,0,0,100
38a9c940949d9c22d42e21befc4679b8bfa722df,0,0,0,0,0,0,0,0,0,0,0,0,0,0,10,2,0,0,0,0,0,0,0,0,0,100
2d25b97f3376fd8f339b15caa80633b5f639b834,0,0,0,0,0,0,0,0,0,0,0,0,0,0,11,3,0,0,0,0,0,0,0,0,0,100
681b535b2f13fe70aac4b779d7782af4d1bcb0d7,6,38,36,2,0,0,0,4,8,551,4,5,1.931620957,645,367,24,44,44,0,4718,4728,10,29,29,0,100
e761ba5753a1d0d031be4c337ed38231db1ebd11,0,0,0,0,0,0,0,0,0,0,0,0,0,0,368,25,0,0,0,0,0,0,0,0,0,100
4d65745a988d53040d5cd0b7cc4f670d5e091110,1,2,1,1,0,0,0,1,2,52,1,1,0,61,369,24,5,4,1,337,331,6,3,3,0,100
8bdce26c5a399b29fb1629b33ff4089398a251f0,0,0,0,0,0,0,0,0,0,0,0,0,0,0,370,21,0,0,0,0,0,0,0,0,0,100
de8ba6f563afe0d70a8b6c7144f683b4ca3c2303,3,93,1,92,0,0,0,16,49,457,1,3,1.11090752,1450,371,7,311,295,16,10051,9392,659,110,106,4,100
ce68f541ade55b12e1f5b7b070c37248a8896d58,1,6,2,4,0,0,0,13,45,260,1,1,0,488,50,0,95,94,1,2926,2888,38,48,48,0,100
e6a1e2823c8d16e1ace98ca7e0a8e16eff0d2db4,1,1,1,0,0,0,0,15,45,105,1,1,0,1007,372,5,86,86,0,7210,7210,0,63,63,0,100
6cf3d760807c7999e68d0772e215cb7252062ff0,4,139,31,108,0,0,0,3,74,987,2,4,1.649965113,1283,373,6,207,202,5,9045,8427,618,53,51,2,100
66ce707c7fa468e09e89a3d4f47284af64f717b4,0,0,0,0,0,0,0,0,0,0,0,0,0,0,374,7,0,0,0,0,0,0,0,0,0,100
9bba76f9c801358eddfd21e06708a83dbab51686,0,0,0,0,0,0,0,0,0,0,0,0,0,0,375,7,0,0,0,0,0,0,0,0,0,100
aaaea5b1705f3a6ccd1a4b7bd3d62f3405f3feb7,1,4,384,380,0,0,0,5,10,110,1,1,0,438,376,7,6,23,17,961,3024,2063,5,13,8,100
6403cb2faa1bd967477d0104997f3e9578c32ab6,0,0,0,0,0,0,0,0,0,0,0,0,0,0,377,8,0,0,0,0,0,0,0,0,0,100
d75639f357d3997a8e06766fde8a2aed74f87b5b,0,0,0,0,0,0,0,0,0,0,0,0,0,0,378,9,0,0,0,0,0,0,0,0,0,100
6a105d000e9de81d55ca5092620ab1c607c09044,0,0,0,0,0,0,0,0,0,0,0,0,0,0,379,9,0,0,0,0,0,0,0,0,0,100
2cf65b12be1811b34f951c4c3670bd58a1e7cac3,2,18,1,17,0,0,0,2,3,1773,2,2,0.485460761,185,51,1,27,26,1,1195,1124,71,18,17,1,100
d0be5ce970af1c872600992ebae7e6886232d842,2,37,0,37,0,0,0,7,14,388,2,2,0.753197991,682,380,9,129,125,4,5646,5368,278,41,40,1,100
5d90a172c645bb7adfb44c9a7ce1a958ca451e24,2,8,5,3,0,0,0,6,10,106,2,2,0.961236605,618,381,10,69,70,1,4678,4636,42,28,28,0,100
9c3b0cc916dd86549e3d835df82603d4a60355a5,2,52,15,37,0,0,0,15,50,20,2,2,0.995978957,1991,382,11,280,278,2,13643,13357,286,122,121,1,100
2fd5ef62349c68b7f76f44898eb755e944125bd8,0,0,0,0,0,0,0,0,0,0,0,0,0,0,383,12,0,0,0,0,0,0,0,0,0,100
4578f079b7f8e0d24adb05d48bbacd17b784e739,0,0,0,0,0,0,0,0,0,0,0,0,0,0,384,13,0,0,0,0,0,0,0,0,0,100
1e02b81eee60c2f88e734d5f73ac1f980691f1af,2,26,8,18,0,0,0,2,2,2052,1,2,0.989992792,109,52,2,10,8,2,794,658,136,7,6,1,100
57d902d0720c7e475ea8890e51c87e45bba1b0a8,2,59,3,56,1,0,1,1,75,17,2,1,0.987956501,809,53,3,147,140,7,6241,5936,305,25,21,4,99.83136594
7233f25143c2a6fc08e879c781ba2e62b70366f4,2,4,18,14,0,0,0,15,72,869,1,1,0.684038436,894,54,3,135,137,2,6109,6174,65,26,27,1,100
46fca75ca6847b299e7befad3ffa887c9b5d9e3a,2,85,1,84,1,0,1,1,6,94,2,2,0.21832103,130,3,0,25,23,2,1171,771,400,5,4,1,99.97187852
6f3d8d9b38850fd020822dcd05be65168d4f5225,1,46,0,46,0,0,0,8,10,857,1,1,0,221,385,9,24,21,3,1685,1446,239,9,8,1,100
5b38d0a7c780e398a19019323d9f70048e42b96b,5,410,143,267,1,0,1,1,75,128,2,5,1.318589695,2265,55,4,482,470,12,17411,15908,1503,164,157,7,96.65103818
9029785a0ba62a60eb48ab768cd71a33be4946a7,1,1,0,1,0,0,0,3,7,122,1,1,0,344,386,9,36,36,0,2053,2044,9,19,19,0,100
2d7f193d16561e5c0d202508e8c3c9decb97c81d,0,0,0,0,0,0,0,0,0,0,0,0,0,0,387,9,0,0,0,0,0,0,0,0,0,100
c47f8c5475d9022b2bcdfbea15cfe9e799e891c2,4,458,0,458,4,0,4,1,1,0,2,1,1.941645309,0,56,5,43,0,43,1671,0,1671,37,0,37,99.88498403
97b3fa3d2b18bc2246431ed86e923e7b88122966,1,1,2,1,0,0,0,2,2,18,1,1,0,138,388,3,6,6,0,1168,1181,13,3,3,0,100
b0ca5de9188c6a3d17161b3739eb5cda2c0eceff,1,1,1,0,0,0,0,2,2,18,1,1,0,71,389,4,1,1,0,382,377,5,1,1,0,100
483caf6ec53a5c715046e771808cbdd306bdd2fc,0,0,0,0,0,0,0,0,0,0,0,0,0,0,390,5,0,0,0,0,0,0,0,0,0,100
9c5df74021faa4b876def7b8d782473cc5d21dcd,1,1,1,0,0,0,0,2,6,573,1,1,0,450,391,6,97,97,0,3227,3227,0,27,27,0,100
7f4d35ade26079e327f62a9ad43c9750ea0eba66,0,0,0,0,0,0,0,0,0,0,0,0,0,0,392,7,0,0,0,0,0,0,0,0,0,100
4ebd913e9ca9769c4ac7cd5de0f615539b9dbabd,5,228,2,226,3,0,3,1,73,140,2,4,1.358202042,626,4,1,121,108,13,5572,4249,1323,40,32,8,98.30061915
4538aef0d72eb27e2f718d713670e619162993a8,3,116,1,115,0,0,0,6,49,133,2,3,1.410092384,948,393,8,158,150,8,7509,6900,609,64,61,3,100
6cb368690c19c273c230ba02f29e4c7be7d0525e,2,36,0,36,0,0,0,6,32,416,2,2,0.581321499,2025,394,9,210,209,1,19728,19494,234,109,108,1,100
37b098d547f59f29adef83058a7bd90c0bbfa24a,2,29,1,28,0,0,0,6,33,519,2,2,0.650022422,1900,395,10,169,168,1,18488,18358,130,107,106,1,100
2ee375de9ba60bb0d94820ac765f6a13474fd950,0,0,0,0,0,0,0,0,0,0,0,0,0,0,396,11,0,0,0,0,0,0,0,0,0,100
e65d01535766cfcd59c73e47a4557e7a67a25ba0,2,29,0,29,0,0,0,4,11,537,2,2,0.957553484,916,397,9,96,92,4,6071,5912,159,42,41,1,100
be22caceed47a761b2483e23b5e4717f0d0c29b2,1,2,1,1,0,0,0,7,20,230,1,1,0,654,398,10,37,37,0,6650,6648,2,26,26,0,100
d77d68b5c017e3b193de228da6d51c087bc33914,3,73,11,62,0,0,0,14,47,1277,2,2,1.548925561,2012,399,11,254,244,10,18842,18512,330,70,66,4,100
22f184d4a36393a28176990c0e0ecf4f6d96b9ad,1,2,4,2,0,0,0,3,12,197,1,1,0,258,400,12,52,52,0,1593,1589,4,12,12,0,100
01cb14ae769a35266decdfc2f9843f62072addec,3,17,3,14,0,0,0,5,76,34,1,3,1.336666482,1666,401,13,310,309,1,11465,11351,114,90,90,0,100
8a17cb893810d513838d1b8b7c430c85c38afad7,0,0,0,0,0,0,0,0,0,0,0,0,0,0,402,11,0,0,0,0,0,0,0,0,0,100
c7a8515c2ba9137d2fd96aa6cd47e2109c6c6ef2,1,10,8,2,0,0,0,2,2,29,1,1,0,124,403,12,10,10,0,1004,984,20,6,6,0,100
043e267adb6fb155e2baab0d812bac26e1c6617c,2,8,4,4,0,0,0,2,51,618,1,2,0.811278124,1482,404,11,311,308,3,9497,9463,34,101,101,0,100
0675f0daf6757c02b56d440dac50acf48359a061,2,38,0,38,0,0,0,3,4,848,2,2,0.991992403,348,405,12,64,58,6,2540,2272,268,25,24,1,99.98639085
9f8c4409d7374f2887170d6c21d0a45eaec3e047,2,45,2,43,0,0,0,11,30,596,2,2,0.991820797,1086,406,13,133,129,4,8678,8353,325,56,54,2,100
0bcef461d693a7e67017f3af86ef437c630d5309,0,0,0,0,0,0,0,0,0,0,0,0,0,0,407,14,0,0,0,0,0,0,0,0,0,100
ddd60ef26f9f24966382b9bd01de1d63ad8ceb20,0,0,0,0,0,0,0,0,0,0,0,0,0,0,408,15,0,0,0,0,0,0,0,0,0,100
98b5861c4aecc6df4bee03e3d6d1688433952fc6,1,1,1,0,0,0,0,4,21,355,1,1,0,1794,409,16,118,118,0,6384,6384,0,109,109,0,100
91eaa7bc8a978b0f4f8c21d3a70c36894dd198d4,0,0,0,0,0,0,0,0,0,0,0,0,0,0,410,17,0,0,0,0,0,0,0,0,0,100
7c90f5078bb50f7ccf5f406fc20208fbf416e83b,1,6,1,5,0,0,0,1,3,2840,1,1,0,67,411,11,8,7,1,430,411,19,5,5,0,100
2bf0fd31ac13079242125249a2e353596bae3780,0,0,0,0,0,0,0,0,0,0,0,0,0,0,110,0,0,0,0,0,0,0,0,0,0,100
314123a0ba1f6dcbecedeb367db28b812ef73148,1,5,1,4,0,0,0,11,31,8,1,1,0,718,412,11,67,67,0,5693,5667,26,35,35,0,100
fe2f82ae2ff43d5dc7a92d4385003354b4a4b501,7,273,63,210,1,0,1,3,76,659,2,5,2.235317169,1992,5,0,416,391,25,15703,14409,1294,126,113,13,99.79602937
861ac425c6be1b8f45b369b6a2a0f3cb6fd4ff49,3,47,1,46,1,0,1,1,74,36,2,3,1.187200307,640,413,12,116,109,7,4533,4313,220,39,33,6,99.97283347
8b0b9e6f9d713a3946834d3dfbf8b79c76491366,3,8,3,5,0,0,0,4,27,204,2,1,1.494918848,1550,414,12,278,277,1,10841,10821,20,131,130,1,100
8ee2bc167e1d72bea4dfc266b271b1870254c600,2,51,5,46,0,0,0,5,14,1755,2,2,0.999079718,575,415,13,72,65,7,4845,4575,270,44,38,6,100
a144520a35cea4658e07a5ce8d59dcdd7a90fac8,2,21,2,19,0,0,0,3,8,416,1,2,0.932111568,610,416,14,97,94,3,3949,3852,97,39,38,1,100
204eb5d75b02e96c635480139b1e5e5635885fd4,4,49,8,41,0,0,0,1,18,538,2,4,1.810576646,1100,417,15,243,239,4,7894,7651,243,76,75,1,100
f273078b3d14874b83925f0b2a45c7c40fae8e4c,0,0,0,0,0,0,0,0,0,0,0,0,0,0,418,16,0,0,0,0,0,0,0,0,0,100
6bc92edfc59a36db28851c614a5909cb3e8096f4,0,0,0,0,0,0,0,0,0,0,0,0,0,0,419,17,0,0,0,0,0,0,0,0,0,100
d96783c9aa8ff143f52a9e7757d39fc2af6b77b0,0,0,0,0,0,0,0,0,0,0,0,0,0,0,420,18,0,0,0,0,0,0,0,0,0,100
71ecc82105aae2deb6dbef9aff40eabdaceadda7,1,1,0,1,0,0,0,11,32,9,1,1,0,719,421,19,67,67,0,5700,5693,7,35,35,0,100
c2d4af2f60b737171b59f49242f4679fd5438d75,1,1,1,0,0,0,0,10,45,288,1,1,0,357,422,20,59,59,0,2260,2263,3,39,39,0,100
973ac665bd604b936624599ef0f0fdc882d9dced,1,2,0,2,0,0,0,15,77,50,1,1,0,826,57,0,143,143,0,6072,6056,16,22,22,0,100
200910e76c26b50671e8d1a837fcb0dad6dc19f8,2,22,12,10,0,0,0,3,9,623,1,2,0.936667382,412,423,21,41,43,2,2454,2430,24,24,24,0,99.98642042
4b783c05ed2cd379c25aa9d33b6dfdbddc318984,0,0,0,0,0,0,0,0,0,0,0,0,0,0,424,22,0,0,0,0,0,0,0,0,0,100
a1ffa5fb7ddb91e78521294163775629305577d0,1,1,1,0,0,0,0,10,50,59,1,1,0,383,425,23,81,81,0,2599,2599,0,31,31,0,100
1683ad6b3a39cb2190e00ed97254510848ae8f43,0,0,0,0,0,0,0,0,0,0,0,0,0,0,426,22,0,0,0,0,0,0,0,0,0,100
d7bab79f3d5213f19440d77657ba90f86352c73a,1,37,0,37,1,0,1,1,1,0,1,1,0,0,427,23,3,0,3,93,0,93,1,0,1,98.45559846
61a05c4dc2d3ea92268e3e8f406755b073599a97,9,52,4,48,0,0,0,3,77,309,2,5,2.862784606,3598,428,24,642,634,8,27360,26975,385,178,174,4,100
47b030626ec948252dae6592da6f6df90909078f,3,50,27,23,0,0,0,5,14,681,2,3,0.852051362,737,429,25,123,121,2,4819,4663,156,80,79,1,100
a02b1bf8c7a9696fdcdbbc48527fec12555402cc,1,1,1,0,0,0,0,7,9,0,1,1,0,187,430,26,42,43,1,1123,1127,4,18,18,0,100
b311eb1735319d615734adc3437550093d948167,1,25,0,25,0,0,0,6,13,200,1,1,0,888,431,27,139,136,3,8114,7987,127,41,38,3,100
0aaa3ffa018646988893a6f8e892877e9aad77fb,0,0,0,0,0,0,0,0,0,0,0,0,0,0,432,28,0,0,0,0,0,0,0,0,0,100
a5f170999865a82bcf28b7d48b2013460cf81106,0,0,0,0,0,0,0,0,0,0,0,0,0,0,0,0,0,0,0,0,0,0,0,0,0,100
0b054f9b8ef5a6016c83509b15f27744656b2ad9,3,11,7,4,0,0,0,4,10,49,1,2,1.299736764,1099,1,1,195,195,0,7322,7271,51,67,67,0,100
4b234c6c4c9f311d2b803260617264569083cb71,1,4,0,4,0,0,0,8,23,614,1,1,0,642,2,2,131,131,0,4885,4878,7,40,40,0,100
955ec712ea79637dda0ea7174fb30c7072fdaf5a,0,0,0,0,0,0,0,0,0,0,0,0,0,0,433,26,0,0,0,0,0,0,0,0,0,100
09d812ef69f0fb7c47730dbae943647c92e3e9ba,1,154,0,154,1,0,1,1,1,0,1,1,0,0,434,25,15,0,15,499,0,499,3,0,3,99.9300014
f467774eee699ba7295cd4a5c1dcedf88f7e5363,0,0,0,0,0,0,0,0,0,0,0,0,0,0,435,24,0,0,0,0,0,0,0,0,0,100
72bd096003bf66632903c785b573305fdfde9707,2,29,4,25,0,0,0,11,139,175,2,2,0.745517843,1751,436,16,277,276,1,13312,13079,233,121,120,1,100
a7eeef342c0c605b7421b25e35d0ee0b53ef63e1,16,3633,5,3628,13,0,13,1,20,88,2,8,3.370874904,567,437,13,537,90,447,19672,4126,15546,264,37,227,99.55406912
5f93836817da745347c835340d647e10b0b816e8,0,0,0,0,0,0,0,0,0,0,0,0,0,0,438,12,0,0,0,0,0,0,0,0,0,100
4efb40ae6b4f37e56adb1908ad321c3e605d2d5e,0,0,0,0,0,0,0,0,0,0,0,0,0,0,439,6,0,0,0,0,0,0,0,0,0,100
dddef893f30079fa0ff0caebd9cda18194dc3697,0,0,0,0,0,0,0,0,0,0,0,0,0,0,440,7,0,0,0,0,0,0,0,0,0,100
a09f19b51a468d2caaba54ea35ec8e519794dc09,2,19,8,11,0,0,0,12,31,418,2,2,0.999010271,942,441,5,150,148,2,7458,7406,52,46,46,0,99.91686296
4943fbcc5ad63fe71628fb8b7c39641a89835d5e,1,5,0,5,0,0,0,3,3,1161,1,1,0,35,6,0,5,4,1,136,123,13,4,3,1,100
74e4b77c5a50dbd0c747e2365cad1a64fe9f1416,1,2,2,0,0,0,0,13,105,560,1,1,0,2065,58,0,371,371,0,16869,16868,1,59,59,0,100
4258046d2136cf7f36c5361e52f45d3dd0042873,4,74,6,68,0,0,0,9,78,462,3,4,0.84758468,1669,442,6,299,289,10,12167,11715,452,97,93,4,100
2a6820eb2428a2fb0f396c59d7a0b55ceff4660d,4,87,147,60,0,0,0,4,79,76,2,4,1.718314345,2563,0,0,454,466,12,18394,18833,439,125,128,3,100
e1e195b409559f32537765083a79ae52c2619618,1,2,2,0,0,0,0,9,13,8,1,1,0,537,443,6,61,61,0,3264,3244,20,28,28,0,100
25a195e3f821281774868f5b3e937afe951022d3,2,207,0,207,2,0,2,1,1,0,1,1,0.849054424,0,1,1,16,0,16,772,0,772,3,0,3,99.94469027
6c8373be8662f5aa8e85c161d873af55234e06c7,0,0,0,0,0,0,0,0,0,0,0,0,0,0,444,5,0,0,0,0,0,0,0,0,0,100
af1651bff0eaaa5220403c3afb87d2ab7f48b9f0,0,0,0,0,0,0,0,0,0,0,0,0,0,0,445,6,0,0,0,0,0,0,0,0,0,100
b8b08db005eeaf0a5e5c063dbbfee5c18e84d48b,4,68,0,68,0,0,0,2,3,135,1,3,2,178,446,7,16,16,0,1428,1428,0,11,11,0,100
fcd7831eb1ae7f26cd48a3a579b767ecd56b285d,0,0,0,0,0,0,0,0,0,0,0,0,0,0,447,8,0,0,0,0,0,0,0,0,0,100
bc3c7183f1618173bfe239aea5de9c33345f43da,1,3,0,3,0,0,0,4,4,1140,1,1,0,127,448,9,37,36,1,1014,985,29,3,3,0,100
89f2d6b9bb9b57910d7abbff3650fdd5c5c99e03,2,33,0,33,0,0,0,4,19,1122,2,2,0.195909271,1999,449,10,279,277,2,14130,13933,197,85,84,1,98.9717938
d53b4c5dfbff9dd235edb0c9fe8fb2224cca75e9,1,1,1,0,0,0,0,2,2,1806,1,1,0,507,450,11,88,85,3,3911,3884,27,25,25,0,100
46616504206512954d72af2acd55367f4b9abe01,1,2,2,0,0,0,0,13,106,21,1,1,0,2065,451,12,371,371,0,16868,16869,1,59,59,0,100
1adaad584ba23a3560769feceb472291920af8ce,1,0,1,1,0,0,0,6,57,351,1,1,0,1261,452,11,81,81,0,9724,9737,13,60,60,0,100
4460aa24ba0e299e55024c69f9afeb3f573542fb,2,23,3,20,0,0,0,6,140,488,1,2,0.779349837,1105,2,2,222,221,1,7872,7787,85,91,90,1,100
589636e53d9eba80731059c7eb5a10d2c999d642,2,24,0,24,0,0,0,5,11,84,1,2,0.249882293,831,3,3,137,135,2,5561,5462,99,49,48,1,100
220f4a34872d03982be7c7c3a676eeb9c2bb6f63,0,0,0,0,0,0,0,0,0,0,0,0,0,0,4,4,0,0,0,0,0,0,0,0,0,100
b21f71553a8f77742ebacd3b90f002afc021c77c,2,641,0,641,2,0,2,1,1,0,2,1,0.448385609,0,7,1,75,0,75,2738,0,2738,66,0,66,99.93019684
7a48cc27af429dd09cada69886ac61adf3436a20,0,0,0,0,0,0,0,0,0,0,0,0,0,0,453,11,0,0,0,0,0,0,0,0,0,100
cbd03b73a5273e1cf209a67e44da950d29cc4366,0,0,0,0,0,0,0,0,0,0,0,0,0,0,454,12,0,0,0,0,0,0,0,0,0,100
2c0a2dd4cc694234332b84684775751b4f7ae0f4,1,1,1,0,0,0,0,2,4,1745,1,1,0,163,5,5,22,22,0,914,917,3,20,20,0,100
f7c88d0582e70f172a0635b0c72429e70019bd89,0,0,0,0,0,0,0,0,0,0,0,0,0,0,455,13,0,0,0,0,0,0,0,0,0,100
3b48455be0314865c31e907705474865aa1a2ff7,0,0,0,0,0,0,0,0,0,0,0,0,0,0,456,14,0,0,0,0,0,0,0,0,0,100
a743dbc0b956913fa103f2ca868fbef667081991,9,117,101,16,0,0,0,7,141,319,2,3,2.38461888,5708,59,0,763,761,2,41939,41886,53,279,278,1,96.62969283
7445ab1631d4ec0c086d1fcf8b8f37a5f17fc148,0,0,0,0,0,0,0,0,0,0,0,0,0,0,344,0,0,0,0,0,0,0,0,0,0,100
0e567673a798ef8f6367e77f9aded8925981b008,5,55,4,51,0,0,0,8,31,772,2,3,2.143250456,1843,6,4,296,289,7,13899,13585,314,148,145,3,100
1ae84f9b4c2affc97564a9ab0f880dd520e5a842,1,2,2,0,0,0,0,7,19,2,1,1,0,688,7,5,157,157,0,4933,4931,2,77,77,0,100
210ee622d04910bf4fc62c62ca4dcbfa3c6b55be,5,30,5,25,0,0,0,3,76,588,1,2,2.177140237,1553,8,6,304,302,2,10285,10201,84,122,120,2,100
8deb32e0907087da9d99c63ddd3df90e97bf2a54,1,1,1,0,0,0,0,16,79,64,1,1,0,824,457,4,142,142,0,6046,6046,0,22,22,0,100
131970e5c3e1effb4f0a915d93351968aff28d0a,2,59,1,58,1,0,1,1,21,264,2,1,0.2108423,154,3,0,44,36,8,1240,994,246,27,19,8,99.95650913
087e3ff1a5c654a6b5e476877abfbdf6b263f846,1,13,4,9,0,0,0,4,5,627,1,1,0,94,4,1,15,15,0,501,495,6,3,3,0,100
b4f33416e5923d4bc6b38856d23c76e3e4c2bbde,1,9,0,9,0,0,0,18,77,5,1,1,0,494,12,0,81,80,1,3622,3577,45,14,14,0,100
53d03ca7437c2057e342d11c9db89213ba1cc3cb,3,35,5,30,0,0,0,16,142,172,1,3,1.472246299,2322,458,2,481,474,7,15769,15624,145,177,173,4,100
31e0c72ce3046a056d2b37a27f65bbc96d3cf19b,4,40,7,33,0,0,0,7,81,444,2,4,1.289375959,2282,459,3,390,385,5,18680,18376,304,120,117,3,96.74082471
bb13ee9d64f69c01800fb59156283e7ec86d2ecd,0,0,0,0,0,0,0,0,0,0,0,0,0,0,460,4,0,0,0,0,0,0,0,0,0,100
4e05f92c5945c78e7daf015cc2c119526ed65e91,2,11,1,10,0,0,0,8,21,291,2,2,0.41381685,709,5,2,41,41,0,6967,6938,29,30,30,0,100
6ff74f3cb82289a19154663a33a47a2d186ecd32,9,853,0,853,9,0,9,1,1,0,2,3,2.934219546,0,9,3,74,0,74,3679,0,3679,49,0,49,99.7097443
2eb877704aa69d9cfdc374b6b8af0b277f12ea68,16,221,62,159,1,0,1,1,107,491,2,6,2.726078099,8746,8,0,1692,1678,14,66142,64743,1399,507,496,11,99.9724442
9feae4e3602f66eba19ecd4822b546a9114c9eb8,1,53,13,40,0,0,0,7,17,3,1,1,0,479,461,4,119,117,2,3710,3474,236,51,50,1,100
70053425ee087ce293f89a3c36ae4f9758d7fc81,9,618,144,474,3,0,3,1,82,100,3,7,2.427453926,1823,9,1,388,328,60,15460,13448,2012,113,91,22,99.90366089
f8713d73ed0746b32252967da2bc2db5f175ddf1,2,9,2,7,0,0,0,14,83,1149,1,2,0.945660305,1096,10,2,223,220,3,8283,8258,25,53,53,0,100
668d095db7465c3ccc0e4db6de3008395ae8b85a,0,0,0,0,0,0,0,0,0,0,0,0,0,0,462,5,0,0,0,0,0,0,0,0,0,100
8c587ed8b651ca234d0f552a0fa4dd8ba72fbd37,5,595,3,592,4,0,4,15,48,48,2,2,2.314384375,1870,6,3,277,222,55,20773,17700,3073,74,60,14,99.89010989
6b7d334c05d648d5d0d92d3f62f4333dc179c2b1,7,219,12,207,3,0,3,1,32,563,2,7,2.672980705,1005,7,4,248,221,27,6639,6059,580,95,79,16,99.84923246
6cffb75282455abc7a27ba2d2db36d8f864dcf26,1,6,1,5,0,0,0,1,4,1430,1,1,0,84,463,5,15,14,1,550,523,27,9,9,0,100
7711dda5e2f7d974bad7265d56a69473a16ca84a,0,0,0,0,0,0,0,0,0,0,0,0,0,0,464,6,0,0,0,0,0,0,0,0,0,100
dacb0c6fa26c80bf1a6b494221da3cdc71fad9ac,0,0,0,0,0,0,0,0,0,0,0,0,0,0,465,7,0,0,0,0,0,0,0,0,0,100
11ceea1e7de089906149d98c90af88625cd5c3e3,0,0,0,0,0,0,0,0,0,0,0,0,0,0,466,8,0,0,0,0,0,0,0,0,0,100
73425a36e631932f7d14fd4eac953df68ce8a026,0,0,0,0,0,0,0,0,0,0,0,0,0,0,467,6,0,0,0,0,0,0,0,0,0,100
ae51eaf2c2ab7cc8795a1905985fe9a76dbd1a2f,10,1013,64,949,2,0,2,1,28,710,2,5,2.209286226,2443,60,0,518,427,91,22429,16069,6360,259,210,49,99.94526546
b49c7844e10c73cadbfd931991098727b87002f6,1,5,7,2,0,0,0,10,51,210,1,1,0,383,61,1,81,81,0,2586,2599,13,31,31,0,100
38ef5c49a9f625f2b3fd988f2f2af560c5642f8c,2,61,0,61,0,0,0,4,7,1150,2,2,0.208180946,1208,468,6,128,124,4,10189,9812,377,60,56,4,100
fd4fd846037cdc21c6b0d57ef4495bb918c9d9a4,17,128,81,47,0,0,0,2,3,1827,1,3,4.058896394,885,469,7,82,82,0,5658,5658,0,49,49,0,100
a339864d49f9a22082da339c03db9260057edd25,5,40,1,39,0,0,0,7,29,861,2,3,1.826751442,2249,470,8,403,399,4,17226,17033,193,135,132,3,100
419ce4148c49da3758352e2873313415411deac1,1,1,1,0,0,0,0,2,3,1847,1,1,0,170,471,9,24,24,0,933,936,3,20,20,0,100
f4cabd2bafd75bf16e8752c16803b9b23f103ece,2,18,3,15,0,0,0,11,80,744,2,2,0.702466551,1882,13,0,224,223,1,9543,9441,102,165,164,1,100
2da64bd848e10005c31df74ed59172bc233d37f5,2,93,6,87,0,0,0,2,8,1236,2,2,0.945660305,1196,8,2,334,301,33,8397,7798,599,49,47,2,100
70f51520e90e30becef40bd7e2d9b4398cb87bc5,6,1,72,71,0,0,0,7,28,402,1,2,2.56350388,1296,9,3,303,313,10,7720,7871,151,131,141,10,100
18f31c05c3a0328876a30ee97a60824870dd00e2,0,0,0,0,0,0,0,0,0,0,0,0,0,0,10,4,0,0,0,0,0,0,0,0,0,100
1fc765479f174e8df3f25d946538d194ffdbf34e,2,45,32,13,0,0,0,17,75,293,1,2,0.985228136,1283,62,2,244,242,2,8465,8401,64,72,72,0,100
09f77be95e655fa4d1f45a7de2832b74bf5e4ec0,7,54,96,42,0,0,0,3,29,291,2,3,2.226206423,1354,11,5,307,313,6,8520,8475,45,132,140,8,100
9ca89eedb29198ea633bff91d2543b292cae4bf4,1,70,0,70,1,0,1,1,1,0,1,1,0,0,12,6,6,0,6,198,0,198,6,0,6,94.60699943
14b5026195d9f3549dd849f83ba2f71be60acce7,1,11,1,10,0,0,0,5,7,315,1,1,0,131,11,1,26,24,2,853,794,59,4,4,0,100
d4720aa5f46353733180a19049a6a850281271eb,1,1,1,0,0,0,0,16,80,87,1,1,0,824,12,1,142,142,0,6038,6046,8,22,22,0,100
6d519e0fd6f0c3eb0c99b271d82ee8355274401c,1,10,1,9,0,0,0,18,80,60,1,1,0,501,10,0,82,81,1,3707,3645,62,14,14,0,100
fd54bb39e9212bbfb6f001669e46987e8b547fdc,1,11,4,7,0,0,0,4,5,138,1,1,0,130,472,7,38,37,1,1062,1014,48,3,3,0,100
9c42e6f5cf009e596aea269c35327d1ba40c8c9a,8,0,18,18,0,0,0,2,8,2362,1,3,2.86382639,2534,473,8,215,216,1,23224,23425,201,67,67,0,100
764b5ad224fbd526744d39b4e8ecd7fa421a7137,0,0,0,0,0,0,0,0,0,0,0,0,0,0,474,9,0,0,0,0,0,0,0,0,0,100
0e732d71f8ae7bbad3435ad7c20127468e71ba26,0,0,0,0,0,0,0,0,0,0,0,0,0,0,475,8,0,0,0,0,0,0,0,0,0,100
72e5d37c2b78a091ab052d86b5749c6cf847becc,1,21,9,12,0,0,0,5,12,291,1,1,0,357,476,9,74,72,2,2516,2475,41,20,20,0,100
36e6d06ca4c42ed071c6c8b71cb532d9ac5533df,1,2,2,0,0,0,0,3,12,460,1,1,0,951,477,10,241,239,2,7090,7074,16,46,46,0,100
5a46b189c08eb1b4138f7cc8e4fcfb548b4a8f3f,1,3,0,3,0,0,0,5,13,0,1,1,0,367,478,11,75,74,1,2540,2516,24,20,20,0,100
874b91277f3dad5c053f0ee0ecc773a3283db339,0,0,0,0,0,0,0,0,0,0,0,0,0,0,479,11,0,0,0,0,0,0,0,0,0,100
1ced425393066c0698dbba2981b7107f0fb832ce,0,0,0,0,0,0,0,0,0,0,0,0,0,0,480,12,0,0,0,0,0,0,0,0,0,100
800beca0458eeafd84aed160c74d6e581d140710,5,289,2,287,4,0,4,1,29,10,2,3,1.56966388,569,481,13,179,148,31,4547,3594,953,49,38,11,99.86447824
3324decefd7fbcf019c796efa84bf2aaecd2dd6d,3,882,0,882,3,0,3,1,1,0,2,2,1.233174532,0,482,10,82,0,82,5311,0,5311,30,0,30,99.92486852
c74373d6114ee7da3be720e03abd73dc6a08ddaf,1,3,1,2,0,0,0,18,143,114,1,1,0,1038,483,11,214,214,0,7445,7427,18,87,87,0,100
da5c02e6d8a7dc71eae75a479f361743b2c70c95,0,0,0,0,0,0,0,0,0,0,0,0,0,0,484,12,0,0,0,0,0,0,0,0,0,100
c8658e5a41ed5e4d326b462a7566a00809287b17,29,810,721,89,2,0,2,8,144,721,2,10,3.154483455,15497,13,1,1977,1945,32,115455,115776,321,995,964,31,91.98693014
c9c613a9b01a05c4d2838e22effe8f3877bcae30,0,0,0,0,0,0,0,0,0,0,0,0,0,0,485,13,0,0,0,0,0,0,0,0,0,100
929e560a185b4367052e2f087a3e4a474356882a,5,154,86,68,1,0,1,10,108,310,2,4,2.039132175,4531,63,0,768,761,7,36336,36292,44,210,205,5,94.0530495
eac151cbbd193a4016bcb202dcacfffaefd6a952,3,33,10,23,0,0,0,5,145,162,1,3,1.224876717,1738,486,4,352,344,8,11869,11691,178,151,150,1,100
6e410368265cd9b6e5fa61c72c24f78b92707d3d,1,165,0,165,1,0,1,1,1,0,1,1,0,0,487,5,8,0,8,1264,0,1264,5,0,5,99.85843214
360a2e2a27d6169cb40c3d55a2fbd7570c02bb23,2,42,10,32,0,0,0,11,146,326,1,2,0.811278124,2231,13,0,526,520,6,15329,15189,140,148,145,3,100
6317c3aa25d00659901a5bd0c4c16e66a0e8cb57,0,0,0,0,0,0,0,0,0,0,0,0,0,0,14,1,0,0,0,0,0,0,0,0,0,100
96c7459b6a4109b7b08d2fcc6d4937fa2450c1d7,2,31,11,20,0,0,0,6,52,220,2,2,0.973668065,793,488,6,110,110,0,5977,5890,87,49,48,1,100
93bb724800787f97cdc1881e1fd89351ed110193,0,0,0,0,0,0,0,0,0,0,0,0,0,0,15,2,0,0,0,0,0,0,0,0,0,100
349fc4f2b214cb6e2eeeeb5eba29e90bcfcbe6f6,1,5,0,5,0,0,0,11,58,3,1,1,0,1208,14,1,311,310,1,7841,7812,29,62,61,1,100
0cce76c8256e8fd09d8ee39d1069f015e79d11dc,1,1,0,1,0,0,0,14,50,3,1,1,0,517,489,7,99,99,0,3107,3094,13,49,49,0,100
1e6a171bc6450a1abb2ec2dee89d487c47ede5cd,0,0,0,0,0,0,0,0,0,0,0,0,0,0,16,3,0,0,0,0,0,0,0,0,0,100
8119b305a1f754dbe3d4b7f216de63b49477de01,0,0,0,0,0,0,0,0,0,0,0,0,0,0,64,1,0,0,0,0,0,0,0,0,0,100
fa575351cbd7e4149dfe895029a80309e218944a,0,0,0,0,0,0,0,0,0,0,0,0,0,0,490,8,0,0,0,0,0,0,0,0,0,100
2e8be6fb89ca1711279b56fedcd58eb7d6ad2303,50,5254,1946,3308,14,0,14,8,84,404,2,13,4.350286833,12628,15,2,2782,2296,486,103992,87852,16140,1158,876,282,93.46140883
4b7d60a7daea8962ce032e1d59e01f68c6386260,0,0,0,0,0,0,0,0,0,0,0,0,0,0,17,3,0,0,0,0,0,0,0,0,0,100
03737fee6d47b51e3622b54fe771e22133a05f89,2,11,31,20,0,0,0,6,53,24,2,2,0.973668065,807,491,5,110,110,0,5890,5977,87,48,49,1,100
cefaf01aa97672d5f58640ce8783f19761069540,2,32,36,4,0,0,0,7,15,195,1,2,0.948848294,452,492,6,105,105,0,2978,2961,17,40,40,0,99.53028831
b0e55e2bf794e7a8d2598a9dacd263caa4354485,0,0,0,0,0,0,0,0,0,0,0,0,0,0,493,7,0,0,0,0,0,0,0,0,0,100
b0eb23009cbf70f2ac6bf53107dc6de764be73d9,0,0,0,0,0,0,0,0,0,0,0,0,0,0,494,8,0,0,0,0,0,0,0,0,0,100
700589f84025a1833d3f6b932dc07f6c78d18d00,1,5,3,2,0,0,0,10,19,18,1,1,0,514,16,3,98,97,1,3331,3322,9,32,32,0,100
455486f2960e60ee4a671d98593d67c3f4ab25c3,4,62,48,14,0,0,0,6,14,179,1,2,1.349854415,2090,495,9,158,157,1,17969,17880,89,91,90,1,99.98370805
e2535a339dcb08de916a3ad8f64fae9f0abe31f0,0,0,0,0,0,0,0,0,0,0,0,0,0,0,14,0,0,0,0,0,0,0,0,0,0,100
f4f7d386f1fe9f5209f8db0bbc23e1af7fb79171,3,209,136,73,0,0,0,1,30,379,2,3,0.346525537,1642,65,1,290,283,7,14194,13774,420,115,112,3,100
326b88eb52746bf493e8ece195b0815b8161b7b6,1,6,3,3,0,0,0,5,7,586,1,1,0,89,496,8,8,8,0,620,606,14,4,4,0,100
ac516772a23a633d89cee7f822b7781c4254b255,6,323,338,15,0,0,0,3,147,1166,2,2,1.448326113,2999,66,2,434,437,3,19649,19712,63,154,154,0,100
5ede007ff869c2ce85d275c869a73fd1197df15e,2,84,16,68,0,0,0,8,82,142,2,2,0.985815037,1309,497,7,162,155,7,10613,10316,297,57,55,2,100
5f60a8380d1743bff8536ea41c3cb882e297f1ce,3,26,33,7,0,0,0,1,24,27,2,3,1.109219129,2081,17,2,275,274,1,16109,16196,87,67,67,0,100
1dc95d64a0767ec7e48f48fe5c418de96773e072,3,143,108,35,0,0,0,3,52,186,2,3,0.495175315,706,18,3,116,111,5,4499,4361,138,60,56,4,100
7bb8d9d210ca42280f2ad4144c42ee86e9e09fc1,1,8,0,8,1,0,1,1,1,0,1,1,0,0,19,4,0,0,0,14,0,14,0,0,0,99.96742671
42e511417b2e180a5e9b35e5c3decc976cff85f2,15,2085,4,2081,14,0,14,1,9,3,2,3,3.116769783,200,18,1,277,38,239,12018,1295,10723,93,15,78,99.48169744
066892e4b9baefc2c82bda2dd3d23e4f4aafce1e,2,65,69,4,0,0,0,16,47,251,2,2,0.661446756,2191,19,2,330,332,2,16465,16417,48,154,154,0,99.96778351
fb90435602999e5eaeed9b92418e29e0d908ba57,4,46,45,1,0,0,0,8,49,700,1,1,1.281597158,2942,15,1,319,319,0,25415,25174,241,100,100,0,100
913fb3e317c5fa301626049a4974e14bb7f920e0,1,5,1,4,0,0,0,21,148,21,1,1,0,1024,16,2,210,210,0,7395,7393,2,86,86,0,100
9a99f42ccf979a3a06704467c41deb48052368a5,3,103,63,40,1,0,1,6,15,379,2,3,1.535292306,1204,20,2,216,212,4,8206,7966,240,137,133,4,99.91954948
5a41257acb1f09d2b8a2a16c33806645f419a699,1,6,3,3,0,0,0,7,32,3,1,1,0,1160,20,4,245,245,0,8967,8969,2,90,90,0,100
d3b832bcdf35258169b48313c63fdf4a4587873f,2,17,2,15,0,0,0,18,54,177,1,2,0.74248757,1321,17,3,272,270,2,8586,8500,86,92,90,2,100
603941a9ddba105401e3f5b36f4b1c0cb246a020,1,1,1,0,0,0,0,3,3,742,1,1,0,290,21,5,59,59,0,1875,1875,0,12,12,0,100
4d0751adba9e676c0d6bad14ffc4a258aac7abb5,4,211,31,180,0,0,0,2,12,600,1,2,1.696217457,1225,43,0,216,201,15,8931,8005,926,80,71,9,99.90350595
c46bc1c519a5906b907125afc662575059ec6fbf,1,3,2,1,0,0,0,4,10,49,1,1,0,1531,21,3,104,104,0,13505,13498,7,67,67,0,100
3b82f292883a78af7505a1f0fb86fba192917c57,6,60,29,31,0,0,0,1,30,70,2,1,2.151734524,3100,22,5,688,681,7,20492,20388,104,346,343,3,100
b0912e39ca69709977a2b63ec67e5d878d402d08,2,168,14,154,0,0,0,1,3,170,2,1,0.997821184,393,22,4,93,75,18,3542,2671,871,74,66,8,100
d9c28922fc9a73a91a048cddf0a977bdf2758e98,0,0,0,0,0,0,0,0,0,0,0,0,0,0,23,5,0,0,0,0,0,0,0,0,0,100
9ba243afe2fafdb8c2079763db28d5977d95da15,0,0,0,0,0,0,0,0,0,0,0,0,0,0,24,6,0,0,0,0,0,0,0,0,0,100
176c63fea0fbd40888c036551385a95d757d70f8,0,0,0,0,0,0,0,0,0,0,0,0,0,0,11,0,0,0,0,0,0,0,0,0,0,100
b27c8e08f0a642cf43cd308995b622257d4ef930,0,0,0,0,0,0,0,0,0,0,0,0,0,0,12,1,0,0,0,0,0,0,0,0,0,100
316a95edb811e4fbd6680d03ccfd21f09e29cb7b,0,0,0,0,0,0,0,0,0,0,0,0,0,0,13,2,0,0,0,0,0,0,0,0,0,100
40bacb044d30095f5485b32e00f8e512d3371dcd,0,0,0,0,0,0,0,0,0,0,0,0,0,0,14,3,0,0,0,0,0,0,0,0,0,100
6630d37b87ab6561731db460d3c8961b885045ab,0,0,0,0,0,0,0,0,0,0,0,0,0,0,67,0,0,0,0,0,0,0,0,0,0,100
45c4450a8d644edce3631cfb3332911f7181aceb,9,809,408,401,2,0,2,1,33,100,2,4,2.013371883,2547,68,1,440,396,44,20979,18182,2797,217,199,18,99.91962707
e684eaaebd749b74063cbe2bd0298da906cdd632,8,416,74,342,1,0,1,17,109,298,2,2,1.992843603,4919,15,4,871,854,17,37740,36500,1240,278,260,18,99.87152722
468d2aa7622bb0c07a1bbcf60b673cd95f34ca21,3,125,135,10,0,0,0,4,22,322,2,2,0.567281463,2405,498,0,248,232,16,10956,10953,3,151,141,10,100
1ecb3b6351602406df4d940ac9ef40818ee53c7c,1,4,4,0,0,0,0,3,5,1056,1,1,0,311,44,1,113,113,0,1943,1943,0,17,17,0,100
3a44e98afdc712ef3912521f515889ce03f7e92b,7,443,109,334,0,0,0,9,110,566,1,4,0.627349393,4786,69,2,930,883,47,39171,36983,2188,275,228,47,98.99296675
b2af62184073c2d95debaaa2eb93e930e4eaeebf,2,69,34,35,1,0,1,1,3,1065,1,1,0.924632772,162,70,3,21,21,0,1368,1296,72,15,15,0,99.93637665
91f5f77a39592ef285ba3b1c871b00ff3a01efda,2,10,4,6,0,0,0,6,13,44,1,2,0.591672779,782,45,1,112,111,1,4897,4830,67,49,49,0,100
b688d01cfb778db5e555c8f3d3876a7692a15d1c,2,48,3,45,0,0,0,6,14,828,1,2,0.522559375,631,46,2,76,72,4,4105,3910,195,35,33,2,100
964c0523e7ecc93185d1b02906dc362f17d11547,1,2,1,1,0,0,0,4,5,9,1,1,0,402,23,1,62,62,0,2790,2792,2,60,60,0,100
cb684b1a6667c7fe2092e4d4490d619d4eb95839,0,0,0,0,0,0,0,0,0,0,0,0,0,0,499,1,0,0,0,0,0,0,0,0,0,100
0906d17e54e880ca3295dd0ce547aa203bcf702b,3,82,3,79,1,0,1,14,34,173,1,3,1.55899379,612,71,4,127,120,7,4090,3704,386,55,55,0,99.95232041
8576a9bbd34c735a86869cb292cfcb559e4f1942,6,132,36,96,0,0,0,1,31,76,2,1,1.967210458,2823,24,2,640,615,25,19121,18286,835,339,327,12,100
0b86e8741b748f2479707d1beb006df20ff1c8d8,1,2,3,1,0,0,0,3,4,56,1,1,0,130,25,3,6,6,0,823,825,2,4,4,0,100
bc40b40bc891e49fe2b8e41afbba6c240e474395,0,0,0,0,0,0,0,0,0,0,0,0,0,0,26,4,0,0,0,0,0,0,0,0,0,100
e8ffe99aabf345adca5b569426e126fc142ef30d,0,0,0,0,0,0,0,0,0,0,0,0,0,0,16,5,0,0,0,0,0,0,0,0,0,100
32cb61ff3748f01cf1a3cd1806264b26848e9c27,2,126,1,125,0,0,0,1,10,110,1,2,0.82650864,1202,27,4,430,360,70,8603,8045,558,56,56,0,100
0c8847ff7d255f9c580822f2580d072cc43a77cf,3,132,55,77,1,0,1,1,34,145,2,2,1.153510417,1147,17,2,139,135,4,9334,8966,368,60,57,3,99.9364676
dee987ab2b3a4158b57274ff4314daf4d5467b1c,4,39,37,2,0,0,0,4,87,114,2,2,1.844746506,1397,18,3,249,248,1,10606,10647,41,63,62,1,100
d88dae8c5013711101b1cae7e8c5df782ac2edc0,0,0,0,0,0,0,0,0,0,0,0,0,0,0,28,5,0,0,0,0,0,0,0,0,0,100
175af88429d8c4aa04bd74f99edaaeb92740aa8f,2,44,36,8,0,0,0,5,8,1386,2,2,0.995938608,226,111,0,26,28,2,1413,1308,105,13,13,0,100
98c805e324688c5470b20c9721ba4d72b0b0c39d,6,572,226,346,0,0,0,3,15,321,1,2,1.88390125,1624,47,0,285,264,21,11817,10720,1097,101,90,11,100
582052873a054154c06cfa0baa2105f54398a0e0,2,63,67,4,0,0,0,2,3,888,1,2,0.805125007,639,72,1,87,88,1,3950,3860,90,29,29,0,100
ce8493c72b8c56490d54dddfcd015a599477eac2,1,8,4,4,0,0,0,15,88,20,1,1,0,1078,19,3,221,221,0,8267,8258,9,54,54,0,100
205c84e0604eca3329209aefb0f1a84757d7c5d7,0,0,0,0,0,0,0,0,0,0,0,0,0,0,48,1,0,0,0,0,0,0,0,0,0,100
2f62fd30d824e772b293643c686a11fb70608653,1,60,60,0,0,0,0,2,2,206,1,1,0,438,25,0,33,33,0,3922,3922,0,25,25,0,100
75eef006d60308d8285fcaaabaa75abb6f3a86c2,115,4955,142,4813,31,0,31,7,89,994,3,23,5.875642256,34654,112,1,6769,6264,505,280890,256290,24600,2228,2052,176,92.31367466
507d5919b1e901ac308dbaf1fb95c404c388a8f5,4,132,6,126,1,0,1,2,34,155,2,3,1.926872054,1094,73,1,207,198,9,8484,7757,727,81,77,4,99.95621237
1f7fedb484eb464e7f083d8ea73af712b6537b05,4,6,75,69,0,0,0,10,90,244,3,4,0.839995836,1791,74,2,298,308,10,12125,12597,472,100,104,4,100
91d63104f83ac0e582134ea3d148986fc373a79d,1,97,21,76,0,0,0,8,25,11,1,1,0,645,500,0,144,132,12,5338,4910,428,41,40,1,100
2e3f516da54925416c07180c4243808789419a50,2,293,79,214,1,0,1,1,24,104,1,1,0.823811633,251,501,1,35,26,9,3132,1954,1178,22,14,8,96.02128431
2a16fe84d4543ee73da7a532ad781f188f5b992a,0,0,0,0,0,0,0,0,0,0,0,0,0,0,113,2,0,0,0,0,0,0,0,0,0,100
76e64241f49f11948e1e96a4b8d1ce936b5d8928,2,12,8,4,0,0,0,3,4,361,1,2,0.468995594,423,345,0,57,57,0,2499,2434,65,16,16,0,100
d9c9d8806bb70dc5c054636b62987d776e5a305b,10,705,672,33,0,0,0,2,83,603,2,7,1.478678766,4121,75,3,681,665,16,32153,31404,749,171,165,6,99.95945398
4eb91aab44f7ed1c4d9884dc8c3a0ff725a44dc2,1,2,1,1,0,0,0,8,21,448,1,1,0,204,114,2,43,43,0,1567,1565,2,11,11,0,100
7c3028ede1e81fec00745975276bd8e90a4bf7ae,1,65,67,2,0,0,0,7,18,20,1,1,0,436,26,1,71,71,0,3253,3253,0,21,21,0,100
577701d2e1fc7c40efbbb901a139b66631721553,2,130,4,126,0,0,0,7,26,574,2,2,0.879458774,1442,76,4,219,207,12,12554,11732,822,74,72,2,100
7bf9c44a5f3e5b748307d42e2b36311e626ac94e,1,44,8,36,0,0,0,12,29,29,1,1,0,532,77,5,151,141,10,3548,3422,126,31,30,1,100
df3c746ae847a061b21a7ce5230c86bd290195d5,1,2,2,0,0,0,0,5,8,1539,1,1,0,163,78,6,38,38,0,970,968,2,19,19,0,100
820347f3a4b4478e48ac46614c3d640088490e6c,12,57,52,5,0,0,0,5,149,1095,1,9,3.416354454,5083,79,7,1013,1013,0,37211,37165,46,312,312,0,100
5092ae48e097433d77062fd95e1f2f300401f4d6,0,0,0,0,0,0,0,0,0,0,0,0,0,0,20,0,0,0,0,0,0,0,0,0,0,100
1eab245b945fea04670379eed2e3708e1e092d0e,13,88,3,85,0,0,0,2,150,463,2,5,3.400113799,3915,346,1,736,726,10,26510,26234,276,388,379,9,100
dcd296889fefe8258ff3ccc8d7d6a84eb7093117,0,0,0,0,0,0,0,0,0,0,0,0,0,0,21,1,0,0,0,0,0,0,0,0,0,100
b2ec6d2a85435aed7429eb04dd5387dcf943afff,2,107,7,100,0,0,0,10,15,52,2,2,0.629249224,558,502,0,77,63,14,3908,3333,575,41,34,7,99.8511502
dea06f612e0639f3c9164a55d7c76bab57ed21c6,0,0,0,0,0,0,0,0,0,0,0,0,0,0,27,1,0,0,0,0,0,0,0,0,0,100
9445cce6e6792faac80bcb7241a8b2dcd516a114,2,38,56,18,0,0,0,16,51,109,2,2,0.998693408,2474,80,5,300,293,7,22614,22859,245,80,80,0,100
e22560d2162c4cd6408b90e7b4c919c2cce5aac0,1,11,0,11,0,0,0,5,23,127,1,1,0,1794,347,1,134,133,1,6425,6393,32,120,119,1,100
29233ec65f01cbed8ca81a2db911107415302f84,38,3370,749,2621,8,0,8,1,111,581,3,12,4.443591191,14770,18,0,2936,2677,259,121994,104239,17755,1247,1094,153,98.20153061
0abde73ca55a152b6f448e49ec85516eaae5620e,1,2,0,2,0,0,0,16,82,195,1,1,0,824,503,1,142,142,0,6045,6038,7,22,22,0,100
6fc21ba6436c31674c514c84488495879ee39a3d,4,81,20,61,0,0,0,6,16,236,1,2,1.926787276,1426,348,2,193,187,6,8626,8320,306,85,83,2,100
00b0c384621e7ddbe52f17ba2b6835b35e351ccf,2,143,47,96,1,0,1,1,5,1566,2,1,0.846701712,369,81,5,72,57,15,2678,2132,546,21,16,5,99.95180142
c86e70701b6e08146083f78c51e17bdc75f941e0,1,1,1,0,0,0,0,10,24,0,1,1,0,738,504,2,163,163,0,5412,5399,13,80,80,0,100
df955c7ad7fdc171a6bdf839a98cc071f078537e,7,18,25,7,0,0,0,4,14,707,1,3,2.546067745,1039,82,6,188,188,0,6644,6774,130,90,90,0,99.89164459
7bd6f27d252d1b0ac531cbaa8021ddfc3350a75b,3,249,87,162,0,0,0,17,63,237,2,2,0.626072313,1817,349,3,339,313,26,15469,14447,1022,140,126,14,100
b86b13c7881ff7326a13021cf56a228271e200fc,2,57,0,57,1,0,1,3,3,834,2,2,0.74248757,140,19,1,17,11,6,1615,1207,408,14,11,3,99.95189417
caf26e23d044f539358e67b3687b3bedbaef06ac,0,0,0,0,0,0,0,0,0,0,0,0,0,0,29,0,0,0,0,0,0,0,0,0,0,100
5b3a72dffdaac9624f110ebd30c6607c0d9ae7ef,2,24,1,23,0,0,0,17,53,199,2,2,0.40217919,1555,30,1,189,187,2,10827,10642,185,118,116,2,100
7548a6e5c79e8b14cacfe0832d2834aa1a324f39,12,44,14,30,0,0,0,17,112,867,3,7,3.090721121,7330,505,3,971,959,12,60048,59831,217,325,321,4,100
68ec9013e14b9263662ad0c4561c372d6613a5cd,1,1,0,1,0,0,0,16,53,0,1,1,0,2150,506,3,233,233,0,20637,20630,7,68,68,0,100
81d099bbee2004147beb5f581efa32482eeac190,0,0,0,0,0,0,0,0,0,0,0,0,0,0,22,0,0,0,0,0,0,0,0,0,0,100
dee29654575d32b3e124371f9be4af3884f4c905,1,10,10,0,0,0,0,1,3,146,1,1,0,229,31,2,57,57,0,1599,1619,20,18,18,0,100
65ef0e51e1098d16d59948d95f4881cd7ea9df42,2,103,80,23,0,0,0,3,4,356,1,1,0.9518811,359,32,3,40,40,0,2877,2529,348,25,22,3,100
6c9ecad63c1d670b1f073addc64eb353980b3477,10,104,114,10,0,0,0,6,32,1514,2,3,2.982708111,2965,83,1,508,518,10,20421,20716,295,163,167,4,99.66414777
a979ed277c79c69b8228b60b311e0a58e6cb75f6,0,0,0,0,0,0,0,0,0,0,0,0,0,0,84,1,0,0,0,0,0,0,0,0,0,100
18ab07e1942bc3c333217687153c47235ffa1b0f,1,15,11,4,0,0,0,5,8,9,1,1,0,210,85,2,33,32,1,1264,1242,22,6,5,1,100
b2be3d2478820f15c108e5771275cb60f4dcbf00,0,0,0,0,0,0,0,0,0,0,0,0,0,0,20,1,0,0,0,0,0,0,0,0,0,100
9f6e40fe39012b2a803ff01203e1e725fe50db68,1,4,0,4,0,0,0,21,151,74,1,1,0,1033,86,3,212,211,1,7460,7453,7,86,86,0,100
22b27cc5025818243f2473a48fbb0d4eb2fb4357,0,0,0,0,0,0,0,0,0,0,0,0,0,0,507,2,0,0,0,0,0,0,0,0,0,100
9fe6e2e186b3e99d1028f4e1d38a3b1a1b3d696e,1,74,75,1,0,0,0,2,3,815,1,1,0,187,33,4,7,7,0,1921,2009,88,6,6,0,100
ca4feeb2912c928dd9095d03b0bf9eef95d09a05,27,452,576,124,0,0,0,3,92,281,2,12,3.339806632,14528,34,3,2649,2651,2,108212,109237,1025,920,917,3,99.92821249
2a9b5c0aba7fce20148155eefab31606e2db2265,0,0,0,0,0,0,0,0,0,0,0,0,0,0,350,0,0,0,0,0,0,0,0,0,0,100
de632b9dcc98169a4ef632fec0609801fe74141f,1,20,0,20,1,0,1,1,1,0,1,1,0,0,35,4,1,0,1,42,0,42,1,0,1,99.97608228
dc7dff0337f4e23f35d464fba3d53306b501c2e3,0,0,0,0,0,0,0,0,0,0,0,0,0,0,21,1,0,0,0,0,0,0,0,0,0,100
0e6b08fe13200d0088df6b622d0f1b5ed2c1017d,4,47,13,34,0,0,0,13,36,93,2,3,1.864167303,2084,36,5,485,474,11,14603,14326,277,104,103,1,100
9581e39bc905d2cd68883b0d8b612da6074067a4,6,946,79,867,0,0,0,3,17,108,1,2,2.161203687,1872,49,0,376,266,110,15928,11305,4623,123,108,15,100
dd6efba0a58d60a9226282a94209be1d007637a7,2,57,14,43,0,0,0,8,25,486,2,2,0.769820581,363,23,0,43,40,3,2609,2340,269,27,25,2,100
07d6d32598a0ffd20e2dcbd944543b4d465a448e,1,11,1,10,0,0,0,4,4,1557,1,1,0,34,37,4,4,2,2,184,139,45,4,2,2,100
9f62ec89fdad623e5ca3afa0a9c1c76a5c07ea8e,0,0,0,0,0,0,0,0,0,0,0,0,0,0,87,3,0,0,0,0,0,0,0,0,0,100
0635baae8bf0fb5c0353311b3fc64b319ecf01e0,0,0,0,0,0,0,0,0,0,0,0,0,0,0,88,4,0,0,0,0,0,0,0,0,0,100
7303464a4cc8e0698ac14e816be5c1e51f525ce9,2,21,2,19,0,0,0,8,24,222,2,2,0.426228657,889,115,0,90,89,1,8402,8379,23,45,44,1,100
d023d43638ae493edf720cef7bed9c84ba4c6be7,0,0,0,0,0,0,0,0,0,0,0,0,0,0,50,1,0,0,0,0,0,0,0,0,0,100
f19baf2c3deeae668f03cc7ec94a98b5f27e9cd3,1,1,1,0,0,0,0,5,5,818,1,1,0,207,38,5,28,28,0,712,716,4,19,19,0,100
bf4de984a21a3725113fb8e1f0c1d95f20d0f79f,3,62,14,48,0,0,0,2,6,71,2,2,1.334637288,489,39,6,80,73,7,3097,2784,313,22,22,0,97.8817734
bd963a013ced216635ffec1e7492fcc412c78204,16,288,149,139,0,0,0,5,35,767,3,6,2.898956716,6706,89,3,570,571,1,54164,53638,526,314,315,1,99.1065563
5aeaf0fe68e12c4fbf26c6673f5807dd7b8a4db9,0,0,0,0,0,0,0,0,0,0,0,0,0,0,90,4,0,0,0,0,0,0,0,0,0,100
23f758a0c611d1eb51f75cfbb229ff0b86210d66,1,100,0,100,1,0,1,1,1,0,1,1,0,0,91,5,12,0,12,427,0,427,2,0,2,99.05437352
d396df7c5402a93204d710714802998064da0eff,1,19,0,19,0,0,0,17,65,63,1,1,0,883,351,1,169,168,1,7071,7033,38,83,82,1,100
ba75369d30d04ee736806aded0e069d993ec5585,0,0,0,0,0,0,0,0,0,0,0,0,0,0,51,2,0,0,0,0,0,0,0,0,0,100
053ddeeeb94f87213d948db05cbc6928c63c6cc0,2,2,2,0,0,0,0,5,19,937,1,1,1,4255,92,5,514,514,0,31136,31160,24,204,204,0,99.98731286
fe6e8ec7b8edc760edd74f5326bc5b455abe5c59,0,0,0,0,0,0,0,0,0,0,0,0,0,0,22,1,0,0,0,0,0,0,0,0,0,100
009041450708dbcc64a47eab99fdd2cf829477b2,1,6,6,0,0,0,0,9,28,117,1,1,0,731,24,1,151,151,0,5549,5549,0,42,42,0,100
8c4f5f6aa83f0f38e5bc98f013ed3d9441577777,0,0,0,0,0,0,0,0,0,0,0,0,0,0,25,2,0,0,0,0,0,0,0,0,0,100
42791ad3022fd4926609026f5b3695c6b1f8d7c1,3,13,5,8,0,0,0,17,93,60,2,3,1.530493057,1345,23,2,267,265,2,10104,10046,58,82,80,2,100
7b1b64625ae5b376daaaf8bad7b334d44973fcda,0,0,0,0,0,0,0,0,0,0,0,0,0,0,24,3,0,0,0,0,0,0,0,0,0,100
7ddb6b0e803db56ba269e465cdd20302fa22c15e,2,6,4,2,0,0,0,6,83,146,2,2,0.970950594,941,40,6,152,153,1,6661,6768,107,29,30,1,100
9bd30babcac618cca963b0b9534dfadea07077ef,0,0,0,0,0,0,0,0,0,0,0,0,0,0,41,7,0,0,0,0,0,0,0,0,0,100
46fd9f41ea36bcc0e102ffaa54c2236ce20fbeae,0,0,0,0,0,0,0,0,0,0,0,0,0,0,42,8,0,0,0,0,0,0,0,0,0,100
06738816e4fdda80afed3fc642bfbd945d5c65b8,0,0,0,0,0,0,0,0,0,0,0,0,0,0,43,9,0,0,0,0,0,0,0,0,0,100
67b8e21674ea1ccd88009098e2683cf5ecb53125,5,33,0,33,0,0,0,5,55,1440,2,4,1.76021847,3260,44,10,425,421,4,27933,27779,154,159,157,2,100
5359895d0260c293dcf05918f107e1e257a591bd,5,0,33,33,0,0,0,5,56,0,2,4,1.76021847,3280,45,11,421,425,4,27779,27933,154,157,159,2,100
85f55a9f7b300acdd8216cd388f4ec6cd7ab482f,0,0,0,0,0,0,0,0,0,0,0,0,0,0,46,12,0,0,0,0,0,0,0,0,0,100
afb064174bb891420a31d6de52fddd40fb21123d,3,180,171,9,0,0,0,5,11,0,2,3,1.432304536,956,47,13,157,156,1,6178,6137,41,77,76,1,100
9657dcf81f5fb96ffd2da87962af96bd0da63679,2,15,0,15,0,0,0,16,57,0,2,2,0.721928095,2304,48,14,267,265,2,21712,21642,70,82,81,1,100
9f6618e5f6aacfae562c1eda7e17f65fcbec577f,2,61,13,48,0,0,0,6,9,1590,2,2,0.956888666,1477,49,15,299,289,10,10487,10171,316,41,40,1,100
b722a19e83011cde7b8afb1055eb62c7ffbcf8b6,0,0,0,0,0,0,0,0,0,0,0,0,0,0,50,16,0,0,0,0,0,0,0,0,0,100
1fb3904868ce5653e3bf9b35797cc591daca79f0,1,5,1,4,0,0,0,8,12,654,1,1,0,158,508,0,34,33,1,812,801,11,21,21,0,100
16968b6287f38f44e0062dd8e00e1d8dd19b5966,0,0,0,0,0,0,0,0,0,0,0,0,0,0,509,1,0,0,0,0,0,0,0,0,0,100
7e5bcd4260ba6591c38ee0c236d843812197ba6f,0,0,0,0,0,0,0,0,0,0,0,0,0,0,510,2,0,0,0,0,0,0,0,0,0,100
fa4a1e761647d4e975d8af80c3f7bcbb072bd746,1,2,2,0,0,0,0,1,2,384,1,1,0,103,511,3,26,26,0,707,707,0,2,2,0,100
99cb03605597660ae7658d9a2b4c5b9c269aff93,4,283,27,256,1,0,1,1,14,1012,2,3,1.322508913,1259,51,14,441,415,26,9288,8007,1281,61,46,15,99.93652406
d0e8c745e0ef6ee9b0e0c04e671e50c9bf87b8c7,0,0,0,0,0,0,0,0,0,0,0,0,0,0,25,3,0,0,0,0,0,0,0,0,0,100
9885c47011fd9fa0c6089f260c15d0527531a953,2,171,169,2,0,0,0,14,30,56,1,1,0.721928095,1325,52,3,93,93,0,9748,9696,52,43,43,0,100
9cb3f4f2f929e0867c816b805672f1d003941dcd,1,1,1,0,0,0,0,3,8,17,1,1,0,172,52,15,28,28,0,1005,1005,0,7,7,0,100
2a4fa8be464f6d87bc4d4f0fd6103619c37dc5a6,3,19,27,8,0,0,0,6,16,337,2,2,1.325784781,1741,26,4,457,462,5,12055,12088,33,83,83,0,100
499798cdb4e6f2d3fe947df036c21b1c86452c9e,0,0,0,0,0,0,0,0,0,0,0,0,0,0,27,5,0,0,0,0,0,0,0,0,0,100
99ef4e104a126a3181849dd6172f7cd3b92083f4,2,53,59,6,0,0,0,4,37,54,1,1,0.885612871,678,28,0,54,55,1,5407,5448,41,40,41,1,100
7d538167086a3317a24e0ab8cbc084ecf136e3e9,0,0,0,0,0,0,0,0,0,0,0,0,0,0,29,1,0,0,0,0,0,0,0,0,0,100
7322d69ccc69af17e8c72f6d9e05a3b86da79219,1,2,0,2,0,0,0,17,84,32,1,1,0,825,53,13,142,142,0,6064,6046,18,22,22,0,100
29d097613708eb0ea488d56417d824ad8660e0f8,2,21,2,19,0,0,0,3,10,889,2,2,0.426228657,714,0,0,101,99,2,5203,5116,87,26,25,1,100
bc8abe6877092cd1504bc7071b1cd1b1df4c3961,4,130,113,17,0,0,0,12,32,136,1,3,1.069984006,1188,30,2,305,301,4,7471,7330,141,118,117,1,100
09fe98c255917b04c0c9d1d981cad5812930d8de,2,142,160,18,0,0,0,13,36,1498,2,2,0.691813865,992,54,14,60,63,3,7641,7542,99,43,44,1,100
796e7134d99642496dfc58f66c1b3708e57f154d,2,5,32,27,0,0,0,3,7,44,2,1,0.956888666,491,1,1,70,79,9,2793,2983,190,19,21,2,100
be151836b102d0a719756e1bc30f62ece7df7b32,2,92,4,88,0,0,0,7,11,454,2,2,0.776555785,1067,2,2,111,107,4,7828,7380,448,38,37,1,99.62891875
8154010070ddce41c78309d7002d3cd4a1e6bdb6,2,173,209,36,0,0,0,1,13,946,1,1,0.3781139,733,31,3,40,34,6,3689,4378,689,33,28,5,97.02770182
286ba8b31059f2393df2cffab7cd250d47d9201d,9,69,68,1,0,0,0,1,59,1279,1,1,2.482419328,3665,512,4,372,372,0,29482,29174,308,163,163,0,100
8fe9eda34af600a22685472e96d63f4b69054a7c,10,93,73,20,0,0,0,5,43,910,1,1,2.65763886,3880,513,5,302,305,3,30320,30204,116,158,158,0,100
3c754eff1d8e13ebc1ff77c9436ce6e59ccdb751,5,215,180,35,0,0,0,5,49,587,1,1,1.797647787,3821,514,6,285,280,5,33019,32458,561,193,192,1,100
7850dc707c3ef9530fc88e616f5e3f7238b89dc9,2,42,15,27,0,0,0,18,55,156,1,2,0.998000884,1429,515,7,266,265,1,8984,8864,120,78,78,0,100
12ec8ce92eecc68099e8053394f6f0823783733a,1,1,2,1,0,0,0,11,21,78,1,1,0,293,516,8,40,41,1,2088,2123,35,20,20,0,100
780b63432d6603f09f8c9f248bc83436c25a3f59,0,0,0,0,0,0,0,0,0,0,0,0,0,0,517,9,0,0,0,0,0,0,0,0,0,100
213b4aee972340753db2cafc69f1c7177c1c3f29,1,5,1,4,0,0,0,3,4,1631,1,1,0,130,518,10,1,1,0,192,176,16,1,1,0,100
ff88c0ac1bffde8e48fca5b759086c59f2d0927c,1,1,1,0,0,0,0,3,5,0,1,1,0,134,519,11,1,1,0,198,192,6,1,1,0,100
4cf44f7d8f867a0e6025f534efb9e7c03a467816,4,270,11,259,2,0,2,14,34,31,2,2,1.264504287,1082,3,3,186,158,28,10472,8831,1641,79,67,12,99.94486713
2d59c422b412397c8b53d76bc67a234565641b56,0,0,0,0,0,0,0,0,0,0,0,0,0,0,0,0,0,0,0,0,0,0,0,0,0,100
a6c18b167500a5ce7d78dede5bb0d45647c92bd9,2,11,3,8,0,0,0,16,85,63,1,2,0.749595257,1356,1,1,245,244,1,9225,9214,11,75,74,1,100
7c8ae0a7f8dba1ccdc0f518df9324cb2f6f1e421,1,10,11,1,0,0,0,10,29,44,1,1,0,731,2,2,151,151,0,5549,5549,0,42,42,0,100
344c3608f7cf76380a6e30490ab0ec7055fb3ac6,4,13,10,3,0,0,0,9,152,483,2,3,1.914170111,2891,3,3,457,455,2,21900,21884,16,200,198,2,100
356bdea0c46e1266a2988c67efcc7a301131895e,1,1,1,0,0,0,0,17,50,2,1,1,0,1057,520,12,89,89,0,7751,7747,4,66,66,0,100
9662f50e72a7c1f69d65315ddc0569e5d1b62f7f,0,0,0,0,0,0,0,0,0,0,0,0,0,0,352,0,0,0,0,0,0,0,0,0,0,100
74d56edb83120dc8f4fe4499a352f87de12a9b88,1,5,6,1,0,0,0,9,16,32,1,1,0,1130,4,4,390,390,0,7282,7265,17,38,38,0,100
05297edc12f700d9eed075156d0c3c20a6b0c99f,60,5026,5897,871,0,0,0,5,35,1545,1,1,5.039496799,16886,4,4,1618,1770,152,131937,138006,6069,724,746,22,99.79072585
65b4fe5bb8d366a863a90d1d47bedad1229db9c6,4,70,9,61,0,0,0,8,37,729,1,2,1.208297086,3357,5,5,273,264,9,29887,29495,392,164,161,3,100
8abdccd57ddd82522f286a61036ecb532aa6d6d3,1,4,2,2,0,0,0,9,29,798,1,1,0,400,5,5,57,56,1,2588,2577,11,12,12,0,100
dff83cdac187954b662da6c3369610ccbe6b3290,2,59,40,19,0,0,0,2,4,708,2,2,0.561028486,243,26,0,59,59,0,1391,1393,2,30,29,1,96.2479062
bb4906863b2443c3d4b733aa839c540e86f8dcef,48,5804,6522,718,0,0,0,4,22,1071,1,2,4.44934872,16387,6,6,1436,1518,82,122494,124358,1864,808,838,30,95.17152256
718819314488effef719a308ba7d1eaa25263beb,0,0,0,0,0,0,0,0,0,0,0,0,0,0,7,7,0,0,0,0,0,0,0,0,0,100
4b3c860e565b16f6c1a93ef361df1674d53f21d9,67,0,5410,5410,0,0,0,2,3,1670,1,16,5.643758343,4261,8,8,0,598,598,0,25028,25028,0,316,316,98.18678589
e2e203d575185d905f3b57e0fe356e42fa60d1fb,2,5,1,4,0,0,0,2,94,129,1,2,0.918295834,1326,353,1,268,266,2,10051,10034,17,76,76,0,100
bdd84a3bb71610ef7b678cc77c5469b6bcc72c2e,0,0,0,0,0,0,0,0,0,0,0,0,0,0,9,7,0,0,0,0,0,0,0,0,0,100
1060f2975ee0c4ff49e0e48320469c4bc91f09e9,0,0,0,0,0,0,0,0,0,0,0,0,0,0,10,8,0,0,0,0,0,0,0,0,0,100
9164fa9465e8ab098c0b33c5e0d6175eeeec3e3c,1,6,1,5,0,0,0,23,153,40,1,1,0,1038,11,8,214,213,1,7514,7495,19,87,87,0,100
0d4cf0d2a5396ca6dacac8d4341d2e695cc14131,5,395,320,75,0,0,0,7,36,991,2,2,1.751590964,2248,55,0,461,450,11,15407,14778,629,190,187,3,99.96204934
3d4ecd4d9e57ca304ae3529808059de28d61b4c9,2,81,9,72,0,0,0,4,22,309,2,2,0.929008368,352,6,1,60,53,7,3069,2593,476,21,17,4,96.51134423
924c54f93f0d209e49001abdb862dcadd12b3d54,4,331,29,302,2,0,2,2,18,251,2,3,1.88111042,635,12,8,140,127,13,6351,4974,1377,69,56,13,96.13839575
8ce2b0e375621b153e1322e81822cbdd71c94df4,2,82,3,79,1,0,1,1,2,132,2,2,0.368115005,61,116,0,12,6,6,1136,623,513,8,4,4,99.97119816
f775e0b852febff80ae0387db58b797a1752d069,0,0,0,0,0,0,0,0,0,0,0,0,0,0,117,1,0,0,0,0,0,0,0,0,0,100
122852c3ca2d2b50268c85a6f02b66fc5b50ed38,2,471,38,433,1,0,1,1,30,28,2,1,0.99330464,731,27,1,206,151,55,8478,5549,2929,70,42,28,99.97121474
cfe33d726ad083f1e6dea139d081d11931eea7e5,1,29,16,13,0,0,0,10,31,23,1,1,0,831,28,1,180,178,2,6337,6302,35,49,47,2,100
844cf28e3d4d145d8f9b43861cc89a7ea9ec37ba,3,30,31,1,0,0,0,17,84,226,2,3,1.03052797,2715,13,1,323,322,1,24648,24664,16,86,87,1,100
5fe9ddff4a64480d7014f61cd5b77de90076a6fd,1,68,0,68,1,0,1,1,1,0,1,1,0,0,14,2,3,0,3,350,0,350,2,0,2,99.9712313
0bd28f02f8738280a1b6b6507bb4ec6c54a095bc,1,14,3,11,0,0,0,3,3,246,1,1,0,286,15,3,52,50,2,1876,1827,49,33,33,0,100
468db48aed514566df682dc1e247e9585d5673ee,0,0,0,0,0,0,0,0,0,0,0,0,0,0,16,4,0,0,0,0,0,0,0,0,0,100
63173e2472d72812895bc124d827682c097f2bbd,1,0,4,4,0,0,0,17,59,6,1,1,0,2155,17,5,233,233,0,20661,20684,23,69,69,0,100
0da67fb1bb8a3ed1469a0c112bc64b301049fb25,0,0,0,0,0,0,0,0,0,0,0,0,0,0,7,1,0,0,0,0,0,0,0,0,0,100
bc8cdcd4c7fe3d3185e6e11585e59dc5847ebd35,0,0,0,0,0,0,0,0,0,0,0,0,0,0,18,6,0,0,0,0,0,0,0,0,0,100
333f1ec2b6b216f3bf3cae30df534b7257ffb719,2,75,3,72,0,0,0,3,4,1808,2,2,0.477071306,390,8,1,44,39,5,3161,2656,505,17,16,1,100
2b14075650e36f71be4eae4c326481dd2545c643,2,49,22,27,0,0,0,9,33,251,1,2,0.992976887,699,93,0,160,154,6,4824,4689,135,56,53,3,100
84a2665b19111576847f28ff05f73ba1479ab610,2,83,85,2,0,0,0,5,23,1979,1,2,0.222284831,487,32,0,101,101,0,3105,3108,3,47,47,0,100
a86ea72ded62baca3019f7ce630531a1fe115228,2,24,2,22,0,0,0,7,19,171,1,2,0.840358672,1414,19,6,189,186,3,8372,8209,163,78,77,1,100
728a30672493e268801aefcc585a8bce1dc39bcf,15,26,28,2,0,0,0,10,56,327,1,9,3.466945372,4638,20,7,1065,1065,0,30833,30833,0,598,598,0,100
b350382d3b174437ee7949647310f3d3c33a489a,1,40,36,4,0,0,0,10,34,11,1,1,0,279,56,0,61,60,1,1816,1801,15,22,22,0,100
2149312ac233ebaa8f943db83aada3dfe087f13e,1,1,2,1,0,0,0,10,32,45,1,1,0,837,29,0,180,180,0,6337,6337,0,49,49,0,100
06406cbc2a38c7efc86392a05dd15ac28ee1b743,3,82,52,30,0,0,0,7,55,313,2,3,1.568607829,1045,21,4,168,164,4,7847,7677,170,68,68,0,100
f4856229468d3cd0849ea8b58b72794376b17d5b,0,0,0,0,0,0,0,0,0,0,0,0,0,0,22,4,0,0,0,0,0,0,0,0,0,100
3104af48addb2becce144258bf1b5aa413b0d233,1,43,25,18,0,0,0,4,6,137,1,1,0,134,23,5,0,1,1,157,198,41,0,1,1,100
f2b759d5019603c080e77d97f5f4e8b091939f94,4,195,47,148,1,0,1,9,86,390,2,4,1.728686612,1574,57,1,256,245,11,11790,10890,900,67,61,6,99.75461894
2ff4b6f6069ad1a9c51ff71fd4f0d53dde081918,0,0,0,0,0,0,0,0,0,0,0,0,0,0,58,2,0,0,0,0,0,0,0,0,0,100
ac7aca451aa02272c98f27557fbbad165f75fa90,1,27,16,11,0,0,0,3,3,2375,1,1,0,173,24,5,26,25,1,1425,1327,98,24,23,1,100
c1ac2e1cc9140916bb925d7d1ec7cae2b9e198da,4,13,9,4,0,0,0,17,66,374,1,1,1.936260028,2907,521,0,388,388,0,22923,22923,0,204,204,0,100
a429a0f4f91e20e7c669c13cf5e4585b7912a909,3,204,171,33,0,0,0,18,67,12,2,2,0.890475972,1707,59,3,286,284,2,13512,13188,324,133,132,1,100
07b1ad472becde98d8026fe50d88b68d2fa65f6e,1,104,73,31,0,0,0,6,12,1242,1,1,0,421,33,1,20,17,3,3173,2846,327,17,15,2,100
efdbfd458c1c77dba3827823d190d8e9ed744180,1,3,0,3,0,0,0,3,7,261,1,1,0,69,25,6,5,5,0,599,581,18,3,3,0,100
ebcffc0693238372fdda709b191e248cc262422c,1,26,4,22,0,0,0,9,34,280,1,1,0,831,26,5,77,77,0,6888,6838,50,42,42,0,100
80d56436afd29ad207897ae2c5e6e656816a85e8,16,60,31,29,0,0,0,6,36,983,1,6,3.694463834,4489,27,6,961,958,3,28276,28147,129,388,385,3,100
46ac438edaf90a769a155c4693b81b5f504b2bcc,3,51,0,51,0,0,0,3,7,328,2,2,1.584962501,575,522,1,102,102,0,3834,3834,0,83,83,0,100
f005a7521f998b4e689db17b020e3f957e4bf0cd,2,41,3,38,0,0,0,4,9,592,1,2,0.439496987,342,9,0,89,85,4,2451,2272,179,28,25,3,100
86c01f81b08b6ced1e5955cfe2f55312711816a2,0,0,0,0,0,0,0,0,0,0,0,0,0,0,523,2,0,0,0,0,0,0,0,0,0,100
c27cccec7656c41cbdb493e97fe0981bb151eec0,0,0,0,0,0,0,0,0,0,0,0,0,0,0,524,3,0,0,0,0,0,0,0,0,0,100
b7aeb99f8f8fb0aa65cc91081905ec71e1bdf91e,0,0,0,0,0,0,0,0,0,0,0,0,0,0,28,4,0,0,0,0,0,0,0,0,0,100
0c2b4a3d9c09dc2fb3d831384765a95257f2f8db,1,1,5,4,0,0,0,11,33,61,1,1,0,837,29,5,179,180,1,6302,6337,35,49,49,0,100
88a21e7cd64a7e8b35a0937d12c2e50ff9b20802,0,0,0,0,0,0,0,0,0,0,0,0,0,0,30,4,0,0,0,0,0,0,0,0,0,100
d52623a89c77b55da6063fafbb4a00296bb1ee60,4,333,11,322,0,0,0,13,84,398,1,3,1.22996262,2689,354,0,372,319,53,14332,13381,951,311,259,52,99.91304348
e0fdb093d45570af7bcc1e1fa004609de1322b85,2,133,30,103,0,0,0,6,14,481,2,2,0.832432106,523,10,1,96,82,14,4261,3507,754,30,25,5,100
f4b4e19d80836b9d25fd2cba83009cb49f3910bd,2,19,3,16,0,0,0,17,60,256,2,2,0.976020648,2292,525,3,258,254,4,21424,21304,120,80,79,1,100
a22282fd94d668f7a9e0c7b3a2b87b0b6b1d7f79,1,2,0,2,0,0,0,3,3,791,1,1,0,192,31,2,30,30,0,1493,1477,16,5,5,0,100
071514fd8aad2a35a8d0abea87369842e87474ff,1,7,7,0,0,0,0,7,21,207,1,1,0,2923,355,1,248,248,0,21936,21920,16,170,170,0,100
2f4376afa218705d4c99a124726c53b71b194186,2,63,7,56,0,0,0,7,11,232,2,2,1,1272,60,0,217,206,11,9115,8739,376,41,40,1,100
8531aa3b59d1f4a47edee7359acf610a13547ed8,1,5,0,5,0,0,0,2,2,3422,1,1,0,43,32,1,11,10,1,245,233,12,9,8,1,100
5e62a35f75f8b0001908e417ea14d1efd3a3ce42,1,16,6,10,0,0,0,13,57,97,1,1,0,402,30,0,88,87,1,2786,2753,33,33,32,1,100
c2122143d01fe54598f260b0a6a3f9df40b43c8d,0,0,0,0,0,0,0,0,0,0,0,0,0,0,33,2,0,0,0,0,0,0,0,0,0,100
1ed6344b2bb16dd5d860ce6ec475c742ef634ea0,0,0,0,0,0,0,0,0,0,0,0,0,0,0,34,3,0,0,0,0,0,0,0,0,0,100
1b127670f355f472c33c75a868a29dfa4385e001,2,24,9,15,0,0,0,6,37,227,2,2,0.999337504,1418,61,1,297,294,3,11087,11018,69,101,99,2,100
1cbb525497ea36367aae10d06a87afa3270bae28,2,174,0,174,2,0,2,1,1,0,2,1,0.978449329,0,62,2,19,0,19,996,0,996,6,0,6,99.97101449
ca48f211f5012dc80ba4369c757941bf0a5d0244,1,10,7,3,0,0,0,4,8,1050,1,1,0,251,63,3,44,43,1,1767,1743,24,14,13,1,100
864058667f2f21cbec19cc564dd4b9081574f22d,2,28,0,28,0,0,0,2,2,2664,1,2,0.966618633,116,356,1,17,15,2,819,682,137,10,9,1,100
594eda25d0ef2beffca55cc72bb20e935b3f0b15,2,25,1,24,0,0,0,5,10,1290,2,2,0.89049164,669,526,0,84,83,1,5316,5198,118,34,33,1,100
6cde9f28fa5dea5ea7714f0c243c9ab43e7de668,5,505,455,50,0,0,0,2,25,1144,2,3,0.722304138,1214,64,4,129,121,8,11146,10882,264,64,59,5,100
c0499b1520fd7061aa57ea84bb67fad82f9243a8,1,6,9,3,0,0,0,15,37,83,1,1,0,476,65,5,96,96,0,2928,2938,10,47,47,0,100
20370a9f06786722992492a44ce08501decfdec2,23,414,0,414,1,0,1,2,7,408,2,10,4.523561956,833,35,4,104,104,0,6532,6532,0,54,54,0,100
90cb42f608828afd518975c2ad907eb21c2310bc,1,1,1,0,0,0,0,17,61,47,1,1,0,2160,36,5,234,234,0,20746,20746,0,70,70,0,100
cd971e99d6de721ca4590bbf3fba974a812c2623,1,5,0,5,0,0,0,7,13,1133,1,1,0,251,357,2,43,42,1,1658,1632,26,25,25,0,100
948f3cc03ce109613f3e1e426efc2fa2e4ac2448,64,2936,967,1969,8,0,8,8,95,518,2,19,4.53958311,21099,66,6,5226,4732,494,160907,148864,12043,1316,1215,101,96.17923866
abfe95b49ddf3a78397d1468a8d90f8a87d406d6,1,1,5,4,0,0,0,4,15,6,1,1,0,991,67,7,254,254,0,7343,7352,9,46,46,0,100
870c3435c24190f3aec6a7325a6aa62e49f2913c,0,0,0,0,0,0,0,0,0,0,0,0,0,0,31,1,0,0,0,0,0,0,0,0,0,100
f023c94902de3419f6af3b0e0e5a8b7d8fd07b30,0,0,0,0,0,0,0,0,0,0,0,0,0,0,32,2,0,0,0,0,0,0,0,0,0,100
c7e9d3891717fcb0bc0f171bbb617087702e33b3,1,1,0,1,0,0,0,17,113,381,1,1,0,2072,37,6,361,361,0,16819,16808,11,61,61,0,100
cd64fbb1704d2462b961d165d971c959353f7113,1,0,1,1,0,0,0,8,16,371,1,1,0,203,94,0,40,40,0,944,948,4,16,16,0,100
0662619ec86f8c885d2fa69d6c1b8f7ee8feb978,0,0,0,0,0,0,0,0,0,0,0,0,0,0,38,6,0,0,0,0,0,0,0,0,0,100
20b8ce526a1646acfb16354f7e8439a7fb1df2db,2,279,1,278,1,0,1,1,56,137,2,2,0.502066707,1041,39,7,224,201,23,7943,6589,1354,76,60,16,99.93188939
f91c43a31bb2e53b45642b5a4e3cf83b75570678,1,2,7,5,0,0,0,17,78,357,1,1,0,272,40,8,46,46,0,2013,2049,36,13,13,0,100
669d4e7ec76386c4216da0fe4f532460c0ef58e9,2,71,0,71,1,0,1,3,4,200,2,2,0.794102142,151,358,2,19,12,7,1635,1305,330,14,12,2,99.97278171
a764360f54766fdc4c97f9fca64a4614a50edf76,0,0,0,0,0,0,0,0,0,0,0,0,0,0,33,3,0,0,0,0,0,0,0,0,0,100
c681749e9adf841d677acf2227c1b69c43b57ddb,2,58,12,46,1,0,1,1,79,4,2,2,0.9905577,268,41,8,50,46,4,2314,2013,301,15,13,2,99.97279652
cc00f5ed002fc5127ad458234c4cad246ad96e99,2,17,9,8,0,0,0,7,20,324,1,2,0.89049164,1071,42,9,91,91,0,5839,5754,85,54,54,0,99.95921142
1e1a46ce0a70dfb9a3a75993954b68f9e36f87ac,1,50,9,41,0,0,0,23,154,249,1,1,0,1042,43,8,219,214,5,7578,7514,64,91,87,4,100
845a6b654232bacaa6ee2c6e04370c5f5ec97953,1,2,8,6,0,0,0,3,8,2036,1,1,0,93,44,9,12,14,2,525,559,34,3,3,0,100
43a3797e32ae08bcf973ddde1e76558a881eed89,1,1,1,0,0,0,0,5,5,1938,1,1,0,533,45,8,48,48,0,3582,3582,0,33,33,0,100
c24d86438b9841583c7e4aca991268b43d9ff1de,1,8,0,8,0,0,0,7,14,279,1,1,0,163,46,9,29,27,2,1322,1258,64,3,3,0,100
7fefa1a4c9512dbd02d05b3c9b37330f124e85a8,1,2,0,2,0,0,0,5,16,41,1,1,0,990,47,10,254,254,0,7350,7343,7,46,46,0,100
0321595beac922d7623127cb0c1be15b3d9090f6,3,258,88,170,0,0,0,3,8,251,2,1,1.25255457,2515,48,11,601,553,48,17768,16800,968,340,314,26,100
6017d9541d6ad92b94d488eafbb1429de2c48b21,2,19,60,41,0,0,0,1,80,16,2,2,0.999884415,304,49,12,46,50,4,2049,2314,265,13,15,2,99.97280392
c0263b132778f4178881edc5089b68d81137c685,1,2,3,1,0,0,0,7,10,308,1,1,0,404,11,0,65,65,0,2399,2395,4,18,18,0,100
b70ad158770f103272af174d31aa65bc9922f82e,2,70,23,47,0,0,0,10,35,180,2,2,0.999249248,1640,34,1,254,250,4,13688,13391,297,83,82,1,100
2112f02e5ed39ae49a183b11843f2c9eb44b972a,1,17,9,8,0,0,0,4,9,1823,1,1,0,199,12,1,33,32,1,1409,1333,76,9,9,0,100
dc8339e140283b88f273aa3d04a23ba8b945586a,0,0,0,0,0,0,0,0,0,0,0,0,0,0,50,9,0,0,0,0,0,0,0,0,0,100
dac2371a5213055f1f50599c3df7f0bcde272e95,3,47,3,44,0,0,0,15,155,607,2,3,1.197477624,1662,51,10,285,279,6,12579,12257,322,131,129,2,100
9ad30c1e02333f2e5f6c12ddfa03e13c40ca1c25,0,0,0,0,0,0,0,0,0,0,0,0,0,0,52,11,0,0,0,0,0,0,0,0,0,100
43a3cf523668e29e853d60b38dc5c8a8b279c0e8,0,0,0,0,0,0,0,0,0,0,0,0,0,0,53,12,0,0,0,0,0,0,0,0,0,100
147b8f536452dd97b2a9a716943f881b918d8f30,0,0,0,0,0,0,0,0,0,0,0,0,0,0,68,0,0,0,0,0,0,0,0,0,0,100
05472d8270d003ebf875de3d76ff67165e390a1c,1,29,6,23,0,0,0,9,23,188,1,1,0,623,69,1,67,64,3,4353,4074,279,24,23,1,100
3c24b63d2bc682976e22f1f3d8160ce9e0791cf5,0,0,0,0,0,0,0,0,0,0,0,0,0,0,70,2,0,0,0,0,0,0,0,0,0,100
87ea43f9631c188ad2f12d1ca224885dc549fcd2,1,5,2,3,0,0,0,3,5,1765,1,1,0,198,71,3,25,25,0,1357,1345,12,10,10,0,100
df5086983d5d51fa98c083e3ffaba056ab0638a1,2,2,0,2,0,0,0,20,156,30,1,2,1,2132,72,4,432,432,0,14417,14405,12,152,152,0,100
7e78434ee34497edc9992f359681e5c4424e2b88,1,4,4,0,0,0,0,9,19,275,1,1,0,507,73,5,117,117,0,3738,3728,10,52,52,0,100
a6aa628f428ab96a30baa2e59870b5de1f7faccb,0,0,0,0,0,0,0,0,0,0,0,0,0,0,74,6,0,0,0,0,0,0,0,0,0,100
24fff2946f9863520da93f38b29e050947375eef,1,2,2,0,0,0,0,20,58,0,1,1,0,1062,54,10,208,208,0,6704,6704,0,60,60,0,100
ae90e11225bd4a387cfa07907b10cd52a5157786,1,14,16,2,0,0,0,23,157,0,1,1,0,1072,55,11,224,224,0,7712,7713,1,92,92,0,100
035836860141f0973bceac9ba4e237c96ef04b8a,0,0,0,0,0,0,0,0,0,0,0,0,0,0,56,11,0,0,0,0,0,0,0,0,0,100
5b301021fdb2477b6495eb5a0e0b05dd6780ccac,0,0,0,0,0,0,0,0,0,0,0,0,0,0,35,1,0,0,0,0,0,0,0,0,0,100
846f585b2be1910722081b0ed94a7ccd65283372,0,0,0,0,0,0,0,0,0,0,0,0,0,0,36,2,0,0,0,0,0,0,0,0,0,100
c5c8311c9837d1621bef1cad8c52222fd7bf3bd7,0,0,0,0,0,0,0,0,0,0,0,0,0,0,37,3,0,0,0,0,0,0,0,0,0,100
ca50f69c75a482efcbe7753c827fae9fbb243e71,0,0,0,0,0,0,0,0,0,0,0,0,0,0,359,0,0,0,0,0,0,0,0,0,0,100
bdbcbf9a5fe36e7ca1c2fa236ddf204be844ab2f,2,31,28,3,0,0,0,3,8,521,1,2,0.964690083,135,57,10,14,10,4,1019,955,64,6,6,0,100
56d0ef1b8fedd1db1097e8c8b44f2df99cf9f689,1,19,12,7,0,0,0,17,81,39,1,1,0,272,58,11,48,46,2,2105,2049,56,13,13,0,100
5c39f8e65d3cd8c0d824c5f92b51ffdb9d9aa2d2,1,39,0,39,1,0,1,1,3,41,1,1,0,0,59,9,2,0,2,245,0,245,2,0,2,99.97280392
36f6ea0741061db0bcd76e56e863bebe94458857,0,0,0,0,0,0,0,0,0,0,0,0,0,0,38,4,0,0,0,0,0,0,0,0,0,100
b6ad5b770b325079ad58be7e049dee002c04993e,2,0,2,2,0,0,0,20,158,16,1,2,1,2134,60,10,432,432,0,14404,14416,12,152,152,0,100
4b636774b991528f029e6bce86ef5ec397b2b646,1,8,8,0,0,0,0,17,82,5,1,1,0,279,61,11,48,48,0,2105,2105,0,13,13,0,100
1683cd00e1f2d8e37d3feabfe2f18303deb835dd,2,5,3,2,0,0,0,7,13,785,2,2,0.811278124,501,62,12,70,70,0,3854,3849,5,26,26,0,100
c8a160aaaa3b09f3bcee0a2d2a530749baeefadf,0,0,0,0,0,0,0,0,0,0,0,0,0,0,63,13,0,0,0,0,0,0,0,0,0,100
79ad318fa3f3aed81e61f5508559de5e80b6efb6,1,14,7,7,0,0,0,11,36,43,1,1,0,839,13,1,183,182,1,6438,6390,48,49,49,0,100
1cd208eccc6a1ce1193285fbdffdc63b41dd43e9,1,39,25,14,0,0,0,7,16,459,1,1,0,285,95,0,62,60,2,1671,1620,51,25,24,1,100
d002f23542f7cd63f7e0db2f767241efad2607c1,1,18,14,4,0,0,0,19,85,277,1,1,0,522,39,4,87,86,1,3813,3794,19,15,15,0,100
22d7396bb2d82f4a38b8271102c23d23002d465c,0,0,0,0,0,0,0,0,0,0,0,0,0,0,14,1,0,0,0,0,0,0,0,0,0,100
fbe3c82a0018f8837e822e768cb3aa2e9ad6fc1a,2,39,2,37,0,0,0,4,5,275,1,2,0.659375881,479,64,14,44,42,2,2922,2782,140,40,38,2,100
cec10d656f747f54740ac82390afcd943fe7bc0a,4,1079,0,1079,4,0,4,1,1,0,1,2,1.825733171,0,65,15,127,0,127,5025,0,5025,46,0,46,99.82348948
86fdebe4efdaa221ce298bcb5cb0b96e14304b84,1,32,1,31,0,0,0,7,10,201,1,1,0,215,15,2,37,33,4,1386,1265,121,6,6,0,100
62fabcac56cec26c3f02c2036e016cd045cc4bcc,4,99,31,68,1,0,1,1,18,761,2,2,1.755783001,530,66,12,146,143,3,3672,3345,327,56,54,2,99.95932755
608af108b19425528029b9650c83af8a59cbaf84,0,0,0,0,0,0,0,0,0,0,0,0,0,0,16,3,0,0,0,0,0,0,0,0,0,100
1752a0cb6f6a2b99e61ad466860f0551a116bdca,1,9,7,2,0,0,0,20,86,12,1,1,0,526,17,4,88,87,1,3823,3813,10,15,15,0,100
c3ac556665989cd59e729bb6f97bd4f00598f646,6,310,211,99,0,0,0,1,159,155,2,4,1.64000916,6215,67,11,1053,1037,16,50455,49852,603,367,359,8,100
e8acb6ff10dd8108af33bf6afc60ca143cfc7802,4,91,23,68,0,0,0,14,85,307,2,3,1.556333233,3368,68,12,550,547,3,21052,20709,343,278,275,3,86.68527734
14bfb3973f860dc08a9717a32a49541b11cbcf0c,1,50,49,1,0,0,0,3,6,138,1,1,0,442,96,1,102,102,0,3033,3033,0,34,34,0,100
b9a2d14d1693a6783880990da6bea88bd060d443,1,49,46,3,0,0,0,11,16,555,1,1,0,554,69,5,63,63,0,3564,3362,202,31,31,0,100
4640e430c9cd63ac302b3242a7a76ad3e7413c48,0,0,0,0,0,0,0,0,0,0,0,0,0,0,70,6,0,0,0,0,0,0,0,0,0,100
e94624d1cf731a0f874b1bc97083f69f2e554d06,0,0,0,0,0,0,0,0,0,0,0,0,0,0,71,7,0,0,0,0,0,0,0,0,0,100
83165574c21b9f585749c7a0d06b79d84f91f54f,0,0,0,0,0,0,0,0,0,0,0,0,0,0,72,8,0,0,0,0,0,0,0,0,0,100
a67ed301df34542899623d984c002d9bda6f1a21,2,22,1,21,0,0,0,2,12,1624,2,2,0.426228657,473,73,8,107,105,2,3589,3457,132,25,24,1,100
c86670001cde01258c086583093bf108eabdef20,0,0,0,0,0,0,0,0,0,0,0,0,0,0,527,0,0,0,0,0,0,0,0,0,0,100
2d6705a45c0bbaf5f86554e0dad87cb3f6a98988,2,9,8,1,0,0,0,14,38,395,2,2,0.787126586,991,97,1,61,60,1,7707,7664,43,43,43,0,100
1da1ec18bb8f8506d4853fae0831441f585752af,0,0,0,0,0,0,0,0,0,0,0,0,0,0,528,1,0,0,0,0,0,0,0,0,0,100
8df2bfbc626dd0948ce68ce72c8cf143aab3e4c8,0,0,0,0,0,0,0,0,0,0,0,0,0,0,74,8,0,0,0,0,0,0,0,0,0,100
ed936c3906f7a067ad51f96f739e1b1e4797c16b,1,20,0,20,0,0,0,17,52,262,1,1,0,1057,529,2,91,89,2,7851,7751,100,68,66,2,100
5dd233013be37ca7bc3e1ae58e3e1b92094ec85d,4,58,13,45,0,0,0,7,87,221,2,3,1.293099233,2854,18,2,357,352,5,20014,19721,293,141,139,2,99.98901099
9e2c218bf7b2cd27cb86a4b398b7add596eda961,4,31,2,29,0,0,0,7,18,616,2,4,1.357792821,912,530,3,141,138,3,6639,6449,190,70,67,3,100
213ad2ed2080f7e20de8ad9cb1c1ffce665ce708,3,25,16,9,0,0,0,7,11,283,2,2,0.734993332,342,531,4,50,46,4,2627,2507,120,17,17,0,100
8adfa6b2eb4d71224fd377d4400555be219db3b8,1,37,0,37,1,0,1,1,1,0,1,1,0,0,532,5,5,0,5,224,0,224,3,0,3,99.95605844
780375b6620e6d04725941883e24be156f17ba97,2,87,14,73,0,0,0,6,12,452,2,2,0.697519531,849,19,3,150,141,9,6077,5755,322,68,62,6,100
d6039b500d6b77501b5149144fef48eba21dbc63,4,68,8,60,0,0,0,3,3,538,2,2,1.699376623,1098,533,6,210,200,10,9105,8731,374,70,64,6,100
f14637210a9e5237c9674ca2f7988a2e7f40f978,4,46,0,46,0,0,0,3,4,0,2,2,1.795200863,1146,534,7,216,210,6,9423,9105,318,73,70,3,100
1cc0951c3f86b4394a74b8b4d152badddf3fb88e,1,1,0,1,0,0,0,3,6,634,1,1,0,126,75,6,24,24,0,996,989,7,4,4,0,100
534a5f37bb8e718a845e197b34943e7bdc3c877f,1,0,2,2,0,0,0,2,2,3651,1,1,0,276,535,8,41,41,0,1511,1533,22,15,15,0,100
1f404679f95e1c89851cb901c7905dd1bc6e499d,1,0,3,3,0,0,0,8,14,162,1,1,0,254,76,7,43,43,0,1658,1658,0,25,25,0,100
23db59fc8ad3258de45fdaf51a4189ab323d2fdb,2,28,25,3,0,0,0,8,32,281,2,2,0.883585086,951,536,9,205,200,5,7673,7616,57,59,59,0,100
9850331a712cbcc754d09b7e51e5c613379ad7ac,0,0,0,0,0,0,0,0,0,0,0,0,0,0,537,10,0,0,0,0,0,0,0,0,0,100
344c43c5229f37673e6789e7d8386fe2429472cb,0,0,0,0,0,0,0,0,0,0,0,0,0,0,538,11,0,0,0,0,0,0,0,0,0,100
790917fd98bd548e0bbc7e2c72e7da6ab48c0a1f,1,17,0,17,0,0,0,1,2,20,1,1,0,31,539,12,5,5,0,224,224,0,3,3,0,100
d6fde9285bbeb1627ca04092a7f2db51d3ebd03f,0,0,0,0,0,0,0,0,0,0,0,0,0,0,540,13,0,0,0,0,0,0,0,0,0,100
00e07d5de3c5ab7a4d661f4614c0a955075323c3,2,1099,994,105,0,0,0,3,5,567,1,2,0.934259924,644,77,8,115,87,28,5004,3963,1041,36,29,7,100
ff8dac4b2ee3f39b1fd6eb6ebc6d7bc455721fd0,0,0,0,0,0,0,0,0,0,0,0,0,0,0,78,9,0,0,0,0,0,0,0,0,0,100
b3a71d785da6284bd6336313d4859d21b90ea7bd,0,0,0,0,0,0,0,0,0,0,0,0,0,0,40,0,0,0,0,0,0,0,0,0,0,100
fc9f3945a8adafec36dc5c9568a988e504f9a701,0,0,0,0,0,0,0,0,0,0,0,0,0,0,41,1,0,0,0,0,0,0,0,0,0,100
19f53169e4f91c6801c9299c0a38cc9eb77cf340,2,33,1,32,0,0,0,5,24,331,2,2,0.989992792,2197,541,2,236,234,2,9595,9474,121,140,139,1,100
2cd4b75d25882d021ce748af8b13e9884c3c951a,0,0,0,0,0,0,0,0,0,0,0,0,0,0,542,3,0,0,0,0,0,0,0,0,0,100
abddf582e01c7026bd4c63bf20bccbb989102d64,2,17,2,15,0,0,0,7,35,347,2,2,0.74248757,1553,543,2,267,266,1,12779,12626,153,79,78,1,100
845916ef02ba6cf9ac524d51a4c41d62c7103e59,3,7,178,171,0,0,0,6,114,829,2,2,0.717223888,3083,544,3,489,499,10,23075,23840,765,98,106,8,100
40ecb9a1a9d57d98f3a35f7acb19652aa2b545e4,1,2,1,1,0,0,0,7,10,1154,1,1,0,187,545,4,43,42,1,1131,1123,8,18,18,0,100
f84d4f80307ed5f561bdc863514bf92bbd1cadcc,1,92,0,92,1,0,1,1,1,0,1,1,0,0,546,5,1,0,1,553,0,553,1,0,1,99.94511526
92b8f453ca52060362a6009577527312ad9c580d,1,2,1,1,0,0,0,2,3,2307,1,1,0,112,547,6,13,12,1,894,886,8,2,2,0,100
a4e43daf00d3880f518bddd268218aae44140325,2,24,1,23,0,0,0,14,39,485,2,2,0.242292189,1147,548,7,103,102,1,8676,8541,135,73,72,1,100
4b9ebcec3ec7c0e77bc1e82c0aa83bdfef4aa277,0,0,0,0,0,0,0,0,0,0,0,0,0,0,549,8,0,0,0,0,0,0,0,0,0,100
40dc470a28b2b415238df225f085cc1e62ebf766,20,4487,23,4464,19,0,19,1,1,0,1,3,4.079845597,145,550,9,774,33,741,33315,994,32321,135,15,120,99.530106
1ce6e242e6b734f5c70b38535df56f17940107b8,0,0,0,0,0,0,0,0,0,0,0,0,0,0,360,0,0,0,0,0,0,0,0,0,0,100
5b7256cf12b43338286a5807996a83603fa70c06,0,0,0,0,0,0,0,0,0,0,0,0,0,0,79,0,0,0,0,0,0,0,0,0,0,100
0e7b6c44045f4fca44ae7fe93377cdad5c3d557d,1,38,0,38,0,0,0,7,11,87,1,1,0,139,80,1,27,25,2,1339,1081,258,7,6,1,100
389455db2373ba0db19b70f45f87b224a7d4641f,0,0,0,0,0,0,0,0,0,0,0,0,0,0,551,10,0,0,0,0,0,0,0,0,0,100
cf9ddce08662a9d802dec5f8c992f8ebef608b9b,0,0,0,0,0,0,0,0,0,0,0,0,0,0,552,11,0,0,0,0,0,0,0,0,0,100
82bfc2678f1789a6a8ae8836308747b1e0ac7161,3,325,0,325,3,0,3,1,1,0,2,2,1.495164846,0,81,2,14,0,14,1503,0,1503,9,0,9,99.92387167
af5316dbbe3e2d95558478c1e1528a4847ce45a9,1,235,0,235,1,0,1,1,1,0,1,1,0,0,82,3,6,0,6,1057,0,1057,6,0,6,99.94569349
de6a9578a777074941f243954be00fb7e7200b65,1,58,0,58,1,0,1,1,1,0,1,1,0,0,361,1,4,0,4,288,0,288,2,0,2,99.97829861
b1b783c7547db823425f7d5bd88bb96f2b7f91a6,8,767,3,764,4,0,4,1,57,127,2,6,2.187407258,3243,75,0,1006,878,128,28329,22892,5437,259,221,38,99.92413569
d5fd04f62ed9c756fc3f168f6db17eeeadd215a3,6,256,189,67,0,0,0,2,42,0,2,4,1.796166047,2159,83,4,442,442,0,16989,16989,0,153,153,0,100
33bf356e1438b6c68650a6626fca892b93ebfc17,0,0,0,0,0,0,0,0,0,0,0,0,0,0,553,11,0,0,0,0,0,0,0,0,0,100
c6b3a11ea1deb11f0ae423e753344aa44b459370,2,18,1,17,0,0,0,15,39,1191,2,2,0.998000884,772,554,9,94,91,3,6158,6019,139,52,51,1,100
5a1024f5da12275ffc633719bc89fd4061c21b94,1,2,2,0,0,0,0,4,5,158,1,1,0,181,362,2,27,27,0,1483,1469,14,25,25,0,100
7756041998eb1c8351aa7e111810afbe12fc0b0a,1,8,2,6,0,0,0,4,21,4,1,1,0,191,555,10,43,42,1,1372,1335,37,14,14,0,100
96a319d36bf8cad48cc4ad6f3d70a9a0ece34e64,1,0,58,58,0,0,0,1,2,20,1,1,0,32,363,3,0,4,4,0,288,288,0,2,2,99.97833153
fceed85f5e1976560559702dc816845b2a2d5dc3,1,13,6,7,0,0,0,18,54,115,1,1,0,1064,364,4,91,90,1,7837,7801,36,67,67,0,100
84c19e7b7c8ef5a540bdecd1a3ef7832913de02e,2,123,18,105,0,0,0,6,13,124,2,2,0.887275117,894,20,0,159,150,9,6451,6077,374,70,68,2,100
561daf4fbd81696d43b2ff83d92c53fc5fc2dbe4,3,109,62,47,1,0,1,8,87,295,1,3,1.376858597,1139,84,4,224,216,8,8203,7926,277,69,67,2,99.95665836
dd615b01ee5eb08a73d3394975b1ed39ccb6e14c,0,0,0,0,0,0,0,0,0,0,0,0,0,0,34,0,0,0,0,0,0,0,0,0,0,100
f1161d8a84fb04be2a3311e344a9c4a855c15a1c,2,102,62,40,0,0,0,2,6,1978,1,2,0.937293066,684,556,3,126,117,9,4639,4328,311,39,37,2,100
92254963bbf54e83812a87947f01e9b735ee9432,3,26,5,21,0,0,0,7,160,145,2,3,1.238278588,2330,557,4,387,386,1,19066,18861,205,149,148,1,94.02356902
aac12aed0836e0999c89094a95b3af0db13b3626,1,4,6,2,0,0,0,7,18,523,1,1,0,212,85,3,17,17,0,1539,1561,22,14,14,0,100
c3649e6a5192574728cb6743c251a4ac7d53bbb2,2,32,9,23,0,0,0,3,6,1799,1,2,0.989245297,130,558,5,23,21,2,1107,954,153,11,10,1,100
33999e28862358d8db3396ddab438fea7c08fdf5,2,334,337,3,0,0,0,4,6,1992,1,2,0.366090475,731,559,6,100,98,2,5419,5282,137,38,37,1,100
9b7069406e594523afec01cf81f613eef84adef7,3,663,0,663,3,0,3,1,1,0,1,3,1.459550617,0,560,7,63,0,63,4186,0,4186,23,0,23,99.92598684
c1c8db411fdd0086ad74f301227db07998d16780,2,26,4,22,0,0,0,8,15,563,1,2,0.881290899,470,561,8,92,90,2,3262,3012,250,22,21,1,99.98356345
85feed54188ca07b0ef75dc4e0b42099931ac863,0,0,0,0,0,0,0,0,0,0,0,0,0,0,562,9,0,0,0,0,0,0,0,0,0,100
38f5cd4de237cc59d8c1a72ab44eff399ae6d614,2,73,15,58,0,0,0,8,21,444,1,2,0.990664927,1373,21,1,212,206,6,8282,7929,353,74,71,3,100
7dc731fdc4514d2ad1d508ae947c7302bd37720d,0,0,0,0,0,0,0,0,0,0,0,0,0,0,35,1,0,0,0,0,0,0,0,0,0,100
38926adbeecfc42764ea4bf16ad2873ed97c5ec7,2,47,5,42,0,0,0,3,4,316,2,2,0.456683632,129,24,0,15,12,3,1264,1136,128,9,8,1,100
15ce1b1b69787f03173c7fec381f61052342da95,2,2,2,0,0,0,0,2,3,1611,1,1,1,452,22,1,80,78,2,3098,3076,22,22,22,0,100
11ffd20e56a17cee30886955153197b00f68cf1a,0,0,0,0,0,0,0,0,0,0,0,0,0,0,563,7,0,0,0,0,0,0,0,0,0,100
4f80b9041bd31c097e2daa186ac58a6da6ee3005,0,0,0,0,0,0,0,0,0,0,0,0,0,0,564,8,0,0,0,0,0,0,0,0,0,100
087fd7d943d41292bd2de23785162be215ef79c9,1,9,7,2,0,0,0,7,37,562,1,1,0,1622,565,9,107,105,2,16260,16233,27,85,83,2,100
f9e2588f2e0aa1dafc8277e8e187c37b42921d09,5,38,12,26,0,0,0,18,68,488,1,1,2.239104056,3463,566,10,388,387,1,27854,27705,149,213,212,1,100
f8d2870afbe64eb67cdcc4e71bf7906e5ecf8ecd,1,3,3,0,0,0,0,7,11,171,1,1,0,303,567,11,28,28,0,2159,2144,15,27,27,0,100
b87c8a38a179857497e3350cf29a5062e7e8db55,0,0,0,0,0,0,0,0,0,0,0,0,0,0,568,12,0,0,0,0,0,0,0,0,0,100
eabb42b7b2ed6794e1fe0d67575d3928d5295035,6,103,25,78,0,0,0,8,22,719,1,2,2.460016272,2284,23,2,378,374,4,14294,14015,279,131,129,2,100
e069ccd6874b7ee9f7aaf76aae8afe9a54380ee3,5,92,55,37,0,0,0,8,88,564,2,4,1.854162821,2535,42,0,296,299,3,19414,19156,258,101,101,0,99.99178172
44c961821184ec47b5842b0adebaa1ef8f65e42e,1,39,0,39,1,0,1,1,1,0,1,1,0,0,43,1,1,0,1,49,0,49,1,0,1,94.02483428
6a7595c9b2eda77144f6eb842dd0b67145e92a76,101,1366,1906,540,0,0,0,9,39,890,2,7,5.0646889,26104,36,1,4404,4437,33,180593,185568,4975,1582,1597,15,88.38717425
11a8ede57ce4a8285b263489922328d92ddaed19,0,0,0,0,0,0,0,0,0,0,0,0,0,0,86,0,0,0,0,0,0,0,0,0,0,100
11f49cbe514026600fc353c31472189a3f35f15f,1,1,2,1,0,0,0,3,5,17,1,1,0,110,87,1,17,17,0,699,707,8,12,12,0,100
d41cf281c2855abce45011b2c971ab182b5c531d,1,111,104,7,0,0,0,20,88,72,1,1,0,536,569,6,90,89,1,3908,3892,16,15,15,0,100
b0e176ba5133f341c0f4b74dfe7486f01a908ee7,1,1,0,1,0,0,0,6,16,1481,1,1,0,197,570,7,37,37,0,1032,1028,4,12,12,0,100
bdffb1e4459afb4223e19b78cab1fd10d51f7f60,2,2,1,1,0,0,0,3,10,1821,2,2,0.918295834,366,25,0,49,49,0,2016,1996,20,25,25,0,100
0b4e14201e7b0540649732171708bf9450f88201,1,3,2,1,0,0,0,4,5,56,1,1,0,58,24,1,6,6,0,579,577,2,4,4,0,100
8fbf6ef1f7a5583e0915a0b820d61ce31935d8c6,0,0,0,0,0,0,0,0,0,0,0,0,0,0,26,1,0,0,0,0,0,0,0,0,0,100
fda8afe3b268d9597a3ccf366ea0e67ba57c5db0,0,0,0,0,0,0,0,0,0,0,0,0,0,0,571,2,0,0,0,0,0,0,0,0,0,100
f73d3856822cec0dd4ac78796c95099940b195ba,17,109,103,6,0,0,0,3,23,1829,1,2,2.683504238,3913,572,3,366,366,0,28364,27890,474,173,173,0,100
f89d06f54d0f49695821b3261229e11fb9513756,1,19,10,9,0,0,0,2,5,2822,1,1,0,94,573,4,24,19,5,607,539,68,10,9,1,100
4fc6036732e962f72cf761be8bc7276176ace8ae,1,89,0,89,1,0,1,1,1,0,1,1,0,0,574,5,1,0,1,653,0,653,1,0,1,98.40404827
5d3e55a8275998e9703315670215dbe49847b029,2,35,1,34,0,0,0,14,96,505,2,2,0.979868757,1730,575,6,275,271,4,12072,11821,251,73,72,1,100
e195559b30bf843db07b6862f4316961b58b17f4,2,0,175,175,0,0,0,1,2,134,2,1,0.927526588,136,88,2,0,10,10,0,728,728,0,5,5,99.93757023
cf44084ef6eb524ba2fe42033a5899caa8d2b3bf,1,5,3,2,0,0,0,9,30,622,1,1,0,402,25,1,57,57,0,2596,2588,8,12,12,0,100
6aa213f20dc723c4e96dee8c7716ef41df23bdec,3,29,1,28,0,0,0,5,48,325,2,3,1.418320371,1731,0,0,579,574,5,12021,11864,157,67,66,1,100
84109c6af5098931e5fcec53c37c37a6d4b88bb5,3,46,2,44,0,0,0,8,24,42,1,2,0.740616496,1676,26,2,224,222,2,10381,10092,289,92,91,1,100
caf32c4b14a0d8232a9a30b513d62d2af17350e7,17,47,12,35,0,0,0,18,63,659,2,2,3.390075677,2831,27,3,330,305,25,25656,25218,438,113,113,0,100
cdc1a202f0fdfbcf4c5a5504ce6b97b514d2671e,1,86,2,84,0,0,0,1,2,140,1,1,0,186,89,3,8,6,2,1549,1057,492,8,6,2,100
4ea24ac6b09e6eb22c8a03a4f2b9360fc15ad4ca,0,0,0,0,0,0,0,0,0,0,0,0,0,0,90,2,0,0,0,0,0,0,0,0,0,100
e673112d29db34b8acb68052022c71f71f90c407,2,36,1,35,0,0,0,8,25,991,1,2,0.699772222,1266,28,4,183,181,2,7809,7626,183,63,62,1,100
6ce0ffde0c57a8fe7338fa4f3d9473dee7e85db8,2,30,36,6,0,0,0,12,115,496,1,1,0.61361902,2426,91,3,447,443,4,18793,18772,21,124,126,2,100
5fd222542a9bca56fd1d5463f8d05568f80f8185,1,19,0,19,0,0,0,6,25,201,1,1,0,1817,92,4,136,135,1,6519,6472,47,122,121,1,100
b475f7699c9e51cfcbe4f5fcb7b4edf9c65928c2,8,66,81,15,0,0,0,4,89,74,2,5,2.21679807,4670,29,4,1369,1376,7,31948,32094,146,152,151,1,100
75ae2ae267f082cb371b5f7adf6f32ee4db8ffb6,5,175,22,153,0,0,0,8,26,51,1,2,1.824847083,2286,30,5,376,364,12,14958,14284,674,122,121,1,100
2ace0f65ca68d3d0d01ff89449daf2eff0c41d2b,2,34,0,34,0,0,0,4,13,748,2,2,0.322756959,813,1,0,127,122,5,5723,5571,152,38,37,1,100
88ebf424a83d66d41faa00d1adea66ca11727553,0,0,0,0,0,0,0,0,0,0,0,0,0,0,576,0,0,0,0,0,0,0,0,0,0,100
a5378e8661133050370b0a29221f88a484d23179,1,1,1,0,0,0,0,18,69,123,1,1,0,893,577,1,170,170,0,7091,7091,0,84,84,0,100
62088e08757f5d5a7535d104a77e7e206b9a4e45,1,23,25,2,0,0,0,1,3,65,1,1,0,253,93,0,8,8,0,1545,1549,4,8,8,0,100
55cf90e49740f9176d31cffb9f25b869bceae3d9,11,3559,0,3559,11,0,11,1,1,0,2,2,3.04684102,0,94,1,421,0,421,17561,0,17561,163,0,163,97.73869347
40d44db3cb8e14eb20b6024aab6a62b493d4bcba,1,40,0,40,0,0,0,1,4,39,1,1,0,251,95,2,9,8,1,1793,1545,248,9,8,1,100
663e1010135b00d381b4b4c870290634f949ee2d,1,2,1,1,0,0,0,2,2,129,1,1,0,63,96,1,1,1,0,655,653,2,1,1,0,100
bcc9f5a6acbdff537184f069c7082daa3a50fb35,2,89,0,89,1,0,1,4,5,243,2,2,0.627819153,164,97,2,22,13,9,1980,1456,524,17,13,4,100
90c81bb6b3e70c3603a9211498fdac783aa1453a,0,0,0,0,0,0,0,0,0,0,0,0,0,0,31,0,0,0,0,0,0,0,0,0,0,100
c2f41b3aad12bf95865afc87d72315836219a7d0,0,0,0,0,0,0,0,0,0,0,0,0,0,0,98,3,0,0,0,0,0,0,0,0,0,100
e2b461c8f1bd71611682500865eb4726790eff72,5,2870,0,2870,4,0,4,13,50,21,2,3,1.55676447,1183,365,0,824,461,363,28413,8104,20309,173,52,121,99.51117318
336aa251183527a6e02a0a661a0147993f5ee784,1,2,2,0,0,0,0,18,64,141,1,1,0,2178,99,4,234,234,0,20956,20956,0,70,70,0,100
370e32957eebe4fe02cca87179cc23c487c4e29d,4,207,5,202,2,0,2,4,65,9,2,2,1.874330598,2355,100,4,266,248,18,23626,22538,1088,92,84,8,97.6369637
1f984ec620aea0726d041b9768b4ca40cd589112,1,4,0,4,0,0,0,23,161,254,1,1,0,1091,101,5,230,229,1,7869,7831,38,94,94,0,100
4412702d262fbcff5b1c97f3d36cf7d906f73002,1,16,4,12,0,0,0,2,3,546,1,1,0,38,102,6,8,5,3,398,310,88,3,2,1,100
7618390d5a3d5a919bcce72ceed9381239bf54e1,0,0,0,0,0,0,0,0,0,0,0,0,0,0,103,7,0,0,0,0,0,0,0,0,0,100
c99f35a9c643a713c9eb748a7a2a258e3788ff2e,1,2,2,0,0,0,0,19,90,128,1,1,0,835,104,8,144,142,2,6123,6107,16,23,23,0,100
0eb2c505dd3eee78fae0944d5b3138ba257ad629,2,1,33,32,0,0,0,6,26,240,2,2,0.989992792,2237,105,9,235,237,2,9521,9642,121,140,141,1,100
2ddf51b98a68d0ef59deee817371e87b11e3f3b5,16,288,276,12,0,0,0,8,61,1488,2,4,3.064257092,7697,106,8,641,619,22,60018,60984,966,386,377,9,99.91200503
41886f1cb32720315d1b77e5b1c12b8fd4d80f87,2,569,422,147,0,0,0,7,14,282,2,2,0.493767655,979,107,8,171,159,12,6966,6451,515,77,70,7,100
6d1f813dd94f9f1f8dd2557b42488483a3ee5968,1,1,1,0,0,0,0,7,14,481,1,1,0,217,108,8,9,9,0,1444,1444,0,9,9,0,100
ce611eea520599af955ab2c362c4b4b19705ddda,13,694,374,320,0,0,0,6,162,664,2,9,3.362914919,8083,109,9,1256,1226,30,51440,50324,1116,546,526,20,99.97487437
a003969a7b113b9bb2316a28ebb52aaf2bcbf6b8,2,22,3,19,0,0,0,8,21,324,2,1,0.795040279,1021,110,4,169,167,2,6602,6433,169,106,104,2,100
f00961b146dad53104381681f08a91b31e60ad00,2,3,22,19,0,0,0,8,22,0,2,1,0.795040279,1038,111,5,167,169,2,6433,6602,169,104,106,2,100
b279c2af8977909c251dbaeaca292535496b852c,1,8,2,6,0,0,0,3,3,276,1,1,0,202,112,5,33,32,1,1379,1347,32,9,9,0,100
971aec1c9ae6559fd2cadd95bf1d9e377ef75830,4,37,30,7,0,0,0,9,27,359,2,3,1.235615715,3973,113,6,516,515,1,33497,33462,35,116,115,1,100
67589ac2dd67be75d739ebbce4749f26e780797a,4,475,351,124,0,0,0,16,163,103,2,3,1.205635516,3816,32,0,595,582,13,27733,27116,617,264,259,5,97.76307081
1448856b78160ede5310c3879d1bc906bfb0a71c,3,73,30,43,0,0,0,2,2,141,2,2,1.420436862,1313,33,1,209,208,1,8782,8434,348,73,73,0,99.91608392
a688632e284d825f87bec8e2a6fb7f44f46ab0a0,3,53,13,40,0,0,0,2,3,96,2,1,1.491688095,1549,34,2,171,164,7,10048,9725,323,86,85,1,100
9a2d9b851b58028d941cc5252cf4da8d8d743a8f,0,0,0,0,0,0,0,0,0,0,0,0,0,0,114,6,0,0,0,0,0,0,0,0,0,100
f115edea9c397ac42596bf6fa2cc7bf6b66f662f,2,2,2,0,0,0,0,5,6,1676,2,2,1,613,115,7,127,127,0,3895,3895,0,24,24,0,100
9772318501c907fdb785ac709defbd561b1d80ef,1,9,9,0,0,0,0,6,21,274,1,1,0,158,2,0,23,23,0,1307,1307,0,4,4,0,100
f40d837a694cc4c8b4b7d3d500ad9c6a70ae52cc,1,1,1,0,0,0,0,17,59,37,1,1,0,644,35,3,120,120,0,3882,3882,0,62,62,0,100
9d7cd38dee7e95d7764e445ff03dfb346659e900,1,1,1,0,0,0,0,3,5,926,1,1,0,232,116,6,34,34,0,1628,1628,0,10,10,0,100
70d3a516ff8023b79701f5d217abadb397d7f44d,1,4,4,0,0,0,0,8,19,337,1,1,0,210,36,4,17,17,0,1539,1539,0,14,14,0,100
9d2b73a04b42a9722be77282d1d5abed15966112,3,13,10,3,0,0,0,1,63,372,2,2,1.325784781,1832,117,7,286,285,1,12093,12094,1,113,113,0,100
bdc6dcf779279ff4b41fbdfaf998732d11291e13,4,73,22,51,0,0,0,9,62,977,2,4,1.552954659,3166,578,0,515,507,8,24046,23806,240,207,205,2,100
3d353e3dfc0e3b594f68dedb7aa8d54a66d1d36e,5,100,19,81,1,0,1,1,116,305,2,5,1.336181122,4895,579,1,646,639,7,39766,39457,309,169,165,4,99.94407159
afe0cb735e58242dd64484d5563cfb98703da9e6,2,51,3,48,0,0,0,5,20,783,2,2,0.445064857,2023,580,2,282,279,3,14379,14130,249,86,85,1,100
2f668e29dd144068ec0759a9fe8f4c77214ba978,0,0,0,0,0,0,0,0,0,0,0,0,0,0,37,5,0,0,0,0,0,0,0,0,0,100
9baf357cbf9bc27eddae4671581447d97cf1da63,2,19,0,19,0,0,0,10,89,669,1,2,0.485460761,1281,581,3,258,253,5,9498,9320,178,96,95,1,100
149b79a750b119356326c138ddd66b597da1ee9a,1,1,1,0,0,0,0,10,26,0,1,1,0,753,582,4,168,168,0,5577,5577,0,81,81,0,100
befe168a8aef32aab1efadf228528b6dbf9ce6f3,2,56,1,55,0,0,0,3,44,154,2,1,0.981940787,1624,583,5,339,331,8,12246,11938,308,127,124,3,100
b5d6531c54dd23f7b52f39c8b9db36d45cdd49f5,54,3721,2883,838,9,0,9,19,164,769,2,13,4.273514315,20348,118,2,2990,2879,111,150670,151397,727,1217,1181,36,91.39905682
808822dd304e688bce05deece4ed4a66111988e6,2,67,0,67,0,0,0,1,5,280,1,1,0.992111692,397,119,3,15,13,2,3064,2568,496,15,13,2,100
3b846c3ea84d6848b2a3fa908545da402ce73c1c,0,0,0,0,0,0,0,0,0,0,0,0,0,0,120,4,0,0,0,0,0,0,0,0,0,100
39b4093a60480a0d65b17255ef56034103b85555,1,35,7,28,0,0,0,21,65,29,1,1,0,1052,584,5,216,211,5,6633,6451,182,61,60,1,100
df8a2e0b4b6b67135b4ff94799e23123bae25057,1,54,0,54,1,0,1,1,1,0,1,1,0,0,585,6,3,0,3,309,0,309,2,0,2,92.36328336
596142206027ce9edaae2cb4aaa3983795e5afce,16,489,7,482,2,0,2,16,165,516,2,10,2.377739528,9798,586,7,1824,1743,81,76866,73661,3205,545,528,17,95.23175602
a96179d1516fdaeea2d47679af6ea65dbc6669a4,12,295,26,269,0,0,0,7,166,797,2,7,2.541467815,4911,587,8,931,908,23,34744,33510,1234,351,333,18,96.6678157
1e8bb97fbf555581bc570117c70543b5b9a3c040,1,15,0,15,1,0,1,1,1,0,1,1,0,0,588,9,2,0,2,54,0,54,2,0,2,89.32427514
480dde33d52fb292b912b39e967f4becf074d024,35,153,107,46,0,0,0,19,71,623,2,7,4.668164658,13722,589,8,1569,1565,4,95304,94691,613,741,740,1,100
5b70b5a74973d46dab904a1033a33c2e18dcb0fe,2,2,22,20,0,0,0,11,37,615,2,2,0.543564443,1685,590,7,253,255,2,13597,13736,139,82,83,1,100
32954da920581347769cb0f8594100e7e8372712,3,337,113,224,0,0,0,2,6,162,2,2,0.691561497,556,591,7,107,88,19,5111,3893,1218,29,27,2,99.97409997
d2b5d0da39ec4c38d6b1fcbd37259ab56df877d5,0,0,0,0,0,0,0,0,0,0,0,0,0,0,592,8,0,0,0,0,0,0,0,0,0,100
29afa089651d50828fc36986849b6b742fed735b,2,86,1,85,0,0,0,4,15,837,1,2,0.362051252,325,593,9,83,60,23,2376,1939,437,16,14,2,93.9025788
ad7b97e1a63553b08918ab71346e31b0ec1e5631,8,299,89,210,2,0,2,5,5,2245,1,5,2.822235013,441,38,0,74,61,13,2774,2285,489,24,16,8,99.89726731
6657b87f565608a52ece9721161ff991165cd186,2,8,0,8,0,0,0,5,11,56,1,2,1,82,121,0,0,0,0,496,436,60,0,0,0,99.92816829
260d0ffabe624d9b6143a7430560bbda36f5b1b4,1,87,79,8,0,0,0,8,14,1064,1,1,0,306,122,1,67,66,1,1764,1735,29,21,21,0,100
6559b1c1439b404a81e146ad2e309b5ce311fadb,2,67,17,50,1,0,1,7,11,13,1,2,0.998363673,88,39,1,18,15,3,655,497,158,9,6,3,92.16375595
6f7599eff8ec328bf0581a6bba1ac4edd7611ba1,28,414,363,51,2,0,2,7,167,417,2,8,3.540414571,9701,594,10,1519,1518,1,69461,69298,163,588,587,1,99.63066735
e264963129dcddc49c272fb98db110b0a59f31b7,1,25,0,25,0,0,0,10,46,32,1,1,0,1371,3,0,301,299,2,10840,10623,217,105,104,1,100
0fdca6d678631f7f885730dc4ca84573c4181a6c,2,123,0,123,2,0,2,1,1,0,2,2,0.964956767,0,4,1,6,0,6,520,0,520,3,0,3,99.91049738
19b6092bbe98803512c2c170e7808f0ddeeac22b,3,189,3,186,1,0,1,14,168,201,2,3,0.873137566,2910,595,11,475,451,24,17558,16838,720,270,261,9,99.97444416
cb156c5b01a5d10cb841571fe472ae5667f785ae,1,1,1,0,0,0,0,14,87,0,1,1,0,1850,596,12,217,217,0,9338,9338,0,166,166,0,100
28a5eee79c37b01fceb729a96071dfcbf7feff0d,12,157,183,26,1,0,1,19,93,107,2,5,1.536339809,4568,123,2,644,646,2,32593,32688,95,259,258,1,99.92337165
a9752ca0bebb3b5a8cf24ba343a0af798c8fb34a,20,2385,143,2242,14,0,14,1,23,144,2,6,3.640135713,1198,597,8,458,211,247,21795,7726,14069,191,57,134,99.42762656
162e48a6a562cce5f33f0ec8ed02f8325432c40c,0,0,0,0,0,0,0,0,0,0,0,0,0,0,598,9,0,0,0,0,0,0,0,0,0,100
dd801c20587bee72ec78ed6be1d3276929184423,0,0,0,0,0,0,0,0,0,0,0,0,0,0,599,10,0,0,0,0,0,0,0,0,0,100
fdb0d632ea38457aace42197e4165ee3ffa55022,8,1335,30,1305,2,0,2,8,87,276,2,6,1.372808673,1721,5,2,395,274,121,17553,11745,5808,168,108,60,95.19564141
fab5f6ab0bc2e157f5e483767ed4ebb3bcd9b5e4,10,114,40,74,0,0,0,9,19,1561,2,4,2.484773095,2333,98,0,646,642,4,15304,14807,497,120,119,1,99.98789346
8a33e7b253f3f6a38c540b3e9567c6e2715e41ca,6,47,25,22,0,0,0,3,17,941,1,3,2.359222033,916,600,11,191,187,4,6520,6357,163,67,63,4,99.98789346
4762727380ea5057b5a4f374254f3ae54e6e2591,3,20,8,12,0,0,0,2,11,707,2,3,1.530618995,642,601,12,89,86,3,3931,3829,102,38,36,2,99.87861131
2d84d70e536339b2cf24dee6432d3cdb412b8606,2,45,4,41,0,0,0,6,7,745,2,2,0.768281409,626,0,0,62,57,5,4470,4240,230,36,35,1,100
7d48332ecc44f2ddac98c7e3158a561e90c5419c,1,2,2,0,0,0,0,2,2,6,1,1,0,243,40,2,7,7,0,1686,1686,0,7,7,0,100
e8795e6d71b3122285edcf8f8cc88a28fd20956c,0,0,0,0,0,0,0,0,0,0,0,0,0,0,602,11,0,0,0,0,0,0,0,0,0,100
b074695d10494a13b64c8a6cd4058f2ba1af178d,0,0,0,0,0,0,0,0,0,0,0,0,0,0,124,3,0,0,0,0,0,0,0,0,0,100
cac8ea6f0049671aa4c180ff170b1994e319165a,3,17,15,2,0,0,0,11,98,63,1,3,1.366314657,1597,125,4,320,320,0,11562,11534,28,100,100,0,100
a994b8949d6dbdf409dc7dc451ecc7aeade290b8,12,71,106,35,0,0,0,8,49,663,2,7,3.031674193,7334,126,5,1457,1463,6,56410,56303,107,323,327,4,100
2d9e5817bd30aa91e485d2b263eff071186472e4,3,15,17,2,0,0,0,11,99,0,1,3,1.366314657,1600,127,6,320,320,0,11534,11562,28,100,100,0,100
d3305b25cc639c38c415e53045e1b540c9d9023d,2,34,5,29,0,0,0,4,7,393,1,2,0.995727452,511,603,12,48,46,2,3042,2942,100,42,40,2,100
44959a624e453d028265d4dbbd77420d3c56d0b5,3,22,15,7,0,0,0,11,100,6,1,3,1.283474827,1597,128,7,322,320,2,11585,11534,51,100,100,0,100
4295a3a1d7a0ee1e752e4dd3ca89ec9759f66880,3,354,284,70,0,0,0,7,40,405,2,2,0.165201745,875,604,11,161,152,9,6066,5602,464,87,83,4,99.95133228
9052d948fdb5220f3994142d39c91559d64a4edd,0,0,0,0,0,0,0,0,0,0,0,0,0,0,605,12,0,0,0,0,0,0,0,0,0,100
ead170c2f962377475a0926786df3657e1746c72,2,32,0,32,0,0,0,8,19,1244,2,2,0.543564443,1071,606,12,129,127,2,9905,9665,240,50,49,1,100
afe0f6a31dc8e7006f1fda30f398a9214a094ef8,0,0,0,0,0,0,0,0,0,0,0,0,0,0,607,12,0,0,0,0,0,0,0,0,0,100
5aa62ffc8bec785795270e52657716785df27134,0,0,0,0,0,0,0,0,0,0,0,0,0,0,608,13,0,0,0,0,0,0,0,0,0,100
230f3677400a02c502b26dbcfb87a46843a243f4,5,429,9,420,2,0,2,18,66,832,2,2,1.439441795,2302,609,14,315,242,73,24240,21778,2462,102,78,24,99.9635214
293349ffe513d990b8d879dcc12f49e1334965b6,1,4,0,4,0,0,0,5,11,30,1,1,0,202,610,15,40,38,2,1379,1335,44,15,15,0,100
dca4c10a1dbbe459d80e79ffd048826fe3de2638,2,32,0,32,0,0,0,21,68,58,1,2,0.625262405,1393,611,16,296,291,5,8984,8788,196,95,93,2,100
fedfe64481d1c7b3691fb5913e055e9077db8b94,2,20,1,19,0,0,0,16,101,40,2,2,0.453716339,1936,27,0,324,321,3,15123,15046,77,105,104,1,100
0f93d9d2b042d8af090856613a3e9a844683fdac,1,6,2,4,0,0,0,20,102,0,1,1,0,1218,6,3,250,250,0,9247,9233,14,61,61,0,100
4c8ef35b8d12ef37e54f8f350341b7a885178a46,3,284,354,70,0,0,0,7,41,12,2,2,0.165201745,933,612,15,152,161,9,5602,6066,464,83,87,4,99.95135595
4a3b07cc99ea7d254a138b77df8b5468b7410730,0,0,0,0,0,0,0,0,0,0,0,0,0,0,613,16,0,0,0,0,0,0,0,0,0,100
b50b6c78edb38c262bf92b58516a2144caf6c538,0,0,0,0,0,0,0,0,0,0,0,0,0,0,614,17,0,0,0,0,0,0,0,0,0,100
08f663f6bef52176aeef6f03ddc988d21f254b48,7,649,0,649,6,0,6,1,24,4,2,3,2.6975788,246,7,2,112,51,61,4354,1881,2473,64,14,50,99.76938949
3d26194080ce27d8aa5eaf92716b1389e1e1b761,0,0,0,0,0,0,0,0,0,0,0,0,0,0,129,5,0,0,0,0,0,0,0,0,0,100
05cd7083df6633a8d541d417d3847bdaf7a2c0ec,0,0,0,0,0,0,0,0,0,0,0,0,0,0,615,18,0,0,0,0,0,0,0,0,0,100
12e0be979a8d898aadd7799d304fa0614a73cfa7,47,806,7,799,0,0,0,1,7,325,3,15,5.553398023,6182,616,19,1004,1004,0,50660,50660,0,293,293,0,100
40422326fae11c30fc5e2d5592996d56ced73fca,0,0,0,0,0,0,0,0,0,0,0,0,0,0,617,20,0,0,0,0,0,0,0,0,0,100
1af728258b1488f4dcf650ada512f035d4c0b0ab,0,0,0,0,0,0,0,0,0,0,0,0,0,0,618,21,0,0,0,0,0,0,0,0,0,100
d98e9097ead0fff933d1ea10b73473dd9508fd34,1,19,1,18,0,0,0,12,38,74,1,1,0,829,28,1,183,181,2,6418,6321,97,49,48,1,100
4e0f25841006443dd96bbf8f95aae05c9d0ac5fd,28,363,414,51,0,0,0,7,169,51,2,8,3.540414571,9767,619,21,1523,1524,1,69494,69657,163,589,590,1,98.31609334
17c2cb0084bf2401b4b750e05894bdadeba42f38,0,0,0,0,0,0,0,0,0,0,0,0,0,0,620,20,0,0,0,0,0,0,0,0,0,100
b9408a69782a4ccd833e7c95aed6920214167cb5,1,3,3,0,0,0,0,5,7,159,1,1,0,320,8,2,68,68,0,1993,1993,0,12,12,0,100
64ecc3e8577296aa6faf056b07a96354b5d41a79,2,11,14,3,0,0,0,7,23,48,1,2,0.634309555,388,130,5,74,74,0,3113,3113,0,19,19,0,100
f8522deda09ed3a17723fbb50a6ed488b75cd122,1,67,81,14,0,0,0,10,23,1211,1,1,0,155,9,3,39,36,3,1045,1005,40,19,19,0,100
e2a9a49d8cad6e0190a15a5b39b45df221f93be9,2,6,7,1,0,0,0,14,103,210,2,2,0.619382195,1760,621,17,276,275,1,12101,12094,7,72,72,0,100
ea471239609247630711b8903eaf4a7967c657f6,10,527,99,428,1,0,1,5,104,518,2,8,2.287045166,3142,10,4,600,554,46,24441,22342,2099,213,180,33,99.95222169
83fbb5a395ee138618fad63f5852fd86d967a132,0,0,0,0,0,0,0,0,0,0,0,0,0,0,622,18,0,0,0,0,0,0,0,0,0,100
e5432e5f44bf8f025dc6376a725df77abaaefcda,0,0,0,0,0,0,0,0,0,0,0,0,0,0,623,19,0,0,0,0,0,0,0,0,0,100
83787b61e29a28ac9e71486db3276da3b0aa97f1,0,0,0,0,0,0,0,0,0,0,0,0,0,0,131,2,0,0,0,0,0,0,0,0,0,100
0adc7b63d07db76bc4d9a500e9ea4f69cbdcd50c,2,276,63,213,0,0,0,6,23,26,1,1,0.940107143,174,132,3,33,33,0,1330,1004,326,26,26,0,99.98805542
f9b01a404d7061c59c843ba559bc5518564ffe52,1,13,13,0,0,0,0,5,13,110,1,1,0,245,133,3,47,47,0,1555,1555,0,11,11,0,100
75f44caeeb943a0dbe7dd2c1dd8ed1bf00e01876,6,302,321,19,0,0,0,13,95,64,1,5,1.488398036,2463,134,4,412,415,3,16369,16354,15,136,138,2,99.95221598
00727dd53a91accf99d9a38172d8226f1ac1897a,2,10,3,7,0,0,0,20,96,7,1,2,0.961236605,645,135,5,103,102,1,4589,4558,31,13,13,0,100
ae8a63336b9722fb5566e0c83262bc77539305ad,0,0,0,0,0,0,0,0,0,0,0,0,0,0,136,6,0,0,0,0,0,0,0,0,0,100
7db6be9a6300db0a7c59a8cfed44511051344c3f,1,51,29,22,0,0,0,12,36,897,1,1,0,283,11,3,65,61,4,1921,1820,101,23,22,1,100
444d7e2f7b18956ebaee9c21ef9ac76773547f04,0,0,0,0,0,0,0,0,0,0,0,0,0,0,12,4,0,0,0,0,0,0,0,0,0,100
bd013dd4fed1fcdc017b131d672805a87e234268,15,427,410,17,2,0,2,7,170,785,2,8,3.078447568,7388,624,3,1102,1106,4,58103,57718,385,474,477,3,92.68040051
57f83dbffb4d540474cd64120edef0671b2c69b0,1,1,2,1,0,0,0,13,21,13,1,1,0,407,625,4,83,83,0,2840,2855,15,30,30,0,100
06896797998722b9c10128eaf7c46b63a4281aa0,0,0,0,0,0,0,0,0,0,0,0,0,0,0,626,5,0,0,0,0,0,0,0,0,0,100
105a0d99e4673589e7c4dde3fa34835af037e4c3,0,0,0,0,0,0,0,0,0,0,0,0,0,0,627,6,0,0,0,0,0,0,0,0,0,100
c39b2c1b2ce8da7466562b56ac8a383ee43b0399,1,1,1,0,0,0,0,2,3,1802,1,1,0,90,628,7,16,16,0,572,572,0,5,5,0,100
12297b9cd2f5f0f99eebceff65776a4e0ff76428,1,2,1,1,0,0,0,11,22,123,1,1,0,839,629,8,72,72,0,7292,7276,16,34,34,0,100
405db4040c753649ea11ffa944a1d6d323a49111,8,161,34,127,0,0,0,5,67,1421,2,5,2.394648652,4565,630,9,709,685,24,37732,36972,760,269,259,10,100
1ed45193e0fa37c389addd6043df2e8172b7381c,1,13,2,11,0,0,0,2,3,216,1,1,0,469,137,6,117,113,4,3033,2980,53,14,14,0,100
140effe1e93ce0fc37eba78f37a02fb6ea08ff4e,1,3,0,3,0,0,0,1,2,360,1,1,0,239,138,7,57,56,1,1644,1617,27,16,16,0,100
18e7642490f1c25e01f07def0a2f8a1bf2db7e44,7,107,49,58,0,0,0,6,105,333,2,5,2.399714357,2674,13,2,484,481,3,19843,19530,313,135,134,1,99.98889629
f871eebd2621c382a9b407b5a5a1592fcf6200d7,1,2,2,0,0,0,0,21,97,31,1,1,0,603,14,3,102,102,0,4421,4403,18,12,12,0,100
7566b97f7747da98be3e2228fbcd98e037c119ca,5,286,89,197,0,0,0,11,37,1244,2,4,1.989486243,5610,1,0,1029,999,30,42088,40898,1190,261,256,5,100
f5a511089dd57df874a0d633ccbcbda72df9fef8,0,0,0,0,0,0,0,0,0,0,0,0,0,0,15,4,0,0,0,0,0,0,0,0,0,100
0ae7f1d024767140d97e8f17fbf35dec14a4b384,2,176,0,176,2,0,2,1,1,0,1,1,0.845350937,0,2,1,9,0,9,771,0,771,9,0,9,99.91131804
56f26f1f15b3869b411e9ffcf099ae533f5f45d9,1,2,5,3,0,0,0,4,5,148,1,1,0,38,16,5,13,11,2,137,130,7,2,2,0,100
9e433c691a2a4d349807f14e60d1fd4d46682cc0,1,0,527,527,0,0,0,3,7,4404,1,1,0,420,631,7,0,68,68,0,2392,2392,0,41,41,99.97786141
24cab3fc80e728c2df9067273cd2652a100a58c3,2,0,26,26,0,0,0,13,89,28,1,2,0.51594693,720,139,2,127,132,5,5005,5139,134,44,45,1,100
44966cf96eceb523c4d181ecce4f585bc44b8355,2,96,6,90,0,0,0,12,39,76,2,2,0.626751137,1683,140,1,260,255,5,14316,13710,606,85,83,2,100
63f789e9a94d7fdd3f73f5e9a98cab07bed45713,1,1,3,2,0,0,0,3,3,1704,1,1,0,507,141,2,88,88,0,3897,3911,14,25,25,0,100
105fa68de87954e1f863c28f322f57048a3d978b,6,519,569,50,0,0,0,9,38,97,2,3,2.00852141,2358,142,3,390,386,4,17137,17276,139,179,176,3,100
6f267b065e91ebfdfa2010306b32309736a29064,2,71,5,66,0,0,0,5,106,609,2,2,0.831474388,1424,143,4,268,261,7,11377,10896,481,72,68,4,100
f6a8f7aa42cae344f71cc6759f1c7880b49211fc,1,7,3,4,0,0,0,4,5,513,1,1,0,93,144,5,13,13,0,592,558,34,4,4,0,100
cf502a7876989588df54c941b80cc12792fabdfb,2,24,15,9,0,0,0,2,5,1418,2,2,0.918295834,167,41,0,20,20,0,1209,1145,64,9,9,0,100
4d0671991045e8dffa0994bb706261a6c377c8a6,1,3,7,4,0,0,0,5,6,2,1,1,0,97,42,1,13,13,0,558,592,34,4,4,0,100
8f9195618cb28373259704a262a5ee0a5118ea02,3,33,3,30,0,0,0,8,37,244,2,3,0.803071727,1909,632,1,338,334,4,15371,15139,232,106,104,2,100
d5b79bc7b42c39c5797b21f30acaaee7dac4ca53,6,481,8,473,4,0,4,18,68,360,2,2,2.088961327,2287,43,2,320,248,72,24402,22094,2308,101,75,26,99.889405
3dd7a6d910888ff5b8507b72ad70e084c10da09f,25,150,138,12,0,0,0,6,33,544,2,5,3.806806625,6037,145,6,1004,1012,8,40415,40619,204,489,489,0,93.1455095
8a28089ce2acbb5bf64158fc6228aaf256019d38,12,80,58,22,0,0,0,8,171,283,2,6,3.210822638,4273,146,6,681,683,2,29027,28923,104,301,301,0,99.90493292
c8834937c51743dca7f770f7795281d0468c130f,14,1292,211,1081,8,0,8,18,69,280,2,2,2.972924835,2925,147,7,564,370,194,32354,26321,6033,188,114,74,99.83111674
1a1cd4cce7a289818d4a3ae60e91dd1b9b8270ec,1,1,1,0,0,0,0,21,98,60,1,1,0,603,148,8,102,102,0,4422,4421,1,12,12,0,100
476acf04e41e1aace00e74424b32b50469c9e04f,1,1,3,2,0,0,0,12,32,0,1,1,0,342,17,0,69,70,1,2179,2191,12,39,39,0,100
70a0fc1db60fcab508a8061e31a2aa1fdb6269e0,0,0,0,0,0,0,0,0,0,0,0,0,0,0,149,9,0,0,0,0,0,0,0,0,0,100
8e6011c4bf71a64b7c5cd9250f3123a03b7f9742,0,0,0,0,0,0,0,0,0,0,0,0,0,0,150,10,0,0,0,0,0,0,0,0,0,100
bc9555800400352835da4fe84100310b4573e12e,1,35,15,20,0,0,0,12,40,44,1,1,0,850,151,9,188,184,4,6607,6488,119,49,49,0,100
af3ce805b4d69ace6def86a18b5714a4172c7c6d,1,28,0,28,0,0,0,17,43,161,1,1,0,733,18,1,78,74,4,6005,5890,115,47,44,3,100
14339314f362d0198fbbd00c726f16c08020f920,1,79,113,34,0,0,0,4,7,1317,1,1,0,196,19,2,34,40,6,1151,1430,279,8,9,1,100
0edcf063e32dfceb82c035e90941c0e8a7b0b1e6,10,577,543,34,0,0,0,2,3,4273,1,2,2.270869477,735,152,7,137,119,18,5512,5350,162,55,55,0,100
87720aa5ff00408994b7aa95b66d5ddac7dbb5d3,1,2,2,0,0,0,0,21,99,27,1,1,0,603,20,3,102,102,0,4413,4422,9,12,12,0,100
d294c36e69db09f8b7d778a23c025533ca3ea75d,3,8,8,0,0,0,0,18,70,680,2,2,1.561278124,2537,153,8,314,314,0,24907,24897,10,81,81,0,100
f7d120fcc461f79b8fa7e35b13095a688970d5c2,7,22,1685,1663,0,0,0,8,90,160,2,6,1.321149885,2392,21,4,163,341,178,8402,15646,7244,74,152,78,99.97892074
2e3acf87ab5e3a791bf5699230ffa77db7945370,2,5,3,2,0,0,0,10,107,107,1,2,0.954434003,1519,633,0,309,309,0,11602,11579,23,78,78,0,100
9378861d416ac536c3e53802ffc0ea31c5bee9cd,1,21,12,9,0,0,0,5,5,3264,1,1,0,95,44,0,14,14,0,593,562,31,2,2,0,100
ae658e88fc959e07d43a03b473a59ecd2ca075d8,1,1,0,1,0,0,0,8,12,291,1,1,0,182,45,1,32,32,0,1175,1169,6,9,9,0,100
931d406234053d498ad995a757c71e347af7566a,1,7,5,2,0,0,0,5,9,951,1,1,0,255,46,2,44,44,0,1787,1767,20,14,14,0,100
a92ceb4f3b7dc2c9537b1f334048b9f28b4e3adb,2,319,0,319,2,0,2,1,1,0,1,2,0.973460007,0,366,0,18,0,18,1445,0,1445,8,0,8,99.94731851
17e38590680c6327a45fc40adaa4cf643dbc9c2a,1,1,1,0,0,0,0,2,3,374,1,1,0,537,154,0,73,72,1,3061,3053,8,34,34,0,100
0985399b08941f4daa9ffdc055e3e116bab16916,6,88,19,69,0,0,0,19,73,969,2,3,2.213370446,4603,634,0,563,546,17,26025,25589,436,337,336,1,100
4d13657e23498d9f06fad3664719931754b79674,0,0,0,0,0,0,0,0,0,0,0,0,0,0,635,1,0,0,0,0,0,0,0,0,0,100
fd66cbd2a6cd86e44b248a67d47fc0142ec35317,3,39,8,31,0,0,0,12,100,105,2,3,1.444370176,1885,47,3,257,253,4,15026,14865,161,77,76,1,100
d1b2ba6fad446719f3064d401ffd68a25f72de03,1,1,1,0,0,0,0,2,4,1,1,1,0,537,155,1,73,73,0,3061,3061,0,34,34,0,100
609aedb73103366eb3239749fe8b87f5e127c70b,0,0,0,0,0,0,0,0,0,0,0,0,0,0,156,2,0,0,0,0,0,0,0,0,0,100
73b5bbf8f743a5d3d337297c0528731af7a27dbf,2,43,40,3,0,0,0,1,3,340,1,1,0.681655912,324,157,3,74,73,1,2156,2129,27,31,30,1,100
bbd1f621ab01766cc6d62414888f98203d08bcfd,2,60,10,50,0,0,0,3,5,13,2,2,0.692419486,866,158,4,101,94,7,6182,5803,379,62,61,1,99.98946925
8923da8cd49c041d99fd5996ddf807f54915c79e,1,827,823,4,0,0,0,19,97,106,1,1,0,822,159,5,138,137,1,5947,5918,29,23,23,0,100
c21d5e728e6d00a97c56ab64b87e6eb3917c7e36,2,15,12,3,0,0,0,12,41,62,2,2,0.99107606,1781,48,1,264,264,0,14522,14490,32,85,85,0,100
57d73ee05a9833df0abc8fdc4c71a21d1eda0f4a,1,43,35,8,0,0,0,10,25,671,1,1,0,194,49,2,28,27,1,1319,1301,18,6,6,0,100
7d3466d175b8229a60e63e59280fee4bef0a0364,0,0,0,0,0,0,0,0,0,0,0,0,0,0,160,6,0,0,0,0,0,0,0,0,0,100
5b924a6a2207454814eab7b7dbc734a317d28062,2,18,2,16,0,0,0,4,6,206,2,2,0.721928095,935,72,0,106,104,2,6420,6269,151,62,61,1,100
2cae0deca0074fc16c2bfb3c4efbe1de5caff153,1,0,0,0,1,0,1,8,17,92,1,1,0,0,161,7,0,0,0,0,0,0,0,0,0,99.97893406
3115d12712d763b48c71a0844535f389ce16ad98,0,0,0,0,0,0,0,0,0,0,0,0,0,0,162,8,0,0,0,0,0,0,0,0,0,100
ba46ddf73aa494dd7b5e668dbdd91afef6128675,1,20,17,3,0,0,0,18,71,95,1,1,0,2353,163,9,281,282,1,23777,23755,22,71,71,0,100
beb22a3f0b9ed18b91a6dc6d2a9c73cef1b8ee45,0,0,0,0,0,0,0,0,0,0,0,0,0,0,164,10,0,0,0,0,0,0,0,0,0,100
f52ad1d45dda2f7312098d8b51fa287f11cc1944,10,14,41,27,0,0,0,6,118,410,2,3,2.867290974,8795,165,11,1051,1054,3,69968,70129,161,357,360,3,93.2128955
63036e8f778e476b0dbccb4aadeb7dacbd11bf80,2,34,9,25,0,0,0,8,59,419,2,2,0.740147043,923,636,0,128,127,1,6945,6833,112,56,55,1,100
20eb916b6ca22089535cdbe145a823773447f50c,2,76,22,54,0,0,0,4,9,431,2,2,0.14372617,649,637,1,131,126,5,4754,4520,234,54,52,2,100
edc9fe4cca373f1d7126d72c24d3ff936c34c9a3,1,4,1,3,0,0,0,21,102,30,1,1,0,607,166,6,104,103,1,4468,4451,17,12,12,0,100
6157b483753be2cffce9e900be12a1b9bcac72ef,2,30,3,27,0,0,0,2,3,200,2,2,0.994030211,870,167,7,119,114,5,5707,5540,167,60,59,1,100
1630e2cc3f1e6aad2de6e60b3475a291304dd8b7,3,34,1,33,0,0,0,10,172,175,1,3,1.258229637,1978,638,2,417,411,6,13840,13724,116,179,177,2,100
2572eec3c41bdbb1f6fa9c48bcc8614131451ce6,1,2,2,0,0,0,0,13,50,317,1,1,0,377,50,0,64,64,0,2374,2374,0,43,43,0,100
ac5b20a3be5722eca829ff630e407831e302ba2d,1,27,9,18,0,0,0,2,2,98,1,1,0,76,639,3,10,10,0,677,526,151,2,2,0,100
ab410c2a8381a4b8f27356e5e4c2901a5ed7ced0,1,79,0,79,1,0,1,1,1,0,1,1,0,0,640,4,2,0,2,454,0,454,2,0,2,99.98103906
f5904073baecc7953ab3212d21f167d3a05274ec,14,3882,0,3882,14,0,14,1,1,0,2,1,3.350585408,0,641,5,389,0,389,22905,0,22905,167,0,167,93.76222135
e886f9ec1a3b19abb013e8415cfe4e62cb0b6887,1,1,0,1,0,0,0,2,2,9,1,1,0,181,168,2,21,21,0,1446,1440,6,5,5,0,100
3f00603e8183e10042d43b234bedbf53761deef1,9,327,249,78,0,0,0,2,108,566,1,5,2.158845192,2994,22,0,561,549,12,21700,21317,383,176,172,4,100
919a08b57741aa98b4c6631d88609ed4232ce3bf,1,22,1,21,0,0,0,17,65,38,1,1,0,620,642,4,122,119,3,3960,3832,128,66,65,1,100
43f246ccd9ed5195dacf29e96999a6c25b2e7a8e,1,41,0,41,1,0,1,1,1,0,1,1,0,0,643,5,1,0,1,141,0,141,1,0,1,99.91924086
6ebc9e4c9966ec3c5d1a31b014cf84f0fae77e60,3,41,25,16,0,0,0,5,18,1516,1,2,0.709782433,278,23,1,48,46,2,1774,1627,147,20,20,0,100
230b714356d7bcacbfbd2af233014156e25c0941,3,138,108,30,0,0,0,17,44,1635,2,3,1.333046579,1494,51,1,234,230,4,11217,10976,241,120,118,2,100
3b68b39a9dc23985552e0a67066cf6dc501af355,3,12,15,3,0,0,0,6,12,240,2,3,1.31056738,270,52,2,41,42,1,1726,1747,21,32,30,2,100
900be27a55268e83cb26caf1d916b6193e3b54e6,0,0,0,0,0,0,0,0,0,0,0,0,0,0,644,5,0,0,0,0,0,0,0,0,0,100
3fa160de303e152020a4b664b9c19df237798de7,6,216,124,92,0,0,0,4,27,679,1,2,2.238112044,2761,53,2,422,404,18,18541,18143,398,134,132,2,100
796d57b8967e51c7b3811e54f1a47e0fb2b52b44,1,155,0,155,1,0,1,1,1,0,1,1,0,0,24,2,14,0,14,961,0,961,8,0,8,99.97981429
6e3c9da8a6e6d1ce1776fc1b77e929506c0a4f17,1,1,1,0,0,0,0,5,8,5,1,1,0,72,25,3,13,12,1,412,403,9,6,6,0,100
c9c70f09593a1bef071160964adc5ae90a24084e,0,0,0,0,0,0,0,0,0,0,0,0,0,0,26,4,0,0,0,0,0,0,0,0,0,100
7ba30a4a8bdfa6d852b151d8a59f5804b5dbd98e,1,15,10,5,0,0,0,3,3,1555,1,1,0,78,54,3,13,13,0,382,366,16,8,7,1,100
e5947ef2afcda38f25af6c6d1d0423980becfc3f,3,59,18,41,1,0,1,11,48,496,1,3,1.384322535,1614,3,0,348,347,1,12483,12317,166,126,126,0,99.94957136
2f15274725af60e6a8af5d0eb3ad5dfdca5ebae6,2,24,13,11,0,0,0,5,7,691,2,2,0.699772222,231,27,5,23,21,2,1709,1629,80,13,11,2,100
378c234675fd4671b5ac6dc16e7752121bd4d47f,1,2,2,0,0,0,0,1,2,870,1,1,0,146,645,5,34,34,0,992,998,6,16,16,0,100
2e49045d2f4593796e1b615e5d5f749fb450a6ea,2,33,1,32,0,0,0,3,109,689,2,2,0.977417818,1434,646,4,276,273,3,11478,11325,153,70,69,1,100
310f8cf30e0713eef584d6653cce5a3c7b8a6b76,3,83,4,79,0,0,0,14,110,135,2,3,0.992539168,2138,647,5,393,385,8,17258,16847,411,114,113,1,100
99fca8bd91f1d36833efb13c06a4de96c152f27c,3,4,83,79,0,0,0,14,111,0,2,3,0.992539168,2196,648,6,385,393,8,16847,17258,411,113,114,1,100
f984898d37de25d9ecfeb1f508bc14b003f7bd97,24,1362,46,1316,6,0,6,7,173,357,3,12,3.343508855,10661,169,1,1703,1570,133,87778,81469,6309,690,603,87,92.52251433
149f9a14486e88012c93380163c150a3f824f680,3,111,4,107,0,0,0,14,113,2,2,3,1.063958207,2123,649,7,393,383,10,17246,16717,529,114,113,1,100
47b458ec1ddc042cc2dfbbce6d3a58fa75598e4f,2,241,0,241,2,0,2,1,1,0,1,2,0.99939135,0,650,8,21,0,21,1241,0,1241,7,0,7,99.95857841
42d65458c82768759a73385710a2c4afe48db4f0,6,90,11,79,0,0,0,17,114,65,3,5,1.573490873,4358,28,6,625,618,7,30536,30045,491,250,248,2,99.99171911
81e93c1efac414a2237f77358f3887c442fa03eb,6,175,6,169,1,0,1,8,115,532,2,5,2.480632845,2564,651,9,467,443,24,19759,18900,859,142,138,4,99.96687919
05f017d055147696d758647250d368c8110b3774,2,77,32,45,0,0,0,3,6,1169,1,2,0.989714805,247,55,4,45,43,2,2171,1802,369,13,12,1,99.99172048
713fe3cc5537075f85ce95409ac9bdd4dbe78af8,3,20,5,15,0,0,0,14,116,114,1,3,1.217796812,1957,29,7,387,383,4,14289,14206,83,118,117,1,100
f512d2296463c451d297189a74a021936e7117fa,5,16,60,44,0,0,0,5,117,0,1,4,1.77362113,2144,652,10,428,428,0,15322,15390,68,117,117,0,99.96687919
2ea0834d2a5a26d0da9b0e5b1f265068bb01a6ff,1,48,0,48,1,0,1,1,1,0,1,1,0,0,653,11,0,0,0,100,0,100,0,0,0,99.96687919
891828499b249e701b5ef5a8bbc1f3010330d82f,1,21,6,15,0,0,0,12,42,118,1,1,0,873,56,5,196,188,8,6794,6639,155,49,49,0,100
c75ce2bbc6f7a94d0da87cb1c68eb4a8e313ffea,0,0,0,0,0,0,0,0,0,0,0,0,0,0,654,9,0,0,0,0,0,0,0,0,0,100
4b5f34956eb50e8afd7cc6db34db498ab08e71bc,2,61,1,60,0,0,0,2,9,291,2,2,0.637387499,496,655,10,58,53,5,3567,3269,298,18,16,2,100
ecdf4d840c830866a658e4b7829be0ae4f7dff92,4,90,79,11,0,0,0,2,174,2232,1,3,0.508646249,1443,170,1,298,297,1,9612,9576,36,125,124,1,100
60cd90e415ffe09d58d83e07df2fe17b1db5d49c,1,35,2,33,0,0,0,3,4,16,1,1,0,90,656,11,6,5,1,726,538,188,4,3,1,100
decf682667b53924ac201cbe3dfd4748f4cd141e,0,0,0,0,0,0,0,0,0,0,0,0,0,0,657,12,0,0,0,0,0,0,0,0,0,100
229d9775a2fe53668fb3e1550c55178716cd8a4e,1,5,4,1,0,0,0,5,20,324,1,1,0,246,658,13,68,68,0,1577,1582,5,18,18,0,100
90104398adaaf15619807748f015eacd537e35af,2,126,35,91,0,0,0,7,12,1076,2,2,0.900834512,621,659,14,43,44,1,6159,5640,519,32,28,4,100
725aab0d587ddb3aa6d15d002602f48d8a5b45fd,1,24,0,24,0,0,0,3,5,4,1,1,0,113,660,15,8,6,2,821,726,95,5,4,1,100
e1318faa0b48d53c49a94c17c3c881ad9aa819a0,0,0,0,0,0,0,0,0,0,0,0,0,0,0,661,16,0,0,0,0,0,0,0,0,0,100
e7831c6a010300b0ec784b787122bb78beb91f28,1,1,1,0,0,0,0,20,118,17,1,1,0,1379,30,4,281,280,1,10389,10385,4,67,67,0,100
97191155e7167f37ee02c4d53c21623474eac8d6,2,10,2,8,0,0,0,17,119,98,1,2,1,2111,171,1,361,361,0,16987,16957,30,61,61,0,100
b284b44f24fc9ef518e64562b1271f15e9bd31e4,0,0,0,0,0,0,0,0,0,0,0,0,0,0,172,2,0,0,0,0,0,0,0,0,0,100
26270da3f6af2107e7b1bc5f0e778a73be37781a,1,12,3,9,0,0,0,6,23,276,1,1,0,89,173,3,10,7,3,437,398,39,7,7,0,100
38c5cb8021f779c1997895b27236f627b0dcd8e5,0,0,0,0,0,0,0,0,0,0,0,0,0,0,174,4,0,0,0,0,0,0,0,0,0,100
7e9269f8cc9a048a634d6a959f23394ca75b35b7,0,0,0,0,0,0,0,0,0,0,0,0,0,0,175,5,0,0,0,0,0,0,0,0,0,100
c4c61ca1ae71fd9789bcc7c0e518244f62f999c8,0,0,0,0,0,0,0,0,0,0,0,0,0,0,662,8,0,0,0,0,0,0,0,0,0,100
3576515af9b4adb37770e52012a8b52bd86ad3f6,1,0,1,1,0,0,0,2,3,92,1,1,0,182,663,9,21,21,0,1446,1446,0,5,5,0,100
fc0f5edd15f9dcc084b743c61ba38b8cf7985e8f,0,0,0,0,0,0,0,0,0,0,0,0,0,0,664,10,0,0,0,0,0,0,0,0,0,100
6d116181c7581f84a907d9b9e351ed4b50990055,0,0,0,0,0,0,0,0,0,0,0,0,0,0,665,11,0,0,0,0,0,0,0,0,0,100
53af56ab066d6a64c724241a58475aed4531df51,0,0,0,0,0,0,0,0,0,0,0,0,0,0,666,12,0,0,0,0,0,0,0,0,0,100
93419609c80d830609f18901547042a00d605ff3,2,25,1,24,0,0,0,2,2,648,1,2,0.89049164,2155,667,13,312,313,1,17459,17577,118,108,110,2,100
1cb2531c41db7942eca2b75f500cfe7e4a8cad81,0,0,0,0,0,0,0,0,0,0,0,0,0,0,176,5,0,0,0,0,0,0,0,0,0,100
4bf4770ab1ac97d4a3815404acebb8931ef13282,0,0,0,0,0,0,0,0,0,0,0,0,0,0,668,6,0,0,0,0,0,0,0,0,0,100
c614b3dc67464dc63efc0dc246409d17e7208b29,0,0,0,0,0,0,0,0,0,0,0,0,0,0,57,0,0,0,0,0,0,0,0,0,0,100
73b3ce76f724dad8a85ddefa2b1eb27b89a501d9,1,14,0,14,0,0,0,21,104,103,1,1,0,613,58,1,108,104,4,4624,4519,105,12,12,0,100
bf90b8d627ff875673fd884e4e40378560343d0c,1,1,1,0,0,0,0,11,49,81,1,1,0,1427,177,6,307,306,1,11209,11201,8,104,104,0,100
c54f1c89294b6e20bb51f0439655c86a60b8bc8c,2,8,10,2,0,0,0,16,43,64,1,2,0.650022422,549,178,7,99,99,0,3005,3013,8,50,50,0,100
bb08727d99ae4f29bf507f107412e196eff39354,2,77,77,0,0,0,0,15,88,498,2,2,0.173781323,1952,0,0,235,239,4,9866,9867,1,175,173,2,99.96691481
f24f09cd26fa43e5f235ef1e1c3ea623b519bf41,1,30,0,30,0,0,0,16,44,20,1,1,0,480,179,3,104,99,5,3061,2899,162,50,50,0,99.94215354
688ebade6a7888eaa962d6024cf6a0439eb53955,3,25,0,25,0,0,0,20,119,163,1,3,1.49868857,1461,31,0,296,291,5,11034,10906,128,73,72,1,100
b988aaa61e983518f09c56e9c103eb79c15730b8,2,33,18,15,0,0,0,3,5,826,2,1,0.873981048,156,32,1,20,22,2,1145,1079,66,6,6,0,100
fe0d2065365d9ac016249a7208e1a33e00c78ffa,21,924,180,744,5,0,5,2,175,380,2,10,3.326657775,6862,1,1,1111,1047,64,51552,47897,3655,486,441,45,99.89270386
83965fb4b56fc3a1d05af5c12a2ab6b4815dd693,2,77,56,21,0,0,0,20,75,8,1,1,0.508250565,1102,2,2,199,193,6,8811,8735,76,98,97,1,100
d2af8ee692492ce1717d28a356caaa9e9bdbbaf3,4,16,13,3,0,0,0,14,120,71,1,2,1.645523772,2641,33,2,505,505,0,19662,19633,29,119,119,0,100
c36f78b64b021e085fb535ae324c7ca8cd9041e5,1,2,2,0,0,0,0,25,176,14,1,1,0,1120,34,3,243,243,0,8054,8054,0,98,98,0,100
df6ef75b4c414d46c99211f876d217cc2a5b61c4,3,22,0,22,0,0,0,5,21,671,2,3,0.699857857,1473,669,0,196,195,1,11493,11436,57,78,77,1,100
b2e9fbb94c9f3d4c3ccd99fd5e337c07db7f6e38,3,5,7,2,0,0,0,3,177,16,2,3,1.459147917,1259,3,3,258,258,0,8848,8880,32,108,108,0,100
f51dce8c166b43c74f59b6def4ded93218dc6d0c,1,1,0,1,0,0,0,5,9,3135,1,1,0,123,180,1,18,18,0,872,861,11,6,6,0,100
9145680fb5a405f0a3bc84ea2206725b5a9fa79b,0,0,0,0,0,0,0,0,0,0,0,0,0,0,670,1,0,0,0,0,0,0,0,0,0,100
862622ca2bff164c69b8655d14d5b4172a615e91,1,3,0,3,0,0,0,4,4,853,1,1,0,40,671,2,8,8,0,439,394,45,3,3,0,100
b08cf58350c4e093f0575acd93c59b24799203ac,0,0,0,0,0,0,0,0,0,0,0,0,0,0,672,3,0,0,0,0,0,0,0,0,0,100
2125666c1941d4a88c08ab87ebf92ee46be4f0ea,16,120,136,16,0,0,0,9,178,469,2,7,2.790704337,5857,181,2,1071,1065,6,41538,41432,106,457,453,4,99.96701303
360ee22671c93d43cc94df9ecd0b238b0eef7e9f,1,2,2,0,0,0,0,25,179,0,1,1,0,1117,4,4,242,242,0,8033,8033,0,98,98,0,100
0ff33527b11c454f5b01c01b90790742a5345216,0,0,0,0,0,0,0,0,0,0,0,0,0,0,182,3,0,0,0,0,0,0,0,0,0,100
6d352acff4ff08ca3b5e86cb27fdc8a281ca8797,1,15,8,7,0,0,0,20,121,23,1,1,0,1382,35,4,281,281,0,10466,10397,69,66,66,0,100
402ff5b180e7cc1980e90729990c41bda2e6a6b5,1,9,4,5,0,0,0,20,122,0,1,1,0,1388,36,5,281,281,0,10472,10466,6,66,66,0,100
71c0e2ddb283df1049561dac8afbc271ef4050b1,1,12,2,10,0,0,0,2,2,1654,1,1,0,115,183,4,23,22,1,692,672,20,13,13,0,100
5b6eceec9d414c0bfc201bbfaf489e613098f651,0,0,0,0,0,0,0,0,0,0,0,0,0,0,673,4,0,0,0,0,0,0,0,0,0,100
1c84ea09b1741646890c439b80f82b832e70c97b,1,6,15,9,0,0,0,20,123,2,1,1,0,1391,37,6,279,281,2,10418,10472,54,66,66,0,100
d34e643dffe9565d992cf52627de938f49f35247,2,28,2,26,0,0,0,8,22,177,2,2,1,1141,674,5,139,136,3,10399,10302,97,57,56,1,100
8af89b0b77ed3ac76f6df22fa638f9bc46a2722c,1,2,2,0,0,0,0,19,59,566,1,1,0,1064,675,6,90,90,0,7770,7770,0,67,67,0,100
736efac598fe9f6be1c1d058a0e3985520a98840,1,0,4,4,0,0,0,19,60,0,1,1,0,1064,676,7,90,90,0,7770,7770,0,67,67,0,100
67aa859718c176079ff1f5f577f8244e1c772546,0,0,0,0,0,0,0,0,0,0,0,0,0,0,677,8,0,0,0,0,0,0,0,0,0,100
3afea449f93696b2c0aea778fc8c5a4af5c7dc14,2,4,4,0,0,0,0,2,2,40,1,1,1,241,38,6,46,46,0,1536,1544,8,27,27,0,100
2b956385bca57041dd5bdbcdc7a4d176adff2f8f,2,21,0,21,0,0,0,5,10,24,2,2,0.791858353,1238,678,9,130,128,2,10006,9916,90,61,60,1,100
a7b989a741fd8a4fb8720951b8cccafdfe0ed9d4,2,35,0,35,0,0,0,6,17,643,2,2,0.512709142,897,679,10,131,128,3,6414,6219,195,38,37,1,100
40f85da5944bcb9458de3bb649c9b0b5ab777abd,1,31,0,31,1,0,1,1,1,0,1,1,0,0,680,11,1,0,1,82,0,82,1,0,1,99.98350107
a2a82a3bb3e49b863f15a19e0fe1a23f29faf8f5,0,0,0,0,0,0,0,0,0,0,0,0,0,0,681,12,0,0,0,0,0,0,0,0,0,100
ebe330a0f904de0a39276b565b8d0673b0c453d3,0,0,0,0,0,0,0,0,0,0,0,0,0,0,682,13,0,0,0,0,0,0,0,0,0,100
dba538627742b9117b3509e20a1deff233c3b051,5,46,42,4,0,0,0,15,124,229,2,3,0.423883064,2706,184,4,438,438,0,18765,18724,41,109,109,0,99.95876629
a98c14b5ddbd0968cf062d3eedd566c141577b36,2,14,10,4,0,0,0,9,29,522,1,2,0.543564443,1214,59,0,96,95,1,7243,7222,21,60,60,0,99.99175326
a6c8b2cd4f6201f86e2b599fd1a67a50fabeb6ee,1,4,4,0,0,0,0,8,12,570,1,1,0,91,185,5,15,15,0,536,536,0,6,6,0,100
a9bd6f25ccf610e92c9c1af15532a6fad77197bf,2,37,16,21,0,0,0,4,7,281,2,1,0.968700344,1365,186,6,159,157,2,8927,8833,94,85,83,2,100
3e05eb4a9f10dae72a541badc46e9276079ec816,0,0,0,0,0,0,0,0,0,0,0,0,0,0,187,7,0,0,0,0,0,0,0,0,0,100
45c96dae2123300041b33536cc74f7a94ce641dd,0,0,0,0,0,0,0,0,0,0,0,0,0,0,188,8,0,0,0,0,0,0,0,0,0,100
ec23e15db9b0a5f9b811c7727bf85fc1a73aef15,0,0,0,0,0,0,0,0,0,0,0,0,0,0,189,9,0,0,0,0,0,0,0,0,0,100
90c4a76c0d8c069afe38202d207c2484216f490d,1,6,1,5,0,0,0,12,34,44,1,1,0,340,190,6,70,70,0,2187,2187,0,39,39,0,100
5bb8e071963a0cfa3da3644683cb1c3557d09618,6,41,31,10,0,0,0,7,125,1165,1,6,1.535166883,3113,191,7,671,663,8,23254,23233,21,190,188,2,100
2eb670355cb3935cb43369b0d0975eece75c2a25,0,0,0,0,0,0,0,0,0,0,0,0,0,0,683,5,0,0,0,0,0,0,0,0,0,100
1981fdff85a7ac837fd6f82074c1c9477d617ebc,3,74,8,66,1,0,1,5,5,900,1,2,1.431454453,181,192,8,35,28,7,1421,1162,259,16,13,3,99.94227756
871cc4f2e453541ee976899c28656ccd3a27b5c0,0,0,0,0,0,0,0,0,0,0,0,0,0,0,193,9,0,0,0,0,0,0,0,0,0,100
0919576ec4376db850ccacc945fe68b50956ff3c,5,6,7,1,0,0,0,2,71,690,2,5,2.295465679,2082,194,10,394,394,0,14111,14143,32,138,138,0,100
5dd4f757588efee4bb6e250e0a8a6f6a0e86af54,0,0,0,0,0,0,0,0,0,0,0,0,0,0,195,11,0,0,0,0,0,0,0,0,0,100
ee69e6cbc94093f52039a2bebd0f6540a1cfa8ca,0,0,0,0,0,0,0,0,0,0,0,0,0,0,5,0,0,0,0,0,0,0,0,0,0,100
f46676e9af21f119e4065337cf5498eb18a284a3,34,1618,1807,189,3,0,3,9,126,947,2,10,4.071340114,13211,196,12,2329,2365,36,97967,96716,1251,749,788,39,99.72864074
a2d79078f2b7cb81c822256a83885a6de2d67b03,0,0,0,0,0,0,0,0,0,0,0,0,0,0,60,0,0,0,0,0,0,0,0,0,0,100
88ae4a5fc1d6ff4a9d3c070fe2fc64a50827c37a,2,5,20,15,0,0,0,22,180,46,1,2,0.970950594,2255,61,1,464,466,2,15123,15197,74,164,164,0,100
34ac656ffb483d2033eafd138b55b3985da45cd1,4,126,139,13,0,0,0,3,26,72,1,2,1.966381172,940,62,2,177,177,0,6314,6335,21,81,81,0,96.72145254
6cf957054fdcbb720cc25ad0674bfefb6d04f686,1,11,17,6,0,0,0,2,4,566,1,1,0,235,197,7,17,17,0,2093,2195,102,14,14,0,100
f132ef8322986d5211e161d51454cc5762d70344,3,41,10,31,0,0,0,2,13,172,2,3,1.358334214,318,684,1,49,47,2,2366,2251,115,35,33,2,100
420bd35c13e91d3f70e9ac87b64088e1bd47e47f,1,0,1,1,0,0,0,1,2,262,1,1,0,545,685,2,122,122,0,3985,3999,14,40,40,0,100
b4104abfb6ecddb06df6839ecd87b91401718ad8,0,0,0,0,0,0,0,0,0,0,0,0,0,0,686,3,0,0,0,0,0,0,0,0,0,100
2c2ea658010aa70c3d54bca983215f2c359a27d2,0,0,0,0,0,0,0,0,0,0,0,0,0,0,63,3,0,0,0,0,0,0,0,0,0,100
6abe6f8ad1daca292b77cde079508f1837526c79,2,40,6,34,0,0,0,1,5,108,2,2,0.932111568,377,198,8,29,28,1,2656,2431,225,15,14,1,100
11181e2cf51ca49390a0a1ba1da3a25f0ce41e70,1,61,2,59,0,0,0,8,19,245,1,1,0,550,64,4,133,122,11,4219,3768,451,32,31,1,99.9456029
61f12cfdbe975085f6f695569396c64690bf3764,1,32,0,32,0,0,0,3,4,672,1,1,0,97,687,3,9,7,2,1041,806,235,6,5,1,93.67333764
a32d7718b4953bf6573c43f82146a0089f0d4edd,10,10,10,0,0,0,0,2,3,1718,1,1,3.321928095,500,199,2,70,50,20,3542,3362,180,30,30,0,100
c1798a081a7f4a99cae83c83ac87c2908dabb764,0,0,0,0,0,0,0,0,0,0,0,0,0,0,688,4,0,0,0,0,0,0,0,0,0,100
606244788397cf4288cbf11718319c6a11404815,5,355,377,22,0,0,0,9,41,295,2,4,1.516852735,1825,200,3,270,272,2,13607,13654,47,137,139,2,90.85984325
5c598bd6ac5b1ad0ba906cc301455ace6e876cb3,0,0,0,0,0,0,0,0,0,0,0,0,0,0,689,5,0,0,0,0,0,0,0,0,0,100
1352b3972dc5647b307d03f2aec6a058bed43dd9,0,0,0,0,0,0,0,0,0,0,0,0,0,0,690,6,0,0,0,0,0,0,0,0,0,100
858ebbe0c0d8eb8277c14bb49669fe8fe878405c,2,365,655,290,0,0,0,2,8,1029,1,2,0.555822738,716,691,7,100,126,26,4592,4660,68,30,39,9,100
cc62d4744703d26a78b3dd5f67d809d971957ec7,2,19,1,18,0,0,0,8,23,422,2,2,0.811278124,1441,692,8,218,216,2,12430,12303,127,77,76,1,100
c5c0d3979451c2ed7981369e43617d810afd33e1,16,585,318,267,2,0,2,5,45,983,2,10,3.247549414,2349,201,3,582,397,185,17047,15413,1634,150,129,21,99.91818368
57eb1bac81a4e03e9838c06f642a1432dbbe4e1b,1,0,12,12,0,0,0,1,2,0,1,1,0,132,202,4,83,85,2,713,826,113,9,9,0,100
c8b00ea9e7bb16d54e3addaf0163dd9912dc7c60,1,1,1,0,0,0,0,20,127,70,1,1,0,1389,39,0,280,279,1,10450,10443,7,66,66,0,100
0775f3408e354bd7cf20de7585b09629c9a004cb,14,332,160,172,1,0,1,3,181,413,3,9,2.985877014,3771,65,1,713,704,9,27702,26680,1022,260,258,2,99.60224375
521870c30d018ee4f03190fcc45414954f75118b,2,3,3,0,0,0,0,5,10,4,1,2,0.918295834,154,203,4,35,35,0,800,800,0,18,18,0,100
92ea6a55f7299422659a659987d48ddae3da51eb,13,288,364,76,3,0,3,5,28,80,2,7,3.013364157,1780,204,5,280,435,155,10807,11720,913,105,106,1,99.88812042
931d88cca22213f9d698496dfa3d76d802200087,2,36,27,9,0,0,0,8,12,1876,2,2,0.985228136,602,66,1,62,64,2,4848,4708,140,30,33,3,100
f5382aad1c9524c8e32a669cd5b0634940e8abb4,0,0,0,0,0,0,0,0,0,0,0,0,0,0,367,0,0,0,0,0,0,0,0,0,0,100
afc213d9cd933d000befa9ebbc617d6d8f2af41a,0,0,0,0,0,0,0,0,0,0,0,0,0,0,205,4,0,0,0,0,0,0,0,0,0,100
506e921aea550c4d834149f9731237161c00befc,0,0,0,0,0,0,0,0,0,0,0,0,0,0,206,5,0,0,0,0,0,0,0,0,0,100
608edc6f9e0ad4ea1ee881f74570b524ea29f2ef,0,0,0,0,0,0,0,0,0,0,0,0,0,0,207,6,0,0,0,0,0,0,0,0,0,100
9781797a3a18a3d8b30762727bd64678dda5d25f,0,0,0,0,0,0,0,0,0,0,0,0,0,0,208,7,0,0,0,0,0,0,0,0,0,100
e9d99f41957488792da8a79a109b089d8ae3ff6e,4,302,0,302,3,0,3,18,72,98,2,2,1.916076217,2352,209,8,300,281,19,25249,23777,1472,80,71,9,99.93903678
20330a57f445116e29ce3b8d8b0f12236465b110,0,0,0,0,0,0,0,0,0,0,0,0,0,0,210,9,0,0,0,0,0,0,0,0,0,100
5790411dad171801793d4fb924214cb201dac041,5,743,511,232,0,0,0,5,182,1245,2,4,1.645222209,3309,211,10,637,602,35,25508,24275,1233,256,231,25,100
b67306a3d15c3e13d3eb621f2f586249a764c2e1,4,173,57,116,0,0,0,18,73,0,2,2,1.942562764,2566,212,11,306,300,6,27504,25249,2255,80,80,0,100
290eb1083f67dafa1a745a44b526c67b32933e9e,0,0,0,0,0,0,0,0,0,0,0,0,0,0,213,12,0,0,0,0,0,0,0,0,0,100
5e2f75cb9f2d357f135a4cb3d2f905fb78fa9d40,0,0,0,0,0,0,0,0,0,0,0,0,0,0,214,13,0,0,0,0,0,0,0,0,0,100
01222694ba35923059194103e075185bbfdc050d,0,0,0,0,0,0,0,0,0,0,0,0,0,0,40,0,0,0,0,0,0,0,0,0,0,100
d95d3beb3c320c98d0af2ce3bcd2f3b656bdc98d,20,308,335,27,1,0,1,20,183,409,2,9,3.045819128,10095,693,0,1273,1272,1,72586,72721,135,621,621,0,99.91876523
e3bd54e5c44746c2fc26ad36076aaa231c995cc7,2,1,3,2,0,0,0,20,95,6,2,2,0.811278124,1186,215,10,228,228,0,9171,9193,22,102,102,0,99.96953387
9393879de448059db13ef0dc21dde970250c0f55,1,1,0,1,0,0,0,20,78,2,1,1,0,919,216,11,181,181,0,7245,7230,15,85,85,0,100
5a69334be2f50d14ab234e31f569157a5bd2ac81,0,0,0,0,0,0,0,0,0,0,0,0,0,0,217,12,0,0,0,0,0,0,0,0,0,100
55fbcd9e73d98ff53391103cabcc269398f4b1cf,2,238,152,86,0,0,0,4,7,1473,1,2,0.854751115,431,218,13,72,57,15,3039,2535,504,19,16,3,100
b8a5c4d1c88fd55e47d7f95c5d8b42c9510bea7e,1,1,1,0,0,0,0,6,9,710,1,1,0,104,219,14,30,29,1,571,565,6,10,10,0,100
e81028183b680d7feabb18e9950299ff7fefe03b,2,23,8,15,0,0,0,8,21,403,2,2,0.869137581,814,220,15,85,83,2,6286,6156,130,40,39,1,100
016713ec01e16387da8d3c85e72a11be7f5234f1,2,58,19,39,0,0,0,3,3,262,1,2,0.624274101,2174,221,16,313,312,1,17604,17459,145,108,108,0,100
7b7fe666342bb10b51aa26b72c9a37b2c81f4c11,1,0,0,0,1,0,1,6,11,518,1,1,0,0,222,17,0,0,0,0,0,0,0,0,0,99.97968306
1ee4f144dc7d429d4bec254f260dd782e914a0cc,12,213,164,49,1,0,1,3,110,183,2,7,3.049205253,3071,41,1,568,567,1,20320,20229,91,228,221,7,99.97968306
555b58f6d658386bf139263b1ab68a3c7a2329df,2,33,1,32,0,0,0,14,41,188,1,2,0.430551867,986,42,2,213,208,5,7020,6800,220,81,80,1,100
83a961bbfd26d114ca28d93ad695df60c4c20eeb,0,0,0,0,0,0,0,0,0,0,0,0,0,0,43,3,0,0,0,0,0,0,0,0,0,100
8d2fe84e0575d4cb3fbc757f8b7df9c3644f3aeb,0,0,0,0,0,0,0,0,0,0,0,0,0,0,44,4,0,0,0,0,0,0,0,0,0,100
28bc905e824c5886eaddc46a7b5f78d632a5b60b,1,0,32,32,0,0,0,3,5,90,1,1,0,127,694,1,7,9,2,806,1041,235,5,6,1,88.21695066
170425eaec075eeeb1c48cc5167d9ff4a045c2c3,4,38,30,8,0,0,0,16,46,146,1,3,1.459023424,744,223,18,138,136,2,4622,4540,82,61,61,0,94.72862632
570b7ac5a7145068f72cb9dede204b96591db3a4,1,3,3,0,0,0,0,6,16,6,1,1,0,174,695,2,35,35,0,1146,1146,0,19,19,0,100
088d3caab282ce9145787db8edcaeff6a46d21a6,0,0,0,0,0,0,0,0,0,0,0,0,0,0,696,3,0,0,0,0,0,0,0,0,0,100
515e46e0fb24b789c3b9a40404ea70e28c7cd067,1,2,2,0,0,0,0,1,3,696,1,1,0,190,697,4,35,35,0,1281,1281,0,6,6,0,100
0322233f511d454f5f75fefb94c0fed838d3e7f2,2,3,3,0,0,0,0,7,7,646,1,1,0.918295834,132,45,4,19,19,0,771,782,11,7,7,0,100
2e1186e21c6c21b748dee5430ffa58c1850e6f75,2,61,60,1,0,0,0,4,8,53,2,2,0.734955759,660,46,5,104,104,0,5107,5159,52,54,51,3,100
566350b5dcd5ec008383e8640fb6a60e66a699c0,0,0,0,0,0,0,0,0,0,0,0,0,0,0,698,5,0,0,0,0,0,0,0,0,0,100
7e1d86931657f021b5d3c9596aff398d1198502f,1,22,17,5,0,0,0,20,128,86,1,1,0,1389,47,6,281,280,1,10479,10450,29,66,66,0,100
1a64fa014c32860b5fefc687e93c815bc16c9112,0,0,0,0,0,0,0,0,0,0,0,0,0,0,48,7,0,0,0,0,0,0,0,0,0,100
4e781c929fca2315389f55ebf0e6e3da8bfb36d7,12,185,195,10,0,0,0,1,3,696,1,1,2.591022317,2263,699,6,390,391,1,17462,17555,93,53,53,0,100
8ea6def548bf9d21bd4a8d6a7e3589b4653f340d,0,0,0,0,0,0,0,0,0,0,0,0,0,0,6,0,0,0,0,0,0,0,0,0,0,100
f2da08cb065d6d3c232d2860054cae7579cb3bb1,1,1,0,1,0,0,0,10,39,3356,1,1,0,961,700,7,251,251,0,7145,7137,8,48,48,0,100
b053d5598fdcfcffb8e7fc128bd499e9308e0757,5,37,9,28,0,0,0,20,184,77,2,3,1.750883217,3876,701,8,580,577,3,27567,27409,158,275,274,1,100
6a1104f52a225321f5ee134e16f8cf5e472b6220,1,2,9,7,0,0,0,16,47,22,1,1,0,504,224,9,104,105,1,3054,3084,30,50,50,0,100
6e3be3423c92b5bce01c7ffbd65ead2fdde775f7,2,50,15,35,0,0,0,18,48,13,2,2,0.937456171,1382,225,10,208,206,2,10537,10329,208,98,97,1,100
958a767028ddc98e2ed1861b98ad99e564e453fe,222,20339,5744,14595,76,0,76,1,185,752,3,35,6.577878803,50858,702,8,9469,7679,1790,458551,378640,79911,3601,2872,729,90.71562696
ab2c72b13ff748543b39396e5f8ac591cdefb7d8,2,7,3,4,0,0,0,2,2,0,1,2,1,299,67,0,47,46,1,2287,2254,33,19,19,0,100
c7750f93d4c0bff26d9bd7d3519bc353d742fc30,3,22,17,5,0,0,0,2,29,12,1,3,0.579635409,860,68,1,174,172,2,5731,5715,16,90,90,0,100
7bca28a78677fe25b88ac510720bd02d485b2df1,1,2,2,0,0,0,0,5,11,92,1,1,0,79,49,8,16,16,0,431,434,3,7,7,0,100
5c20f83e547b2a11c5e02ba017cd530a2c643957,2,33,14,19,0,0,0,7,18,696,2,2,0.999673426,499,226,10,73,71,2,4010,3839,171,26,26,0,99.99059089
04fe5ed7d682fba6811c9a2976240183981a0f84,0,0,0,0,0,0,0,0,0,0,0,0,0,0,227,11,0,0,0,0,0,0,0,0,0,100
49775b5693d8781a79f889136a5759fa98814b36,8,72,62,10,0,0,0,1,2,8,2,2,1.831158797,2775,703,9,352,349,3,21777,21734,43,122,121,1,100
0271c894ac793972b328582674c72032414bb338,3,11,5,6,0,0,0,21,112,39,2,3,1.5,926,69,2,169,166,3,6654,6640,14,52,50,2,100
b048c9e5302ab7c518de9cd2281137883b3445d8,0,0,0,0,0,0,0,0,0,0,0,0,0,0,704,8,0,0,0,0,0,0,0,0,0,100
9ad88082f335a2de315f639fb3de4e93a480f338,2,135,1,134,1,0,1,18,75,12,2,2,0.973472882,2426,228,4,291,282,9,26477,25795,682,77,73,4,99.98118532
ea4c6f9d3d49e3a7caef59c2f782beb51bfcdfe7,0,0,0,0,0,0,0,0,0,0,0,0,0,0,229,5,0,0,0,0,0,0,0,0,0,100
b81df9603a63b5b7077c84625187008a27c4650e,1,1,1,0,0,0,0,4,13,66,1,1,0,304,230,6,40,40,0,1630,1626,4,23,23,0,100
b230e25df6ba427b7f6c90dcbf095d98a13fa47c,1,13,9,4,0,0,0,13,62,369,1,1,0,447,231,7,98,98,0,3102,3095,7,35,35,0,100
f9de4e1b4e91adfc19ad4512e3b827ff7a297295,0,0,0,0,0,0,0,0,0,0,0,0,0,0,70,3,0,0,0,0,0,0,0,0,0,100
65e634bb74ce39c055c654c50fc616b1728a5315,2,155,24,131,0,0,0,3,15,2690,2,2,0.90267228,709,232,8,89,82,7,5981,5054,927,43,41,2,100
fbf40fc683ce1367df3becced4252fb08849701d,283,1,84388,84387,0,0,0,11,21,4457,2,17,7.497749056,59313,233,9,58,8663,8605,2005,468668,466663,10,3142,3132,90.90830225
8746506dc821642f65de798ec49df56820839810,0,0,0,0,0,0,0,0,0,0,0,0,0,0,234,10,0,0,0,0,0,0,0,0,0,100
55b0705970d56c45a762c7ba231f46e8c685a35b,0,0,0,0,0,0,0,0,0,0,0,0,0,0,235,11,0,0,0,0,0,0,0,0,0,100
099d2aee3ce4d1295c848abcd9148e55b22112d7,0,0,0,0,0,0,0,0,0,0,0,0,0,0,236,12,0,0,0,0,0,0,0,0,0,100
5e4bd817ea3f05998dd64f92f853f1fb22c3070b,0,0,0,0,0,0,0,0,0,0,0,0,0,0,237,13,0,0,0,0,0,0,0,0,0,100
03f24cc8db2e79de726d148cc4c1ab6250851930,0,0,0,0,0,0,0,0,0,0,0,0,0,0,238,14,0,0,0,0,0,0,0,0,0,100
c37014005007d533e8c8eb2b3b7c68fe02136f85,0,0,0,0,0,0,0,0,0,0,0,0,0,0,239,15,0,0,0,0,0,0,0,0,0,100
6565f6e59449bdb42881ccb8edb046e95209c0f3,1,19,9,10,0,0,0,2,2,33,1,1,0,770,240,16,151,146,5,6932,6848,84,18,16,2,100
8fe2cc60a0341b2678c0a1741ca47d908898d5b3,1,1,2,1,0,0,0,14,63,11,1,1,0,451,71,4,98,98,0,3091,3102,11,35,35,0,100
6e488f28ad2a983286e054725b4787df6d0332c1,20,1388,120,1268,7,0,7,1,16,115,2,6,3.719293407,4189,705,1,864,696,168,41503,34035,7468,245,187,58,89.53404277
79ee4aeb2f0bf4cd5f51cb5c5eaaa268092ebd11,1,23,0,23,0,0,0,1,3,44,1,1,0,223,706,2,36,32,4,2068,1889,179,8,8,0,100
2ba3631cb76f7ae67b0d924d1078cb86d29479af,2,4,3,1,0,0,0,1,22,26,1,2,0.985228136,274,707,3,45,45,0,2185,2161,24,10,10,0,100
1fe3a09b9d18bd4402fe75911fbe77497d110c2a,2,5,13,8,0,0,0,1,4,52,1,2,0.503258335,315,708,4,65,66,1,2007,2022,15,42,44,2,93.81804044
2f5f7c4db36b06fd3fcf7bd961cd532d185e1fe3,1,3,1,2,0,0,0,20,130,54,1,1,0,1396,241,13,284,283,1,10534,10526,8,68,68,0,100
5234ae45c485e07f7af2ababa4c0f63b5b8ee76a,2,21,1,20,0,0,0,2,23,56,1,2,0.773226674,271,242,14,46,45,1,1935,1857,78,17,16,1,100
996ceba34d867885f141fa8c51f5871b83028c95,1,4,0,4,0,0,0,1,4,3,1,1,0,243,709,5,38,36,2,2104,2068,36,8,8,0,100
75d645e499885a96868efe37d1832e7c90b69c52,1,1,1,0,0,0,0,1,2,3,1,1,0,68,710,6,11,11,0,524,522,2,5,5,0,100
381ec8ab3ed0aba4f6541fe087c405314f616458,1,5,1,4,0,0,0,8,12,1190,1,1,0,188,711,7,44,43,1,1142,1127,15,18,18,0,100
020155fdc42e555401e5772da7dce4016ad4cc1f,0,0,0,0,0,0,0,0,0,0,0,0,0,0,243,15,0,0,0,0,0,0,0,0,0,100
975b60b21a9c48a8f58ae3ee336b61354db9d429,1,1,1,0,0,0,0,6,11,223,1,1,0,437,244,16,100,100,0,2988,2995,7,34,34,0,100
3cc7387f9ae7f13ea6ff04fc6330bcf164f1f1ac,0,0,0,0,0,0,0,0,0,0,0,0,0,0,712,8,0,0,0,0,0,0,0,0,0,100
2dda3e1203f965293eb4a06b600d89c8733f41ae,0,0,0,0,0,0,0,0,0,0,0,0,0,0,713,9,0,0,0,0,0,0,0,0,0,100
aea2c77171de623621db06a9618f0cc62fb18bcb,0,0,0,0,0,0,0,0,0,0,0,0,0,0,714,10,0,0,0,0,0,0,0,0,0,100
c5f12d26ad0e7e056b56d4493f74c9b6037cc971,1,8,6,2,0,0,0,1,3,9,1,1,0,164,715,11,32,32,0,970,952,18,9,9,0,100
afb868d03332946b6482b5c050d11e5f14504ae0,1,1,1,0,0,0,0,8,13,5,1,1,0,191,716,12,45,44,1,1150,1142,8,18,18,0,100
a3915173b4db315d58ced0f17f151b5c81a52ca3,4,108,24,84,0,0,0,21,122,55,2,2,1.123522411,3981,72,2,688,682,6,32165,31731,434,173,171,2,93.87044635
5c849edecb3bec4f0e0ef028b268bbc2e0152bda,2,18,7,11,0,0,0,9,62,66,1,1,0.904381458,1937,717,12,175,172,3,15167,15074,93,111,111,0,100
764b84d9c4f754d6a4f730a1c988a67cabc57d42,1,6,0,6,0,0,0,14,44,66,1,1,0,955,718,13,53,52,1,7542,7520,22,41,40,1,100
5e433cb45c5263d1a234902b125c951be60ace47,1,8,8,0,0,0,0,20,96,102,1,1,0,265,719,14,47,47,0,1941,1941,0,17,17,0,100
e670646ac4c1b89663e05c74177e7caa3a27868d,1,36,0,36,0,0,0,1,5,10,1,1,0,247,720,15,49,38,11,2412,2104,308,9,8,1,91.23467412
08305272ce4c4a6aeb64c408eea2d05f7b400e8c,2,101,26,75,0,0,0,4,14,3301,2,2,0.950732532,831,721,16,81,75,6,4887,4567,320,44,42,2,99.81947829
89f09837eab6407ad678233cc144749ca6cbf060,1,2,3,1,0,0,0,2,2,2888,1,1,0,76,245,13,9,9,0,428,437,9,6,6,0,100
e41764f14f5625e6834e58ac960f266f6eac7119,3,100,15,85,0,0,0,1,28,543,1,3,1.139258679,805,722,17,156,139,17,6092,5638,454,49,46,3,100
af97fc0d86549e4d9fb3f8f0f38f98080dfc9895,1,1,1,0,0,0,0,1,3,2694,1,1,0,644,723,18,124,124,0,4071,4077,6,52,52,0,100
ae2dd3a97f7b73ed55c9d2a1d3ecdb299405d704,0,0,0,0,0,0,0,0,0,0,0,0,0,0,246,12,0,0,0,0,0,0,0,0,0,100
cbe8078ac8876b367acbaf5697cd57c5e9992205,2,59,16,43,0,0,0,1,11,609,1,2,0.978217666,1768,724,19,264,256,8,15489,15196,293,63,62,1,100
d4b90a734190ca0e8d1af549956d175675b19a49,0,0,0,0,0,0,0,0,0,0,0,0,0,0,725,20,0,0,0,0,0,0,0,0,0,100
6e4d6ba8852f7b7cd8c474f1412e0ad2d24a5966,3,38,2,36,0,0,0,4,7,137,2,2,1.12087997,308,247,6,27,23,4,2629,2448,181,18,17,1,100
a9de8581eb5a883b3eb62c1d91995259233249e9,5,86,6,80,1,0,1,1,4,344,2,3,0.917353825,352,726,21,68,66,2,2528,2024,504,36,34,2,94.15762248
a5c83dc892dca81a097d359cbb5d3103b315708b,2,11,11,0,0,0,0,1,3,804,1,2,0.994030211,525,727,22,43,43,0,4395,4395,0,40,40,0,100
910c6e303928fdaaaf2b80c9dbf1c51956b415ee,5,50,7,43,0,0,0,3,31,1061,2,2,2.307287566,842,728,23,153,148,5,5434,5247,187,87,86,1,99.95332011
ee6111d97ab65b3e6e9e0bc5ec0eeff54ef4d485,2,40,1,39,0,0,0,7,100,469,2,2,0.996134484,1987,729,24,328,325,3,14424,14151,273,61,58,3,99.98833411
c48b71340234529f3726bb9a5787a0927b316691,2,11,0,11,0,0,0,18,76,54,2,2,0.684038436,2526,730,25,293,291,2,26564,26477,87,77,77,0,100
dfdbb23da25e70550f3a5fc71f2f2a5078615807,2,2,12,10,0,0,0,12,26,461,1,2,0.940285959,1093,731,26,97,97,0,9275,9329,54,41,41,0,95.22920556
01286c8a4db2bead1f8afcae926c1e7110ca9016,2,2,2,0,0,0,0,3,3,52,1,2,1,194,248,7,27,27,0,1659,1659,0,11,11,0,100
aeb5d11d0c0eba20f41062acc94cdcbe3a092e4c,3,14,3,11,0,0,0,5,28,341,1,2,1.022420704,915,732,27,199,197,2,5887,5863,24,102,102,0,99.90689013
9f0d797f0451d24877db10bac7bfa05d4e4634c8,3,51,0,51,0,0,0,2,4,429,2,2,1.584962501,491,733,28,93,93,0,3467,3467,0,45,45,0,100
57191a9f03a2f5b46ca59c566f44508fab36b7f2,5,88,6,82,0,0,0,4,114,40,3,5,1.658828643,1235,249,8,193,188,5,9699,9149,550,69,68,1,99.96285635
042204f36aa3715d2bf2fdb6666cda6c54cc9a24,0,0,0,0,0,0,0,0,0,0,0,0,0,0,734,29,0,0,0,0,0,0,0,0,0,100
6bc72f16c22ce76d8fb53e736bb9cbbc53430fc7,3,30,59,29,0,0,0,3,4,62,1,2,0.749831573,521,73,0,87,92,5,3683,3852,169,33,35,2,100
f3e4cea3bfe76310dcc9f0c9f8a250095ebfaa73,3,73,35,38,0,0,0,10,101,80,1,3,0.792089951,1579,74,1,290,283,7,11212,11057,155,86,82,4,100
e62022c3f54501bfcea553ce93065bd2924ca976,0,0,0,0,0,0,0,0,0,0,0,0,0,0,735,10,0,0,0,0,0,0,0,0,0,100
e27ad3a856341854bb422394d932e5fc0fee1da4,26,733,634,99,0,0,0,5,131,528,3,9,3.28116486,11641,75,2,1729,1710,19,90514,89578,936,568,567,1,99.85106581
753353a6824d4f6e4d0ea63b041c275c94439831,3,10,10,0,0,0,0,3,7,13,1,1,1.295461844,1383,4,0,275,275,0,11815,11815,0,44,44,0,100
7a9106da8d7c8d7f1aa1edd9af87abc003bbbeeb,5,125,29,96,1,0,1,3,4,78,1,1,2.05565037,432,250,0,86,73,13,3746,3230,516,32,27,5,99.95334951
09c109beac43ea820c2e25f99a5352609916bf37,2,27,108,81,0,0,0,3,6,18,1,2,0.790078158,1008,76,3,186,197,11,8368,8948,580,21,25,4,94.45419808
729bf353cc48dbdf9207f3c638b9b02ea53574b8,4,13,12,1,0,0,0,4,29,51,1,2,1.459470571,2943,77,4,507,507,0,25050,25080,30,122,122,0,100
ca00bb663aa60b116fcf359f3929201840cde624,2,110,97,13,0,0,0,3,10,706,2,2,0.849054424,505,78,5,52,48,4,3514,3476,38,17,13,4,100
635c889056bc625202463c235680786f1f84ade6,6,1411,71,1340,3,0,3,1,32,238,2,3,1.896862645,1254,736,1,420,187,233,16715,7991,8724,151,75,76,99.9191032
eb10ad71910a9415e21a4ec97da0281d7ef4fe17,10,156,329,173,0,0,0,2,8,81,2,4,2.248554542,2586,251,1,412,435,23,19417,20164,747,104,109,5,99.88445985
977327e199ac6f32c9c72b1141e601f383286e3f,2,237,55,182,1,0,1,1,8,428,2,1,0.98041903,320,252,2,88,68,20,2967,1993,974,26,12,14,99.95377326
e07d5ff830ca74021beaef1f7a5665cb43a5bc0d,9,44,14,30,0,0,0,2,68,13,2,3,2.864432137,3937,79,3,474,468,6,31823,31639,184,167,166,1,100
743caa0b96a3d8cedf4194d924a454f9aeae4d7c,1,2,0,2,0,0,0,3,3,3694,1,1,0,244,80,4,50,50,0,1645,1622,23,15,15,0,100
3a0c126dc9f13a245e24a3bd353677594388fe59,1,1,1,0,0,0,0,3,4,48,1,1,0,268,253,3,41,41,0,2168,2168,0,9,9,0,100
d99c7028bdc3938365396eab022de6cd0b3c093e,4,31,28,3,0,0,0,3,9,19,2,4,0.849631236,1323,81,5,249,248,1,11495,11440,55,46,46,0,100
1c0511b6de212ee88242b3034ea1f2d4ac32cc98,1,2,2,0,0,0,0,2,2,168,1,1,0,29,254,4,5,5,0,231,232,1,4,4,0,100
c2bc51b87038b8a5c04c24c76a7d52dc1b7c2126,7,66,59,7,0,0,0,3,69,70,2,3,1.157610987,2697,737,1,354,351,3,20975,20974,1,105,105,0,100
3bc494a4fc2cea5a7811ffa0e2acc504d8065324,3,25,12,13,0,0,0,21,82,87,1,1,1.425613238,2900,738,2,361,358,3,22684,22596,88,201,200,1,100
af4eb15318947ba7f17972086b23d68c9d6db743,8,150,351,201,0,0,0,5,132,211,2,4,2.326361676,2935,739,3,500,520,20,21139,22027,888,149,160,11,99.96538195
b79f136f21e6817aa267b4ef711581b250895897,0,0,0,0,0,0,0,0,0,0,0,0,0,0,740,4,0,0,0,0,0,0,0,0,0,100
58fbb844ee493734fb40e73c2e201c8910333ad4,0,0,0,0,0,0,0,0,0,0,0,0,0,0,741,5,0,0,0,0,0,0,0,0,0,100
6816d028e09762bf8c41d4fb050300754f8539c8,2,1,2,1,0,0,0,6,18,0,1,2,0.918295834,1047,742,6,218,218,0,8945,8950,5,23,23,0,100
1d254982ebd42bdc55eed0494edb5fb79a6c2140,1,42,3,39,0,0,0,14,45,105,1,1,0,960,743,7,53,53,0,7984,7542,442,41,41,0,100
739710fd609d3e7bd668f928fa22057bfbed800d,2,0,124,124,0,0,0,2,2,2284,1,2,0.99323382,82,744,8,0,5,5,0,576,576,0,3,3,99.93080383
dc153282a754ca720667e52442560c7833c28b93,65,1766,1684,82,1,0,1,2,133,407,4,25,2.764303754,22949,255,5,3248,3248,0,169778,168009,1769,1262,1262,0,94.55758831
6646b7ee826810c6f3069ef5dbf5353a18292da6,0,0,0,0,0,0,0,0,0,0,0,0,0,0,745,9,0,0,0,0,0,0,0,0,0,100
3030c8c096a2fe1376dbf1b9bf34034fd70c832d,14,449,198,251,2,0,2,2,134,131,2,9,2.63910516,6922,746,10,1105,1072,33,56446,54750,1696,334,311,23,93.94244062
0e8b5f4b62e069684699a940d558bfa84291fc1b,1,2,0,2,0,0,0,1,2,2,1,1,0,97,747,11,13,13,0,998,980,18,3,3,0,100
45b6ec27fe7786bca008c50e9046e52e076e0aef,0,0,0,0,0,0,0,0,0,0,0,0,0,0,748,12,0,0,0,0,0,0,0,0,0,100
d5c023bea52be5036c04634aaaae6c23ac57e796,3,10,9,1,0,0,0,15,102,136,2,2,1.323531576,2038,749,13,300,302,2,16342,16303,39,85,85,0,100
441ca33fb83e11d023ab5860095222b41a31308b,11,225,166,59,0,0,0,8,116,413,3,7,2.671367382,5895,82,6,727,721,6,40794,40518,276,271,272,1,100
b26a5fbbf9d95bcd1c7ad99ee63d283a80ea409d,3,295,157,138,0,0,0,2,2,24,2,2,1.458406921,1209,83,7,256,233,23,9626,8695,931,83,76,7,100
5e4e01f962e1084355b4fcc0041ebe1f4ca5574a,1,1,1,0,0,0,0,11,51,237,1,1,0,1443,256,5,310,311,1,11325,11337,12,104,104,0,100
26ae78e7333a7ea602c052bdacda343338a708a2,1,1,1,0,0,0,0,14,46,6,1,1,0,996,750,14,53,53,0,7986,7984,2,41,41,0,100
50f9900e7f51a356f29e9d580d9eacf32d729220,1,1,1,0,0,0,0,15,89,437,1,1,0,1852,751,15,217,217,0,9360,9360,0,166,166,0,100
05f73f07c854a71d878d3dcd36557876dd17d139,0,0,0,0,0,0,0,0,0,0,0,0,0,0,5,0,0,0,0,0,0,0,0,0,0,100
f90073fb3561cdb223283813b92a286e3cea0aa1,1,1,1,0,0,0,0,15,90,0,1,1,0,1852,257,6,217,217,0,9360,9360,0,166,166,0,100
8f2b2a2bfffdf72d00142e1dc45ba0857e0e10e6,1,8,3,5,0,0,0,3,7,2,1,1,0,203,258,7,30,30,0,1197,1193,4,11,11,0,100
05a24605bec4b048172a1a0d571c946ce04eadfa,1,13,11,2,0,0,0,2,5,14,1,1,0,70,259,8,13,12,1,545,534,11,6,5,1,100
44107db37642d4237db0227792716753e6c1d128,1,1,1,0,0,0,0,12,37,185,1,1,0,396,260,9,28,28,0,2393,2393,0,16,16,0,100
a07760720edd5092f607af887532058949da967b,1,12,13,1,0,0,0,3,6,13,1,1,0,269,261,10,42,41,1,2198,2187,11,10,9,1,100
c3c2c2ccd78c221775a51c188262badbaf5f045f,1,2,1,1,0,0,0,4,14,21,1,1,0,714,262,10,143,143,0,6567,6550,17,14,14,0,100
38fdc4295d5da0122d8b33a15d290af1be87fb23,0,0,0,0,0,0,0,0,0,0,0,0,0,0,263,11,0,0,0,0,0,0,0,0,0,100
9401837e789aaeaebad0f694aa35c35cbc56b608,1,3,0,3,0,0,0,3,6,19,1,1,0,141,264,11,20,20,0,1193,1182,11,5,5,0,100
a6c9a4ce1bb37d9146fb60a2f8c3a8aa8a461db0,20,1348,148,1200,5,0,5,21,104,448,3,9,3.298006565,4290,752,15,857,695,162,37885,30997,6888,329,273,56,92.93841207
cd25ea617cd7a7f7e2a18cf4e84188190ff3d5c3,1,4,0,4,0,0,0,3,7,12,1,1,0,269,753,16,43,42,1,2224,2198,26,10,10,0,100
6fec92d896c54a05f8a3fb6710774c45264c86f7,1,6,0,6,0,0,0,4,12,20,1,1,0,283,754,17,52,51,1,2476,2404,72,9,9,0,100
20e1609e1bd1eade7edb2fb07b2f7419f8f5512b,8,187,77,110,0,0,0,21,105,0,2,5,1.28805586,3237,84,4,620,601,19,25345,24694,651,209,201,8,100
c46691389778a42ed24ed8f1093f8f8c26d74473,1,9,5,4,0,0,0,4,15,8,1,1,0,715,755,18,143,143,0,6623,6567,56,14,14,0,100
1123c80271d5486a2e0cc39f788a7e6bf19d62f6,1,10,1,9,0,0,0,4,8,396,1,1,0,842,756,19,86,85,1,5887,5850,37,50,50,0,100
902985fb51b0288e0dc62260f1403dce34da0083,1,3,1,2,0,0,0,22,74,90,1,1,0,1133,265,12,225,224,1,7164,7152,12,66,66,0,100
32bd3d96f913735b6f6209618dd089e15f1c2e08,0,0,0,0,0,0,0,0,0,0,0,0,0,0,266,12,0,0,0,0,0,0,0,0,0,100
8fabad5ac0155446029d440e372b2a99226cf383,1,1,2,1,0,0,0,2,3,36,1,1,0,29,267,13,5,5,0,212,231,19,4,4,0,100
07b15fb6134216cf35a55ee56cd7716adfe97430,2,2,2,0,0,0,0,2,16,25,1,2,1,818,268,12,156,156,0,7625,7621,4,17,17,0,100
28e8cc03116fb1e7f79c699a4e9d3d93efe22ee8,2,1,4,3,0,0,0,2,13,117,1,1,0.970950594,401,269,13,74,73,1,3422,3414,8,19,19,0,100
950078a37f881379fe647655bb4fcdcfa5874695,0,0,0,0,0,0,0,0,0,0,0,0,0,0,270,14,0,0,0,0,0,0,0,0,0,100
0c1e3f5bdd692672e3b669997c2a6307e7617f32,2,14,0,14,0,0,0,18,50,133,2,2,0.591672779,1446,757,5,218,214,4,11096,10994,102,102,101,1,100
cd0731efb3e60a5cfc94b5e13d06185bb9829c7e,0,0,0,0,0,0,0,0,0,0,0,0,0,0,758,6,0,0,0,0,0,0,0,0,0,100
64a719c1b474b30b8c04c664fdcc47c12286f078,0,0,0,0,0,0,0,0,0,0,0,0,0,0,759,7,0,0,0,0,0,0,0,0,0,100
ed845cdbe03c8cc61b7076b2528904c3bd4ff67d,9,28,27,1,0,0,0,2,17,108,1,3,3.008772264,1611,760,8,297,297,0,13304,13269,35,77,77,0,100
e716249e8c50f6f82a9a3ee59624d2421f45af71,2,13,9,4,0,0,0,2,5,51,1,2,0.945660305,286,761,9,59,55,4,2053,1963,90,16,16,0,100
f90a4c0cbb4e7eba4b8d25f16b65f8c5c700e57b,7,238,35,203,0,0,0,6,10,486,2,5,1.336553734,2948,762,10,459,437,22,25405,24127,1278,133,131,2,99.79937584
07d7dfbcd9524860b2683f4f522190488ead6c68,0,0,0,0,0,0,0,0,0,0,0,0,0,0,763,11,0,0,0,0,0,0,0,0,0,100
f15580363c8391e41d8c30c2b5e059395ac7893b,4,12,8,4,0,0,0,3,18,15,1,2,1.94064545,1528,764,12,285,285,0,13410,13362,48,53,53,0,100
4e4299c1d14a3cc6b9f6c5d650cf7b3196407e5d,10,321,110,211,1,0,1,1,41,78,2,6,2.472877319,4605,765,13,855,819,36,37143,35785,1358,282,270,12,99.922049
f688487f8a3c1a2ac58de41ff9b2ae54be94a48b,1,3,0,3,0,0,0,3,8,26,1,1,0,142,766,14,20,20,0,1228,1193,35,5,5,0,100
9aaa6ca3e0ce5956f36c11bb796f530298fff279,2,5,5,0,0,0,0,4,19,28,1,2,0.721928095,831,6,0,159,159,0,7649,7649,0,19,19,0,100
13af000b47b852c07c1f7d5ec765c113e10adfb1,2,11,2,9,0,0,0,2,27,495,1,2,0.995727452,186,271,9,14,14,0,1249,1214,35,6,6,0,100
8ab64b2790ca131ecd2c1a04b191d6c27ce4cc96,1,1,1,0,0,0,0,2,5,56,1,1,0,439,272,10,69,69,0,2819,2819,0,22,22,0,100
864a325fd28fa0d34ff80e0126fc91cc4fd51316,9,46,46,0,0,0,0,2,20,84,1,3,2.530090503,3327,0,0,543,543,0,29139,29141,2,120,120,0,100
daad790815eeb9d1c91bacb9ddbb9c153e238dab,1,2,2,0,0,0,0,5,21,5,1,1,0,721,767,15,143,143,0,6673,6673,0,14,14,0,100
a04f39026f71b7c297b71b885ad0644a4b519af7,4,23,23,0,0,0,0,4,22,22,1,1,0.765363613,1274,7,1,229,229,0,10676,10650,26,41,41,0,100
346bc9a12597bcfbfea9bfca8aeaea90cada92ad,2,4,3,1,0,0,0,4,11,2,1,1,0.985228136,345,8,2,56,56,0,2800,2782,18,16,16,0,100
16abc52f654603db1315da344aa08415ab29110d,0,0,0,0,0,0,0,0,0,0,0,0,0,0,273,7,0,0,0,0,0,0,0,0,0,100
c4f8622d5df73f0d00a233d41e063523cb3e7eb6,3,11,28,17,0,0,0,3,6,333,2,2,1.464975467,849,274,6,106,108,2,5517,5603,86,35,35,0,99.94441356
96f83c3b885806918f39161f0a5b2077ffe15505,1,8,3,5,0,0,0,1,3,412,1,1,0,233,275,7,43,42,1,1648,1618,30,30,30,0,100
bbf1d823fdc20d825552d98b0ef7ea1e67331ebf,1,1,1,0,0,0,0,5,23,5,1,1,0,721,768,11,143,143,0,6696,6696,0,14,14,0,100
dd1e6bb27d40ee90fcbfc3b588e8a8051235f72e,2,5,3,2,0,0,0,12,43,335,2,2,0.954434003,1797,769,12,272,272,0,14693,14657,36,85,85,0,100
f4b5d798bb70f557e839248f500c6351586141cf,0,0,0,0,0,0,0,0,0,0,0,0,0,0,770,13,0,0,0,0,0,0,0,0,0,100
760f7ca6543e3aea5e64e512badf30ee27748292,2,3,5,2,0,0,0,12,44,0,2,2,0.954434003,1799,771,14,272,272,0,14657,14693,36,85,85,0,100
c76a96d12c09ea072cc447126c97d9c50a1c4cfe,1,1,2,1,0,0,0,4,10,10,1,1,0,71,772,15,13,13,0,536,552,16,6,6,0,100
c89cf492ed04a5ef24a69a2708790a9e3012f553,0,0,0,0,0,0,0,0,0,0,0,0,0,0,773,16,0,0,0,0,0,0,0,0,0,100
b14fb569614151e44789dd8e48ed6243e3002275,1,1,1,0,0,0,0,3,3,256,1,1,0,159,276,8,35,35,0,962,962,0,11,11,0,100
faa0f25fb72b4950fd55c7fdc74e9f45d37bb1ab,103,960,3298,2338,4,0,4,7,106,1965,2,8,3.929502821,9397,774,14,1190,1795,605,48098,63503,15405,446,442,4,99.52291135
6d515a2df2909e365a18c4aa99b761ab11bf65a6,0,0,0,0,0,0,0,0,0,0,0,0,0,0,775,8,0,0,0,0,0,0,0,0,0,100
a57b171238265b1892b434063c5fec0d52f6f93a,5,19,13,6,0,0,0,21,86,782,1,3,2.186278124,1368,776,8,232,229,3,10486,10455,31,104,103,1,99.94457377
b82ad18593952709007b960463b615b5d6a0f50c,4,37,27,10,0,0,0,4,8,1748,1,3,1.551785546,626,777,9,58,55,3,3651,3529,122,49,49,0,99.33789211
0aaebd72052217349c41beb7e464a1d3f461c88e,0,0,0,0,0,0,0,0,0,0,0,0,0,0,778,10,0,0,0,0,0,0,0,0,0,100
58cdf0959b847ed462882a90dafef8d71d35adef,3,67,12,55,0,0,0,2,19,2894,2,3,0.598701057,345,779,11,72,62,10,2689,2283,406,19,15,4,99.94685939
63b264af2783c815e2892752ca8b923700cdc4e0,15,173,171,2,0,0,0,1,87,339,3,8,3.069339124,5059,780,12,901,892,9,40182,40326,144,298,296,2,84.58651655
ee75e1c11f15cb6dcc5912b01552b1b4854f41f7,4,318,0,318,4,0,4,1,1,0,1,2,1.988637321,0,781,13,20,0,20,2056,0,2056,12,0,12,99.81874207
e7be404ce17bbc666f54c315c19604ca7154804a,1,1,1,0,0,0,0,2,3,133,1,1,0,78,277,2,11,11,0,655,654,1,4,4,0,100
68a583284af87a83646dc2908d3cf2be85b27647,2,4,4,0,0,0,0,1,2,2,1,1,1,153,782,13,14,14,0,1149,1145,4,7,7,0,100
db309e04a2d3100994116927e6681e2c6ba77b9c,6,50,13,37,0,0,0,1,38,0,1,2,2.569193928,670,783,14,52,46,6,5586,5365,221,34,30,4,100
9c5554901086f246d0db5154b6e1a170e5fd6579,1,4,5,1,0,0,0,3,6,626,1,1,0,131,278,2,8,8,0,793,821,28,5,5,0,100
78fd82f2a99e8562c270a3bfeec346889f19ce75,1,2,1,1,0,0,0,2,5,99,1,1,0,612,784,10,127,127,0,4601,4586,15,37,37,0,100
ed6c6d49d27b197f20f87fafeb48efd6970fcddd,1,3,0,3,0,0,0,19,107,36,1,1,0,851,785,11,141,140,1,6111,6100,11,25,25,0,100
031c4d7b665aafcba38d5e47de0742492274a134,1,10,1,9,0,0,0,12,36,409,1,1,0,563,786,12,123,121,2,3796,3760,36,74,74,0,100
e4248242bc9000b08b466f1bd1cdc06f5c09c4eb,0,0,0,0,0,0,0,0,0,0,0,0,0,0,279,2,0,0,0,0,0,0,0,0,0,100
ee639573fc17b96e1472a20cbd7decbe948e4058,1,2,1,1,0,0,0,10,46,81,1,1,0,630,787,13,136,135,1,4258,4248,10,52,52,0,100
85074d0979b404eb1a26c297eacfee1f5ab51d1d,2,40,27,13,0,0,0,2,6,57,2,1,0.739480937,931,788,12,167,164,3,7540,7333,207,59,59,0,100
6ab412d9a189fc8b04531c99f1ef1601e547ef5d,0,0,0,0,0,0,0,0,0,0,0,0,0,0,789,13,0,0,0,0,0,0,0,0,0,100
fafded26168d0c3079de7b4e81254d2c93098da8,1,6,2,4,0,0,0,2,2,50,1,1,0,167,280,3,22,21,1,1187,1155,32,10,10,0,100
f72c0b8627547957a7f0d99aa1603ea226bd0ecf,5,200,76,124,0,0,0,2,38,331,1,4,1.072128778,1354,85,0,348,311,37,9816,8991,825,90,84,6,99.92750997
d4fc36bbdaf4847147a8e3941f50b06228f541ec,1,5,6,1,0,0,0,2,3,9,1,1,0,171,790,14,21,22,1,1188,1187,1,10,10,0,100
e5368c7aa06aa05042a3186c53a4c1234d50f1d3,2,35,3,32,0,0,0,12,38,313,2,2,0.899743759,535,791,13,54,50,4,3441,3179,262,29,28,1,100
70105565933e3a8cb5db1a73a60d130c8829c22a,3,11,2,9,0,0,0,2,6,93,1,3,1.548580607,411,281,4,72,71,1,2726,2668,58,41,41,0,99.92743106
a80096a222ec96b64a7342733aba6fc9f0338ac5,30,610,217,393,4,0,4,21,135,329,2,15,3.691749377,10642,792,14,1862,1822,40,81157,78980,2177,728,700,28,99.76440739
88834d498faff435672b5822fa3f1108010676bc,3,117,62,55,2,0,2,1,2,0,1,2,1.574382702,136,793,15,17,15,2,1174,1129,45,10,8,2,99.89155973
f7e012786758a210ffef5fe670eb74462f8597e0,1,2,0,2,0,0,0,1,3,2,1,1,0,91,794,12,13,13,0,545,536,9,6,6,0,100
fba513d69918e0b4e3ad7b4f36940eb797082ff9,6,223,111,112,0,0,0,2,108,88,2,4,1.983654507,4413,86,1,687,678,9,34615,33994,621,225,220,5,99.98194294
ebdf0cdf42ff530b6fddc1fca54266405263469e,1,4,0,4,0,0,0,19,109,0,1,1,0,867,87,2,142,141,1,6277,6236,41,25,25,0,100
dd9ca11363e41eb69b7b75084112083e7c6c8f8e,65,320,220,100,0,0,0,3,26,8,2,9,5.383918747,9743,88,3,1624,718,906,77673,46212,31461,608,241,367,82.19484882
2f43ea7d713c03f5b441085c4b2c239065dcd5f7,0,0,0,0,0,0,0,0,0,0,0,0,0,0,89,4,0,0,0,0,0,0,0,0,0,100
6ad752b4009ec4f89e0b7cba6c982ce9507616d0,1,1,1,0,0,0,0,6,20,47,1,1,0,205,795,11,44,44,0,1414,1414,0,7,7,0,100
427be6673fbc6669361a347be877cf070614fb8c,0,0,0,0,0,0,0,0,0,0,0,0,0,0,90,5,0,0,0,0,0,0,0,0,0,100
4b73177576d5bb08d1135a0b933571180bfa32cd,6,36,7,29,0,0,0,1,28,173,2,5,2.087162704,1907,796,12,377,371,6,13955,13751,204,188,187,1,100
44dcfda004e2dd6b170e5a798627c56af7679f86,1,3,0,3,0,0,0,7,9,1660,1,1,0,220,91,6,35,35,0,1267,1260,7,18,18,0,100
efb1a864b8034de57a590dfbf253a498833d5030,1,1,1,0,0,0,0,4,11,176,1,1,0,438,797,9,87,87,0,3118,3118,0,40,40,0,100
8524f2449955039df5dbd63cb7573d6eec0edf0f,17,212,98,114,0,0,0,9,136,81,2,11,3.401392148,7632,92,7,1374,1356,18,61638,60953,685,386,382,4,99.95692749
7526cb0e14ad2b65db1c04538b672ffd7db7ae03,0,0,0,0,0,0,0,0,0,0,0,0,0,0,93,8,0,0,0,0,0,0,0,0,0,100
13c04280ccae026202fbb91a847fe8a7e15fe4da,3,55,10,45,0,0,0,2,4,123,2,2,1.530816556,1287,798,8,238,230,8,10247,9870,377,83,80,3,100
e88434c75f4d38eb30be19a60a623b50cf8df763,8,267,10,257,0,0,0,2,75,461,2,6,1.612446866,4236,799,9,841,818,23,31145,29614,1531,298,288,10,95.20023131
c6371c41579e49abbf8af75a2c30f574e7e59687,1,2,2,0,0,0,0,2,5,0,1,1,0,345,800,10,40,40,0,3115,3115,0,15,15,0,100
430b4501b31d22fc3589ea5660af1f252507b94c,3,197,3,194,1,0,1,5,77,520,2,2,1.21667251,2684,801,11,318,299,19,29322,28082,1240,95,90,5,99.97088792
58d2d9ccacb160c5dd5ebfaaf28f80edf0594cb1,1,5,2,3,0,0,0,7,20,184,1,1,0,183,802,12,37,37,0,1267,1220,47,20,20,0,100
8057ac93db30d402d74b54a8b61d30e7f2862920,1,12,3,9,0,0,0,3,3,288,1,1,0,75,803,13,9,9,0,495,428,67,6,6,0,100
9419fc81752db6330aef5e42807d4b7a401c1c69,1,2,5,3,0,0,0,7,21,0,1,1,0,186,804,14,37,37,0,1220,1267,47,20,20,0,100
ccc4882a53cc9374816c4e4facac442eb65ada4e,7,76,39,37,0,0,0,4,117,188,2,7,2.546283701,2053,94,9,356,350,6,13885,13706,179,133,129,4,100
33029a9bd5268617348e35af82d348ec18e9862f,1,2,2,0,0,0,0,5,5,393,1,1,0,308,805,15,53,53,0,1780,1780,0,13,13,0,100
3fa2e25873cd403b28abdfbcfc0ada80bb9b22d5,1,11,5,6,0,0,0,22,76,6,1,1,0,1141,806,16,227,226,1,7265,7206,59,66,66,0,100
344475f2efdf182ba1b0f90b646be45801bf6013,0,0,0,0,0,0,0,0,0,0,0,0,0,0,807,17,0,0,0,0,0,0,0,0,0,100
4b29d9956afb6882f0dc2157bbadc298e1612ccb,0,0,0,0,0,0,0,0,0,0,0,0,0,0,808,18,0,0,0,0,0,0,0,0,0,100
325b6ec680b3c28d74916301131acb22ae0d650d,0,0,0,0,0,0,0,0,0,0,0,0,0,0,809,19,0,0,0,0,0,0,0,0,0,100
8deb85a6fa5cec2426f801ad224b788175667b77,0,0,0,0,0,0,0,0,0,0,0,0,0,0,810,20,0,0,0,0,0,0,0,0,0,100
b9923fcf44adf5f9ae4f72cdf6add8bf38868d16,4,156,43,113,1,0,1,12,28,57,1,4,1.494022552,1528,95,9,285,276,9,12622,12136,486,62,55,7,99.94181818
6b63ff8c2008acc6933dd55c60641380a67f02ad,5,74,8,66,0,0,0,10,137,119,2,4,1.609114292,6710,811,17,1066,1061,5,53037,52652,385,255,252,3,98.43901091
ca8befc84b77e16e15f6ffa3288b97dcbf9d987e,1,7,4,3,0,0,0,5,15,16,1,1,0,272,812,18,53,51,2,1765,1765,0,13,13,0,100
17a9ab7c98c5d997ea21af96e47422db3da3e427,1,3,3,0,0,0,0,2,3,3182,1,1,0,127,813,19,22,22,0,696,696,0,19,19,0,100
1483adb6e084b07e54eea799523e95120749f90a,1,6,4,2,0,0,0,4,9,280,1,1,0,280,814,20,19,19,0,2563,2521,42,16,16,0,100
8bd6e9646ab343d16f733014a688dc5af07ba59a,3,74,0,74,0,0,0,19,138,78,2,3,0.873637455,2572,815,21,352,394,42,19924,19442,482,87,137,50,100
2139dd414380099afcbff42c87c60e9ca8398f2a,2,19,2,17,0,0,0,4,12,204,2,2,0.702466551,327,9,0,46,45,1,1991,1908,83,27,26,1,100
0ad5845185a9e754637b811c388259d8e8c162d5,1,1,0,1,0,0,0,21,139,0,1,1,0,1427,816,22,296,245,51,10844,10843,1,65,14,51,100
4a1f891f438137fc571656c907380e199573c4d8,1,12,2,10,0,0,0,7,23,11,1,1,0,184,817,22,39,37,2,1320,1228,92,20,20,0,100
af5543f9f7122629d5a6925fdbfecd36684e367d,7,34,26,8,0,0,0,5,140,68,2,6,2.275335241,3092,96,10,435,434,1,23211,23137,74,137,137,0,99.96046389
761d85d8f9d8e0003c024f0c8a323cd7e67da0c7,2,20,1,19,0,0,0,2,6,18,2,2,0.998363673,977,818,23,199,196,3,7304,7167,137,60,59,1,100
3519fa65cb89bd4e9006aa91adae08ebced46e56,6,75,22,53,0,0,0,21,89,500,2,2,2.005360218,3258,97,9,540,533,7,23005,22676,329,246,243,3,100
c3015a36527d54daf5c1264137956180e1120028,1,2,1,1,0,0,0,19,66,4,1,1,0,1125,819,24,95,95,0,8357,8355,2,69,69,0,100
3016e1790e5db6193edfface5aafe4e93e0a2495,1,19,22,3,0,0,0,4,4,387,1,1,0,103,10,1,12,13,1,611,600,11,4,4,0,100
710d9219e0857d642445a771aafa20ef283c72d9,0,0,0,0,0,0,0,0,0,0,0,0,0,0,820,18,0,0,0,0,0,0,0,0,0,100
dd664dbe96187591bd5fc6730bab3141599f958a,1,23,6,17,0,0,0,9,28,398,1,1,0,653,821,19,39,37,2,6708,6622,86,28,27,1,100
685cc49d9c417f1add814dc4740034ed2881a0e3,0,0,0,0,0,0,0,0,0,0,0,0,0,0,282,0,0,0,0,0,0,0,0,0,0,100
df4b2e003c9f23c296f75bdadf831ba22f58ce2e,1,7,1,6,0,0,0,4,10,175,1,1,0,110,98,3,16,16,0,1018,976,42,5,5,0,100
80eb9bdb0b5689256110dcbd7d9a35d47b9f26dc,2,146,98,48,0,0,0,7,12,1053,1,2,0.98243285,673,822,13,143,137,6,4509,4374,135,43,40,3,100
975a554034920997fa4115bb5c275c5bc1306498,0,0,0,0,0,0,0,0,0,0,0,0,0,0,823,14,0,0,0,0,0,0,0,0,0,100
9a990003db1daa027d9a3f69ae93088759c99ce8,1,3,1,2,0,0,0,4,7,235,1,1,0,201,824,13,25,25,0,1376,1376,0,10,10,0,100
17bff0de41191ed2508ff9f560cab432c04f994e,0,0,0,0,0,0,0,0,0,0,0,0,0,0,825,14,0,0,0,0,0,0,0,0,0,100
9d0ea7a98a59fbb361e5675c7ce1caa4869bef35,2,51,9,42,0,0,0,12,45,160,2,2,0.948078244,1797,826,13,277,272,5,14968,14657,311,86,85,1,100
23afdad3e0ca750107dc99244f699471546c4422,0,0,0,0,0,0,0,0,0,0,0,0,0,0,827,8,0,0,0,0,0,0,0,0,0,100
d5ba195acc1a2902ba6e456a20ae092d4066917d,2,8,3,5,0,0,0,3,99,370,1,2,0.845350937,410,1,0,63,62,1,3091,3045,46,22,22,0,100
5af0edeba3df8acf82bda57882970c111e4ba963,2,98,146,48,0,0,0,7,13,14,1,2,0.98243285,713,828,8,137,143,6,4374,4509,135,40,43,3,100
c25345291007ce60f3915cccf64f4ccaa404077d,66,139,75,64,0,0,0,5,50,3397,3,11,5.543728743,4500,829,9,641,554,87,29075,28098,977,260,258,2,100
1534baa7c4d0498538031cb762ef8c861e4c7d2c,11,251,33,218,3,0,3,6,72,229,1,7,2.945299788,2177,99,1,424,411,13,14613,13902,711,200,192,8,99.90763953
8e2d3cda27754c17acc179c8203d2d57b4a37529,2,141,16,125,0,0,0,6,141,87,2,2,0.872556984,1674,100,2,331,313,18,13690,12853,837,79,75,4,100
5caa76f4ae9eb94f119697349a833a0173190e28,15,158,154,4,0,0,0,4,39,687,2,5,3.349629471,3617,101,3,719,712,7,23164,23055,109,278,279,1,92.07587946
f1cf2be4d098055e41fc9d76168f49950a2b6265,3,48,31,17,0,0,0,2,142,46,1,3,0.674572287,2374,102,4,508,504,4,18121,17932,189,117,116,1,100
4141895d6a41c0d84a49aac37303b46319a22941,1,1,1,0,0,0,0,2,3,268,1,1,0,205,830,8,21,21,0,1612,1612,0,11,11,0,100
c29da39e2d557071aa84f997ea946252301fdec8,2,31,3,28,0,0,0,3,10,408,1,2,0.733537929,645,831,9,103,100,3,4815,4611,204,31,30,1,100
8d0be9aa3b5fce0a62467cae37b1818ba5bec31e,1,1,1,0,0,0,0,19,67,68,1,1,0,1126,832,10,95,95,0,8357,8357,0,69,69,0,100
15affe5767d04f0fa23fc68a3bc9296cdb792334,1,24,3,21,0,0,0,22,100,30,1,1,0,278,283,0,52,48,4,2155,2006,149,18,17,1,100
cf5989a2e606598e81bef65196b9f053eb77a11a,3,48,12,36,0,0,0,12,143,210,1,2,1.483355755,2134,284,1,424,420,4,15698,15597,101,101,99,2,100
466d6db83ab4283ec1601ca053495999df818745,1,12,6,6,0,0,0,10,31,125,1,1,0,208,833,7,35,35,0,1614,1582,32,10,10,0,100
3585e29335e3fb6ffc72816199613bf88a148b62,6,42,13,29,0,0,0,1,29,105,1,3,2.247535435,3710,103,4,636,631,5,32469,32269,200,180,177,3,100
a6a35a5f1824e000e6a9c1e6e7332e9e2052cfbf,32,273,233,40,0,0,0,3,90,680,2,5,3.620308051,21251,834,6,2136,2129,7,175869,176430,561,1018,1015,3,100
f4eded50e25e54238337407ca54ac56f2007e9a6,2,2,2,0,0,0,0,7,73,327,1,2,1,1041,835,7,211,211,0,6750,6755,5,89,89,0,100
1596c45da9cc1c1519d74283f1876e2c2c8ebeb5,2,129,22,107,0,0,0,12,47,9,2,2,0.852911871,1848,836,8,287,280,7,15790,15099,691,89,86,3,100
6375e3454c1730b824a938c661b08fad7643fa60,1,88,0,88,1,0,1,1,1,0,1,1,0,0,837,9,15,0,15,296,0,296,8,0,8,99.977959
97923514ccf4c5899579e319bf2d18297d9b8c75,2,40,6,34,0,0,0,7,13,150,2,2,0.666578358,466,838,10,81,77,4,3562,3293,269,35,34,1,100
00a94c9377ac421880b0122bb9a0f38a6482f674,3,17,2,15,0,0,0,10,186,225,1,2,1.086987702,2620,839,11,530,525,5,18536,18442,94,178,178,0,100
c11ad43adbc47b1e53cff4877d4e297fc335d8c6,6,83,1,82,1,0,1,18,79,178,2,5,1.510321233,3418,840,12,427,424,3,33768,33166,602,108,105,3,98.38692783
b10eba3ddab896e2b923806fac0f35c9782e3b04,2,8,8,0,0,0,0,18,80,0,2,2,0.954434003,2543,841,13,286,286,0,26761,26761,0,77,77,0,99.96007187
c81965c4c002dd2392c54b88102d826086fa80be,2,2,2,0,0,0,0,25,187,0,1,1,1,2000,842,14,393,393,0,14248,14248,0,126,126,0,100
f4ae07555f6d98693fe8ee11e21787450d5d19ac,1,3,2,1,0,0,0,2,7,211,1,1,0,431,843,15,68,68,0,2772,2763,9,21,21,0,100
4387ba1c70579f304655ddbfa0ccd7244317e3f2,0,0,0,0,0,0,0,0,0,0,0,0,0,0,844,16,0,0,0,0,0,0,0,0,0,100
e15b90ca9d10e0018ad98297aefad5b46d40fb82,18,156,71,85,0,0,0,22,77,726,1,11,3.876169109,6137,845,15,1156,1146,10,40077,39727,350,417,421,4,94.83734873
e87bb31e646371f12d050b4ae8243287fe2d6843,1,1,1,0,0,0,0,25,188,2,1,1,0,1123,846,16,250,249,1,7953,7946,7,100,100,0,100
f92a4e11f626c797b1871a79dfb7c73c71f3ff36,19,362,92,270,0,0,0,3,91,69,3,10,3.496707986,6384,104,5,1214,1168,46,51726,50354,1372,465,451,14,99.97498749
38ba37a1acffdf0cdeaa37d4ae3e668cd90edba0,2,2,2,0,0,0,0,7,74,2,1,2,1,1045,847,17,211,211,0,6767,6762,5,89,89,0,100
9fec2319b387f6fea87470888f570ed54472b942,1,1,1,0,0,0,0,7,20,1,1,1,0,408,848,18,87,87,0,2827,2825,2,21,21,0,100
bca9ec6f57d12e52da893d7df96b890e8a7b8b76,1,3,1,2,0,0,0,3,9,118,1,1,0,106,849,19,15,14,1,722,701,21,7,7,0,99.96247655
09bd644a3cca54c10fb76a96beac96349bb93481,4,329,128,201,1,0,1,5,15,28,2,3,1.676688049,908,105,6,184,166,18,7082,6108,974,64,58,6,99.94998124
4d9558615bbc0852e410b13cde0b79e1802ef327,3,8,3,5,0,0,0,6,23,319,2,3,1.435371391,675,850,20,97,96,1,5487,5434,53,33,33,0,100
66bc2aa31cbe0adb3bbd309cf43306ddeb7141f1,0,0,0,0,0,0,0,0,0,0,0,0,0,0,851,21,0,0,0,0,0,0,0,0,0,100
77da2e95d3e6ea1da8faf3b095b5efcd3c57364f,0,0,0,0,0,0,0,0,0,0,0,0,0,0,852,22,0,0,0,0,0,0,0,0,0,100
80f177cfb414b33d4dc2c71265de0aa3d7db5f2e,1,1,1,0,0,0,0,3,5,14,1,1,0,248,853,23,22,22,0,1952,1952,0,12,12,0,100
bad04a1f3f7e9d520379f98e849c3a13491b232c,0,0,0,0,0,0,0,0,0,0,0,0,0,0,29,0,0,0,0,0,0,0,0,0,0,100
074a83f53b469bfa289321b9d671267e049dee3a,32,1770,983,787,4,0,4,3,189,133,2,10,3.683965591,9828,106,3,1555,1448,107,78362,74140,4222,544,491,53,91.90998269
5a88abdd26befed76da89dac7a228069dc47bce8,2,30,2,28,0,0,0,8,25,253,2,2,0.69621226,1172,285,2,144,142,2,10677,10471,206,54,52,2,100
6baacdffbc64fdb4828a405572cb523226257f98,1,15,17,2,0,0,0,7,14,13,1,1,0,236,854,22,38,38,0,1395,1393,2,6,6,0,100
97c44661e7815ec9a3a20d9f6481e00b0a0c1083,0,0,0,0,0,0,0,0,0,0,0,0,0,0,855,23,0,0,0,0,0,0,0,0,0,100
4c6ef79f70086fd1cfef8e46e662e0d40ce41ead,1,8,6,2,0,0,0,7,16,15,1,1,0,484,856,24,105,106,1,3143,3165,22,33,33,0,100
6a645c547db51984779436fa370be008119593f2,1,13,1,12,0,0,0,3,5,237,1,1,0,265,857,25,10,8,2,1756,1712,44,10,8,2,100
cc98ecbd46446cb0f5c3a89abc87166f698e4030,1,39,7,32,0,0,0,5,31,3,1,1,0,783,858,26,152,146,6,7545,7270,275,16,15,1,100
2ceb43cfdfa38ec205a616239b6eafb47f7d4fdb,7,97,37,60,0,0,0,12,33,132,2,5,2.316043935,2635,107,4,361,353,8,20349,20042,307,127,125,2,99.95713214
6b012b602f224a6dab128dc31772b41ac6d13168,1,6,1,5,0,0,0,2,2,290,1,1,0,31,108,5,0,0,0,101,101,0,0,0,0,100
faf259e36193c5e1543efadb9861da12d5d40da9,21,136,96,40,0,0,0,15,81,747,3,9,3.483168629,5991,859,26,738,730,8,53708,53439,269,274,269,5,100
b03da9a9e214f1d31e7c30b60091b33bdbbd3e5b,39,378,242,136,0,0,0,2,144,244,3,16,2.982945123,20017,109,6,2742,2742,0,147185,146943,242,1099,1099,0,100
80b2e496a21a885d184cc1ad62f9a57d684bb722,1,1,2,1,0,0,0,5,32,3,1,1,0,812,110,7,157,152,5,7700,7545,155,16,16,0,100
fabd22351ee2c44066016992247baa8a0270c21d,2,68,17,51,0,0,0,3,12,97,2,2,0.999101249,601,860,27,82,80,2,4273,4004,269,27,26,1,100
9f4f49140053ec72bc2396f68b431ba00c434c2e,1,6,8,2,0,0,0,7,18,3,1,1,0,479,861,28,106,105,1,3165,3143,22,33,33,0,100
d86dc5675616fb49425fb0377bbae8d03cb1006d,0,0,0,0,0,0,0,0,0,0,0,0,0,0,862,29,0,0,0,0,0,0,0,0,0,100
b1008667d3c802ac323c6911bc31a3a5b0b30877,1,9,3,6,0,0,0,7,19,1,1,1,0,484,863,29,107,106,1,3177,3165,12,33,33,0,100
cfb94aed91769431616547f3d2b809ac428232ad,1,1,1,0,0,0,0,13,40,60,1,1,0,296,864,30,66,66,0,1900,1900,0,23,23,0,100
2530a24483fe015b11b6d839123a6561e14f882e,0,0,0,0,0,0,0,0,0,0,0,0,0,0,865,31,0,0,0,0,0,0,0,0,0,100
e4ad33375b057a7a6dd53b4f5e08f337a3538782,5,85,0,85,0,0,0,2,7,163,1,4,2.321928095,1258,866,32,279,279,0,10017,10017,0,79,79,0,100
dda21991518376c8becb1aef9b49b6841e6fefdb,0,0,0,0,0,0,0,0,0,0,0,0,0,0,867,31,0,0,0,0,0,0,0,0,0,100
13702aeedbbb69b2794508d149f0af775108d4c4,2,15,11,4,0,0,0,2,6,10,2,2,0.51594693,503,286,1,58,57,1,3279,3276,3,40,40,0,100
c0fae7573088c6e979f70fa1b3f255ee31da4167,3,4,3,1,0,0,0,3,13,63,2,2,1.556656707,882,868,27,124,124,0,5893,5881,12,39,39,0,100
7c1d7dfa440fa0a463b1a7ac20ae859f584d63d1,1,13,0,13,0,0,0,4,9,296,1,1,0,849,869,28,87,86,1,5946,5887,59,51,50,1,100
e899dc7003802da3f187c92d6f42dca9122d5dfa,1,36,0,36,0,0,0,9,29,105,1,1,0,668,870,24,42,39,3,7027,6708,319,31,28,3,100
1dde47b3f219369ded02b00466473c0f6b2183a3,1,2,2,0,0,0,0,19,115,15,1,1,0,881,871,24,145,145,0,6324,6324,0,26,26,0,100
19474c6f9389792d64509e6132ae5050f8a8b429,0,0,0,0,0,0,0,0,0,0,0,0,0,0,872,23,0,0,0,0,0,0,0,0,0,100
e82024192252bf22e4132c0470e340999aa1a271,3,26,3,23,0,0,0,3,14,9,2,2,0.574828144,883,873,21,125,124,1,6032,5893,139,40,39,1,100
1709ed2d5753c3994bd71643c198ed91b174995a,8,45,34,11,0,0,0,5,37,38,2,7,2.756490597,2123,111,5,319,321,2,15083,15049,34,114,113,1,100
989223bd8c5951daf47fe7ff2145f8a76ba6c6f6,3,37,29,8,0,0,0,2,33,56,2,2,1.548736037,609,112,6,69,65,4,4981,4935,46,25,25,0,100
2ae9dc758050cc2dc74439a29929440114d97fef,0,0,0,0,0,0,0,0,0,0,0,0,0,0,113,7,0,0,0,0,0,0,0,0,0,100
1b90ccce23bd0278bd66ba9c8d1c7fa830fad0db,0,0,0,0,0,0,0,0,0,0,0,0,0,0,874,20,0,0,0,0,0,0,0,0,0,100
bf69cf1a3934261c0324471787b4e6aeea16ee79,2,4,4,0,0,0,0,2,16,119,2,2,1,608,875,14,85,85,0,4274,4266,8,33,33,0,100
65da60add0aa89fbae092d5a799e689643dfe642,0,0,0,0,0,0,0,0,0,0,0,0,0,0,114,3,0,0,0,0,0,0,0,0,0,100
ddf412ffa0334fb4fb621f65c55692d3ec816bef,2,32,8,24,0,0,0,4,10,648,2,2,0.909736123,1340,876,1,207,204,3,9094,8979,115,66,65,1,100
15c74fafb107ef9fa823cd4ee930830958c85a6d,63,267,299,32,0,0,0,2,92,1178,2,9,5.473887628,18016,877,1,1834,1834,0,136793,136883,90,955,954,1,93.55766159
2a240e4df06f24ac8a8fb4bd2db660b7a86f9aea,1,7,3,4,0,0,0,10,49,89,1,1,0,931,878,2,91,90,1,7940,7903,37,45,45,0,100
77d38296465381f6b7eb4f22f2faee22becb8716,8,147,71,76,0,0,0,3,23,761,2,7,1.696637112,2175,115,1,303,299,4,16081,15865,216,136,135,1,100
a468fe8c14a0a7a0f43d2eede291261df20f12fc,6,99,63,36,1,0,1,1,50,142,1,1,1.864821889,2529,879,3,242,242,0,21422,21298,124,117,117,0,91.66764464
c9146566cd023ef79081965c418fe1f115cd4627,25,3467,545,2922,4,0,4,2,145,751,2,14,3.015406182,11360,287,0,2457,1975,482,102742,88364,14378,777,639,138,99.80276134
b8dc1cc80f02db37b9ff5b3c1506e8f73012d392,0,0,0,0,0,0,0,0,0,0,0,0,0,0,288,1,0,0,0,0,0,0,0,0,0,100
c897809b470b9ad811b700f92b6d59c919726460,1,4,4,0,0,0,0,7,16,193,1,1,0,718,30,0,46,46,0,5356,5356,0,21,21,0,100
e3f0496ec64aaf40d9de15c819cbf8863a11af10,1,2,17,15,0,0,0,9,13,300,1,1,0,257,116,0,22,24,2,1594,1678,84,9,9,0,100
f8311ce1cee5d5f45489f1e1dcf32e8e1ff8b3bf,1,12,14,2,0,0,0,2,5,651,1,1,0,170,117,1,10,10,0,1000,1009,9,10,10,0,100
d1b5b2b68fd16873851b6ed17b65c7fcea061a69,1,27,17,10,0,0,0,12,29,210,1,1,0,588,880,0,102,101,1,3964,3909,55,31,31,0,100
5666fe1779c3067ffbba23d194d8bc1f10b5e5eb,2,61,5,56,0,0,0,4,7,749,1,2,0.439496987,817,881,1,118,116,2,5358,5034,324,37,36,1,100
1f0a92c5578ed6a9ee8fb646b52fea1319561b1b,2,94,77,17,0,0,0,3,16,115,2,2,0.600245554,675,882,2,76,83,7,4588,4613,25,30,28,2,100
6751f83868543d80d2d8993b571ac88fee967a09,2,185,4,181,0,0,0,12,48,186,2,2,0.702466551,1929,883,3,303,287,16,17192,15859,1333,93,89,4,100
4b2f9b76ce0619fba2b327fed11641f72f043021,0,0,0,0,0,0,0,0,0,0,0,0,0,0,118,2,0,0,0,0,0,0,0,0,0,100
f030e96cc375df8e9a48d5eedd50a445cec3090d,0,0,0,0,0,0,0,0,0,0,0,0,0,0,119,3,0,0,0,0,0,0,0,0,0,100
0ae4dae280e6acd14116f625bd0e4d75dcb7371d,1,13,9,4,0,0,0,8,11,174,1,1,0,561,884,4,51,51,0,3829,3806,23,34,34,0,100
dad344527cfa03108bf12b4cf3005033dcf1f343,1,16,7,9,0,0,0,4,5,336,1,1,0,293,885,5,53,52,1,1927,1886,41,33,33,0,100
13bb6ca63e7027c3375f610faccb1fe787101888,0,0,0,0,0,0,0,0,0,0,0,0,0,0,886,6,0,0,0,0,0,0,0,0,0,100
b2fbab0a44ffa715934e1d26dab3e1dd7f8c553d,2,103,10,93,0,0,0,12,49,2,2,2,0.969905843,2064,887,7,314,303,11,17750,17192,558,95,93,2,100
d97244b7cb2f61d220ef50b723b535acafc61840,0,0,0,0,0,0,0,0,0,0,0,0,0,0,888,8,0,0,0,0,0,0,0,0,0,100
6fda0c93ed56e22f5c59e3447390739dff86ec37,1,45,0,45,1,0,1,1,1,0,1,1,0,0,889,9,4,0,4,174,0,174,1,0,1,99.93434874
3bc385598d2c212a98f6d88ecfb4fe326235ef53,2,2,4,2,0,0,0,8,24,59,2,2,0.918295834,944,890,10,120,120,0,7043,7016,27,48,48,0,100
9e85328e90b84dd54fe4b9142b08a4601202cfca,3,3,3,0,0,0,0,1,8,134,1,3,1.584962501,398,891,11,68,68,0,3603,3627,24,15,15,0,99.9474652
ff5405aea25a7ea4f5cff562a47fb090d12d3c3f,4,914,48,866,2,0,2,2,4,365,1,2,1.838724447,223,892,12,79,19,60,5795,1607,4188,28,8,20,99.89501312
51d0e8fde9073d7314c3141895648ac802eba763,2,17,1,16,0,0,0,2,22,2756,2,2,0.503258335,367,893,13,65,62,3,2279,2212,67,29,28,1,100
8fe1e8f682feaa9871cd4a2e647a8bd655ceeb35,2,325,19,306,0,0,0,4,9,406,1,2,1,540,894,14,77,51,26,4279,3160,1119,58,42,16,100
46b34d195210a3c31b92527fc87bfe1bfb8efd43,1,1,0,1,0,0,0,4,25,12,1,1,0,384,895,15,69,69,0,3228,3223,5,14,14,0,100
870a96f574b366c0800180a304332b9f19b8e74f,4,81,23,58,0,0,0,7,117,506,2,4,1.780396057,3517,896,8,638,631,7,24602,24124,478,161,157,4,100
81abb6bd0adb6e101898d67b3c2a9e35e11ce993,21,1836,1531,305,6,0,6,1,93,282,2,7,3.247158175,9256,897,9,1078,1069,9,78613,77249,1364,517,501,16,99.64705882
562e07cc1de2f1e56f5e1a5841967c454e717457,2,10,0,10,0,0,0,8,35,829,2,2,0.970950594,940,898,10,204,202,2,7683,7629,54,57,57,0,100
b17a900c51f24f0d8b6846f15d42a671bf55a6af,12,808,483,325,5,0,5,1,48,156,3,4,2.433092577,3691,899,11,535,512,23,31732,30261,1471,178,155,23,99.61074348
607ea45287fa3ee82a53aef06eff4783e5c91550,1,39,0,39,0,0,0,1,2,2,1,1,0,258,900,11,24,20,4,2487,2256,231,12,11,1,99.89662747
46e917ccee61465b71084d78fcf29d48a6b39162,3,74,54,20,0,0,0,5,15,200,2,3,1.085228429,1340,901,12,206,199,7,8382,8278,104,140,138,2,100
f7a7635e5f0a34734398066350f81c506b9d87cf,3,29,3,26,0,0,0,2,31,281,1,2,0.534954723,505,120,0,78,76,2,3850,3821,29,23,21,2,100
a734414d48ba884b5bac68add9b724d9199f4a78,2,19,10,9,0,0,0,4,11,225,1,1,0.957553484,224,121,1,43,41,2,1568,1516,52,22,21,1,100
f7fa8e676dbb7803e3049e24c6e76f6f95caa212,2,60,24,36,0,0,0,2,15,22,1,1,1,256,122,2,20,18,2,1945,1677,268,13,12,1,100
09a4790022ec2857fac35a19e01b73008b0c577c,1,2,2,0,0,0,0,2,4,23,1,1,0,163,123,3,37,36,1,981,977,4,14,14,0,100
9a9bfa30c359ca3f1bca29d501f56c0c07c52bc3,0,0,0,0,0,0,0,0,0,0,0,0,0,0,289,0,0,0,0,0,0,0,0,0,0,100
2619862225cd071d431e47985e019b2b2991a4a8,2,30,3,27,0,0,0,3,4,312,2,1,0.967294779,145,290,1,23,20,3,1114,1012,102,8,7,1,100
450c12a42ecf950e65c20ddabf56be4b9379f1eb,4,55,26,29,0,0,0,12,50,248,1,4,1.358136267,1314,124,4,295,291,4,10711,10576,135,71,70,1,100
8c062d4d66b97bf7e5a31487f1a655e30d4ded5f,0,0,0,0,0,0,0,0,0,0,0,0,0,0,902,6,0,0,0,0,0,0,0,0,0,100
1f1473a33a3814eb2703d98b739d1020d03fdfe8,2,9,1,8,0,0,0,21,146,191,1,2,1,1593,125,5,316,316,0,12034,11995,39,68,68,0,100
cfdcfe982a20c50fc79608c8d4113afed8300a32,1,1,1,0,0,0,0,7,15,279,1,1,0,89,291,2,14,14,0,602,598,4,6,6,0,100
58a9ac5883093651fa1ec9efbbd9af2e809670b1,3,28,8,20,0,0,0,8,147,110,2,3,1.084884029,4059,903,1,614,614,0,34338,34160,178,148,147,1,100
dc404aace67e0bcdd29bf195f9ef91b3d3083b85,2,2,1,1,0,0,0,2,5,2726,1,2,0.918295834,211,904,2,43,43,0,1204,1193,11,17,17,0,100
43c79e6b132f46c4ec12acd0a88443248a13f14d,5,79,29,50,0,0,0,4,148,145,2,3,1.87178031,2650,905,0,513,506,7,23103,22628,475,125,125,0,100
0fcf259292639837fd1e4f3c23ed82c2a07d1e3f,4,29,78,49,0,0,0,4,149,0,2,2,1.812723278,2113,906,1,342,349,7,18938,19411,473,91,91,0,100
ccd6477c4f4efee864173a36b20188e580352f54,4,78,29,49,0,0,0,5,150,0,2,2,1.812723278,2073,11,0,349,342,7,19411,18938,473,91,91,0,100
267d481abd5166712d4f7a9d5c46d9e6a45a28ce,1,58,0,58,1,0,1,1,1,0,1,1,0,0,907,2,1,0,1,386,0,386,1,0,1,93.70002423
203ecc4a1f04b5f5d11e42e1b82f95b702f32e66,2,55,3,52,1,0,1,1,10,232,2,2,0.531340014,221,908,3,36,35,1,1539,1267,272,19,18,1,99.95440036
70740889405980f022ac756fb60fc2c041c61e68,2,65,18,47,0,0,0,3,118,470,2,1,0.896892883,963,909,4,151,149,2,7421,7049,372,31,29,2,100
be9db905c7acbfebd1fc61ce1ae1b177d3fba2a3,2,4,3,1,0,0,0,4,8,150,1,2,0.591672779,860,910,5,118,118,0,5362,5358,4,37,37,0,100
e36106b4e64e39ac150a14b961fc0ffd6aee0aec,1,7,9,2,0,0,0,4,9,123,1,1,0,482,911,6,26,26,0,2103,2110,7,23,23,0,100
336d796dd3af8c791b0905caeee16059a79c27cd,0,0,0,0,0,0,0,0,0,0,0,0,0,0,912,7,0,0,0,0,0,0,0,0,0,100
734d7d553c6ab721991697f7afbb0d747b1842a3,4,73,12,61,0,0,0,11,22,1094,2,4,0.858115095,3043,913,8,455,445,10,25039,24515,524,121,120,1,100
dcac5778079db999599f81d5cfa88f075feb5fb9,1,14,3,11,0,0,0,8,13,818,1,1,0,230,914,9,52,51,1,1401,1373,28,19,19,0,100
432c4ff6b3fb658a06b269d528ca5967e9e78e06,3,33,2,31,0,0,0,18,83,448,2,2,0.626994856,2703,915,10,314,312,2,28001,27817,184,84,82,2,100
da947d15b3d2e2fb54be242304f5d6f42ff12b14,1,2,1,1,0,0,0,2,3,68,1,1,0,49,916,11,6,6,0,234,216,18,3,3,0,94.075214
c17fcb9c84e8923dab4c9628f4e4292c825cdc58,1,3,5,2,0,0,0,4,12,249,1,1,0,907,917,12,89,89,0,5999,6019,20,52,52,0,93.38205847
a4c4014ab9ff26b6d26c8c90db7b22b7685e2e56,0,0,0,0,0,0,0,0,0,0,0,0,0,0,918,13,0,0,0,0,0,0,0,0,0,100
b465c29bf793aaed5220b9cd4d7c74c937fddb1f,1,3,2,1,0,0,0,5,9,828,1,1,0,162,919,14,30,30,0,1063,1067,4,24,24,0,100
73de20fe49e8a16f5f7d71e59a6e1fa55befdd7a,1,1,0,1,0,0,0,7,11,20,1,1,0,221,920,15,35,35,0,1271,1267,4,18,18,0,100
fcc004ca7ba926a76ee9343fd06735fccaa0c1be,1,3,14,11,0,0,0,8,14,12,1,1,0,237,921,16,51,52,1,1373,1401,28,19,19,0,100
cadd334830e5629ebeee8d5737bcdaa431d159d6,3,40,4,36,0,0,0,18,84,12,2,2,0.530406078,2723,922,17,316,314,2,28283,28001,282,86,84,2,100
c1c6ab3593a890870c26a61bc0116bf8173e81d5,1,2,2,0,0,0,0,3,6,357,1,1,0,248,923,18,22,22,0,1952,1952,0,12,12,0,100
7d860975e9e771979d15057c7c0a25b32c224bf5,1,2,2,0,0,0,0,3,5,260,1,1,0,491,924,19,119,119,0,3072,3080,8,14,14,0,100
ec25b6d4ab36142756b14367b302a83155ce00e8,6,285,50,235,0,0,0,3,34,304,2,5,1.813152183,1931,126,0,336,311,25,17667,16338,1329,77,73,4,93.38205847
74a556e21900c54a346fd773430daec477b55739,2,22,5,17,0,0,0,2,9,639,1,1,0.918295834,266,127,1,53,52,1,2177,2044,133,18,18,0,100
755e6ae124c057c49b306adb993c58322e788f68,0,0,0,0,0,0,0,0,0,0,0,0,0,0,925,20,0,0,0,0,0,0,0,0,0,100
01e0714ee6a3648b8e8544e3dc374be70cb28c9e,1,51,0,51,1,0,1,1,1,0,1,1,0,0,926,21,3,0,3,181,0,181,3,0,3,99.9667249
e604b0e10100a4c83aee44acdd1c1d335c3a4c90,0,0,0,0,0,0,0,0,0,0,0,0,0,0,927,22,0,0,0,0,0,0,0,0,0,100
d734dfbebdaa5de29ca041e7e9b41e695a536046,3,51,6,45,0,0,0,4,34,47,1,2,0.492137991,1129,128,2,202,197,5,10637,10349,288,30,29,1,100
054c5067a113dce53504b8569ad1cb76a1623e9c,4,38,9,29,0,0,0,1,4,997,2,1,1.451222845,486,928,17,101,101,0,3302,3049,253,48,47,1,100
865eff7dcd768fe3f2cc9cdf7a7c5196abfad3dd,0,0,0,0,0,0,0,0,0,0,0,0,0,0,929,18,0,0,0,0,0,0,0,0,0,100
86842ce6f2b284b14cf501a500426627994a817f,1,8,6,2,0,0,0,18,85,28,1,1,0,2546,930,13,288,288,0,27100,27062,38,79,79,0,100
553e242c7617714aa274688a8cec2fafc7b2b728,4,146,71,75,0,0,0,1,13,491,2,2,1.698962205,1170,931,8,165,130,35,8175,7698,477,76,71,5,100
d5f8e73c43237756d08fde32b930ab56b7c5af84,0,0,0,0,0,0,0,0,0,0,0,0,0,0,932,8,0,0,0,0,0,0,0,0,0,100
4a37d22adb62b414b019ac26fddbfcc79de5c308,7,40,31,9,0,0,0,3,94,292,2,3,2.515992823,3337,129,1,418,416,2,25758,25730,28,195,193,2,93.38470777
05061ce7c52d0908773789e724839ccf9278951b,4,84,18,66,0,0,0,3,9,254,2,3,0.808251571,1053,130,2,233,227,6,7812,7489,323,137,134,3,100
38749912f58ed4c1b7efeb00e687daaf86c22206,1,18,12,6,0,0,0,5,7,80,1,1,0,383,131,3,20,19,1,2511,2474,37,16,16,0,100
bf526ee58c09519f9d4396e9bd236d4649b7000d,3,43,41,2,0,0,0,11,23,75,2,3,1.458618551,1259,933,5,200,202,2,8782,8717,65,74,75,1,100
a648d120f5331d9a752ed343f41f79ce9831625d,2,14,0,14,0,0,0,4,14,16,2,2,0.591672779,1104,934,6,144,140,4,7325,7222,103,68,68,0,100
0960d79cdcebbaad235c9ae9b239fa4104431c92,0,0,0,0,0,0,0,0,0,0,0,0,0,0,132,4,0,0,0,0,0,0,0,0,0,100
5df96bbe3af9a0c914bca043918c553b7c9dcf9f,3,48,17,31,0,0,0,2,35,264,1,3,0.637990801,1159,133,4,219,216,3,10843,10741,102,32,31,1,100
3e2467e8c3a966175969788930ed358b8614f665,3,11,6,5,0,0,0,3,8,806,1,2,1.579863401,1817,134,5,503,503,0,12149,12074,75,230,230,0,100
e86370cb6de9230ffd98ca72ee53fb66ee7c8ac1,1,1,1,0,0,0,0,12,22,3,1,1,0,659,135,6,81,81,0,5030,5030,0,39,39,0,100
04fc039b1918a4ec56dcfdc1c6eea66fa7955d11,0,0,0,0,0,0,0,0,0,0,0,0,0,0,935,5,0,0,0,0,0,0,0,0,0,100
8e293612c4fcc07179b8f1f7d8c792eb4e7391c0,3,54,13,41,0,0,0,13,41,189,2,3,1.399276674,995,136,7,154,151,3,6533,6252,281,102,101,1,100
a620bc6acabd125fd5faae8433011e76b8882e32,3,67,11,56,0,0,0,1,8,593,1,2,1.45654615,689,137,8,137,121,16,5023,4678,345,66,62,4,93.39339339
83819b28ba83ec19606d89e2931ba588c12171cf,3,58,2,56,0,0,0,1,7,1216,2,2,1.294820355,461,936,3,34,32,2,3078,2808,270,22,20,2,100
721eaae08a868ea49b6f9e185d854f2552fb9358,4,123,67,56,0,0,0,2,42,703,2,3,1.201477229,1288,138,8,144,140,4,7280,6963,317,89,86,3,99.97503952
e0994bbd8871f9ec0746744b419de8a12420b5b4,2,25,0,25,0,0,0,2,2,404,2,2,0.529360865,491,139,9,32,30,2,3569,3403,166,21,20,1,100
484f80661d29adaa62e6eb075c5463562d2934e7,2,12,1,11,0,0,0,1,13,500,2,2,0.619382195,288,937,4,33,32,1,2280,2201,79,15,14,1,100
9647a133ebc523f63e8f1cc008a60132c44a4f1e,0,0,0,0,0,0,0,0,0,0,0,0,0,0,938,5,0,0,0,0,0,0,0,0,0,100
af475351f2ca73b4b7cb4765e3f3453619075d7a,1,33,20,13,0,0,0,4,11,1311,1,1,0,227,140,8,43,41,2,1490,1439,51,10,10,0,100
8af34f1971628d1eeb0cd1f07fe03397ca887b81,30,2233,709,1524,14,0,14,1,151,208,2,16,3.318867642,9302,939,4,1980,1767,213,78493,70280,8213,571,479,92,99.50906973
38d3e3e0d299c63833ffa938cf107af8b1828e7e,17,884,352,532,0,0,0,2,37,313,2,7,2.507097791,6958,141,8,1203,1134,69,57193,54593,2600,398,379,19,99.95839228
3b270290f0c377c3992a1c339b9340d662df9ec2,0,0,0,0,0,0,0,0,0,0,0,0,0,0,940,5,0,0,0,0,0,0,0,0,0,100
696ac3de0fc1b2da3bdd4ef97b63bc58d5fea393,0,0,0,0,0,0,0,0,0,0,0,0,0,0,941,6,0,0,0,0,0,0,0,0,0,100
2f83171969c7c3c545bf1bbe935cc24afe9e01f9,1,18,8,10,0,0,0,4,11,479,1,1,0,258,142,4,38,38,0,1551,1531,20,12,12,0,100
dea80db3bd312f1b7eee4faee0394cc501cef1fd,1,11,9,2,0,0,0,2,6,250,1,1,0,273,143,5,43,42,1,2277,2266,11,10,10,0,100
ed42399013e505f6f189c4a5df4a3ac4439a09fb,1,11,5,6,0,0,0,4,12,0,1,1,0,260,144,6,39,38,1,1579,1551,28,12,12,0,100
3056787406382d44b4a699cf350e78d61cda3f2e,1,1,1,0,0,0,0,4,13,0,1,1,0,266,145,7,39,39,0,1583,1579,4,12,12,0,100
00aae0ef8159381612de3ccdc6427dbe5c06e4f9,2,40,4,36,0,0,0,2,11,28,2,2,0.684038436,1075,146,8,146,145,1,6622,6466,156,60,59,1,100
9a5309bca3c724baef1ef75a34d9a9f263e1b05a,19,707,103,604,3,0,3,1,95,556,2,10,2.949687127,4245,942,5,820,752,68,37416,33573,3843,347,327,20,98.91257444
845e5ffc9236c6b36fb82546e8d4b49b65f212ad,1,1,5,4,0,0,0,1,2,16,1,1,0,143,943,1,21,22,1,1271,1288,17,3,3,0,100
7f98753503c6a013dfd85c8f0b20753b64a24d6a,0,0,0,0,0,0,0,0,0,0,0,0,0,0,944,2,0,0,0,0,0,0,0,0,0,100
619f4fe1d7c435f3c90ed22ffece63283b100389,2,75,21,54,0,0,0,3,5,252,2,1,0.992158662,158,945,3,29,23,6,1509,1114,395,10,8,2,100
c0f60ade8b5a241a78c68833c64ffc91169bf0e9,0,0,0,0,0,0,0,0,0,0,0,0,0,0,946,4,0,0,0,0,0,0,0,0,0,100
c3109ff6bb0f0f7647435252276b92cd1cbba538,0,0,0,0,0,0,0,0,0,0,0,0,0,0,947,5,0,0,0,0,0,0,0,0,0,100
5ed9a9427435a60961de1b8002e7f8297d658149,2,21,75,54,0,0,0,3,6,0,2,1,0.992158662,217,948,6,23,29,6,1114,1509,395,8,10,2,100
7daf7add37c4555ebd3ae06afc82b629685e512b,2,71,2,69,0,0,0,3,7,8,2,1,0.758663863,158,292,0,35,23,12,1540,1114,426,12,8,4,100
bf1ecc5254a7e9f763ef29f03e949c22d8b564a2,0,0,0,0,0,0,0,0,0,0,0,0,0,0,293,1,0,0,0,0,0,0,0,0,0,100
1fee32e50ded93ae75ec46fb87fcdb5cea444d45,0,0,0,0,0,0,0,0,0,0,0,0,0,0,949,7,0,0,0,0,0,0,0,0,0,100
47efdc58e73a12ea6d384a120082a9fa33685b65,1,1,1,0,0,0,0,1,2,3641,1,1,0,46,950,8,8,8,0,235,235,0,2,2,0,100
a764e2b5bbb83b20d89109523fc3db71e8016a62,2,6,3,3,0,0,0,7,7,456,1,2,0.918295834,205,368,0,29,29,0,1233,1227,6,8,8,0,100
624fcca0dcf03367f0d4f32cc2ffba7afbd1e7fe,1,1,0,1,0,0,0,3,14,302,1,1,0,146,951,9,21,21,0,1242,1231,11,6,6,0,100
99ea4cf221771764f07f96eb656f26cd966ae789,1,13,0,13,0,0,0,4,28,71,1,1,0,385,952,10,71,69,2,3388,3234,154,14,14,0,100
a49e1e26d284d65dbf7670281d5a76712e34dc1d,1,6,0,6,0,0,0,4,8,818,1,1,0,77,147,0,9,8,1,501,455,46,5,4,1,100
77cfb4a6649341d2f5335d3c8cc645e519208a72,4,20,0,20,0,0,0,2,2,692,1,1,2,485,953,9,91,87,4,3719,3639,80,43,43,0,100
9440d24f2c08bada893c59626581517783f466ed,3,27,2,25,0,0,0,14,102,640,2,3,0.574828144,1539,954,10,152,151,1,12040,11843,197,91,90,1,100
c3ae87db72ccc850ecb41a0e928eefbd765408fe,12,280,76,204,3,0,3,11,125,759,1,11,2.846867028,6050,955,6,884,870,14,51035,49999,1036,163,159,4,99.89254052
43db8da84f96d88e5ac5e7498991fb5160443373,0,0,0,0,0,0,0,0,0,0,0,0,0,0,956,7,0,0,0,0,0,0,0,0,0,100
6e297a5af341522596d74531b5ae9430501c873a,0,0,0,0,0,0,0,0,0,0,0,0,0,0,957,8,0,0,0,0,0,0,0,0,0,100
fba27deb1e707eb642fc661ddb15889d50548f85,4,143,45,98,2,0,2,1,21,1305,2,3,1.919434232,1338,958,9,204,196,8,8404,8123,281,60,52,8,99.94634713
6537a2c9ec5607fb508c67d59992b785d9443217,0,0,0,0,0,0,0,0,0,0,0,0,0,0,959,10,0,0,0,0,0,0,0,0,0,100
9b5a9a2752d839b4bfa7631ab7394a13236a64a9,2,37,8,29,0,0,0,12,51,344,2,2,0.353359335,2129,960,10,319,315,4,17997,17766,231,95,95,0,100
4c828cd88149cd8fa009c46f321711e2af54a1e4,2,22,23,1,0,0,0,8,75,424,1,1,0.99964375,2373,961,11,206,206,0,19870,19886,16,110,110,0,100
ad519d818715cb13d78f482aae694394e8e87cfb,1,7,1,6,0,0,0,22,79,339,1,1,0,1180,962,12,231,230,1,7577,7541,36,65,65,0,100
c04054573ba6811cf866433032c9e0094da86cb9,1,23,4,19,0,0,0,5,39,77,1,1,0,917,963,13,173,170,3,8645,8512,133,17,17,0,100
862258a81e2bf9b1b66cbb08f06cec8afd2e912a,1,1,0,1,0,0,0,2,8,81,1,1,0,412,148,1,95,95,0,3588,3573,15,11,11,0,100
401324e301e18cbfff187c2838397eb57d257576,1,3,5,2,0,0,0,2,12,12,1,1,0,1852,964,11,255,256,1,16406,16414,8,46,46,0,100
20da4d10bb418fd9cde72f741cfd9bc04689f8a0,1,3,2,1,0,0,0,22,103,33,1,1,0,304,965,12,54,54,0,2214,2205,9,19,19,0,100
da4fe711a3c69d3e64b0656e7ee480b608cc4ff1,2,24,8,16,0,0,0,10,76,526,2,2,1,1582,966,13,146,146,0,12090,11889,201,71,71,0,100
2df66637bd701be08e085bf795a9b84e8a4efeb0,1,9,11,2,0,0,0,1,2,126,1,1,0,39,967,14,5,5,0,303,338,35,4,4,0,99.62365591
91c8c504c5ea20153e9b210a4269cf5814851360,0,0,0,0,0,0,0,0,0,0,0,0,0,0,968,15,0,0,0,0,0,0,0,0,0,100
b9db72146ed03555919ba48eb0522cca22e4c2c1,1,3,3,0,0,0,0,13,51,2009,1,1,0,1204,969,16,480,480,0,8348,8348,0,53,53,0,100
da323cc5f45674110641899f1f03251854ba6d00,1,5,5,0,0,0,0,22,104,5,1,1,0,305,970,16,54,54,0,2206,2214,8,19,19,0,100
8a20f45ba5e815291bb0314ac3891b13df8c4b7c,25,11,2931,2920,0,0,0,3,152,355,2,14,2.830624711,13400,971,17,1982,2464,482,88831,103207,14376,639,777,138,94.2531142
d835cada4253983270b9158eafde265620c6e3b7,1,0,0,0,1,0,1,2,6,132,1,1,0,0,972,18,0,0,0,0,0,0,0,0,0,99.97491219
9f8d39f0a413efd4ad5655aa4e997dc228817431,1,25,6,19,0,0,0,1,2,635,1,1,0,28,149,1,10,4,6,349,203,146,2,1,1,100
57c5db269aead28337e25c844b01777aa392c7c1,3,11,10,1,0,0,0,7,77,173,2,2,1.20600269,1616,150,2,141,140,1,12296,12312,16,82,82,0,100
8c31f506f8c009ec7b7e6b93180870c778e8cf1d,4,136,163,27,0,0,0,21,96,2736,2,2,0.493465905,3901,151,3,522,557,35,36174,36931,757,205,201,4,100
3d7c402ca0e1a4e5a60a4909043a5e28acdf73aa,3,31,40,9,0,0,0,13,40,266,1,2,1.029192975,1588,973,18,304,308,4,13136,13182,46,95,95,0,94.78516342
ee3af1f1707f9f826d8c8513632500b58638835d,1,17,9,8,0,0,0,22,153,3,1,1,0,1457,152,4,305,305,0,11157,11144,13,66,66,0,100
d377c0194e491dadde171784156cfe87281d482c,0,0,0,0,0,0,0,0,0,0,0,0,0,0,974,19,0,0,0,0,0,0,0,0,0,100
ad212765221661418bd1b13526d247549fb1d0c0,1,167,109,58,0,0,0,7,15,590,1,1,0,232,975,20,43,38,5,1629,1395,234,9,6,3,100
b65758c1ac6432063f109f6cc04aa49c0e80ad8b,1,14,4,10,0,0,0,3,8,500,1,1,0,127,976,21,10,8,2,870,778,92,5,5,0,100
f7550198009da47f8d9a871967ca8450923143a0,1,1,1,0,0,0,0,1,2,45,1,1,0,68,977,17,7,7,0,406,406,0,2,2,0,100
a9800ff027c521e67e548a3a34eb331fc3750d8a,1,1,1,0,0,0,0,10,51,498,1,1,0,935,978,18,91,91,0,7950,7942,8,45,45,0,100
502f54c39bf4689ffabe0d4059f72535d62e113b,1,7,3,4,0,0,0,2,13,35,1,1,0,1850,979,19,256,255,1,16414,16406,8,46,46,0,100
a343a2acbe4909b29aaf9be2e21171b4656a8553,0,0,0,0,0,0,0,0,0,0,0,0,0,0,980,16,0,0,0,0,0,0,0,0,0,100
3a3225dafc3a469b77646e4daad012df8214689f,4,81,15,66,0,0,0,3,41,76,2,4,1.680155967,3221,981,16,507,490,17,28882,28346,536,83,81,2,100
041940c7fc968e020e160e72ad922fdab109124e,0,0,0,0,0,0,0,0,0,0,0,0,0,0,982,6,0,0,0,0,0,0,0,0,0,100
05bb7178d8042592fa189f5d4d0d88ebc788c935,3,1021,0,1021,1,0,1,1,15,303,2,2,0.275899362,1509,983,2,382,189,193,15577,9557,6020,211,88,123,99.97610514
e7706954a9c27153a886724b2fefb3cc348deca6,1,0,482,482,0,0,0,1,2,0,1,1,0,639,984,3,94,188,94,2877,5754,2877,61,122,61,100
8d30f5db99d783f9f1c80889b909ebe61bb5baa1,0,0,0,0,0,0,0,0,0,0,0,0,0,0,985,4,0,0,0,0,0,0,0,0,0,100
aff6cd0f3290bf013418135f0da5018a219c3355,2,62,2,60,0,0,0,18,87,465,2,2,0.997180399,2563,986,5,263,259,4,27153,26789,364,89,88,1,100
d2c072965390a11901889c3f1ccd571f879a7001,3,97,26,71,0,0,0,8,17,742,2,2,1.386525471,1043,153,0,155,147,8,7984,7662,322,61,56,5,100
58588f70835f70849181549be92b2479ce54d6b1,0,0,0,0,0,0,0,0,0,0,0,0,0,0,987,5,0,0,0,0,0,0,0,0,0,100
35f9ade5ee1d6c1af1de939316bea1409c1d311b,0,0,0,0,0,0,0,0,0,0,0,0,0,0,988,6,0,0,0,0,0,0,0,0,0,100
2b05bcc82efb86f6257d1f416d31c2775b8360dc,5,219,125,94,0,0,0,2,15,266,2,3,0.684862015,3161,154,1,402,388,14,24299,23947,352,140,136,4,100
2ba10151182aee4bf9a510f566c6cffc31efbe92,2,17,2,15,0,0,0,3,154,461,1,2,0.74248757,1570,155,0,322,320,2,11984,11879,105,73,73,0,94.75618721
b1dd9b6e1fd05741d4ef06ac1ac046466f7831df,3,18,4,14,0,0,0,10,38,1964,2,3,1.177022555,5075,989,0,1174,1169,5,39176,39087,89,121,121,0,100
0882f7954fd42d4312a9e1c7e8448f11129ebd0b,2,41,18,23,0,0,0,14,39,354,1,2,0.999792766,1140,990,1,246,241,5,8472,8311,161,81,79,2,100
1366f6d6e6d02c6b88b43baf2f200d74632f7087,2,2,2,0,0,0,0,6,11,934,1,2,1,838,991,2,144,144,0,5453,5453,0,39,39,0,100
7ea85c62d3076907c4286249564d79d2a23d672a,2,47,7,40,0,0,0,3,11,551,2,1,0.918295834,571,992,3,103,96,7,3971,3707,264,76,75,1,100
e3ef20fcced523d87b0be85740d0e46cb7c3b987,2,153,13,140,1,0,1,1,3,515,2,1,0.910053429,55,993,4,19,9,10,966,281,685,8,3,5,94.28631446
79f92f9f99edda315f9edc08e70d4886db80015a,2,204,0,204,2,0,2,1,1,0,1,2,0.940878254,0,994,5,2,0,2,492,0,492,2,0,2,99.96394447
226a1a1a47f7e9d6a115ab8f2a092eac783c047d,5,59,8,51,0,0,0,2,37,252,2,4,1.893617695,1863,156,0,283,275,8,13146,12806,340,84,82,2,100
e21de2629c2a72d31fb64d06228d34bbcadc501e,2,94,44,50,0,0,0,4,5,3268,1,2,0.578133612,250,995,6,47,39,8,1992,1748,244,15,13,2,100
98d2177e0b6a4dcaf6c6e102203968f1c83a78a2,0,0,0,0,0,0,0,0,0,0,0,0,0,0,996,7,0,0,0,0,0,0,0,0,0,100
d926060ad7222b3aee201e1f08fe806185d8171d,2,44,94,50,0,0,0,4,6,0,1,2,0.578133612,297,997,8,39,47,8,1748,1992,244,13,15,2,100
88ceb9867deff997c24c1e9078b2aa08c8c0ed6b,2,22,7,15,0,0,0,6,28,1886,1,1,0.929363626,547,157,1,120,119,1,3257,3144,113,52,52,0,100
c3e21226acbe1b688c2a1afb7803bdbcacb27bc5,14,175,201,26,0,0,0,1,42,1113,1,3,3.497361601,2314,158,2,492,516,24,17797,18088,291,94,97,3,100
842e3a28d03339312b8880a57ec8b6ff1fb3e103,4,546,11,535,1,0,1,4,43,842,1,4,1.049616901,1208,159,3,327,230,97,13097,10036,3061,104,35,69,96.12956639
b80c8a88f63e9888cb74a50199b13037f01c9858,1,0,215,215,0,0,0,1,2,0,1,1,0,294,160,4,33,66,33,1265,2530,1265,33,66,33,100
381ef5acd73b1a25f29f7cf1bf9434d7eed97695,1,5,0,5,0,0,0,22,155,83,1,1,0,1462,12,0,305,305,0,11168,11157,11,66,66,0,100
4f4346790e9353b1c0860a938174189a803d03de,3,19,2,17,0,0,0,7,16,345,1,3,1.023037066,747,161,5,113,112,1,5644,5560,84,29,28,1,90.92814002
4137b8db89f2d374630fdb1cdaa930a2dec13971,5,602,46,556,0,0,0,1,44,117,1,4,1.513875005,3699,162,6,760,660,100,33864,31083,2781,281,222,59,100
caf2540f8742496d7958ba76b76099602579ea7a,2,13,11,2,0,0,0,9,24,505,2,2,0.738284866,3924,163,0,515,514,1,29503,29495,8,216,216,0,100
c1e5d126c6b0ae0c8a7024ef0a850cab98c0b804,2,8,8,0,0,0,0,2,3,542,1,2,0.811278124,492,164,1,41,41,0,4013,4013,0,21,21,0,100
4eec8e279df517aa5a03271701e837a7c52bc382,1,11,5,6,0,0,0,6,10,65,1,1,0,131,165,2,29,28,1,835,816,19,5,5,0,100
97aa09dc59f496b44b8050f9292ef58de7d99452,1,2,2,0,0,0,0,3,13,207,1,1,0,348,166,3,30,30,0,2648,2648,0,17,17,0,100
2e3e044bc11fb7cf67e96945c9e1fa8e5656d87e,9,85,88,3,0,0,0,12,37,337,2,5,2.212975996,2968,167,4,468,473,5,24786,24899,113,143,139,4,99.22103213
4f7378522fdd008e0bd514c4aadc74c72e56b27c,2,9,5,4,0,0,0,1,5,780,2,2,0.985228136,289,998,0,51,50,1,2103,2073,30,24,24,0,100
75ca474d478213dc4644fd4c1f4370cd8ce5d29b,1,2,2,0,0,0,0,1,6,2,1,1,0,93,999,1,13,13,0,545,545,0,6,6,0,100
15ced6ca24c428ab053777b790729547ed5b71ff,2,14,18,4,0,0,0,4,8,1324,2,1,0.543564443,173,1000,2,22,22,0,1216,1203,13,7,7,0,100
19b6181350d6e78ea4ea85cfded308a63704cc41,3,56,4,52,0,0,0,18,88,180,2,2,1.360964047,2693,1001,3,281,269,12,27934,27482,452,91,90,1,99.94074425
2c30470998030a0521d957666df252dfd5f417e5,2,297,0,297,2,0,2,1,1,0,1,2,0.945660305,0,1002,4,19,0,19,1416,0,1416,11,0,11,99.84598981
46e5c5ff0c9046d061c56c8d788de49e45baaa34,1,2,2,0,0,0,0,18,89,1,1,1,0,2550,1003,5,251,251,0,26712,26712,0,83,83,0,100
db1d563060190b3ebcf177a970cb60a0e76789c0,2,26,1,25,0,0,0,2,52,2488,2,2,0.876716289,1018,168,0,233,231,2,8032,7862,170,60,59,1,100
8020d24920c901074b625d39dcff002122263646,1,1,1,0,0,0,0,2,5,18,1,1,0,102,1004,6,26,25,1,651,647,4,3,3,0,100
eb9bfbf13cb5874d387152d08d17a0fdd8c839c0,1,1,1,0,0,0,0,15,39,1150,1,1,0,289,1005,7,20,20,0,2580,2581,1,11,11,0,100
55a0bbbe7b087fbda8fe7327a0510c2a73285685,3,44,2,42,0,0,0,6,33,941,2,2,1.11467858,1104,1006,8,164,159,5,7726,7452,274,86,84,2,100
c4dac937bf9aa90f34a6d3cebcf9e391df667f6b,3,44,4,40,0,0,0,2,10,348,2,2,1.122607968,786,1007,9,168,165,3,5509,5265,244,127,126,1,100
237e1aa92489a331021412f3b06775ea4d6dbd2d,2,109,63,46,0,0,0,2,8,911,2,2,0.964498737,549,169,1,69,66,3,4601,4281,320,30,29,1,99.97630332
22e146100f44c2d280eea8a857113a2d98ca3269,2,22,4,18,0,0,0,4,8,625,2,2,1,474,170,1,58,56,2,3511,3411,100,21,21,0,100
bcca5cc12a02b78f4f60940b00339dbea081be24,5,37,50,13,0,0,0,10,45,415,2,4,1.887955881,3712,171,2,575,581,6,31150,31401,251,122,120,2,99.91693367
578c45052721b9eb753d301e69c2b7b3fac70133,5,87,12,75,0,0,0,2,38,151,2,4,1.953174358,1850,172,3,275,268,7,13173,12658,515,84,84,0,90.04026528
c76f11fd9d1daf961a329bb33ff00607c238a92d,2,13,1,12,0,0,0,2,4,1804,2,1,0.591672779,540,294,0,69,67,2,4713,4615,98,39,38,1,100
4ce7d0eaa9b80c5aa313e649c6d8b043b28c2bd1,2,15,12,3,0,0,0,19,120,210,2,2,0.975119065,1037,173,4,151,151,0,7426,7414,12,33,33,0,99.95279679
8057bbe21cb27b2bf0e978b30bb20850abf240de,7,34,22,12,0,0,0,2,39,786,2,6,1.77830001,1598,174,5,287,284,3,11954,11910,44,133,131,2,100
7ace01ad91aba5249c014fb89e20d50fd4a3d896,0,0,0,0,0,0,0,0,0,0,0,0,0,0,175,6,0,0,0,0,0,0,0,0,0,100
f65c5f6436a3a0f64200e7a96401926b4c365533,2,37,36,1,0,0,0,5,11,783,1,2,0.675863572,559,176,7,99,99,0,4275,4266,9,32,32,0,100
ae6a1e73fa92c83c245baed40f3237ea6f60d47f,7,165,81,84,0,0,0,2,46,648,1,4,1.978825591,2298,177,8,456,446,10,18167,17449,718,128,128,0,99.90534785
41810d08533ecace93cd4fbe9534301a1962ea0d,3,38,1,37,0,0,0,2,39,25,2,3,1.497449071,2760,178,9,332,326,6,20871,20688,183,103,102,1,100
cad61e553abc4958e34cf5b1736f3f45fd2c6cc9,7,67,37,30,0,0,0,2,47,248,2,5,2.233463685,2339,1008,0,484,481,3,18777,18476,301,183,180,3,99.90517957
057d0de9312433f3bb155eb8bf8c11142aeba392,11,504,78,426,3,0,3,2,156,400,1,8,2.641350358,3904,179,10,832,772,60,32100,29452,2648,230,206,24,99.79924421
efcf9f8ab6c074065de50f7d003ee77465bd101c,1,63,73,10,0,0,0,9,15,707,1,1,0,230,180,4,51,51,0,1402,1373,29,19,19,0,100
0eab5a83de64ea0d245f6ee2b4a6b3fd8e5724a2,3,6,5,1,0,0,0,1,5,189,1,3,1.435371391,414,181,5,73,73,0,3508,3501,7,21,21,0,100
b7409ebf25d53909b7b2be4af0c72d7bf1e4ea72,1,2,0,2,0,0,0,17,56,29,1,1,0,504,182,6,108,108,0,3057,3045,12,55,55,0,100
5be72620743c341158c4c4a021a28e659c33e206,0,0,0,0,0,0,0,0,0,0,0,0,0,0,183,7,0,0,0,0,0,0,0,0,0,100
a1f23178442d1d25569e0c28abf3fb822a646b67,1,1,1,0,0,0,0,5,13,660,1,1,0,167,1009,1,14,14,0,1217,1217,0,10,10,0,100
801cf3ee7624527f1e7f7b446e1ef9870eb8dd0d,0,0,0,0,0,0,0,0,0,0,0,0,0,0,1010,2,0,0,0,0,0,0,0,0,0,100
ece9b7cdb904fc99ad048d9ce9eb5cbd810b1496,8,534,6,528,5,0,5,1,40,304,2,4,2.45192226,537,1011,3,134,90,44,5173,3206,1967,77,50,27,99.85887334
724ce4de61f2c7d3f1202593223ebce1a0ae2228,6,179,47,132,1,0,1,9,190,673,2,4,1.855281177,2392,13,0,426,415,11,17650,17046,604,185,181,4,96.64373814
b59a5782fab57fc557c30fed05cf9191abf8761d,0,0,0,0,0,0,0,0,0,0,0,0,0,0,1012,3,0,0,0,0,0,0,0,0,0,100
91bcfaf436db8257f912d8e49849a998eefe13f0,0,0,0,0,0,0,0,0,0,0,0,0,0,0,1013,4,0,0,0,0,0,0,0,0,0,100
a80930596119328b5c8a71471f15a2d1d7728368,3,7,7,0,0,0,0,15,91,2165,2,2,1.378783493,3833,1014,5,550,550,0,23815,23815,0,268,268,0,100
1b16f75686ee95be7f72811ef093bbcf1a163462,0,0,0,0,0,0,0,0,0,0,0,0,0,0,1015,6,0,0,0,0,0,0,0,0,0,100
d374a13d08c1f2594257a24a1373154e3ccb4e1a,2,75,0,75,0,0,0,5,9,723,1,2,0.353359335,868,1016,7,121,119,2,5683,5399,284,39,37,2,100
a7ecd08f2ba4354282dbff3c40a01e2a4c816040,6,22,19,3,0,0,0,2,97,170,2,4,2.103261225,2926,184,0,519,518,1,23674,23641,33,156,156,0,100
9f7129c5111ad6750f4ddc36042e0c8202bc256b,1,3,2,1,0,0,0,13,32,1133,1,1,0,343,185,1,85,85,0,1954,1951,3,58,58,0,100
3aee11cd4f45ede2fa82d8700dde063365869afd,10,35,67,32,0,0,0,6,75,558,1,8,3.041645334,2643,186,2,485,486,1,16643,16774,131,214,215,1,99.86797888
618c41228a2af2dd7d963b809d792f2e7ee15cd3,3,102,13,89,0,0,0,6,19,361,2,2,0.894354395,458,187,3,90,83,7,3631,3049,582,43,38,5,99.9879721
3b0edee2e9b5890c0bb53df6575d4c8ea5bb17aa,7,452,34,418,3,0,3,1,121,271,2,5,1.967884256,2693,1017,1,512,460,52,20774,18441,2333,132,115,17,99.40305635
e2ac2bbd37a22e708842fa5a2215398fdb4003cc,0,0,0,0,0,0,0,0,0,0,0,0,0,0,1018,1,0,0,0,0,0,0,0,0,0,100
7f4f4de3e1c169a5ab265cee25ec302d5ae44757,2,18,12,6,0,0,0,3,31,288,1,1,0.996791632,533,1019,2,93,92,1,4350,4357,7,21,21,0,100
2a944a57b0ba07f2ad7fad0b360e7e0a52ea1700,0,0,0,0,0,0,0,0,0,0,0,0,0,0,188,0,0,0,0,0,0,0,0,0,0,100
9b3386a9717a17472edac960815d0ee79aa0e8d9,0,0,0,0,0,0,0,0,0,0,0,0,0,0,1020,2,0,0,0,0,0,0,0,0,0,100
ec7e3bcdbfbee23c2ba73a516a4201da744d2f91,1,16,5,11,0,0,0,4,32,65,1,1,0,416,1021,0,77,76,1,3603,3543,60,14,14,0,100
a7c5b902f4f6dc859375fe0ff373e56eb107b865,3,18,5,13,0,0,0,10,46,2098,2,3,1.409844941,1290,189,0,163,162,1,11359,11313,46,53,53,0,100
d1fec2dafeabd6394f8ea5f61becf204dab1f6d5,3,37,6,31,0,0,0,2,16,251,2,3,1.337619137,1704,190,1,295,287,8,10538,10293,245,178,177,1,100
615ae5c8bcd014f312c79efdbffb4d71969a64fb,4,185,38,147,0,0,0,10,52,488,2,3,1.902938252,1487,191,2,224,207,17,12692,11737,955,93,91,2,99.90494297
23e1cd0946b2b0ea4283d50dac0d6ec504308097,19,170,125,45,0,0,0,18,90,3406,2,2,3.609257466,5924,192,3,991,973,18,47391,47215,176,304,304,0,100
a649913187e94668b57638aa4eabc294114fedb2,1,21,10,11,0,0,0,5,50,186,1,1,0,1005,193,4,199,198,1,8710,8675,35,18,18,0,100
de235d107de25756af9af142098132543ae84940,4,60,6,54,0,0,0,9,51,1243,1,4,1.121739273,2397,194,5,654,640,14,18092,17755,337,70,69,1,100
7150eeb325cfc7691d1c93f7804069247f98ea1d,4,232,119,113,0,0,0,2,52,753,2,3,1.237319026,1411,195,6,254,244,10,12663,12012,651,41,38,3,100
624abd6686d0f044bd6aa00eec940e6ce1121d0f,4,97,19,78,0,0,0,5,20,897,2,4,1.617939222,1636,196,7,315,301,14,11875,11472,403,103,99,4,100
fb1b826a038a887e31ff1cd0d30431cc9b7b90b1,34,333,350,17,0,0,0,2,41,1028,1,6,4.544756019,10379,197,8,2112,2102,10,71014,71641,627,836,826,10,97.35339337
1d85c13acaa99add201f8709b43f49958a148a75,4,31,23,8,0,0,0,2,35,5,1,3,1.608049533,1287,198,9,290,288,2,8092,8065,27,129,128,1,100
dee4e35f13554620ce65f23c3099f4a4f915b6e2,2,39,10,29,0,0,0,7,23,14,1,2,0.768281409,799,199,10,167,161,6,5134,5010,124,46,46,0,100
6675ba75a19cea1c188f70fc2ae08b6504039054,5,64,42,22,0,0,0,2,127,363,1,4,2.025414203,4850,200,11,787,785,2,39908,39765,143,169,169,0,100
857211bb97374df0e3a16f438266d6999c6800be,0,0,0,0,0,0,0,0,0,0,0,0,0,0,201,12,0,0,0,0,0,0,0,0,0,100
342d6ddd860e04542324e6ddb14fe0f3eb45b75d,1,30,16,14,0,0,0,9,23,248,1,1,0,549,14,0,39,38,1,4349,4301,48,20,20,0,100
ec7ed17b0e6219d81f098d6efd7ca2965966f742,1,47,36,11,0,0,0,2,10,1162,1,1,0,273,202,3,52,51,1,1941,1898,43,15,15,0,100
684b838d2f5678450f088a381dfcb96e0466a67a,1,0,5,5,0,0,0,14,42,50,1,1,0,647,203,4,172,173,1,3994,4036,42,41,41,0,100
33b8a60e401c484ef1ef5bb0fcd6b8e43c41e6b5,5,133,11,122,0,0,0,2,17,481,2,4,2.011155798,1458,204,5,218,196,22,9819,9260,559,94,90,4,100
157479993411c1539343d4fce8ed6a4a497f0695,1,4,0,4,0,0,0,7,24,44,1,1,0,542,205,5,124,122,2,3506,3487,19,36,36,0,100
189c1b3db6f81e603c6b039a4724293b0fb5b250,1,10,3,7,0,0,0,7,9,1346,1,1,0,112,206,6,23,20,3,720,655,65,5,5,0,100
40125b6d17222e0db8fd32da92d9b0d62d040ba6,4,14,11,3,0,0,0,4,53,2274,2,4,1.459470571,2116,1022,0,416,416,0,15701,15617,84,108,108,0,100
3ae62ab4650cb5f607f318ab8fa1db359e533c00,1,1,0,1,0,0,0,9,17,1006,1,1,0,324,1023,1,59,59,0,2240,2234,6,25,25,0,100
f34b477b65d4655f3f760c0f0902ebea30c94097,1,13,11,2,0,0,0,8,20,1986,1,1,0,601,207,5,135,133,2,4237,4219,18,32,32,0,100
da13d4a33702f576ac35e996438828c53969a0c5,2,52,3,49,0,0,0,2,18,60,2,2,0.988283611,1253,208,6,171,160,11,7697,7527,170,70,68,2,100
1e023d5f5a957a77d2dab5d6c9b205cc6f15992a,3,18,6,12,0,0,0,2,14,323,1,2,0.94056624,420,209,7,87,83,4,3279,3197,82,27,26,1,100
76a13f520af1a481ed8e460eb6f14f2835561f99,3,35,45,10,0,0,0,2,21,142,2,2,1.044360232,2840,210,8,358,355,3,21096,21255,159,116,114,2,100
49c43695ac987ff89fd445f4e5dcebe38f10d27d,4,99,27,72,0,0,0,2,15,167,2,3,1.850063684,1329,211,9,250,240,10,9950,9511,439,160,158,2,100
618327cf383db6afa565b6757aca51ce663c50d6,2,21,0,21,0,0,0,2,53,99,1,2,0.453716339,1334,212,10,246,246,0,11508,11306,202,29,29,0,100
29864f7ab4145ff429ebb0d9ec9b964d1e40a542,5,173,25,148,0,0,0,2,20,570,2,3,1.693808952,1516,213,10,204,182,22,9228,8583,645,123,111,12,100
35bd23471a0651eebc0360eba8264fc8b6daa2de,2,28,5,23,0,0,0,3,8,880,2,1,0.884963636,219,1024,2,36,35,1,1680,1540,140,13,12,1,100
a27f7b4b2acfd975177e4ba282a37d9bb6268e98,2,31,9,22,0,0,0,5,8,1565,2,2,0.543564443,334,1025,3,33,29,4,2938,2828,110,21,21,0,100
9093561cced81b481a983d601dd8b47b7238059c,4,42,4,38,0,0,0,6,34,216,2,4,0.765363613,713,214,7,103,97,6,5871,5614,257,30,26,4,100
b9a7c538b4402815823f88c48a56912574da99ba,1,15,1,14,0,0,0,2,3,2672,1,1,0,138,1026,2,32,29,3,1056,970,86,6,6,0,100
acbc0a233d06a3720d4d2bedef524e4d229eaa5a,0,0,0,0,0,0,0,0,0,0,0,0,0,0,1027,3,0,0,0,0,0,0,0,0,0,100
0234b33f04f4d75596fed740926507a89056b8b6,1,7,1,6,0,0,0,3,10,756,1,1,0,536,1028,4,73,72,1,3159,3121,38,33,33,0,100
9b75072a6b08442b623e5f3e4e219a56db01e8e0,0,0,0,0,0,0,0,0,0,0,0,0,0,0,1029,3,0,0,0,0,0,0,0,0,0,100
173722fbd64c9509e4590c35146373b983c22010,1,18,0,18,0,0,0,20,70,1433,1,1,0,1126,15,0,96,95,1,8438,8354,84,70,69,1,100
8f66bae10f9e75bb30b242b513624145c399a7e6,2,20,3,17,0,0,0,2,4,957,2,2,0.932111568,512,1030,4,33,32,1,3716,3571,145,22,21,1,100
9ffc5e489721aca48f62379e88b98674096f1fd8,3,126,20,106,0,0,0,19,91,3967,3,3,1.051831,2631,16,1,271,257,14,28162,27102,1060,91,89,2,100
b91691ef1d20e616fd9c37d4018eb0db78db8898,3,57,35,22,0,0,0,19,92,3,3,3,1.573771614,2719,17,2,270,271,1,28082,28162,80,90,91,1,99.9592585
fef4ab47834685f12667cea68f6e2f83b5baf188,3,23,2,21,0,0,0,22,98,153,2,2,1.541315277,3807,18,3,491,490,1,36717,36634,83,192,191,1,100
131095aa77ec327686022f6ebcafcc0888a0995b,1,4,0,4,0,0,0,22,105,903,1,1,0,305,1031,0,54,54,0,2226,2206,20,19,19,0,100
9a704c453d6cee19d57f7b4fd4b255ec0afbd8b8,1,102,0,102,1,0,1,1,1,0,1,1,0,0,1032,1,9,0,9,277,0,277,1,0,1,99.95927095
b50a67b24062be13e57d61591a0a2f78973425d8,1,4,2,2,0,0,0,11,23,206,1,1,0,251,1033,2,60,59,1,1412,1404,8,40,40,0,100
5ce29d70d8366e2ff6ed0a88e6d6e95048e48867,1,33,0,33,0,0,0,20,71,60,1,1,0,1141,19,1,97,96,1,8490,8438,52,71,70,1,100
5a25b12defab4d484a12ad15182a007e388a4f41,5,71,3,68,0,0,0,10,57,263,2,5,2.061127313,2867,215,0,469,457,12,24029,23577,452,129,127,2,99.98982085
30a7ad6a3bbf429d86c22c13ed5a4949957f8f31,4,129,26,103,0,0,0,2,21,145,2,3,1.686120812,1943,216,1,335,320,15,12946,12380,566,108,107,1,100
1b81c7f5f1219bb88ad8130d84ebc3dbbb1d2b37,1,36,31,5,0,0,0,17,76,388,1,1,0,631,217,2,124,124,0,3922,3906,16,68,68,0,100
b39cb3d2ed1270616c9fb5c7eb31b68f1bba7810,6,153,63,90,0,0,0,7,44,315,1,5,1.574786853,1889,218,3,320,311,9,13384,13017,367,80,77,3,100
57efd153633729600121eb979eb913f023e83424,2,13,7,6,0,0,0,7,45,0,1,2,0.992774454,410,219,4,47,47,0,2525,2508,17,12,12,0,100
ec4ebb67d8d23c7777e215e7b6bd1356e9f61979,1,2,0,2,0,0,0,22,157,483,1,1,0,1463,295,0,305,305,0,11202,11176,26,66,66,0,100
5e540f17e8ca4da6534cc2825d89dfb62fa2b8ce,0,0,0,0,0,0,0,0,0,0,0,0,0,0,296,1,0,0,0,0,0,0,0,0,0,100
7e60a8491f3ade984dec54b7e1c14cd6acbbe14a,11,660,460,200,0,0,0,9,66,1997,3,4,2.494606896,5975,220,5,490,497,7,49647,47492,2155,294,291,3,100
adbc27cd985b4c06d50d38dd24732a777c83c015,0,0,0,0,0,0,0,0,0,0,0,0,0,0,1034,0,0,0,0,0,0,0,0,0,0,100
50fc8423c34919333576576c80a22c100f73f6b6,8,78,13,65,0,0,0,1,7,615,1,2,2.83194265,1132,221,0,222,216,6,8740,8399,341,86,86,0,100
12723bbc3932debf86d3f23a69905acdab51d2d0,4,87,19,68,0,0,0,14,40,638,1,2,1.353919153,1088,222,1,220,208,12,7900,7478,422,83,77,6,96.80564896
197e6c13bed1f49fb9aa87a1a646a33f729c6b7b,1,21,38,17,0,0,0,13,30,271,1,1,0,460,20,0,104,104,0,2682,2644,38,43,43,0,100
0473e89c701f3673d025d226524e308b567c3b2c,2,22,3,19,0,0,0,20,72,200,2,2,0.529360865,1586,223,2,177,174,3,12156,12093,63,85,85,0,100
c4f1f41b45bfc5715f8b04efa6bfcd10f371d003,1,1,5,4,0,0,0,4,16,276,1,1,0,234,224,3,33,35,2,2030,2068,38,11,11,0,100
ceef3a08f454984203966bf858908feba48ec381,5,60,9,51,0,0,0,3,16,337,2,4,1.749597387,1363,225,4,270,266,4,10323,9952,371,157,154,3,99.93764809
e0e741fc57bda86d098e3e6a7a69003d55f932e9,1,2,2,0,0,0,0,6,8,4241,1,1,0,141,1035,1,26,26,0,853,853,0,4,4,0,100
2fc69135a3b3119c936721a6230c3d1010dff437,16,176,155,21,0,0,0,14,158,863,1,11,3.392560974,5745,226,5,1029,1030,1,43637,43667,30,248,247,1,99.93764809
7e99d6ca387f7cd50fcf89e2c0dd229f5174918e,1,1,1,0,0,0,0,2,11,776,1,1,0,655,227,6,135,135,0,4880,4870,10,40,40,0,100
49eb252a8e8f2aedc980f0547ad7ec6d4eecf114,1,1,1,0,0,0,0,1,2,783,1,1,0,117,1036,2,1,1,0,445,445,0,1,1,0,100
ba703fb74bb4e8ef0f159c3f77f9f4941f9647fb,1,8,9,1,0,0,0,7,22,96,1,1,0,291,228,7,46,46,0,1781,1793,12,11,11,0,100
3099f200d014c068b6af8c9012fadfede82387d8,1,2,2,0,0,0,0,6,8,6213,1,1,0,82,229,8,12,12,0,598,596,2,3,3,0,100
142203333568442dd4df5a621a8ce1e7ad63a144,1,1,1,0,0,0,0,5,6,2079,1,1,0,289,230,8,63,63,0,2426,2423,3,17,17,0,100
233f70e03db00c5cbf0635a257675f0195786975,1,54,19,35,0,0,0,3,4,2088,1,1,0,48,231,8,7,6,1,235,184,51,6,5,1,100
932de0ee786d1d88f9e105dc8458cfdb27ee80a4,0,0,0,0,0,0,0,0,0,0,0,0,0,0,232,6,0,0,0,0,0,0,0,0,0,100
03aaa0d7a621a6e291fc2ba9ac827ce2db220dfc,2,14,2,12,0,0,0,22,99,148,2,2,0.69621226,1176,21,0,229,227,2,9031,8961,70,107,107,0,99.98753117
485d4fb27750fdde69a68a86f776d1faf567af8f,1,0,2,2,0,0,0,1,2,518,1,1,0,155,1037,0,29,29,0,1191,1200,9,5,5,0,100
93f072b02bef19b6a1deb9b55b1301cefdaefc39,2,105,99,6,0,0,0,3,22,659,1,1,0.26086291,1145,1038,1,82,82,0,6092,6034,58,77,77,0,100
6f7897a9e6637f0651e8c10da3b22017a12b8739,1,32,0,32,0,0,0,4,7,1327,1,1,0,115,22,0,10,8,2,1223,988,235,7,6,1,100
3b59d015624b29c72fd841102b6ec42a55c09a23,2,30,1,29,0,0,0,7,31,2296,2,2,0.554778163,2375,23,1,246,245,1,10193,10103,90,148,147,1,100
f96a424dd0886951fc091c793fdef30fd9e0e261,1,29,24,5,0,0,0,19,94,191,1,1,0,2642,24,2,264,264,0,27837,27756,81,85,85,0,100
c7006ffa7ea3c278528de36b787efe8cf24d60a8,2,132,8,124,0,0,0,7,32,0,2,2,0.397125419,2401,25,3,250,246,4,10448,10193,255,153,148,5,100
a914f378fb899d5f3f7c95c8da2b545c485748ca,0,0,0,0,0,0,0,0,0,0,0,0,0,0,233,0,0,0,0,0,0,0,0,0,0,100
e40ae1e9abbc409fa157acf502fc6df038798190,4,133,105,28,0,0,0,4,26,836,2,3,1.968141772,1662,234,1,275,264,11,11916,11609,307,82,83,1,100
405059342567777b28a744d7242fd0a6917de908,1,76,0,76,0,0,0,9,16,1681,1,1,0,152,26,4,13,10,3,1383,934,449,9,6,3,99.98753117
9c0e462fae65fd5b4052086f07f519bd676fdcda,1,117,572,455,0,0,0,8,17,1434,1,1,0,1205,27,5,51,188,137,5094,8622,3528,40,37,3,100
de8a6169bbed7a2a7c5249dfc4ea372fd2f40c1f,3,66,10,56,0,0,0,13,43,1583,2,2,1.253914846,1703,235,2,303,301,2,11851,11332,519,119,117,2,100
ffb0845900369822124a5084dd90d2f4c8180b94,1,7,0,7,0,0,0,2,15,95,1,1,0,308,236,3,47,46,1,2710,2641,69,10,10,0,100
5eeafaca21a27f632b0bbe6835e79d0ef4fd3dea,6,48,26,22,0,0,0,2,56,1398,1,4,2.030756078,3268,237,4,535,529,6,28093,27896,197,96,93,3,99.96258885
77d014014fb078bd6a35a2672d7ee4267f0a4a08,6,164,44,120,0,0,0,2,46,1066,3,4,1.895950082,2057,238,5,274,263,11,12493,12223,270,113,105,8,100
5c797150b232fb1ece7117630831ba0a8f9e558c,1,5,3,2,0,0,0,9,18,307,1,1,0,325,1039,2,61,59,2,2262,2240,22,25,25,0,100
48496ea362395e2ac9ef0db915ad54a24b14fffd,0,0,0,0,0,0,0,0,0,0,0,0,0,0,1040,3,0,0,0,0,0,0,0,0,0,100
82e5d9b5b091034ef8cca9f9a0b3910cf9858475,0,0,0,0,0,0,0,0,0,0,0,0,0,0,1041,4,0,0,0,0,0,0,0,0,0,100
814ec89e0d9ec964a0aa12c3ece2c431a0f91b47,0,0,0,0,0,0,0,0,0,0,0,0,0,0,1042,5,0,0,0,0,0,0,0,0,0,100
b5e692c65b6a6d4b787a943684db23d4f4153f02,0,0,0,0,0,0,0,0,0,0,0,0,0,0,239,6,0,0,0,0,0,0,0,0,0,100
05bfc043e401be23db332248090bd2e8a2ff2bc0,4,135,3,132,1,0,1,1,24,381,2,3,1.433722051,1433,240,7,195,185,10,8828,8269,559,86,80,6,99.96259352
fcf5c3b00126802f519405a12da85c256211f3eb,3,112,82,30,0,0,0,4,11,1193,2,2,0.316844746,568,241,8,123,113,10,4749,4532,217,27,25,2,100
16fc82f6428035584c7be60e789a8e2d9fd43c62,1,15,4,11,0,0,0,26,191,620,1,1,0,1136,242,9,255,253,2,8092,8052,40,101,101,0,100
592e606a4dfb22d3701e7f1af71a2bb892ed2168,1,1,1,0,0,0,0,15,67,170,1,1,0,451,28,6,96,96,0,3114,3114,0,35,35,0,100
f1a8ac6c8f82710f6e69b04509d1e9bac69159e5,3,15,15,0,0,0,0,2,17,114,2,3,0.69984284,691,1043,6,91,90,1,5312,5304,8,35,35,0,100
0b53b0bc534772bf2829ad12adfc2d8691724cdf,6,248,0,248,2,0,2,5,192,43,2,5,2.069643589,1409,1044,7,301,275,26,11161,9913,1248,119,109,10,91.96338877
b38e44ae4ed39cf83f60b8114548e595867541e0,1,1,1,0,0,0,0,13,27,1598,1,1,0,286,1045,8,40,40,0,2089,2089,0,20,20,0,100
9f34f48a8d0ad3b49ce94295b351b9bd7746a77a,1,9,0,9,0,0,0,3,4,1774,1,1,0,349,1046,7,8,8,0,3097,3016,81,2,2,0,100
ae778cfa770eb6050dece5586f01fa38e552b191,2,31,1,30,0,0,0,2,57,32,2,2,0.448864489,1341,1047,6,231,228,3,11504,11277,227,33,32,1,100
c26e507325ff1bfb829eced0fe3339f5a99c76e1,3,92,3,89,0,0,0,9,25,751,2,3,1.09657508,4608,1048,7,776,759,17,34471,33954,517,265,257,8,100
fc0b5399afbbc7ebd00210bcd37f7a59a8e29a6c,2,14,6,8,0,0,0,6,193,1108,1,2,0.881290899,1393,243,4,307,302,5,9868,9802,66,116,116,0,94.05208228
8b4ac9a1e0e31548a74b0c451f18cce5be85fede,1,9,9,0,0,0,0,2,4,4026,1,1,0,229,244,5,57,57,0,1599,1599,0,18,18,0,100
6b87f95b02b06b1d7e3cd620f599ec9343ef3e61,4,9,9,0,0,0,0,1,48,491,2,3,1.891061112,439,1049,8,43,43,0,2547,2547,0,26,26,0,100
0591d3ac5004c17e851f5b26b096bc2f55a98aed,5,66,66,0,0,0,0,12,106,1698,2,5,1.353669631,1262,245,6,202,211,9,8540,8599,59,82,82,0,100
434af05d867006ec7767ece349e80d2b1842cfe1,1,4,2,2,0,0,0,19,122,599,1,1,0,886,1050,7,143,143,0,6448,6420,28,25,25,0,100
10ad70b82958d03544aefad95091e03e47802f2d,9,99,22,77,0,0,0,14,123,533,2,8,2.783844424,3238,246,3,529,521,8,22550,22164,386,136,132,4,100
27ea6517d5958390d21138db8cdc5c2794552681,0,0,0,0,0,0,0,0,0,0,0,0,0,0,1051,5,0,0,0,0,0,0,0,0,0,100
81606ec76063eb429d2690b8738d7a72959787c9,1,2,1,1,0,0,0,8,24,1661,1,1,0,221,247,4,16,16,0,1651,1638,13,13,13,0,100
bed7add37bc748af28975474ba15877abe991144,5,422,9,413,1,0,1,3,26,1298,2,3,1.575018618,1428,29,0,422,373,49,12577,9795,2782,105,91,14,92.77943583
4697f2f3a74bf162ff3de757186b0af924217600,2,88,40,48,0,0,0,8,18,903,2,2,0.982316608,1057,30,1,109,104,5,7243,6867,376,55,53,2,100
f5de361531667ff23a2b9ec402244000adde780f,2,159,15,144,0,0,0,3,4,2296,1,2,0.957553484,2190,1052,0,336,313,23,18700,17604,1096,112,108,4,99.97255763
8e75a65ba61beb17885f1553958a4a5a82e761ea,8,187,37,150,0,0,0,2,58,258,2,4,2.103641978,2251,248,1,381,360,21,18375,17663,712,97,82,15,100
7f1a87e24edf9ef891bbdea1afc44c89a0791b0a,2,84,36,48,0,0,0,3,5,3438,1,1,0.384311544,191,249,2,30,24,6,1332,1146,186,15,14,1,100
b3b7f401dea2ebd7659e532966a28c3f4918e99a,2,59,9,50,0,0,0,1,2,716,2,2,0.984343203,180,1053,0,32,29,3,1585,1198,387,16,12,4,100
6c7c3c9af3be709c4a453bd51a6675ddb291fa35,2,79,36,43,0,0,0,2,5,1644,1,2,0.975810492,341,1054,1,33,32,1,2651,2359,292,13,12,1,100
6f3af8f90239e8cc5b825862bea50d8a5da8ae3e,0,0,0,0,0,0,0,0,0,0,0,0,0,0,1055,2,0,0,0,0,0,0,0,0,0,100
92c7f3c3fdd496c377647c3f36b299004e7f25d0,0,0,0,0,0,0,0,0,0,0,0,0,0,0,1056,3,0,0,0,0,0,0,0,0,0,100
18c6012b084440f21f60b053f3acf7c8954162ad,4,104,6,98,0,0,0,22,124,823,2,3,1.29218128,3354,1057,4,563,554,9,26320,25746,574,225,217,8,100
87717268a1707553e00f07262eb62774e980d23a,2,28,6,22,0,0,0,3,6,2140,2,2,0.959686894,928,1058,5,132,129,3,6115,6005,110,62,61,1,90.97759884
1ad1ecdf23a6ea2bea33f5fd4e5b1f9a46c094f8,2,9,1,8,0,0,0,4,50,74,1,2,1,437,1059,6,48,47,1,2737,2705,32,15,15,0,100
6dc4f57f4b8592c1804df08891036ce1515b1f9a,2,73,16,57,0,0,0,12,54,738,2,2,0.264517368,2160,1060,7,328,320,8,18396,18021,375,97,95,2,100
4235b6e2cdc2b263d1e36d1f581905a84818e6bc,3,145,8,137,1,0,1,1,7,6,2,2,1.003384558,942,1061,8,144,132,12,6883,6115,768,68,62,6,97.81446728
c62913c12c0f58cff87eb72f67b108df9cab1e4c,1,2,2,0,0,0,0,21,120,142,1,1,0,636,250,0,109,108,1,4702,4690,12,13,13,0,100
04eb704e2581fd52998a4d6b13bd8e9706a51470,2,142,1,141,1,0,1,1,2,4111,1,2,0.920609219,142,1062,9,31,20,11,1501,619,882,17,9,8,99.95237528
0f69a42dd01bc249428015f960ac9ab454055a90,2,16,4,12,0,0,0,2,8,586,1,1,0.992774454,333,251,1,73,73,0,1945,1925,20,23,23,0,100
0d165f2b97cc91455730d2f6cfd2c0172dbf755c,3,37,3,34,0,0,0,7,43,968,2,2,1.263168141,1098,252,2,235,232,3,7327,7033,294,67,64,3,100
1a8f3402285d79e705c50d1ffbe10d65deb4a0e2,1,1,1,0,0,0,0,4,34,315,1,1,0,441,253,3,80,80,0,3684,3684,0,14,14,0,100
0b1c6c96bbc01e0cf2b6873a37a517b3c56638e3,1,4,4,0,0,0,0,2,9,1818,1,1,0,357,1063,1,41,41,0,3215,3219,4,16,16,0,100
011a502e3878d8e06a4c7693a5ae902c354dcb4f,0,0,0,0,0,0,0,0,0,0,0,0,0,0,1064,2,0,0,0,0,0,0,0,0,0,100
aab1833e5f0021af657c0147c241dcd46e4025a5,0,0,0,0,0,0,0,0,0,0,0,0,0,0,1065,2,0,0,0,0,0,0,0,0,0,100
4eeb0a72c7a195ee7aa4bc59c403694ad29ba639,4,128,27,101,0,0,0,3,92,577,2,3,1.514108754,4226,31,0,880,854,26,27131,26310,821,233,228,5,100
8715957748e20e18ccec6d9c6a345219ebf4e3db,0,0,0,0,0,0,0,0,0,0,0,0,0,0,1066,0,0,0,0,0,0,0,0,0,0,100
4057a6ed9ce0c3782f1f6cce33ab2a91dde8122f,1,12,1,11,0,0,0,3,4,2217,1,1,0,159,1067,1,36,35,1,985,962,23,11,11,0,100
845edbee63a29dc49f274c397bac676f9a448af2,2,47,2,45,0,0,0,6,11,3606,2,2,0.931304369,417,1068,2,50,47,3,3346,2967,379,17,16,1,100
b5565f5b9573824a4b21628d82d5f50784462545,1,2,1,1,0,0,0,6,11,5930,1,1,0,120,32,0,22,22,0,725,723,2,8,8,0,100
4f8410bccc1013adb9e7cd1b74bcb5c66a6eaea3,0,0,0,0,0,0,0,0,0,0,0,0,0,0,33,1,0,0,0,0,0,0,0,0,0,100
45bb0d6605844c57661f849d774b96f6b75386b2,0,0,0,0,0,0,0,0,0,0,0,0,0,0,34,2,0,0,0,0,0,0,0,0,0,100
00aa97e46330b0242ae8dde0756a7e07a5b653a4,2,48,0,48,0,0,0,1,10,3130,2,2,0.69621226,682,35,3,148,144,4,5223,4894,329,45,42,3,100
b230c798e9ee1e366769631df59a06189cec6cfd,1,0,9,9,0,0,0,6,13,2072,1,1,0,73,254,0,12,14,2,333,408,75,6,6,0,100
8f3c75696d5ce6fa2c3ae412e60dc23b67a24096,0,0,0,0,0,0,0,0,0,0,0,0,0,0,36,4,0,0,0,0,0,0,0,0,0,100
f61aad305e48b006edbb2af061f35d0f07d8c757,2,14,0,14,0,0,0,3,25,349,2,2,0.371232327,2814,37,5,347,346,1,20655,20613,42,116,115,1,100
deb4a30b610806bb1b99bccd454811e77eafab90,4,180,120,60,0,0,0,9,14,1285,2,3,1.107161175,1413,255,1,249,246,3,11346,10968,378,86,85,1,99.95239795
7c78790c207ecdf648e8aeca00979538775627ae,1,1,1,0,0,0,0,4,35,197,1,1,0,441,256,0,80,80,0,3687,3684,3,14,14,0,100
933eefb11c8d69bc6b026492e679b397173b2455,7,66,64,2,0,0,0,9,40,1205,2,6,1.760192016,6655,38,0,1221,1221,0,48766,48579,187,302,302,0,100
283788da78847b6fdd2205543c23b8de35819129,3,67,32,35,0,0,0,7,12,2321,2,2,1.246469703,769,39,1,110,104,6,5208,4935,273,35,34,1,100
be808a00bbb7964c1c210c118d615f7bd50ac98e,2,251,361,110,0,0,0,16,93,168,2,2,0.120364434,2057,1069,0,241,266,25,10598,11092,494,174,173,1,100
d4ad2c258691e694e124a4d115e9aa7501103e36,2,15,5,10,0,0,0,26,194,310,1,1,0.721928095,1309,1070,1,264,264,0,9203,9187,16,102,102,0,100
3691e24a493f953ba49a97429fcb54c4e9c94eec,0,0,0,0,0,0,0,0,0,0,0,0,0,0,1071,2,0,0,0,0,0,0,0,0,0,100
a1d0941dba9e53e9814ffeee1c486fd9f351f7d7,1,1,1,0,0,0,0,9,27,20,1,1,0,2979,40,2,254,254,0,22253,22253,0,176,176,0,100
a509441c41f411792dbd175bcdafa96f9860cfec,0,0,0,0,0,0,0,0,0,0,0,0,0,0,257,1,0,0,0,0,0,0,0,0,0,100
889a53a33498bfec69fdcb429a19f9fd3f0f6bef,7,67,41,26,0,0,0,5,25,2058,2,5,2.364760275,862,258,1,131,131,0,6948,6597,351,34,34,0,100
7e7bdaaa4551ce430f59f74f75e0411d28f821c6,5,83,12,71,1,0,1,1,18,370,2,5,1.530612458,925,259,2,185,178,7,7784,7544,240,47,46,1,99.94051868
51c7500a25f7eb5703b227b9d309e72ec4f2c448,0,0,0,0,0,0,0,0,0,0,0,0,0,0,1072,0,0,0,0,0,0,0,0,0,0,100
29ff7cef02ed0ed314327a16faa7d78871a3e463,2,2,2,0,0,0,0,5,10,1050,1,2,1,924,1073,1,122,121,1,5693,5683,10,39,39,0,100
082a9c0829d1f5df128e4fd7d5c13a9e24f89fbc,5,29,4,25,0,0,0,2,36,2360,1,3,2.240328856,1172,1,0,255,251,4,7399,7338,61,139,135,4,100
c58c28a623b6351abb53dc908cca9228ac8a4150,2,18,2,16,0,0,0,8,55,2434,2,1,1,1987,1074,2,398,396,2,14257,14225,32,187,185,2,100
5b7cd9858717e46e818e9ed525a185f9d89966e9,3,63,1,62,1,0,1,1,108,772,2,3,1.049886625,386,1075,3,64,61,3,2982,2722,260,28,26,2,99.94055404
8cb400ed376191516999f0c711eebd3ad502f226,0,0,0,0,0,0,0,0,0,0,0,0,0,0,1076,4,0,0,0,0,0,0,0,0,0,100
02fc6371df7f83293caa4b92ba2460e72f7b9afc,3,52,3,49,0,0,0,3,26,284,2,3,1.095795255,1466,260,0,190,187,3,8941,8735,206,89,88,1,100
816211ee3713acee89386f3d650b31e20f773a6e,0,0,0,0,0,0,0,0,0,0,0,0,0,0,1077,5,0,0,0,0,0,0,0,0,0,100
8de345c944a64e80130224fba02506ce061c214a,0,0,0,0,0,0,0,0,0,0,0,0,0,0,1078,6,0,0,0,0,0,0,0,0,0,100
9efbdf48af42919f240f2158cd2c69409e7f621c,6,0,258,258,0,0,0,1,2,1740,1,1,2.584962501,108,1079,5,0,18,18,0,598,598,0,12,12,99.8215348
8a0f9b285281766e0e76d355dbf6a336a3673ac6,3,75,3,72,1,0,1,3,56,796,2,2,1.118170145,1543,1080,6,322,315,7,12446,12159,287,111,105,6,99.95237528
4b035218005fe10fbc9e901f638d5305e6c0e091,3,120,2,118,1,0,1,1,44,687,2,3,0.286577012,704,1081,7,187,182,5,4962,4237,725,56,51,5,99.97620181
13fceed41e28c005f4b2df3e6341e628fcf548cf,0,0,0,0,0,0,0,0,0,0,0,0,0,0,1082,8,0,0,0,0,0,0,0,0,0,100
c6666c9df11aab3367e25cf3b93be4b3a939d64b,2,29,1,28,0,0,0,6,10,4395,2,2,0.353359335,493,41,0,52,46,6,2954,2807,147,20,19,1,100
afa9c97140e14031b0117179ce28411888a8e238,1,2,0,2,0,0,0,2,3,1809,1,1,0,117,1083,7,23,22,1,790,772,18,5,5,0,100
92f435b6dcaa9da255f638b78b0d553d6ca0676d,1,7,2,5,0,0,0,11,54,367,1,1,0,1065,42,1,101,100,1,9128,9073,55,52,52,0,100
cf1b1afc3a6c20f035f2d58d1f6b48f7caa4e90f,0,0,0,0,0,0,0,0,0,0,0,0,0,0,43,2,0,0,0,0,0,0,0,0,0,100
6fa771968ff700439e39b3d13bec9769f594766f,0,0,0,0,0,0,0,0,0,0,0,0,0,0,44,3,0,0,0,0,0,0,0,0,0,100
73ca9f6e972cba9efcb85b4240844593643858ea,0,0,0,0,0,0,0,0,0,0,0,0,0,0,45,4,0,0,0,0,0,0,0,0,0,100
c38ea926a48e1f5d5a9635a03e619dbaca957317,1,5,1,4,0,0,0,7,20,2260,1,1,0,227,1084,5,11,10,1,1618,1587,31,9,9,0,100
dee57f0b855bfab24599a53838769945af44c1cc,0,0,0,0,0,0,0,0,0,0,0,0,0,0,46,5,0,0,0,0,0,0,0,0,0,100
5446a38c1391117b5676022b574aa7f1e18e0dd4,1,24,22,2,0,0,0,13,28,546,1,1,0,286,261,0,40,40,0,2191,2089,102,20,20,0,100
304544b8d2ecc9aaa70ea092d39e754aa89bed44,2,132,44,88,0,0,0,2,9,1771,1,2,0.88946639,341,1085,1,55,41,14,2995,2422,573,19,16,3,100
e586bac473c092d4319380e67147d3ccd8d8260b,0,0,0,0,0,0,0,0,0,0,0,0,0,0,47,4,0,0,0,0,0,0,0,0,0,100
a7b3e60ff7c336bd3fe7e666ac433a4586db0965,4,35,49,14,0,0,0,6,22,1779,2,2,1.111501767,2569,48,5,439,439,0,17865,17712,153,106,106,0,100
dc0fa7b44b8ac83d8df4a0dac9f48eab76851148,3,139,56,83,0,0,0,4,10,2826,3,3,1.316365111,494,262,1,60,47,13,4744,3976,768,34,27,7,96.71585488
b95002b9ab7e3a545036dff89a05c2e66a74050c,0,0,0,0,0,0,0,0,0,0,0,0,0,0,49,2,0,0,0,0,0,0,0,0,0,100
c299bb26598cb283bcf49506ce32c9c911894e71,1,5,4,1,0,0,0,1,2,87,1,1,0,92,1086,1,5,5,0,719,719,0,5,5,0,100
6a2697b6dad34b1545ecef536dbb6825d30852b9,0,0,0,0,0,0,0,0,0,0,0,0,0,0,50,3,0,0,0,0,0,0,0,0,0,100
5b34cca306a83627e4843d73cd5995c2c98b8e35,2,2,2,0,0,0,0,3,128,649,1,2,1,3969,263,0,637,635,2,33505,33481,24,108,108,0,100
6c6d53ccdaa7581d5c15437143a376988db1fa2d,51,346,1565,1219,1,0,1,22,159,1946,4,26,4.491930274,19326,264,0,3052,3230,178,136961,144708,7747,984,1041,57,94.87303741
ffb854f4555d7774c3c6dd72a4d892bc99f45586,0,0,0,0,0,0,0,0,0,0,0,0,0,0,265,1,0,0,0,0,0,0,0,0,0,100
6e315f1b15fc6e2ebf89c49bbcd01ebb339973c7,0,0,0,0,0,0,0,0,0,0,0,0,0,0,266,2,0,0,0,0,0,0,0,0,0,100
01fe8d9f33a9b5fcb6c923d69cf61838df868044,4,295,22,273,0,0,0,22,102,627,2,3,1.312224391,3326,51,0,572,546,26,24261,22866,1395,229,220,9,99.99092229
f02a7ac948e07778b293c2b231c97d13f2ca9761,3,130,29,101,0,0,0,3,60,449,2,3,1.275656762,1573,267,3,262,257,5,14249,13460,789,48,46,2,97.42277809
4728fb7abd0a14c7e8ffa4d4de7214246d45f5a7,1,2,7,5,0,0,0,1,2,259,1,1,0,34,268,4,6,7,1,219,252,33,1,1,0,100
6504bc6e1dca856c779ddb5ccd19fd65b2d25b36,0,0,0,0,0,0,0,0,0,0,0,0,0,0,269,5,0,0,0,0,0,0,0,0,0,100
e79b54c25f9dcad3936d68d4d1095a8a92940635,0,0,0,0,0,0,0,0,0,0,0,0,0,0,52,1,0,0,0,0,0,0,0,0,0,100
ea60cac15576cba7e984169ccd3bec86e0b25614,1,7,2,5,0,0,0,1,2,20,1,1,0,147,270,6,21,21,0,1316,1242,74,6,6,0,100
3ce69a7205347a88c4d4692d90b6f025728f30ac,3,105,3,102,0,0,0,3,61,176,2,3,1.201985119,2550,271,7,411,397,14,18154,17694,460,103,101,2,100
ed3c127203643db8cd016ae7021399221204ca44,1,1,1,0,0,0,0,4,15,793,1,1,0,125,1087,0,18,18,0,842,842,0,8,8,0,100
f087336679b7afe0f1764ff77e680ecd7c3b92ff,5,145,37,108,0,0,0,6,8,2392,1,4,0.876402813,779,272,8,157,139,18,5166,4606,560,62,54,8,100
27cdd8d05c1790c10f332403e2c2b47562cfaee5,6,187,145,42,0,0,0,8,41,3634,2,2,1.682678567,2199,273,9,395,394,1,15817,15436,381,116,115,1,100
6b11db216e6dbdebfa03912b02c726281de5fec2,2,0,655,655,0,0,0,2,5,4862,1,2,0.504275307,565,1088,1,0,91,91,0,4281,4281,0,28,28,99.95043616
e9ff9c27c10c61362e8460b35af4b88b21ef8f15,8,226,23,203,0,0,0,9,48,1308,2,4,1.678185438,6858,53,2,1190,1169,21,52370,51137,1233,330,320,10,99.97024695
94d2fa0e67ce4a5d0418556c46e4878fa001aec1,2,18,3,15,0,0,0,4,16,1876,2,2,0.958711883,1258,1089,2,181,180,1,8477,8387,90,74,73,1,100
cdb3914d59cb900a2b65b5c7571434e530de5be5,2,153,111,42,0,0,0,3,17,1385,2,2,0.91053306,476,274,10,55,47,8,3791,3708,83,33,26,7,100
80153dd759611b970a53fb5323049631dd6e3451,2,12,2,10,0,0,0,7,12,1728,2,2,0.863120569,481,275,8,74,72,2,3730,3666,64,30,30,0,100
f09de8f3130ef60e85d431c09cfcb50fc23cad79,0,0,0,0,0,0,0,0,0,0,0,0,0,0,1090,3,0,0,0,0,0,0,0,0,0,100
ec4d81a1a183351af188920cf134a85c7d4060af,0,0,0,0,0,0,0,0,0,0,0,0,0,0,276,7,0,0,0,0,0,0,0,0,0,100
22b10c469d6af383607508af5f101f7412e7ce33,0,0,0,0,0,0,0,0,0,0,0,0,0,0,277,8,0,0,0,0,0,0,0,0,0,100
8a39c2700623591a5ce8a5ed7de34b526b9eed78,28,1180,41,1139,3,0,3,3,130,950,2,15,3.487786293,13155,278,9,2439,2302,137,106037,99681,6356,834,782,52,99.49263828
df6577bc2044476859219c81dcee69a940d569c7,5,252,75,177,0,0,0,3,36,501,2,3,1.305179537,3980,279,8,564,541,23,30068,29119,949,174,168,6,100
af080f5560e831e415693be26c07ede38ab41983,0,0,0,0,0,0,0,0,0,0,0,0,0,0,280,8,0,0,0,0,0,0,0,0,0,100
254d35af60bd3cd4ba53e2fbd95f02a1153c90d9,8,157,22,135,1,0,1,20,125,2588,2,4,1.684060252,3860,1091,4,612,594,18,26895,26374,521,202,192,10,99.61007798
1d87797e3aaf5adba947e228ec8c04318019d175,0,0,0,0,0,0,0,0,0,0,0,0,0,0,1092,5,0,0,0,0,0,0,0,0,0,100
7d221038ca9242f43ac2989c939fdc89f0bde5c8,0,0,0,0,0,0,0,0,0,0,0,0,0,0,1093,6,0,0,0,0,0,0,0,0,0,100
0b0cf0a651af6c14d976c0c33cce5f5cd24cb077,0,0,0,0,0,0,0,0,0,0,0,0,0,0,1094,7,0,0,0,0,0,0,0,0,0,100
90cde47d729918734a21969a82e15dd2cf4d41d3,1,1,1,0,0,0,0,11,35,77,1,1,0,224,54,0,37,36,1,1633,1629,4,10,10,0,100
dfb23ac8dd4c267f9fc48daa20e5c33c7bb64e9f,0,0,0,0,0,0,0,0,0,0,0,0,0,0,1095,4,0,0,0,0,0,0,0,0,0,100
543194f6a67648b2b5363b8bdb8cab714d7ec66e,0,0,0,0,0,0,0,0,0,0,0,0,0,0,1096,5,0,0,0,0,0,0,0,0,0,100
f8639ac07b759df0231925b4d14ca16c909f3540,0,0,0,0,0,0,0,0,0,0,0,0,0,0,2,0,0,0,0,0,0,0,0,0,0,100
b81319beae4fc594d6ffba2b49118ec01dbdbc24,0,0,0,0,0,0,0,0,0,0,0,0,0,0,55,1,0,0,0,0,0,0,0,0,0,100
bdd277a966a3f987bf5450b549216ca646430c74,5,134,15,119,0,0,0,8,94,1566,2,3,1.861263047,4501,281,0,576,560,16,33859,32778,1081,320,318,2,100
bfbf32035e9fcdee29cf2ad8d826b78eb3698f7a,6,131,6,125,0,0,0,10,58,2282,2,5,1.445028622,2673,282,1,456,441,15,22801,22097,704,171,163,8,100
c8895e2e4fa4b6d5b927044b4bf96dfcacd08ff9,1,4,0,4,0,0,0,2,2,87,1,1,0,91,283,2,17,17,0,420,396,24,9,9,0,100
b7580799c008e570680217fcf9d0c689a609783b,2,27,4,23,0,0,0,3,30,96,2,2,0.962900415,1475,284,2,148,147,1,7165,7090,75,97,97,0,100
d2343cbe9eb2eca6c9fb3e4f59f864b1b5bdeece,0,0,0,0,0,0,0,0,0,0,0,0,0,0,1097,0,0,0,0,0,0,0,0,0,0,100
5c433f857ea6ce3315f45a97adf2ce00bc2f38b6,0,0,0,0,0,0,0,0,0,0,0,0,0,0,1098,1,0,0,0,0,0,0,0,0,0,100
7fd0b9a2666677bc6072c6be7e7aa86080648ac5,0,0,0,0,0,0,0,0,0,0,0,0,0,0,1099,2,0,0,0,0,0,0,0,0,0,100
7b8d463ebcbbc4d591944ae473e88589ae88181d,0,0,0,0,0,0,0,0,0,0,0,0,0,0,1100,3,0,0,0,0,0,0,0,0,0,100
508f387ac5408415fa6d446269483b7cf37d05e2,1,2,1,1,0,0,0,10,16,1321,1,1,0,193,56,0,47,46,1,1142,1134,8,19,19,0,100
c4b4c2975490818ee80f8f4efc1b480802e35291,3,113,26,87,0,0,0,20,122,295,2,3,1.275507185,2045,285,0,266,253,13,15667,15104,563,104,102,2,100
ee45e1f93d2fb4c641ec8426a6688a2bff278905,1,14,8,6,0,0,0,20,75,4,1,1,0,1234,286,1,106,104,2,9076,9059,17,74,74,0,100
6c81940dcae3e5bfeb846b7f5f8d7ec55649a075,0,0,0,0,0,0,0,0,0,0,0,0,0,0,287,2,0,0,0,0,0,0,0,0,0,100
84eebfef2359bc7adc1608a71cccda961e59a8ac,2,105,1,104,1,0,1,1,46,67,2,2,0.313812964,656,57,1,185,179,6,4789,4164,625,45,42,3,99.97996795
f66031a71a08954b982d03c9b67d2de13eb8c18a,4,40,1,39,0,0,0,8,160,830,2,4,1.470413172,2801,1101,0,446,444,2,23376,23121,255,122,122,0,99.53126558
a10256a5463fc108e2a9e2d964a3797fd697766e,2,131,0,131,1,0,1,19,95,502,2,2,0.733974961,2643,1102,1,277,264,13,28470,27837,633,89,85,4,99.98013903
d93aa521dc14a08230249d514b14ddf6b19eba25,14,867,12,855,3,0,3,6,30,2073,2,7,2.599445235,4329,1103,2,649,564,85,39365,35322,4043,254,210,44,99.94047619
7936afbe260e4249971c006de9bf284138196a8b,1,2,2,0,0,0,0,9,31,2,1,1,0,1126,58,1,119,119,0,10361,10357,4,50,50,0,100
5a1a89e3311bcf4f3cada30c4038a9b3e6261f80,3,59,3,56,0,0,0,6,21,6,2,2,0.834646465,740,1104,3,72,62,10,5530,5232,298,37,36,1,100
8ef3d6c7d3a8ebcd49ed91b71d7845eb912ce5d2,39,53,44,9,0,0,0,4,95,3274,2,9,5.026682338,13376,1105,4,1211,1211,0,97294,97288,6,845,845,0,100
560f904e06aa588348bc104081636638c00cf7ed,7,16,15,1,0,0,0,5,25,1135,3,4,2.416421005,1856,1106,5,208,208,0,14510,14510,0,76,76,0,100
fd36de008625440744ab2402d14d8e38a375d8e7,1,3,3,0,0,0,0,9,33,5,1,1,0,1126,1107,6,119,119,0,10379,10367,12,50,50,0,100
4fab333051a00dcf009e2a6f063fba0dcdec7ef0,2,108,31,77,1,0,1,1,20,130,2,1,0.999962665,289,59,0,66,65,1,2277,1970,307,22,17,5,99.95046072
57f0f941c22002bb4c4acd51d2cf046249844308,1,1,2,1,0,0,0,5,10,2377,1,1,0,480,60,1,26,26,0,2103,2103,0,23,23,0,100
8826eb449305a83c78c6ecdfcfcd00220cd5440a,6,347,192,155,1,0,1,6,161,1577,2,5,1.517468354,2812,0,0,555,552,3,23000,23020,20,112,111,1,99.93068621
1ce8edc0fd9deaf66ccdb7c8253f2d89842666de,2,12,0,12,0,0,0,8,21,2277,2,2,1,841,1108,0,79,78,1,5239,5112,127,46,46,0,100
3c051fa9d8c701745cf2c2fe2b8bfe7bac45f774,2,82,33,49,0,0,0,3,59,1476,2,2,0.426228657,1557,1109,1,323,321,2,12322,12038,284,111,110,1,99.98020586
90fe4db4e3ef56070cd0a00f5bdf1159d9d4e5de,0,0,0,0,0,0,0,0,0,0,0,0,0,0,1,1,0,0,0,0,0,0,0,0,0,100
127ab8466940d1c8cb63ec2f5a1e6435a0237a01,2,18,6,12,0,0,0,10,19,1638,1,1,0.41381685,435,2,2,46,46,0,3164,3066,98,14,14,0,100
9892bd73abf957c4f1d5c409dbbdab6ed3e4d8a7,5,60,5,55,0,0,0,3,27,1211,2,3,1.473758087,1948,61,0,451,445,6,13488,13162,326,126,123,3,100
36d9fde10be4c749db03dec7dc9d727e771ca7ea,2,13,4,9,0,0,0,9,18,3568,2,2,0.997502546,981,62,1,150,148,2,8199,8144,55,48,48,0,100
50e5cda8607e450056a98c31543df997b76cfbfb,2,43,0,43,0,0,0,10,69,842,2,2,0.854180205,1064,63,2,141,137,4,8140,7891,249,64,63,1,100
ac35c2b14bd7da9adeab42728f466888b5383d1c,1,10,1,9,0,0,0,8,21,1421,1,1,0,603,288,0,136,135,1,4302,4237,65,33,32,1,100
f91ab423789552308eb988a8dec6e3d61f9d66d3,1,7,4,3,0,0,0,4,19,405,1,1,0,232,289,1,34,34,0,2088,2066,22,11,11,0,100
9241c5dc0a651d5f56152cf9a9dd27714a53b3f0,0,0,0,0,0,0,0,0,0,0,0,0,0,0,3,3,0,0,0,0,0,0,0,0,0,100
ec1b1471475c533c0496e7dea674bc06851478b1,161,15378,747,14631,88,0,88,1,103,704,2,30,6.333743391,29160,4,4,5586,3926,1660,302028,223048,78980,2467,1713,754,93.67139959
d524ae638e6cba784894fe0840ca755eb3eff821,2,42,16,26,0,0,0,2,2,1174,1,2,0.735508582,921,5,5,154,148,6,7937,7703,234,45,45,0,100
cc76487b01886871a2b2ba26f482fd6253802fa8,2,37,2,35,0,0,0,1,19,0,1,2,0.779349837,500,6,6,102,96,6,3998,3759,239,23,21,2,100
6d397bbe7920087152bc9271c694b5417003fdc8,4,82,20,62,0,0,0,21,195,264,2,4,1.364819862,4252,290,2,736,724,12,29480,29088,392,312,308,4,100
60f3287a686cefcabd534d395807717133e0b05f,0,0,0,0,0,0,0,0,0,0,0,0,0,0,291,3,0,0,0,0,0,0,0,0,0,100
3c5d0afdc5ad316c85a426707f909bd4a8b9d773,0,0,0,0,0,0,0,0,0,0,0,0,0,0,292,4,0,0,0,0,0,0,0,0,0,100
64048a6a5719042f9fe280ef5ee649e69458e8d2,1,2,3,1,0,0,0,11,80,2,1,1,0,1315,7,7,87,87,0,10057,10068,11,61,61,0,100
89230b5f0fec30bb55c4673e29f9207a18c0ea9b,18,556,296,260,2,0,2,1,162,752,2,12,2.649406533,5386,1110,2,1088,1074,14,41311,41110,201,389,383,6,95.57774608
270065640f46982eb4a0ffc80c3999ae2a3bc2c4,4,27,9,18,0,0,0,2,78,111,1,1,1.30155817,1522,293,5,142,141,1,11638,11444,194,88,88,0,99.78122514
b4c555558a737091f64af5015971aac18d09e5f2,2,18,9,9,0,0,0,23,104,6,1,1,0.503258335,1628,294,6,270,268,2,12095,12035,60,129,128,1,100
fccfade3c06fb2c86bd7a05faa923620401083b7,6,13,39,26,0,0,0,9,55,137,1,2,0.856434394,6181,295,7,628,632,4,53559,53788,229,350,351,1,99.99009312
77aa1ca67473629a5b3627a6cd60f2af356a132d,0,0,0,0,0,0,0,0,0,0,0,0,0,0,8,8,0,0,0,0,0,0,0,0,0,100
b045d8e1ca14dbc9bfd8c65bd5945e2a9cb12fd6,0,0,0,0,0,0,0,0,0,0,0,0,0,0,9,9,0,0,0,0,0,0,0,0,0,100
c9459712b05931721599b303624cf937928a2aa9,0,0,0,0,0,0,0,0,0,0,0,0,0,0,296,8,0,0,0,0,0,0,0,0,0,100
1627acb74884a5c6dfbbb8d0b451e110b66207a0,2,50,3,47,0,0,0,4,20,591,1,2,0.803715924,548,297,9,85,81,4,5041,4798,243,21,21,0,100
a14e189a92933bb6a718ccf76fc8f56960c35254,0,0,0,0,0,0,0,0,0,0,0,0,0,0,10,0,0,0,0,0,0,0,0,0,0,100
20039228a783f5defc04b537e8507a892c1bb3c6,0,0,0,0,0,0,0,0,0,0,0,0,0,0,11,1,0,0,0,0,0,0,0,0,0,100
972f912904cd1a6312550e8b98c9f9bd379a84df,2,55,1,54,0,0,0,15,45,2292,2,2,0.811278124,722,64,0,80,74,6,5097,4796,301,39,38,1,100
84e1a53a12ab43fb42e97f212aa77c20b782157c,7,115,97,18,0,0,0,3,22,1401,3,5,2.381110392,2798,298,0,528,529,1,20790,20637,153,147,148,1,100
6dd3ca4deb84edd9edd7765aa1d12f89a31b1283,2,1,6,5,0,0,0,5,123,202,1,2,0.985228136,1119,12,0,208,208,0,8153,8168,15,55,55,0,100
f6c6a009048a1eb7ee65fde11d163fe3272d136b,5,289,54,235,0,0,0,2,2,7991,1,2,2.120226561,275,13,1,80,20,60,3019,1411,1608,29,11,18,99.87155419
d791ae0b37945c1edf6738a9f6e06cb01b88ea32,1,1,1,0,0,0,0,5,9,2927,1,1,0,233,1111,0,34,34,0,1657,1657,0,10,10,0,100
dab664eb12adb45d4af5f44fce36f78065791c17,3,22,12,10,0,0,0,4,10,2074,2,2,1.022420704,954,65,0,123,122,1,6310,6188,122,66,65,1,100
06b1c51e5ef959104b82e6881dbac368ee9beb0d,28,1197,637,560,8,0,8,13,57,100,2,4,4.197629648,4592,0,0,648,603,45,38861,35076,3785,295,265,30,99.55660656
6a1797ff9043f22c7ce08d71777b8904de313264,0,0,0,0,0,0,0,0,0,0,0,0,0,0,14,0,0,0,0,0,0,0,0,0,0,100
2be2932213cdb3f78feece95fe03c6c9b0067b2c,3,8,4,4,0,0,0,2,4,9,1,2,1.28067213,1158,15,1,182,181,1,9732,9712,20,52,52,0,100
c5c5dd2e07278b94bc6737bdc49a5c3db12109cc,7,351,76,275,0,0,0,8,56,3780,2,4,2.269996726,1665,16,2,198,176,22,12887,11777,1110,85,73,12,99.78405968
c61a19563d6107b43ecd2315c4c4fe5dbdf45af5,0,0,0,0,0,0,0,0,0,0,0,0,0,0,1,1,0,0,0,0,0,0,0,0,0,100
ff5bac74b435e265ab0c5b1497c5acf2cdf7ed51,17,42,268,226,0,0,0,7,57,3262,3,7,3.205422619,4310,299,0,390,400,10,29796,30320,524,233,240,7,99.75547731
c90ec4bc29f4eeba052ebf75186e3145bb467018,0,0,0,0,0,0,0,0,0,0,0,0,0,0,17,3,0,0,0,0,0,0,0,0,0,100
c3b9256743511dd62a4ff48bba408fbd0d8cdcb8,2,5,2,3,0,0,0,7,20,22,1,1,0.985228136,1353,300,1,117,117,0,9269,9254,15,60,60,0,100
f32dc7602421ecb2bcddaeedea23fd4be48bf179,1,5,1,4,0,0,0,4,5,36,1,1,0,170,18,4,36,35,1,1013,996,17,10,10,0,100
204f9892c4efc993ae4cffacb3f363730eece96c,1,10,0,10,0,0,0,5,6,27,1,1,0,200,301,2,52,51,1,1107,1083,24,27,26,1,100
9f4c26ab6136797d2dc228aed2ea57181a8f731b,1,5,2,3,0,0,0,2,3,477,1,1,0,93,1112,0,18,17,1,437,420,17,9,9,0,100
874ba5a1835aa93e89b080dd796422cb48710521,1,37,0,37,0,0,0,1,2,215,1,1,0,210,19,2,48,45,3,1242,1061,181,44,43,1,95.3891366
aea4ede7de4e5d7bb98ae4182badb211acbf6b9b,0,0,0,0,0,0,0,0,0,0,0,0,0,0,302,2,0,0,0,0,0,0,0,0,0,100
74b04ef3edea9cfe2736ecdd5a41d0787fb375b3,2,27,0,27,0,0,0,3,4,5956,1,2,0.691289869,423,303,3,101,93,8,3450,3291,159,94,92,2,99.97898277
f38e1f9aacabc7ed6bb5af48b458fe62315008c7,4,92,2,90,1,0,1,1,17,604,1,3,0.749442124,507,20,3,95,83,12,3542,3248,294,35,25,10,94.57446809
44a13795084009c1ce2f171e9b7bc5e8452f8bd0,0,0,0,0,0,0,0,0,0,0,0,0,0,0,21,2,0,0,0,0,0,0,0,0,0,100
3a2d7e4b2066dd648d5a84f6def2ad42b993af97,0,0,0,0,0,0,0,0,0,0,0,0,0,0,304,2,0,0,0,0,0,0,0,0,0,100
37004949133a2a0359bcce21d69588229ff31e58,1,30,39,9,0,0,0,4,9,1335,1,1,0,211,1113,0,35,37,2,1224,1252,28,22,22,0,100
e47419bc0959acf44838ade5c61aca08276cfe2c,1,1,1,0,0,0,0,7,9,5727,1,1,0,100,1114,1,17,17,0,446,444,2,17,17,0,100
57ba81702cdac277b33d8081eaf782c055ddf9ab,1,19,8,11,0,0,0,23,163,300,1,1,0,1460,305,0,305,304,1,11271,11195,76,66,66,0,100
917b77c22f276894e5dbf736d36c5450d257d124,2,13,1,12,0,0,0,4,8,737,2,2,1,973,66,0,142,139,3,6429,6362,67,65,64,1,100
9e08d66fb0058c1a08b8fd82e066f157fb2f6a68,4,52,13,39,0,0,0,3,31,820,2,3,1.950766896,2256,67,1,329,324,5,14335,14202,133,112,111,1,100
9aac5def852f8a21299d6ab96bace2aa9593fdf7,1,4,2,2,0,0,0,3,4,4724,1,1,0,383,22,0,46,46,0,2756,2736,20,21,21,0,100
246af30f8c5e79e55ef5a048c82bb3b907f6ec1a,0,0,0,0,0,0,0,0,0,0,0,0,0,0,68,2,0,0,0,0,0,0,0,0,0,100
d63a85b9d26d6c6379cf7d0ccfe16bc24d618625,1,0,1,1,0,0,0,4,5,3380,1,1,0,98,306,0,17,17,0,571,587,16,6,6,0,100
aba818160437bd3d9d94bf427ba7015637b59eab,2,3,8,5,0,0,0,3,5,1936,2,2,0.994030211,546,307,1,56,57,1,4576,4623,47,29,29,0,100
da257e255e9bb5be8fdc1dcdbef31000fe035184,1,1,1,0,0,0,0,2,14,747,1,1,0,223,308,2,55,55,0,1843,1843,0,13,13,0,100
9441d84d80af3535078d903545febcfb50ab4110,10,573,108,465,3,0,3,3,32,424,2,5,2.988183954,5226,309,3,871,813,58,39101,36464,2637,386,348,38,99.81769437
05e6bc9e1927d290cbed946d1d43e5086f6e59b7,3,45,17,28,0,0,0,3,36,1354,2,3,1.179996005,1204,23,0,186,180,6,10419,10303,116,60,58,2,100
c3c841227b46fc1c0ebcf6a7426f409d2010fffa,0,0,0,0,0,0,0,0,0,0,0,0,0,0,24,0,0,0,0,0,0,0,0,0,0,100
600c19be4b0e0a4e868f55a939a662fc1248ef4a,0,0,0,0,0,0,0,0,0,0,0,0,0,0,310,0,0,0,0,0,0,0,0,0,0,100
73aefad1f41a537d8c9bd109a1bbc1e8a4aa4e26,1,2,0,2,0,0,0,2,6,159,1,1,0,638,25,0,105,105,0,5684,5655,29,25,25,0,100
952c56b3ef986d73bd6df6ae48a688494efd047a,1,2,2,0,0,0,0,2,7,0,1,1,0,640,26,1,105,105,0,5691,5684,7,25,25,0,100
54846b4852852dc609d5be8a1627fb8d62cbc007,1,12,1,11,0,0,0,2,17,527,1,1,0,352,311,1,53,50,3,2976,2936,40,11,10,1,100
586e73155d1d6938cbf68d6a65196b76dfb3de70,2,33,4,29,0,0,0,12,27,1554,2,2,0.571354974,1243,312,1,197,192,5,9028,8797,231,77,76,1,100
d7a9bb53bdd3d852f5f51db8627db087911878db,5,57,3,54,0,0,0,3,196,1342,2,5,1.766896286,3385,313,2,668,664,4,23747,23347,400,264,261,3,99.8932878
50178f43642910000d58f2f7fea105655648d2ab,9,364,56,308,0,0,0,23,105,1789,2,4,1.823879902,4955,69,0,777,759,18,37238,35566,1672,277,270,7,100
41aba5ac2b4ac697c8f02e34bbaedd2ec40edc90,7,40,25,15,0,0,0,23,106,820,1,1,2.280320622,5313,27,0,616,610,6,41637,41483,154,300,299,1,100
dae28a14c5183f38d03bcad801cbe3ab44a65ae3,5,127,14,113,0,0,0,8,42,5786,2,2,1.704531471,1173,70,1,189,164,25,8579,7664,915,94,92,2,99.94667235
73733543bcd34d28f50800dc3a560b4e94cae26f,2,105,51,54,0,0,0,6,18,2310,2,2,0.790318319,893,71,1,87,81,6,5134,4922,212,46,44,2,100
72fe24cf12deecb6c8c3a97a946d3d05ba769db0,2,9,3,6,0,0,0,19,96,2216,2,2,0.811278124,2688,314,0,269,269,0,28310,28258,52,87,87,0,100
9d94a017825003ba6b40ffa29bc5c8c9bb0f06c4,2,64,11,53,0,0,0,2,31,2216,2,2,0.747806158,296,315,1,39,32,7,2516,2117,399,15,13,2,99.96800683
ca4d681a67d423d05f33beade4efa772b86a70d4,1,39,0,39,1,0,1,1,1,0,1,1,0,0,72,2,2,0,2,141,0,141,2,0,2,99.97867804
d35635c27a406ccadc44beff2231eb130ccf1906,1,21,11,10,0,0,0,2,9,1567,1,1,0,169,316,2,39,39,0,1091,988,103,14,14,0,100
a499d84104be45b878f01e56ffb433ec8bf8a4cc,24,44,70,26,0,0,0,3,197,1536,3,14,3.708070327,8839,317,3,1212,1213,1,62464,62715,251,540,540,0,99.95736517
2bc355be24eb524d6beca58ff44027d6013c5cc4,2,44,2,42,0,0,0,11,31,946,2,2,0.978070971,857,28,0,82,79,3,8265,8073,192,55,53,2,100
22a5d18ddf5f17161902398691c2ce56a388a8e1,1,2,2,0,0,0,0,4,16,20,1,1,0,239,318,4,49,47,2,1598,1584,14,23,23,0,100
235e7c5294f5ddd2f664ee5671cbf262763d4853,1,4,6,2,0,0,0,2,2,541,1,1,0,59,29,1,9,9,0,411,416,5,5,5,0,100
ae86f903b642890f096fc4ce84d1408bcd225b3d,4,11,8,3,0,0,0,7,52,1783,2,3,1.613519734,3486,73,0,1113,1112,1,24287,24260,27,98,98,0,100
1786fd3b7e8d7116c3cd8336de854343673c04a0,2,54,23,31,0,0,0,9,30,1198,2,2,0.994030211,3595,74,0,403,403,0,26863,26811,52,214,213,1,100
afe48740b56131ce50eaf7e57888f6a97f0b3421,3,28,12,16,0,0,0,5,5,3667,2,2,1.278897903,599,319,0,57,54,3,4734,4593,141,30,27,3,99.87201365
5d59e7f75f2ba8912add27cfca9452815afd4335,2,47,3,44,0,0,0,8,22,2455,2,2,0.924818705,1287,75,0,150,147,3,7569,7436,133,67,66,1,100
bfa67ce54cf9a24db99c5f15ae42e0712ac11506,2,54,12,42,0,0,0,10,70,1126,2,2,0.61361902,1094,76,0,149,141,8,8339,8140,199,66,64,2,100
3a93a26ec5e81df71358b5fdcfb480a3af4ea46e,0,0,0,0,0,0,0,0,0,0,0,0,0,0,30,0,0,0,0,0,0,0,0,0,0,100
0f7126e7fb7b7b0ee90cb74961c05bd07376ebc0,4,91,56,35,0,0,0,16,57,3108,2,2,1.088529289,2651,31,0,380,380,0,22418,22040,378,123,123,0,100
c576cec73e8698e7e64370fbd157d7014ebbe129,0,0,0,0,0,0,0,0,0,0,0,0,0,0,32,1,0,0,0,0,0,0,0,0,0,100
73c1544120aec6f5f473045cda0896253526ddb9,0,0,0,0,0,0,0,0,0,0,0,0,0,0,33,1,0,0,0,0,0,0,0,0,0,100
4876540ecc84879c493123553ce6069fa3077a9d,9,294,51,243,1,0,1,1,164,1709,2,7,2.162507697,4574,320,0,976,951,25,36498,35045,1453,251,232,19,99.97865984
4d3967853721c3da3815959db23eaa6afd2a0a80,1,2,0,2,0,0,0,6,21,1551,1,1,0,291,77,0,62,62,0,1997,1971,26,19,19,0,100
cae9db7b9087a44c22696e6f7d37d9958fe53ca3,2,5,7,2,0,0,0,4,18,768,1,2,0.650022422,353,78,1,67,67,0,2479,2481,2,24,24,0,100
46064229087d80bd14b47f9630a8e98820384365,6,106,107,1,0,0,0,1,58,1627,1,4,1.724671474,2977,321,1,450,449,1,24630,24477,153,108,108,0,100
a26a2e68d8871e72fdee0bd9b23ca802dd847d27,1,38,0,38,1,0,1,1,1,0,1,1,0,0,322,2,2,0,2,149,0,149,1,0,1,99.45646266
b77f86409be3144aa63b2efebc28f0ad7ce589cd,1,19,0,19,0,0,0,15,38,1482,1,1,0,354,79,2,93,89,4,2171,2023,148,62,61,1,100
8943b28876afcb74e36bc2ab2cb54144c255a453,3,41,1,40,0,0,0,8,20,1716,1,1,1.553763114,504,323,3,96,91,5,2776,2651,125,31,28,3,100
f591c70827dc2aa732ef595998c373c5107d84ec,6,452,21,431,3,0,3,1,66,257,1,3,1.913189357,1489,324,4,312,272,40,15202,12975,2227,54,35,19,99.69976649
aca7d0d876f2647c43ed2fa06e21fbc9d120616f,1,5,5,0,0,0,0,3,9,842,1,1,0,353,325,4,42,42,0,3090,3090,0,24,24,0,100
1b866ad79711e6b8c0171926834f6c070f391107,12,579,15,564,7,0,7,6,37,321,2,4,2.691117182,1051,326,5,215,149,66,10203,7819,2384,85,56,29,99.81064825
1facb7e45380b2a2516e2e4bacf7142453f0be1c,1,13,11,2,0,0,0,1,2,10,1,1,0,116,327,6,13,13,0,1045,1051,6,8,8,0,100
d08857948abdd04c5beb9604efaf3c06256531b5,2,13,6,7,0,0,0,2,22,820,2,1,0.981940787,351,328,7,65,66,1,2334,2303,31,23,22,1,100
901ea1fee362cabaf6044e1d82238066d21485b4,0,0,0,0,0,0,0,0,0,0,0,0,0,0,1115,0,0,0,0,0,0,0,0,0,0,100
64822944c7e336c5e570fb068ae134799eb17131,0,0,0,0,0,0,0,0,0,0,0,0,0,0,1116,0,0,0,0,0,0,0,0,0,0,100
52af2f280bde961f9ed6b27731180984eb18db4a,0,0,0,0,0,0,0,0,0,0,0,0,0,0,1117,1,0,0,0,0,0,0,0,0,0,100
4f7abda1fe28fdd6e7f293b86fed93e7dcf8303b,0,0,0,0,0,0,0,0,0,0,0,0,0,0,1118,2,0,0,0,0,0,0,0,0,0,100
ab7308987daa181aebe3db70cde8998af5d42e1a,2,58,16,42,0,0,0,6,16,1632,2,2,0.974024864,615,80,0,80,74,6,3811,3561,250,29,26,3,100
9d656255623566f030922c334379c13a0c72668e,0,0,0,0,0,0,0,0,0,0,0,0,0,0,1119,2,0,0,0,0,0,0,0,0,0,100
a71ea0c1eca7c9ca9811e338f85166748fd5be30,2,68,24,44,0,0,0,3,6,1571,2,2,0.998635964,467,34,0,62,62,0,3443,3145,298,30,29,1,100
72b3e4f8320614aecd2d50eaabf6aeaa18d2cac9,1,5,5,0,0,0,0,4,7,14,1,1,0,168,35,1,32,32,0,1004,1007,3,10,10,0,100
f203e5cd4f25bb4850be57a019ad8971ee635e40,3,42,15,27,0,0,0,10,31,3069,2,3,0.796650084,1217,81,0,185,182,3,8716,8567,149,56,55,1,100
cb8624f248258110c9f6d8bd82adb98ba7930eb8,2,31,2,29,0,0,0,3,11,3081,2,2,0.799048521,1071,82,0,218,216,2,8134,7881,253,63,62,1,100
e619a4a37a00783f3144b5b91c93a911f6c848d9,2,6,6,0,0,0,0,2,24,2989,1,2,1,367,83,1,83,83,0,2221,2209,12,50,50,0,100
05d9b20065a322d10d6c89bfdc343b9d78d96ad2,3,29,22,7,0,0,0,4,56,3605,2,2,1.489352812,1088,0,0,119,117,2,8614,8602,12,67,67,0,100
75d698344effdd44885f5dc556517712554422a7,0,0,0,0,0,0,0,0,0,0,0,0,0,0,1,0,0,0,0,0,0,0,0,0,0,100
35a7de6239512784eaae6db2855d32136984a419,1,4,0,4,0,0,0,5,6,3703,1,1,0,80,84,0,12,11,1,477,466,11,4,4,0,100
a5caea17126f5780054700870fb3fc9a0017f8b8,1,34,43,9,0,0,0,3,21,1953,1,1,0,529,85,1,128,128,0,4479,4501,22,12,12,0,100
419134478a213bd4941e737c87d9630eb07e3630,1,2,1,1,0,0,0,8,23,3494,1,1,0,290,86,2,47,46,1,1794,1781,13,11,11,0,100
f8f61c17f2c390de289c793c50a7447d237cc17c,0,0,0,0,0,0,0,0,0,0,0,0,0,0,87,0,0,0,0,0,0,0,0,0,0,100
f89575fb0f1c585162081aa45e81ea0a31cfe393,0,0,0,0,0,0,0,0,0,0,0,0,0,0,36,0,0,0,0,0,0,0,0,0,0,100
9db0980b29058b6b4c3133a306b7d7b01c89d952,11,539,137,402,2,0,2,3,14,2251,3,7,2.674865544,3147,37,0,653,587,66,26119,23478,2641,252,213,39,99.93332593
bdd9908231024d9a78c93821341afdf93c6ad583,3,99,13,86,0,0,0,4,15,102,2,2,1.35992294,1743,88,0,357,348,9,13519,12967,552,107,101,6,100
0b2066a6fd9e2907210c5dff1c480f017889425b,0,0,0,0,0,0,0,0,0,0,0,0,0,0,38,0,0,0,0,0,0,0,0,0,0,100
e22fcb2967489388f07307e3de689a7c9cc9b6f8,1,6,2,4,0,0,0,3,10,2906,1,1,0,177,89,0,41,39,2,1123,1091,32,14,14,0,100
60760b95f226e0c7d53a557ddd30311fddfea00d,4,28,1,27,0,0,0,21,198,3876,2,4,1.796505003,2211,90,0,425,420,5,16317,16176,141,168,165,3,100
59ec4a326079c9f937a052194405415b1e3a2b06,2,28,4,24,0,0,0,3,13,1858,2,2,0.928362072,673,91,1,89,86,3,5601,5439,162,42,41,1,100
ac17d18fe08c7f6a17f2cb1a472ee156e040b22f,0,0,0,0,0,0,0,0,0,0,0,0,0,0,92,0,0,0,0,0,0,0,0,0,0,100
c5045dfd13d632da0ac50b310b751caa678f507a,1,1,1,0,0,0,0,3,8,4515,1,1,0,640,93,1,105,105,0,5691,5691,0,25,25,0,100
a2fb029733201e1bee86fc4836387c0df36587a6,1,27,0,27,0,0,0,3,9,0,1,1,0,640,94,2,111,105,6,5873,5691,182,25,25,0,100
d39288c84495fbbcc3729ec10107d4952028c9dd,1,1,1,0,0,0,0,3,10,0,1,1,0,665,95,3,111,111,0,5873,5873,0,25,25,0,100
a3ba5e20b3851948d0bf83cfb7e049142d7507d3,1,9,2,7,0,0,0,3,11,0,1,1,0,665,96,4,112,111,1,5920,5873,47,25,25,0,100
c0d75ba930f9aa5c6454d0264a96f82b45279202,11,140,88,52,0,0,0,3,71,5458,3,7,2.652332933,5760,329,0,1017,1013,4,37541,37544,3,387,379,8,99.82220247
367d4e5a69ef492145a76a79e49f7a7341b77e33,10,111,160,49,1,0,1,2,107,4823,1,2,2.280508559,3235,330,1,458,454,4,23204,23603,399,247,240,7,99.94441356
c74a1f26a1480b28014a63f5c8f1d52d4d00e4f9,1,1,0,1,0,0,0,11,22,6414,1,1,0,458,331,2,64,64,0,3865,3849,16,30,30,0,100
d4012482e128f66ef6fb7cd55a1200d496972a43,0,0,0,0,0,0,0,0,0,0,0,0,0,0,332,3,0,0,0,0,0,0,0,0,0,100
0abc224e6aee2cfcb4d0fba7e45d7bc431ddc6a1,1,1,1,0,0,0,0,4,17,6095,1,1,0,1022,333,4,123,123,0,6769,6770,1,57,57,0,100
123447b87908a23461bb01cce63601b00a6a3d1a,1,0,0,0,1,0,1,7,17,0,1,1,0,0,334,5,0,0,0,0,0,0,0,0,0,99.97776295
ccd5be898f94696761ca53c7677bff72296bdc33,1,2,1,1,0,0,0,2,2,8300,1,1,0,230,335,6,22,22,0,1741,1743,2,13,13,0,100
ac76f6bab097e26bfea22477dcda3be0c599ed61,3,3,1,2,0,0,0,3,37,5396,2,3,1.5,622,97,0,104,104,0,5062,5040,22,26,26,0,100
2050831ec824fe59d43f84117e14d541966c285b,0,0,0,0,0,0,0,0,0,0,0,0,0,0,98,1,0,0,0,0,0,0,0,0,0,100
462979566daa8d6cfff9e5ffb4aad53923998785,1,4,4,0,0,0,0,3,9,6986,1,1,0,291,99,2,25,25,0,2303,2303,0,14,14,0,100
367291aacfb68a2970a968379ca233bf0a1f7b93,1,2,0,2,0,0,0,13,42,4801,1,1,0,1265,336,0,104,104,0,11170,11154,16,46,46,0,100
7512c032131cc56ecff831d947245aeb9bcdf265,4,40,3,37,0,0,0,4,14,3152,3,4,1.836023468,1470,337,1,300,295,5,11398,11175,223,111,106,5,100
0ee3e49c5c18c697ca3bcc958a025f53407d67c7,2,18,6,12,0,0,0,5,10,6723,1,1,1,448,338,2,75,73,2,3189,3093,96,23,23,0,100
14df917165ffd6b1617c0975c9f9cfdadbee3ac3,0,0,0,0,0,0,0,0,0,0,0,0,0,0,339,3,0,0,0,0,0,0,0,0,0,100
dacf1dfdfcdc6f949e02a269e070ec6a9d92864b,2,4,2,2,0,0,0,1,2,9126,1,1,1,172,340,4,21,21,0,1264,1224,40,7,7,0,100
34aefba994f2cd1cfe96a2425d67135dbc43e69a,0,0,0,0,0,0,0,0,0,0,0,0,0,0,341,5,0,0,0,0,0,0,0,0,0,100
a2673eb5165831c0db8a8e0125bb7b6dc9074d22,0,0,0,0,0,0,0,0,0,0,0,0,0,0,342,6,0,0,0,0,0,0,0,0,0,100
b050a33c66fc22d648370b5c6bda04e0e51d3aa3,0,0,0,0,0,0,0,0,0,0,0,0,0,0,343,7,0,0,0,0,0,0,0,0,0,100
2b7795b1d41dc02a8e494f70abcffe4d25f00f76,1,6,1,5,0,0,0,14,44,6821,1,1,0,510,344,0,113,112,1,3650,3637,13,42,42,0,100
8d540454a4a43da1c5fed12b36a36b4ffcb7d3bc,1,2,1,1,0,0,0,2,4,7943,1,1,0,140,345,0,22,21,1,1292,1273,19,3,3,0,100
ac0ccd6552af2e3b0640d27c07c74377f8a82308,1,9,1,8,0,0,0,6,67,5222,1,1,0,1117,346,1,219,218,1,9594,9550,44,21,21,0,100
24a1e1770f1ce076480f4ddd357cd1bf0b284295,2,15,8,7,0,0,0,3,9,2144,2,2,0.965636133,277,347,2,47,47,0,2110,2033,77,28,28,0,100
4bf875077dbd0f9c7baed23cd0d33d9c93c973fe,0,0,0,0,0,0,0,0,0,0,0,0,0,0,348,3,0,0,0,0,0,0,0,0,0,100
