CommitID,NMF,TotalAddLines,TotalDeleteLines,LC,FileAdd,FileDelete,NAD,NDEV,NUC,AGE,NS,ND,Entropy,LT,EXP,REXP,CommitComplexity,LastCommitComplexity,CFC,CommitTokenCount,LastCommitTokenCount,NCC,CommitMethodNum,LastCommitMethodNum,NMC,a2a
ef1a9569c57c965118737d2b32929fb1d931da01,0,0,0,0,0,0,0,0,0,0,0,0,0,0,2,2,0,0,0,0,0,0,0,0,0,100
107c009880f8e1889183f50be2618a1ab7862866,0,0,0,0,0,0,0,0,0,0,0,0,0,0,3,0,0,0,0,0,0,0,0,0,0,100
b06c41eb5b4d78ed4133c7ad5cc83aec0cc0217d,0,0,0,0,0,0,0,0,0,0,0,0,0,0,4,1,0,0,0,0,0,0,0,0,0,100
b6c2535f27d8ebc7d44ad06704642c5ae17e9d93,0,0,0,0,0,0,0,0,0,0,0,0,0,0,5,2,0,0,0,0,0,0,0,0,0,100
499c6c0370d4573019b5da7ea1d7d23e2554abec,0,0,0,0,0,0,0,0,0,0,0,0,0,0,6,3,0,0,0,0,0,0,0,0,0,100
58b2af09171e0dd89a9f84725a419234d253812b,0,0,0,0,0,0,0,0,0,0,0,0,0,0,7,4,0,0,0,0,0,0,0,0,0,100
652c13aa304d52f37b78687e2247179592ab4120,0,0,0,0,0,0,0,0,0,0,0,0,0,0,8,5,0,0,0,0,0,0,0,0,0,100
38b4d62102901dd5c66698fb8f53e1a923e8cb0a,0,0,0,0,0,0,0,0,0,0,0,0,0,0,9,6,0,0,0,0,0,0,0,0,0,100
4377352d3b85cdb9e60a1b772dab92b695aee131,0,0,0,0,0,0,0,0,0,0,0,0,0,0,10,7,0,0,0,0,0,0,0,0,0,100
b67707cf5ff16c80bd27a0350761a2c2d9180f3b,31,345,2227,1882,0,0,0,1,2,90,1,6,4.583163492,1800,11,8,129,285,156,5744,14755,9011,78,158,80,59.05511811
5acf5e4132bb6e37cb5777f3d63f4e7962fac188,14,839,82,757,8,0,8,1,3,0,1,5,3.004158841,519,12,9,174,86,88,7458,4007,3451,110,56,54,69.23076923
eb74b14e5e81821f2ce504f5d1133c4a578cb62d,1,0,193,193,0,0,0,1,3,0,1,1,0,115,13,10,0,24,24,0,994,994,0,14,14,98.14814815
7d0ace7defdbff12b11ede1d6981e54f3e86e6ac,5,110,67,43,2,0,2,1,4,3,1,3,1.919111901,90,14,11,12,9,3,1265,828,437,5,3,2,91.74311927
c48d7b36d1e201a3491dc3602e3a6b4b0ac8f807,3,24,106,82,0,0,0,1,4,6,1,2,1.133165513,142,15,12,5,17,12,716,1164,448,5,11,6,96.3963964
7a6c223e90f29f87a037641933fb567fc28fdfd3,0,0,0,0,0,0,0,0,0,0,0,0,0,0,16,10,0,0,0,0,0,0,0,0,0,100
a9a62ac8ef44f4d2c5f8b2200d5a61873f336af2,0,0,0,0,0,0,0,0,0,0,0,0,0,0,17,10,0,0,0,0,0,0,0,0,0,100
19513ad4b7488848953e9dfd99ef61a4efbe3427,0,0,0,0,0,0,0,0,0,0,0,0,0,0,18,11,0,0,0,0,0,0,0,0,0,100
ef36c22d788fa4ddce6e30c8e3b5f018350c7860,10,228,150,78,0,0,0,1,5,18,1,6,2.255020544,561,19,11,96,90,6,4599,4480,119,67,61,6,93.22033898
b6c6afe6eb46c022de7d49b47d8eafeee35ef733,1,9,5,4,0,0,0,1,3,0,1,1,0,89,20,12,22,22,0,662,662,0,18,18,0,100
75bd233c2bd360bf0907488b167257b3c7118340,0,0,0,0,0,0,0,0,0,0,0,0,0,0,21,13,0,0,0,0,0,0,0,0,0,100
50feb1a423d8896d513a919368427ef72429dcf2,3,58,57,1,0,0,0,1,4,0,1,2,1.21362783,132,22,13,25,23,2,1041,1017,24,18,19,1,100
ab01bad7663dc0891294efad4e4ec2e55ed767ae,1,0,2,2,0,0,0,1,5,0,1,1,0,92,23,14,24,24,0,662,686,24,17,17,0,100
bac51914312cf1a21ac7a9c8ce76175cc4384686,1,6,6,0,0,0,0,1,6,0,1,1,0,90,24,15,24,24,0,662,662,0,17,17,0,100
6948f4d2166d0d65fdf9933561f592a59453a06f,1,1,1,0,0,0,0,1,7,0,1,1,0,90,25,16,24,24,0,662,662,0,17,17,0,100
883088d0e0e3df20eb001edf08a2f44121a60f8e,3,20,16,4,0,0,0,1,8,18,1,1,1.146277995,256,26,17,61,59,2,1856,1778,78,41,39,2,100
b4efd73b43bdd86e585c25b0eda70da841e82aa3,0,0,0,0,0,0,0,0,0,0,0,0,0,0,27,18,0,0,0,0,0,0,0,0,0,100
d7c621d4aa08413318af9986f22e9c78683b2792,1,12,0,12,0,0,0,1,4,0,1,1,0,18,28,19,0,0,0,102,102,0,0,0,0,100
502e2ae2ae2144052688343ae90407eab648934f,8,154,311,157,0,0,0,1,9,14,1,4,2.030263856,484,29,18,71,80,9,2986,3339,353,45,52,7,99.20634921
fd0979c534bc11172d4221a8b2f5d3eb18ec00b4,0,0,0,0,0,0,0,0,0,0,0,0,0,0,30,19,0,0,0,0,0,0,0,0,0,100
089c18f09e6f24238b044eb98cbded73bc35de81,0,0,0,0,0,0,0,0,0,0,0,0,0,0,31,20,0,0,0,0,0,0,0,0,0,100
f2de2a05db58de0f60af60d2ac2f9576b8c98aeb,7,82,39,43,1,0,1,1,6,25,1,4,2.180574402,303,32,21,53,47,6,2493,2049,444,30,27,3,94.53125
6efb23a66908e4f71b60e1985a4b2b55013fe56b,0,0,0,0,0,0,0,0,0,0,0,0,0,0,33,22,0,0,0,0,0,0,0,0,0,100
87aba27c607f7ae466205919ff58aad6935aad06,6,24,12,12,0,0,0,1,10,2,1,3,2.383188365,511,34,23,108,105,3,3951,3849,102,70,69,1,97.6744186
4b1d4c3f1ebd7ed8f7ac3e92d18029146d601546,0,0,0,0,0,0,0,0,0,0,0,0,0,0,35,24,0,0,0,0,0,0,0,0,0,100
498f333f20d8b96903cb55d4b7b7ba36f48e1381,1,15,8,7,0,0,0,1,3,0,1,1,0,29,36,25,8,5,3,314,263,51,1,2,1,100
ce11168bd55ccbf7df98c45326a53d249cd2a517,0,0,0,0,0,0,0,0,0,0,0,0,0,0,37,26,0,0,0,0,0,0,0,0,0,100
46b1ac4bbe92014e61ffb39d2d951f1397a01cc5,2,2,22,20,0,0,0,1,5,15,1,1,0.249882293,43,38,27,6,6,0,282,378,96,6,6,0,100
9cba36e7cabebc0236dcba88610e68bad5162d8a,0,0,0,0,0,0,0,0,0,0,0,0,0,0,39,28,0,0,0,0,0,0,0,0,0,100
d9805cde5cbc36bd7870f7d1bedd89695550fb25,1,0,34,34,0,0,0,1,2,144,1,1,0,6,40,29,0,0,0,0,17,17,0,0,0,98.41269841
73fe94e58bb7114799baa5e1cddd4936166b88b0,0,0,0,0,0,0,0,0,0,0,0,0,0,0,41,30,0,0,0,0,0,0,0,0,0,100
7c3721ffb981ddf86ae6d07da979cc846a78c726,2,9,18,9,0,0,0,1,8,0,1,1,0.950956048,125,42,31,22,22,0,849,908,59,11,11,0,100
893ba2a853cc00fcb69ac8d34676362a52c47fae,3,6,13,7,0,0,0,1,9,13,1,1,1.323531576,301,43,32,64,64,0,2296,2336,40,36,36,0,100
a24d931f726322e1dd27bea51ac75dd995e50186,0,0,0,0,0,0,0,0,0,0,0,0,0,0,44,33,0,0,0,0,0,0,0,0,0,100
cf493ae74e0319c0dfdec622680532f6901ea639,3,57,18,39,0,0,0,1,10,3,1,2,0.418089375,295,45,34,62,62,0,2139,2132,7,35,35,0,100
fb0ba18f07c345b5f4e3eaf07f8a685961c8a82c,2,27,10,17,0,0,0,1,7,0,1,1,0.699772222,28,46,35,4,4,0,173,173,0,3,3,0,100
56fd5de93998adecc188726768aee848e1da3a81,0,0,0,0,0,0,0,0,0,0,0,0,0,0,47,36,0,0,0,0,0,0,0,0,0,100
ed484c3c9798171b7bcf1d02a4945f45128665b1,1,4,4,0,0,0,0,1,5,10,1,1,0,18,48,37,0,0,0,102,102,0,0,0,0,100
397b22330ef26c38a6332948b4287ba25f93a77f,0,0,0,0,0,0,0,0,0,0,0,0,0,0,49,35,0,0,0,0,0,0,0,0,0,100
17e0cbbb901c41bac0f4960e701228c418e04773,6,16,28,12,0,0,0,1,11,24,1,4,2.04902395,234,50,36,28,28,0,1796,1879,83,17,17,0,96.69421488
06efc77bf8dbf8290eb17d648b05ff83fd07aa38,4,7,8,1,0,0,0,1,12,0,1,1,1.640223929,244,51,37,52,52,0,1770,1770,0,34,34,0,100
098947a5c7211a7ed3363f0cbd9ed297ad30a86c,0,0,0,0,0,0,0,0,0,0,0,0,0,0,52,38,0,0,0,0,0,0,0,0,0,100
c5bb6027e3be184f78deaf239e1d5b21a3102687,1,1,0,1,0,0,0,1,4,3,1,1,0,15,53,39,1,1,0,136,136,0,1,1,0,100
45f3a4aa2925c9cd133b913b83f4e67dda059011,3,63,61,2,0,0,0,1,12,0,1,3,1.577756941,272,54,40,58,56,2,2060,2107,47,42,41,1,100
2e857d2f87bc3f7ffefdf966600cc1bdbe1569f2,0,0,0,0,0,0,0,0,0,0,0,0,0,0,55,41,0,0,0,0,0,0,0,0,0,100
ab3f528dc28bc1df563336c6a505251258c646a3,3,52,1,51,0,0,0,1,13,0,1,2,1.424282603,142,56,42,33,29,4,1317,1128,189,21,19,2,89.47368421
798287d361d87bfaed1b3b9de8dcc1e05d4e9466,0,0,0,0,0,0,0,0,0,0,0,0,0,0,57,43,0,0,0,0,0,0,0,0,0,100
97cb0cccac0f2be5b65206ba13a075128fd7801b,2,27,11,16,0,0,0,1,14,2,1,2,0.998000884,143,58,44,36,33,3,1323,1207,116,24,21,3,100
9560358dd61e216ce3b19ffd7911730809fb6020,1,6,3,3,0,0,0,1,4,5,1,1,0,35,59,45,8,8,0,341,314,27,1,1,0,100
64a758ca29317b80384e3dec64cb1ab1b52d269c,0,0,0,0,0,0,0,0,0,0,0,0,0,0,60,44,0,0,0,0,0,0,0,0,0,100
9939a1b457e0df19b277c9484a5f97849b5eb105,0,0,0,0,0,0,0,0,0,0,0,0,0,0,61,45,0,0,0,0,0,0,0,0,0,100
e4a11af5f94b5d97ac0ffa5b69b7a4586e414424,8,152,0,152,0,0,0,1,8,26,1,4,3,330,62,46,52,52,0,2640,2640,0,38,38,0,100
9240ed785a1a52cef881b17ac6bd58da2622974e,1,1,1,0,0,0,0,1,4,21,1,1,0,20,63,47,0,0,0,160,160,0,0,0,0,100
d7ae0183592a19957873336990ae2364d929152b,1,18,19,1,0,0,0,2,5,7,1,1,0,143,0,0,29,29,0,1018,1034,16,23,23,0,100
d3b100987d2179e06e80e4f836bb83609745b546,0,0,0,0,0,0,0,0,0,0,0,0,0,0,64,45,0,0,0,0,0,0,0,0,0,100
175d624a3b0891f3e014ae504c65c0b6e2fb71ec,2,11,7,4,0,0,0,1,9,12,1,2,0.918295834,180,65,46,38,38,0,1353,1377,24,29,29,0,100
c2fc5d03dc283f81317e3ddc508dd33a285915de,0,0,0,0,0,0,0,0,0,0,0,0,0,0,66,37,0,0,0,0,0,0,0,0,0,100
0bb261c5e2116ce347ae3e583715d9dc564a1592,1,0,71,71,0,0,0,1,3,72,1,1,0,27,67,38,0,9,9,0,201,201,0,3,3,97.22222222
d18adac1456d191413cdc0d0dca2e73fbdb4fed6,2,0,314,314,0,0,0,1,8,21,1,1,0.86432049,114,68,39,0,28,28,0,997,997,0,20,20,94.05940594
c7538589bef7d3d4e085a3917297f47fb730cf54,8,797,410,387,3,0,3,1,15,14,1,5,2.434026931,619,69,40,169,132,37,5880,4609,1271,104,81,23,91.34615385
d7e314c45b01d4ecd2920b2581e7346f429fed6a,0,0,0,0,0,0,0,0,0,0,0,0,0,0,70,41,0,0,0,0,0,0,0,0,0,100
b9a5bb3ad1e132fa483eb2715fcdfc5938a07eba,2,56,3,53,1,0,1,1,14,0,1,2,0.418684311,112,71,42,25,22,3,941,802,139,14,11,3,97.4789916
0a8f080dd4a268afae6f08d46a06f3292188e9b0,0,0,0,0,0,0,0,0,0,0,0,0,0,0,72,43,0,0,0,0,0,0,0,0,0,100
645f8f9db2cd5f086d731cd1f76ac0adb336a4dc,0,0,0,0,0,0,0,0,0,0,0,0,0,0,73,44,0,0,0,0,0,0,0,0,0,100
1710cf88778d6664d7e490489806254cd7730154,0,0,0,0,0,0,0,0,0,0,0,0,0,0,74,45,0,0,0,0,0,0,0,0,0,100
ad97914719bcfaf0f2df0fc9f361134177029d5d,0,0,0,0,0,0,0,0,0,0,0,0,0,0,75,46,0,0,0,0,0,0,0,0,0,100
1638aa92bcd805861241c7a9ca2d56d61cb22917,0,0,0,0,0,0,0,0,0,0,0,0,0,0,76,47,0,0,0,0,0,0,0,0,0,100
9784366df0e09f927bf67172d653150ca220fb1b,0,0,0,0,0,0,0,0,0,0,0,0,0,0,77,48,0,0,0,0,0,0,0,0,0,100
bcc1cfb680e3b48bbda91dd87d03df8d9f054102,17,646,348,298,3,0,3,1,16,12,1,7,2.80596653,860,78,41,156,157,1,7316,6698,618,95,95,0,88.52459016
e3b4948fdbf9f5e11fc5a16c7bf4eafd324d51ea,13,335,630,295,0,0,0,1,17,0,1,4,2.641862835,804,79,42,136,135,1,5586,6169,583,84,84,0,85.36585366
6188e556ea37b65714dcdff169a508e0e4930d04,3,11,13,2,0,0,0,1,11,0,1,2,1.308502445,93,80,43,13,13,0,771,797,26,10,10,0,96.8503937
515c3cb1d0af3470d3be9881c27dcb3d7eff22df,1,2,3,1,0,0,0,1,6,0,1,1,0,39,81,44,8,8,0,341,350,9,1,1,0,100
498696c1f11269b5971608bdf1a84878ec85b7f0,0,0,0,0,0,0,0,0,0,0,0,0,0,0,82,45,0,0,0,0,0,0,0,0,0,100
f3d9555f485fe467da694c8f2f55eceeffd9ac74,0,0,0,0,0,0,0,0,0,0,0,0,0,0,83,34,0,0,0,0,0,0,0,0,0,100
e05add7e0c2503e50440bac647821b4583000437,17,1631,1314,317,3,0,3,1,18,0,1,7,3.584637372,860,84,35,156,157,1,7296,6698,598,95,95,0,88.52459016
0302d9e886d90797bbd407638de0b27c35596fc1,3,0,343,343,0,0,0,1,12,0,1,2,1.494669068,77,85,36,0,1,1,0,589,589,0,1,1,88.49557522
aebef215910404e07ed2dcb828801c2723d0f906,6,56,11,45,0,0,0,1,13,0,1,5,1.868439696,505,86,37,101,101,0,3986,3999,13,67,67,0,97.34513274
03b1a2ffa409f8a6af4c9f9ac7d025ce6138a0eb,4,19,11,8,0,0,0,1,12,0,1,3,1.714736649,444,87,38,92,91,1,3507,3444,63,60,60,0,100
0784a927b51575f2953b75b40db4e5c164851f0e,1,1,0,1,0,0,0,1,12,1,1,1,0,21,88,39,0,0,0,161,161,0,0,0,0,100
f7a560dc4a164b40f3c2ac490a51673e3eb183e1,7,122,34,88,1,0,1,1,11,15,1,3,2.02684135,312,89,35,50,43,7,2952,2523,429,30,25,5,96.09375
097d97860a366b7fb5832e98c7260528936e70c8,1,3,3,0,0,0,0,2,13,0,1,1,0,137,90,36,29,29,0,1011,1011,0,23,23,0,100
aa71687b8e1cc70b4e25abf24f93f8ce1416ae2a,1,1,1,0,0,0,0,1,7,0,1,1,0,36,91,33,1,1,0,316,316,0,1,1,0,100
dde90da8ac1c52695394467f78a041ec5ea3a127,4,299,259,40,0,0,0,1,19,15,1,4,1.132165715,219,92,31,44,41,3,1848,1645,203,34,32,2,100
7acd2de32c79c3d15d006914ce4e81075f14d605,1,19,0,19,0,0,0,1,4,12,1,1,0,61,93,32,7,7,0,438,438,0,5,5,0,100
d9be1e3bcf9b64cd9b473a376e40649935807c45,4,69,13,56,0,0,0,1,15,15,1,2,1.754233886,192,94,31,37,34,3,1791,1480,311,22,20,2,91.2
71ca90bab4b5a4b995ad7c43c80699897547d27a,9,239,21,218,2,0,2,1,16,34,1,5,2.54685474,490,95,31,120,100,20,5025,3924,1101,76,70,6,96.55172414
4d61d71c6ea0739a48a0b912413d95720c5f4649,2,232,0,232,2,0,2,1,1,0,1,1,0.998659388,0,96,32,24,0,24,1016,0,1016,12,0,12,93.98496241
2cfd78579b01f472516d4da5b3640cb1c7442538,2,0,232,232,0,0,0,1,17,0,1,1,0.998659388,109,97,33,0,24,24,0,1016,1016,0,12,12,91.04477612
1463c6358dbc551f3b3d2e6a1ccf80174c4bd02a,2,2,2,0,0,0,0,1,2,0,1,1,1,109,98,34,24,24,0,1016,1016,0,12,12,0,100
4a7de52ce194c873cd0b26806a924f13f67406ad,1,2,2,0,0,0,0,1,7,0,1,1,0,125,99,35,28,28,0,1031,1027,4,18,18,0,100
b3ce89c4bac15b2cca4292283f1122d5dfc8129f,1,0,13,13,0,0,0,1,6,63,1,1,0,20,100,36,1,1,0,73,169,96,1,1,0,100
148c24cd32f0953e701be4125858541650228451,3,33,66,33,0,0,0,1,7,0,1,1,1.074889169,120,101,37,25,25,0,914,1089,175,13,13,0,100
d0991744bb28b897efb0c3303536a3fa40b6f9a3,12,456,112,344,2,0,2,1,20,5,1,4,2.438111185,676,102,38,173,130,43,6911,5355,1556,113,80,33,90.4
75fcaa5bba1129d0c478f49853ad9cd6978e8ac4,1,4,4,0,0,0,0,1,9,0,1,1,0,124,103,39,28,28,0,934,929,5,18,18,0,100
1d0894388404ed4a0930e14e24123935c047c9fe,4,65,30,35,0,0,0,1,12,6,1,2,1.555749679,150,104,40,28,28,0,1525,1302,223,16,16,0,96.875
3c1a211591b72bf830166bd79a222bbf7d3d1773,1,1,5,4,0,0,0,1,5,0,1,1,0,28,105,41,2,2,0,223,233,10,1,1,0,100
c549c30a2a90cb853520099fe23580ee9d02fa96,5,70,78,8,0,0,0,1,19,18,1,3,2.046399848,349,106,28,56,63,7,2753,2817,64,28,28,0,100
d8f737f269c14a15f50dd0bd9d9fbd878b4ce0db,6,511,464,47,0,0,0,1,13,16,1,5,2.23193569,286,107,21,41,37,4,2729,2443,286,24,20,4,96.06299213
abf8c9b8631574acc2b5ee4a3c16004e87d8efb9,3,7,15,8,0,0,0,1,11,25,1,2,1.381460855,341,108,22,65,65,0,2497,2555,58,43,43,0,100
38c6393804d079160447a19a08a88870a31cacf4,1,0,3,3,0,0,0,1,10,0,1,1,0,43,109,23,8,8,0,367,385,18,1,1,0,100
025f6a41892f3633c631f461484f2859d1597b50,1,1,1,0,0,0,0,1,6,1,1,1,0,56,110,21,7,7,0,408,408,0,5,5,0,100
d34988f99595c82ef860bf863daac9799f2907a5,4,29,58,29,0,0,0,1,20,0,1,3,0.793523392,400,111,20,66,73,7,3115,3158,43,43,43,0,100
3e47c285a99beae39bb0bc2097f308bfdc2a31a7,1,3,7,4,0,0,0,1,21,3,1,1,0,73,112,20,13,13,0,557,598,41,9,9,0,100
ac17dd694d53b48b8f6957ba063fc658281ec8b2,7,54,41,13,0,0,0,1,22,22,1,4,2.369533347,540,113,19,100,99,1,4529,4388,141,54,53,1,100
9c804ed49bcd92f421015160e40cf7da129770e8,4,261,208,53,0,0,0,1,17,12,1,3,0.535990019,356,114,20,71,65,6,3114,2831,283,45,42,3,93.79310345
33d016da416ccf2785766241c0ac22f79833d5c7,4,49,5,44,0,0,0,1,23,13,1,2,1.727747188,199,115,20,34,30,4,1918,1705,213,19,16,3,100
e721b8d614a50d931066ff565d31733cbadb837c,7,109,50,59,1,0,1,1,24,18,1,4,2.322982015,375,116,21,65,57,8,3378,3203,175,43,35,8,92.56756757
42a421c96cdf602863ce081e6e5f1653d1803c91,1,3,2,1,0,0,0,1,13,0,1,1,0,130,117,22,24,24,0,1108,1093,15,15,15,0,100
134e790199cc28892e61aa75e5e687f0b6448ada,5,65,18,47,0,0,0,1,25,0,1,3,2.237058835,259,118,17,49,44,5,2440,2223,217,31,27,4,100
17033f9dee5cbf6a46a186f28c0963f21e1caac4,3,13,13,0,0,0,0,1,26,0,1,1,0.991264261,143,119,18,20,20,0,1225,1225,0,14,14,0,100
2a56622dcddb6353a9a9b67d7c0c3d4dd13097bf,1,0,1,1,0,0,0,1,21,37,1,1,0,22,120,19,0,0,0,137,137,0,0,0,0,100
23df2af66295c2c20e6b60476525357e3eb0dc13,1,4,8,4,0,0,0,1,27,0,1,1,0,103,121,20,19,20,1,854,871,17,14,14,0,100
ef727ae8bb727641a1aa5d009fbdfb7746411fca,1,7,19,12,0,0,0,1,10,41,1,1,0,124,122,19,27,28,1,897,934,37,17,18,1,100
a57d7a0cb41b39109dd5dd515a84314e332956f5,1,1,1,0,0,0,0,1,14,4,1,1,0,132,123,20,24,24,0,1106,1108,2,15,15,0,100
00c2d865ddbcbd392ea7176674379746e144da76,1,3,3,0,0,0,0,1,14,10,1,1,0,144,124,20,28,28,0,1093,1093,0,18,18,0,100
9f1d1fbad1b0848494c50fe51c8f1fb882ab6304,1,1,1,0,0,0,0,1,5,4,1,1,0,36,125,21,4,4,0,303,303,0,1,1,0,100
67c48d6ed7d1ee84809bb7722a5d14baf4d7f916,6,193,32,161,1,0,1,1,28,3,1,2,2.03320471,364,126,20,77,60,17,3763,3140,623,46,36,10,91.92546584
57abb2b5ceba91b8bbc7fabd53707cf5c6ce872b,2,19,5,14,0,0,0,1,12,26,1,2,0.650022422,137,127,21,29,28,1,1475,1175,300,15,15,0,100
3767a9700fd7cc3462d95e785f0a8a1d0e5d693a,1,9,19,10,0,0,0,1,4,0,1,1,0,39,128,22,6,7,1,236,511,275,6,6,0,100
6405a88a4912d25932e86abb6fae73cdef634c37,0,0,0,0,0,0,0,0,0,0,0,0,0,0,129,23,0,0,0,0,0,0,0,0,0,100
414687c56271547a20abd174eb64f9673a9a26f1,0,0,0,0,0,0,0,0,0,0,0,0,0,0,130,23,0,0,0,0,0,0,0,0,0,100
1900e38e48bcdf3b8d1f67810547de61a2e6ff2f,12,945,0,945,12,0,12,1,1,0,1,2,3.34583641,0,131,24,84,0,84,2936,0,2936,48,0,48,79.89949749
15fb25e545b3f1a7d20e99e3780d44a1ca362406,0,0,0,0,0,0,0,0,0,0,0,0,0,0,132,25,0,0,0,0,0,0,0,0,0,100
4695dd6ba7b24c1a20fdb304b56c0211c7c706d6,1,12,10,2,0,0,0,1,2,0,1,1,0,59,133,23,6,6,0,291,291,0,4,4,0,100
649aa57cd4df42686be16ca96bfbc9a42680f8fe,7,292,289,3,0,0,0,1,16,6,1,4,1.11811358,455,134,24,68,71,3,3533,3525,8,34,30,4,92.30769231
d3c330a2bc6750c74e60b0c03596b4f794f6ea2d,4,491,305,186,1,0,1,1,13,30,1,2,1.560389058,187,135,25,46,34,12,2426,1556,870,27,17,10,99.04761905
bd49b4952a155012309157e13df6649a4b4bcd70,3,45,16,29,1,0,1,1,29,4,1,2,1.153853057,243,136,24,46,46,0,2089,2043,46,32,32,0,98.13953488
1e8064f4c84f5ec675e0131e6edafa7f840ac350,14,145,147,2,1,0,1,1,30,35,1,6,3.246199302,992,137,4,168,170,2,7888,8028,140,114,112,2,82.87292818
2097558ff399329c8f40a0f42bfe2c66700c74e2,2,4,4,0,0,0,0,1,12,0,1,1,1,126,138,5,29,29,0,945,945,0,19,19,0,100
ae82d1eda563075f235c6bf131405d9411fbd0ee,3,19,16,3,0,0,0,1,19,0,1,1,1.510110604,263,139,6,53,54,1,2067,2090,23,34,35,1,98.63013699
43686c5e78fe18db077762d6268b3f04e9a24428,2,52,28,24,0,0,0,1,20,37,1,2,0.468995594,186,140,3,37,34,3,1777,1632,145,19,17,2,100
9b430027ccb1696493168b75abe7777936d778fe,3,12,4,8,0,0,0,1,17,53,1,3,1.5,121,141,4,20,18,2,1022,974,48,11,9,2,100
39cdcfacdaad39600b9fff897b582a3568b14af4,3,7,3,4,0,0,0,1,31,23,1,2,1.521928095,185,142,5,31,31,0,1615,1597,18,18,18,0,100
79681c69b54cde6f3b7f2e9c161261c71ab8fc72,2,11,11,0,0,0,0,1,15,29,1,2,0.945660305,232,143,6,33,33,0,1822,1822,0,18,18,0,100
1d58e7953d4a66412d02c4f95974c64572171670,2,16,7,9,0,0,0,1,32,31,1,1,0.998635964,151,144,7,30,29,1,1203,1175,28,20,20,0,100
f7bab71270301a1ea5e73525fb0bee6906eecee9,5,25,24,1,0,0,0,1,33,0,1,2,2.181703302,451,145,8,81,78,3,3836,3786,50,45,45,0,100
572bb5f7b5f4aa62ec53317c537713d0c7301720,2,9,7,2,0,0,0,1,2,52,1,2,0.69621226,77,146,9,9,9,0,288,265,23,8,8,0,100
bbe1ea05f61454d5d8b4ab6af3c534087304a3fa,0,0,0,0,0,0,0,0,0,0,0,0,0,0,147,10,0,0,0,0,0,0,0,0,0,100
fa15f3bd7f61e209a0bf54565e353bc09b999e5c,5,163,101,62,1,0,1,1,34,8,1,2,1.795964125,428,148,11,83,81,2,3667,3540,127,46,45,1,82.28571429
cd3d3b35eacc064d681cc7b4c2ebe7da4c46afc0,1,29,2,27,0,0,0,1,23,0,1,1,0,150,149,12,29,25,4,1439,1302,137,16,15,1,100
2a7fd8ac186ec727122d8e59003e7d25ca0fb6b6,3,32,1,31,0,0,0,1,22,55,1,2,1.572623664,183,150,13,37,33,4,1518,1365,153,22,20,2,100
70de8122c9b6411d731bc34d50ecb2f0f992963c,1,0,1,1,0,0,0,1,15,0,1,1,0,102,151,14,24,24,0,735,746,11,14,14,0,100
4657bdf6bf99f3812b6af9f23ff7bde009e48130,3,35,15,20,0,0,0,1,16,14,1,2,1.474309555,199,152,15,45,42,3,1702,1501,201,27,27,0,100
4b79cd235ebaab81f2af39ff3921cabef29dc43d,1,1,1,0,0,0,0,1,17,0,1,1,0,103,153,16,25,25,0,758,758,0,13,13,0,100
02f616252923dc78cc703b7f05957facb17cbddf,0,0,0,0,0,0,0,0,0,0,0,0,0,0,154,17,0,0,0,0,0,0,0,0,0,100
f812227dcd1bec1e5f88ed550aa9fbaf21fd3c65,2,149,0,149,2,0,2,1,1,0,1,2,0.883738185,0,155,15,20,0,20,591,0,591,12,0,12,97.10144928
dd1b90c3f9b3e3f5dce69e98e2f989bf41bfeb4d,5,170,87,83,0,0,0,1,13,94,1,4,1.638918193,335,156,16,70,60,10,2436,2147,289,33,29,4,100
8140725ed04288f0998ebc3b0fdf4de5f9d8ed4b,0,0,0,0,0,0,0,0,0,0,0,0,0,0,157,17,0,0,0,0,0,0,0,0,0,100
80242b27f8e79b05b347c8a472a45d08e9b0435c,0,0,0,0,0,0,0,0,0,0,0,0,0,0,158,18,0,0,0,0,0,0,0,0,0,100
a8498b040f146bf70a264824360159e5c0987236,1,30,3,27,0,0,0,1,2,93,1,1,0,112,159,13,18,18,0,853,618,235,11,11,0,100
85f2a83ded7e0240c06b7b2d6f28c61bb09db67e,6,27,12,15,0,0,0,1,35,35,1,1,2.1390907,394,160,12,66,65,1,3308,3218,90,39,38,1,100
bc4db117401d71500de663237899570deb81175a,1,0,16,16,0,0,0,1,15,53,1,1,0,60,161,12,8,11,3,380,492,112,2,3,1,100
dafbba39a188838f053fdf5cb75ecae1c43a45c8,0,0,0,0,0,0,0,0,0,0,0,0,0,0,162,11,0,0,0,0,0,0,0,0,0,100
53c8ee2137f13d543cdc850da42c5af42404f37e,4,132,0,132,1,0,1,1,25,11,1,2,1.787765556,313,163,12,74,52,22,3495,2741,754,35,26,9,90.74889868
7c44eb7f82c924002da9f1efc71a11619a5f6581,1,37,2,35,0,0,0,1,2,0,1,1,0,36,164,12,10,10,0,277,277,0,7,7,0,100
0e8282b00654adce38a0f509da5bd744e354e425,3,27,42,15,0,0,0,1,15,43,1,3,0.513185179,98,165,13,20,20,0,684,684,0,12,12,0,100
930cea71919245fab0f19eb5052c0ca6db72be6d,1,1,1,0,0,0,0,1,3,0,1,1,0,36,166,14,10,10,0,277,277,0,7,7,0,100
f9a1c11827bf4350f33302a92574e3c722bfdad1,12,1689,1377,312,0,0,0,1,36,20,1,5,3.175600857,876,167,15,178,148,30,8667,7534,1133,94,83,11,95.55555556
d2753a9bcc0a20f4d86c17747e30b8d60df6f800,0,0,0,0,0,0,0,0,0,0,0,0,0,0,168,16,0,0,0,0,0,0,0,0,0,100
6dcf091786aef7b6975d9fe52f4411a0395e75a5,5,316,318,2,0,0,0,1,37,59,1,4,0.975132412,500,169,15,91,92,1,3945,3974,29,61,61,0,100
b4476e55426c4c62f4c90f3d4a7fec1ec3017d97,3,78,2,76,1,0,1,1,16,176,1,1,0.397974479,60,170,13,18,10,8,854,461,393,5,3,2,94.26523297
081c7162036e5f8e326af29c7584f329d6cfb591,0,0,0,0,0,0,0,0,0,0,0,0,0,0,171,12,0,0,0,0,0,0,0,0,0,100
e3a4d7d212af50ca54d1ba7a2c7d32193821ecf6,0,0,0,0,0,0,0,0,0,0,0,0,0,0,172,13,0,0,0,0,0,0,0,0,0,100
a600e20c1760563f8953002aa2bf7c1c038571c1,0,0,0,0,0,0,0,0,0,0,0,0,0,0,173,14,0,0,0,0,0,0,0,0,0,100
7151514171921b727608c5ce3abb1a9c4e1e70ba,11,25,25,0,0,0,0,1,27,16,1,4,3.33366069,701,174,15,101,91,10,5811,5424,387,58,56,2,91.23505976
6264ec4dc21cbd944a3299b8f2e5b8c04c6e7eb4,6,22,22,0,0,0,0,1,28,0,1,3,2.334209459,403,175,15,56,57,1,3434,3406,28,31,27,4,90.04149378
639f4f70228ca7625ec2975e30ff28c368c468c3,0,0,0,0,0,0,0,0,0,0,0,0,0,0,176,14,0,0,0,0,0,0,0,0,0,100
2f4e3ad5998f5f3bd2968a58a428ab0d0d5010c7,1,1,1,0,0,0,0,1,4,18,1,1,0,14,177,15,2,2,0,94,94,0,1,1,0,100
af8269b4752e9d768e1e48298e0070314f9606da,5,27,23,4,0,0,0,1,18,39,1,3,1.935646899,300,178,16,55,54,1,2418,2424,6,33,31,2,100
6b41c97d66f6944e98d3a5b27177f65efbb35bef,9,57,71,14,0,0,0,2,29,25,1,3,2.843815587,611,179,14,118,116,2,4722,4814,92,80,77,3,99.58333333
c28612eecf28af22c0ee71817dbc23a067ad11f2,0,0,0,0,0,0,0,0,0,0,0,0,0,0,180,15,0,0,0,0,0,0,0,0,0,100
c0f3cfc029136920eb1079a6ae6242ee93c9ae74,12,218,81,137,1,0,1,1,30,40,1,4,2.652334981,1035,181,12,226,211,15,9024,8345,679,149,135,14,97.10743802
db0924e6e87cc3b4c573cc66b6e4014d534d0147,10,61,42,19,0,0,0,1,38,27,1,4,3.111245988,1059,182,13,222,222,0,8244,8244,0,155,155,0,99.59016393
274d6b5755c2785139ca9bf6ddb90e63d2007757,1,2,2,0,0,0,0,1,1,0,1,1,0,52,183,14,8,8,0,411,411,0,8,8,0,98.36065574
de5133f41ab311657188515b345b23028f5fc38b,25,1404,141,1263,10,0,10,1,39,9,1,8,3.70311847,1216,184,14,390,235,155,17275,9856,7419,246,140,106,85.5513308
d91ebc623c4a55f6b0d042f1a614cee4517c19f8,1,5,3,2,0,0,0,1,6,0,1,1,0,49,185,15,10,8,2,420,402,18,2,2,0,100
181a98896580a81f05dbb37c867081f59c313320,7,133,0,133,0,0,0,1,2,0,1,3,2.807354922,460,186,15,74,74,0,3816,3816,0,46,46,0,100
0e2c67d28d16117108267787f56638932b3d3bad,3,21,23,2,0,0,0,1,22,2,1,3,1.138763195,304,187,16,60,59,1,2882,2851,31,23,22,1,100
21e49e95cfceee1b88e7b1b49188dcd6c05a9da5,2,10,1,9,0,0,0,1,40,6,1,2,0.945660305,357,188,12,70,69,1,3299,3209,90,32,31,1,100
11ffbc672bf6b58880bd43666e3d2bb0054a88b1,2,23,2,21,0,0,0,1,33,16,1,2,0.795040279,495,189,11,96,92,4,4679,4483,196,44,43,1,100
1914d2f36a625867dbe3688a6193c576cbca8b33,4,32,29,3,0,0,0,1,41,26,1,2,1.98513801,703,190,9,127,127,0,6254,6264,10,63,63,0,100
a4ed985111dce4cb3b6d1a3f91f9c1ef62a47987,7,1033,984,49,0,0,0,1,35,36,1,7,1.69536144,718,191,10,141,137,4,6553,6369,184,66,63,3,100
841051929e731edf09d1be7a9161c0773b1df65d,2,331,0,331,2,0,2,1,1,0,1,2,0.619953458,0,192,11,26,0,26,1515,0,1515,16,0,16,98.6013986
5bc2e47ed0e3cdd3827341f455918bdb35b3c640,1,25,0,25,0,0,0,1,36,0,1,1,0,287,193,12,56,54,2,2600,2459,141,31,30,1,100
d20e69b7f8c2ddcf8d1c4a9861e0adff09cb020f,1,2,1,1,0,0,0,1,37,0,1,1,0,302,194,13,56,56,0,2628,2600,28,31,31,0,100
b6fc647904c8fb6087527836d2492bc4839cc3a3,1,9,8,1,0,0,0,1,38,0,1,1,0,303,195,14,56,56,0,2628,2628,0,31,31,0,100
cdb13cefd470fb6edae253385115ead7b61a84fa,1,2,12,10,0,0,0,1,2,0,1,1,0,175,196,15,25,25,0,1279,1306,27,15,15,0,100
aa38751d0a50f9d1664e7c31ba718cce10659215,9,52,44,8,0,0,0,1,39,26,1,6,2.028663362,913,197,13,172,172,0,7928,7940,12,96,96,0,100
1d54c28587bcd555501bd317b806c9f2b10457bc,0,0,0,0,0,0,0,0,0,0,0,0,0,0,198,13,0,0,0,0,0,0,0,0,0,100
17cc468c624b1ab442ab0ed63d3b1c7e65f5f11c,0,0,0,0,0,0,0,0,0,0,0,0,0,0,199,13,0,0,0,0,0,0,0,0,0,100
ade5a3152c936835d9d23d2396e6ba1947c56181,4,45,208,163,0,0,0,1,28,10,1,3,0.900871749,503,200,14,70,91,21,3401,4252,851,29,43,14,99.30555556
575f3b3bd1e785e2009e7c7ee121008f9838371a,0,0,0,0,0,0,0,0,0,0,0,0,0,0,201,14,0,0,0,0,0,0,0,0,0,100
183471d228912054aff51160ac129d9045ae807a,5,161,7,154,1,0,1,1,42,9,1,4,1.507693843,736,202,14,152,140,12,7543,6547,996,70,66,4,99.30555556
32949947d919f1f1375ca07fd973497b8cf2b3af,1,1,1,0,0,0,0,1,41,0,1,1,0,360,203,15,59,59,0,3185,3176,9,32,32,0,100
bcf59aa9c8fa32a9e4f66a86468b7f1fb6fb2e62,10,69,20,49,0,0,0,1,42,34,1,5,2.79445872,991,204,16,178,178,0,7750,7802,52,98,98,0,97.00996678
24d427bdafc4152dccbcdfb77922a55e0c0f8e90,3,36,9,27,0,0,0,1,9,51,1,1,1.367381018,67,205,17,16,16,0,464,464,0,13,13,0,100
ddd8eb7e63dff1dfadb5f4d12f57a2bb7e5c3014,1,9,3,6,0,0,0,1,10,1,1,1,0,28,206,18,9,8,1,249,217,32,6,6,0,100
3334a92f374500c9cbedef6ae904ccf261bb47a1,5,112,75,37,2,0,2,1,18,14,1,1,2.135373884,112,207,18,16,20,4,814,894,80,5,5,0,92.56756757
d8c8300574cf8032da508eb141d0c434c0cd8719,2,3,1,2,0,0,0,1,43,14,1,2,1,603,208,18,107,107,0,5590,5566,24,48,48,0,100
37e61d6c177a539e77e849e6d3b5f274dcebdfbe,4,44,35,9,0,0,0,1,44,20,1,4,1.163331509,682,209,12,120,119,1,6359,6294,65,53,52,1,100
80ae52b160d206249f4af97c6e0878c445ee8dfa,0,0,0,0,0,0,0,0,0,0,0,0,0,0,210,13,0,0,0,0,0,0,0,0,0,100
10fdfff177b91c01a5791c639843b57a4a0cc02b,4,88,45,43,0,0,0,1,45,10,1,3,1.580532506,788,211,14,144,138,6,7264,7063,201,65,65,0,100
fd69398335da86baae743707e27be1f9cd583b5a,3,54,59,5,0,0,0,2,46,7,1,2,1.456453149,535,0,0,98,96,2,4441,4291,150,57,55,2,99.64285714
146fc24b297b0a238d2e7a4d4af8881ee0da0f26,19,1562,1919,357,2,0,2,1,47,45,1,4,3.480229571,1178,212,15,144,173,29,8619,10136,1517,78,94,16,88.81118881
7fd80c141476b27d14414bee73db5552bf341f90,4,313,312,1,0,0,0,1,8,161,1,3,1.860652866,214,213,16,30,27,3,1012,1035,23,21,20,1,100
421391d8a714002f9500f1756c8751d7e2f476ca,14,632,132,500,4,0,4,1,48,12,1,6,3.007802666,1162,214,14,254,201,53,11979,9921,2058,161,107,54,89.83606557
9e5b48a91669d3be765af9a014244559c171d96f,2,6,2,4,0,0,0,1,49,0,1,2,0.543564443,428,215,15,67,66,1,3788,3736,52,35,35,0,100
53769e4a36c60d3e8f0811617227d41098ac0bf4,14,270,698,428,0,0,0,1,50,5,1,6,3.106696632,1532,216,14,208,274,66,10497,12848,2351,115,173,58,96.25
42e16ad5593d291ac798af35a710a32413e861db,1,6,13,7,0,0,0,1,20,1,1,1,0,27,217,15,0,0,0,187,204,17,0,0,0,100
c205fd72279b707298a0514f16e99465cdb9b6bc,1,0,2,2,0,0,0,1,21,0,1,1,0,24,218,16,0,0,0,172,187,15,0,0,0,100
d57a80c0908d421c74f5387c5496e8dd05cd4564,1,2,1,1,0,0,0,1,22,1,1,1,0,23,219,17,0,0,0,172,172,0,0,0,0,100
740844d7b5c9bb93bf5038bc5b1170d7204f2b6b,5,71,23,48,0,0,0,1,51,38,1,4,1.699393471,652,220,16,127,121,6,5870,5630,240,73,71,2,100
8cfc04df68f67d9cc1ba78d28c107e4e42ba115e,1,23,19,4,0,0,0,1,2,17,1,1,0,76,221,14,21,16,5,724,704,20,6,6,0,99.06542056
db242262dfe9466c30c7b51b7184b212a5b3f406,1,1,0,1,0,0,0,2,52,5,1,1,0,372,222,14,63,63,0,3249,3243,6,32,32,0,100
9bbe097b36123a611345640cadc504e423c19050,3,18,3,15,0,0,0,2,44,8,1,3,1.409975019,286,223,15,57,55,2,2337,2218,119,35,34,1,100
22a06fbf716df8a7690f0fd6982edec44c595886,1,0,11,11,0,0,0,1,9,0,1,1,0,61,224,16,5,6,1,461,568,107,3,3,0,100
339b68623295892bef4de42a420ab3a41a35f385,1,84,99,15,0,0,0,1,9,18,1,1,0,109,225,17,14,12,2,871,865,6,4,8,4,98.08917197
221d6f082798b2df42b6bd28f516b96b6a644aff,0,0,0,0,0,0,0,0,0,0,0,0,0,0,226,12,0,0,0,0,0,0,0,0,0,100
4a7a80f0e4f72781ca0c7cff1ca9d637d7ec6b30,10,1134,1186,52,0,0,0,1,53,33,1,6,2.651248857,1206,227,10,207,212,5,9912,10245,333,103,109,6,93.33333333
f3584aca4126c312bb9b0cb28f7fb221ba26cfa2,6,1,414,413,0,0,0,1,11,57,1,3,1.642737958,494,228,11,40,89,49,1930,3752,1822,32,72,40,93.00699301
e6e94a51d88fd444ac78ca66c165d29d3ec57fa1,1,1,1,0,0,0,0,1,4,0,1,1,0,62,229,12,12,12,0,414,414,0,9,9,0,100
c3ae687034231e7a568db61c9d939454a3f36aa7,3,38,17,21,0,0,0,1,54,15,1,2,0.969010946,415,230,5,61,58,3,3785,3604,181,32,31,1,100
8bce35f57d28814e6e7444515f9be1c8e1c5afe7,3,69,22,47,0,0,0,1,6,46,1,1,1.492831828,207,231,5,43,41,2,1764,1629,135,21,20,1,100
27b65acd5878cac0989608020e7e6c37c4198d1b,1,7,2,5,0,0,0,1,5,101,1,1,0,101,232,6,23,22,1,717,689,28,10,10,0,100
d303555bcae693e29fdc78a9f1951170612e7f3c,1,7,8,1,0,0,0,1,2,101,1,1,0,43,233,7,5,5,0,357,360,3,2,2,0,100
c4d3d4dea04515b5d802916a77bd23e524e26f16,1,7,2,5,0,0,0,1,46,20,1,1,0,156,234,8,32,31,1,1295,1267,28,19,19,0,100
d5650a7df061f5dcd98a866ccbea7e34b88f1ebe,1,12,6,6,0,0,0,1,11,78,1,1,0,24,235,9,5,3,2,259,198,61,1,1,0,100
f9a15259a0df14d8a9c170b51f64d788bca0339b,1,1,1,0,0,0,0,1,12,0,1,1,0,30,236,10,5,5,0,259,259,0,1,1,0,100
a0d0b1ced5e58211f48e980d5495e4ffa0974292,1,18,2,16,0,0,0,1,4,75,1,1,0,55,237,11,9,8,1,532,414,118,5,5,0,100
97ae03b832df65465aec50478bb611b992997798,1,5,7,2,0,0,0,1,3,0,1,1,0,42,238,12,5,5,0,340,357,17,2,2,0,100
e7c42bf10849eeb51552e2fd2aa3e263b09a3bd8,7,249,179,70,1,0,1,1,55,26,1,2,1.797945574,783,239,13,144,142,2,6710,6398,312,73,71,2,90.93959732
e479a3b334bae61543e0a13bf43d7cc1fa0667fa,1,1,1,0,0,0,0,1,5,0,1,1,0,33,240,14,4,4,0,296,292,4,2,2,0,100
d1882e7b956b8992bc20be64b1992e3606e17634,4,10,8,2,0,0,0,1,56,0,1,2,1.765246528,462,241,15,68,68,0,3927,3923,4,38,38,0,100
0c5abd7582172c98b8f2914303545da788d927fd,0,0,0,0,0,0,0,0,0,0,0,0,0,0,242,16,0,0,0,0,0,0,0,0,0,100
44092e38f67a8235abe9d9f9bfc06b721b282fd1,3,61,56,5,0,0,0,1,57,0,1,1,1.127678973,610,243,17,111,109,2,4917,4947,30,58,58,0,100
de66aeba4de5f8010a80ee3adf905425e1c554e0,5,50,48,2,0,0,0,1,36,9,1,4,1.889748491,482,244,18,91,84,7,4166,4275,109,33,30,3,100
2e0fc0aa0ecbd311b304d0e9d665c23dff61e635,16,338,226,112,1,0,1,1,58,31,1,8,3.293612366,1451,245,15,271,270,1,12723,12200,523,123,123,0,92.1686747
27b751de432d1b4a258964cfbe59fb404d50d24e,4,40,6,34,0,0,0,2,14,57,1,3,1.19759824,272,1,0,49,44,5,2462,2275,187,28,26,2,100
d80a37fec6d0f96ab1d66e7b741adb7a35c9349f,2,1,6,5,0,0,0,2,25,16,1,1,0.985228136,128,246,16,26,26,0,1031,1061,30,15,15,0,100
f0453e1685f6030c3149b0d10fc5c66ca720468f,1,40,37,3,0,0,0,1,12,3,1,1,0,130,247,17,17,17,0,1104,1104,0,4,4,0,100
050e02c1e3086757e9c5836aae599a8421f36ebd,0,0,0,0,0,0,0,0,0,0,0,0,0,0,248,3,0,0,0,0,0,0,0,0,0,100
cfb87e771428bec37c114146d1e8b1e2557a208d,0,0,0,0,0,0,0,0,0,0,0,0,0,0,249,1,0,0,0,0,0,0,0,0,0,100
9711f607985fb3811b925f1853e2424fda0c700e,1,1,1,0,0,0,0,1,2,182,1,1,0,18,250,2,2,2,0,137,137,0,1,1,0,100
20850d7ac178fe52a7bdb64af8621d090eb6658a,3,68,11,57,0,0,0,1,59,75,1,2,0.939358448,680,251,3,123,119,4,6286,5832,454,58,56,2,98.06629834
b9e5fab4f3b3992edfc64cfc17fa257b1de682a4,3,51,8,43,0,0,0,1,60,0,1,2,1.086155376,726,252,4,128,123,5,6661,6286,375,60,58,2,100
2f2abcda4bb47d46c4224aa159faa195260ff674,6,290,231,59,4,0,4,1,61,12,1,2,2.31486413,435,253,4,62,61,1,3873,3710,163,27,26,1,94.1011236
d2e1db10699939a8bcb39013a57c74909fb50675,7,366,4,362,2,0,2,1,6,41,1,4,1.16286502,179,254,5,47,21,26,4019,1513,2506,19,7,12,88.43930636
9073f2b43ee6549dab1d93f95ad164221b5ad554,11,58,47,11,0,0,0,1,62,76,1,4,2.59017331,1470,255,6,276,255,21,12105,11203,902,155,148,7,96.62921348
fc92f223ce478aeac0abe861a08391952c551b30,4,211,82,129,0,0,0,1,63,27,1,1,1.602144167,771,256,7,137,138,1,6300,6331,31,70,71,1,100
dd95bc40993406dda929e84b0f4709d7e11c0c78,1,6,0,6,0,0,0,1,2,6,1,1,0,10,257,8,0,0,0,94,94,0,0,0,0,100
cc41be098627de94079adf07035cf8438eeea8cc,26,2270,2775,505,0,0,0,1,64,73,1,8,3.769638075,1994,258,8,245,309,64,14808,16909,2101,124,184,60,87.65432099
3d4dbcf37a368350ebaa996ff0eed8fa367852a7,3,73,7,66,0,0,0,2,65,21,1,2,1.531549827,776,2,0,145,130,15,7145,6831,314,67,61,6,100
3d9334156b04f272b8da67bb3a9e8fa11096d839,5,22,80,58,0,0,0,1,66,12,1,3,1.158123392,754,259,8,131,129,2,6293,6577,284,58,60,2,96.875
6e437e60f7c085057e997f278f624f82c7d9820b,12,1296,705,591,4,0,4,1,67,11,1,3,2.72479915,1263,260,7,307,239,68,13492,10786,2706,155,119,36,87.69716088
73deb95254d1edc975848b863a00e2c1ebe260d8,5,80,67,13,0,0,0,1,28,5,1,2,2.031712673,455,261,6,101,101,0,3644,3644,0,56,56,0,100
e5089632767907eab8ec8f61578c1a4e81fe9a79,6,368,24,344,3,0,3,1,68,11,1,3,1.962850913,700,262,3,151,123,28,7230,5840,1390,80,65,15,93.61179361
294b6a62bae9e990d8597489ca611fb6cc432451,3,129,68,61,0,0,0,2,69,38,1,3,1.071321847,624,263,2,114,105,9,6008,5496,512,48,46,2,100
c4c493a5675157afae5d919fd3299c75fc5e936c,4,15,6,9,0,0,0,1,19,143,1,1,1.315966997,167,264,3,18,17,1,1506,1436,70,8,8,0,100
79948e49834b5ff0c3195b03d36225d1060b2b68,1,3,3,0,0,0,0,1,20,0,1,1,0,28,265,4,3,3,0,222,222,0,1,1,0,100
94021ddfa21384e54cc054b1b5f9d64a1ed4a62a,1,8,7,1,0,0,0,1,15,42,1,1,0,23,266,5,7,7,0,163,163,0,4,4,0,100
7477670591adfdc93e78b3c914e4e6ac2e9b3f9e,7,72,27,45,0,0,0,1,70,30,1,3,2.180807439,746,267,6,135,129,6,6493,6221,272,69,67,2,100
1cc2046bdabcc18adca5f71e2f25189b84b2cf07,4,119,67,52,0,0,0,1,71,91,1,2,1.123878566,617,268,7,110,104,6,5510,5248,262,56,54,2,100
44faf8e0052de47c9652f67a65e10fac3ce3d331,6,1104,1006,98,0,0,0,1,31,4,1,3,2.483094946,499,269,7,111,97,14,4538,4073,465,56,52,4,100
026fbd361402055de5bdd2ac1271e79cbe496a54,2,2,5,3,0,0,0,1,27,72,1,1,0.863120569,62,270,0,0,0,0,503,503,0,0,0,0,100
87758f8370964fd16b97d33fecb724f877bb55aa,20,723,435,288,3,0,3,1,72,143,1,7,3.214705045,1725,271,0,351,323,28,16408,14394,2014,170,159,11,88.53211009
d46b42f53f6a91eacf63c4a952bbb1ec90320421,11,234,9,225,2,0,2,1,58,86,1,4,2.838650006,1016,272,1,201,186,15,9615,8530,1085,97,90,7,96.96969697
88f1ddb1cf2ad112cc62e8a7e932797b0e56de5c,1,1,1,0,0,0,0,1,8,192,1,1,0,16,273,2,2,2,0,120,120,0,1,1,0,100
b456224be8ba889cdd3fc60700225743f534cf58,7,289,19,270,2,0,2,1,73,10,1,3,2.599432943,1169,274,3,237,208,29,11688,10127,1561,109,95,14,91.50579151
8ff0698220a159151213ee741005eccd32312f2f,3,46,2,44,1,0,1,2,60,6,1,2,0.557266991,347,275,4,59,57,2,3047,2873,174,32,31,1,99.48979592
55a9262d0eaca527c3790ac225b99974c8f5ad52,0,0,0,0,0,0,0,0,0,0,0,0,0,0,276,5,0,0,0,0,0,0,0,0,0,100
c2ebb1c12dc565d5513b16f8a375265b0a83d9e6,7,607,50,557,3,0,3,2,61,24,1,4,2.169789335,735,3,0,188,142,46,9555,6346,3209,78,62,16,84.4017094
fe2aa8180dbd448fe467614eb2376d7a3f251f7c,11,192,174,18,0,0,0,1,74,103,1,6,2.283182144,2148,277,0,346,346,0,18918,18627,291,161,163,2,100
b8671373a5be0cc1ab032eb6c83a35b126634308,2,2,45,43,0,0,0,1,29,59,1,2,0.419921097,57,278,1,0,2,2,335,496,161,0,1,1,98.20359281
e5b28fb7ace45a878516600166d09e64dc228441,7,47,17,30,0,0,0,1,75,290,1,6,2.555090907,786,279,0,149,145,4,7013,6838,175,67,66,1,100
d274e17f39e25034bcf95c64e88390e974dcf0af,7,20,36,16,0,0,0,1,76,7,1,6,2.314910018,805,280,1,145,149,4,6952,7013,61,66,67,1,100
2dcb2ac6b30ebf0d6b04f6f6a1f07908a87c2930,1,9,0,9,0,0,0,2,51,87,1,1,0,304,281,2,65,62,3,2906,2820,86,22,22,0,100
3e4ed97294e747dd1b9152420ce614f58ac32c95,7,1075,4,1071,3,0,3,2,77,110,1,5,1.847253978,1126,282,0,316,194,122,16645,10130,6515,131,86,45,83.37730871
fb4c782fb12ba0301470aac37cf2aaf0e7e41551,2,83,3,80,1,0,1,1,53,7,1,1,0.21832103,404,283,1,93,88,5,4319,3892,427,28,26,2,99.543379
901c06e2c95d4a3f578caf0ffba8d727b6a58b97,1,1,1,0,0,0,0,1,2,0,1,1,0,45,284,2,5,5,0,427,427,0,2,2,0,100
e2eecb332cf85995caa7ca605fc94264de63a280,2,164,146,18,0,0,0,2,78,14,1,1,0.956198985,939,285,3,135,135,0,8573,8573,0,57,57,0,100
e520ed55dcac5827192ce820014c2f82ded71e80,0,0,0,0,0,0,0,0,0,0,0,0,0,0,286,4,0,0,0,0,0,0,0,0,0,100
7809e97cc21a9959491a4702c20712dfa9ea5e18,2,91,2,89,1,0,1,1,79,86,1,2,0.458685816,549,287,0,89,81,8,5427,4980,447,32,29,3,99.54751131
3f8b0feeb649294ab12f41efd3d556b68be98db9,0,0,0,0,0,0,0,0,0,0,0,0,0,0,288,1,0,0,0,0,0,0,0,0,0,100
11355a1089d1edb35e0ddea41fa2464f8e48dab2,55,139,112,27,0,0,0,1,21,259,1,15,5.304502469,5278,289,2,812,453,359,44046,28607,15439,354,194,160,72.49508841
6ba4dc3847735b294d026688d9d5a588f0bd9648,1,18,5,13,0,0,0,1,2,27,1,1,0,46,290,2,7,5,2,546,440,106,2,2,0,100
25c6bad25a8cf16ca5463459fa07e6edb0bdb88f,0,0,0,0,0,0,0,0,0,0,0,0,0,0,291,1,0,0,0,0,0,0,0,0,0,100
deeabb3aec617ef8b46770b45792372e685974ad,0,0,0,0,0,0,0,0,0,0,0,0,0,0,292,2,0,0,0,0,0,0,0,0,0,100
42584cd5328fc55a499d318dda6fefff6459242c,22,1258,1587,329,5,0,5,1,12,30,1,8,3.751432539,2522,293,3,385,417,32,19620,22106,2486,159,169,10,88.24701195
66242ee8c21a2c85ba3c1eb9da1debeb7e25a544,15,290,148,142,0,0,0,1,27,103,1,6,2.971769134,2417,294,4,414,407,7,21373,20041,1332,197,192,5,99.53488372
13fa142e5cc30470fc44730548465e23aa21a6cb,7,655,0,655,7,0,7,1,1,0,1,2,2.415478442,0,295,5,57,0,57,2601,0,2601,26,0,26,96.41255605
449e1c488609a89e9c9540b628e7b6d668ce1009,8,52,52,0,0,0,0,1,28,81,1,5,2.481243779,1784,296,6,264,262,2,15101,14931,170,112,112,0,100
2af3924eb5ba185ecdd3a142621ff3a67d4f38ab,9,192,62,130,2,0,2,1,12,100,1,5,2.259885477,1124,297,5,206,189,17,10870,9833,1037,84,79,5,87.65133172
6af8d178e629253b68c341c73507de3f7bb25517,1,0,2,2,0,0,0,1,2,0,1,1,0,66,298,5,10,10,0,523,545,22,3,3,0,100
7981a27d3cf1fd7ea59d969a106152ac4def1d5c,3,1371,1360,11,0,0,0,1,7,22,1,3,1.152922166,808,299,5,132,131,1,7589,7480,109,50,50,0,100
99d76a350fd7a034de204c8d70d4241f990daae5,4,80,58,22,0,0,0,1,29,18,1,4,0.409846263,1067,300,6,154,149,5,9291,9046,245,61,61,0,100
f43285c130f115a045c016bbb6372f321e189920,4,43,68,25,0,0,0,1,6,46,1,3,1.598637281,592,301,7,77,77,0,5201,5362,161,35,37,2,88.15165877
2127cea147cc333fdc87753c4c1f2d5e840656a8,5,242,173,69,2,0,2,1,11,117,1,3,1.867120184,588,302,8,84,72,12,5781,5370,411,41,34,7,95.16129032
94a9cb1130868938d280989e96f42af62a48477f,0,0,0,0,0,0,0,0,0,0,0,0,0,0,303,9,0,0,0,0,0,0,0,0,0,100
2733dc22dedb9e834c53eaf406ebb5da74c8c105,1,6,2,4,0,0,0,1,2,0,1,1,0,74,304,10,10,10,0,658,621,37,5,5,0,97.4459725
1fb2f56268345d7568eb69d01ccb952ccdb238a8,24,106,1144,1038,0,0,0,1,30,379,1,9,3.902618508,3167,305,9,382,476,94,20575,24206,3631,170,222,52,93.47368421
8a46ac56866f89314087588c078fa0ebed002d18,4,16,100,84,0,0,0,1,9,9,1,2,1.245410508,1296,306,10,180,189,9,11246,11518,272,75,80,5,97.60348584
0853b9077b8f86488ccbd3a037d19ae59f2eaab0,8,180,199,19,0,0,0,1,10,57,1,3,2.70540316,1515,307,10,220,210,10,13336,13543,207,89,90,1,93.5334873
62a46bba9baf29ee6a934caa763927e9006daa47,12,138,343,205,2,0,2,1,10,37,1,5,2.867790869,1116,308,11,144,148,4,8887,9784,897,55,62,7,94.60154242
be3e8684dc3dc0578d905633f95114e586f28a26,7,395,479,84,1,0,1,1,11,15,1,4,2.022956409,1879,309,12,280,272,8,15717,15779,62,113,113,0,98.44559585
6e4f673bccae7260ec25493ef43570458e617398,19,321,999,678,4,0,4,1,13,149,1,6,3.917412174,1439,310,13,188,228,40,9766,12549,2783,69,90,21,88.42975207
b910252452bfa31a0b8b543e61a1fbbb535ad333,23,912,1377,465,5,0,5,1,31,172,1,10,3.354553364,2547,311,14,364,390,26,20086,21431,1345,154,167,13,88.59416446
6dff58a6c7252a957de460809e0f5d056f539f41,8,57,204,147,0,0,0,1,14,22,1,3,2.092724945,1457,312,15,253,271,18,11784,12454,670,105,119,14,95.45454545
83226359ee28dc89ef16bd3ec420d02a7c69ddd2,3,0,3,3,0,0,0,1,9,38,1,2,1.584962501,146,313,16,25,25,0,1241,1263,22,14,14,0,100
9f9dc84d78fe87ed24b7da42741b0db6b20890a2,8,31,357,326,0,0,0,1,7,97,1,6,1.976647744,507,314,17,48,77,29,2790,4029,1239,24,40,16,95.76271186
54fba2979bbf96bfb9b366b70fecd2d1e08c382b,1,4,0,4,0,0,0,1,17,132,1,1,0,41,315,16,7,6,1,383,362,21,1,1,0,100
c453ca6efbe70262fd35250afeff8dba81d236b9,1,112,112,0,0,0,0,1,32,33,1,1,0,32,316,9,0,0,0,268,268,0,0,0,0,100
5e12164f465c6e049581d41b1816e58094c2a5cc,1,52,0,52,1,0,1,1,1,0,1,1,0,0,317,10,12,0,12,323,0,323,3,0,3,99.39759036
c2162a3a8c62086f41cd623956266459e65e9c49,3,42,19,23,0,0,0,1,15,55,1,2,1.11664043,853,318,9,142,137,5,7797,7602,195,38,38,0,100
46ba9c1fb97fd31e35edc42eb4c4887cac29db92,15,1311,1366,55,0,0,0,1,16,37,1,9,1.217297877,2655,319,9,419,425,6,21832,21981,149,180,186,6,96.25360231
04916d46ed7edc5b91f653f647f1c6ffded804de,1,24,0,24,1,0,1,1,3,1367,1,1,0,0,320,9,2,0,2,165,0,165,1,0,1,94.85861183
affa48221e1dea78ad0928ea13455d65c57a795c,11,1083,0,1083,10,0,10,1,8,95,1,3,2.931512975,31,321,6,145,8,137,4723,191,4532,89,7,82,95.21640091
91dcce2b16b401ffd98644695046c0a326c5c5ff,2,265,0,265,2,0,2,1,1,0,1,1,0.998263344,0,322,4,48,0,48,1196,0,1196,26,0,26,98.08510638
5e168fe524f54f056067b5a4cc1ecf98c1da3389,10,616,5,611,8,0,8,1,2,4,1,1,3.037393623,162,323,2,60,36,24,2068,1004,1064,46,30,16,96.38554217
1129112e77373ae770fbf9cee3e498668b8d74f5,1,3,3,0,0,0,0,2,12,120,1,1,0,17,324,2,2,2,0,133,133,0,1,1,0,100
ff891911f82431f1eb7ece5eda5d939139c958c1,4,231,2,229,2,0,2,1,6,77,1,3,0.229121398,301,325,3,82,60,22,3994,2130,1864,26,17,9,98.46449136
08d6c2045f0a908523d1405522b83e3a3e5f3d99,1,121,0,121,1,0,1,1,1,0,1,1,0,0,326,3,19,0,19,738,0,738,6,0,6,99.62121212
f7659bfebea3aa0ab5dfb97db99adc7f32a1b2cd,1,0,2,2,0,0,0,1,2,0,1,1,0,99,327,4,19,19,0,731,738,7,6,6,0,100
1d87dd22c26acaec8ab396f5f05b1121b2baa9ac,0,0,0,0,0,0,0,0,0,0,0,0,0,0,328,0,0,0,0,0,0,0,0,0,0,100
5c032322707f592aa1245265d07d2653d0a70fa0,0,0,0,0,0,0,0,0,0,0,0,0,0,0,329,1,0,0,0,0,0,0,0,0,0,100
5df17dea14721a0785cc114ef2299be5cab95a1b,0,0,0,0,0,0,0,0,0,0,0,0,0,0,330,2,0,0,0,0,0,0,0,0,0,100
46b52606e5aa92156799460b8225d75c31f4bf2d,0,0,0,0,0,0,0,0,0,0,0,0,0,0,331,3,0,0,0,0,0,0,0,0,0,100
82be6072d4c8143d2a03dd93f67aba8505e70f71,1,19,10,9,0,0,0,1,22,445,1,1,0,28,332,4,4,3,1,263,226,37,1,1,0,99.81132075
a9f0777b6cfb6b4258c858fa5de58e36cd2ad937,13,210,242,32,0,0,0,1,17,331,1,5,3.059324921,2113,333,3,314,321,7,18377,17760,617,119,130,11,93.97089397
b8c9fb4c652bf35ad8c4d552407d3ffb68b4464c,2,2,2,0,0,0,0,2,3,252,1,2,1,366,0,0,72,72,0,2408,2408,0,29,29,0,100
52be306fe6fb43e9bc6c8d34f17c5d94967d246e,3,54,12,42,0,0,0,1,2,543,1,2,1.06479483,320,334,0,56,51,5,2411,2145,266,22,20,2,100
78e2928698eed17a356fe9047af93ac724e87f74,0,0,0,0,0,0,0,0,0,0,0,0,0,0,1,1,0,0,0,0,0,0,0,0,0,100
74f50acdb93f27e713200439e65c28a84eb88c21,16,69,49,20,0,0,0,2,3,143,1,3,2.700923275,1161,2,1,228,287,59,7525,7962,437,129,143,14,91.62679426
51747279bbf05316e4a0f73ed898ae984e64dd9c,0,0,0,0,0,0,0,0,0,0,0,0,0,0,3,2,0,0,0,0,0,0,0,0,0,100
850023efb960ed489c0ff509bf8df1a60af6e97a,0,0,0,0,0,0,0,0,0,0,0,0,0,0,335,0,0,0,0,0,0,0,0,0,0,100
25487560042e8eec331f02c5974d83cd8b91d981,0,0,0,0,0,0,0,0,0,0,0,0,0,0,336,1,0,0,0,0,0,0,0,0,0,100
d7b035a4285b45fb8281089ef1f1144c25cf9c90,26,640,621,19,1,0,1,1,18,345,1,7,3.216392792,2699,337,2,401,352,49,24352,22305,2047,146,126,20,84.79809976
200efca535241de23d8aadce9e36026e212f40ee,13,432,373,59,1,0,1,1,33,42,1,8,2.003137359,1743,338,3,279,326,47,15508,16672,1164,105,90,15,91.35021097
7f23f104c3080fdf019943508bc2d43353835443,1,25,0,25,1,0,1,1,1,0,1,1,0,0,339,2,1,0,1,35,0,35,1,0,1,99.609375
ef5a602fd8bbc2a8c8a10a637d040d5243c59022,4,2,172,170,0,0,0,1,11,11,1,2,1.135843322,160,340,3,14,25,11,597,1499,902,3,8,5,93.95833333
abf6c7d31d2e64dc0ffcbcef6df751f86891e0eb,0,0,0,0,0,0,0,0,0,0,0,0,0,0,341,4,0,0,0,0,0,0,0,0,0,100
2ab03d384eccdd4b7f5e2189d6a042c7d12809b4,0,0,0,0,0,0,0,0,0,0,0,0,0,0,342,5,0,0,0,0,0,0,0,0,0,100
11a1230418126da1b59e68877d45f1c88007a154,59,3924,962,2962,30,0,30,1,34,123,1,7,5.180907935,1557,343,5,591,263,328,20910,10137,10773,383,140,243,80.90551181
c11bfd11b205e26e08839f0fc455d1c6f26364d6,0,0,0,0,0,0,0,0,0,0,0,0,0,0,344,6,0,0,0,0,0,0,0,0,0,100
5faccbf1efe0335a1671eb4920b53077d75e9cf7,4,21,12,9,0,0,0,1,4,8,1,3,1.162684885,409,345,6,62,61,1,2347,2335,12,40,39,1,97.83693844
2d95981f891a6f1c231d4a61af9f00f068f557d8,0,0,0,0,0,0,0,0,0,0,0,0,0,0,346,7,0,0,0,0,0,0,0,0,0,100
8fa74ce7ba5c928f6fa1da999b973aa38b11aede,1,2,3,1,0,0,0,1,3,11,1,1,0,58,347,8,13,13,0,375,378,3,6,6,0,100
0372a9dab3b2b481aae787e6e464a400c436a2ce,6,223,92,131,1,0,1,1,2,20,1,2,1.641649054,227,348,5,54,41,13,1953,1462,491,31,33,2,98.4399376
c6a845431c6a1f2555721511e90e1356221c8052,5,43,62,19,0,0,0,1,5,16,1,3,1.484518319,358,349,6,58,57,1,2439,2445,6,25,24,1,98.28393136
e82058158019ad3fcf63de2d75ffceb7b9a69df5,2,7,7,0,0,0,0,1,4,0,1,2,0.863120569,108,350,7,17,17,0,816,816,0,5,5,0,100
cb90523cd128531d0ca02d82bd9d41d81c5f5402,2,61,3,58,1,0,1,1,2,16,1,2,0.543564443,72,4,0,17,13,4,839,454,385,12,10,2,97.32888147
45159a256f2f569dc474e409daa009d018722e14,16,8,750,742,0,0,0,1,23,310,1,4,3.746445404,1516,351,8,171,245,74,9000,13389,4389,74,98,24,94.83394834
cf9c1ad1616e49dd316df272863a1bebc3156ba9,0,0,0,0,0,0,0,0,0,0,0,0,0,0,352,9,0,0,0,0,0,0,0,0,0,100
ce434879ed0bebbaf33de64c0191240b694fb827,12,7,12,5,0,0,0,1,20,83,1,3,3.471354487,1293,353,0,189,153,36,10989,10501,488,79,56,23,97.68339768
25542406b5608afef639e201854acb831773e6b3,13,387,191,196,3,0,3,1,6,58,1,4,2.633027025,1420,354,1,267,245,22,10204,9122,1082,147,129,18,93.11531842
93cc7b4af300359a2c4ae4c438a691ab9813c95f,5,304,4,300,2,0,2,1,35,171,1,3,0.856911118,90,355,2,49,11,38,2416,671,1745,17,10,7,99.23430322
fa31eda12ebdb6bfa1d2de5ca3f967a9d3dba87c,3,37,37,0,0,0,0,1,36,0,1,3,0.668912825,252,356,3,37,34,3,1902,1890,12,21,19,2,100
5dbe1b8b35d02c4f83258cf5bc6e6205b65c63a5,0,0,0,0,0,0,0,0,0,0,0,0,0,0,357,4,0,0,0,0,0,0,0,0,0,100
0d8f1131845b4d755ba2f3a239b4cb0203acb136,3,14,18,4,0,0,0,1,7,0,1,1,0.818091464,756,358,5,133,133,0,4799,4812,13,76,76,0,100
a764f7042487fc6a8d1a688e6f83bdd1048eeabd,0,0,0,0,0,0,0,0,0,0,0,0,0,0,359,6,0,0,0,0,0,0,0,0,0,100
f7c9256bdda0c829f8dbe9a6fb6bad7850408bde,0,0,0,0,0,0,0,0,0,0,0,0,0,0,360,7,0,0,0,0,0,0,0,0,0,100
91153873c8ebfaeca90e9e07b66c042f0d32929f,0,0,0,0,0,0,0,0,0,0,0,0,0,0,361,8,0,0,0,0,0,0,0,0,0,100
2ae4420c9034f237a7658871b6f058eca817d67d,20,530,168,362,2,0,2,1,37,49,1,5,2.973852782,1977,362,9,371,332,39,14300,12332,1968,212,198,14,93.9628483
677c599f5e2e0d8ea5f69e677915f4adf7ffe8f0,1,4,27,23,0,0,0,1,5,74,1,1,0,154,363,0,23,28,5,923,1092,169,16,16,0,100
32d0d17bc0b02d01ea682c55995641c5fdebafa7,10,116,53,63,0,0,0,1,9,84,1,2,2.638963508,982,364,1,176,166,10,6839,6506,333,97,92,5,98.90282132
2f4315ec31e17f8c9738540c3e4db8a7b52795be,9,257,109,148,1,0,1,1,14,96,1,3,1.376896371,1687,365,0,309,297,12,11534,10675,859,161,159,2,98.59375
27cf2390bbbbfaf32efc03479b44645346423929,1,28,26,2,0,0,0,1,2,20,1,1,0,111,366,1,13,13,0,868,835,33,2,2,0,100
9e299cf1a820685e52e8dd7e456ad788e75285a1,6,6,46,40,0,0,0,1,7,72,1,2,2.213613685,1476,367,2,257,258,1,9087,9275,188,137,137,0,97.16088328
8c963c6fa649fc71fd50e9f5d1178d2d818736a7,3,23,14,9,0,0,0,2,8,33,1,2,0.811710315,949,368,2,177,177,0,6134,6121,13,85,85,0,100
64d15f211acfc1fc4df7312c337ffe89a9d41b08,11,124,214,90,0,0,0,1,38,70,1,3,2.216974457,1826,369,3,301,299,2,11575,11618,43,159,159,0,96.41744548
5ab76357b0b7441bc0fe62588545846d65b8a15c,0,0,0,0,0,0,0,0,0,0,0,0,0,0,370,4,0,0,0,0,0,0,0,0,0,100
3011f32637f55c103bb5157210c0d24824139f08,5,57,100,43,0,0,0,1,12,0,1,1,1.606090564,1214,371,5,216,219,3,7581,7846,265,107,110,3,100
674b9dd45d96e3b455a29d45d42705f0993520e5,1,1,1,0,0,0,0,1,8,62,1,1,0,226,372,0,40,40,0,1469,1469,0,24,24,0,100
073b50486309db03507dff7867b1c797049e8f5b,4,22,13,9,0,0,0,1,11,45,1,1,1.629099637,1136,373,1,212,214,2,7457,7407,50,109,111,2,100
c5f0e6adca352b638e10b62ac180d9447cf314b8,1,4,4,0,0,0,0,2,12,5,1,1,0,459,374,2,86,86,0,3004,3004,0,45,45,0,100
387fbcbadf75df3ec704e25e2a0ced2dc5d8cc39,1,9,2,7,0,0,0,1,3,273,1,1,0,101,375,3,18,17,1,628,567,61,13,12,1,100
77dce9e0cfc0f538e3dc0c3717410332b978f88f,1,1,1,0,0,0,0,1,2,395,1,1,0,76,376,4,11,11,0,583,583,0,8,8,0,100
a4a9503d0f73165bd10fc3c7f96ebfc3b0ab98c9,12,342,158,184,0,0,0,1,13,129,1,2,2.642072945,1862,377,5,363,333,30,13031,12017,1014,197,189,8,96.79487179
46ae2cb13bbd39c72e772a8aa8256663313df7fe,4,12,13,1,0,0,0,2,14,51,1,1,1.535482555,1100,378,6,210,210,0,7308,7333,25,93,93,0,100
e3d006b470db1dcac15d0d8a4331cd39bfbf27f2,6,162,38,124,3,0,3,1,15,50,1,3,2.276752232,1077,379,7,213,209,4,7923,7447,476,86,82,4,92.02898551
b166be614bc2d47545a6c8e5194803974fd7e9cf,56,3,7449,7446,0,0,0,1,39,550,1,8,5.384567399,4973,380,8,32,804,772,1600,42298,40698,19,350,331,70.11278195
5fa3c78d8d41a6445182ca30f1b26e521fe4d96c,1,1,1,0,0,0,0,2,14,0,1,1,0,380,381,9,78,78,0,2530,2530,0,29,29,0,100
9ce7c3357aed35b2f39a73fb125c47d6d58e9bd2,9,1235,17,1218,1,0,1,1,40,208,1,7,0.306487522,850,382,10,325,150,175,11091,6028,5063,147,77,70,98.57142857
f9347bdb867346094b1152d2f789f02a817ca08c,1,0,2,2,0,0,0,1,3,291,1,1,0,30,383,11,5,5,0,159,175,16,5,5,0,100
2e9212ec1b9e781a58a1e87c7df4485dc16d9eea,4,81,35,46,0,0,0,2,17,77,1,2,1.25483828,723,384,12,141,133,8,5166,4977,189,76,73,3,100
38d13ebfdc14a02ccbb4a8d8972823f1f7383a7f,1,1,2,1,0,0,0,1,8,8,1,1,0,137,385,13,22,22,0,915,920,5,14,14,0,100
d5f9ffcac2676ae9da7f85f8da7146720f3c0adc,11,153,40,113,0,0,0,1,11,103,1,4,3.284102109,1475,386,14,318,323,5,10967,11166,199,141,145,4,91.97324415
81266da230328ae7e6720c4035ab01eb2d0b71db,4,202,6,196,0,0,0,2,18,207,1,1,0.494305466,917,387,13,216,177,39,7084,6061,1023,114,102,12,100
eb8af04c6c8c90f63c61498c5e93bd6d0aa455fc,1,2,2,0,0,0,0,2,15,15,1,1,0,380,388,14,78,78,0,2534,2530,4,29,29,0,100
5392cbc6663d7e5a123149b21e61a1bf3111088a,2,0,8,8,0,0,0,1,16,5,1,1,0.954434003,530,389,15,104,105,1,3502,3551,49,45,46,1,100
c9a287325fa46e12cfed015c879c9da87c435bf8,1,1,1,0,0,0,0,2,17,2,1,1,0,376,390,16,77,77,0,2515,2515,0,28,28,0,100
12a9db0e050484189d861d45dd7ca019fc8c2413,6,114,21,93,0,0,0,1,19,78,1,2,2.295548996,1316,391,17,259,248,11,9295,8759,536,123,117,6,100
9cb40203cc917a209ff3673956b823690c0bf241,0,0,0,0,0,0,0,0,0,0,0,0,0,0,392,18,0,0,0,0,0,0,0,0,0,100
efccc9a3dce210f86c04d3abfa16083d217ff123,11,555,93,462,4,0,4,1,10,318,1,4,2.560513302,412,393,19,143,59,84,4933,2614,2319,59,28,31,88.01169591
c57cd5a7e98fbe5cd17af3bf247440c1b2f71a62,1,8,7,1,0,0,0,2,19,0,1,1,0,382,394,20,79,79,0,2584,2584,0,28,28,0,100
d258099c43f39f1a68359f0d3c61e5d1d81fe929,0,0,0,0,0,0,0,0,0,0,0,0,0,0,395,21,0,0,0,0,0,0,0,0,0,100
e37347ee8809ac1b83245270d0b9a0251f4a8a6b,2,8,8,0,0,0,0,1,4,7,1,2,0.543564443,315,396,22,59,59,0,2245,2245,0,14,14,0,100
1fc116d652ead112bc1a2249058dbe34e6d38065,1,1,1,0,0,0,0,1,12,3,1,1,0,73,397,22,9,9,0,608,600,8,4,4,0,100
1fad5eddfe99205cf46858ca9d0d1a7cf900e35d,1,1,1,0,0,0,0,1,13,0,1,1,0,73,398,23,9,9,0,600,608,8,4,4,0,100
852d31cb094e62608a83c812fe6dc44ac3a6ec56,2,5,115,110,0,0,0,1,14,11,1,2,0.286396957,149,399,23,10,20,10,626,1181,555,4,12,8,93.31395349
6d5cf53e804fc554b867f8439371c9dd4b2d7810,1,7,2,5,0,0,0,2,20,9,1,1,0,494,400,24,98,98,0,3410,3382,28,47,47,0,100
6ad1a0ef5dcefa0d4a1924f9385da1a34c45adbb,2,146,1,145,1,0,1,1,2,4,1,2,0.103843651,133,401,25,42,25,17,2144,937,1207,17,8,9,91.34078212
ec0a6f81fc8e8232f86a0cc9141450dcfebfa50d,1,1,1,0,0,0,0,2,16,9,1,1,0,232,402,26,38,38,0,1518,1493,25,19,19,0,100
b31f80ede04b980778b305e6e5a3951e1bf8bc80,5,30,26,4,0,0,0,2,20,90,1,2,1.763929379,686,403,27,124,125,1,4641,4588,53,51,52,1,100
a62688cbd3d5ec619399e2b575f6574990640fdd,1,1,1,0,0,0,0,2,21,8,1,1,0,499,404,28,98,98,0,3410,3410,0,47,47,0,100
37afe5954846ef8f56f5d1c2d2d4f7a921eea9fe,10,508,2,506,2,0,2,1,11,8,1,5,2.076385821,739,405,29,182,133,49,7737,5382,2355,83,59,24,98.98989899
ec8eadc01f67617c17162bc21dfe7053df990554,1,0,32,32,0,0,0,1,11,38,1,1,0,31,406,28,4,8,4,111,189,78,3,7,4,100
0949d5f8728a1bab48c91afb3ea1a188e990c843,1,36,29,7,0,0,0,2,21,11,1,1,0,382,407,29,80,79,1,2596,2584,12,28,28,0,100
619d38013b52a850a95b01c2943d53656b51354b,10,219,87,132,1,0,1,1,22,102,1,2,1.965064284,864,408,27,175,159,16,6408,5830,578,95,86,9,91.42857143
c96143196343653acea72cadc3d12ea032ddc877,0,0,0,0,0,0,0,0,0,0,0,0,0,0,409,25,0,0,0,0,0,0,0,0,0,100
2b6cc18ebff6c33b217e9cc6774d7ee244e8c553,0,0,0,0,0,0,0,0,0,0,0,0,0,0,410,25,0,0,0,0,0,0,0,0,0,100
37ae3dd6d2419118c1a3a8d7de9e7d92ab1ba226,1,8,2,6,0,0,0,1,3,38,1,1,0,88,411,24,18,17,1,649,608,41,12,12,0,100
83b8f23f5173b78f9cc56552c762e9a7440ba9da,11,143,124,19,0,0,0,2,23,20,1,3,3.045429761,2053,412,25,381,381,0,14126,13953,173,173,175,2,100
1be11cd182293897994e2d5b0574f34d9e88c9bb,0,0,0,0,0,0,0,0,0,0,0,0,0,0,413,16,0,0,0,0,0,0,0,0,0,100
61dd2726eeab1555ad2c488f34c0b759c1378f62,1,4,2,2,0,0,0,1,5,6,1,1,0,139,414,15,26,26,0,1013,1000,13,8,8,0,100
6932ea7bf99da3e9073afa42b9b474b0cf6b0440,0,0,0,0,0,0,0,0,0,0,0,0,0,0,415,16,0,0,0,0,0,0,0,0,0,100
0ac5d2c9725c41a692dac890d3d597b1ef1e53aa,1,1,1,0,0,0,0,1,6,9,1,1,0,16,416,16,0,0,0,123,123,0,0,0,0,100
9f15b90aecf10a411e5cdda70493b40efabd9d90,4,7,7,0,0,0,0,1,23,25,1,2,1.291691997,995,417,17,195,201,6,6486,6713,227,96,97,1,100
891de970975a94e2b0b61458f1f042a7457f0a88,1,41,14,27,0,0,0,1,6,5,1,1,0,140,418,18,31,26,5,1133,1013,120,9,8,1,100
ac387220dbda0c0bb97297462d6eb518dcc571a8,2,19,15,4,0,0,0,2,8,15,1,2,0.672294817,101,419,13,16,16,0,815,801,14,8,8,0,100
bd9b16831a8b820053daaca4adb1f3a58a9d9f86,0,0,0,0,0,0,0,0,0,0,0,0,0,0,420,14,0,0,0,0,0,0,0,0,0,100
325b2b6a83852436b502b2204bdbde3ac1df1791,0,0,0,0,0,0,0,0,0,0,0,0,0,0,421,13,0,0,0,0,0,0,0,0,0,100
019e3b60a48ef1cd35aa76aa9e0b14d0aaff290d,1,18,38,20,0,0,0,1,7,13,1,1,0,163,422,14,25,31,6,1034,1133,99,8,9,1,100
112785fb145ad473d1858381f7bdbb38022b6c96,4,26,0,26,0,0,0,1,2,80,1,1,1.479226995,234,423,12,38,38,0,1542,1542,0,15,15,0,100
1120a7617e69945e49f3a7e10421c6b8d3b18c0d,3,11,3,8,0,0,0,2,24,47,1,2,1.492614068,536,424,11,104,102,2,3583,3545,38,41,41,0,100
0936f598c88c2ecbb1ed164c3143a591e63d3f36,0,0,0,0,0,0,0,0,0,0,0,0,0,0,425,12,0,0,0,0,0,0,0,0,0,100
23f871513490c178819c40b2ecff712851ffbed3,0,0,0,0,0,0,0,0,0,0,0,0,0,0,426,13,0,0,0,0,0,0,0,0,0,100
cd3d7222812debea95c50d5c146d8007b4ab309d,10,140,34,106,0,0,0,1,25,95,1,2,2.800072984,1713,427,13,335,323,12,11800,11399,401,174,165,9,95.34883721
66493212565c4d2632fe365b533df12b514d4de1,0,0,0,0,0,0,0,0,0,0,0,0,0,0,428,14,0,0,0,0,0,0,0,0,0,100
fb37f28c232d16e693252f9f8e58c8800b4bed29,0,0,0,0,0,0,0,0,0,0,0,0,0,0,429,15,0,0,0,0,0,0,0,0,0,100
dd9482141d56d9356a4efa3014626da695246b6a,7,102,39,63,0,0,0,1,26,20,1,3,2.145458991,1491,430,15,294,286,8,10260,10083,177,137,130,7,92.78996865
6f36f5f2fa3c7e9fb6c4faa79f6122e023827cd9,0,0,0,0,0,0,0,0,0,0,0,0,0,0,431,15,0,0,0,0,0,0,0,0,0,100
929aed1da6db6caff532d09966180d74dd9e24c6,2,5,214,209,0,0,0,1,16,31,1,1,0.377238241,539,432,16,83,111,28,2622,3641,1019,36,53,17,95.22292994
2fd2c502a9b9f9f56ae156072ae60a0cce1d0cc1,2,2,2,0,0,0,0,1,4,279,1,1,1,152,433,17,28,28,0,889,889,0,17,17,0,100
c5c8f7884c2b68d71debd9a213bb2d2b333c1e3e,0,0,0,0,0,0,0,0,0,0,0,0,0,0,434,16,0,0,0,0,0,0,0,0,0,100
4c71d7b0dc7d003d89a22e996bff80938851381d,6,89,56,33,0,0,0,1,24,108,1,2,1.938944433,890,435,17,161,150,11,6161,5802,359,84,81,3,100
f71337abaaf9256889860927623f2f937899e8fa,1,4,10,6,0,0,0,2,25,0,1,1,0,505,436,18,97,98,1,3393,3410,17,46,47,1,100
99e40d4772f1d55c3d3ef8a1c31b1a94a2cd6376,1,8,1,7,0,0,0,1,19,0,1,1,0,78,437,19,11,10,1,662,630,32,4,4,0,100
72d075d10db843e2e749e2daa9c7f0c8ac9b0a06,1,14,14,0,0,0,0,2,26,31,1,1,0,501,438,14,97,97,0,3393,3393,0,46,46,0,100
dea2b9b267ee60c46d982f51d4204279647c0a72,0,0,0,0,0,0,0,0,0,0,0,0,0,0,439,5,0,0,0,0,0,0,0,0,0,100
3df54189a2323f482006f4d4b4f9ac4866a5bc46,0,0,0,0,0,0,0,0,0,0,0,0,0,0,440,2,0,0,0,0,0,0,0,0,0,100
ea8db3913f6c10d99431b00d09d5a99522098260,1,2,2,0,0,0,0,1,4,115,1,1,0,113,441,3,24,24,0,697,697,0,8,8,0,100
14745479db6456278d229fa3f025fa4b9fa06f58,10,154,229,75,0,0,0,1,27,212,1,1,2.720218951,1810,442,4,360,352,8,12202,12010,192,163,164,1,90.14925373
daba6c7c8167ef9c15cb346c283e7091e8c855f2,1,1,1,0,0,0,0,2,28,0,1,1,0,461,443,5,92,92,0,3023,3023,0,35,35,0,100
a9af676f8ceca1432b52788834b1bb340167f92e,6,30,30,0,0,0,0,1,29,11,1,1,1.869134464,1548,444,6,307,307,0,10252,10252,0,135,135,0,98.84393064
1ce61404daac6bebfdd561228f5c8e2a3e2dc921,10,120,99,21,0,0,0,1,30,150,1,2,2.211535079,1737,445,6,334,333,1,11482,11476,6,172,171,1,87.1641791
9f5ee1791ef9bbcce98bd5278079cc6b5a976694,0,0,0,0,0,0,0,0,0,0,0,0,0,0,446,7,0,0,0,0,0,0,0,0,0,100
27eddd69e0f2a4446b8af7c3d45749a8fed02b27,6,35,29,6,0,0,0,1,31,78,1,2,2.31380211,1598,447,5,324,323,1,10649,10633,16,151,151,0,98.7654321
2a32f6c9ce835ce46504df93cf0270dd89dbb467,1,0,1,1,0,0,0,1,8,0,1,1,0,149,448,6,35,35,0,937,946,9,27,27,0,100
37326db4790e1f58e4390af4f5475370b282420f,5,34,33,1,0,0,0,1,31,26,1,1,1.724700356,1335,449,7,263,264,1,9059,8988,71,134,134,0,100
655549cdcf6ad85b7c375a5563aacd6d434f1f65,2,4,11,7,0,0,0,1,21,100,1,2,0.566509507,513,450,8,98,100,2,3521,3593,72,38,38,0,100
5316b8bdf6af8292fbaa0cb52d69b19320e77285,0,0,0,0,0,0,0,0,0,0,0,0,0,0,451,9,0,0,0,0,0,0,0,0,0,100
59fe309a48ebfe92e617fa4aa003596024298f49,2,21,3,18,0,0,0,2,14,4,1,1,0.954434003,317,452,10,63,61,2,2214,2134,80,44,42,2,100
4635151b66f4ac319a944a0f1776a4fe72eea9a8,2,24,2,22,0,0,0,1,15,2,1,1,0.391243564,291,453,11,58,53,5,2066,1997,69,35,32,3,100
d14d446d2750310832b7ba6b6a803bcf7aad6739,5,34,10,24,0,0,0,1,32,56,1,2,1.651631118,1166,454,12,230,226,4,7997,7819,178,106,105,1,100
71f6a766a2d2d7e4bd9dc3ab1c028dc63a1a449e,1,3,0,3,0,0,0,1,20,107,1,1,0,82,455,10,11,11,0,699,662,37,4,4,0,100
640b22759e3347c871bf96c9610e87f53f3c95d0,30,1962,546,1416,11,0,11,1,41,90,1,5,4.09284124,2624,456,0,668,501,167,23327,17069,6258,375,282,93,80.06644518
916be4c2b99e07445ea109b5f3521f0a41cf0b23,0,0,0,0,0,0,0,0,0,0,0,0,0,0,457,1,0,0,0,0,0,0,0,0,0,100
617c06ad89589d7fb1c7b99112cc5d5458f67e7c,0,0,0,0,0,0,0,0,0,0,0,0,0,0,458,2,0,0,0,0,0,0,0,0,0,100
9c099253547fad4a3398452c59e6eac0ffda5949,15,622,125,497,2,0,2,1,34,98,1,3,2.629047567,1779,459,3,379,331,48,13952,11850,2102,186,161,25,84.66076696
a33c52b6f4a300eb011610ec3a130c61a430e93b,1,5,5,0,0,0,0,2,23,3,1,1,0,249,460,4,43,43,0,1596,1596,0,24,24,0,100
16ae9ff6eb20b60214647a9442d2532c3b8a5fb8,2,27,28,1,0,0,0,2,35,10,1,1,0.999761525,1102,461,5,213,215,2,7395,7368,27,96,96,0,100
3bdaa068f30264c72d9febe91fc623a3e98d6c33,4,10,15,5,0,0,0,1,35,49,1,1,1.60273954,1246,462,6,256,256,0,8377,8401,24,125,125,0,100
2a3717fa7c97b6b5bfd36e538529d5508119e462,2,398,0,398,2,0,2,1,1,0,1,1,0.698201288,0,463,7,45,0,45,1698,0,1698,24,0,24,98.7654321
a55a36f3a0d03ff99c0a6deb97f59ee92b2a3261,3,34,1,33,0,0,0,1,2,12,1,1,1.158604828,278,464,8,45,45,0,1755,1755,0,24,24,0,100
89596c3611fd1a5bab1558fdc96917ba94f5adfd,0,0,0,0,0,0,0,0,0,0,0,0,0,0,465,9,0,0,0,0,0,0,0,0,0,100
f44435f62fcc93e6e95660a75105782ba8815ee5,2,2,17,15,0,0,0,1,12,27,1,2,0.831474388,296,466,9,59,60,1,2013,2039,26,34,35,1,100
b14825e01cd30e72d65cfb0303616ee9dc470af4,1,1,0,1,0,0,0,1,13,6,1,1,0,150,467,10,25,25,0,1115,1109,6,8,8,0,100
fa36b2b182d4ea2cda667052c09fca49e44dd61c,1,4,60,56,0,0,0,1,2,36,1,1,0,155,468,9,20,30,10,929,1187,258,7,9,2,100
6aabbc06769b41c79f5245583993e978e9aa4213,2,77,17,60,0,0,0,1,22,58,1,1,0.998693408,132,469,3,20,17,3,1596,1074,522,8,8,0,100
5c90fc95ea37232be759d1ec6a5d5babdf5950be,1,0,2,2,0,0,0,1,11,0,1,1,0,80,470,4,8,8,0,669,694,25,4,4,0,100
93a09403e7d84bdd9f5052c37063bac41f20db3c,1,1,1,0,0,0,0,1,24,45,1,1,0,409,471,5,88,88,0,2787,2787,0,36,36,0,100
86066c3d945c44b495330087d28d771955192cc5,2,5,3,2,0,0,0,2,24,45,1,2,1,354,472,4,55,55,0,2527,2498,29,28,28,0,100
cbd8cfcc120038f3153f02c2c22b693e4fd2b860,3,67,55,12,0,0,0,1,25,11,1,2,1.128003793,594,473,5,113,108,5,4416,4384,32,47,44,3,100
a21a43cf63c6a9921fd41aa2edc76292098c26d4,1,18,1,17,0,0,0,1,25,0,1,1,0,100,474,6,15,12,3,973,867,106,6,4,2,100
937330062b7f40a56b0c6ddd1ea1e61139e23713,1,1,1,0,0,0,0,1,26,0,1,1,0,408,475,7,88,88,0,2786,2786,0,36,36,0,100
a2ba796c9796724f4a63c824718ef13744628d32,1,15,16,1,0,0,0,1,26,0,1,1,0,115,476,7,15,15,0,933,973,40,7,6,1,100
2b1b2acf5f5470081180b019acd73b72e7007ce4,1,7,7,0,0,0,0,1,27,0,1,1,0,113,477,8,15,15,0,933,933,0,7,7,0,100
211912eb978a59764de69204d98a3f6e0970a165,12,217,63,154,1,0,1,1,42,113,1,3,2.404279001,2346,478,9,470,454,16,16375,15649,726,239,233,6,95.94272076
bd34a7458ca9b0de35219ff6ebcd3ced9d6f55b1,1,1,1,0,0,0,0,1,13,18,1,1,0,95,479,10,13,13,0,763,763,0,7,7,0,100
a5f87708b2b48d90d0db19bcbe4f98e2565a385a,1,3,4,1,0,0,0,1,2,0,1,1,0,77,480,11,7,8,1,607,619,12,4,4,0,100
2ac72e7ab0e52634871eeee5e7b0761aaa786d6a,3,16,6,10,0,0,0,2,43,0,1,3,1.342019218,358,481,12,52,51,1,2545,2456,89,29,29,0,98.11320755
71a52ff86c06153af31f71ff8d04f13acaa851ff,3,1,11,10,0,0,0,2,44,0,1,3,1.188721876,365,482,13,52,52,0,2515,2545,30,29,29,0,98.11320755
a9c57156e44e8ed8fe46dcec85265d789d0fc6ae,3,21,10,11,0,0,0,1,28,28,1,1,0.547553155,306,483,14,54,54,0,2021,2007,14,32,32,0,100
9b3649aa0f1ecfa4b7fde7964f02eb550d18e77e,1,0,2,2,0,0,0,2,29,0,1,1,0,254,484,15,44,44,0,1613,1627,14,25,25,0,100
4dc6dfb28012b002ea3a883fdbca5de6dbafa8ea,1,27,1,26,0,0,0,2,30,8,1,1,0,252,485,13,49,44,5,1769,1613,156,26,25,1,100
8b10292e64157ec3fae96cf13773bb39316c147a,0,0,0,0,0,0,0,0,0,0,0,0,0,0,486,14,0,0,0,0,0,0,0,0,0,100
1eaff5d8cf541bf30cf7a136a34ecf117749b980,0,0,0,0,0,0,0,0,0,0,0,0,0,0,487,15,0,0,0,0,0,0,0,0,0,100
77e14468aefebc49396530545899912581254bcf,35,249,195,54,0,0,0,1,45,216,1,5,3.450237296,3733,488,16,681,690,9,24747,24977,230,379,380,1,100
209411b64d59fe5d1764c6d3ac48c43ce5aa9138,1,0,6,6,0,0,0,1,6,137,1,1,0,122,489,17,25,25,0,714,770,56,9,9,0,99.29742389
2676c22ef94953f78b236c744948edc6b2d35f9f,20,150,266,116,0,0,0,1,38,251,1,2,2.612297785,3009,490,12,569,579,10,19257,19633,376,298,308,10,96.33027523
121473c4d900dd1f6786027afbff4bbd47614e83,0,0,0,0,0,0,0,0,0,0,0,0,0,0,491,13,0,0,0,0,0,0,0,0,0,100
7f9861238266dd4f07b6f581865d19acfc7af245,0,0,0,0,0,0,0,0,0,0,0,0,0,0,492,14,0,0,0,0,0,0,0,0,0,100
5cca1d9544c4277acb62636634b4c8af0dc8b4bb,1,12,0,12,0,0,0,1,30,0,1,1,0,408,493,15,91,88,3,2845,2773,72,36,36,0,100
619db1c7c290d5c3df96793ea60c90e91eb9904d,1,2,1,1,0,0,0,2,39,0,1,1,0,663,494,16,128,128,0,4540,4533,7,56,56,0,100
0a2fc4b838634d95512d8f7c113b5f4705fb9e1d,0,0,0,0,0,0,0,0,0,0,0,0,0,0,495,17,0,0,0,0,0,0,0,0,0,100
b6b51e042cb61f2339b67f014ed8af8b6f08e66d,1,33,0,33,0,0,0,1,31,19,1,1,0,417,496,11,101,91,10,3037,2845,192,37,36,1,100
eaf0a85a9862dd407ef9c9017c0b1310521f02e0,1,13,22,9,0,0,0,1,32,0,1,1,0,448,497,12,95,101,6,3015,3037,22,36,37,1,100
d0483621171f66254aa3fb19f097a67e786317ab,0,0,0,0,0,0,0,0,0,0,0,0,0,0,498,13,0,0,0,0,0,0,0,0,0,100
75d6004f5298a468f7c2b006f44c011d8b97e627,6,15,362,347,0,0,0,1,14,114,1,3,1.898035263,636,499,11,75,120,45,2547,4083,1536,44,66,22,95.92326139
ba555c3104b94900335ce24379412e4e5ce55bea,0,0,0,0,0,0,0,0,0,0,0,0,0,0,500,10,0,0,0,0,0,0,0,0,0,100
37bb2a51f369ac89e11a7ac71e4e2e8127eaff3b,1,10,4,6,0,0,0,1,3,445,1,1,0,100,501,11,19,19,0,799,746,53,6,6,0,98.96907216
27b813d60b55d3f68bc6a7e7215460cc28c5632e,1,35,9,26,0,0,0,2,33,72,1,1,0,274,502,3,52,49,3,1924,1769,155,26,26,0,100
3b2c0c5e55a71153572c52d379d34e26042ff55c,0,0,0,0,0,0,0,0,0,0,0,0,0,0,503,4,0,0,0,0,0,0,0,0,0,100
96fc34e0b76dbaf9d528e61f13575dfaef4fddc2,0,0,0,0,0,0,0,0,0,0,0,0,0,0,504,5,0,0,0,0,0,0,0,0,0,100
28ecfbce45d618753407f112e5f852b0ce2d45cb,0,0,0,0,0,0,0,0,0,0,0,0,0,0,505,3,0,0,0,0,0,0,0,0,0,100
33bb3f6f3a81b03c63297ecea4e34194c912d316,0,0,0,0,0,0,0,0,0,0,0,0,0,0,506,4,0,0,0,0,0,0,0,0,0,100
732a75070172aae812c84d3d8f70deebcdfd0b19,8,187,77,110,3,0,3,1,34,58,1,3,2.692505695,681,507,5,112,106,6,5178,4966,212,57,51,6,95.71788413
91e5c607d252f312292ca9fbdb9a4559fe1cea9b,0,0,0,0,0,0,0,0,0,0,0,0,0,0,508,6,0,0,0,0,0,0,0,0,0,100
c80f812c2e342ddd6bcdb409660a8ea5e2b5c8c6,0,0,0,0,0,0,0,0,0,0,0,0,0,0,509,7,0,0,0,0,0,0,0,0,0,100
b6916a17ff93cbe143414e6db5c56bc71d5005b9,0,0,0,0,0,0,0,0,0,0,0,0,0,0,510,8,0,0,0,0,0,0,0,0,0,100
3cdaef5c4ce892e98b0869fdf9ffbe19cb1c78fe,0,0,0,0,0,0,0,0,0,0,0,0,0,0,511,9,0,0,0,0,0,0,0,0,0,100
36e870ac20557682cc4588b0b931fcd81dae4126,0,0,0,0,0,0,0,0,0,0,0,0,0,0,512,10,0,0,0,0,0,0,0,0,0,100
5e6a8a3c39aa2c08173b6afacb6a3e06934fd350,0,0,0,0,0,0,0,0,0,0,0,0,0,0,513,11,0,0,0,0,0,0,0,0,0,100
2f0acc698b2c6528783b978861189e0610934aac,0,0,0,0,0,0,0,0,0,0,0,0,0,0,514,12,0,0,0,0,0,0,0,0,0,100
1ce3942f28e7b86c92bc87b509ae98cdb4748118,5,210,14,196,2,0,2,1,40,66,1,2,1.753020585,975,515,8,200,180,20,7431,6591,840,92,82,10,98.54014599
b637c47bc700f6c1fdc4dc1bcd4416bb5573e037,0,0,0,0,0,0,0,0,0,0,0,0,0,0,516,9,0,0,0,0,0,0,0,0,0,100
d9c008de64a2f734cf6a4cfc18ad01ca098cb81d,1,56,36,20,0,0,0,1,2,7,1,1,0,58,517,5,16,13,3,603,378,225,5,6,1,100
d402ba23db5a6d4671b786e17f2f3995229ec519,0,0,0,0,0,0,0,0,0,0,0,0,0,0,518,4,0,0,0,0,0,0,0,0,0,100
835da7d889e61ffd1052486be7a229d8013601a5,0,0,0,0,0,0,0,0,0,0,0,0,0,0,0,0,0,0,0,0,0,0,0,0,0,100
a3cdd0b9eb3d47ec1ea60efd522fd893c57c0fd0,4,398,6,392,1,0,1,1,33,112,1,1,0.407325653,755,519,4,221,164,57,6763,4973,1790,133,94,39,97.77777778
5fa6618cc9d545740ba3363668e1217217a52694,15,654,363,291,6,0,6,1,41,134,1,5,3.29326788,1846,520,5,395,352,43,13620,12629,991,185,161,24,92.39631336
39cb0b35cd64063d174b698745653fcf11c8fcb3,3,5,14,9,0,0,0,1,4,0,1,1,1.568316493,97,521,6,17,17,0,528,639,111,16,16,0,99.13793103
697f39593775d6426d64a426a67075f1492d5808,1,0,1,1,0,0,0,1,4,179,1,1,0,122,522,7,20,20,0,918,929,11,7,7,0,100
66505c2ea9d7abba705593582194948e88bb94ce,0,0,0,0,0,0,0,0,0,0,0,0,0,0,523,8,0,0,0,0,0,0,0,0,0,100
97e02464689ec544b9be881372696bf124db2944,0,0,0,0,0,0,0,0,0,0,0,0,0,0,524,9,0,0,0,0,0,0,0,0,0,100
9825d4071f37e86088289a92851e54f1a0968d5d,7,21,148,127,0,0,0,1,39,68,1,4,0.88690751,1478,525,6,276,293,17,9160,9878,718,130,136,6,97.9638009
e3682dc82fa4404084c39afa482d3b5a9b200b22,4,33,15,18,1,0,1,1,36,74,1,2,1.656604484,494,526,2,86,85,1,3495,3385,110,42,41,1,97.9638009
e1be56c7a1e2e5aadf6d42da73cb9ea4efcb1403,1,2,3,1,0,0,0,2,37,8,1,1,0,299,527,3,54,54,0,1949,1960,11,27,27,0,97.97752809
3481340b5d8f2edf3c208c42835347c709da72b3,1,13,8,5,0,0,0,1,3,31,1,1,0,291,528,3,54,54,0,1761,1728,33,37,38,1,100
920d8f93d84c5e3941202dd79fd6d63f5f97f9d3,0,0,0,0,0,0,0,0,0,0,0,0,0,0,529,4,0,0,0,0,0,0,0,0,0,100
7435b5824befcffb4bb6efd1ddc5dd5915862af0,1,1,2,1,0,0,0,1,4,0,1,1,0,294,530,5,54,54,0,1756,1761,5,37,37,0,100
9f600f361aaabf8874f4891f9bb1951e18c5ecf6,0,0,0,0,0,0,0,0,0,0,0,0,0,0,531,6,0,0,0,0,0,0,0,0,0,100
a2db9b56b4d97be76448d4e1a4f2e519eddc965c,1,4,0,4,0,0,0,1,6,239,1,1,0,202,532,7,35,35,0,1564,1548,16,6,6,0,100
57047d9828cb2fff11add497de35c2aa3734f811,1,0,202,202,0,0,0,1,17,15,1,1,0,154,533,8,0,25,25,0,1130,1130,0,8,8,98.35294118
3552f7bb196968bfbc6810c3f5b8722ee4c8a53a,0,0,0,0,0,0,0,0,0,0,0,0,0,0,534,9,0,0,0,0,0,0,0,0,0,100
36d73de566b77bfa465a6102c15f314308df102a,6,31,19,12,0,0,0,1,38,104,1,2,2.296050764,1133,535,9,212,212,0,7762,7604,158,101,101,0,100
aeb0223954122e94365009643600aba79e1c8c71,0,0,0,0,0,0,0,0,0,0,0,0,0,0,536,10,0,0,0,0,0,0,0,0,0,100
5adde2045194e31dec27faee112fb03bfcbc67f4,7,854,2,852,6,0,6,1,19,42,1,3,2.337166278,15,537,9,92,2,90,4568,107,4461,37,1,36,95.61200924
36b9a1961dde6df6e4207c7cbc7324bb65086a14,1,1,1,0,0,0,0,1,6,284,1,1,0,111,538,3,13,13,0,868,868,0,2,2,0,100
90dcbc8ac95d814f53c5cd4e412f43b14b57436c,0,0,0,0,0,0,0,0,0,0,0,0,0,0,539,4,0,0,0,0,0,0,0,0,0,100
ae9236e1ee1b55a1cb482b727cf806f89fe3f500,10,812,104,708,2,0,2,1,42,105,1,4,2.066376343,2492,540,5,589,518,71,19366,16566,2800,285,248,37,98.0349345
8af7dc5951ccf30d9991211f92a9213888aafba4,0,0,0,0,0,0,0,0,0,0,0,0,0,0,1,0,0,0,0,0,0,0,0,0,0,100
e87e36896680c6e31ae6b1438efa076621ef877b,2,3,5,2,0,0,0,1,46,184,1,2,0.811278124,233,541,4,35,35,0,1776,1786,10,6,6,0,100
2997ca9c4a125d1de582b8cf44647ca75099cec2,1,3,3,0,0,0,0,1,2,25,1,1,0,312,542,5,49,49,0,2191,2191,0,22,22,0,100
b2e2adc6facec1f610b9cdfdcdd8a9e4c7fea70e,4,135,12,123,1,0,1,1,39,43,1,4,1.779711086,516,543,5,102,90,12,4121,3693,428,37,34,3,99.14346895
0c860eaf01b9030c67e6edf72bb37ea3394965bd,0,0,0,0,0,0,0,0,0,0,0,0,0,0,544,6,0,0,0,0,0,0,0,0,0,100
3bef450d3ea6b5b6099b341d253f03c287af2217,1,1,1,0,0,0,0,1,2,37,1,1,0,40,545,7,4,4,0,304,304,0,2,2,0,100
238c7c98f22a813de6bdebb31a925e8927074a1c,0,0,0,0,0,0,0,0,0,0,0,0,0,0,546,8,0,0,0,0,0,0,0,0,0,100
a91c9d3ae71820d05da4b3891eb156414f0f7263,1,1,1,0,0,0,0,2,41,41,1,1,0,536,547,6,108,108,0,3547,3547,0,49,49,0,100
fdbffeb1c3c3bdf5bccd1dd7ea56ee88c76e19d0,1,6,10,4,0,0,0,1,6,80,1,1,0,296,548,7,53,54,1,1775,1802,27,37,37,0,100
b815f8873c0f64514de60f4cf90cd792bbe5e62e,0,0,0,0,0,0,0,0,0,0,0,0,0,0,549,8,0,0,0,0,0,0,0,0,0,100
e0f6dd9724a30b8aec6d2c0838d97ea59d2b29d2,4,9,7,2,0,0,0,1,47,19,1,4,1.882856064,589,550,9,101,101,0,4191,4173,18,36,36,0,100
022e7df72313f7918df0fdcf8dd605a49f50176c,1,21,39,18,0,0,0,2,41,2,1,1,0,298,551,10,49,54,5,1856,1981,125,26,27,1,100
587acde127b612ca8a666ace14610bb7f7e5edbc,1,3,1,2,0,0,0,2,42,0,1,1,0,278,552,11,49,49,0,1856,1856,0,26,26,0,100
524781e3e47ee91878ff40fbcf644cc9ed3c9373,1,1,1,0,0,0,0,2,43,0,1,1,0,278,553,12,49,49,0,1856,1856,0,26,26,0,100
db2631e70bc3e35cf47f1e28f952ea6d675d9bca,9,640,39,601,4,0,4,1,20,7,1,3,2.193500976,485,554,13,151,50,101,7685,3449,4236,51,5,46,88.93617021
b722da331946e84986949c8b4d253c383250cb8e,0,0,0,0,0,0,0,0,0,0,0,0,0,0,555,14,0,0,0,0,0,0,0,0,0,100
fc689fc902d7822cabc1896c28456ba9c554bf49,13,47,20,27,0,0,0,1,42,136,1,2,3.361606213,1151,556,15,207,207,0,7531,7531,0,115,115,0,100
22b96d0ff4a992dcebb39e945f620467fa9bfb63,0,0,0,0,0,0,0,0,0,0,0,0,0,0,557,16,0,0,0,0,0,0,0,0,0,100
46b92737a82a750695ba4bc9d13f89bbcd7a3cf1,1,2,2,0,0,0,0,1,2,7,1,1,0,184,558,17,30,30,0,1552,1550,2,9,9,0,100
e6a23f01cce5846f9af1bd9a967f341d21292e63,2,12,9,3,0,0,0,1,4,8,1,2,0.863120569,496,559,16,80,79,1,3769,3743,26,31,31,0,100
b93a713dc98b9f26be528d54e4198216428f3951,0,0,0,0,0,0,0,0,0,0,0,0,0,0,560,9,0,0,0,0,0,0,0,0,0,100
19f7a4570595de5856a5d92d082660a3c03426a3,2,2,2,0,0,0,0,1,4,697,1,2,1,11,561,7,1,1,0,70,70,0,1,1,0,100
11272e2a71835f6f0c3f756f99e97c174d2a93bb,0,0,0,0,0,0,0,0,0,0,0,0,0,0,562,7,0,0,0,0,0,0,0,0,0,100
e2f7d93c0c8377428407c1b43c0191ffe2443f16,23,215,173,42,1,0,1,1,44,190,1,6,3.249008477,3922,563,3,692,698,6,28225,28030,195,311,317,6,95.76271186
aabaaecec491a8dda883ba431edbdec32e707f95,0,0,0,0,0,0,0,0,0,0,0,0,0,0,564,4,0,0,0,0,0,0,0,0,0,100
3ad040cd5549ac7b8773d844bd8c90f3c36e94d6,11,30,57,27,0,0,0,1,45,78,1,2,2.615023638,1814,565,5,330,330,0,12213,12104,109,158,158,0,95.98308668
c9a9f31c76eab3d7d453a3fc9311320682f99f3b,13,2257,2257,0,0,0,0,1,8,136,1,4,3.26582714,1426,566,1,241,241,0,10573,10573,0,122,122,0,100
c40b5528a63518da6799c9ab3917e4d0cfb42376,0,0,0,0,0,0,0,0,0,0,0,0,0,0,567,2,0,0,0,0,0,0,0,0,0,100
58c629658f85d3a40765b971bd5a54fea2b7d0ac,104,6,6,0,0,0,0,1,1,0,2,14,0.918295834,9396,2,0,1747,1248,499,66211,86216,20005,902,104,798,15.73498965
f25c11c81589ed1a79722abbafcee8aaa81336ff,0,0,0,0,0,0,0,0,0,0,0,0,0,0,568,2,0,0,0,0,0,0,0,0,0,100
734a941d5e82af6598c9972d500d95694ac648b7,0,0,0,0,0,0,0,0,0,0,0,0,0,0,3,1,0,0,0,0,0,0,0,0,0,100
5dfacc3d1c4990d2754bcc747064e80b50f88220,0,0,0,0,0,0,0,0,0,0,0,0,0,0,569,3,0,0,0,0,0,0,0,0,0,100
bf07fffb337d2bc469a54d09e4d0648ff5a9bc7a,0,0,0,0,0,0,0,0,0,0,0,0,0,0,570,2,0,0,0,0,0,0,0,0,0,100
ec9365c2c0840657d4211fc287fec8f89bb4cbe3,0,0,0,0,0,0,0,0,0,0,0,0,0,0,571,2,0,0,0,0,0,0,0,0,0,100
516e5bc2e2936cc8e8acfdd6117cf51c97a6942e,0,0,0,0,0,0,0,0,0,0,0,0,0,0,572,3,0,0,0,0,0,0,0,0,0,100
55ad7d28646aecf0d4be5017df90adc139a168ec,0,0,0,0,0,0,0,0,0,0,0,0,0,0,573,4,0,0,0,0,0,0,0,0,0,100
e0df899a4d81512b18a7e16919c2aa2c8c4338c7,1,3,3,0,0,0,0,2,2,52,1,1,0,312,574,5,49,49,0,2191,2191,0,22,22,0,100
a5800e9c1de758ea384775f186aeecbc4f423045,0,0,0,0,0,0,0,0,0,0,0,0,0,0,575,5,0,0,0,0,0,0,0,0,0,100
a50fe633dc6e50fcd9b7c55ffc20158f8d112fd7,0,0,0,0,0,0,0,0,0,0,0,0,0,0,576,6,0,0,0,0,0,0,0,0,0,100
f7c31937fc6a35f954a516aace99ac9053061fef,0,0,0,0,0,0,0,0,0,0,0,0,0,0,577,7,0,0,0,0,0,0,0,0,0,100
57d2599b93b3f34a3c79d7d404695f4acfe9482a,7,200,454,254,0,0,0,2,2,63,1,1,2.301078268,862,578,8,103,144,41,6154,7394,1240,39,44,5,98.98785425
c460f9b7c06c727e36551c34d0d48948177a4d54,6,356,0,356,6,0,6,1,1,0,1,2,2.344134808,0,579,9,25,0,25,1348,0,1348,12,0,12,96.64031621
73888aeef4655d6810caa33385633a5a836ace60,8,921,133,788,4,0,4,1,2,40,1,4,2.670042807,1642,580,10,419,308,111,15693,11170,4523,184,136,48,95.40229885
0f30527b19afe28eec6c50ec0b5f62e1e35e40a9,16,391,371,20,0,0,0,2,3,60,1,5,2.749373817,2779,581,11,520,510,10,19146,18902,244,234,236,2,96.74952199
5f8861359e602a0d7dcdd92126e0eb35f4922727,2,6,4,2,0,0,0,2,2,82,1,1,1,206,582,12,28,28,0,1690,1664,26,14,14,0,100
d70cf102bef9066889ef8df84000d4b5459ce693,1,9,12,3,0,0,0,1,2,2,1,1,0,73,583,13,6,6,0,571,601,30,5,5,0,99.42196532
d2811431a4cf27db11dd24399d33a58cc736a71f,0,0,0,0,0,0,0,0,0,0,0,0,0,0,584,10,0,0,0,0,0,0,0,0,0,100
e120f89841e82fd0f4c95e3bcbb9216920d11cec,2,29,18,11,0,0,0,2,4,24,1,1,0.25387844,1363,585,5,274,271,3,9372,9309,63,107,107,0,100
c04f5a58b21fcf6b0aa7e0e7a3eaf1b62de52e41,1,0,0,0,1,0,1,2,3,26,1,1,0,0,586,6,0,0,0,0,0,0,0,0,0,99.6124031
8603f0eb92f98a0016f15d2eb1887d9725c78d3e,0,0,0,0,0,0,0,0,0,0,0,0,0,0,587,2,0,0,0,0,0,0,0,0,0,100
8885ac3493c2934c93051ec8cead9133750a51e1,0,0,0,0,0,0,0,0,0,0,0,0,0,0,588,3,0,0,0,0,0,0,0,0,0,100
41e13424612cf3b61b92667f6342152f7a2721f8,0,0,0,0,0,0,0,0,0,0,0,0,0,0,589,4,0,0,0,0,0,0,0,0,0,100
ca5b05df83aceb85f7c413096981a1978657f2e3,5,131,77,54,0,0,0,2,5,96,1,3,1.710691427,1043,590,5,202,195,7,7400,7019,381,102,100,2,99.22178988
8da46ee422c475ad0e2fdcc77da68da5e09dd6e9,2,108,38,70,0,0,0,2,6,43,1,1,0.144506143,1011,591,4,215,201,14,7252,6716,536,94,91,3,100
dcbbde2f0299fecc90ea3ec7c2e4a24cdc042d76,0,0,0,0,0,0,0,0,0,0,0,0,0,0,0,0,0,0,0,0,0,0,0,0,0,100
ecc66c5cdf8053a1c452acb96cc8c25ce25c6cee,13,166,111,55,0,0,0,3,7,71,2,5,2.500802763,3729,1,1,704,695,9,26984,26788,196,294,291,3,98.6381323
480526556a1fa8ca71f4f194c4c489a02a2af59b,4,155,86,69,0,0,0,2,6,55,1,2,1.375327881,1421,592,5,277,270,7,9887,9636,251,124,121,3,100
9e433c4e018dc6e65a1f701616d7bf7ef71c498e,1,1,1,0,0,0,0,3,7,0,1,1,0,797,593,6,155,155,0,5544,5544,0,56,56,0,100
543e983a12f820f19ac12ac46f271aaf5873579d,1,3,0,3,0,0,0,3,8,2,1,1,0,619,594,7,129,128,1,4147,4106,41,53,53,0,100
bc8e0cd2ea17507d2651feb8bd841d07f919ed6f,3,266,206,60,0,0,0,3,8,27,1,2,0.092348195,1058,2,2,199,198,1,7668,7524,144,77,75,2,96.77419355
684395d06b2934617daec1b01b4fa4a9395a943f,0,0,0,0,0,0,0,0,0,0,0,0,0,0,3,3,0,0,0,0,0,0,0,0,0,100
08e2564b7970604b05b9fecb55d9fd1352ed58c0,2,136,58,78,0,0,0,3,9,9,1,1,0.115151019,1116,595,8,226,220,6,7810,7402,408,96,94,2,100
ed4827cefbe5244754dcce3791db9effd96fc958,1,246,253,7,0,0,0,3,5,34,1,1,0,235,596,5,37,37,0,1638,1638,0,16,16,0,100
9c09fc9deca40e7491210fb38ca020af5956932c,8,146,104,42,0,0,0,3,8,121,2,3,2.847915211,1232,597,1,195,195,0,9120,9094,26,84,84,0,97.76536313
ddbb929b79ee9b61cdcbb42fcd0d0414aadb7de7,2,3,3,0,0,0,0,3,3,0,1,1,1,74,4,0,14,14,0,444,438,6,11,11,0,100
cd93e310d81235bb1a97a0c81d548d1eaca64f65,6,58,37,21,0,0,0,2,10,115,1,2,2.050553158,1837,598,2,357,353,4,12131,12028,103,186,182,4,100
0798508d186ccc41490fbda752464a55fdf14f47,2,11,4,7,0,0,0,3,4,32,1,1,0.566509507,300,5,1,56,55,1,1891,1865,26,39,38,1,100
cab8f901dc406e9df1acc04648af70796d5c8a12,22,2983,775,2208,13,0,13,1,10,40,2,5,3.402479373,2008,6,2,555,358,197,24504,13633,10871,279,172,107,92.89617486
3331debeda98a05460af330a945ca70f5919639a,0,0,0,0,0,0,0,0,0,0,0,0,0,0,599,3,0,0,0,0,0,0,0,0,0,100
ffa364f91af9abe3a33ff159f2cf94252a9b92f2,1,2,8,6,0,0,0,2,2,11,1,1,0,558,600,4,96,97,1,3609,3636,27,44,44,0,100
465c804f3a6c08682de75bae1622f0940c145cc7,5,99,88,11,0,0,0,3,11,10,2,2,1.53689124,2101,601,5,394,395,1,14318,14372,54,162,159,3,100
4c6abb4488db48a406478fba06dc98add773e390,32,1760,652,1108,16,0,16,1,12,15,2,12,4.135521043,3252,7,3,632,563,69,26110,22345,3765,317,263,54,87.5
19afdf19bca0529c06b44a323a2ee25642fcd6a8,2,19,15,4,0,0,0,2,12,79,1,1,0.322756959,935,602,5,181,180,1,6253,6217,36,73,73,0,100
fe84b6eb5df0e8e4fd8b8b5f27ebbeba60879fe4,6,149,9,140,2,0,2,2,5,102,2,2,1.65435231,503,603,6,109,100,9,3890,3289,601,77,71,6,97.52186589
0e347d0ba4782b8d110d72f72e02053cf889d53e,0,0,0,0,0,0,0,0,0,0,0,0,0,0,604,7,0,0,0,0,0,0,0,0,0,100
1634fe1134234f60c3f056dcef7e8f453973e216,1,2,2,0,0,0,0,2,6,1,1,1,0,269,605,7,47,47,0,1797,1782,15,29,29,0,100
c0ec69bde3cfb78d710340e4aee223a310c1d8ef,5,13,12,1,0,0,0,3,13,52,1,1,2.062683189,1854,606,7,370,370,0,12726,12695,31,158,158,0,100
63dfb0d5b7f4e15b00c824c189a666f79ac2dcf6,0,0,0,0,0,0,0,0,0,0,0,0,0,0,607,8,0,0,0,0,0,0,0,0,0,100
18bb4338b45faadd6222dc13a2b337f5b4dec662,5,0,418,418,0,0,0,2,2,25,1,3,1.824989983,288,608,9,2,40,38,134,2166,2032,2,29,27,97.62611276
b74daecafcf1f5a9f619d51fc3af39e9245767f5,5,19,41,22,0,0,0,2,3,10,1,2,1.212512023,386,609,10,53,23,30,2336,979,1357,29,15,14,98.78787879
9c3ccebf3e55705701a1ab068fca846b7a6178ec,0,0,0,0,0,0,0,0,0,0,0,0,0,0,610,11,0,0,0,0,0,0,0,0,0,100
f75c2a563e8945d79f83b79bffc742946db50e4a,10,108,747,639,1,0,1,2,14,21,1,4,3.030655566,1753,611,12,233,313,80,9013,12343,3330,103,140,37,96.89349112
7e22e202ebd5c67d46e2085d2def8171718fafee,5,1,1,0,4,0,4,1,5,0,1,3,0,44,612,13,4,4,0,390,390,0,1,1,0,98.83040936
cf9fa9882a8228c2315aa1c9013572a1c2e5a9e8,1,1,0,1,0,0,0,1,3,0,1,1,0,44,613,14,4,4,0,403,390,13,1,1,0,100
fabcb54ac6491c6a89ffd414cfb5015e706be73a,36,2010,208,1802,14,0,14,3,7,36,2,6,4.096678284,3159,614,12,838,626,212,31771,23087,8684,429,318,111,94.06657019
231a3b8261db1123d9027f81381437eb4dd8b257,1,0,0,0,1,0,1,2,3,5,1,1,0,0,615,13,0,0,0,0,0,0,0,0,0,99.71590909
fe3bfbf374caf90710db19da3ebbdfe51f8c576b,0,0,0,0,0,0,0,0,0,0,0,0,0,0,616,14,0,0,0,0,0,0,0,0,0,100
c044654fcec5204253334d99a245257003acf218,36,576,226,350,1,0,1,3,15,1,2,7,4.545992164,4112,8,1,748,734,14,30006,29568,438,376,370,6,97.21448468
b1e9e98179322e62c8df798d1a9a524a73c56953,8,243,7,236,4,0,4,3,8,1,1,3,2.235520702,179,9,1,32,18,14,2535,1476,1059,20,10,10,97.16981132
13be362bf7c2a06e8efe7a2449360e08ea7a582e,3,7,10,3,0,0,0,3,9,0,1,3,1.379280487,481,617,15,70,71,1,3430,3450,20,43,43,0,100
75e055fabbd0c1470b58987a51ef9f84c6c782ce,2,4,3,1,0,0,0,3,16,26,1,1,0.863120569,1377,618,15,277,277,0,9426,9399,27,108,108,0,100
4dfd099ec1b0aa9254a59ee83e8e5ecbc70fbfae,7,100,67,33,0,0,0,1,10,2,1,2,2.13672121,1550,10,2,294,284,10,10920,10741,179,152,152,0,100
3056ea2a6001c40382d1deb81c08fb86210a79f9,15,260,849,589,0,0,0,1,11,41,2,3,2.457622923,2263,11,3,261,332,71,13156,15956,2800,119,161,42,98.4
9fbe28092bef6a44036f44ce19efe0aedbe6a16f,8,502,199,303,5,0,5,1,14,3,1,3,2.6229288,682,12,4,118,115,3,5337,4526,811,77,72,5,96.11528822
3eddc0b330060778f9e0596f3b997d31446c3c91,6,306,182,124,0,0,0,3,11,15,2,5,0.840898224,614,13,5,107,97,10,4942,4278,664,72,64,8,97.99764429
0a168f39f0bc6a138da755ae7ebe4f2439ac4eae,1,1,1,0,0,0,0,3,11,0,1,1,0,364,14,6,60,60,0,2284,2282,2,43,43,0,100
a2c986824c41995443b80d263ade1e422aa07911,10,1279,38,1241,7,0,7,1,7,4,1,2,2.511618769,860,15,7,342,186,156,11492,5810,5682,162,103,59,94.11764706
dac9ac58f6b80a3e3352712c917157c6e572bbbe,0,0,0,0,0,0,0,0,0,0,0,0,0,0,619,13,0,0,0,0,0,0,0,0,0,100
0f343bc9ad8032483152f8274f15ef4173bc73c3,3,84,29,55,0,0,0,2,12,26,1,2,0.815706002,666,16,8,108,101,7,4612,4268,344,62,60,2,100
1462fae7479e23692513327c5895e0bdb847ccf4,1,26,8,18,0,0,0,3,17,17,1,1,0,751,620,13,151,147,4,5288,5186,102,55,55,0,100
15caec9c7c57dd1ea9ba2a84bb5e34d9fd4a5103,2,13,4,9,0,0,0,2,8,11,1,1,0.522559375,1051,17,9,225,223,2,7727,7658,69,80,80,0,100
556cb96a3eb179d50021c2cd50f40916b1de3923,2,14,3,11,0,0,0,3,13,9,1,1,0.977417818,1303,621,14,271,270,1,9081,9023,58,107,107,0,100
14297ee41594b018d0e3b422f4b2d0698ed1d0dd,1,12,12,0,0,0,0,3,10,0,1,1,0,683,622,15,141,141,0,4829,4825,4,54,54,0,100
8f6862450ed13c73a7f592f3941f8bb9d7e3a900,1,2,3,1,0,0,0,3,11,0,1,1,0,683,623,16,141,141,0,4819,4829,10,54,54,0,100
f3cc725dd74683bff83059828dd73ccb1f2ff5a9,2,3,3,0,0,0,0,3,7,21,1,1,1,470,624,10,98,98,0,3132,3135,3,65,65,0,100
2b5ece17ccfe9c0ab9a2eed4de62602f3d86ac99,1,2,4,2,0,0,0,3,12,17,1,1,0,67,625,11,7,7,0,540,554,14,5,5,0,100
1c0bda95b96b1b06f04f42159a07938a04ee72f1,8,10,150,140,0,0,0,3,13,14,2,4,0.922463477,644,626,12,66,79,13,4569,5911,1342,28,33,5,97.52781211
c510b0de8ba54212c2bcd1cab381f90a21d517a6,1,48,0,48,1,0,1,1,1,0,1,1,0,0,627,13,6,0,6,162,0,162,6,0,6,97.76674938
9eb2880cbf60bcd8cd242bb8af00c3a4eba0ceb5,2,19,10,9,0,0,0,3,9,18,2,2,0.66319684,129,628,14,17,16,1,1102,1079,23,9,8,1,100
095c4b4084d848a422aee01da269a82cff924fda,14,240,888,648,0,0,0,1,8,150,1,3,3.161514747,889,629,14,92,130,38,4071,7664,3593,38,52,14,92.67707083
7cfb3d245364d73938ab45c08caa956d80a43bdc,1,0,0,0,1,0,1,2,4,0,1,1,0,0,630,15,0,0,0,0,0,0,0,0,0,99.76635514
55fe01e13c593078aa6f58f5138d70ea90ef8a79,1,5,13,8,0,0,0,2,4,17,1,1,0,343,631,15,49,49,0,2143,2237,94,19,19,0,100
6f551067636411f6ac87f3b253005e63fc0f22d0,0,0,0,0,0,0,0,0,0,0,0,0,0,0,632,15,0,0,0,0,0,0,0,0,0,100
6035f94e356a887887b9087b4c81c0c16ead87e4,1,2,0,2,0,0,0,2,5,0,1,1,0,334,633,16,49,49,0,2157,2143,14,19,19,0,100
ebc38d4ceb109b60292576ca520b946d4b09c7e2,8,12,47,35,1,0,1,1,7,31,2,3,1.313259575,518,634,17,85,8,77,3782,359,3423,37,7,30,96.59224442
2f3f21d1452fccff8fc85d3c8db6eed56248c24b,2,9,2,7,0,0,0,1,2,2,1,1,0.439496987,188,635,18,33,32,1,1478,1440,38,18,17,1,100
7a53100abd5fee5f3363eaca9b9da0425d10e7c1,1,30,0,30,1,0,1,1,1,0,1,1,0,0,4,0,4,0,4,107,0,107,2,0,2,99.64705882
1b60c7f3002cdac28c54755b0fedf4825cfd416a,1,18,1,17,0,0,0,1,2,0,1,1,0,21,5,1,4,4,0,107,107,0,2,2,0,100
8ddbed533ec812c1645843c2212f0019b243ca48,1,21,0,21,1,0,1,1,1,0,1,1,0,0,6,2,2,0,2,72,0,72,1,0,1,99.29824561
c0704c7c933a932666cbb59447b5e19bafd8ecb5,2,4,3,1,0,0,0,1,4,44,1,1,0.863120569,488,18,6,61,61,0,3619,3608,11,30,30,0,100
24357b7b7a0e900dd522af9837863f7065f40eed,1,1,1,0,0,0,0,3,13,31,1,1,0,356,636,17,59,59,0,2220,2220,0,43,43,0,100
7832d2a187168d8eda101e2d01a24750350ab267,1,1,0,1,0,0,0,3,18,32,1,1,0,766,637,18,151,151,0,5293,5288,5,55,55,0,100
ce2ccdf1932884955203d92c069228ae77623745,1,2,3,1,0,0,0,3,19,0,1,1,0,767,638,19,151,151,0,5285,5293,8,55,55,0,100
4c906c60ab0b2707e811a3b7e24422f724b211ec,1,17,1,16,0,0,0,1,2,18,1,1,0,34,639,20,6,6,0,162,162,0,6,6,0,100
2b902d42cbb600d926fbd77f7d99d99eaa10f63e,3,10,25,15,0,0,0,3,8,20,1,1,1.336286231,160,7,3,15,16,1,1225,1578,353,7,7,0,95.81795818
64b047fb160b58bdf4a46f2f46540267bf6cee98,3,103,1,102,2,0,2,1,2,3,1,1,1.505689598,13,8,4,8,2,6,254,72,182,4,1,3,95.98393574
8500d79493b4c52d5395788c5ae5e6f77e280398,2,78,87,9,0,0,0,2,12,40,1,1,0.225363639,1064,640,16,224,226,2,7731,7763,32,80,80,0,100
9e035cf7b639751c345092db4e81f0921835ea37,2,123,18,105,1,0,1,1,3,11,1,1,0.997059057,141,641,17,36,22,14,1704,1201,503,14,7,7,99.72527473
b9ec010a743b510db647bda27562c426c4219e0c,24,2559,0,2559,24,0,24,1,1,0,1,3,4.31068497,0,0,0,324,0,324,11753,0,11753,153,0,153,89.89037759
ab72037434516a1dbe4232c6994a0c9444ca1178,1,1,1,0,0,0,0,2,2,1,1,1,0,39,642,15,5,5,0,318,318,0,3,3,0,100
734f798ae1302e7995cdc7307db263cd53dab7e8,2,36,18,18,0,0,0,2,15,66,1,1,0.503258335,288,19,1,45,42,3,2023,1968,55,28,26,2,100
a354483ba1ae471fbc5ac252d47ec16c563463cc,0,0,0,0,0,0,0,0,0,0,0,0,0,0,20,2,0,0,0,0,0,0,0,0,0,100
b7ef7c70641752de93aa1e0abaf3b7977a438e68,1,5,6,1,0,0,0,3,14,26,1,1,0,356,9,5,59,59,0,2220,2220,0,43,43,0,100
0d9ee6dcc0cdba8476d6e5a6f81ea6c6bf43aebd,8,914,58,856,1,0,1,2,20,42,1,1,1.219036766,1922,643,10,456,347,109,16063,12709,3354,249,189,60,99.78118162
b7aea27bbdb855c9cbcbe199a0722e29b535d92f,1,3,2,1,0,0,0,2,3,81,1,1,0,73,644,8,8,8,0,611,600,11,3,3,0,97.28317659
614efc37d0ea1b076b198fc7779d8ae0b6958770,1,2,2,0,0,0,0,3,16,11,1,1,0,358,21,2,59,59,0,2234,2231,3,43,43,0,100
08e340a026767f306219141df2a32a11be7d0153,23,391,274,117,1,0,1,2,21,43,3,6,3.321538088,4063,645,5,692,683,9,29435,28820,615,322,316,6,99.7
1ea7e2d0532f01ab2e7fbc071b51d67b4abc8916,4,7,1,6,3,0,3,1,6,81,1,2,0,255,22,3,34,34,0,1720,1694,26,22,22,0,96.566077
728d6d2abc1612acf2ba5199cdd54dd8d5cd4132,1,1,2,1,0,0,0,3,18,5,1,1,0,367,23,4,61,61,0,2278,2286,8,43,43,0,100
174d1232a8133d35d81928fb9ab569ebaf781d76,2,37,51,14,0,0,0,1,16,8,2,2,0.266764988,483,646,4,83,82,1,3505,3519,14,39,40,1,99.56474429
9bf532685ee71fe720a30c5d53d642a1cd265541,6,60,218,158,0,0,0,1,14,63,1,2,2.245430737,286,647,5,20,29,9,1539,2375,836,8,17,9,94.54354669
3bb48cbce7bb752d1224d23d6f281f34938418cd,1,5,7,2,0,0,0,1,6,2,1,1,0,179,648,6,31,31,0,1488,1497,9,7,7,0,100
4146e6730399845d4afdfe5783a77b833840e222,1,5,1,4,0,0,0,3,14,20,1,1,0,674,649,7,140,139,1,4793,4764,29,55,54,1,100
d613500bcf3dea82fa5e1a32b0941c7f2f200939,5,97,97,0,1,0,1,1,3,53,2,2,1.730406701,329,650,6,61,61,0,2489,2489,0,29,29,0,99.6969697
03cd4a6e44549efc25cf3c261d8f4643641afce2,10,440,294,146,1,0,1,1,15,78,2,2,2.440898402,1875,24,3,321,298,23,14243,13574,669,162,151,11,95.58067831
4248e7e9fdd8f9df997148cb23a4cb6343ff11f7,1,0,0,0,1,0,1,2,6,137,1,1,0,0,651,6,0,0,0,0,0,0,0,0,0,99.78991597
658ebcd4b271a4dfb9ad6b2015c4b86a1aca5a97,4,132,56,76,2,0,2,1,16,4,2,3,1.627320441,848,25,4,164,161,3,6386,6196,190,67,65,2,99.47643979
eba84e43fda3d9e7676ae949a14688f471acfd25,4,56,132,76,0,0,0,2,17,4,2,3,1.627320441,872,652,7,161,164,3,6196,6386,190,65,67,2,99.47643979
3dddd4c6a969923aa67562f33d37f0ed7ee8bdd6,1,11,0,11,0,0,0,3,22,47,1,1,0,809,653,7,162,160,2,5666,5599,67,59,59,0,100
4a788416cf92786544d5be611dc0fcb11e94803b,2,62,9,53,0,0,0,2,23,63,1,2,0.716258391,848,654,8,179,168,11,6093,5841,252,65,63,2,93.3106576
8719b81e83f9e462d883f3c9db5d561ce569e44e,4,10,14,4,0,0,0,2,5,38,2,2,1.650022422,322,26,2,36,38,2,2424,2433,9,17,17,0,100
0bd9846c665da662392897d1591ad07208e4fb53,1,5,5,0,0,0,0,3,24,0,1,1,0,816,655,9,161,161,0,5665,5665,0,59,59,0,100
c56ebec093b11b535c64daccf96fd1259ece59d6,1,1,1,0,0,0,0,3,11,47,1,1,0,110,656,10,13,13,0,945,939,6,5,5,0,100
a6a2981f0a700ddbb12616a1793c6840843866b2,5,115,110,5,0,0,0,2,25,54,1,3,2.161091127,1668,27,3,296,296,0,11345,11285,60,132,132,0,100
4f7bf4097483418001f310e03d505a3381f678c9,5,110,115,5,0,0,0,2,26,10,1,3,2.161091127,1670,657,7,296,296,0,11285,11345,60,132,132,0,100
06fb8011d209a2064f813e0d5d0018a12887e366,1,142,10,132,0,0,0,2,3,126,1,1,0,13,658,5,16,2,14,1370,72,1298,3,1,2,95.60185185
0e04d22153f37dd47802be16ed6b58906b4a5528,1,1,1,0,0,0,0,2,4,0,1,1,0,138,659,6,16,16,0,1370,1370,0,3,3,0,100
9eebdd26507385500187f2d8e6017908122a040a,2,35,14,21,0,0,0,1,18,65,2,2,0.536359651,886,660,3,186,180,6,6659,6528,131,68,67,1,100
81f48aa10a8ef12bceb8090e1a5b68b56aee7822,1,1,6,5,0,0,0,3,19,0,1,1,0,722,661,4,153,154,1,5114,5146,32,61,61,0,100
fb1385bf4e4344b6616a690ba938929f2503dc4d,1,42,9,33,0,0,0,3,7,92,1,1,0,63,662,5,10,6,4,842,543,299,4,3,1,99.45115258
41a7d29979a938df6a4cd00f01a020743f09c860,1,3,3,0,0,0,0,2,5,17,1,1,0,138,663,6,16,16,0,1370,1370,0,3,3,0,100
7bcb56f5ce83d1230f7932d3e887f2c1693341bf,1,19,7,12,0,0,0,2,6,3,1,1,0,138,664,6,20,16,4,1429,1370,59,4,3,1,100
d0c6549b61af029b71660792fb921fc59cd7e565,0,0,0,0,0,0,0,0,0,0,0,0,0,0,1,0,0,0,0,0,0,0,0,0,0,100
89bfa1586362223c0cc6f5bfade9058c526563e1,6,96,96,0,0,0,0,2,20,60,2,3,0.744973179,1503,665,7,298,295,3,11506,11516,10,126,125,1,95.34342258
428626331b9de092fcb667856b88b13ca806606b,4,85,80,5,0,0,0,2,27,52,1,2,1.806068706,1324,28,0,245,245,0,9142,9086,56,113,113,0,100
be9fd62d75bdbbba202b86f0c3e1290c8fdfb945,4,182,35,147,1,0,1,2,5,47,2,3,1.425436743,266,29,1,67,51,16,3084,2138,946,24,18,6,99.3872549
c177024fd0a3d0b61dea2ffd7460b6a5890c1c0f,0,0,0,0,0,0,0,0,0,0,0,0,0,0,666,8,0,0,0,0,0,0,0,0,0,100
07f64c35975c4695606c0bb945bc87b089d768e3,2,158,2,156,1,0,1,2,2,254,1,2,0.963167245,6,667,7,17,1,16,473,35,438,10,1,9,99.51515152
5103006a02a3252d45fbb8897aec83a7a73abb84,1,7,8,1,0,0,0,3,19,130,1,1,0,366,30,2,62,61,1,2281,2278,3,43,43,0,100
068be8d453c495a8fa93ba0846abc7474be4506e,2,10,6,4,0,0,0,2,4,77,2,2,0.988699408,105,668,3,27,26,1,590,559,31,20,19,1,100
30882b8927e1f0b361e9a38aeaea1774694c931e,0,0,0,0,0,0,0,0,0,0,0,0,0,0,669,4,0,0,0,0,0,0,0,0,0,100
47c43d11d2469f8e82c17bec1ae50c0bc2b33b0b,0,0,0,0,0,0,0,0,0,0,0,0,0,0,670,5,0,0,0,0,0,0,0,0,0,100
6edc8e3ace1fa6916b9eabf1c51b51e8e104575b,3,25,15,10,0,0,0,3,28,91,1,1,1.581290899,1799,671,4,365,364,1,12628,12586,42,144,144,0,100
79e7948cfba29daa1b59475b7218553b41e8c411,1,1,1,0,0,0,0,2,3,495,1,1,0,312,672,5,49,49,0,2191,2191,0,22,22,0,100
60857cf149368c0a135a8067a9d61e4afc16a4d7,0,0,0,0,0,0,0,0,0,0,0,0,0,0,673,6,0,0,0,0,0,0,0,0,0,100
231d7bdc3bc8b5a84374b5ba01b498677ea60948,10,825,164,661,5,0,5,1,20,38,2,5,2.991890192,1007,31,1,263,180,83,11305,7626,3679,111,78,33,97.88732394
d1f5f23a2f58ca6899311fa4d7341da1122e1d85,0,0,0,0,0,0,0,0,0,0,0,0,0,0,674,7,0,0,0,0,0,0,0,0,0,100
b15783bc4ea36fa0b26d2227c90bef151ef62336,0,0,0,0,0,0,0,0,0,0,0,0,0,0,675,7,0,0,0,0,0,0,0,0,0,100
050e1bd2a910e1400d02b6ae2d35fce1cba7e4f4,0,0,0,0,0,0,0,0,0,0,0,0,0,0,676,8,0,0,0,0,0,0,0,0,0,100
3b2674bb7713fefda075bf18bd6f2435474cf94f,0,0,0,0,0,0,0,0,0,0,0,0,0,0,677,9,0,0,0,0,0,0,0,0,0,100
2e2d310c75aaf798372987a7771c0717af192558,0,0,0,0,0,0,0,0,0,0,0,0,0,0,32,2,0,0,0,0,0,0,0,0,0,100
1e70e59b2f992e6725396fb1d2c4da18587915f7,0,0,0,0,0,0,0,0,0,0,0,0,0,0,678,10,0,0,0,0,0,0,0,0,0,100
57057cac9f8d45eedd77fcadc2b804deb6cd9956,0,0,0,0,0,0,0,0,0,0,0,0,0,0,679,11,0,0,0,0,0,0,0,0,0,100
69b295d30b88756c39680ab0433b8c979301a66f,0,0,0,0,0,0,0,0,0,0,0,0,0,0,680,12,0,0,0,0,0,0,0,0,0,100
876117ac2c6d237d02d27d1e331b1b7f833a1466,0,0,0,0,0,0,0,0,0,0,0,0,0,0,681,13,0,0,0,0,0,0,0,0,0,100
e2d0e8cf2932b7f7aa8b980fa6104f0190caeceb,1,24,10,14,0,0,0,3,8,291,1,1,0,223,682,14,39,36,3,1626,1576,50,16,16,0,100
a36c457f43b57e81df2b8076099a1e20656f2f3e,0,0,0,0,0,0,0,0,0,0,0,0,0,0,683,15,0,0,0,0,0,0,0,0,0,100
6cc049212195d3b1d6c920cf8df6f4f3aa640f3f,26,938,919,19,6,0,6,2,11,165,3,6,3.897227072,1477,684,15,268,265,3,10661,11008,347,169,150,19,92.87257019
21f5e51ef216c6c24a970c6037b9c17446592784,0,0,0,0,0,0,0,0,0,0,0,0,0,0,685,16,0,0,0,0,0,0,0,0,0,100
488c614fb6691069737006be3dbe477cf0c5de9f,6,523,1,522,4,0,4,2,2,92,1,2,1.877865816,55,686,17,55,3,52,3072,471,2601,40,2,38,98.78172589
a5483d1c72cad5cc16afb6a30bce044aa6cff963,1,14,11,3,0,0,0,2,2,0,1,1,0,118,33,2,13,13,0,898,883,15,9,9,0,100
a02c07b55f7de8e2e0e8898e4de3f260e4a25e54,1,13,6,7,0,0,0,3,14,272,1,1,0,629,34,3,131,130,1,4275,4256,19,53,53,0,100
4f53d5c5648e3f606419b51ca36f521a95874be1,34,314,335,21,0,0,0,2,29,117,4,7,4.650765904,3427,687,16,560,563,3,25064,24874,190,309,313,4,98.6721144
46dd9edbfb086c74311faa700cc5e763f9531867,1,1,2,1,0,0,0,3,13,0,1,1,0,108,688,17,13,13,0,928,928,0,5,5,0,100
293f51c03ae973f4156641e7ff9d7e45b87f73d4,1,2,2,0,0,0,0,1,3,12,1,1,0,75,689,15,14,14,0,622,622,0,5,5,0,100
feb5f991b0844987fcd12465711b0fa8c2a5241f,0,0,0,0,0,0,0,0,0,0,0,0,0,0,690,13,0,0,0,0,0,0,0,0,0,100
cc4ac29daff8cb9d0e69e4fac3ba58d13efdec3d,14,613,37,576,9,0,9,1,7,10,1,4,3.548348449,374,35,2,92,60,32,4811,2721,2090,59,43,16,96.35995956
607a7e78b7d074e874bde7b9f19117becb59fbac,7,119,0,119,0,0,0,1,4,100,2,6,2.807354922,1078,691,7,191,191,0,8187,8187,0,94,94,0,100
3705e95eb5e92dac1ab59f949d516466be8f0737,0,0,0,0,0,0,0,0,0,0,0,0,0,0,692,8,0,0,0,0,0,0,0,0,0,100
f982eadf81dfcf054e1bf5bfab9b0f804550c1d2,0,0,0,0,0,0,0,0,0,0,0,0,0,0,36,3,0,0,0,0,0,0,0,0,0,100
ce5fa075f1e7e71c11095ce5153f703a0c7ffb06,4,14,11,3,0,0,0,2,8,36,2,2,1.79126128,197,37,3,30,30,0,1505,1505,0,18,17,1,100
106b028938c67882ff2edae785bc7d966729ecce,0,0,0,0,0,0,0,0,0,0,0,0,0,0,38,3,0,0,0,0,0,0,0,0,0,100
7b71700bc2ad0375b4b37553753e9a0a284b4309,0,0,0,0,0,0,0,0,0,0,0,0,0,0,693,6,0,0,0,0,0,0,0,0,0,100
bbeb3e004bf12f1c0bba60f01f99984220cdc913,6,69,130,61,0,0,0,2,21,12,1,5,1.147848912,526,39,4,70,73,3,3451,3826,375,38,45,7,99.90138067
10d3182a379ee8c160ec0e170c1d542f524e34e6,5,11,53,42,0,0,0,2,22,40,3,2,2.024386449,535,40,5,76,80,4,3532,3628,96,50,54,4,100
97677852d41594fe0f166ef1663669fb17683716,9,94,59,35,0,0,0,3,23,161,1,1,2.78378656,3141,41,6,630,626,4,21178,20905,273,336,332,4,97.06744868
a2372ba05bfe849f4e97e8b394886cfd8f8e1b57,10,1151,0,1151,9,0,9,1,30,4,2,5,2.76014127,816,2,0,299,161,138,11318,5668,5650,127,59,68,97.91073124
1ce00cf41f3418ee033d068eed6d4400805260da,0,0,0,0,0,0,0,0,0,0,0,0,0,0,694,5,0,0,0,0,0,0,0,0,0,100
021231824d9eaa9260f03414cbda872da7312815,0,0,0,0,0,0,0,0,0,0,0,0,0,0,695,6,0,0,0,0,0,0,0,0,0,100
4b91a6ff0167f4537561fb799b88e034446b14a2,0,0,0,0,0,0,0,0,0,0,0,0,0,0,696,7,0,0,0,0,0,0,0,0,0,100
b85db9ef448472938c9f5298a68f0198cbbcb85f,2,29,28,1,0,0,0,2,2,2,1,2,0.669996032,91,42,7,15,15,0,689,705,16,5,5,0,100
5bf488c3b4482e20fde6fbe6f6c5329be738603b,1,10,0,10,0,0,0,3,12,49,1,1,0,230,43,8,57,56,1,1585,1525,60,48,47,1,99.53660797
eb69880d48872a9a2c159495f3fb7ae112206f1d,5,24,12,12,0,0,0,1,9,31,2,2,1.386274094,306,697,8,52,50,2,2768,2650,118,17,16,1,100
5ddd3a1efcde5efc00ec9b2cd81e8da8e4bed9f5,0,0,0,0,0,0,0,0,0,0,0,0,0,0,698,9,0,0,0,0,0,0,0,0,0,100
62f9dfc669524f90467ddf1d2dd00e444dd8e057,4,57,39,18,0,0,0,1,5,6,2,3,1.693407856,444,699,10,69,67,2,4206,4133,73,22,20,2,98.5046729
3fc5d028f48f500239fc5ce17ca9179f19c0ad42,2,7,7,0,0,0,0,1,2,4,1,1,0.985228136,368,3,1,65,65,0,2768,2768,0,28,28,0,100
8c0cc8b0a0d576537a93b593ba1ddb68b7868489,1,41,12,29,0,0,0,1,5,2,1,1,0,102,700,10,23,17,6,1188,974,214,4,4,0,100
5db99e287a6f70e15eeeb0e2c00e5bcc4ed3a85d,0,0,0,0,0,0,0,0,0,0,0,0,0,0,701,10,0,0,0,0,0,0,0,0,0,100
65ef231b4ff8309dde608fe637a1c06288636252,11,15,12,3,0,0,0,2,6,81,1,4,3.263603706,419,44,9,66,73,7,2727,2726,1,54,61,7,97.34848485
c61d2220dad39958541430eeb67b7e8b175fec46,10,1088,67,1021,1,0,1,2,31,86,2,3,2.340056753,2060,702,11,515,372,143,19485,14158,5327,255,210,45,97.12962963
0466e0fa14634e8dbc4719376544fc726eb91faf,0,0,0,0,0,0,0,0,0,0,0,0,0,0,703,12,0,0,0,0,0,0,0,0,0,100
4331f31f2b07e3baf36383743c2cf7872af88592,1,2,3,1,0,0,0,2,2,652,1,1,0,186,704,13,34,34,0,1432,1440,8,12,12,0,100
a26e10ff827fa6825b4821031f5b07e064de2706,0,0,0,0,0,0,0,0,0,0,0,0,0,0,705,14,0,0,0,0,0,0,0,0,0,100
4cdef89882def55fcba7aa3b8901f04a7bc340b3,2,17,10,7,0,0,0,2,6,57,1,1,0.380946586,86,706,15,19,18,1,495,473,22,18,17,1,100
47f79549b89d11443fcf7b6bf0a905e4699db93d,7,126,70,56,0,0,0,2,24,40,3,3,1.402433523,670,707,13,115,109,6,5501,5208,293,53,50,3,98.92761394
dbcdd30238f3294d55f3eed2868d67c5daa61944,2,42,26,16,0,0,0,2,8,10,1,1,0.26086291,580,45,5,89,89,0,4252,4134,118,36,35,1,100
0fd8ac3ec4955196c97b7f65e7bc6503cdf58405,8,116,37,79,0,0,0,2,25,39,1,3,2.334207429,1154,46,6,189,179,10,8757,8055,702,107,106,1,95.84487535
b0c7500a2531bfa7080b145ba38b464cf72ce715,0,0,0,0,0,0,0,0,0,0,0,0,0,0,47,7,0,0,0,0,0,0,0,0,0,100
0ed17d71d4c8b224d22ca4757b107dc0a7268fd4,1,76,0,76,1,0,1,1,1,0,1,1,0,0,708,14,10,0,10,286,0,286,9,0,9,99.61352657
6522849b193ab177335d1c72be22c42dad65ce69,2,5,4,1,0,0,0,2,7,0,1,2,0.918295834,542,709,15,91,91,0,3748,3732,16,36,36,0,100
1a918f916e3b4debf0037fe58e9c0f3b500d69bf,0,0,0,0,0,0,0,0,0,0,0,0,0,0,710,16,0,0,0,0,0,0,0,0,0,100
af72c00e04782fcfd139135968179bcd3e91d2f5,4,121,21,100,0,0,0,3,16,237,1,3,1.013831561,937,48,3,182,180,2,6612,6211,401,74,72,2,98.74517375
01d510d97b627eaf27ede33da6d018192ba2a106,1,18,10,8,0,0,0,2,5,23,1,1,0,15,711,9,0,0,0,128,122,6,0,0,0,100
d43d0141842853d6a5fb6432a317837b318f6bc5,4,308,0,308,3,0,3,1,14,14,2,2,1.607642676,243,49,1,85,59,26,3195,1634,1561,63,50,13,98.37631328
5b8ce05952c53d6c3ed575e904d62f4b6ce015ab,1,2,0,2,0,0,0,3,5,412,1,1,0,69,712,1,15,15,0,431,422,9,13,13,0,100
c8b4acad5eb9412740ba6763fba060b984efa00a,0,0,0,0,0,0,0,0,0,0,0,0,0,0,713,2,0,0,0,0,0,0,0,0,0,100
9246be22fc528d2735eaf7c5043298e90ffc27a5,0,0,0,0,0,0,0,0,0,0,0,0,0,0,714,3,0,0,0,0,0,0,0,0,0,100
6c203186f2add834f3e5a07b9d112bf2f45ae9c5,11,731,66,665,5,0,5,1,32,92,1,4,2.946375622,2202,4,0,485,416,69,18728,15413,3315,187,162,25,98.50746269
e03d072ed875748d365fdb47183d90d063daec80,0,0,0,0,0,0,0,0,0,0,0,0,0,0,715,3,0,0,0,0,0,0,0,0,0,100
4447493c576c7a983eb1c66c62f42b3299612eb8,0,0,0,0,0,0,0,0,0,0,0,0,0,0,716,4,0,0,0,0,0,0,0,0,0,100
27e2eda89ae03d32a630a8e21435a55fd0bed935,3,172,42,130,0,0,0,3,12,195,1,1,1.324699497,634,717,5,140,118,22,5265,4401,864,66,63,3,100
3032b0c8db8a7b9fd8d23067b6f267cff0c0baa2,0,0,0,0,0,0,0,0,0,0,0,0,0,0,718,6,0,0,0,0,0,0,0,0,0,100
2c21db2717f5a56784fd236a4a8c809b2cd976ae,29,694,2419,1725,5,0,5,1,3,264,1,4,4.544522965,1547,5,1,84,313,229,2994,11310,8316,37,149,112,93.4678194
6dfcfd9c7356f5fcee2dad274656bf23d3ef085d,0,0,0,0,0,0,0,0,0,0,0,0,0,0,719,4,0,0,0,0,0,0,0,0,0,100
eb2e9422202d8bfbc9be5db5f225230f4ec9b1b1,0,0,0,0,0,0,0,0,0,0,0,0,0,0,720,5,0,0,0,0,0,0,0,0,0,100
0c116a175facfcaeeafe96d5c100cc324fa93ea0,0,0,0,0,0,0,0,0,0,0,0,0,0,0,721,6,0,0,0,0,0,0,0,0,0,100
5f8ce54021137dbbdc5c751738f7169576f1da1e,0,0,0,0,0,0,0,0,0,0,0,0,0,0,722,7,0,0,0,0,0,0,0,0,0,100
bc011e4fa5187334df6964ffecbcd329ee9ce810,0,0,0,0,0,0,0,0,0,0,0,0,0,0,723,8,0,0,0,0,0,0,0,0,0,100
33c5559c2aa4df2c6e3217c42e7c488d936b8baa,0,0,0,0,0,0,0,0,0,0,0,0,0,0,724,9,0,0,0,0,0,0,0,0,0,100
fe082c8bb467aadafc2e7cc0f5647b6f9a152160,0,0,0,0,0,0,0,0,0,0,0,0,0,0,725,10,0,0,0,0,0,0,0,0,0,100
e5a7129844084c36a4121291684f57b8b304a32c,0,0,0,0,0,0,0,0,0,0,0,0,0,0,726,11,0,0,0,0,0,0,0,0,0,100
2637192f9d47b28bb295f520bc23d2df0b6a4f15,0,0,0,0,0,0,0,0,0,0,0,0,0,0,727,12,0,0,0,0,0,0,0,0,0,100
ce155cf06a7814d3c26051b4d2d7ee50e93e5fd3,0,0,0,0,0,0,0,0,0,0,0,0,0,0,728,13,0,0,0,0,0,0,0,0,0,100
49dc9757ba3cdef8261c24db7244ed290bd64dc2,0,0,0,0,0,0,0,0,0,0,0,0,0,0,729,14,0,0,0,0,0,0,0,0,0,100
fa55aec58f53a4456bc6f480cec2d953dff774fc,0,0,0,0,0,0,0,0,0,0,0,0,0,0,730,15,0,0,0,0,0,0,0,0,0,100
36ae4f41277b6fa2d40cd19aec6f82ce30eec987,0,0,0,0,0,0,0,0,0,0,0,0,0,0,731,16,0,0,0,0,0,0,0,0,0,100
d693320763273f9825f46f83383c8fc6f898b749,0,0,0,0,0,0,0,0,0,0,0,0,0,0,732,17,0,0,0,0,0,0,0,0,0,100
40e9ad841168fb604aa888eac5584e587977898a,0,0,0,0,0,0,0,0,0,0,0,0,0,0,733,18,0,0,0,0,0,0,0,0,0,100
eaf269373fd9444c6062559dcf33e31f09a9c811,0,0,0,0,0,0,0,0,0,0,0,0,0,0,734,19,0,0,0,0,0,0,0,0,0,100
74ed21ac98a66b470d7a3905b38d38e9303fa80d,0,0,0,0,0,0,0,0,0,0,0,0,0,0,735,20,0,0,0,0,0,0,0,0,0,100
8340070fdbe39b1fa10b02c1f2130b3540cdabc9,0,0,0,0,0,0,0,0,0,0,0,0,0,0,736,21,0,0,0,0,0,0,0,0,0,100
36f231f8234d85048ad8946dd276dffb58b44c37,0,0,0,0,0,0,0,0,0,0,0,0,0,0,737,22,0,0,0,0,0,0,0,0,0,100
9a722e3e24e891685c1fc3ccdb7fb1f630125fe6,0,0,0,0,0,0,0,0,0,0,0,0,0,0,738,23,0,0,0,0,0,0,0,0,0,100
e6878e8fac865b12436b33db0296b9c00e30802b,0,0,0,0,0,0,0,0,0,0,0,0,0,0,739,24,0,0,0,0,0,0,0,0,0,100
b2e150954703c8d7608d4182e42dbb1156c86bee,0,0,0,0,0,0,0,0,0,0,0,0,0,0,740,25,0,0,0,0,0,0,0,0,0,100
e486a181b434365862231e176237e18e400523e2,0,0,0,0,0,0,0,0,0,0,0,0,0,0,741,26,0,0,0,0,0,0,0,0,0,100
c3b883a5e484ad314c351bca6ecd647022b44cca,0,0,0,0,0,0,0,0,0,0,0,0,0,0,742,27,0,0,0,0,0,0,0,0,0,100
640b563a7cfc4ccf6dda73e1d3afe5d3ec59ccb4,0,0,0,0,0,0,0,0,0,0,0,0,0,0,743,28,0,0,0,0,0,0,0,0,0,100
dc97651860d9a301b101210aab078609301d00d4,0,0,0,0,0,0,0,0,0,0,0,0,0,0,744,29,0,0,0,0,0,0,0,0,0,100
1a12d4df004a21f7c216dfe9dfee583c90d2b3c6,0,0,0,0,0,0,0,0,0,0,0,0,0,0,745,30,0,0,0,0,0,0,0,0,0,100
bd09661f095bf2fc5830f36d55a58f4096b19843,0,0,0,0,0,0,0,0,0,0,0,0,0,0,746,31,0,0,0,0,0,0,0,0,0,100
107c1cc1741d931a158d79b16d9966046f4cb1b0,0,0,0,0,0,0,0,0,0,0,0,0,0,0,747,32,0,0,0,0,0,0,0,0,0,100
c97a645b730541feaf6debd0e968f2e74aff6b94,0,0,0,0,0,0,0,0,0,0,0,0,0,0,748,33,0,0,0,0,0,0,0,0,0,100
a74209efbe6970b950d0f28a06b685efb572d790,0,0,0,0,0,0,0,0,0,0,0,0,0,0,749,34,0,0,0,0,0,0,0,0,0,100
9971281476083aef67d060bff20df4d749e64506,0,0,0,0,0,0,0,0,0,0,0,0,0,0,750,35,0,0,0,0,0,0,0,0,0,100
4fea67fff97c13d45728e5d5e847193ff748039c,0,0,0,0,0,0,0,0,0,0,0,0,0,0,751,36,0,0,0,0,0,0,0,0,0,100
73c5483f2cd3dac9d68919132ed18bb2bb388d70,0,0,0,0,0,0,0,0,0,0,0,0,0,0,752,19,0,0,0,0,0,0,0,0,0,100
3b66f7ab71658f62d5747ffc74df6bdd3b1d7aef,2,28,27,1,0,0,0,2,26,138,1,2,0.439496987,826,753,20,139,138,1,5564,5526,38,69,69,0,100
d01cb2c0e5a459517538a97fbe01bc4cf63a38a2,2,5,6,1,0,0,0,1,15,115,2,2,0.845350937,283,754,21,66,66,0,1920,1920,0,55,55,0,100
1a7286afce71c005bae8d45e6b280e977f823a79,1,11,7,4,0,0,0,2,4,252,1,1,0,312,755,22,51,49,2,2265,2191,74,22,22,0,100
7e43b4c1e525f3dfa9263ddce595e43fb15dbb2c,0,0,0,0,0,0,0,0,0,0,0,0,0,0,10,0,0,0,0,0,0,0,0,0,0,100
f4826950b285c34d97cd157a0840e72f09231c7f,15,990,192,798,6,0,6,2,27,70,1,4,3.337751676,1350,756,23,290,201,89,12324,9351,2973,170,113,57,97.72502473
402458e291cceb0d67f4bc6bd9b9513cbf4ace2e,15,193,991,798,0,0,0,2,28,0,1,4,3.338391303,1854,757,24,201,290,89,9351,12324,2973,113,170,57,97.72502473
91b91905257ed4eeba690b5c7d0312770147307b,0,0,0,0,0,0,0,0,0,0,0,0,0,0,11,1,0,0,0,0,0,0,0,0,0,100
1f363c2f0b1d5ee8cb7501a2a7a8994349724cc6,15,978,178,800,6,0,6,2,29,0,1,4,3.308287844,1350,758,25,290,201,89,12324,9351,2973,170,113,57,97.72502473
3f950642778c3859096e1c1215404aec24c10c04,0,0,0,0,0,0,0,0,0,0,0,0,0,0,759,26,0,0,0,0,0,0,0,0,0,100
0ea76eb07c1daefa7104896695f061e0c6fe5278,0,0,0,0,0,0,0,0,0,0,0,0,0,0,760,27,0,0,0,0,0,0,0,0,0,100
5980f4db1630ddef8d0e6d31b06d4751971b6c54,1,1,1,0,0,0,0,2,2,114,1,1,0,117,12,2,14,14,0,937,940,3,6,6,0,100
dc73f5061c2bc529fa8e032177f7cfb1a48a4091,1,1,1,0,0,0,0,3,9,265,1,1,0,234,50,0,39,39,0,1628,1626,2,16,16,0,100
b51545e4e89e659ff1ad9453bad5310dfe619653,26,964,133,831,8,0,8,2,30,165,3,6,3.373452211,1530,51,1,345,248,97,15314,11858,3456,153,114,39,95.11952191
10cb3b67606e313c11c083531f7a996a6152c2a4,1,2,2,0,0,0,0,2,4,225,1,1,0,458,761,3,99,100,1,3033,3054,21,55,55,0,100
92c33d8c343a110301a01a5ef54bad1cf362102d,3,14,15,1,0,0,0,3,4,579,1,1,1.269920726,232,13,1,29,29,0,1834,1797,37,6,6,0,100
151aa0107425922beb6d950ea6f2213bf5983acd,12,15,15,0,0,0,0,2,11,44,2,5,3.456564762,632,14,2,91,98,7,4637,4656,19,61,68,7,97.18875502
ef192586fbbfe724de68cd52218c2741cd6202ed,7,0,0,0,0,0,0,1,1,0,1,1,0,267,15,3,49,56,7,1393,1442,49,49,56,7,97.22222222
647298acfd25b9caf18d39673420fd89bbf45caf,1,2,2,0,0,0,0,2,5,66,1,1,0,321,16,3,51,51,0,2263,2265,2,22,22,0,100
282c35458b789a848cbe5bec94426eb76db05203,0,0,0,0,0,0,0,0,0,0,0,0,0,0,52,2,0,0,0,0,0,0,0,0,0,100
fb86dce3702c1d163a14bdab09bbd7e97fb5a06a,0,0,0,0,0,0,0,0,0,0,0,0,0,0,762,1,0,0,0,0,0,0,0,0,0,100
348c4d1ae8abb032ca317f6c94985ed66ceb9ad9,0,0,0,0,0,0,0,0,0,0,0,0,0,0,17,4,0,0,0,0,0,0,0,0,0,100
31ad7e0aac5f82c5556432f48dabd7870521cb59,0,0,0,0,0,0,0,0,0,0,0,0,0,0,763,2,0,0,0,0,0,0,0,0,0,100
a575cd536a2497f6deeff915430849d794441a33,8,205,38,167,0,0,0,2,31,141,3,4,2.479969054,1039,53,3,200,184,16,8710,7705,1005,94,88,6,99.60356789
4d14b4841ea850761670f2f5b60632f30fd095b4,1,14,15,1,0,0,0,3,29,57,1,1,0,403,18,5,68,68,0,2544,2538,6,44,44,0,100
b5fb196987426f0ca65f432fec43eeadbe2462ac,1,22,10,12,0,0,0,1,2,161,1,1,0,46,54,4,8,7,1,508,426,82,3,3,0,100
24f7d052fe84faaec6e57fbb06ea0b619b4cc966,1,108,0,108,1,0,1,1,1,0,1,1,0,0,55,5,14,0,14,321,0,321,13,0,13,99.80237154
f41e86161cf9777f71abba823d9fec72c9e21c07,31,569,351,218,0,0,0,2,23,113,3,9,3.777421818,4065,56,5,772,760,12,33431,31403,2028,304,300,4,97.54178958
731e4321925d101a8886ee27421d2825c80df9ca,19,492,98,394,3,0,3,1,33,115,2,7,3.050474733,2446,57,6,506,463,43,18423,16450,1973,228,209,19,95.29411765
7b76390db525faa748a4990c46ec743b212c2cf0,17,373,213,160,1,0,1,2,21,129,1,5,2.765738959,2022,58,7,299,296,3,14060,13899,161,146,145,1,99.83221477
804ace7d0cdfb59ab4d04e442080652d7cb0e666,2,27,2,25,0,0,0,2,11,292,2,2,0.362051252,86,59,8,34,19,15,679,525,154,19,17,2,100
070a311f33cada88e50b4870b3c32982dbc65664,1,16,19,3,0,0,0,2,11,4,1,1,0,364,60,9,65,65,0,2897,2911,14,12,12,0,100
ac0e361849ea3ac6cbca2ed4844897385d2d738e,23,241,90,151,0,0,0,1,32,57,3,7,3.476161851,3737,61,10,705,684,21,29108,28117,991,314,308,6,96.81697613
8b5c81c2072f930ddeaf64faa4eff60172e8f41b,0,0,0,0,0,0,0,0,0,0,0,0,0,0,764,3,0,0,0,0,0,0,0,0,0,100
1f0ca3c342265e5902774210ace894f20e3ecf58,0,0,0,0,0,0,0,0,0,0,0,0,0,0,765,4,0,0,0,0,0,0,0,0,0,100
568ef7578dcf7245e5b87fcd47f8d74fab183c43,0,0,0,0,0,0,0,0,0,0,0,0,0,0,766,5,0,0,0,0,0,0,0,0,0,100
942be60b75e1ce09e3426a110ca0c0139985d2b7,0,0,0,0,0,0,0,0,0,0,0,0,0,0,767,6,0,0,0,0,0,0,0,0,0,100
f6543eaaddd882ddfc51bad4b01038070f83b4c0,0,0,0,0,0,0,0,0,0,0,0,0,0,0,768,7,0,0,0,0,0,0,0,0,0,100
f16bd2cbc2aa8b77d1668d5f47ea39763f67c3ac,1,2,2,0,0,0,0,2,7,14,1,1,0,118,769,7,23,23,0,862,872,10,15,15,0,100
bf1d1aa113dd4c87f7f7906d6c72106c9110b4a0,11,187,105,82,0,0,0,1,13,15,2,4,1.704973823,905,62,10,185,169,16,7840,6975,865,66,64,2,96.5973535
aea4998f952c834a644927539910452eb161e1e2,1,41,0,41,1,0,1,1,1,0,1,1,0,0,63,11,2,0,2,91,0,91,2,0,2,99.15014164
63424f3a8a4c8eef0e7e59a6967e57561b68923f,0,0,0,0,0,0,0,0,0,0,0,0,0,0,770,8,0,0,0,0,0,0,0,0,0,100
1d327708347d1041d2323098d8e4cf6bfd5f2762,0,0,0,0,0,0,0,0,0,0,0,0,0,0,771,9,0,0,0,0,0,0,0,0,0,100
29cf86cd7472e6ea7dfa840ccb9f9e9d8a9ed7cd,25,494,1242,748,1,0,1,1,14,51,3,8,4.200279956,2414,64,12,327,410,83,14238,19900,5662,113,156,43,92.41316271
c38bed51e4e320ecdb3c55c7ec9f779f911bee75,0,0,0,0,0,0,0,0,0,0,0,0,0,0,65,13,0,0,0,0,0,0,0,0,0,100
77f5f731679f653466e1cae632d534dfecb3c3a4,4,20,1,19,0,0,0,2,15,2,2,2,1.664497779,564,66,14,97,94,3,4785,4706,79,22,20,2,100
8b565fa31eb772c64e456ddd81bc4a720103b817,3,6,7,1,0,0,0,2,4,153,1,1,1.52623491,786,19,6,205,205,0,6321,6331,10,82,82,0,100
8a4b9875cfee4fa2b087fd7d875af9023e11ffed,0,0,0,0,0,0,0,0,0,0,0,0,0,0,20,7,0,0,0,0,0,0,0,0,0,100
27a78053ed1395b14c59f6ae1a2231a8144b4582,13,797,106,691,2,0,2,2,34,190,1,4,2.8090038,3544,772,10,769,676,93,27401,24454,2947,337,297,40,95.99627561
5040e451f026ca875f9d57c9d0742426c84963b1,6,60,56,4,0,0,0,1,26,0,1,1,1.651451047,1838,773,11,374,373,1,12666,12614,52,168,169,1,100
e3d370049e8bfa1a6e4ec08899a4057e1eb8f951,0,0,0,0,0,0,0,0,0,0,0,0,0,0,774,12,0,0,0,0,0,0,0,0,0,100
9fa11a33aeb15a1b21fcf48c15d2897339f62c8a,0,0,0,0,0,0,0,0,0,0,0,0,0,0,775,13,0,0,0,0,0,0,0,0,0,100
9c71834d485415bd770f44add280ca8b593f9c5c,0,0,0,0,0,0,0,0,0,0,0,0,0,0,776,12,0,0,0,0,0,0,0,0,0,100
374e392d7332fb10c6f7af408a2496aeb4d29247,0,0,0,0,0,0,0,0,0,0,0,0,0,0,777,13,0,0,0,0,0,0,0,0,0,100
1efa6d449f325ea3bed1802ac91a350c52758672,3,68,22,46,0,0,0,2,16,18,1,1,1.557783281,585,67,10,121,116,5,4849,4671,178,39,34,5,100
bb4e99f052df19078ed42574cc9f1f7ffe94e68c,19,885,488,397,4,0,4,1,35,165,1,3,3.504394025,2880,6,0,603,566,37,21327,19906,1421,250,234,16,98.46449136
eb8436ccd53ecca8685ced0195a19f62f5568ff7,3,0,0,0,3,0,3,1,3,0,1,1,0,0,7,1,0,0,0,0,0,0,0,0,0,99.42748092
9590f349d5b659a0a2c6fc373c11f1df4fd34316,14,155,175,20,0,0,0,2,17,16,2,3,2.286326894,1119,778,14,209,209,0,8731,8731,0,72,72,0,100
3ffba653930e1e0f92dcd984b0bb4fc00ac04b69,1,4,3,1,0,0,0,2,11,9,1,1,0,80,68,4,11,11,0,688,679,9,4,4,0,100
bb866cf06793c293f355636c9a77e832065fc73b,1,3,3,0,0,0,0,2,12,1,1,1,0,81,779,7,11,11,0,688,688,0,4,4,0,100
257b20c409d3a96611682c4e9e5b4be02a7bc7d8,0,0,0,0,0,0,0,0,0,0,0,0,0,0,21,0,0,0,0,0,0,0,0,0,0,100
0a5ea07ff170bbce006d2d27ba5cabf08443e863,0,0,0,0,0,0,0,0,0,0,0,0,0,0,22,1,0,0,0,0,0,0,0,0,0,100
ad40fd1635bff3ea02ff6299b2d3ce63191da1db,0,0,0,0,0,0,0,0,0,0,0,0,0,0,23,2,0,0,0,0,0,0,0,0,0,100
3ae93cc2fcf6400ccfc4efbce9e51af6d576e1ca,2,53,34,19,0,0,0,4,22,75,1,2,0.362051252,473,780,4,64,61,3,3316,2909,407,25,24,1,98.01886792
a2c1e3a953c0a20c5d49e965539e440b43a8efc2,1,10,1,9,0,0,0,4,23,0,1,1,0,143,781,5,13,13,0,1142,1108,34,6,6,0,100
d69bd15284449801e9123b079371f7cbb5d4bc7f,5,60,35,25,0,0,0,2,18,31,2,3,1.744835082,814,782,6,167,159,8,6570,6519,51,52,50,2,100
ac4969839ff9b9b9a964a4afae1fd8d13787a7b6,0,0,0,0,0,0,0,0,0,0,0,0,0,0,783,7,0,0,0,0,0,0,0,0,0,100
747ee83990f9c8214317b409b0e1822a9f815fc6,0,0,0,0,0,0,0,0,0,0,0,0,0,0,0,0,0,0,0,0,0,0,0,0,0,100
11ecd082f95688f6e1da2fc9e5fe2b5234c0ff8a,0,0,0,0,0,0,0,0,0,0,0,0,0,0,784,8,0,0,0,0,0,0,0,0,0,100
2994bac28f74d6c9ad996689428b7a1f8d895c5d,1,2,0,2,0,0,0,2,19,0,1,1,0,443,785,9,85,85,0,3820,3820,0,15,15,0,100
ac5e33d0735664feab913f42682e3b19578c915d,7,49,40,9,0,0,0,2,20,18,2,3,1.609585318,1100,69,2,220,218,2,8872,8831,41,66,65,1,100
4b983fc7c52e1778d54c817eef0a34c8d5e2b8d2,0,0,0,0,0,0,0,0,0,0,0,0,0,0,70,3,0,0,0,0,0,0,0,0,0,100
6197d8e53efa30907371044d6442212d2e3e018a,0,0,0,0,0,0,0,0,0,0,0,0,0,0,71,4,0,0,0,0,0,0,0,0,0,100
3203cb0c4d33e940835c7387b7056b3cb8b600a1,8,21,30,9,0,0,0,2,8,396,2,2,2.745790421,1045,72,5,130,130,0,7733,7715,18,57,57,0,100
7d6c0b80ba74fd95121435091b7cc71e942277df,73,1087,943,144,0,0,0,2,36,435,1,10,4.693219279,10015,73,6,1999,2000,1,69637,69550,87,978,979,1,98.11676083
3973e4785e45c3d9fac7be347d0bcce8bb1ddba4,1,2,0,2,0,0,0,4,24,5,1,1,0,149,74,7,13,13,0,1149,1142,7,6,6,0,100
4c8153109dfd8691e056dbd6233c291b11b76917,2,1,5,4,0,0,0,2,25,29,2,2,0.918295834,254,786,10,24,24,0,1922,1936,14,9,9,0,100
0ddf1fe595b46f92781d486c674987430b0af06c,2,5,1,4,0,0,0,2,26,0,2,2,0.918295834,250,787,11,24,24,0,1936,1922,14,9,9,0,100
0e6c6b33927ae842e5cac80bfb58579d25ed30dc,0,0,0,0,0,0,0,0,0,0,0,0,0,0,788,10,0,0,0,0,0,0,0,0,0,100
e96a3005edce9e0efcac7f1642ab044df0afb95e,1,2,1,1,0,0,0,2,12,2,1,1,0,342,75,8,51,51,0,2205,2194,11,19,19,0,100
26e5f68c0c23700963f24f34d7b423970b1832ce,11,210,241,31,0,0,0,2,37,32,2,5,2.444223384,3149,76,8,574,574,0,21727,21997,270,243,244,1,99.71264368
402d58a492224d6b5b9c194d5974361d7e3e9b67,4,505,0,505,3,0,3,1,16,14,1,3,1.518464193,20,77,9,61,2,59,2582,159,2423,28,1,27,99.33269781
ec4125db0b4a7f1f31bd3b017e2b30ca121d6dd2,0,0,0,0,0,0,0,0,0,0,0,0,0,0,78,10,0,0,0,0,0,0,0,0,0,100
03ba07aecb474bcbb9bfba97286329ee93afdf35,2,11,1,10,0,0,0,4,22,2,1,1,0.979868757,931,79,11,197,195,2,6264,6203,61,92,92,0,100
650a981e6b9cb8ee5a165095c4c4116a766ea7e1,1,2,3,1,0,0,0,4,13,2,1,1,0,219,80,12,48,48,0,1442,1446,4,31,31,0,100
c7ad781191befa005bdf332909ea3b355af4096d,1,3,4,1,0,0,0,3,34,12,1,1,0,387,24,3,66,66,0,2570,2578,8,36,36,0,100
b3b9816b44d7074f8a41ffecd9cb7efe4dcb1073,0,0,0,0,0,0,0,0,0,0,0,0,0,0,789,10,0,0,0,0,0,0,0,0,0,100
2d789907aa961be6e6e395c3349d5dd36bb992e8,0,0,0,0,0,0,0,0,0,0,0,0,0,0,790,11,0,0,0,0,0,0,0,0,0,100
f07c1845dbace9fa79a670b70f8bb68e2365c6db,0,0,0,0,0,0,0,0,0,0,0,0,0,0,791,12,0,0,0,0,0,0,0,0,0,100
f80af4ace6177d07ce4c91dacbb6ea7bd3a6e640,4,75,66,9,0,0,0,2,17,34,2,4,1.557620507,346,81,13,63,59,4,2661,2675,14,19,16,3,98.67298578
958ae2d23b1b7734f569af0bce7dc9ba60c2542d,1,3,3,0,0,0,0,3,18,18,1,1,0,247,25,4,60,60,0,1669,1672,3,50,50,0,100
aeeef1aa6e3d1bcf9e74ce64a09edfb4cc8b46bd,1,1,0,1,0,0,0,5,14,11,1,1,0,218,0,0,48,48,0,1444,1442,2,31,31,0,100
c7db2db070cf3c34ae00f939e8dfe48bc2215e4d,2,27,4,23,0,0,0,2,8,11,1,2,0.637387499,181,82,13,29,25,4,1502,1395,107,8,6,2,100
e739ed7ba656646ddc66db3ac18484f23e804f2b,6,33,37,4,0,0,0,2,18,18,1,2,2.239211779,694,792,12,121,121,0,5290,5304,14,36,36,0,100
153c94689686bcff8934d7661a8bca4ef2a2a67f,0,0,0,0,0,0,0,0,0,0,0,0,0,0,1,1,0,0,0,0,0,0,0,0,0,100
c3c56392e4c11e6b3d08618d61db725c819a58b4,21,1626,314,1312,10,0,10,3,35,78,1,4,3.792860794,2955,2,2,587,501,86,24423,20066,4357,282,233,49,94.53197405
8c758866493eb7a79f8ad52e6dd1a7771fc60a13,21,314,1626,1312,0,0,0,2,34,42,1,4,3.792860794,3582,793,13,501,587,86,20066,24423,4357,233,282,49,94.53197405
ed16ad6dab91cc3250bc62187b989bc30caf6492,0,0,0,0,0,0,0,0,0,0,0,0,0,0,794,14,0,0,0,0,0,0,0,0,0,100
2cc8a1a0cfd79cc7d641fe09d802bff936eb24bf,0,0,0,0,0,0,0,0,0,0,0,0,0,0,795,15,0,0,0,0,0,0,0,0,0,100
864d1a07c810a2a437823d0be5ff2a9339f91067,0,0,0,0,0,0,0,0,0,0,0,0,0,0,796,16,0,0,0,0,0,0,0,0,0,100
c0bef31258c949fe5200a33201e6c32577e74094,1,21,5,16,0,0,0,2,21,38,1,1,0,448,797,17,87,86,1,3947,3830,117,15,15,0,100
a9aa9e7d1949408f1d9c0ebd18a0ae9f3d73a1bb,1,1,1,0,0,0,0,2,22,0,1,1,0,459,798,17,87,87,0,3947,3947,0,15,15,0,100
a97d4e9846ee4fadb685482b3a9ecdf697947e37,1,0,1,1,0,0,0,4,15,117,1,1,0,168,1,1,30,30,0,1053,1060,7,13,13,0,100
5d4ef22206500de94c2c6f3ce96b7934afe6c325,0,0,0,0,0,0,0,0,0,0,0,0,0,0,799,10,0,0,0,0,0,0,0,0,0,100
ed219a51e1dbcd9ffc6379982ddc227a6d9f8018,0,0,0,0,0,0,0,0,0,0,0,0,0,0,800,11,0,0,0,0,0,0,0,0,0,100
cff28669f9d116b758da337c82719dbf8faccee9,1,10,20,10,0,0,0,1,2,1014,1,1,0,90,26,0,22,22,0,768,818,50,14,14,0,100
7bca97d27cb109aac1d1db5f2c8953aff9e6adf5,2,14,17,3,0,0,0,3,6,85,1,1,0.962900415,706,27,1,181,181,0,5741,5742,1,73,73,0,100
d4a50645fc2a177d485e174d7e14e62ab4594828,3,14,18,4,0,0,0,2,5,422,1,1,1.247556249,186,28,2,48,48,0,1173,1201,28,22,22,0,100
3e85482848fb619440b4080389aa8c2e58b811ea,11,2587,0,2587,11,0,11,1,1,0,1,1,2.798082618,0,29,3,281,0,281,8455,0,8455,149,0,149,97.68303985
e83b4274276393b432fd532d93c1833d5b498d66,2,239,0,239,2,0,2,1,1,0,1,1,0.887838614,0,30,4,38,0,38,1020,0,1020,21,0,21,99.54873646
ec6054612b290c455b6cbe3413687e1593593056,0,0,0,0,0,0,0,0,0,0,0,0,0,0,801,4,0,0,0,0,0,0,0,0,0,100
fe6131347d83c6e54e6384abf9dba423423a3798,0,0,0,0,0,0,0,0,0,0,0,0,0,0,802,3,0,0,0,0,0,0,0,0,0,100
459ed7c20b7c0dbda84e2a28a011735d27d38657,0,0,0,0,0,0,0,0,0,0,0,0,0,0,31,5,0,0,0,0,0,0,0,0,0,100
8166adcd09e4a4005a554123507c674969292654,0,0,0,0,0,0,0,0,0,0,0,0,0,0,32,6,0,0,0,0,0,0,0,0,0,100
042e62c4a58bf94e1b88b38c6f669079c2f37984,0,0,0,0,0,0,0,0,0,0,0,0,0,0,33,7,0,0,0,0,0,0,0,0,0,100
534523e6b78f38be6bd4e0d6e694497c10ee87a8,13,1858,2423,565,0,0,0,2,2,13,1,2,2.716206641,1654,83,0,270,319,49,8090,9475,1385,136,170,34,99.0942029
96ed9f1be5f22acc49cc010e12edfbf0e6140f63,1,10,74,64,0,0,0,3,32,104,1,1,0,408,84,1,59,69,10,2217,2572,355,38,45,7,100
ffa4756bad33c0eb3ef0ee9f2bb6eda0069079de,66,4885,3025,1860,22,0,22,0,38,74,3,12,5.085863239,9316,3,0,1872,1772,100,71900,64159,7741,863,800,63,90.73294019
a26058fac95c61f1ea188523b4ef20db0b75c6e1,18,2341,170,2171,9,0,9,2,35,134,3,5,2.934940514,2063,5,1,705,448,257,23174,15508,7666,319,193,126,90.42471042
1b9d778dac249e841bfef0f82d4998bb39ae5633,0,0,0,0,0,0,0,0,0,0,0,0,0,0,6,2,0,0,0,0,0,0,0,0,0,100
686212750a31bcae81082e8d53136f581d30296c,0,0,0,0,0,0,0,0,0,0,0,0,0,0,803,0,0,0,0,0,0,0,0,0,0,100
bddfcc59280d795332f6936e333da830445ed217,3,59,33,26,0,0,0,3,23,277,1,1,1.17038022,47,34,0,2,2,0,563,459,104,2,2,0,96.43134213
da60eae7fd2cadd42743f2029a13827ccc889ee0,4,31,36,5,0,0,0,2,20,24,1,3,1.4228426,1165,85,0,246,239,7,8016,7852,164,106,106,0,100
71a5f56e9d9abb5ab0c0efd3b2f170b218993c86,3,11,8,3,0,0,0,2,23,179,1,2,1.432983121,711,86,1,130,130,0,5701,5700,1,34,34,0,100
80a3b9b0d78076fc3d5d4093543039050963f7c0,2,7,0,7,0,0,0,2,24,108,1,1,0.863120569,487,87,2,95,94,1,4152,4099,53,23,22,1,100
cf35fa081f8c19d2059353de2f1ea604446e109a,1,5,1,4,0,0,0,2,25,4,1,1,0,461,88,3,88,87,1,4014,3984,30,15,15,0,100
c58145626e34f4b36789f12872d5e3ce87dd3359,7,96,43,53,0,0,0,2,14,190,1,1,2.067156496,531,89,4,74,71,3,3828,3564,264,50,49,1,100
3616230102bca2f20c9e4e5774b0db4739439abd,1,57,0,57,1,0,1,1,1,0,1,1,0,0,90,5,1,0,1,91,0,91,1,0,1,99.68479117
e107f46fb48fba452be37226f0ffc784024828f1,1,79,1,78,0,0,0,4,37,38,1,1,0,443,91,6,96,80,16,3391,2986,405,40,38,2,100
58a9e8370ec701fe10ae4ad444622b7eeb0aa664,1,5,21,16,0,0,0,2,26,7,1,1,0,465,92,7,87,88,1,3897,4014,117,15,15,0,100
d8752bf5aef6a4ecb7ea0d1f6047ebb1accecacf,1,0,6,6,0,0,0,2,27,1,1,1,0,454,93,8,86,87,1,3830,3897,67,15,15,0,100
427047fc28fb089e12aa9a3a84b43a71c30fdfd9,1,21,5,16,0,0,0,2,28,3,1,1,0,448,94,9,87,86,1,3947,3830,117,15,15,0,100
b200734b3f0ed6474470759bab516cd61dca08df,0,0,0,0,0,0,0,0,0,0,0,0,0,0,804,0,0,0,0,0,0,0,0,0,0,100
9acc51a7b2cf899a40e199292f84cc65249d111b,0,0,0,0,0,0,0,0,0,0,0,0,0,0,805,1,0,0,0,0,0,0,0,0,0,100
3ad813e15b9cb5a6c0f52b314fc7df66768f49a8,9,881,20,861,7,0,7,1,17,34,2,5,2.241871781,128,95,10,121,30,91,5418,871,4547,43,16,27,98.37209302
4a1902f08348e86bff7ef6ba93891a09b04e6468,3,19,40,21,0,0,0,2,38,30,2,3,1.287848447,888,96,11,146,146,0,5985,5979,6,56,56,0,100
526d55675d5e50a7ea4f6b6c26d7682a44c7452b,1,40,39,1,0,0,0,2,2,6,1,1,0,52,806,2,4,5,1,494,495,1,1,1,0,100
63799243755045cde8af9a7b18c770276d960a43,0,0,0,0,0,0,0,0,0,0,0,0,0,0,807,3,0,0,0,0,0,0,0,0,0,100
6b25ac3fb00a12aaf3b7d1f337b4a178828d38aa,5,204,20,184,0,0,0,2,39,39,2,4,1.158418627,1579,808,4,296,269,27,12987,11866,1121,118,113,5,100
f0e48efec6c432dc570ec666d5785d1ef62434b6,1,3,3,0,0,0,0,2,3,263,1,1,0,6,809,5,0,0,0,69,69,0,0,0,0,100
30addf0cc1adc87e023ad6cfdb8555d4bebfbb92,2,35,2,33,0,0,0,2,30,43,1,1,0.98678672,728,97,1,150,142,8,6097,5922,175,35,32,3,100
12327585bdb2110488bc82e7ebde351023d5f6d9,2,470,448,22,1,0,1,1,31,6,1,1,0.999945217,587,810,3,113,113,0,5199,5019,180,16,16,0,99.38366718
d5b20f7c3866be8a9e6e8921f8a4917fde645553,1,17,0,17,0,0,0,1,2,0,1,1,0,394,811,4,69,69,0,3332,3332,0,13,13,0,100
8a714dad1f10272beae634e5416b49df2d5905a9,1,1,1,0,0,0,0,2,2,110,1,1,0,422,812,5,60,60,0,3187,3187,0,21,21,0,100
034047b601b9069b2ddef56a8476f13f9138d5e4,8,84,91,7,0,0,0,2,40,101,2,3,2.486316985,1922,98,1,379,381,2,13396,13534,138,169,169,0,100
fa360636478656689a30bb93058bb9c384ece045,0,0,0,0,0,0,0,0,0,0,0,0,0,0,99,2,0,0,0,0,0,0,0,0,0,100
15d4aa23242bb0e690ff9db4cac6c0405fda1084,4,847,664,183,1,0,1,2,33,0,1,1,1.448660918,758,100,3,163,150,13,6399,6133,266,51,36,15,98.99224806
8582c50cdc4995259a56eae0437d04a20e5aa7b0,4,49,38,11,0,0,0,3,41,48,1,3,1.503467125,1159,101,4,185,187,2,8090,8084,6,111,109,2,96.4360587
b898ef2b9ab674485067d6be125a4715ad4c3ba7,0,0,0,0,0,0,0,0,0,0,0,0,0,0,813,3,0,0,0,0,0,0,0,0,0,100
72c2e0a41f0f607ec0ab28cd7a808c6a4504d852,3,39,39,0,0,0,0,2,42,133,1,2,1.142010709,842,102,5,158,158,0,5587,5588,1,67,66,1,100
8404d6f55764cad6f22ff52404130e64d6be8cfe,0,0,0,0,0,0,0,0,0,0,0,0,0,0,103,6,0,0,0,0,0,0,0,0,0,100
be4a652d22dd3320e83d5de77cd9e8555bf9c783,0,0,0,0,0,0,0,0,0,0,0,0,0,0,814,4,0,0,0,0,0,0,0,0,0,100
22e9c1b46552a809c6e8d023459d8ec19329e57d,106,23963,42,23921,100,0,100,1,37,6,3,4,6.00584748,1246,104,7,3373,244,3129,120675,8892,111783,1265,121,1144,87.42482231
d8c69a5ba259ab076e3ce0d2a6088c937aa52c0f,8,1953,0,1953,7,0,7,1,43,0,1,2,2.449137583,499,105,8,325,97,228,12810,3303,9507,151,42,109,96.7413442
48e5dcac58518b7024ac277f888b457837ca0972,8,24,13,11,0,0,0,1,35,0,3,3,2.606648973,1451,106,8,234,247,13,12718,13019,301,107,112,5,99.56521739
a39026673f2465cc1dffb3182ee486f93530045a,114,42,25927,25885,0,0,0,2,44,0,3,5,6.124182253,18519,815,5,341,3699,3358,12195,133596,121401,163,1417,1254,82.99120235
705526543b55a107e7ac2866907e81116c452167,8,1953,0,1953,7,0,7,2,45,0,1,2,2.449137583,499,816,6,325,97,228,12810,3303,9507,151,42,109,95.57399723
e9ee4b5a0aa3e6dea8498071b5368bdc341ce60d,0,0,0,0,0,0,0,0,0,0,0,0,0,0,817,7,0,0,0,0,0,0,0,0,0,100
f008824bcf40eb3eb0fc90e4138ae343554e496f,1,25,10,15,0,0,0,2,12,74,1,1,0,108,818,8,15,11,4,909,824,85,4,3,1,100
5488dac3b99a714a1c1e3286f6c52fdb06a669b9,1,1,0,1,0,0,0,4,28,304,1,1,0,100,819,6,10,10,0,714,708,6,5,5,0,100
d36e10a54d91f98cfdb19c51a526fc3a9c44540b,1,24,19,5,0,0,0,2,7,377,1,1,0,409,820,7,94,91,3,3200,3121,79,26,26,0,100
f1f4a5003b73012ffa49a9f63fe191c415f3e72d,1,6,0,6,0,0,0,1,5,684,1,1,0,34,821,8,6,5,1,322,304,18,1,1,0,100
43021b9d3d01d0a376585df9373664f8040eb0d2,9,37,9,28,0,0,0,4,29,347,1,5,2.823720363,719,822,9,119,116,3,5177,5035,142,77,75,2,99.7730711
9b0a224744ea1b8ac3fe76d3418585a095ed6ee3,1,0,2,2,0,0,0,3,7,0,1,1,0,83,823,10,16,16,0,660,674,14,5,5,0,100
aea23d59a6ca61332d260e2922a15d06c96528cd,1,3,1,2,0,0,0,3,13,392,1,1,0,74,824,11,13,13,0,690,681,9,2,2,0,100
9f729900fa13f2f37a98cf64c5281f64fcf6d832,2,20,31,11,0,0,0,2,16,2,1,2,0.95260921,146,825,12,19,19,0,954,1013,59,11,11,0,99.77324263
7cf0c960845a13d3b5dbcce53c484e909771e310,1,2,2,0,0,0,0,3,17,0,1,1,0,122,826,13,17,17,0,836,841,5,9,9,0,100
b23b40fd723df8c71f8ec0e724fd9c11c0e582d2,2,67,30,37,1,0,1,1,8,4,1,2,0.892338681,419,827,14,95,94,1,3261,3200,61,29,26,3,96.5379494
7c774efd43f8ebc3690254daf85a03844b6622e7,1,17,0,17,0,0,0,2,2,124,1,1,0,6,35,0,0,0,0,55,55,0,0,0,0,100
6cd3f147e58683bae5570c64c7af771cba1113fd,1,9,4,5,0,0,0,2,2,124,1,1,0,371,36,1,65,65,0,3024,2999,25,12,12,0,100
187b7c0e82cf2a007eba7b03651e8b825107c18b,3,490,489,1,0,0,0,1,1,0,1,2,0.051190971,475,37,2,78,12,66,3803,1482,2321,22,3,19,99.28571429
4302a4c63793553c6f1b741d47029d73251dcff3,1,1,1,0,0,0,0,2,2,127,1,1,0,46,38,3,7,7,0,450,448,2,1,1,0,100
4ce9c89243ee594978c77ca5233575005ba79b22,1,185,0,185,1,0,1,1,1,0,1,1,0,0,39,4,21,0,21,1031,0,1031,4,0,4,97.49715586
0a6ee4f13f917bce505e4def7a8bd924a9068b22,1,118,117,1,0,0,0,1,2,0,1,1,0,110,40,5,21,21,0,1037,1031,6,4,4,0,100
2823312f5e7d18de56efb2e3d99637bdebe6c74f,1,9,5,4,0,0,0,1,3,1,1,1,0,111,41,6,22,21,1,1060,1037,23,4,4,0,100
9e91a6c7f93da5c6d595a98af4b923da70c3b690,1,19,9,10,0,0,0,1,4,0,1,1,0,114,42,7,22,22,0,1033,1060,27,4,4,0,100
3c873220573778f90efb4e2795cf04f34dc46764,1,23,8,15,0,0,0,1,5,2,1,1,0,114,43,8,24,22,2,1109,1033,76,4,4,0,100
6dd4d4eef23cc2c6668f288ddc33e0e40dfb931c,6,214,22,192,5,0,5,1,6,0,1,1,2.569084754,127,44,9,31,24,7,1585,1109,476,10,4,6,99.34924078
03ec0618d020cdc16cecc0f989e58001cac897ca,1,8,8,0,0,0,0,1,2,0,1,1,0,5,45,10,0,0,0,40,40,0,0,0,0,100
3d0ca00badbe166bcc913ccb51498174eaf49e76,1,1,2,1,0,0,0,1,7,0,1,1,0,131,46,11,25,25,0,1133,1133,0,4,4,0,100
70669ff86eabcc74899fa675665359792e8291c8,1,4,2,2,0,0,0,1,8,0,1,1,0,131,47,12,25,25,0,1147,1133,14,4,4,0,100
d1f8e1d9bc15e38a5d03e4c6cce180600d40e5de,4,12,13,1,0,0,0,1,9,0,1,1,1.79126128,164,48,13,28,28,0,1383,1383,0,7,7,0,100
9b77f4301f4423b2d7c3ffbc0729bcb97c76a142,1,13,2,11,0,0,0,1,10,1,1,1,0,131,49,14,28,25,3,1217,1147,70,5,4,1,100
bb253dee5ba1d914440c6d51d9e4262964f114ea,1,4,2,2,0,0,0,1,11,8,1,1,0,140,50,15,29,28,1,1223,1217,6,5,5,0,100
0e9a86c380feaccea8d2455d3e62695126a7f285,1,44,43,1,0,0,0,1,12,0,1,1,0,142,51,16,29,29,0,1297,1223,74,5,5,0,100
4ed75ea645ec434c51b452c282a34a78fe2b84d2,2,218,0,218,1,0,1,2,4,77,1,2,0.132065356,88,52,17,50,24,26,1707,561,1146,30,15,15,99.78378378
54b1e3d0817b132b1659ee6ec786431e59a31336,2,127,0,127,2,0,2,1,1,0,1,2,0.923455963,0,53,18,8,0,8,574,0,574,4,0,4,99.7301673
9a011e82c22d9c28327f8db4fa584b3b3f7beb07,0,0,0,0,0,0,0,0,0,0,0,0,0,0,54,19,0,0,0,0,0,0,0,0,0,100
8cd4be2065d06693be8a67c12803e2b89fc79174,1,21,15,6,0,0,0,1,13,0,1,1,0,149,55,20,31,29,2,1381,1297,84,5,5,0,100
c30895194c281e73589f037aa4f329eeb76f65af,2,3,1,2,0,0,0,1,2,0,1,2,1,70,56,21,8,8,0,600,574,26,4,4,0,100
5bd2dd9e980449c235e59d0bb676fe02434ec439,2,11,7,4,0,0,0,1,14,0,2,2,0.650022422,210,57,22,37,36,1,1941,1891,50,7,7,0,100
60b1110c928b88821ece40c103a34599c4a8871c,2,3,4,1,0,0,0,1,15,4,2,2,0.863120569,216,58,23,37,37,0,1938,1941,3,7,7,0,100
0d8342d2e4fa023f41494989ab96e35635fd6d39,1,56,0,56,1,0,1,1,1,0,1,1,0,0,59,22,1,0,1,300,0,300,1,0,1,99.40891994
ddc6e12ff885d8861edceb80b6694eb245f1cc58,1,2,0,2,0,0,0,3,18,59,1,1,0,122,828,0,17,17,0,846,836,10,9,9,0,100
98b75e9c53c9f0bac46ba1f0edc39fa573e064fd,2,6,3,3,0,0,0,4,39,152,1,1,0.99107606,1194,829,1,236,236,0,8125,8104,21,113,113,0,100
f1208df6c61dab482a6cfe68317e9d32f9b0f3c5,1,5,5,0,0,0,0,2,2,1345,1,1,0,34,830,2,4,4,0,270,275,5,2,2,0,100
63fe82c79946146e23f7386326002227275c8a80,0,0,0,0,0,0,0,0,0,0,0,0,0,0,831,3,0,0,0,0,0,0,0,0,0,100
a6e1c9cf902a19993f657c58145689279427fd6b,0,0,0,0,0,0,0,0,0,0,0,0,0,0,832,4,0,0,0,0,0,0,0,0,0,100
e6943fe6417dad77b6e682a5eaf0c1910eed88e4,3,195,201,6,0,0,0,1,16,34,1,2,0.671200333,346,60,9,58,58,0,2791,2855,64,20,20,0,100
df3edcc4d94f4eb5366ba5e3721a7ef0f95415bb,0,0,0,0,0,0,0,0,0,0,0,0,0,0,833,5,0,0,0,0,0,0,0,0,0,100
8e7671abceb313a1981b95f9b07febaef57bf45e,5,40,19,21,0,0,0,1,17,45,1,1,1.640955769,212,61,2,42,38,4,1964,1836,128,11,11,0,100
9fee11cffa933f33da0c5fb47ea60de4adf35785,7,15,8,7,0,0,0,2,37,318,2,2,2.347312051,1135,834,6,203,202,1,9141,9102,39,55,55,0,100
da3a02784fd22596ddbd2f5f38dda46bfab8c477,0,0,0,0,0,0,0,0,0,0,0,0,0,0,835,7,0,0,0,0,0,0,0,0,0,100
791202485f9184d742e79d573a911dedfa288f28,1,7,7,0,0,0,0,4,30,30,1,1,0,797,836,8,169,169,0,5704,5712,8,67,67,0,100
385c8f974709016b9c4587ccc914bb6383ff9ffe,2,14,4,10,0,0,0,4,31,127,1,2,0.503258335,838,837,9,170,169,1,6081,6027,54,67,67,0,100
79896cefb2ace50ac3f5f0693f1dea355d511ab0,0,0,0,0,0,0,0,0,0,0,0,0,0,0,838,10,0,0,0,0,0,0,0,0,0,100
8631a5af69528e8d8b8056ec8a36302f61d95dec,0,0,0,0,0,0,0,0,0,0,0,0,0,0,839,11,0,0,0,0,0,0,0,0,0,100
6842ee0e2f44a6385c77dcd7f314d48f55f5470b,1,3,1,2,0,0,0,1,18,9,1,1,0,173,62,2,37,36,1,1538,1522,16,5,5,0,100
3c48acb07d7ff738525032613360c5c503ba12fa,0,0,0,0,0,0,0,0,0,0,0,0,0,0,840,11,0,0,0,0,0,0,0,0,0,100
13de8181164750e0079a20e7b92b79ef6e13b708,1,42,39,3,0,0,0,3,7,387,1,1,0,480,841,12,78,78,0,3226,3159,67,34,34,0,100
1e0acd46742acbf96cf86ec8f00c1b20d0e8fc91,1,2,1,1,0,0,0,3,7,149,1,1,0,123,842,13,12,12,0,862,862,0,10,10,0,100
e91b7667294360421df99e469b2569d591d7caef,0,0,0,0,0,0,0,0,0,0,0,0,0,0,843,13,0,0,0,0,0,0,0,0,0,100
c784f298df5f97d3796ef19b7a1b801d45d704a5,0,0,0,0,0,0,0,0,0,0,0,0,0,0,844,14,0,0,0,0,0,0,0,0,0,100
0a30b477d8e61e9d8512a69bd481633985c3455e,1,23,0,23,1,0,1,1,1,0,1,1,0,0,63,3,1,0,1,151,0,151,1,0,1,99.78575254
6b8096c59df385a067103a801be41b117839a5cc,1,9,1,8,0,0,0,1,2,0,1,1,0,16,64,4,2,1,1,224,151,73,2,1,1,100
bbe3b25e39afbd46b6c6953b004e870f253095f8,1,31,0,31,1,0,1,1,1,0,1,1,0,0,65,5,2,0,2,226,0,226,2,0,2,99.73276323
b1207b1333ff16852903b71ec90ca62f32d63748,2,2,2,0,0,0,0,1,19,4,1,2,1,198,66,6,39,39,0,1768,1764,4,7,7,0,100
13aad761656511ecd748073e8b87b7d4b703e215,2,34,0,34,0,0,0,1,3,0,1,1,1,46,67,7,4,4,0,454,454,0,4,4,0,100
016d23f5472b426917aec4bd92a44271d317a0f3,0,0,0,0,0,0,0,0,0,0,0,0,0,0,845,12,0,0,0,0,0,0,0,0,0,100
28f7adc106d4c829f5ca58d50d5af237e9b17844,1,0,1,1,0,0,0,4,46,143,1,1,0,501,7,0,97,97,0,3328,3337,9,42,42,0,100
d03e7556868066548e330ebfc144f1c3a2152419,4,61,62,1,0,0,0,2,19,283,1,4,1.830872698,274,846,13,45,39,6,2270,2051,219,18,18,0,97.68692846
f2b319cd7cbb5cea6045d0dc2ecc6384d20ed334,0,0,0,0,0,0,0,0,0,0,0,0,0,0,847,14,0,0,0,0,0,0,0,0,0,100
66604ce962e6d5562d6cfe160693a8b79370d597,0,0,0,0,0,0,0,0,0,0,0,0,0,0,848,15,0,0,0,0,0,0,0,0,0,100
c62588e0caffc5eeca8c91bbe6a9434b74a80b5e,1,124,96,28,0,0,0,1,20,20,1,1,0,175,68,7,42,37,5,1777,1538,239,13,5,8,100
5e5511f61dc170960853d9edb3ea44670856a57b,2,19,13,6,0,0,0,1,5,84,1,2,0.811278124,72,69,8,11,8,3,685,604,81,4,4,0,99.83757445
49da8bb5923a74db3f9b31a1b049515e6bb53119,0,0,0,0,0,0,0,0,0,0,0,0,0,0,849,11,0,0,0,0,0,0,0,0,0,100
d198dd318e4e1acaf3a818fee938e51e65fe312e,1,4,1,3,0,0,0,1,3,48,1,1,0,21,70,8,4,3,1,217,188,29,3,3,0,100
9041dcadbf9d7b76fad5b2f973cb058b74d0156d,1,2,1,1,0,0,0,2,9,143,1,1,0,422,850,9,94,94,0,3209,3207,2,28,28,0,100
b8223ca9c3ae20ddcb1f69dc722b34aff45a16bf,1,1,1,0,0,0,0,1,2,143,1,1,0,8,851,10,2,1,1,65,54,11,1,1,0,100
1a186c9e99174e8de10391e830420e0a34891ad4,0,0,0,0,0,0,0,0,0,0,0,0,0,0,852,11,0,0,0,0,0,0,0,0,0,100
7e5b925eaee1dd37ce676b56af31d84b78bebb93,0,0,0,0,0,0,0,0,0,0,0,0,0,0,853,12,0,0,0,0,0,0,0,0,0,100
9cef1a88d9fa92abfb29b15a30652b450eb5824d,3,26,13,13,0,0,0,4,14,163,1,3,1.309466963,321,71,8,29,29,0,2676,2581,95,14,14,0,100
5397c159243289a885a62259d03af1998b679faa,0,0,0,0,0,0,0,0,0,0,0,0,0,0,72,9,0,0,0,0,0,0,0,0,0,100
d8dc5212dedda1d7b8b58b27f6aa9c4d71109287,0,0,0,0,0,0,0,0,0,0,0,0,0,0,854,9,0,0,0,0,0,0,0,0,0,100
64f67ca22014d7d4cb4b859cdc15076a969e70da,1,0,2,2,0,0,0,4,47,35,1,1,0,500,107,0,97,97,0,3294,3328,34,42,42,0,100
24b5edeadbf4f76d81db9c18aceffab2e70f8d52,21,212,132,80,0,0,0,2,40,329,4,3,2.657207669,5463,108,1,1061,1054,7,39725,39445,280,418,409,9,100
8d2129ffb2ac8ded9180f2488e44c275930d9e29,0,0,0,0,0,0,0,0,0,0,0,0,0,0,73,5,0,0,0,0,0,0,0,0,0,100
c190f9f745abbd6135d76e32e9a68758369010d9,1,23,4,19,0,0,0,2,39,4,1,1,0,491,855,9,95,92,3,4036,3969,67,21,21,0,100
4e3c86ceebd5435167313022b4a017e066b36820,1,18,23,5,0,0,0,5,40,4,1,1,0,1081,856,10,212,212,0,7622,7618,4,70,70,0,100
b285ff992149db0d337fd4a93dcce385a691f523,4,41,28,13,0,0,0,1,4,18,2,3,1.527669045,81,74,6,13,9,4,781,537,244,10,7,3,99.67567568
337192523cb453b134d6279f18d9edf4ef5f40aa,1,102,92,10,0,0,0,2,40,0,1,1,0,504,857,11,95,95,0,3988,4036,48,22,21,1,100
fcbe9c7d4347c44244f3619ac52fe4cc3fff0ac6,14,20,9,11,0,0,0,3,48,151,1,5,3.672997272,2067,0,0,328,239,89,13471,11607,1864,195,133,62,98.37837838
425e980426cd3a26b28870ea751dfab63bc344b2,1,7,6,1,0,0,0,2,14,185,1,1,0,104,858,11,18,18,0,769,769,0,13,13,0,100
d5b0980e98eafc513416c08185e439af77fdc5b1,11,179,118,61,0,0,0,3,21,92,2,4,2.491765719,610,859,10,112,112,0,4981,4983,2,54,54,0,100
d614b24edd6a8b64b3e57a76c6cd369e3aa4f52d,3,3,3,0,0,0,0,5,49,4,1,1,1.584962501,1758,860,11,355,355,0,12235,12235,0,148,148,0,100
6db6b4fe35e4c18a4172390cc3df3b4eb3b48941,1,1,0,1,0,0,0,3,19,0,1,1,0,22,75,7,2,2,0,198,185,13,1,1,0,100
29f26ce4d366f85c4c4fc66819e589e9a1132042,2,8,12,4,0,0,0,3,50,21,1,2,0.811278124,615,861,12,113,113,0,4101,4087,14,51,51,0,97.25882973
f47e118d3f013a468b6c835da3dcfee6f1010da9,1,4,3,1,0,0,0,2,3,564,1,1,0,149,76,8,28,28,0,857,853,4,9,9,0,100
c4f678a764e00caa54bd9b5209ac4fc74a4c6e82,0,0,0,0,0,0,0,0,0,0,0,0,0,0,862,13,0,0,0,0,0,0,0,0,0,100
ae00ce5bb4335f90fabd894c0b1555c8c77ea944,0,0,0,0,0,0,0,0,0,0,0,0,0,0,863,14,0,0,0,0,0,0,0,0,0,100
785047bfc8d6ccc8b353cabfdaca2690555cbe4a,0,0,0,0,0,0,0,0,0,0,0,0,0,0,864,14,0,0,0,0,0,0,0,0,0,100
9fdd10116a7c6dcc1354b76d12efc5adf93004a5,2,19,13,6,0,0,0,1,7,25,1,2,0.954434003,79,77,5,12,11,1,732,685,47,3,4,1,100
1d164a78898914f3d9c95e9e9c114d9ded7eeada,5,288,0,288,4,0,4,1,20,10,2,4,1.742817963,23,865,1,26,2,24,1801,198,1603,8,1,7,99.23430322
bee8d165dc81d46ddb32c222770b102a772a2df7,0,0,0,0,0,0,0,0,0,0,0,0,0,0,866,2,0,0,0,0,0,0,0,0,0,100
b1c3ee3a582cebca355bdcdde3d79e9069184c7c,1,7,7,0,0,0,0,1,2,0,1,1,0,116,867,3,16,16,0,1046,1046,0,4,4,0,100
979fd49d1b919188acbe902d8c08ef7f08fda103,1,1,1,0,0,0,0,1,3,0,1,1,0,116,868,4,16,16,0,1046,1046,0,4,4,0,100
2ede721bed8c50804910efc7e90eef7ada5bd0f6,1,6,0,6,0,0,0,1,4,0,1,1,0,116,869,5,17,16,1,1069,1046,23,4,4,0,100
1717ff2f5f378b7771c4232fc5a071681abc5c2e,1,0,2,2,0,0,0,2,3,30,1,1,0,9,870,6,1,1,0,47,57,10,1,1,0,100
271a1f2589f53a0d73a97d5cc761c8356e4991da,1,3,3,0,0,0,0,2,4,243,1,1,0,58,871,7,9,9,0,340,340,0,9,9,0,100
331bf0ecc734c365260422d908cee50676dbff0f,1,19,19,0,0,0,0,2,4,243,1,1,0,332,872,8,51,51,0,2625,2625,0,24,24,0,100
5b7f5f80079120a07a08da016d1e1a7c9a03b93f,11,279,508,229,1,0,1,2,41,185,3,5,3.052607693,2353,873,9,414,456,42,16368,17431,1063,184,186,2,96.30459127
1e97428fc912f181d561b08c8facc69bfd4fedcd,5,752,2,750,4,0,4,1,2,1,1,3,1.873343529,16,874,9,91,3,88,4061,120,3941,36,1,35,99.93757803
7e2e36900e77c47120b54b6e027a647caa38a799,5,2,2,0,0,0,0,2,5,12,2,2,0,381,875,10,55,59,4,2885,3259,374,31,12,19,98.69240349
eaea98cea2c9f7303a0fb66042cfe090c666b1e5,3,15,3,12,0,0,0,2,21,322,1,2,1.571541672,429,876,11,87,85,2,3455,3340,115,57,57,0,100
c2734bbcd3edf354363127f611dd1165b5bed544,1,3,1,2,0,0,0,3,22,0,1,1,0,285,877,12,68,67,1,2003,1990,13,51,51,0,100
ba6c66a5dae8c84b7b26f7c30e05b22913982812,0,0,0,0,0,0,0,0,0,0,0,0,0,0,878,13,0,0,0,0,0,0,0,0,0,100
14d8412936a716df6af5d9f58c46f10b866486c9,1,5,1,4,0,0,0,1,3,59,1,1,0,107,879,0,17,17,0,1022,1022,0,4,4,0,100
000baf5f607b8b00aa13abd278d620e60b71bd8a,2,15,7,8,0,0,0,2,42,80,2,2,0.439496987,459,880,1,83,83,0,3762,3743,19,27,27,0,100
5f3c53784bdfaf6f1f5d3c81f0fefe37680860b1,1,7,14,7,0,0,0,2,43,0,1,1,0,360,881,2,67,67,0,2853,2872,19,21,21,0,100
c75cdb4cd894987027a1519577f91392420b4c14,1,1,1,0,0,0,0,3,23,62,1,1,0,287,882,3,68,68,0,2007,2003,4,51,51,0,100
6a54b4f803f394ffc86e34ef3bc6f73592d777d2,1,1,2,1,0,0,0,4,24,1,1,1,0,287,1,0,68,68,0,2008,2007,1,51,51,0,100
e1fb88aca9e62ed82c17997d4d627b43075a57c1,8,123,65,58,0,0,0,3,51,120,1,4,1.893419457,2229,2,1,449,441,8,16187,15834,353,219,218,1,100
382b5f1e39d400735dd3eefea90a04f6d29c1004,2,77,0,77,2,0,2,1,1,0,1,1,0.972449715,0,78,0,0,0,0,84,0,84,0,0,0,99.6900186
c57a03bc1de54cc6e24d97ad749a9cd42220af81,22,986,192,794,2,0,2,3,44,173,3,7,3.862930592,3166,8,0,709,606,103,27714,23822,3892,322,268,54,93.66157329
7088e5a59491d98764b6b81ab71f320f26321b68,13,2123,0,2123,12,0,12,1,8,1,1,4,3.19597941,53,9,1,234,0,234,8672,411,8261,100,0,100,98.45995893
5e65bf4ecf52dc1b5e376125f027fa786c9f92aa,1,0,2,2,0,0,0,4,9,0,1,1,0,54,10,2,0,0,0,411,419,8,0,0,0,100
df770c0a7470eaa191a82ed4e8706994885fcffb,3,31,10,21,0,0,0,3,37,0,3,3,0.927027994,1009,883,4,202,199,3,7515,7363,152,76,76,0,100
34014ac8d9e94d9851f6e21be46a31186460ab2c,1,20,12,8,0,0,0,3,6,12,1,1,0,151,884,5,22,22,0,1373,1304,69,6,6,0,100
91013baf1704baa200f64addeb2662d7366fb3bc,4,45,8,37,0,0,0,2,41,208,2,2,1.45068298,1414,885,6,277,271,6,10040,9808,232,126,124,2,100
5e8227c18c20663bde65fe02c3c89c12cee34a4e,0,0,0,0,0,0,0,0,0,0,0,0,0,0,886,7,0,0,0,0,0,0,0,0,0,100
eb5c9e80c20c77d4c7f234afb4ff5f0bd884f4c6,3,79,301,222,0,0,0,3,22,29,1,3,1.127583304,408,887,4,42,66,24,1821,3229,1408,18,25,7,99.69650986
f52f29f8d47f8741132828a49ba9229557fcf517,1,1,2,1,0,0,0,3,45,49,1,1,0,345,888,4,68,69,1,2727,2731,4,21,21,0,100
cf70b26407a5128bcddb4635d767edaee4f27024,1,7,1,6,0,0,0,3,7,54,1,1,0,157,889,2,23,22,1,1413,1373,40,6,6,0,100
c3bbeb3664ccaaf1446d4b9e8913c9f002f64fdb,1,1,2,1,0,0,0,3,8,0,1,1,0,162,890,3,23,23,0,1388,1413,25,6,6,0,100
91c2baa9d89a375ffeedde95cb1523d5ffe47029,1,4,5,1,0,0,0,3,4,797,1,1,0,17,891,4,1,1,0,165,182,17,1,1,0,100
4dcc09146b97130e710347adcf247a72cbe4a7fa,4,12,8,4,0,0,0,3,16,41,3,3,1.846439345,500,892,5,75,74,1,4087,4047,40,23,23,0,100
35b24a069a221ab13a45f9287d4e9cc5fc162209,10,21,27,6,0,0,0,3,39,494,1,3,3.148949546,3323,79,0,668,671,3,23404,23386,18,273,273,0,100
285e73f50786ca541b6caa8659c62ee6796f050f,26,360,382,22,0,0,0,3,41,344,1,9,3.574088966,7574,80,1,1445,1445,0,51461,52042,581,595,595,0,100
679479b173ace9ed90063de0441bad0e16d1eda1,3,15,21,6,0,0,0,2,46,49,1,1,0.803071727,447,81,2,86,86,0,3517,3555,38,31,31,0,100
0c0240f00530aac3471f9c5249de6ea6fbaff1e2,2,4,4,0,0,0,0,2,22,224,1,1,1,392,82,3,67,67,0,2869,2869,0,27,27,0,100
07aa602d3163a68f07d00907c416e76b13fbc0e5,1,11,12,1,0,0,0,5,41,2,1,1,0,834,893,6,178,178,0,5927,5927,0,69,69,0,100
d4ce86d9a1ae8e98feca7c5e26413fd2ff1eee26,16,721,242,479,0,0,0,2,10,96,1,4,2.510633071,1718,83,4,370,301,69,12727,10046,2681,164,144,20,99.695586
e4da82482794714d67607737eec4a3b65b771c3f,11,1362,0,1362,11,0,11,1,1,0,1,1,3.25679865,0,11,0,183,0,183,4900,0,4900,130,0,130,98.69934967
de21eb1f3ae08a4692fd0e9efbc00b9e82da0d22,0,0,0,0,0,0,0,0,0,0,0,0,0,0,12,1,0,0,0,0,0,0,0,0,0,100
3a04775b6a54a5d160c93e5c8ef7e42804b5e773,8,156,56,100,1,0,1,2,9,73,1,2,2.702427764,1022,13,2,184,171,13,5590,5332,258,120,107,13,93.60986547
b49bd88de0f7dbf9ae1b92eb6430d7eb6163f59b,1,2,2,0,0,0,0,1,5,200,1,1,0,119,894,5,17,17,0,1067,1069,2,4,4,0,100
ff1bfbd5e55f25c18ed1b97e70a778ea9d62bf11,155,1633,1772,139,0,0,0,3,52,372,3,30,6.219636658,18449,109,0,3468,3498,30,129320,129963,643,1578,1597,19,95.82366589
873c47ffcb9aa6cf150982541730953fb1d2625c,3,198,0,198,2,0,2,1,4,0,1,2,1.053644847,19,110,1,18,4,14,1344,153,1191,5,1,4,99.68652038
dc3be7020428c2f08f22d13ffe637b424aca868b,2,4,5,1,0,0,0,2,10,0,1,2,0.764204507,190,111,2,25,25,0,1532,1546,14,8,8,0,100
97c57b0dd49e5375d4c872eb516db6de47772878,8,146,65,81,1,0,1,2,48,39,2,2,2.593441416,935,112,3,185,190,5,7405,7294,111,81,80,1,99.63541667
fa6c7e82d706d9e733fd2dac0164f3fcbde86d05,36,1466,488,978,11,0,11,3,49,32,3,11,4.299865298,3716,113,4,730,644,86,32108,27592,4516,332,295,37,94.28571429
db2aff6bbb94b0a829bfc59716522a65be64809f,1,17,0,17,0,0,0,1,2,0,1,1,0,38,114,5,2,2,0,341,341,0,2,2,0,100
0aaa0fb1e64050fe1a708b7d7edd24af8ad66e04,9,25,15,10,0,0,0,3,50,1,1,1,3.037326145,1169,115,6,238,238,0,8788,8797,9,104,104,0,100
5feb6db63d5f84b1c7a71898c8219090c9dddc4f,0,0,0,0,0,0,0,0,0,0,0,0,0,0,895,1,0,0,0,0,0,0,0,0,0,100
e8c78019124afca21281573b6819c7ae9e7af12d,2,62,42,20,0,0,0,1,3,7,1,2,0.424808874,366,116,7,57,57,0,2986,2825,161,21,21,0,100
38b4b43250815fa0647c2ee8d3fd2da1d4a5334f,4,132,3,129,2,0,2,1,51,3,1,1,1.722863752,475,117,8,93,89,4,4026,3637,389,41,38,3,99.78750531
ae850f9b9eea820bddd79e73a1b6bd53c477ddab,1,1,3,2,0,0,0,2,2,233,1,1,0,157,118,9,28,28,0,1234,1257,23,5,5,0,100
63146072a295e4002d0881ea4dff1d0099b9c73c,0,0,0,0,0,0,0,0,0,0,0,0,0,0,896,1,0,0,0,0,0,0,0,0,0,100
c4a45d80f63c807ab79c071130d467aede22eac8,3,13,29,16,0,0,0,2,52,45,2,2,1.094914318,524,897,1,98,100,2,3795,3966,171,41,41,0,89.16849015
b25d4a5bc774469d7cdb6b3940e16ffe9044989d,0,0,0,0,0,0,0,0,0,0,0,0,0,0,898,0,0,0,0,0,0,0,0,0,0,100
c56029422950c05c1a7b116ea458416547e20634,0,0,0,0,0,0,0,0,0,0,0,0,0,0,899,1,0,0,0,0,0,0,0,0,0,100
f662cc080d4ec961ab6f279b101c6ee81414fe0b,0,0,0,0,0,0,0,0,0,0,0,0,0,0,900,2,0,0,0,0,0,0,0,0,0,100
74c45db56b21084d07d15d5ee5286d4d259f58ae,0,0,0,0,0,0,0,0,0,0,0,0,0,0,901,3,0,0,0,0,0,0,0,0,0,100
572a9f748ab3011c65326ce2cd1f63f49f7764e9,0,0,0,0,0,0,0,0,0,0,0,0,0,0,902,4,0,0,0,0,0,0,0,0,0,100
870af56c6c7898fb743efffb50b09b5c6b90ca30,0,0,0,0,0,0,0,0,0,0,0,0,0,0,903,5,0,0,0,0,0,0,0,0,0,100
0c7eafaf1eed23b68553e9c9ddd9124499aa9926,0,0,0,0,0,0,0,0,0,0,0,0,0,0,904,6,0,0,0,0,0,0,0,0,0,100
d3eaf0be61b3a57cdb37c55e7090894d4c88da6b,21,2217,950,1267,10,0,10,1,53,98,1,4,3.550937465,3238,905,7,750,716,34,28851,25479,3372,336,350,14,86.62016487
853a7cbb6fd3c49f605e4a5a4986e7d425f4e239,0,0,0,0,0,0,0,0,0,0,0,0,0,0,906,8,0,0,0,0,0,0,0,0,0,100
40cd500bf2cecdf143804f3bc64772e5598a1928,24,853,77,776,13,0,13,1,11,103,1,5,4.074977509,1527,14,0,316,252,64,11386,8537,2849,186,151,35,97.58909853
990e8d6c52142932e3a59f52b68d5e431c306c46,0,0,0,0,0,0,0,0,0,0,0,0,0,0,907,0,0,0,0,0,0,0,0,0,0,100
14f9217551915acbdeaaf9c629eb3f8cede0b2fc,6,98,38,60,0,0,0,3,44,144,1,2,2.072751794,1786,908,1,377,372,5,13541,13172,369,171,167,4,97.69155206
4fac14fa3f5b262d7cd238e592fc301d1c64a799,0,0,0,0,0,0,0,0,0,0,0,0,0,0,909,2,0,0,0,0,0,0,0,0,0,100
e826b31d8c7bfb1499a004d17850e1824fc10e79,1,1,1,0,0,0,0,2,3,839,1,1,0,90,910,1,17,17,0,576,572,4,8,8,0,100
0261c448af03ba3538d38496ec32ea4932523073,2,20,14,6,0,0,0,3,14,44,1,2,0.833764907,248,911,2,31,30,1,2074,2042,32,15,13,2,100
bab63f92fe69977b768b1e995937158973f932b9,2,20,18,2,0,0,0,4,53,88,2,2,1,532,912,3,92,94,2,4281,4213,68,34,34,0,96.47532729
5ba70c0e36ba60f19fb657e63d25b1d0043a325d,1,1,1,0,0,0,0,3,26,226,1,1,0,224,913,4,64,63,1,1483,1464,19,34,34,0,100
295c3c9336635094e53108655e24946d27228283,0,0,0,0,0,0,0,0,0,0,0,0,0,0,914,5,0,0,0,0,0,0,0,0,0,100
eb252c890d2edf642b2938eef39a849689808563,2,33,1,32,1,0,1,1,45,27,1,1,0.322756959,838,915,6,179,178,1,6003,5949,54,70,69,1,99.62345347
054a6cb520b7d21aaee282ed708ab4c8d84a3bdc,1,14,3,11,0,0,0,4,54,27,1,1,0,375,916,7,73,71,2,3007,2929,78,25,25,0,100
1bad2e973e25e708b5c3b5db167b35cda8686012,16,1879,0,1879,16,0,16,1,1,0,1,2,3.386492396,0,917,0,157,0,157,8198,0,8198,63,0,63,96.96
a2de4bdc94577c938ad9e7ab02fa91007a0a22fd,12,434,71,363,1,0,1,1,2,11,1,2,2.716768187,927,918,1,184,142,42,9800,7551,2249,64,52,12,99.47173798
87bea081a30846213d2cfb0eae193e02bc26f815,1,70,0,70,0,0,0,2,10,326,1,1,0,118,0,0,37,27,10,1032,673,359,21,15,6,100
e94812572d74db6506e8fea3eae18ba1cf813aca,0,0,0,0,0,0,0,0,0,0,0,0,0,0,919,2,0,0,0,0,0,0,0,0,0,100
4543e49606a6c69a668b3970628618d13a1fae33,0,0,0,0,0,0,0,0,0,0,0,0,0,0,920,3,0,0,0,0,0,0,0,0,0,100
f2c165d67fe3b2622cfc19f195f7589b6fc3d799,0,0,0,0,0,0,0,0,0,0,0,0,0,0,921,4,0,0,0,0,0,0,0,0,0,100
85a26e265d60b2c9c2f3c811772c2b4a61ce9b6b,0,0,0,0,0,0,0,0,0,0,0,0,0,0,922,5,0,0,0,0,0,0,0,0,0,100
81791bed5f3753b710af043c400f107230c635f6,0,0,0,0,0,0,0,0,0,0,0,0,0,0,923,6,0,0,0,0,0,0,0,0,0,100
a38663673e3ef303816626cb7d850ab6d1b75f14,24,536,250,286,5,0,5,2,3,259,1,4,4.178503599,2032,0,0,356,345,11,14911,13618,1293,168,165,3,96.96811291
23b58a857768bdd8142ba3625adc329328a88d83,0,0,0,0,0,0,0,0,0,0,0,0,0,0,924,5,0,0,0,0,0,0,0,0,0,100
a9f3204e7ee1769e86ed04775d2923def6d959a4,0,0,0,0,0,0,0,0,0,0,0,0,0,0,925,6,0,0,0,0,0,0,0,0,0,100
fbb55938eea3419e26c872f718b72f28669e444d,2,3,7,4,0,0,0,4,55,246,2,2,0.881290899,502,926,7,92,93,1,3954,3968,14,32,32,0,100
50d39d76d5723d9c11fd85963572a2e7790bf8e8,2,7,0,7,0,0,0,6,54,244,1,2,0.985228136,693,1,0,123,121,2,4429,4387,42,62,62,0,100
9a4e5d097d4b929f374530dd30400f77b18ececb,1,5,5,0,0,0,0,5,6,227,1,1,0,229,2,1,45,46,1,1175,1205,30,21,21,0,100
e803fdf1775c187dc9ac9074796e8309562d70d0,12,519,45,474,0,0,0,1,6,413,1,6,2.658684567,1897,1,0,381,343,38,15260,12399,2861,187,156,31,99.84480083
45b8f0178bda08e0425bddd46386bcb3c4f95843,0,0,0,0,0,0,0,0,0,0,0,0,0,0,927,3,0,0,0,0,0,0,0,0,0,100
0de769bed32ab80359676f964bb0e3e602e31c8c,0,0,0,0,0,0,0,0,0,0,0,0,0,0,928,4,0,0,0,0,0,0,0,0,0,100
b85f26f18a0585f0bc2dbfc50e1675d9b33a288f,1,1,0,1,0,0,0,3,21,683,1,1,0,116,929,5,16,16,0,805,805,0,9,9,0,100
c0d25189a041faa52cf275cd9df52087c90bddd2,0,0,0,0,0,0,0,0,0,0,0,0,0,0,84,0,0,0,0,0,0,0,0,0,0,100
828a41dc0ab1bfdbbd17d951687f7ac35c42ae11,1,2,2,0,0,0,0,4,56,36,1,1,0,384,85,1,74,72,2,3043,2996,47,25,25,0,100
bff70b25de94d61c6713f9152fca88b1a3087d54,1,1,1,0,0,0,0,4,57,0,1,1,0,385,86,2,74,74,0,3043,3043,0,25,25,0,100
e67bbc16c60c9f9c5d034cfe28580a6344f8754a,3,55,4,51,1,0,1,1,2,40,1,2,1.353988848,57,2,1,11,8,3,555,430,125,6,4,2,99.89669421
73bd2ab426dca1773a8b32e4bf1711875f700ae6,1,1,1,0,0,0,0,6,12,22,1,1,0,221,3,2,33,33,0,1288,1288,0,21,21,0,100
e52cb65a6bf461335852f0a6aff67e273cff8aab,1,4,2,2,0,0,0,2,2,254,1,1,0,56,930,3,7,7,0,387,398,11,6,6,0,100
345a12dcdea8e52914a46329c7d76c51bb4343ac,3,212,9,203,1,0,1,4,16,203,2,3,0.768926984,220,931,4,42,27,15,3180,1894,1286,18,13,5,99.89690722
ea9b45027eabb174f7aa9c43c7ebb110e7f5ffba,1,2,3,1,0,0,0,3,7,438,1,1,0,77,932,5,18,18,0,418,433,15,6,6,0,100
6e59097b8680874c823bb76ff099a03e668590b0,1,11,5,6,0,0,0,5,18,451,1,1,0,282,4,1,40,39,1,1892,1820,72,13,13,0,100
24c5834c63797725b3829289dc22803078c6d716,3,79,14,65,0,0,0,1,5,45,1,2,1.580451714,749,3,1,121,113,8,4639,4278,361,78,72,6,100
ca2589b03e7dedf44a91796304157e7d14945d62,0,0,0,0,0,0,0,0,0,0,0,0,0,0,933,3,0,0,0,0,0,0,0,0,0,100
3162be1690bca332748c9e114032614c55bd26ac,7,863,0,863,6,0,6,1,22,71,1,1,2.427901669,25,934,1,113,2,111,4438,224,4214,49,1,48,98.77300613
5adf0c14256cbd72ea698b3c0f26d17c52cbb9a5,1,76,59,17,0,0,0,2,4,139,1,1,0,306,4,0,52,32,20,2849,2688,161,7,7,0,100
136908bad913ca76d142fbad042b5b1521e68a3b,1,1,1,0,0,0,0,2,5,0,1,1,0,323,5,1,52,52,0,2849,2849,0,7,7,0,100
48a92c2338ef1aa11ed34c19d29900d2815eb183,0,0,0,0,0,0,0,0,0,0,0,0,0,0,6,2,0,0,0,0,0,0,0,0,0,100
43fff765517f8fd92256a135baca1d7aa11c626d,19,2842,30,2812,12,0,12,1,6,48,1,7,3.475981861,1007,7,3,448,171,277,22498,8232,14266,161,53,108,98.40716775
588f69d47c95327251487a61f7e0bd6e1c2e32d5,27,5930,46,5884,14,0,14,3,55,245,2,8,3.158558747,4317,935,1,1558,814,744,51470,30045,21425,609,317,292,97.55409219
fe53eb864ae7234eda4633ed959ec4aba1b2c2a0,9,462,16,446,2,0,2,4,58,321,2,3,2.544773244,1164,936,2,285,231,54,11143,8733,2410,126,101,25,99.77365324
b31f2a9dd825c062657cce207419ff7dd9eed0e0,3,59,5,54,0,0,0,1,6,75,1,2,1.583538233,786,8,4,126,121,5,4972,4639,333,82,78,4,100
fe8bef8bb06196b67e352ee7542565ad9f3851a5,1,2,3,1,0,0,0,6,30,362,1,1,0,300,0,0,71,71,0,2084,2092,8,55,55,0,100
736e6c1ab2f64d5fd4f3fb3142999595cadbad2c,9,546,107,439,3,0,3,1,4,24,1,4,2.387673198,1379,9,2,275,207,68,14177,11862,2315,78,57,21,95.20639148
c7ddbcb317cf13e7ac1b8395058f3ff7c07cccad,2,478,678,200,0,0,0,3,6,34,1,2,0.105295367,1182,937,2,207,211,4,6093,5826,267,81,73,8,99.69775475
1e953f236485e1e4caa0f12b7536efc823792f8e,1,6,5,1,0,0,0,2,7,43,1,1,0,321,10,2,52,52,0,2864,2840,24,7,7,0,100
c96d4d706e8a3e58d4b192b9ce60034ddd7214e2,0,0,0,0,0,0,0,0,0,0,0,0,0,0,1,1,0,0,0,0,0,0,0,0,0,100
136b33425ba70e19878b1f8d00c745489fa64d54,1,3,1,2,0,0,0,4,9,869,1,1,0,130,938,1,12,12,0,898,902,4,10,10,0,100
edfb4b1575c4eeb7a0a2c0b92f0e987d2448ec1f,1,1,0,1,0,0,0,3,3,619,1,1,0,375,939,2,41,41,0,2837,2831,6,11,11,0,100
7c0b8897f9755f03f7c34edd2d0e1f715d6f40ec,0,0,0,0,0,0,0,0,0,0,0,0,0,0,940,3,0,0,0,0,0,0,0,0,0,100
7292b60d6dc204109b66607e426495288a62d8b8,0,0,0,0,0,0,0,0,0,0,0,0,0,0,941,4,0,0,0,0,0,0,0,0,0,100
ed1adc7dc0416cc2403b35dae84d5757ba05a0b6,0,0,0,0,0,0,0,0,0,0,0,0,0,0,942,5,0,0,0,0,0,0,0,0,0,100
8ea80200cea6c84be44d383c1a6cd04ec52e36b9,0,0,0,0,0,0,0,0,0,0,0,0,0,0,87,0,0,0,0,0,0,0,0,0,0,100
af88b6a92346a7e2b5225366c4645bf493d8f9a8,0,0,0,0,0,0,0,0,0,0,0,0,0,0,88,1,0,0,0,0,0,0,0,0,0,100
f7ee2f42a907eadd199d38996c4f5aa02a4a5db4,6,27,35,8,0,0,0,1,2,17,2,2,2.436805987,589,89,2,111,170,59,4179,7077,2898,48,54,6,96.70726207
ab92f3098bc05762bfc098a04925a74f6bca64bd,0,0,0,0,0,0,0,0,0,0,0,0,0,0,943,6,0,0,0,0,0,0,0,0,0,100
02690d8aad9f1d11758b399b9c30d3ac442c788d,0,0,0,0,0,0,0,0,0,0,0,0,0,0,944,6,0,0,0,0,0,0,0,0,0,100
9fdfd0b8870b0f511fc7713f735ff62bc65700a2,0,0,0,0,0,0,0,0,0,0,0,0,0,0,90,3,0,0,0,0,0,0,0,0,0,100
ee09cd25fe5d84c02f4b39082f172e010a23fecf,0,0,0,0,0,0,0,0,0,0,0,0,0,0,945,7,0,0,0,0,0,0,0,0,0,100
d73e87ca3a1c1afe9567310546262976f2a89e8e,0,0,0,0,0,0,0,0,0,0,0,0,0,0,946,8,0,0,0,0,0,0,0,0,0,100
7fe9f6eb41c6a56629b7c1d8f17d1dc7946351f6,0,0,0,0,0,0,0,0,0,0,0,0,0,0,947,9,0,0,0,0,0,0,0,0,0,100
99fc3d2f9c85ead1f70d88fe0197fc836c416d39,13,74,69,5,0,0,0,2,56,409,2,6,3.407396961,3953,948,10,683,682,1,26880,26837,43,325,326,1,100
90c302ba74a2f92ea7509f17f2643819afd348ab,0,0,0,0,0,0,0,0,0,0,0,0,0,0,949,11,0,0,0,0,0,0,0,0,0,100
0b73bdb1c7b77d7654179e8528ab115d61489911,0,0,0,0,0,0,0,0,0,0,0,0,0,0,950,12,0,0,0,0,0,0,0,0,0,100
56ed3e29207c662ad8113d566ca9bfe041d2c71d,0,0,0,0,0,0,0,0,0,0,0,0,0,0,8,0,0,0,0,0,0,0,0,0,0,100
5610f97a3dcb56756df043acc5de778131441f9a,0,0,0,0,0,0,0,0,0,0,0,0,0,0,951,10,0,0,0,0,0,0,0,0,0,100
6bdc15b3260e91eee24ba3b5a9fae50b2d5217c5,1,0,42,42,0,0,0,1,2,104,1,1,0,1167,952,11,229,235,6,6914,7176,262,73,75,2,100
fb6257159c25f05903cc9c25f349148238c16da7,0,0,0,0,0,0,0,0,0,0,0,0,0,0,953,12,0,0,0,0,0,0,0,0,0,100
b0e91fcde7feb7f532621b1e1b3103d409d550b3,7,37,25,12,0,0,0,4,59,251,1,2,2.545858287,1245,91,4,244,242,2,9513,9352,161,111,109,2,98.84044527
c9a03c29d50f9a834397109b7c746add5ae76d0a,2,310,0,310,2,0,2,1,1,0,1,2,0.999519549,0,92,5,27,0,27,1936,0,1936,15,0,15,98.55410448
af8c27c7403d0390833f7f0f8a7bd44107648652,2,271,20,251,1,0,1,2,2,20,2,2,0.499812296,41,954,11,35,5,30,2229,325,1904,10,1,9,96.67104687
7f3316fa60c8ee5128963a9fccb887ffff7af2e9,3,323,0,323,2,0,2,1,24,39,1,2,0.990909723,26,11,0,37,2,35,2132,237,1895,5,1,4,99.80007997
2c41bd8bcd1c063800080be9192a71ea3da56965,1,14,5,9,0,0,0,2,2,2,1,1,0,91,955,7,14,14,0,783,702,81,2,2,0,100
d5ec98558f4aa3a8c5b7e1c14bab74198d22d4ac,2,18,8,10,0,0,0,2,2,508,1,1,0.98285869,475,2,0,89,87,2,3278,3150,128,53,51,2,100
533ccdb19803aef602ea6434f8d8399025d87b19,0,0,0,0,0,0,0,0,0,0,0,0,0,0,956,8,0,0,0,0,0,0,0,0,0,100
4764dbccc907c8a96d086f1ba661efea4d1de9db,2,90,66,24,0,0,0,2,3,5,1,2,0.930586129,253,957,9,36,35,1,1967,1963,4,5,4,1,100
9b90c19aaadbf1797cf13b22d8ba4299bcd693cb,1,3,0,3,0,0,0,1,2,513,1,1,0,254,958,7,39,39,0,1874,1857,17,11,11,0,100
aeec527cc774e27330f2728fcd3740a3c051b780,2,12,11,1,0,0,0,2,4,4,1,2,0.426228657,276,12,1,36,36,0,1967,1967,0,5,5,0,100
119cc47365cae1e678187799f5dda95db9ffed6e,3,3,8,5,0,0,0,2,3,180,1,2,1.435371391,905,3,1,180,180,0,6659,6692,33,65,65,0,100
f5118075b2977401c4bc2131ba225a1f9cd29fa1,0,0,0,0,0,0,0,0,0,0,0,0,0,0,959,8,0,0,0,0,0,0,0,0,0,100
5c0afb60cb44ffec81b6bd1cb2d81e3e6f610301,0,0,0,0,0,0,0,0,0,0,0,0,0,0,960,9,0,0,0,0,0,0,0,0,0,100
dd1a88d1f24aa7abe6916fac385e571caa95a8bf,0,0,0,0,0,0,0,0,0,0,0,0,0,0,961,10,0,0,0,0,0,0,0,0,0,100
85c8c0722836342a59466d0a3b4c989f9d63d41b,0,0,0,0,0,0,0,0,0,0,0,0,0,0,962,11,0,0,0,0,0,0,0,0,0,100
fba0fec659331ec67dbdf1ea237a5859accb2a67,0,0,0,0,0,0,0,0,0,0,0,0,0,0,963,12,0,0,0,0,0,0,0,0,0,100
6029d2efa36a9b1376d25a034c3aeceefcf4ecc5,1,0,1,1,0,0,0,2,4,6,1,1,0,255,4,2,39,39,0,1861,1861,0,11,11,0,100
39d3d5b04b9061ee5b7488a64569c23c0e11bb8e,3,111,45,66,0,0,0,5,60,75,1,1,1.351264903,872,0,0,204,193,11,7168,6826,342,86,81,5,100
c554046a949f15474f31f7a1413b555c034ff715,0,0,0,0,0,0,0,0,0,0,0,0,0,0,964,10,0,0,0,0,0,0,0,0,0,100
4353bfa45893a795d97c7b24f9e958748582b074,0,0,0,0,0,0,0,0,0,0,0,0,0,0,965,11,0,0,0,0,0,0,0,0,0,100
603e175eb620a0a2280a5dbf662f32d70878257e,9,125,80,45,0,0,0,1,23,706,1,3,2.545837858,970,93,0,161,160,1,6264,5964,300,86,85,1,100
6a0e396bf8e738d4d85417789b015469e931c8fa,0,0,0,0,0,0,0,0,0,0,0,0,0,0,966,7,0,0,0,0,0,0,0,0,0,100
1a911161679bd496ae6869e0d2053cf651989982,1,9,30,21,0,0,0,3,8,0,1,1,0,48,94,1,7,7,0,394,419,25,5,5,0,100
dd2eec48ffa4451c9db819934367b2977619b87a,1,29,22,7,0,0,0,3,7,568,1,1,0,346,5,1,52,52,0,2767,2732,35,24,24,0,100
b1409bc5046d5882a9b0e4cd7328d58280b94df7,89,174,172,2,0,0,0,2,61,249,5,22,6.079144512,10824,6,0,1800,1441,359,83422,76995,6427,767,580,187,91.41791045
9df03451da0ab06d5bf44bd3f3c65b3f407a34c0,4,51,47,4,1,0,1,3,20,320,2,3,1.638963929,217,967,0,25,27,2,1558,1636,78,19,20,1,99.3955095
4ccb78965e16ea158bba91881176a666d2d4e726,0,0,0,0,0,0,0,0,0,0,0,0,0,0,968,1,0,0,0,0,0,0,0,0,0,100
7eaa67b0ad71492dc3e5f0fede81614213c9d0d9,0,0,0,0,0,0,0,0,0,0,0,0,0,0,969,2,0,0,0,0,0,0,0,0,0,100
8bca56739ea03f56a4beb8e17fb62abaa91e7a56,0,0,0,0,0,0,0,0,0,0,0,0,0,0,970,3,0,0,0,0,0,0,0,0,0,100
d81e87b80d2be51f3983ee785db887f111379e36,20,1015,420,595,4,0,4,1,47,304,3,5,3.243335305,3225,7,0,703,621,82,26627,23707,2920,313,285,28,99.44013781
82870f7fb3926d6334c0210adcfb0bed53640be4,0,0,0,0,0,0,0,0,0,0,0,0,0,0,8,1,0,0,0,0,0,0,0,0,0,100
6d0233febab9eca3dcd91f4d6385d82449e93633,2,4,20,16,0,0,0,3,45,220,1,2,0.249882293,1179,971,3,229,229,0,8303,8303,0,79,79,0,100
cdd8f0615ba5d37fc8d2010c485fa0bc9757d12a,3,57,16,41,0,0,0,4,5,75,2,3,0.936478246,474,972,4,82,76,6,4198,3972,226,15,14,1,100
0e8c669154cc39100f4fe24ead8a6f0f3179d532,1,4,1,3,0,0,0,6,48,9,1,1,0,838,9,2,180,178,2,5973,5943,30,69,69,0,100
1b63a525381956d39241d622024bb590ea028e36,17,2576,1,2575,16,0,16,1,49,1,1,3,3.613743877,841,10,3,549,180,369,16722,5973,10749,234,69,165,94.4347064
e1eeec32ffb25bf11e8c692477fd390eef6af83e,14,487,29,458,2,0,2,3,9,101,2,7,3.231487107,2118,13,0,391,351,40,19928,17535,2393,151,137,14,99.03635567
5add649630ce0a8a588d2f34341176f75dd737ea,6,297,19,278,1,0,1,4,6,40,3,5,1.144492759,1184,973,2,259,211,48,8823,7819,1004,134,91,43,99.12549191
f1047c872be6aaf0a65610c01478b0544286d827,0,0,0,0,0,0,0,0,0,0,0,0,0,0,974,3,0,0,0,0,0,0,0,0,0,100
0e0d1947b087125b389ec2216d3afcd092bde386,5,54,45,9,0,0,0,2,5,54,1,2,1.637208943,1228,14,1,208,207,1,10258,10215,43,73,73,0,100
69b1fc70ef11e9d71795c64af854fd7f90e8a334,1,449,0,449,1,0,1,1,1,0,1,1,0,0,11,1,41,0,41,2964,0,2964,15,0,15,98.27204253
004569ca2b7d3916e599a7ba979bb0f34c0f6e47,16,53,45,8,0,0,0,2,62,176,4,7,3.688384388,3359,975,2,587,587,0,24914,24884,30,277,277,0,99.07732865
3f89f0213176619b65549785af676dca7e1407ea,0,0,0,0,0,0,0,0,0,0,0,0,0,0,12,2,0,0,0,0,0,0,0,0,0,100
f47541abacef5e3520c99e481fb3f9ef104aabd5,12,108,96,12,0,0,0,2,9,227,1,3,2.519473975,2044,13,3,361,360,1,15978,15729,249,140,139,1,100
3fd43841819e9d57b1a3e7f641e9aa270783ba01,1,9,3,6,0,0,0,4,8,11,1,1,0,51,976,3,10,9,1,559,503,56,1,1,0,100
1580e07b787bf0817206fdd1b9cf29aac253bdcd,0,0,0,0,0,0,0,0,0,0,0,0,0,0,977,4,0,0,0,0,0,0,0,0,0,100
b3aec632cb46eda49eb904b551952bc1cd79fe3f,0,0,0,0,0,0,0,0,0,0,0,0,0,0,978,5,0,0,0,0,0,0,0,0,0,100
a335d18c901ad1fb5036f827fc4fbd7058289090,0,0,0,0,0,0,0,0,0,0,0,0,0,0,979,6,0,0,0,0,0,0,0,0,0,100
47b00b37eb78dbb4d83219e178796770adf6955b,3,103,55,48,0,0,0,4,63,72,1,3,0.506519245,714,980,6,133,129,4,5944,5812,132,45,45,0,100
03f21bb1d59affddd93f2507299ffeed391d1d9a,14,46,69,23,0,0,0,2,25,128,1,5,3.374381515,2671,95,0,474,478,4,20107,20300,193,199,199,0,99.69244288
30221cab563f2ca273d413b961af34b0e6930a9d,4,52,50,2,0,0,0,2,50,322,1,3,1.027954626,1422,981,4,244,245,1,10772,10855,83,94,92,2,100
53e03eb2819e76839fb06af984bf954348fa2f78,1,0,3,3,0,0,0,2,3,0,1,1,0,340,982,5,43,43,0,2877,2886,9,17,17,0,100
caeeaaa03f71fffaba3a03409b724e4cd9fc03e2,12,231,182,49,0,0,0,2,64,301,3,4,2.173999819,1815,983,3,332,330,2,14302,14092,210,143,141,2,99.82386614
5df2c939d4c7f9ecca1fd38c528a609d208e93dc,2,10,4,6,0,0,0,3,6,128,1,2,0.371232327,390,984,4,62,62,0,3130,3079,51,17,17,0,100
d51dba1a7af1b5bd8a7793d42f13334c3da3af46,1,1,1,0,0,0,0,2,2,191,1,1,0,51,985,5,11,11,0,345,349,4,8,8,0,100
1e83088022b04b197b1ad04760ae8c97ab6cbb22,1,14,11,3,0,0,0,3,5,0,1,1,0,159,986,6,29,28,1,1302,1285,17,5,5,0,100
a5345247bf6657b2396734ec2ff6112f499d7aab,1,13,6,7,0,0,0,3,7,0,1,1,0,125,987,7,21,20,1,881,811,70,14,14,0,100
31788d002a7e812ba568ce802f00b4490ef20d35,4,125,51,74,0,0,0,4,9,60,3,4,1.05948269,642,14,0,110,101,9,5708,5313,395,23,21,2,100
a6fa85b8c83cf8b0ec535a026b38f0750a7e1fbc,1,34,30,4,0,0,0,1,2,431,1,1,0,103,988,7,18,18,0,894,885,9,8,8,0,100
d927fe991fe57e239e8d90ccc234bca2fcaa9094,13,432,160,272,1,0,1,2,65,227,4,6,2.47854217,2046,989,8,389,362,27,17091,15598,1493,180,166,14,98.5339849
31d583fd50d1230570d17ccb59dc61dac02e00ba,0,0,0,0,0,0,0,0,0,0,0,0,0,0,990,9,0,0,0,0,0,0,0,0,0,100
2c1cf59bac037f7fe411b21cc3fad03d86cb1ca2,11,397,346,51,1,0,1,4,66,99,2,5,2.454552754,1770,991,10,318,334,16,13549,13441,108,151,152,1,97.67337808
ab3bed984e02ad1273d8315ed86cdbb536e6efcf,2,5,1,4,0,0,0,4,8,82,2,2,1,451,992,11,82,82,0,3698,3690,8,32,32,0,100
33144c6c7ffab4a3faa86b125243fa8a63d0981d,1,2,8,6,0,0,0,4,8,8,1,1,0,407,15,1,69,71,2,3221,3250,29,13,13,0,100
5695c0b1023f79f7f20cc13efec259c6520ee285,9,247,194,53,0,0,0,2,10,66,1,4,2.450726208,2161,16,2,361,362,1,17333,16969,364,140,141,1,100
beb4a14c79ecfee2bbe690213026a42fe7b14565,1,0,4,4,0,0,0,3,12,960,1,1,0,38,993,12,9,10,1,190,200,10,7,8,1,100
7eddda37a8abdf26cf8a005a9206b8dfad38062e,1,1,1,0,0,0,0,3,13,0,1,1,0,35,994,13,9,9,0,190,190,0,7,7,0,100
af3382038b04e445f113f44fa186a90ad6cb1b25,1,4,4,0,0,0,0,2,6,11,1,1,0,157,995,14,30,30,0,1248,1248,0,10,10,0,100
add9dd534daf9b888cc84b5ab6d55381da097ff3,2,4,4,0,0,0,0,3,14,5,1,1,0.811278124,320,996,15,57,57,0,2203,2203,0,28,28,0,100
eb4447f93061239b49572b53206e2df28d06bb3b,1,1,1,0,0,0,0,2,3,976,1,1,0,6,96,1,0,0,0,43,43,0,0,0,0,100
0df48fb3fcfc7fcd80b4c71edd70325cf7792cf2,11,183,6,177,1,0,1,4,32,495,2,5,2.05923209,1479,997,16,292,269,23,9225,8412,813,189,177,12,99.91071429
7a417dd33b10768fa6df06f836efd14b8a97e3b4,2,5,3,2,0,0,0,3,7,489,1,2,0.811278124,368,998,17,61,61,0,2315,2287,28,29,29,0,100
8bdb6cb7d1f99a6caa3619c0dbee617b698e53a5,4,18,18,0,0,0,0,1,7,355,1,2,1.275162983,229,999,18,27,25,2,1833,2280,447,14,10,4,94.91730537
e460bf459bd2d06bdb077f7578086b52f2c210b0,1,1,1,0,0,0,0,1,2,0,1,1,0,75,1000,19,8,8,0,718,718,0,3,3,0,100
c1d5de56e1fab73045b80fd0605263e4770782cb,1,5,5,0,0,0,0,2,5,2402,1,1,0,292,97,2,52,52,0,2111,2111,0,13,13,0,100
c7106f12ada302ad8851531d568a55ae32ae6f40,2,2,8,6,0,0,0,6,67,14,1,1,0.721928095,595,1001,20,104,105,1,4550,4560,10,45,45,0,100
48ebc4a065a613800c488811b051350dc01c4933,12,33,33,0,0,0,0,3,24,0,2,6,3.302456439,1106,1002,21,164,150,14,8072,7800,272,95,83,12,98.92473118
26426e6a75de226e3968cf8c6a1f2699db345306,0,0,0,0,0,0,0,0,0,0,0,0,0,0,1003,22,0,0,0,0,0,0,0,0,0,100
8e5b65219c72c25a26d610dbabcf08e9f57dc253,1,5,2,3,0,0,0,1,2,2,1,1,0,14,1004,23,2,2,0,99,99,0,2,2,0,100
b512232958caa736f8183b04545b4276dce3d3b8,5,27,9,18,0,0,0,2,33,12,1,5,1.938820142,1579,17,3,269,267,2,12698,12650,48,121,119,2,100
37e33132a51566eca2eb13f653725b382797ed1e,15,2053,0,2053,14,0,14,1,2,15,2,6,3.051074424,41,98,2,184,10,174,11738,321,11417,63,6,57,98.66468843
6259f1d364dd6abc6e35b828867ea51af29d05a5,1,5,5,0,0,0,0,2,4,30,1,1,0,118,99,3,17,16,1,885,881,4,12,12,0,100
ecf451f6f25f50797b28b5c65da172a0a18628ca,0,0,0,0,0,0,0,0,0,0,0,0,0,0,1005,17,0,0,0,0,0,0,0,0,0,100
b3c8c565f7ae9c150e8aedc1840b3e80fdf4b92b,0,0,0,0,0,0,0,0,0,0,0,0,0,0,1006,18,0,0,0,0,0,0,0,0,0,100
2587b4085b35f060fb4487175eccdb33f3494f44,18,177,404,227,1,0,1,3,59,36,2,7,3.740813459,2424,1007,19,369,385,16,16213,16787,574,218,231,13,96.7291437
8940c7cc6727168d3e50a3895ae23a03be3480a7,2,4,4,0,0,0,0,1,46,96,1,2,0.811278124,1179,1008,19,229,229,0,8321,8303,18,79,79,0,100
ae12751a0da79639314ab9f4d33cb27638a9478f,1,4,3,1,0,0,0,6,68,22,1,1,0,468,1009,20,86,86,0,3606,3602,4,32,32,0,100
2d4d11f1234bc2be15a7f8acb78cf0648ccc8f4d,3,36,30,6,0,0,0,1,16,3,1,1,1.241653681,283,1010,21,43,42,1,1813,1788,25,24,23,1,98.1580967
c2ef4d2ad164b581c770126f5510b057346b9a34,6,161,20,141,1,0,1,1,69,9,2,3,1.103919646,1439,1011,18,272,259,13,10566,9773,793,130,125,5,96.65641814
bbb4aa7b3b4b132ac991923c1ced647216e670d8,7,296,358,62,0,0,0,2,70,30,2,3,2.16659281,1228,1012,19,242,228,14,9275,9477,202,106,106,0,97.3820059
c9307ea8d35a0bb6a5b65116a658d4d511a7c87c,2,33,62,29,0,0,0,6,71,0,1,1,0.251862848,663,1013,20,128,134,6,5097,5233,136,44,46,2,100
1c44ca734b829d4d0d5c6b3f7ec67cc4b7c70a7d,2,3,6,3,0,0,0,4,23,42,1,2,0.764204507,250,1014,21,34,34,0,2026,2044,18,12,12,0,100
b15c71ea387e6708b820a17174394a1d6d9b8963,19,111,97,14,0,0,0,4,72,729,3,5,3.595065541,2037,1015,22,380,379,1,14940,15169,229,178,177,1,99.74035608
c6695e82057db4c10f6ab08a87322acad49f577e,1,10,22,12,0,0,0,6,73,11,1,1,0,475,1,0,90,95,5,3570,3651,81,33,33,0,100
7bada0c8ac9f3d4c585b18d7cb29d94a58716a3e,0,0,0,0,0,0,0,0,0,0,0,0,0,0,1016,12,0,0,0,0,0,0,0,0,0,100
83e31d96013d73433e4aa06abb2f32656fb6bb05,3,395,168,227,1,0,1,3,6,136,1,3,1.030272087,276,15,0,45,36,9,3099,1970,1129,12,5,7,99.92565056
caa196085f7d87f47ca4ce77a2686372319d97a2,1,19,34,15,0,0,0,6,51,95,1,1,0,839,1017,12,173,178,5,5870,5955,85,67,69,2,100
b566dd35f1c4d32083d3fb41414f082aba45986a,0,0,0,0,0,0,0,0,0,0,0,0,0,0,1018,12,0,0,0,0,0,0,0,0,0,100
bf035eaade536f9c363b34c7f12c4732049a7792,0,0,0,0,0,0,0,0,0,0,0,0,0,0,1019,13,0,0,0,0,0,0,0,0,0,100
fd04f51f0f502fe2f54ad7b5ddfe96687364862d,8,204,479,275,0,0,0,2,7,82,3,5,1.724036358,1651,16,1,249,263,14,9883,11208,1325,132,142,10,99.73968018
12508684a8097bb1071df5b4256a600aa2a92813,0,0,0,0,0,0,0,0,0,0,0,0,0,0,1020,12,0,0,0,0,0,0,0,0,0,100
63b7f35b88cb7e5f6abc57c31576b28f5ae004d6,1,95,95,0,0,0,0,6,20,80,1,1,0,266,1021,13,36,37,1,2180,2262,82,12,12,0,100
25136ca18f9ee756b1bba5ca20749b16e808e94e,1,0,12,12,0,0,0,6,21,0,1,1,0,264,1022,14,33,36,3,2081,2180,99,11,12,1,100
2a17730f7b1b0a3cd7746878999496a44c44dafe,1,22,17,5,0,0,0,1,2,400,1,1,0,225,1023,13,33,32,1,1953,1938,15,9,9,0,100
d6846c32dd3feb673de330c2a9f4b0f503b1e739,2,50,50,0,0,0,0,4,8,114,1,2,0.242292189,296,1024,14,51,51,0,2274,2269,5,17,17,0,100
c83e7f95ddd75c98fc038f43dce20f657a5636a8,2,62,90,28,0,0,0,4,9,0,1,2,0.464810709,295,1025,14,47,51,4,2197,2274,77,14,17,3,100
2a2ac12a01a62b6aacdb8e31baeeb314b7dcb44f,0,0,0,0,0,0,0,0,0,0,0,0,0,0,1026,14,0,0,0,0,0,0,0,0,0,100
7b13359b8d37be20e3ce810baa69057a946a0e3b,7,72,21,51,0,0,0,2,62,227,2,4,1.976913406,2831,1027,11,501,494,7,19302,19083,219,224,219,5,100
a21495f6f4ce3348e156a4ffe28ccfa927e616a7,0,0,0,0,0,0,0,0,0,0,0,0,0,0,1028,12,0,0,0,0,0,0,0,0,0,100
bfed6dd60cfb4b83533a46672339a54bee18f993,0,0,0,0,0,0,0,0,0,0,0,0,0,0,1029,13,0,0,0,0,0,0,0,0,0,100
f6e74f0da406c636e69b7fcd3c2eaf6452b339e9,14,135,133,2,0,0,0,2,74,346,4,9,1.936018681,2452,1030,14,395,403,8,16968,17583,615,219,216,3,96.46302251
b8b92468bbdde19b6d656535d97b03a69e9ed900,1,2,3,1,0,0,0,3,3,23,1,1,0,410,1031,14,64,64,0,3695,3699,4,20,20,0,100
ee9dad065ab934191d2dd339a315efac8dcdeea0,1,2,0,2,0,0,0,6,52,25,1,1,0,824,1032,15,173,173,0,5883,5870,13,67,67,0,100
ad3d3f6defc272a8fd352b175ab34758ccfa5352,0,0,0,0,0,0,0,0,0,0,0,0,0,0,1033,16,0,0,0,0,0,0,0,0,0,100
75b9f480c4ce12f2e336db7b3d3c370b51b56ea2,0,0,0,0,0,0,0,0,0,0,0,0,0,0,1034,17,0,0,0,0,0,0,0,0,0,100
a92f1b325853a0bac6e92f5719da2d0b80acfd53,0,0,0,0,0,0,0,0,0,0,0,0,0,0,18,0,0,0,0,0,0,0,0,0,0,100
0b2c8a534e09c953387e7479ce0f01ccd3c659c1,0,0,0,0,0,0,0,0,0,0,0,0,0,0,1035,17,0,0,0,0,0,0,0,0,0,100
5c7f5a56cadc377fdabd65c4c9852335449e66ca,7,131,204,73,0,0,0,2,63,80,4,4,1.618912315,1472,1036,11,286,291,5,9921,10044,123,132,138,6,96.46302251
37d65a99f89d324a4d6a6390440844d712801b37,1,0,5,5,0,0,0,3,12,0,1,1,0,110,1037,12,15,15,0,612,628,16,7,7,0,100
1d7a66abef884d7f0b3f60e02cbf18e12c8c720a,0,0,0,0,0,0,0,0,0,0,0,0,0,0,1038,13,0,0,0,0,0,0,0,0,0,100
5b18b134edad1fe3056dac6e297c0c5479f83fe2,0,0,0,0,0,0,0,0,0,0,0,0,0,0,1039,13,0,0,0,0,0,0,0,0,0,100
c4e8c7c03ac8f2f93624fb7f38dc215e7bc00a3a,19,211,186,25,0,0,0,5,46,462,3,9,3.775580819,2363,1040,14,329,329,0,17178,16735,443,182,182,0,94.51442503
8cff9caf14e20953aeacf0a3907d60fb919a01c9,0,0,0,0,0,0,0,0,0,0,0,0,0,0,1041,15,0,0,0,0,0,0,0,0,0,100
d98b1bfbb82884a1f41f0a512e40e5cde5c265bf,2,10,9,1,0,0,0,5,22,91,2,2,0.899743759,309,1042,11,38,38,0,2548,2574,26,14,14,0,100
7e603ccaa223386720d93ebd7417a1498ca42cd8,0,0,0,0,0,0,0,0,0,0,0,0,0,0,1043,12,0,0,0,0,0,0,0,0,0,100
24f86fb449486a8cc5b14778f44226cb6952973b,0,0,0,0,0,0,0,0,0,0,0,0,0,0,1044,13,0,0,0,0,0,0,0,0,0,100
1b3f1744a33a29686c2eafe7764bb3640938fcc8,2,0,2,2,0,0,0,1,30,59,1,2,1,344,1045,10,51,51,0,2881,2899,18,15,15,0,100
34ec483ac476bf634aa986f86ca33b09fce90737,1,33,14,19,0,0,0,6,23,20,1,1,0,255,1046,11,36,33,3,2170,2088,82,11,11,0,100
3f75a3f72c8662f404a87e7b713746359b94255d,1,0,6,6,0,0,0,6,24,0,1,1,0,268,1047,12,36,36,0,2170,2170,0,11,11,0,100
1bfd29c1d2565a6df2acebd26a1072daaf8c2ab8,1,3,2,1,0,0,0,6,75,68,1,1,0,465,1048,13,90,90,0,3572,3570,2,33,33,0,100
f5d489c6be8d680eef61bdeaf2b150242b3eeebb,1,4,0,4,0,0,0,6,76,0,1,1,0,466,1049,14,91,90,1,3592,3572,20,33,33,0,100
3deb28aadb43d8aa9259ffe9154c4de0bdeef38c,1,1,1,0,0,0,0,2,3,82,1,1,0,172,1050,15,41,41,0,812,812,0,41,41,0,100
fe98826e43889c706b3bc27d9aaf2ce2e05808a7,0,0,0,0,0,0,0,0,0,0,0,0,0,0,1051,15,0,0,0,0,0,0,0,0,0,100
a6568493e60554c8dc33e73f3c81b5ca8bcd7558,0,0,0,0,0,0,0,0,0,0,0,0,0,0,1052,16,0,0,0,0,0,0,0,0,0,100
7823a5ffccef5f78fb0bcc361bf508bcca2cca87,0,0,0,0,0,0,0,0,0,0,0,0,0,0,1053,13,0,0,0,0,0,0,0,0,0,100
8dac9eadd2520a5b2386b7c754267bc37dca87f4,0,0,0,0,0,0,0,0,0,0,0,0,0,0,1054,14,0,0,0,0,0,0,0,0,0,100
9867d3d19f1e6bec74b9c4598a72c6d752003310,0,0,0,0,0,0,0,0,0,0,0,0,0,0,1055,15,0,0,0,0,0,0,0,0,0,100
db0e124c165c133d2bfdae6c215d175311c02c31,0,0,0,0,0,0,0,0,0,0,0,0,0,0,1056,16,0,0,0,0,0,0,0,0,0,100
444869ffe857c6c3b28c7d63c636e765bb01cb24,4,20,50,30,0,0,0,2,8,38,2,2,1.16643432,584,1057,15,107,115,8,4100,4405,305,44,45,1,100
fef3ac58a9dc8aa2a9632d3457ebee7ed7e6293c,0,0,0,0,0,0,0,0,0,0,0,0,0,0,1058,16,0,0,0,0,0,0,0,0,0,100
359c717a915050d07bc97e2ff9c86494571fdb66,0,0,0,0,0,0,0,0,0,0,0,0,0,0,1059,17,0,0,0,0,0,0,0,0,0,100
892b4a6bcdac4128cd6aa8041b42b85d3ae9f057,2,3,3,0,0,0,0,2,9,0,1,1,0.918295834,282,1060,18,63,63,0,1999,1999,0,24,24,0,100
0e17d70d6c2d8d2107a8f5602a673cb05be63f10,0,0,0,0,0,0,0,0,0,0,0,0,0,0,1061,19,0,0,0,0,0,0,0,0,0,100
55d8caf1bd4d11c2f382175e3e290f78449c64f5,0,0,0,0,0,0,0,0,0,0,0,0,0,0,1062,20,0,0,0,0,0,0,0,0,0,100
a7d9395eef52d3e0a37c84cd6932757af8b0598c,0,0,0,0,0,0,0,0,0,0,0,0,0,0,1063,21,0,0,0,0,0,0,0,0,0,100
12bd2cc1e73befc931e6eb5afc81ee0c90d325b3,2,0,108,108,0,0,0,2,3,1684,1,2,0.984109528,52,1064,22,0,7,7,0,341,341,0,7,7,99.77588525
adfe4be5d0a4297ef948e23c36061bba08a8177a,1,2,2,0,0,0,0,2,4,45,1,1,0,122,1065,22,15,15,0,915,915,0,4,4,0,100
19fac4b094e1be3af56ddfc2f1186acfe60ac89a,4,42,9,33,0,0,0,2,4,150,1,2,1.551162248,952,17,0,168,163,5,5890,5658,232,122,121,1,100
5496512c80eb969058fc6f9fc8512be22fabcd5e,3,23,9,14,0,0,0,1,8,155,1,1,1.468177321,324,1066,21,59,56,3,1383,1329,54,53,51,2,100
95e0c2cd5a6f444130c1cb3544175c23b515ba40,0,0,0,0,0,0,0,0,0,0,0,0,0,0,1067,21,0,0,0,0,0,0,0,0,0,100
7cdb15f9783e44bcebb4b2835e69f3beb02eec67,2,379,63,316,0,0,0,2,5,18,1,2,0.366430027,739,18,1,167,121,46,7319,4645,2674,103,75,28,99.91015274
096c771e9a6dc1200c008ee86ffdafdf68d01d84,0,0,0,0,0,0,0,0,0,0,0,0,0,0,1068,18,0,0,0,0,0,0,0,0,0,100
f9a0e846d6613fe0a7e16e2b2323fe01822f916c,5,14,13,1,0,0,0,1,4,969,1,3,1.994542131,867,1069,16,164,164,0,5555,5540,15,78,78,0,100
9e9d7eaafb02be8eea16b8bd24f15847a1d8337c,5,30,3,27,0,0,0,2,37,780,3,3,2.156064643,528,1070,0,106,104,2,4215,4074,141,55,53,2,96.67847653
c37a8493c12074cc613d13809bedbe8c7a5abe71,1,15,1,14,0,0,0,3,5,1230,1,1,0,210,1071,1,57,53,4,1364,1290,74,23,22,1,100
96f6c00acddc2c5c24a9cd58033f03d7414f31d0,2,1210,0,1210,2,0,2,1,1,0,1,2,0.909518121,0,19,0,123,0,123,5767,0,5767,64,0,64,99.39393939
57e249d5cafe3d3f1f6172823d54b138394446b7,0,0,0,0,0,0,0,0,0,0,0,0,0,0,1072,2,0,0,0,0,0,0,0,0,0,100
2e8b102813e1af95c344dab17c283b8584c70680,8,48,23,25,0,0,0,5,64,715,1,3,2.702410278,1857,1073,0,276,272,4,12741,12626,115,162,160,2,100
9a3e8975c12171695c2030d7220aac386aa9e913,1,15,15,0,0,0,0,4,18,273,1,1,0,109,19,0,13,13,0,945,942,3,5,5,0,100
6b56a382d2b95ca5208caf39f9eea5844358254a,1,2,0,2,0,0,0,6,77,244,1,1,0,469,1074,0,91,91,0,3599,3592,7,33,33,0,100
834872e3667ba9a85cef9818ca3d28e1f485624d,14,72,497,425,1,0,1,2,14,779,1,4,3.010947109,1057,1075,1,142,191,49,4465,6473,2008,76,101,25,98.96417782
fb7f9887c1aa03e7f4f9f04682254aa94847c208,8,9,505,496,0,0,0,3,6,2215,2,2,2.919426473,383,1076,2,14,63,49,909,2329,1420,6,55,49,99.08176651
4b227e770b21f56ebb5aba1e9a05037c5ce77a57,2,2,41,39,0,0,0,3,9,861,1,2,0.518569732,56,1077,3,1,2,1,316,496,180,1,2,1,99.91181658
01cea46919bc5806ece632e85860e7b5df9ab3e1,39,84,90,6,0,0,0,2,38,816,4,16,4.939925518,6105,1078,4,1163,1163,0,43298,43298,0,503,503,0,100
a19721b4f8e528935027643b0591c646bc81d07a,14,1324,186,1138,7,0,7,1,48,557,2,2,3.138947817,2601,1079,5,610,496,114,23683,18148,5535,239,189,50,97.42895805
f8dde3f1d50ae0c6e3d5878e9026bdc13916fd0f,3,134,66,68,0,0,0,1,30,3,2,1,1.292847692,1092,1080,6,214,202,12,8393,7903,490,81,78,3,95.32577904
2177cedb40262200839deadc99be6bbc4cfede1e,0,0,0,0,0,0,0,0,0,0,0,0,0,0,1081,6,0,0,0,0,0,0,0,0,0,100
2d8809dbcd8d829064d5f6e1679a71723f4bdaa6,1,17,14,3,0,0,0,3,11,404,1,1,0,488,1082,1,79,78,1,3250,3226,24,34,34,0,100
dd6b41e92f1776c86720ea7c1efa0f1130ae56f1,1,0,3,3,0,0,0,1,2,55,1,1,0,6,1083,2,0,0,0,35,42,7,0,0,0,100
d17c4f8422a0fbbeaf0484342f252d13be7dc616,5,8,8,0,0,0,0,6,27,497,1,3,2.155639062,1287,1084,2,186,186,0,8993,8993,0,109,109,0,100
cb13b2fa0b1c7cc5168d6aa008f7bd8ba7b46777,0,0,0,0,0,0,0,0,0,0,0,0,0,0,1085,3,0,0,0,0,0,0,0,0,0,100
607998808f7ee6a53ab83c1395610abd0d51bd8d,0,0,0,0,0,0,0,0,0,0,0,0,0,0,1086,4,0,0,0,0,0,0,0,0,0,100
335c293c8dd399aa2be2f090331383243758c8b8,0,0,0,0,0,0,0,0,0,0,0,0,0,0,1087,5,0,0,0,0,0,0,0,0,0,100
410afba9ec3096161597166ba81403da0e89e8ea,1,1,1,0,0,0,0,2,3,84,1,1,0,335,0,0,54,54,0,2747,2747,0,13,13,0,100
c5c0c3d8bbab1947480d9005bab72dde542835c7,1,0,5,5,0,0,0,1,2,108,1,1,0,108,1088,4,16,16,0,749,789,40,10,10,0,100
4caccda58632e67007c3d30bcd5357134f39c7b6,6,746,11,735,4,0,4,1,8,508,1,6,1.762858553,397,1089,1,133,57,76,6383,2896,3487,41,25,16,99.47064485
9f43db884157a98d312099cdf5d1c5ef6d593d98,1,3,2,1,0,0,0,3,15,153,1,1,0,158,1090,2,22,22,0,943,940,3,10,10,0,100
627d49ff942de3b95fc0c9c9cca0fa45d40cb925,1,1,1,0,0,0,0,1,2,58,1,1,0,259,1091,0,39,39,0,2081,2081,0,5,5,0,100
0754a1492ab447aafdfdf7aff35d0a15e5cacda1,1,2,2,0,0,0,0,3,12,154,1,1,0,492,1092,1,79,79,0,3250,3250,0,34,34,0,100
7c877dc938e3ddf9686254a9a2eb321d8144194e,36,125,4104,3979,0,0,0,3,48,920,1,6,4.428763208,4023,1093,2,226,712,486,8026,23773,15747,150,401,251,92.98423996
99d750bf38d4063b0f81d1838104508b53715262,36,4104,125,3979,26,0,26,3,49,0,1,6,4.428763208,1402,1094,2,712,226,486,23773,8026,15747,401,150,251,92.98423996
6c2bc4fdc105ca273ce379a4119035568dd48680,6,42,23,19,0,0,0,1,50,311,2,4,1.923032306,1081,1095,3,163,158,5,7059,6970,89,91,91,0,100
01f26352ef8f3f0fe3546906a58ef5dfeee777c7,0,0,0,0,0,0,0,0,0,0,0,0,0,0,1096,4,0,0,0,0,0,0,0,0,0,100
a90f7b8e2859778ac5a8b6992db42d1cbd38e0b3,0,0,0,0,0,0,0,0,0,0,0,0,0,0,1097,5,0,0,0,0,0,0,0,0,0,100
7d3f762e1d367425f3d8877998c13c38601f7e6f,5,149,82,67,2,0,2,3,20,460,3,5,1.884653464,363,1098,4,60,55,5,2568,2297,271,33,29,4,99.71333015
fd3ee2652d54fe2b819626768c860bef9b37f3dc,0,0,0,0,0,0,0,0,0,0,0,0,0,0,1099,5,0,0,0,0,0,0,0,0,0,100
b6ad744ea63a2bb7b5a4a33763ee75595973e25d,1,1,1,0,0,0,0,3,21,0,1,1,0,72,1100,6,14,14,0,545,545,0,5,5,0,100
979f1137618fb61b7d76a7d435c8b8c380bfbf82,1,6,18,12,0,0,0,1,2,693,1,1,0,127,1101,7,20,20,0,759,825,66,14,14,0,98.97003745
2bb92f2561d9d96cc62855554c7904db0579d05f,0,0,0,0,0,0,0,0,0,0,0,0,0,0,1102,8,0,0,0,0,0,0,0,0,0,100
acdda7895657db8859b6d18c878cf36248ce3633,2,58,7,51,0,0,0,3,9,101,1,2,0.333522004,337,1103,9,47,45,2,3154,2734,420,8,8,0,99.95400184
d95e85084b0b662cc3db728927dc6febd9922618,1,2,2,0,0,0,0,6,24,25,1,1,0,219,1104,10,34,34,0,1310,1306,4,19,19,0,100
488528991cfa3679b9d172c0e7a363931927c952,7,3265,0,3265,7,0,7,1,1,0,1,4,2.371951982,0,0,0,358,0,358,13759,0,13759,158,0,158,98.49795175
783be788189528206acc12657becbac55889269b,0,0,0,0,0,0,0,0,0,0,0,0,0,0,1,1,0,0,0,0,0,0,0,0,0,100
1b142bc4d8d79e9bd02d88d918665169a4692eb8,7,7,7,0,0,0,0,1,2,0,1,4,2.807354922,2007,2,2,358,358,0,13759,13759,0,158,158,0,100
24edb99398cdfd186324e99bdb7a8d6d169fc5c9,3,209,166,43,1,0,1,1,78,728,1,1,1.532976295,527,2,0,115,100,15,3986,3926,60,42,37,5,99.77538185
5993276621ae035159400c463274829bc9a438ab,1,5,0,5,0,0,0,1,2,0,1,1,0,88,3,1,27,26,1,533,517,16,10,9,1,100
6df6269ad1d3943c461d65964311f3a15c30bb87,3,836,0,836,3,0,3,1,1,0,2,3,0.893273925,0,1105,0,147,0,147,5120,0,5120,57,0,57,99.68736043
00630b0e0fc1c13b01f56459e4d428aee37e3435,2,18,7,11,0,0,0,2,2,732,1,1,0.970950594,24,1106,0,6,4,2,254,180,74,4,3,1,100
1783cdfc4eff871d59911054c4a56f88da686210,2,3,3,0,0,0,0,4,10,958,1,2,0.918295834,280,1107,1,47,47,0,2197,2197,0,14,14,0,100
535c8de834a352fd95b738eb307bc740041fff94,1,2,2,0,0,0,0,2,5,1119,1,1,0,118,100,0,17,17,0,884,885,1,12,12,0,100
3eb396e7660d5ffbda6f08be53f7490e057cc8e6,16,560,1205,645,2,0,2,5,79,666,3,4,3.488676906,2069,1108,0,265,329,64,11631,15657,4026,147,158,11,98.50272232
4db86a0635ea9f8474e14af4e0fcfd95e3af72f8,3,0,256,256,0,0,0,2,4,512,1,1,0.91709721,237,1109,1,15,50,35,891,1629,738,5,17,12,99.26639156
7a4f1c7176494d54f3815940a7a5b3c586e46e6c,4,68,72,4,1,0,1,1,11,311,2,3,1.644696898,447,1110,2,88,93,5,2989,3134,145,30,31,1,99.90917348
8658e8c38045f1a1fa0c2adf7ef278d850b4b60d,5,84,67,17,0,0,0,1,80,5,1,1,0.844318872,884,1111,3,176,171,5,6235,6201,34,88,86,2,100
b893c2f913f40204e1d2b21242d9a15d3b9283f1,2,10,20,10,0,0,0,6,81,0,1,1,0.566509507,681,1112,4,131,133,2,4744,4815,71,60,60,0,100
977e3586aa75fc53f87b05bc3d38479633983b38,25,85,1188,1103,0,0,0,1,65,612,2,8,3.325975087,3238,1113,5,368,502,134,16749,21193,4444,212,284,72,98.76768599
5a5569482cb2e5380246d3341660c37a20a39f66,7,72,49,23,0,0,0,1,82,166,2,3,2.213210469,2242,1114,6,419,418,1,15946,15836,110,186,185,1,99.95421245
b35244b515efd3be919f7a2a0a014c373f488b29,1,4,2,2,0,0,0,6,83,33,1,1,0,455,1115,2,83,83,0,3435,3435,0,33,33,0,100
ca6ffe14be4585ec1291317846167030e129efde,11,94,99,5,0,0,0,1,67,343,2,3,2.981545991,1683,1116,1,264,268,4,10971,11074,103,146,146,0,99.27437642
2c4f27c15e24525200e8cbbcb97dbaa2c50d34ff,15,71,199,128,0,0,0,5,68,513,3,9,2.57770801,2371,1117,2,353,358,5,16231,16672,441,196,199,3,98.40989399
a38742041cf96b0e7655e35f14077458a5165c33,11,817,392,425,1,0,1,2,54,2359,2,1,2.525688741,1911,1118,3,335,295,40,15823,13857,1966,142,127,15,94.59009571
fbf4d1c92561d6ed53286520b5c577792fb8f1f3,21,0,3479,3479,0,0,0,3,9,588,1,2,3.989010461,2274,1119,4,0,428,428,0,13518,13518,0,222,222,97.9499795
072fca1a6cb3e5e59df8fd9692f5cc24534c5641,8,149,155,6,0,0,0,2,84,573,4,5,2.636916266,2229,1120,4,406,406,0,14100,14148,48,196,194,2,99.8738966
295b377545f817ce20a6f208315165d552c7ae13,8,154,148,6,0,0,0,2,85,0,4,5,2.63503231,2217,1121,5,406,406,0,14148,14100,48,194,196,2,99.8738966
f7619fbdcc5f4ee8bf9899dee7ffa9b2fbf39ea2,7,116,116,0,0,0,0,1,86,0,3,4,2.417878623,2142,1122,6,401,401,0,13242,13252,10,195,193,2,99.8738966
97f2b98ba592d27525e8799c2268187700c60d68,0,0,0,0,0,0,0,0,0,0,0,0,0,0,1123,5,0,0,0,0,0,0,0,0,0,100
e5f18914c76709c9859a66e2aaad952b6ce63a7d,0,0,0,0,0,0,0,0,0,0,0,0,0,0,1124,6,0,0,0,0,0,0,0,0,0,100
ec3c1ebdf1da2c371c299d29c1ebec49dc6d5187,8,135,119,16,0,0,0,2,55,56,2,1,2.744586189,2034,1125,5,334,322,12,14932,14903,29,144,139,5,100
60e37e92e16805a5ca9432e8ff0532252adaba46,1,12,6,6,0,0,0,6,56,2,1,1,0,828,1126,6,175,175,0,5917,5921,4,67,67,0,100
0deaa67f64ac0aaf8d1a13276276066e0a9983dc,1,3,4,1,0,0,0,2,3,774,1,1,0,104,0,0,16,16,0,777,749,28,10,10,0,100
cac14f363e88201c60dbd67fbdf738529715d42d,7,553,2,551,6,0,6,1,25,234,2,3,2.348954554,27,1127,5,61,2,59,3070,250,2820,32,1,31,98.47522236
c01f6c8de816661f640a1c567ece02fb78eb3e3d,3,63,68,5,0,0,0,1,2,9,1,1,0.833948122,237,1128,5,46,46,0,1779,1779,0,22,22,0,100
48a376432c1f1240a096f407a1c7e87f9eac03d9,1,1,1,0,0,0,0,1,9,82,1,1,0,192,1129,6,25,25,0,1638,1638,0,8,8,0,100
df5ecdec3aef47a8b9cacc240e07a5bb06d7baf0,1,4,0,4,0,0,0,2,13,30,1,1,0,327,1130,5,42,42,0,2266,2244,22,24,24,0,100
5fc51015eee744daed7f7c2f34ab4030c9555683,2,1,3,2,0,0,0,2,57,32,2,1,1,880,1131,6,179,179,0,6277,6290,13,69,69,0,100
855f9f585eb23763bed68272d7076b44f76e4cb2,0,0,0,0,0,0,0,0,0,0,0,0,0,0,1132,6,0,0,0,0,0,0,0,0,0,100
f527528f3e3944d18515c78c071455b5c6aad345,1,2,2,0,0,0,0,3,4,1565,1,1,0,91,1133,7,9,9,0,782,776,6,3,3,0,100
60b1bb0ce8e77d0459000367b5a3b4f457d1fe7d,0,0,0,0,0,0,0,0,0,0,0,0,0,0,1134,7,0,0,0,0,0,0,0,0,0,100
cb909a923d59041829d6f680d84aabbcfdec8ff7,2,39,9,30,0,0,0,2,10,35,1,1,0.14609425,360,1135,7,53,50,3,2975,2737,238,25,24,1,100
d38b4dfa17f8ab064f88b8a05cb8839e0a9d0f3a,0,0,0,0,0,0,0,0,0,0,0,0,0,0,1136,8,0,0,0,0,0,0,0,0,0,100
b582ad269066c2054366b08da9490482ca52b56a,26,237,278,41,0,0,0,5,87,299,3,10,3.05912375,4473,1137,9,767,766,1,31767,32012,245,394,399,5,97.79681763
b975237dafca3a0b32c0d0a158ebb851bc6065fb,17,215,81,134,0,0,0,4,88,209,3,6,3.102244373,3265,1138,8,607,585,22,22712,22016,696,340,326,14,100
8df31418cb25428c20d4439f131d8b0336991da0,3,58,9,49,0,0,0,1,89,0,1,1,0.919834488,667,1139,9,142,133,9,5084,4839,245,70,68,2,100
d0a4fad4abdc974b2cf29e7159638c0b5e9857cf,1,2,1,1,0,0,0,2,9,181,1,1,0,358,1140,10,45,45,0,3033,3027,6,19,19,0,100
24246ffde7f815c733848c7d2fbdaae5aa887399,6,9,13,4,0,0,0,4,90,381,2,3,2.481714573,1609,1141,11,341,341,0,11972,12006,34,142,142,0,100
4ef9f9ae46b8afac5618f7fafe332581602baa71,13,55,214,159,0,0,0,1,91,9,2,5,2.104200665,2504,1142,12,387,416,29,15987,16767,780,232,245,13,100
a80f2c0df3e0900cd39bb52880ff480653866cc1,4,272,88,184,0,0,0,3,33,402,1,3,1.716285239,319,1143,13,66,45,21,3850,2621,1229,16,15,1,99.8828125
b55af25b8670b898daa9d3f867bac1141ef443c9,1,3,3,0,0,0,0,6,92,0,1,1,0,468,1144,14,89,89,0,3591,3591,0,38,38,0,100
198020ac3acd499cebf22f6c6d9039e6854fb728,1,23,23,0,0,0,0,6,93,0,1,1,0,468,1145,15,89,89,0,3600,3591,9,38,38,0,100
a791717268f8d07b707a1571e190e7531043a95c,3,20,23,3,0,0,0,4,59,323,1,1,1.00239806,1671,1146,16,332,331,1,11529,11522,7,144,146,2,100
d7387244829330ab06df56d4c2fe9bdefda04a59,1,2,2,0,0,0,0,6,60,0,1,1,0,833,1147,17,169,168,1,5819,5811,8,65,65,0,100
6cf52300cc2f91566a856fcf9a57e878f1c4ab85,1,2,2,0,0,0,0,6,94,2,1,1,0,468,1148,18,89,89,0,3604,3600,4,38,38,0,100
6a713aa60498ee0deec2337153f7e683a34221ff,1,4,1,3,0,0,0,6,95,2,1,1,0,468,1149,19,90,89,1,3623,3604,19,38,38,0,100
2cff825b6e8c3f91f881ee93dded4b732d3d856e,1,0,2,2,0,0,0,6,96,0,1,1,0,470,1150,20,90,90,0,3610,3623,13,38,38,0,100
ddbb80f46e749575c06b48fab47ea25b56a59a44,16,96,171,75,0,0,0,1,97,60,3,7,2.306899481,2582,1151,20,406,416,10,17878,18175,297,232,237,5,96.95493301
5968da5f1ad57ee1acf44eb5c0675f48ea0b7deb,1,3,7,4,0,0,0,6,98,8,1,1,0,492,1152,19,93,93,0,3756,3793,37,38,38,0,100
625cad48e3ae5e95049d67db463f72251b2e2977,0,0,0,0,0,0,0,0,0,0,0,0,0,0,1153,19,0,0,0,0,0,0,0,0,0,100
10764281108998a4caea31af0c8d7d104083232b,9,186,281,95,0,0,0,2,99,272,2,3,2.565821499,1453,1154,20,283,293,10,9761,10049,288,156,164,8,99.57912458
5b90bdcd87b231e5ed56e02f7442e5b9121a2283,10,213,185,28,0,0,0,1,100,57,3,4,0.916791952,1494,1155,21,250,246,4,10215,10177,38,140,136,4,100
b1ccd5ec8c419f4080e7464c8810f75acd15fa11,1,38,4,34,0,0,0,3,4,2367,1,1,0,24,1156,22,9,5,4,242,142,100,7,4,3,100
9d0a009e33ecb8aec8d122d82ad924de8a0b595b,3,3,4,1,0,0,0,2,3,3626,1,1,1.556656707,84,1157,22,10,10,0,669,685,16,6,6,0,100
b3e98806811d9254405c6804c4d3ca127d79df2b,1,22,2,20,0,0,0,6,101,2,1,1,0,575,1158,23,107,105,2,4469,4379,90,43,42,1,100
5fb37d4b72dd955c05c3fed412a06e0f71f04eae,1,3,3,0,0,0,0,6,102,0,1,1,0,591,1159,24,107,107,0,4469,4469,0,43,43,0,100
256512023f301b79d9b87486e4b5f51586bf2df8,3,42,46,4,0,0,0,5,103,2,1,1,1.131514649,1078,1160,25,222,224,2,7604,7605,1,109,110,1,97.41012756
2f57bda8d0b0c92b97e60404b497b12ea1333a17,5,66,57,9,0,0,0,1,104,6,2,2,1.528592219,1176,1161,26,217,216,1,8475,8444,31,107,106,1,100
c4f46752ea639fae2a87133ddd6c1694d0d887ad,1,77,42,35,0,0,0,6,105,1,1,1,0,597,1162,27,110,105,5,4728,4548,180,46,42,4,100
d45ad792aaab3e4507d1338d1ce447249827fa9d,1,21,24,3,0,0,0,6,106,0,1,1,0,624,1163,28,110,110,0,4703,4728,25,46,46,0,100
94ba60ee8124235c547c223d124799088e1c7bff,0,0,0,0,0,0,0,0,0,0,0,0,0,0,1164,29,0,0,0,0,0,0,0,0,0,100
ecdeb841d813d36ad8c8fcfb9a42a8d9c415e3c3,4,30,26,4,0,0,0,4,107,19,1,1,1.638398471,1008,1165,24,202,198,4,7357,7386,29,104,102,2,100
ac3fb5c345a35f5be12df83809c69bcb7058b253,8,65,7,58,0,0,0,6,71,33,1,3,2.442563029,1937,1166,23,310,301,9,13207,12881,326,194,189,5,95.83333333
bd2c08ec0593280ea9e4007a8986a39f326c0050,2,9,11,2,0,0,0,5,44,4,1,1,0.609840305,364,1167,19,90,91,1,2390,2395,5,57,58,1,100
0f3c3124f07784b6147d22cab6f71ca22e20d5be,1,3,5,2,0,0,0,1,3,90,1,1,0,173,1168,19,38,38,0,1330,1344,14,15,15,0,100
d6d6f890db2ecd2480fd0c20e19eaa5f1a6f569d,10,128,971,843,1,0,1,2,108,153,3,6,2.037365667,1775,1169,18,208,356,148,8028,13391,5363,106,167,61,91.34262656
4aced1b421469edc524ba27cf740fd2dbc8f5df1,9,85,178,93,0,0,0,2,72,345,4,6,1.951201501,2770,1170,0,481,488,7,18927,19553,626,223,224,1,94.75193576
5401914e9663f022e5dd534346568c4b25271273,3,5,4,1,0,0,0,3,62,31,2,3,1.530493057,936,1171,1,178,178,0,6601,6589,12,78,78,0,100
baa995cc802bde4e4422aa4a2518a6b080e7e2de,1,1,0,1,0,0,0,4,11,93,1,1,0,129,1172,2,20,20,0,929,922,7,6,6,0,100
5ac3599198987801445838dba26292174836a844,5,124,207,83,0,0,0,3,63,317,2,3,1.251097532,1358,1173,3,228,235,7,9459,10070,611,94,98,4,100
e228a1871f0cb5bf9fb1646874cd781effddb6d4,1,9,2,7,0,0,0,2,6,0,1,1,0,136,1174,4,14,13,1,1193,1155,38,3,3,0,100
7760fe4431d4a4fc512f233dc233fb79c1e17fa6,2,14,1,13,0,0,0,2,64,0,1,2,0.721928095,965,1175,5,187,187,0,7133,6999,134,68,68,0,99.08920439
992af3fd111a5e305301475bed195d9992275146,1,2,9,7,0,0,0,6,65,0,1,1,0,834,1176,6,173,173,0,5872,5917,45,65,65,0,100
68353f377112dbbc97b89be771de537281a48b59,2,48,32,16,0,0,0,2,66,0,1,2,0.428069629,971,1177,7,187,187,0,7165,7088,77,68,68,0,100
8f6b95a8ad5802910975e376f861fb6d5a8d038d,1,3,5,2,0,0,0,2,9,0,1,1,0,152,1178,8,14,14,0,1231,1251,20,3,3,0,100
bd7e85ceb25383ab372432245c92ca1b7e9acd53,1,3,12,9,0,0,0,2,10,0,1,1,0,151,1179,9,13,14,1,1175,1231,56,3,3,0,100
b75792a72903b57b832a88bed7384d2d8087a89a,1,4,0,4,0,0,0,2,11,0,1,1,0,143,1180,10,12,13,1,1147,1175,28,3,3,0,100
a9b5888080b85faa00dc010002f2cd3cabced3c2,2,2,1,1,0,0,0,2,26,0,1,2,0.918295834,273,1181,11,28,28,0,2124,2094,30,10,10,0,100
e05e498eefd23108a13617c3336c08ba9e21d8de,3,23,7,16,0,0,0,2,67,0,1,2,0.770343771,1108,1182,12,208,201,7,8159,8038,121,77,75,2,100
dde375498bb65c442858839379cd1da3595b62a7,2,3,1,2,0,0,0,2,68,0,1,2,0.811278124,992,1183,13,193,192,1,7245,7212,33,70,70,0,100
ee92d6c34c68283b335fc4ddb149948230800c88,1,2,0,2,0,0,0,2,15,0,1,1,0,143,1184,14,13,13,0,1201,1177,24,3,3,0,100
c5c6824c39dbde589619c6adabe6427e1ee2d1f9,2,3,3,0,0,0,0,2,69,0,1,2,0.650022422,996,1185,15,192,193,1,7244,7269,25,70,70,0,100
9169e759e6a7aa72ee68688627dc755eb342b8e9,2,2,0,2,0,0,0,3,70,9,2,2,1,980,1186,16,199,199,0,7031,7013,18,81,81,0,100
5a648dab6c4c90bfc5cc8b945e8815c024b33e0d,2,85,1,84,0,0,0,3,8,1685,1,2,0.159350063,405,1187,17,76,63,13,3441,2928,513,30,27,3,99.89431968
56a11c6cbc552455218b89966924a9abba80f387,1,20,13,7,0,0,0,3,16,110,1,1,0,427,1188,18,94,97,3,3205,3277,72,32,32,0,100
6e23f7a516fbbec00c511de8ca8d0128c27860c3,1,33,26,7,0,0,0,6,109,78,1,1,0,623,1189,19,113,112,1,4732,4691,41,46,45,1,100
b3f1c9802a85971b1ee15d15a270981675b3741b,2,28,24,4,0,0,0,1,110,55,1,1,0.74441318,733,1190,3,130,130,0,5507,5452,55,61,61,0,100
593db089e57570cabb8ad1317fb25014450a08c0,9,685,38,647,4,0,4,5,111,24,2,2,2.434566158,1160,1191,4,298,227,71,10814,8452,2362,160,119,41,99.7627208
bdf6331721b8762414e7d6f2316061dcfc5aa03d,2,2,2,0,0,0,0,3,35,130,1,2,1,303,1192,5,42,42,0,2566,2563,3,9,9,0,100
396bc529f5be1ad2ba9348742c43b9c8f3246ff6,7,1029,1151,122,1,0,1,2,14,170,1,1,1.999208131,1177,1193,6,145,150,5,7615,8692,1077,68,71,3,99.65690156
4aaf7de5929793d351598a61f7ef7d823c030895,0,0,0,0,0,0,0,0,0,0,0,0,0,0,1194,7,0,0,0,0,0,0,0,0,0,100
724308a1fb3e9bf01992da8d413851d247e605c2,0,0,0,0,0,0,0,0,0,0,0,0,0,0,1195,8,0,0,0,0,0,0,0,0,0,100
3173b8317d1852c02cdd420b1b86dd46aff8456d,0,0,0,0,0,0,0,0,0,0,0,0,0,0,1196,8,0,0,0,0,0,0,0,0,0,100
f468e2df76b3e6e56682b18b51b66ecc02264598,0,0,0,0,0,0,0,0,0,0,0,0,0,0,1197,8,0,0,0,0,0,0,0,0,0,100
47a8cd83468face5f8e0c4e21c7aa92f5c6e7a3e,0,0,0,0,0,0,0,0,0,0,0,0,0,0,1198,9,0,0,0,0,0,0,0,0,0,100
739d1daa04e40d7b0511881a9b4e42fbf69018d4,0,0,0,0,0,0,0,0,0,0,0,0,0,0,1199,10,0,0,0,0,0,0,0,0,0,100
ae47e1a33dccfd703f8abf2f005e205bfbc77d6e,2,29,17,12,0,0,0,1,21,571,2,2,0.998635964,982,1200,10,131,131,0,6572,6513,59,56,56,0,100
cd72f02d15b5ee2e274e7803ff0c33fa366b5f63,1,93,93,0,0,0,0,1,3,0,1,1,0,696,1201,11,91,91,0,4641,4654,13,43,43,0,100
3582f9d55a39d57a0bd04585c3df7a313052d57e,0,0,0,0,0,0,0,0,0,0,0,0,0,0,1202,12,0,0,0,0,0,0,0,0,0,100
6765a51030c8926dfc2a6fbccb53efa357d7ecad,0,0,0,0,0,0,0,0,0,0,0,0,0,0,1203,13,0,0,0,0,0,0,0,0,0,100
9392635e2961d271beff7115682c72fd8bc15e6e,0,0,0,0,0,0,0,0,0,0,0,0,0,0,1204,14,0,0,0,0,0,0,0,0,0,100
6ebddd31b3954982e1fb046dfc26f0f033c98f7a,0,0,0,0,0,0,0,0,0,0,0,0,0,0,1205,15,0,0,0,0,0,0,0,0,0,100
7a588d3e8cb6c1b0097f86157138affd1e5c8707,0,0,0,0,0,0,0,0,0,0,0,0,0,0,1206,16,0,0,0,0,0,0,0,0,0,100
72c6799d4416a62ba7571481913702eb6228e6d0,0,0,0,0,0,0,0,0,0,0,0,0,0,0,1207,17,0,0,0,0,0,0,0,0,0,100
057bf1a94b1a2cf2e627aacd2da1603a788f15b1,0,0,0,0,0,0,0,0,0,0,0,0,0,0,1208,18,0,0,0,0,0,0,0,0,0,100
744590cca44fc12c960214e525a8e55f213fa3e0,0,0,0,0,0,0,0,0,0,0,0,0,0,0,1209,19,0,0,0,0,0,0,0,0,0,100
ced1fa093338db1646e74db920b0b3268ee5b37f,0,0,0,0,0,0,0,0,0,0,0,0,0,0,1210,0,0,0,0,0,0,0,0,0,0,100
c38624dab9cea8d3fefecb44d121c7675901c134,0,0,0,0,0,0,0,0,0,0,0,0,0,0,1211,1,0,0,0,0,0,0,0,0,0,100
e2d7322e525a18516affdf4d3c4f8510ade8cfa5,0,0,0,0,0,0,0,0,0,0,0,0,0,0,1212,2,0,0,0,0,0,0,0,0,0,100
1e4571725d6d2ab82517d2a23f2067cc48166f7d,0,0,0,0,0,0,0,0,0,0,0,0,0,0,0,0,0,0,0,0,0,0,0,0,0,100
3d52fa804cbbf51dd35b1daa4cc81e12c9127591,0,0,0,0,0,0,0,0,0,0,0,0,0,0,1,1,0,0,0,0,0,0,0,0,0,100
0472ac46ecae82d7162a2dfb1a2bcb30c32fc77f,1,1,2,1,0,0,0,4,8,1193,1,1,0,356,1213,3,53,53,0,2925,2939,14,23,23,0,100
22c73961cc3ad84be59b534003fc794730dfb6b5,0,0,0,0,0,0,0,0,0,0,0,0,0,0,1214,4,0,0,0,0,0,0,0,0,0,100
710a4e72d179033f5af49cb4be66a6eeb1b352c1,0,0,0,0,0,0,0,0,0,0,0,0,0,0,1215,5,0,0,0,0,0,0,0,0,0,100
9dc57e7ae8125bb4b66abd211c78a61951225ea9,0,0,0,0,0,0,0,0,0,0,0,0,0,0,1216,6,0,0,0,0,0,0,0,0,0,100
611a62f792db5a2ae5821614faaae22471111557,0,0,0,0,0,0,0,0,0,0,0,0,0,0,1217,7,0,0,0,0,0,0,0,0,0,100
7709d87268dd723868bf3b32c0fbbfbf1e482772,0,0,0,0,0,0,0,0,0,0,0,0,0,0,1218,8,0,0,0,0,0,0,0,0,0,100
4f3a2283e49a2b9dde53c1d76ffe46452ec598a0,0,0,0,0,0,0,0,0,0,0,0,0,0,0,1219,9,0,0,0,0,0,0,0,0,0,100
cc8e484d396b443aae4debcf59cf3db9c2dfaff0,0,0,0,0,0,0,0,0,0,0,0,0,0,0,1220,10,0,0,0,0,0,0,0,0,0,100
ac1d1ad9652419b02809d576e70ce4e97827e72f,0,0,0,0,0,0,0,0,0,0,0,0,0,0,1221,11,0,0,0,0,0,0,0,0,0,100
f062fdc8f18c08cab7672128157467f589a7d973,0,0,0,0,0,0,0,0,0,0,0,0,0,0,1222,12,0,0,0,0,0,0,0,0,0,100
2782839996aa091974bc2ddd42bbc9124c8e4ddd,0,0,0,0,0,0,0,0,0,0,0,0,0,0,1223,13,0,0,0,0,0,0,0,0,0,100
01ad02ffde340e51232ee83755f2cd86a61d334c,1,2,2,0,0,0,0,4,7,107,1,1,0,146,2,2,19,19,0,1234,1234,0,3,3,0,100
60c14699f655986bd73217d8508eed554d3e4006,0,0,0,0,0,0,0,0,0,0,0,0,0,0,1224,14,0,0,0,0,0,0,0,0,0,100
22c0b2f8075b28671dba0a4e8d735a83569da324,1,7,5,2,0,0,0,2,8,258,1,1,0,159,1225,0,22,22,0,1095,1083,12,12,12,0,100
082e5b55bcaac421309ba01aa32cf487aa46430a,2,73,66,7,0,0,0,2,9,446,1,2,0.575505862,576,1226,1,89,88,1,3969,3920,49,36,36,0,100
d677800bcc4431b5730d715a9ad761f7df65b4ff,2,2,2,0,0,0,0,1,3,1191,1,1,1,799,1227,2,152,154,2,5602,5610,8,87,87,0,100
ec4c3bc0824a743c49e4b69327e1ea90edeb378b,1,10,6,4,0,0,0,1,14,300,1,1,0,158,1228,2,22,22,0,1119,1103,16,12,12,0,100
65a0839736f475bcc116f3ba4a233108d68594d9,3,5,3,2,0,0,0,3,22,265,2,2,1.061278124,1072,3,0,143,143,0,7142,7143,1,63,63,0,100
4db7ac9733abdd408fe3be4f4849aa415239250f,6,97,28,69,0,0,0,6,112,1601,3,5,1.793132314,1427,1229,0,236,223,13,10914,10499,415,97,95,2,100
69b1c166eeece41f5557567489130c4113744342,0,0,0,0,0,0,0,0,0,0,0,0,0,0,1230,1,0,0,0,0,0,0,0,0,0,100
db5cec9d124cc41ed46a171ef62ecbbf94f27188,0,0,0,0,0,0,0,0,0,0,0,0,0,0,4,0,0,0,0,0,0,0,0,0,0,100
3ee433413294e5b833e569472289f6a404e32576,2,413,0,413,2,0,2,1,1,0,1,1,0.998134178,0,5,1,43,0,43,2206,0,2206,20,0,20,99.89417989
5635fff7ad187852669bec4a88ee7eb5bda3259d,0,0,0,0,0,0,0,0,0,0,0,0,0,0,1231,1,0,0,0,0,0,0,0,0,0,100
437b09a92bc7cb3209bacc04a85ff6d6550991d1,0,0,0,0,0,0,0,0,0,0,0,0,0,0,1232,2,0,0,0,0,0,0,0,0,0,100
a33eadf2db21e7e7c9c47f39cfa8e53547063d76,0,0,0,0,0,0,0,0,0,0,0,0,0,0,1233,3,0,0,0,0,0,0,0,0,0,100
6161c2596188f8adcffc087206aa1dc089a35033,0,0,0,0,0,0,0,0,0,0,0,0,0,0,1234,4,0,0,0,0,0,0,0,0,0,100
de4fea5e6bd9d41706f421a89332521a41c053a6,1,1,1,0,0,0,0,4,12,395,1,1,0,76,1235,4,6,6,0,606,606,0,5,5,0,100
77597172fa4c04f852f7eb65159b0201066204bf,0,0,0,0,0,0,0,0,0,0,0,0,0,0,1236,0,0,0,0,0,0,0,0,0,0,100
9c0fa443186b9f07167d1c653265f414e2b00325,0,0,0,0,0,0,0,0,0,0,0,0,0,0,1237,0,0,0,0,0,0,0,0,0,0,100
656c0134f432821e2a413ea380350b7f3148168e,0,0,0,0,0,0,0,0,0,0,0,0,0,0,1237,0,0,0,0,0,0,0,0,0,0,100
321a2b543825907d93c3c312f45bf2e0cb0f1381,0,0,0,0,0,0,0,0,0,0,0,0,0,0,1239,2,0,0,0,0,0,0,0,0,0,100
0225205a97191c17a9f7cc35041580503ad356f1,0,0,0,0,0,0,0,0,0,0,0,0,0,0,1240,3,0,0,0,0,0,0,0,0,0,100
ce572d8eae22700b0a5e78f8bdba409e598e1e07,4,8,8,0,0,0,0,7,59,1403,1,3,1.905639062,1429,6,0,228,228,0,9434,9434,0,146,146,0,100
33041c09951d1ad671147ca19be4cedabe288455,37,9,6192,6183,0,0,0,3,58,1686,4,13,4.560609332,5411,1237,0,236,865,629,10290,41674,31384,152,377,225,96.18364419
3a3ea7a37743b5f3759a86460e63ae414b2e9081,0,0,0,0,0,0,0,0,0,0,0,0,0,0,1241,0,0,0,0,0,0,0,0,0,0,100
84c2fa18e32c2e38060e3143f288fcc3abb3ff6c,4,8,8,0,0,0,0,7,59,1404,1,3,1.905639062,1429,6,0,228,228,0,9434,9434,0,146,146,0,100
bf225235cffb6eb647511f2c7cc09d4813eaf5d6,0,0,0,0,0,0,0,0,0,0,0,0,0,0,1243,2,0,0,0,0,0,0,0,0,0,100
e488e08d18c6ce16840a0c843f8eb9c2161dfb1e,0,0,0,0,0,0,0,0,0,0,0,0,0,0,1244,3,0,0,0,0,0,0,0,0,0,100
c095c7da2e529256579429da9bb2d534a96da873,1,3,1,2,0,0,0,2,8,2030,1,1,0,564,1245,4,113,112,1,4710,4698,12,27,27,0,100
c709c0af22b19321dc32ee46fc3182b57b219d3e,0,0,0,0,0,0,0,0,0,0,0,0,0,0,1246,0,0,0,0,0,0,0,0,0,0,100
5aed6e39f4ec2f8996b418bfd375763f0d06a68c,2,274,0,274,2,0,2,1,1,0,1,2,0.99688469,0,0,0,28,0,28,1282,0,1282,9,0,9,99.65849115
09243a3ca1565ba678ee7455a8d25288d95ddf2a,0,0,0,0,0,0,0,0,0,0,0,0,0,0,1247,1,0,0,0,0,0,0,0,0,0,100
583c69b37817f9ee76403805657d6650f2efc6d3,3,142,8,134,1,0,1,5,47,1309,2,2,1.481984231,370,1248,1,101,88,13,3250,2514,736,53,47,6,99.72586049
86b4f34a784863b7c5bc9f6e7a0bb68e8eb08bb0,0,0,0,0,0,0,0,0,0,0,0,0,0,0,0,0,0,0,0,0,0,0,0,0,0,100
de85316a2e5ce6f6a970969d0249a92663bd4485,0,0,0,0,0,0,0,0,0,0,0,0,0,0,1249,0,0,0,0,0,0,0,0,0,0,100
283e6e09674a96eb511a8242d17a75a2d44957c0,0,0,0,0,0,0,0,0,0,0,0,0,0,0,1250,1,0,0,0,0,0,0,0,0,0,100
236745a750da7aa81ce903d81c2618d7ff9d6da6,0,0,0,0,0,0,0,0,0,0,0,0,0,0,1251,2,0,0,0,0,0,0,0,0,0,100
b1bd0b98049e42629d85e672975593e518d031df,0,0,0,0,0,0,0,0,0,0,0,0,0,0,1252,3,0,0,0,0,0,0,0,0,0,100
7de1cbce3065fc322c6d29dbc071a2fcc8b28dcb,0,0,0,0,0,0,0,0,0,0,0,0,0,0,1253,4,0,0,0,0,0,0,0,0,0,100
64d7254fa20c65101e0dd4bbe5c1e85da3e6a152,1,1,1,0,0,0,0,2,3,1596,1,1,0,711,1254,5,143,143,0,4469,4467,2,55,55,0,100
1dc5eaa2e5eeacb7ddc6571098a6c82117ec3745,2,26,36,10,0,0,0,3,4,1152,1,1,0.740865686,1126,0,0,208,208,0,7211,7289,78,79,79,0,100
062b837f78479d279112807c29ffeb1a84ae63cd,1,1,1,0,0,0,0,3,5,3,1,1,0,704,1255,6,143,143,0,4404,4402,2,55,55,0,100
f30e0c4100eed5627049609d949e2cf710dc2be0,0,0,0,0,0,0,0,0,0,0,0,0,0,0,1256,7,0,0,0,0,0,0,0,0,0,100
bed9af081268ed4c8eb58cf6cc6713145d5d46bf,0,0,0,0,0,0,0,0,0,0,0,0,0,0,1257,8,0,0,0,0,0,0,0,0,0,100
b67823bdf8baea15fae6e2f951876ffee50a0ca2,0,0,0,0,0,0,0,0,0,0,0,0,0,0,1258,9,0,0,0,0,0,0,0,0,0,100
4b3ecbaa199043853013248a16470ef06e35d4df,6,136,5,131,1,0,1,2,71,1424,2,3,1.264701276,1513,1259,0,301,291,10,11513,10859,654,151,143,8,99.93968637
d41e81bfc8fdeba4de300b8ec9f526cdf04d1dd9,0,0,0,0,0,0,0,0,0,0,0,0,0,0,1,0,0,0,0,0,0,0,0,0,0,100
81e21e00c759a4191f5d3761c4771073d34cafa1,0,0,0,0,0,0,0,0,0,0,0,0,0,0,1,0,0,0,0,0,0,0,0,0,0,100
62c11dedc754526e830da6ee81da558d9a44177e,0,0,0,0,0,0,0,0,0,0,0,0,0,0,3,2,0,0,0,0,0,0,0,0,0,100
83f906c23c5ac1ff0e9f4c04991253cd21b612f7,3,23,0,23,0,0,0,2,6,1529,1,2,1.520375095,351,4,3,58,54,4,2890,2777,113,25,25,0,100
5da38ec6bcf43c17fffa3726281e16d98b240ec5,0,0,0,0,0,0,0,0,0,0,0,0,0,0,1260,1,0,0,0,0,0,0,0,0,0,100
fb28bcbcff97872ecd4434bfa7b934c48d1ce3ee,9,2779,0,2779,9,0,9,1,1,0,1,2,2.574379955,0,1261,0,327,0,327,9623,0,9623,191,0,191,98.73156342
556c7b386b1fb27a41763a61d1126e1dd1bd216a,0,0,0,0,0,0,0,0,0,0,0,0,0,0,119,0,0,0,0,0,0,0,0,0,0,100
ce0cbec6c371b1442585f6b6182d0ac3fa60258f,0,0,0,0,0,0,0,0,0,0,0,0,0,0,1262,0,0,0,0,0,0,0,0,0,0,100
fe57a39cc5a576d11d9137fbae156a79d4d7a8a1,0,0,0,0,0,0,0,0,0,0,0,0,0,0,0,0,0,0,0,0,0,0,0,0,0,100
2ecb5c9dee77110cd72fc67080f2da1ba7e5552d,0,0,0,0,0,0,0,0,0,0,0,0,0,0,0,0,0,0,0,0,0,0,0,0,0,100
734a4d7337cbd132623c7dcb84c300de428d13bf,1,1,1,0,0,0,0,3,4,4564,1,1,0,7,0,0,0,0,0,51,51,0,0,0,0,100
