CommitID,NMF,TotalAddLines,TotalDeleteLines,LC,FileAdd,FileDelete,NAD,NDEV,NUC,AGE,NS,ND,Entropy,LT,EXP,REXP,CommitComplexity,LastCommitComplexity,CFC,CommitTokenCount,LastCommitTokenCount,NCC,CommitMethodNum,LastCommitMethodNum,NMC,a2a
c7d4888692b3847fb215f21156098b3a526e18b3,0,0,0,0,0,0,0,0,0,0,0,0,0,0,0,0,0,0,0,0,0,0,0,0,0,100
155aa696c8b1cb3649ab1d0c8ddea38ecdd4b44e,0,0,0,0,0,0,0,0,0,0,0,0,0,0,1,1,0,0,0,0,0,0,0,0,0,100
ecfc90604c258196e0e3456bb4857276c80eabe7,0,0,0,0,0,0,0,0,0,0,0,0,0,0,2,2,0,0,0,0,0,0,0,0,0,100
a919cc191a207373c7aa854dfe4949f9f0fe9daa,150,8197,1567,6630,48,0,48,2,2,0,1,51,6.107247668,10844,0,0,2214,1200,1014,99347,71031,28316,917,560,357,70.10804322
a64c9125ab72089e96facab691e9cfe7f165fd34,150,1539,10579,9040,7,0,7,1,1,0,1,50,6.177309106,15036,0,0,1328,2080,752,61731,108194,46463,554,920,366,70.10804322
b0684a18811241e913f4ef6452513532f06674a1,0,0,0,0,0,0,0,0,0,0,0,0,0,0,3,3,0,0,0,0,0,0,0,0,0,100
5e72a63a191488a52155cb62fa6d0bfe540a4129,0,0,0,0,0,0,0,0,0,0,0,0,0,0,0,0,0,0,0,0,0,0,0,0,0,100
dd93eb022716ad414f92c17a8b89ebeb890e61fe,0,0,0,0,0,0,0,0,0,0,0,0,0,0,4,4,0,0,0,0,0,0,0,0,0,100
7db4a66269ff0ff593d4589262b0fd374d5cfcfa,0,0,0,0,0,0,0,0,0,0,0,0,0,0,4,4,0,0,0,0,0,0,0,0,0,100
999d0bbc342185763164a64bfdf8e750c26e64f1,0,0,0,0,0,0,0,0,0,0,0,0,0,0,6,6,0,0,0,0,0,0,0,0,0,100
5d510e90573fbe6111014438ca9e6721e1db5899,0,0,0,0,0,0,0,0,0,0,0,0,0,0,7,7,0,0,0,0,0,0,0,0,0,100
7fb7745f08ee8c74e209a24703f47a04bed43090,0,0,0,0,0,0,0,0,0,0,0,0,0,0,8,8,0,0,0,0,0,0,0,0,0,100
34faa3004615c37c4117016a9200b94b2a248b3a,0,0,0,0,0,0,0,0,0,0,0,0,0,0,9,9,0,0,0,0,0,0,0,0,0,100
70e84c0318f76190d85a84ec2bdc1f5f1f78fbd0,150,8197,1567,6630,48,0,48,2,2,0,1,51,6.107247668,10844,0,0,2214,1200,1014,99347,71031,28316,917,560,357,70.10804322
008a7f8f47bb25fc77d87e83c7d57967963cc998,150,1539,10579,9040,7,0,7,1,1,0,1,50,6.177309106,15036,10,0,1328,2080,752,61731,108194,46463,554,920,366,70.10804322
fb9af7edd2101abb0fc2e9dd3162d0d1c3b350b3,150,8197,1567,6630,48,0,48,2,2,0,1,51,6.107247668,10844,0,0,2214,1200,1014,99347,71031,28316,917,560,357,70.10804322
af743223827ef48d4868d42d825340c78890800a,0,0,0,0,0,0,0,0,0,0,0,0,0,0,1,0,0,0,0,0,0,0,0,0,0,100
ac5ecf5035b87d0cdc25fb3cf77b242d321b1818,0,0,0,0,0,0,0,0,0,0,0,0,0,0,2,1,0,0,0,0,0,0,0,0,0,100
41fdc1cfbf92e11fb39fe4a2b70c0b984a164b12,0,0,0,0,0,0,0,0,0,0,0,0,0,0,0,0,0,0,0,0,0,0,0,0,0,100
d797c6b0476fa491833aa0b3cff3661a3cff3ba3,0,0,0,0,0,0,0,0,0,0,0,0,0,0,1,1,0,0,0,0,0,0,0,0,0,100
842462fcee2973da4dd2d04122e385cb3c2347db,217,0,2493,2493,0,0,0,2,2,0,2,64,3.137231339,19809,0,0,2659,12183,9524,119967,1144935,1024968,1130,3134,2004,15.24008351
2a6d996beebf26ac603b8ac85e63c2f2dcc9fe65,202,752,752,0,0,0,0,1,2,0,1,60,6.795286505,18443,1,1,2657,2657,0,120618,119780,838,1128,1128,0,100
29c089e3f0c162c2410c8bf2f1c397daded3c8f5,405,28790,28790,0,202,0,202,2,2,0,2,121,8.074526777,18464,3,3,2659,14575,11916,119967,1258888,1138921,1130,4158,3028,15.24008351
2411e40faf41c79ac996531ca2e4b9c5c1e798af,405,28790,28790,0,202,0,202,3,3,0,2,121,8.074526777,18464,2,2,2659,14575,11916,120805,1250374,1129569,1130,4158,3028,15.04702194
1ae657ae03cce670577f1f288d5929e9799fa5a7,202,469,469,0,0,0,0,1,2,0,1,60,7.233776945,18443,3,3,2657,2657,0,120618,120618,0,1128,1128,0,100
0ef9478fd418f8695b75618c0f332dcb62650155,405,28790,28790,0,202,0,202,2,2,0,2,121,8.074526777,18464,4,4,2659,14575,11916,119967,1258888,1138921,1130,4158,3028,15.04702194
7c51b5a5995b6a4af7bfbe7b0d23fca95de9edea,405,28790,28790,0,202,0,202,3,3,0,2,121,8.074526777,18464,5,5,2659,14575,11916,120805,1250374,1129569,1130,4158,3028,15.04702194
c73db58ffa1d21e3b8e4ce53f409c0e17336be7d,2,115,102,13,0,0,0,2,3,26,1,2,0.458685816,174,6,3,26,23,3,2249,1870,379,9,6,3,100
b24d27c27902a1e8784a147cfe5b188b1d732a74,18,3,2055,2052,0,0,0,2,3,18,1,3,2.911385158,1642,7,4,12,118,106,384,9636,9252,8,47,39,94.52954048
0232b1da744bdfabe2c2fc79ae5cb53f848599dd,0,0,0,0,0,0,0,0,0,0,0,0,0,0,8,5,0,0,0,0,0,0,0,0,0,100
3bbde87916f02c6e34004b8949d847d99bd78412,0,0,0,0,0,0,0,0,0,0,0,0,0,0,0,0,0,0,0,0,0,0,0,0,0,100
3f3890e2f2fd0816599e1ca1823c2b8ff96a01dd,0,0,0,0,0,0,0,0,0,0,0,0,0,0,1,1,0,0,0,0,0,0,0,0,0,100
f66f099c999b56a6e3e67cadcbc0f932bc1f87cf,0,0,0,0,0,0,0,0,0,0,0,0,0,0,2,2,0,0,0,0,0,0,0,0,0,100
10a58f6e6a203cd4de29b0e80f48f8359565d598,0,0,0,0,0,0,0,0,0,0,0,0,0,0,0,0,0,0,0,0,0,0,0,0,0,100
fd99302aa10e638f98c08d6d892576358430150c,0,0,0,0,0,0,0,0,0,0,0,0,0,0,3,3,0,0,0,0,0,0,0,0,0,100
ae321aadd9b1a75a97ff8a3f0542d04bc4a184bc,0,0,0,0,0,0,0,0,0,0,0,0,0,0,4,4,0,0,0,0,0,0,0,0,0,100
ab6d60d6a323d1da7fad073a961414dad39f9d2b,0,0,0,0,0,0,0,0,0,0,0,0,0,0,1,1,0,0,0,0,0,0,0,0,0,100
6fccedad04f128efe26d574b6a191a04799f319f,388,28790,26751,2039,202,0,202,2,2,0,2,119,8.036223278,16937,1,0,2659,3658,999,119967,246249,126282,1130,2012,882,13.98907104
979dee01a27b67b4d659fd60ff906fbd3ecc9593,0,0,0,0,0,0,0,0,0,0,0,0,0,0,10,0,0,0,0,0,0,0,0,0,0,100
13e8a716e71954e54b78e94ec87f233c7db95d52,0,0,0,0,0,0,0,0,0,0,0,0,0,0,2,1,0,0,0,0,0,0,0,0,0,100
0544c2665ebae6f0b5c62728abd77fa2c9167137,0,0,0,0,0,0,0,0,0,0,0,0,0,0,1,0,0,0,0,0,0,0,0,0,0,100
90cda3ff2d9e45af9b00a71ba9d2e870cb39ee84,217,0,2493,2493,0,0,0,2,2,0,2,64,3.137231339,19809,0,0,2659,12183,9524,119967,1144935,1024968,1130,3134,2004,15.24008351
dd8f0ca2933e7d41fb7bef8ffb2e2096ada6a9ec,202,752,752,0,0,0,0,1,2,0,1,60,6.795286505,18443,1,1,2657,2657,0,120618,119780,838,1128,1128,0,100
3854e07588e02d0f3fa41aee2ef4385fc49ae1d0,202,0,0,0,0,0,0,1,1,0,1,60,0,18443,2,2,2657,11918,9261,120618,1138270,1017652,1128,3030,1902,15.46499478
d504487d19c5f2a16e3f255945c8a3ee3c4b54f7,202,469,469,0,0,0,0,1,2,0,1,60,7.233776945,18443,3,3,2657,2657,0,120618,120618,0,1128,1128,0,100
9d5374cc9ef1952d9a51b272dae4e5762ea582a6,2,115,102,13,0,0,0,2,3,0,1,2,0.458685816,174,2,1,26,23,3,2249,1870,379,9,6,3,100
a9d4eece160bad5e8c374d7d4e4b22abed904d24,18,3,2055,2052,0,0,0,2,3,0,1,3,2.911385158,1642,3,2,12,118,106,384,9636,9252,8,47,39,94.52954048
9149957339144216f3520f10aa1ab78b40bb4909,0,0,0,0,0,0,0,0,0,0,0,0,0,0,4,3,0,0,0,0,0,0,0,0,0,100
57e3a8f8c082d591c0257981009752f4570c3630,0,0,0,0,0,0,0,0,0,0,0,0,0,0,0,0,0,0,0,0,0,0,0,0,0,100
88ded5f08a081097bebae93e334f3deb92244e1d,0,0,0,0,0,0,0,0,0,0,0,0,0,0,1,0,0,0,0,0,0,0,0,0,0,100
6dc127518f1eabd7a5c134699c6d10551f5daf33,0,0,0,0,0,0,0,0,0,0,0,0,0,0,2,2,0,0,0,0,0,0,0,0,0,100
d91387e892b8b5e363cdc31eedfc2cb4d0d9ccbc,0,0,0,0,0,0,0,0,0,0,0,0,0,0,0,0,0,0,0,0,0,0,0,0,0,100
47226af261b7b94776032244df83056b2e3d1739,0,0,0,0,0,0,0,0,0,0,0,0,0,0,0,0,0,0,0,0,0,0,0,0,0,100
97f25dfdda60bc6b5496736fc7809376aea1ac19,0,0,0,0,0,0,0,0,0,0,0,0,0,0,1,1,0,0,0,0,0,0,0,0,0,100
c5d80a83189b70e39aafbfb12d00b17c6905521e,0,0,0,0,0,0,0,0,0,0,0,0,0,0,1,1,0,0,0,0,0,0,0,0,0,100
e639420938e5356f79ad2c2e4d8661edcb73a439,0,0,0,0,0,0,0,0,0,0,0,0,0,0,2,2,0,0,0,0,0,0,0,0,0,100
af3066d5c1b1b5145d3ce8c482323448821ccd93,0,0,0,0,0,0,0,0,0,0,0,0,0,0,3,3,0,0,0,0,0,0,0,0,0,100
b15ec5a58a9970dc3c0df705303bb0fd03b7f644,0,0,0,0,0,0,0,0,0,0,0,0,0,0,4,4,0,0,0,0,0,0,0,0,0,100
c2e85f4e2d5a6bf1b33a24a2f28eca70262d0a3b,0,0,0,0,0,0,0,0,0,0,0,0,0,0,3,3,0,0,0,0,0,0,0,0,0,100
6cbd6a7b7db21d92bec39fc27108972011b18685,0,0,0,0,0,0,0,0,0,0,0,0,0,0,5,5,0,0,0,0,0,0,0,0,0,100
4a414a18b8a45116b898f7962690df11fac581f0,0,0,0,0,0,0,0,0,0,0,0,0,0,0,9,9,0,0,0,0,0,0,0,0,0,100
aeba74c50535d835a9d431b5c21b04e1c1b6499e,0,0,0,0,0,0,0,0,0,0,0,0,0,0,6,6,0,0,0,0,0,0,0,0,0,100
65dfc82f00889bc49b8915cefd20e2331d8e2e51,0,0,0,0,0,0,0,0,0,0,0,0,0,0,10,10,0,0,0,0,0,0,0,0,0,100
1eb0862f9e7d66d897a11cf8480cb0f94354c91f,0,0,0,0,0,0,0,0,0,0,0,0,0,0,7,7,0,0,0,0,0,0,0,0,0,100
e6945f29acb8ebb2c6198ec1e05a2251561ba0d5,0,0,0,0,0,0,0,0,0,0,0,0,0,0,8,8,0,0,0,0,0,0,0,0,0,100
6b79ed171ebe3b73a89cd84669886ebb6f3d8ba9,0,0,0,0,0,0,0,0,0,0,0,0,0,0,9,9,0,0,0,0,0,0,0,0,0,100
d8c9dbec436d56549c0ceeb68e05298e2f22bf49,0,0,0,0,0,0,0,0,0,0,0,0,0,0,10,10,0,0,0,0,0,0,0,0,0,100
14e656c101d69186dfa672dbf64df97805e8bfa9,0,0,0,0,0,0,0,0,0,0,0,0,0,0,13,13,0,0,0,0,0,0,0,0,0,100
425cc8bf9d56cbe8f8f8c67b8a28a9d60dfd4a10,2,325,0,325,2,0,2,1,1,0,1,1,0.977696346,0,14,14,28,0,28,1376,0,1376,12,0,12,98.74857793
fd35b10dd25fce278962ab87b574ad9acd15d19f,23,992,24,968,14,0,14,1,4,17,1,11,3.621400534,763,2,1,237,104,133,10873,4842,6031,146,67,79,96.31236443
bc140a571a78c428e9ae5a3315c427724183782f,0,0,0,0,0,0,0,0,0,0,0,0,0,0,3,2,0,0,0,0,0,0,0,0,0,100
40be20a6a1f78d0097b678bf8a7cee45779f4a63,19,826,185,641,4,0,4,2,3,60,1,9,2.89112068,1317,0,0,285,232,53,8943,7028,1915,205,166,39,98.65145228
5bd1ddaf4af2fefd3843aae7df0c0313114aec36,65,1673,2057,384,16,0,16,1,5,33,1,24,5.132262992,3972,0,0,544,505,39,27825,26939,886,282,239,43,92.55861366
2c379a239ea19a509e8d3636d087c80f080dda8d,68,4068,204,3864,46,0,46,1,5,1,1,37,5.225481521,1981,0,0,786,307,479,35786,12964,22822,431,160,271,89.45454545
0e798451051fb3359be1342f8f9520e1fdd5a4b5,0,0,0,0,0,0,0,0,0,0,0,0,0,0,0,0,0,0,0,0,0,0,0,0,0,100
84d9be3a8f2484432adfa132dd91f51c172bda7d,0,0,0,0,0,0,0,0,0,0,0,0,0,0,4,2,0,0,0,0,0,0,0,0,0,100
5ee15b990466e42a9914150620ef289199ec2e31,254,3904,453,3451,1,0,1,1,6,0,1,88,7.94273193,21120,1,1,3243,3243,0,143490,143490,0,1507,1507,0,99.83471074
95fa3451db6881fbfe1f1144488af7d17a7acf26,0,0,0,0,0,0,0,0,0,0,0,0,0,0,5,2,0,0,0,0,0,0,0,0,0,100
eb8f5e1faaf7c1552843f105c2394941d2cf13a1,0,0,0,0,0,0,0,0,0,0,0,0,0,0,6,3,0,0,0,0,0,0,0,0,0,100
e759672b8bbca64bb82e254ea6332e2adee98cce,0,0,0,0,0,0,0,0,0,0,0,0,0,0,0,0,0,0,0,0,0,0,0,0,0,100
1d4eeb0fc74f379fa328108fcd20ec34a5f0686a,0,0,0,0,0,0,0,0,0,0,0,0,0,0,0,0,0,0,0,0,0,0,0,0,0,100
e3e7979a7093b352b881dbbafd7a8e0bb1c3e3a4,0,0,0,0,0,0,0,0,0,0,0,0,0,0,1,1,0,0,0,0,0,0,0,0,0,100
19c09fa49a4dd2032934b3401a22a136df816178,0,0,0,0,0,0,0,0,0,0,0,0,0,0,7,3,0,0,0,0,0,0,0,0,0,100
563acab9a99b8b41828b9972f80978ce8e1c8860,0,0,0,0,0,0,0,0,0,0,0,0,0,0,0,0,0,0,0,0,0,0,0,0,0,100
b558fad39fcd7a1e3b7042462990b2aee2303b30,0,0,0,0,0,0,0,0,0,0,0,0,0,0,1,1,0,0,0,0,0,0,0,0,0,100
d25c73008aa27956922f6a5423ee8f791fd28bd5,0,0,0,0,0,0,0,0,0,0,0,0,0,0,2,2,0,0,0,0,0,0,0,0,0,100
59221f75c2e677b2d379e859ce11bc8454579b10,0,0,0,0,0,0,0,0,0,0,0,0,0,0,3,3,0,0,0,0,0,0,0,0,0,100
b43b48256000234f433b458e0ef5faaaf165fe7e,51,1909,317,1592,16,0,16,2,5,0,1,25,4.567497777,2723,8,4,595,1845,1250,30449,61592,31143,309,809,500,91.37096774
f785a4366f9ed6dd01b07172a50bf06aeb01cbca,0,0,0,0,0,0,0,0,0,0,0,0,0,0,2,2,0,0,0,0,0,0,0,0,0,100
d5f7039563967bda0cf80de3460a9cdfc027b66a,57,3236,576,2660,37,0,37,1,6,0,1,30,5.294919001,1816,1,0,514,308,206,24175,14011,10164,298,152,146,92.32488823
fb638fe57745f54cc47c316f3e2cad883a9de73c,0,0,0,0,0,0,0,0,0,0,0,0,0,0,9,5,0,0,0,0,0,0,0,0,0,100
876e61f5bf5574659032948051abdc80916c24da,1,0,0,0,0,0,0,1,1,0,1,1,0,68,10,6,9,9,0,503,503,0,5,5,0,99.71751412
18893a166adf35e26fcb6eff86a01d38c3c03da6,21,452,68,384,1,0,1,3,6,10,1,15,3.011865236,1761,4,3,287,244,43,16235,13787,2448,146,127,19,99.64763918
6d9ebed78020d50dc3da459daa9aadbd4707c118,0,0,0,0,0,0,0,0,0,0,0,0,0,0,3,1,0,0,0,0,0,0,0,0,0,100
bbb3e790f30573f791afd88ea217a7a284e6b24d,0,0,0,0,0,0,0,0,0,0,0,0,0,0,5,4,0,0,0,0,0,0,0,0,0,100
aa255986a03f019f4671a16df1ca1b8d8e1211ca,13,710,106,604,5,0,5,3,3,2,1,8,2.932303975,726,2,0,172,100,72,9650,5775,3875,82,51,31,99.02166317
8372ad63d111cfb82ab975cf6c4508b8f5914800,0,0,0,0,0,0,0,0,0,0,0,0,0,0,4,2,0,0,0,0,0,0,0,0,0,100
bdc7f71f3086520db7806bc1a79180050687a851,0,0,0,0,0,0,0,0,0,0,0,0,0,0,5,3,0,0,0,0,0,0,0,0,0,100
49fcde983c05c96a8c8abd38957fe4164a030dad,0,0,0,0,0,0,0,0,0,0,0,0,0,0,6,4,0,0,0,0,0,0,0,0,0,100
69d9674857ae27e93f43214a6553512830d580e9,6,81,57,24,0,0,0,2,5,22,1,3,1.687564875,842,3,1,113,106,7,6461,6198,263,45,43,2,100
3d3d6bf6f0eaf764a99c31d7b9876cad011411fa,0,0,0,0,0,0,0,0,0,0,0,0,0,0,7,5,0,0,0,0,0,0,0,0,0,100
312c50e2be2362c2a2a18198fd3835d21c7de3d3,0,0,0,0,0,0,0,0,0,0,0,0,0,0,8,5,0,0,0,0,0,0,0,0,0,100
24312b568b115d8ae675f1f97ed58a25f4684f84,0,0,0,0,0,0,0,0,0,0,0,0,0,0,9,6,0,0,0,0,0,0,0,0,0,100
45df3df8b503dcc953945086349649bd8ff6196a,0,0,0,0,0,0,0,0,0,0,0,0,0,0,10,7,0,0,0,0,0,0,0,0,0,100
2fdfb1a88c4c37af128d10bfcdb35f6ead5007de,0,0,0,0,0,0,0,0,0,0,0,0,0,0,6,2,0,0,0,0,0,0,0,0,0,100
754b551cdff14a1af3adfaabfca3e4a9f5ef3cea,10,408,5,403,2,0,2,1,6,55,1,8,1.932402541,1054,2,0,154,124,30,10701,7907,2794,66,56,10,99.37629938
afc10d6486e86b657ea3162046801a81aa770cb2,0,0,0,0,0,0,0,0,0,0,0,0,0,0,7,3,0,0,0,0,0,0,0,0,0,100
09acf470df3001d9ade23f1115504c277284ac3f,0,0,0,0,0,0,0,0,0,0,0,0,0,0,0,0,0,0,0,0,0,0,0,0,0,100
f4830b3799bfdcda4f2469145091f3ba3d50d30c,0,0,0,0,0,0,0,0,0,0,0,0,0,0,11,8,0,0,0,0,0,0,0,0,0,100
e450e0eab0031357e0d0420dea1cb933c70d1be4,0,0,0,0,0,0,0,0,0,0,0,0,0,0,8,4,0,0,0,0,0,0,0,0,0,100
91859f42c59b7eb9926f1a9ab24a8a1a339cca86,0,0,0,0,0,0,0,0,0,0,0,0,0,0,3,1,0,0,0,0,0,0,0,0,0,100
67303469dfbbd5045dd3dc78ceff4d77ecb604b2,0,0,0,0,0,0,0,0,0,0,0,0,0,0,9,4,0,0,0,0,0,0,0,0,0,100
3ffc57c967f7e0cbc59deaf7f75488c643abcaca,0,0,0,0,0,0,0,0,0,0,0,0,0,0,12,8,0,0,0,0,0,0,0,0,0,100
dfb2ccdcc94d6d56c7500d3ef5ed02953ac10fae,0,0,0,0,0,0,0,0,0,0,0,0,0,0,4,2,0,0,0,0,0,0,0,0,0,100
4b14988ef6810b4591728dd951af40784f464abd,0,0,0,0,0,0,0,0,0,0,0,0,0,0,11,0,0,0,0,0,0,0,0,0,0,100
3bb943f69930b1e6c624a6fe35b67d5a3b66b6bd,0,0,0,0,0,0,0,0,0,0,0,0,0,0,13,7,0,0,0,0,0,0,0,0,0,100
526d23ecd30b835cc9f598e6b78b11eb9850cb9e,0,0,0,0,0,0,0,0,0,0,0,0,0,0,5,1,0,0,0,0,0,0,0,0,0,100
40e68a70bfc200c5b599a0bdf47837bef4079ea6,0,0,0,0,0,0,0,0,0,0,0,0,0,0,12,1,0,0,0,0,0,0,0,0,0,100
860cd9aa8d1eff74966403ebd2291c2d299a3c0a,0,0,0,0,0,0,0,0,0,0,0,0,0,0,10,3,0,0,0,0,0,0,0,0,0,100
24cef92c0fe0f58b136dfaa6d7caa0896f9f6a46,0,0,0,0,0,0,0,0,0,0,0,0,0,0,1,0,0,0,0,0,0,0,0,0,0,100
18af391b7cd65d54a41f8ed33b057018f7a00337,0,0,0,0,0,0,0,0,0,0,0,0,0,0,11,1,0,0,0,0,0,0,0,0,0,100
8d9f7809640e6953eee7df653d3d308378fea159,0,0,0,0,0,0,0,0,0,0,0,0,0,0,13,2,0,0,0,0,0,0,0,0,0,100
c01e6746b4e1eb1e8b8e34ec00ddab1bf7404ffc,50,1415,1464,49,12,0,12,2,6,44,1,31,4.773448786,2912,4,0,414,303,111,23966,17632,6334,235,154,81,94.22680412
d8927d6e518b6a57cbbc6ce9669e4db9d4b8ae1a,84,3088,2144,944,14,0,14,2,7,48,1,51,5.48945012,5189,6,1,918,662,256,45658,35093,10565,483,365,118,91.58383035
7f66d1633aaba79e447e679b66bc07642c072b9f,1,2,1,1,0,0,0,1,3,5,1,1,0,178,5,1,17,16,1,1482,1484,2,6,6,0,100
585f25ae52d8e51cd831c33254338e284c2775d3,4,454,0,454,2,0,2,1,2,6,1,4,1.351631603,169,0,0,43,6,37,3563,1428,2135,19,4,15,99.67928159
f3c98c42de5b519e9d9efa9ab3df74092caa400f,0,0,0,0,0,0,0,0,0,0,0,0,0,0,6,2,0,0,0,0,0,0,0,0,0,100
972b812e09926b46a1fd68bbc687c9742451ff03,11,467,45,422,5,0,5,1,8,6,1,8,2.919393375,626,7,3,158,128,30,7306,5082,2224,84,66,18,98.3627204
13931880e004b12bf0c346bb61eaa263df43bb6a,0,0,0,0,0,0,0,0,0,0,0,0,0,0,14,0,0,0,0,0,0,0,0,0,0,100
9cd9e73962304cb6f02294dcd56dc15a21802674,16,98,88,10,0,0,0,2,7,83,1,9,3.888125266,1474,8,4,213,213,0,9192,9192,0,141,141,0,100
4d257ecfb393c3109cbccba580de8fa9e0d7f1b7,0,0,0,0,0,0,0,0,0,0,0,0,0,0,15,1,0,0,0,0,0,0,0,0,0,100
30ed07897f02ecfd237a7b8721fa848a2343b262,16,807,583,224,9,0,9,1,8,2,1,12,3.475584954,1247,9,5,230,379,149,11408,13421,2013,103,166,63,93.78531073
ab518d56ccde5ba4e7f04c8129664b5dcb863af8,0,0,0,0,0,0,0,0,0,0,0,0,0,0,16,2,0,0,0,0,0,0,0,0,0,100
7b7dd2b831823b5914cd1bf35e61a18c5bc83b08,0,0,0,0,0,0,0,0,0,0,0,0,0,0,17,3,0,0,0,0,0,0,0,0,0,100
e570aa98ddd237562c94efe2c8c3af4f552f35ae,16,1252,85,1167,11,0,11,1,8,6,1,7,3.694919193,363,10,6,109,45,64,9486,2807,6679,65,23,42,91.79810726
64da8e9a6e5f6a787a71af7e6d27789ba736ac36,15,1039,43,996,9,0,9,2,4,8,1,8,3.221234546,813,1,1,167,109,58,12022,6774,5248,75,42,33,98.57761286
a1dc7a8d632400776e1718dea72cdcd9ef72b477,0,0,0,0,0,0,0,0,0,0,0,0,0,0,2,2,0,0,0,0,0,0,0,0,0,100
0daa7a42bce530eea893415b54c654585e5b45ba,539,24098,36363,12265,186,0,186,2,9,0,2,223,8.429528991,27493,11,3,3242,3568,326,154332,167271,12939,1646,1663,17,17.44421907
cbe3c86d4db42b489d962ba10849dab6a8aec928,0,0,0,0,0,0,0,0,0,0,0,0,0,0,15,0,0,0,0,0,0,0,0,0,0,100
88532d9d404a927a9e6da7fdb1984f0653c1e8f1,0,0,0,0,0,0,0,0,0,0,0,0,0,0,18,3,0,0,0,0,0,0,0,0,0,100
4b66c1bb573da4c5b1d478ffd63dfab45ca41e36,0,0,0,0,0,0,0,0,0,0,0,0,0,0,19,4,0,0,0,0,0,0,0,0,0,100
4f0d870f8253179a5c7f1c1c0f2649c820c0d858,0,0,0,0,0,0,0,0,0,0,0,0,0,0,20,5,0,0,0,0,0,0,0,0,0,100
12530072ae94921e5b6d6800b9890eec1d0d7edd,0,0,0,0,0,0,0,0,0,0,0,0,0,0,21,6,0,0,0,0,0,0,0,0,0,100
846302e1eda7c090c9229a94cb67822a4aa61bb7,9,287,12,275,1,0,1,2,2,0,1,7,2.311970902,993,0,0,113,98,15,10143,7915,2228,61,47,14,99.39439818
9ddf13fb942739aef40498cc78ad7537630c7b64,0,0,0,0,0,0,0,0,0,0,0,0,0,0,12,0,0,0,0,0,0,0,0,0,0,100
1990e23e5ca57fb50f0fa39ccf02604a445539b9,0,0,0,0,0,0,0,0,0,0,0,0,0,0,22,7,0,0,0,0,0,0,0,0,0,100
c7ec265ca247f7ea6fb7016e54f0c20b739e149d,62,3520,5014,1494,19,0,19,1,2,0,1,28,5.26332489,3793,14,0,526,554,28,28015,26291,1724,270,292,22,90.75931232
01231ab79625201e9f476884bcac00e84ca8f4fd,11,390,65,325,4,0,4,1,3,6,1,5,3.042467219,670,12,2,170,136,34,5971,5127,844,87,61,26,98.98373984
418b02b55b1200c84c427f4b303ffe4f6f1e8b12,0,0,0,0,0,0,0,0,0,0,0,0,0,0,23,5,0,0,0,0,0,0,0,0,0,100
431be8f07e6a9bbe8a8c5e54e23a357beb3f40af,0,0,0,0,0,0,0,0,0,0,0,0,0,0,24,6,0,0,0,0,0,0,0,0,0,100
1b9224be52db87f049c657649d2d9cf1b08ab97f,1,3,1,2,0,0,0,3,3,12,1,1,0,117,13,1,17,17,0,1080,1066,14,8,8,0,100
7231b4e23d1082a9b0f0c42143b7e9daf7ff1a0e,0,0,0,0,0,0,0,0,0,0,0,0,0,0,25,7,0,0,0,0,0,0,0,0,0,100
bd9a26b5247416c26f981f8e115f63f5b6e225d8,0,0,0,0,0,0,0,0,0,0,0,0,0,0,14,2,0,0,0,0,0,0,0,0,0,100
761943a3b6fc797b8841c67132273e9345bd4b84,2,84,8,76,0,0,0,1,4,15,1,2,0.086504214,202,13,2,52,35,17,1814,1449,365,16,16,0,100
4bf830401a72d68f1e9d52a08a3e80501df9ab6a,0,0,0,0,0,0,0,0,0,0,0,0,0,0,15,3,0,0,0,0,0,0,0,0,0,100
c72c1cce57316b0a8487f6967591b1bab4d309f4,0,0,0,0,0,0,0,0,0,0,0,0,0,0,16,4,0,0,0,0,0,0,0,0,0,100
f2fa8182b0d78ced8892a0262775c43b9732cac3,0,0,0,0,0,0,0,0,0,0,0,0,0,0,0,0,0,0,0,0,0,0,0,0,0,100
a3f582006830dca819ae407995d748254938ef0b,0,0,0,0,0,0,0,0,0,0,0,0,0,0,14,3,0,0,0,0,0,0,0,0,0,100
6461039d2e3a0b7156583e7cab3d721aff3675f8,0,0,0,0,0,0,0,0,0,0,0,0,0,0,17,5,0,0,0,0,0,0,0,0,0,100
8d8884724016aeef60d3d3fe80092d6edc389314,0,0,0,0,0,0,0,0,0,0,0,0,0,0,15,3,0,0,0,0,0,0,0,0,0,100
7572d6bdd0d5301ebc452fd21e0740d8366d0292,0,0,0,0,0,0,0,0,0,0,0,0,0,0,26,8,0,0,0,0,0,0,0,0,0,100
c41b82207d26e3574bf975acec393b73a766f033,2,23,8,15,0,0,0,3,3,36,1,2,0.981152234,182,0,0,34,31,3,1626,1525,101,15,14,1,100
46c25093e65a78037883b9365a8059bc4ddfe426,60,4216,367,3849,28,0,28,2,3,0,1,27,4.513329266,3392,15,1,1026,420,606,45071,26208,18863,574,199,375,92.69125683
353da40259f92378e06ad84c322815dc293d7b15,0,0,0,0,0,0,0,0,0,0,0,0,0,0,0,0,0,0,0,0,0,0,0,0,0,100
49896c30bc2022cca4cc86db6244dab80322cd49,0,0,0,0,0,0,0,0,0,0,0,0,0,0,0,0,0,0,0,0,0,0,0,0,0,100
ac977166a868f7db22f45e11f31c24b83eaeabfc,0,0,0,0,0,0,0,0,0,0,0,0,0,0,18,5,0,0,0,0,0,0,0,0,0,100
24cbf702502d9c2a7626e11024cce585bab41131,4,436,10,426,3,0,3,1,5,6,1,4,1.591754953,198,0,0,86,42,44,3877,1348,2529,34,11,23,99.51790634
28cd32c6ff2f997e23950c99c3ce8ffff3487fb2,0,0,0,0,0,0,0,0,0,0,0,0,0,0,27,4,0,0,0,0,0,0,0,0,0,100
bb22cbbb7706726a63a8dd8cd590f04dbc8f5a38,0,0,0,0,0,0,0,0,0,0,0,0,0,0,16,4,0,0,0,0,0,0,0,0,0,100
9f0b6010808e4b679a076d8ec1741b8bef004308,80,1635,523,1112,17,0,17,1,6,0,1,46,5.443542601,5341,17,4,796,691,105,48196,42550,5646,414,355,59,94.89862655
392a5be09c4a0aef52e44583a1bda15f2f19a79d,20,1211,290,921,11,0,11,1,4,10,1,14,3.924277696,1377,1,1,170,141,29,16662,11570,5092,86,57,29,94.8441247
f0421c1028a4c95e10aecdb1bc0fee43d7826159,0,0,0,0,0,0,0,0,0,0,0,0,0,0,0,0,0,0,0,0,0,0,0,0,0,100
aa449afb51d24eb46bd74c1fa8389dcd55130313,0,0,0,0,0,0,0,0,0,0,0,0,0,0,0,0,0,0,0,0,0,0,0,0,0,100
b855ef34d1f3a501f6afd76f96e7dded30f903af,0,0,0,0,0,0,0,0,0,0,0,0,0,0,19,2,0,0,0,0,0,0,0,0,0,100
7bcabbf601f4d8bd5fc9c095bd8eb1aa3befb015,0,0,0,0,0,0,0,0,0,0,0,0,0,0,0,0,0,0,0,0,0,0,0,0,0,100
66450934627c40d34a490735ebd9affe32f915e3,0,0,0,0,0,0,0,0,0,0,0,0,0,0,1,1,0,0,0,0,0,0,0,0,0,100
2e984b8e4631ac45a49253815997f824d4d0018b,0,0,0,0,0,0,0,0,0,0,0,0,0,0,28,1,0,0,0,0,0,0,0,0,0,100
008c9a824083686db0410e1a5ac73f75a7d9d0e0,8,97,27,70,0,0,0,2,4,54,1,8,2.552684261,727,16,0,122,102,20,6023,5664,359,47,43,4,100
c1c9dca529690aaa0cf61ab907bfeb531c14ed10,0,0,0,0,0,0,0,0,0,0,0,0,0,0,29,2,0,0,0,0,0,0,0,0,0,100
c5354323e78fcd34fdac42628a295c092cb5ec2a,11,862,18,844,8,0,8,2,4,12,1,5,3.110324464,184,17,1,115,33,82,6133,1703,4430,51,17,34,98.29738933
66ca236fdd6416f5187c1c30a738c6438d29313d,14,932,268,664,3,0,3,3,4,38,1,12,2.220044719,1286,20,1,258,151,107,14107,10946,3161,172,67,105,98.94444444
2a2dad4044bb38a45874ccd4732422ae36fee332,6,481,52,429,3,0,3,1,2,18,1,4,2.002493682,202,18,2,66,16,50,4041,1535,2506,37,9,28,99.50549451
57261e177865a77c397c9b3d5576e8497568d87f,15,382,51,331,5,0,5,2,5,26,1,9,3.450974029,454,19,3,108,75,33,5353,3719,1634,52,35,17,99.24160347
b6f7a1a8fd766b14b0fe3f73e4de94ef463659c1,10,227,54,173,1,0,1,2,4,61,1,8,2.840500326,653,20,4,138,114,24,6507,5207,1300,72,58,14,98.14710837
75592971a8ea1280270a538432ae9c500afb365c,59,2561,779,1782,16,0,16,2,6,19,1,40,4.029849226,4015,21,5,841,674,167,43327,33016,10311,407,321,86,95.55683785
230f0d205766e25f27fe316b449dc6a55c3711c6,32,1870,18,1852,24,0,24,2,7,11,1,12,4.64716009,815,22,6,284,120,164,14779,6413,8366,155,67,88,96.54605263
70d5214f3aa9d2900149a323abf5348bde4636fc,0,0,0,0,0,0,0,0,0,0,0,0,0,0,30,2,0,0,0,0,0,0,0,0,0,100
6b5fbaa577838f3ec7b11e3dd40e55df9b33d986,5,47,68,21,0,0,0,2,8,21,1,5,1.581553029,678,23,7,56,54,2,5553,5630,77,26,25,1,100
9a7869e98bf53e50d489daf390c4f5597174fb34,0,0,0,0,0,0,0,0,0,0,0,0,0,0,2,0,0,0,0,0,0,0,0,0,0,100
42c606c4e073592db86d54e5fab8fbb90f75bd65,4,290,305,15,1,0,1,2,2,108,1,4,1.639173277,266,2,0,43,48,5,1781,2019,238,29,21,8,99.78723404
56848aa7d48e6be98dc1e9e9d3d1779727828444,10,112,23,89,0,0,0,3,7,54,1,7,2.240229676,958,24,3,154,137,17,8143,7448,695,64,60,4,99.73558964
0c6b09bae814dc9951278332d1760e91c2ac8548,6,462,347,115,1,0,1,2,3,68,1,6,1.097671834,835,3,1,108,97,11,7700,7074,626,56,46,10,99.79002625
bd9f74143dc5a3819733607a4c9f6f9948ceb3f6,0,0,0,0,0,0,0,0,0,0,0,0,0,0,31,1,0,0,0,0,0,0,0,0,0,100
7a45ff9c6f556f778a7dbd077b817ad6341cf567,4,4,19,15,0,0,0,2,6,0,1,1,1.241524204,329,25,3,55,58,3,2293,2436,143,28,29,1,100
0670dad9f742c142341851ddf6cd8eb505e3fd40,3,145,2,143,1,0,1,2,6,12,1,3,1.38421334,296,26,4,12,9,3,3208,2633,575,11,8,3,98.23925427
32d22fc2b63c5d1a30ab5dd87dc78c679a703de9,0,0,0,0,0,0,0,0,0,0,0,0,0,0,21,0,0,0,0,0,0,0,0,0,0,100
acea8ca2395c52d93da6381aa55b5ec0a9833d9d,53,3331,461,2870,16,0,16,2,4,23,1,25,4.540340842,2851,27,4,994,584,410,35029,21164,13865,622,369,253,96.88911189
fabe86e4129590915e9385a9f7ecef5d48c7d906,23,973,130,843,5,0,5,1,9,22,1,16,3.614549997,1972,28,5,356,282,74,20944,15060,5884,172,136,36,95.44794189
0fe2097a5e9655e4c612a1c400a0fc34cbf0adf6,2,77,4,73,1,0,1,1,4,46,1,2,0.424405145,104,29,6,14,12,2,1128,600,528,10,8,2,99.80961447
5c11770c60d9f14ac2bc9ecbea4b95f5716142aa,2,133,116,17,0,0,0,2,4,122,1,2,0.374408845,226,30,7,32,29,3,3044,2972,72,13,12,1,100
1686db742f5e0601600fab2338cd391d8ba2c81f,4,113,8,105,2,0,2,1,2,22,1,2,1.93021088,55,31,8,29,11,18,778,374,404,14,10,4,98.54323308
e3697a69f1ff736962aa579f8698a360344f5e02,0,0,0,0,0,0,0,0,0,0,0,0,0,0,4,2,0,0,0,0,0,0,0,0,0,100
5a326da026c4b8b61f94d24cebd15564fbd30e0a,1,0,17,17,0,0,0,2,2,156,1,1,0,0,22,1,0,0,0,0,0,0,0,0,0,99.90697674
bf20bba4e2057ea47aba4fa5e58518ad95879deb,13,1035,45,990,11,0,11,1,3,17,1,6,3.320699086,309,5,3,125,38,87,7887,2510,5377,72,15,57,98.90460977
c3f7d7a3f1dad9a9a9b0b39f1b59093d8c438102,0,0,0,0,0,0,0,0,0,0,0,0,0,0,32,2,0,0,0,0,0,0,0,0,0,100
8d82b8610c24d844ffd0afd224339502ba088f02,0,0,0,0,0,0,0,0,0,0,0,0,0,0,32,9,0,0,0,0,0,0,0,0,0,100
4429a3846b941e1b55e0374ff05bdf4e371a837c,2,191,0,191,2,0,2,1,1,0,1,2,0.813346099,0,33,10,27,0,27,904,0,904,16,0,16,99.77668602
5bfce471d95cfaad50d3dd275a4849f3ccb1381f,0,0,0,0,0,0,0,0,0,0,0,0,0,0,33,2,0,0,0,0,0,0,0,0,0,100
c884f06c4c495230e9c686510e388e884e1be23e,0,0,0,0,0,0,0,0,0,0,0,0,0,0,23,2,0,0,0,0,0,0,0,0,0,100
77014676dbd241d55f34c529b05e82ef81d287e5,0,0,0,0,0,0,0,0,0,0,0,0,0,0,24,3,0,0,0,0,0,0,0,0,0,100
2c6c27e32467b511eecddf60c0ebad538c528863,0,0,0,0,0,0,0,0,0,0,0,0,0,0,25,4,0,0,0,0,0,0,0,0,0,100
ea18037ba6b6bc7a466aa08958dba334bbcc7328,8,385,7,378,4,0,4,1,6,8,1,6,2.460349828,567,34,10,86,61,25,6343,3995,2348,48,34,14,99.46761313
e81650bec99cea4f8b24693b0221096f7ac2111f,0,0,0,0,0,0,0,0,0,0,0,0,0,0,34,3,0,0,0,0,0,0,0,0,0,100
05c3e814910ff15228336d1b2c44d488060dee62,0,0,0,0,0,0,0,0,0,0,0,0,0,0,35,4,0,0,0,0,0,0,0,0,0,100
5c22a4d161414e2376ac34c0fa44535607a1dc62,2,13,10,3,0,0,0,2,2,97,1,1,0.258018669,140,35,11,50,49,1,1148,1125,23,20,20,0,100
ce49c5d57ae357c57088be707c8be0991688a87e,0,0,0,0,0,0,0,0,0,0,0,0,0,0,36,12,0,0,0,0,0,0,0,0,0,100
e2d0b1ded454f434d7b305cd16bd1a25bfc14083,1,1,1,0,0,0,0,1,2,165,1,1,0,127,37,13,17,17,0,977,973,4,7,7,0,100
bd44d69409ba0911edd8a62f862634f95d2b2abc,3,36,3,33,0,0,0,1,2,41,1,3,1.00639071,309,38,14,27,22,5,3010,2753,257,22,20,2,100
882ba77cc8e8bbd95a54ca022f225843505b5192,0,0,0,0,0,0,0,0,0,0,0,0,0,0,36,5,0,0,0,0,0,0,0,0,0,100
b471ae08d1849f3c9f63be976dde79a93a215e52,4,168,0,168,2,0,2,2,4,54,1,4,1.332027738,638,39,15,72,59,13,5957,5043,914,26,20,6,99.82363316
5fb4dda0e385ba030455db4c7d1290f872b688ce,2,0,144,144,0,0,0,1,2,0,1,2,0.822100404,87,40,16,0,10,10,0,761,761,0,5,5,99.82363316
d3257a79d0a853ed511c1231ab79a2bfcc48603f,0,0,0,0,0,0,0,0,0,0,0,0,0,0,37,6,0,0,0,0,0,0,0,0,0,100
cf295eabb3f8003f9b177d589010e2220e8d09bc,0,0,0,0,0,0,0,0,0,0,0,0,0,0,26,0,0,0,0,0,0,0,0,0,0,100
75642001803396e8884385b0fc297a2312ead3eb,2,0,223,223,0,0,0,2,2,234,1,2,0.892499385,123,41,0,0,28,28,0,773,773,0,16,16,99.77866313
db3b437f152bdffa879ba3d9f64a0abfb02d0f36,0,0,0,0,0,0,0,0,0,0,0,0,0,0,6,0,0,0,0,0,0,0,0,0,0,100
a045159d06a682724998b71045eb88885dab57d0,0,0,0,0,0,0,0,0,0,0,0,0,0,0,27,1,0,0,0,0,0,0,0,0,0,100
861336f0d4610df881f855bf6b2096f5bc7bb74d,0,0,0,0,0,0,0,0,0,0,0,0,0,0,38,0,0,0,0,0,0,0,0,0,0,100
a116a95f2ccd908194c6a6d7f92b79a6c79bb153,0,0,0,0,0,0,0,0,0,0,0,0,0,0,39,1,0,0,0,0,0,0,0,0,0,100
2b0f1228d7bb0956e88bcf6d38b7e3a5ce2c1276,0,0,0,0,0,0,0,0,0,0,0,0,0,0,40,2,0,0,0,0,0,0,0,0,0,100
523b7b1c6b5ba7980eff53a1f4a668a408bc41a3,0,0,0,0,0,0,0,0,0,0,0,0,0,0,41,3,0,0,0,0,0,0,0,0,0,100
e50c0f3777aeb66db490eddc3be5cb8b05d073cd,0,0,0,0,0,0,0,0,0,0,0,0,0,0,42,4,0,0,0,0,0,0,0,0,0,100
1c568bf046a85fee1dc170a96bfe98ca79fb085f,1,187,84,103,0,0,0,3,7,66,1,1,0,119,43,5,16,11,5,1062,862,200,7,2,5,100
5ffcef8d4a9ec0788dca094f54b07d99c44c6bef,41,980,632,348,5,0,5,1,10,33,1,26,3.165453233,3024,42,1,451,245,206,26148,26947,799,241,149,92,91.92324855
13c5a4cd10ceb80a27eaffa359f08c4058ed5f09,0,0,0,0,0,0,0,0,0,0,0,0,0,0,28,2,0,0,0,0,0,0,0,0,0,100
bf7c527a73b6ade10d164ba205df6935b4440733,0,0,0,0,0,0,0,0,0,0,0,0,0,0,0,0,0,0,0,0,0,0,0,0,0,100
78b45258093f5e03ba2643d5f3bfe337ec632895,0,0,0,0,0,0,0,0,0,0,0,0,0,0,0,0,0,0,0,0,0,0,0,0,0,100
2d0c76ac9f9581ca2a284fb22143564c08218f72,0,0,0,0,0,0,0,0,0,0,0,0,0,0,1,1,0,0,0,0,0,0,0,0,0,100
dd92bd4d3a242c0c693c9a9e211c994f613be687,0,0,0,0,0,0,0,0,0,0,0,0,0,0,2,2,0,0,0,0,0,0,0,0,0,100
8b9d938861af86ac0fe89e563e788b16467d9ac2,0,0,0,0,0,0,0,0,0,0,0,0,0,0,3,3,0,0,0,0,0,0,0,0,0,100
528966c1e54d52554cab07fae11efcc3427f3e6c,0,0,0,0,0,0,0,0,0,0,0,0,0,0,4,4,0,0,0,0,0,0,0,0,0,100
30561604c964d645eb1d7e011f48604e1291c02d,0,0,0,0,0,0,0,0,0,0,0,0,0,0,1,1,0,0,0,0,0,0,0,0,0,100
8cf29f874a82ad53e932fe7cce7f197cae2e0d21,0,0,0,0,0,0,0,0,0,0,0,0,0,0,3,0,0,0,0,0,0,0,0,0,0,100
1182d1a87ce6a7b19b23a2d93bb72819835da102,0,0,0,0,0,0,0,0,0,0,0,0,0,0,0,0,0,0,0,0,0,0,0,0,0,100
63209e7e30b3b8089850c1e010fa8e126cdf1562,0,0,0,0,0,0,0,0,0,0,0,0,0,0,7,1,0,0,0,0,0,0,0,0,0,100
b0423073c5fed7c32be2e3943a940b0260d267f4,4,68,2,66,1,0,1,2,4,123,1,3,1.495486139,214,7,0,58,53,5,2096,1758,338,25,22,3,99.9103139
0047387635f77995d3a9bba9801fe38a7e2ca869,0,0,0,0,0,0,0,0,0,0,0,0,0,0,29,2,0,0,0,0,0,0,0,0,0,100
e99b6000146bbc6986611e31879941edddf57313,0,0,0,0,0,0,0,0,0,0,0,0,0,0,0,0,0,0,0,0,0,0,0,0,0,100
9c70a44c72c148f1054cafcde61e92cc0f1c2de1,0,0,0,0,0,0,0,0,0,0,0,0,0,0,1,1,0,0,0,0,0,0,0,0,0,100
bbd6474e2e48a39ac1471bbcd5f12e461d7ec9d8,4,81,45,36,0,0,0,2,4,205,1,1,1.928547617,172,30,2,29,32,3,1168,1023,145,20,24,4,100
b9282b438422d56fac23301dc854a39ae7d83a83,0,0,0,0,0,0,0,0,0,0,0,0,0,0,8,0,0,0,0,0,0,0,0,0,0,100
9d0e4a020216592377c4a38db88723a0e6f3772a,0,0,0,0,0,0,0,0,0,0,0,0,0,0,0,0,0,0,0,0,0,0,0,0,0,100
e5d75e7036fefcaba4f0a1b27473b67d57cd0201,26,4318,0,4318,26,0,26,1,1,0,1,12,3.961765231,0,43,0,466,0,466,23687,0,23687,189,0,189,95.45454545
93054463e602b0fa4d40b8ec0e735db6d011bb26,44,4150,4722,572,9,0,9,2,5,101,1,20,4.175388523,4017,44,1,775,829,54,27830,33195,5365,516,571,55,96.75516224
225a490cf4a475e728bf9129ea3e662b543f5cc4,0,0,0,0,0,0,0,0,0,0,0,0,0,0,31,1,0,0,0,0,0,0,0,0,0,100
1ea8d9ee426c6e0b14238abd6cfb5f8763fd9fa5,67,2865,878,1987,11,0,11,2,11,60,2,32,4.224269178,6847,45,2,1544,1254,290,60652,50733,9919,834,693,141,96.98257544
817548647efe736dd05a7675d33f12f415ecf46f,31,3376,318,3058,22,0,22,3,4,61,2,20,4.595791259,1181,44,0,527,261,266,20444,9081,11363,315,144,171,96.8487395
71d644ed11757b5895d2c4bc143af6c011613703,1,3,2,1,0,0,0,1,2,0,1,1,0,71,45,1,9,9,0,431,406,25,7,7,0,100
443e7ced3cc5a05bd4f62e4aa514da481bfb5406,0,0,0,0,0,0,0,0,0,0,0,0,0,0,32,1,0,0,0,0,0,0,0,0,0,100
3acb216539f8d757e52eae021838d9e56e379cc4,6,163,70,93,0,0,0,1,2,0,1,5,1.292775755,701,46,2,97,84,13,5056,4576,480,67,63,4,100
f5c6d00936cc05a34075928bb7027196523c5ae4,5,151,65,86,0,0,0,1,3,0,2,4,2.012082221,525,47,3,47,43,4,3843,3569,274,42,39,3,99.95854063
58294b6659856b4e5d1feecc2b670251a15bc09e,47,1022,233,789,7,0,7,2,12,151,2,25,4.694064628,3895,46,3,628,534,94,34798,30139,4659,325,276,49,97.74682507
5adff74490b6750fa0c3b5fcbf61b4414eae2acb,4,430,343,87,0,0,0,1,4,3,1,2,0.735187683,2711,47,4,697,682,15,19299,18855,444,478,468,10,100
fa946169cf0987ebddfd7e309f2bb471a6d9f18b,6,500,50,450,2,0,2,3,4,1,2,6,1.699768081,857,48,4,214,165,49,8902,6664,2238,115,81,34,99.75757576
86ce763e55e17f50a6ea8a92661a9b0acc178fe3,5,422,78,344,1,0,1,1,4,0,2,4,1.96002984,575,49,5,120,56,64,5742,4437,1305,78,51,27,99.55698752
84b7c162b681e0b90384e85e5e2a5d182327ea31,0,0,0,0,0,0,0,0,0,0,0,0,0,0,2,0,0,0,0,0,0,0,0,0,0,100
3a14080c3ea3c7f93b919521a3d7898f1a2e399f,18,106,42,64,0,0,0,1,13,0,2,11,2.550636949,2697,48,3,409,398,11,20994,20706,288,195,188,7,99.87937274
10f55358aeb3d3158eab68c396d0233befc3e476,0,0,0,0,0,0,0,0,0,0,0,0,0,0,49,4,0,0,0,0,0,0,0,0,0,100
b7e16d2f9a6deeef2356dfa4ba70f17ce4a8714b,3,305,26,279,1,0,1,1,6,11,1,3,1.048862341,211,50,6,54,32,22,2769,1717,1052,31,15,16,99.87951807
839bd20931d62219f4e375199601899ab3f71001,3,229,165,64,0,0,0,2,8,24,1,3,1.024479618,317,51,7,43,41,2,2322,2234,88,16,14,2,98.83814103
5ac442431d567a1d4c45a22f3103f0e0d01d951d,0,0,0,0,0,0,0,0,0,0,0,0,0,0,33,1,0,0,0,0,0,0,0,0,0,100
8e8f9e05c13395185ff45bc84465b0d964ec95da,0,0,0,0,0,0,0,0,0,0,0,0,0,0,4,0,0,0,0,0,0,0,0,0,0,100
fc2dc3d6b9b958b85dee4dc06ac5f274a7c86af7,32,893,153,740,4,0,4,2,14,49,2,11,3.921179576,3364,50,2,611,553,58,27937,25250,2687,277,250,27,99.24662966
47bc9b6defa3707b07ec1fa0123bbb72843a4b33,0,0,0,0,0,0,0,0,0,0,0,0,0,0,9,0,0,0,0,0,0,0,0,0,0,100
8b623b87f5754edfa0f1ef27b9b740af7b4f6f2e,11,460,92,368,1,0,1,2,7,25,2,8,2.602989999,1086,52,4,204,182,22,8312,6669,1643,121,107,14,99.76433621
e3ce452a067fda4941645b152106974d311907a3,2,143,132,11,0,0,0,3,10,0,1,2,0.086761335,472,53,5,105,101,4,3740,3564,176,45,42,3,100
7445e328dfc34736bf81e5ba1d6580dabbd4376a,9,119,25,94,0,0,0,2,6,246,1,7,2.73784234,1736,51,3,203,191,12,14627,14100,527,102,95,7,100
6a9dd29a63e5337a0536315437ca7d89145bdfe4,5,90,88,2,0,0,0,3,7,35,2,4,0.973684279,775,54,4,130,131,1,5896,5907,11,83,85,2,100
e6bd70c29e2c0c211c9eb50d39a2c74a8db95b22,0,0,0,0,0,0,0,0,0,0,0,0,0,0,34,1,0,0,0,0,0,0,0,0,0,100
7eceac2aa9e1387f544f6059baaa2d0e9f440acb,2,135,25,110,0,0,0,3,5,262,1,2,0.69621226,240,10,1,38,32,6,3862,3044,818,17,13,4,100
2e5538c4e7abd21aa73ecea4ef88c596e51896e0,0,0,0,0,0,0,0,0,0,0,0,0,0,0,3,0,0,0,0,0,0,0,0,0,0,100
3dfd7be6f9b5325bdce01ed21f15d2ed13384ea3,22,1944,412,1532,12,0,12,3,7,6,2,13,3.858116078,1664,55,5,354,270,84,18395,12104,6291,218,157,61,98.56921887
4212927b0c6a2f86e51b0289e68fd2ed2438c636,2,172,21,151,0,0,0,1,5,28,1,2,0.921711401,303,56,6,62,46,16,2401,1863,538,39,24,15,100
e0ef22ceb65bba06fe730e6d632312daa88954d4,2,17,1,16,0,0,0,1,7,40,1,2,0.503258335,703,52,2,61,60,1,5781,5688,93,55,54,1,100
15d04abecee1fe4e8155ec644a0913d8c0850df4,2,164,101,63,0,0,0,2,2,416,1,2,0.064053477,151,53,3,25,22,3,1265,1214,51,8,6,2,100
eaf625a7975c56ac20d268c2c77e89d3daa7e471,0,0,0,0,0,0,0,0,0,0,0,0,0,0,35,2,0,0,0,0,0,0,0,0,0,100
ef3e9fa5ea506f3ba624ca2102ea9028782dd974,15,824,138,686,3,0,3,2,8,6,2,8,3.028154096,1022,57,6,192,162,30,9430,6727,2703,120,97,23,99.43117179
6fb85e124d87581c37b79ea105570f4f85b59384,14,623,18,605,5,0,5,3,15,18,1,12,2.48519354,1667,54,4,381,309,72,16365,12815,3550,168,137,31,91.39328445
5e86bc3dd661be137e88bc62cfa5b8952bf3d3ac,11,1153,253,900,6,0,6,2,6,16,1,6,3.150446605,1023,55,5,289,185,104,11834,6840,4994,149,102,47,99.0990991
baf0d24a45e865ec3aafc128d657e0a7b69260af,13,178,504,326,0,0,0,1,9,0,1,8,2.392063937,1690,58,6,144,164,20,10444,12084,1640,106,118,12,100
728133b9115a0d9774a97fdc43063d8aef9df300,13,594,237,357,2,0,2,1,8,13,2,9,2.707863833,1588,56,6,233,177,56,14160,11687,2473,154,127,27,99.49416342
1fbbf7648651efd8c8f3c944ee86b9aed4e0e279,6,284,93,191,0,0,0,2,5,48,2,6,1.450743475,604,59,7,86,74,12,4443,3821,622,56,47,9,100
c64e8ad039018982d2903de88d423f37f25971d2,0,0,0,0,0,0,0,0,0,0,0,0,0,0,8,0,0,0,0,0,0,0,0,0,0,100
3a2ecc404bdd8e6047dbe7199dee45192aa94428,14,492,38,454,5,0,5,2,6,5,2,9,2.97470242,834,60,8,127,92,35,6539,5254,1285,96,64,32,98.61591696
32d5ff64af0405ac99a718896ac15511046c2575,7,154,54,100,0,0,0,1,4,1,1,5,2.000416057,679,61,9,59,55,4,5433,4872,561,46,42,4,100
095313255620355132b885fae24cf4669db4392d,6,145,70,75,0,0,0,1,10,4,2,5,2.383440553,644,62,10,101,89,12,4678,4321,357,60,55,5,99.80988593
e0c9970b1f467135f01ee212fb2a8d7f2d61de8b,10,382,136,246,1,0,1,2,6,66,1,8,2.840078518,1732,11,2,206,173,33,15289,13872,1417,97,84,13,99.54510993
5f725445044ad8b37bab5f928bb96658e0e430b0,0,0,0,0,0,0,0,0,0,0,0,0,0,0,0,0,0,0,0,0,0,0,0,0,0,100
eb6739399b308c9c8290ee9cedfce49e9654c9f6,0,0,0,0,0,0,0,0,0,0,0,0,0,0,63,11,0,0,0,0,0,0,0,0,0,100
5843421f5205d007569b274363adc3ee03dc8efe,2,26,0,26,0,0,0,1,5,304,1,2,0.961236605,422,57,7,48,45,3,3541,3311,230,24,22,2,100
319e61e7a4d6d6872a2889168dc9f8fdda28321d,1,52,0,52,1,0,1,1,1,0,1,1,0,0,58,8,3,0,3,288,0,288,1,0,1,98.46266471
001b5cc5bc9ecece648730d99285de056319a07c,0,0,0,0,0,0,0,0,0,0,0,0,0,0,0,0,0,0,0,0,0,0,0,0,0,100
4a4cb8b117dbb66bbfb4915bca9d871a06682c28,2,401,0,401,2,0,2,1,1,0,1,1,0.95736999,0,64,10,34,0,34,1561,0,1561,21,0,21,99.8225692
e7fed2d587f7878af52b6e17f091f07193ad51c7,5,147,114,33,0,0,0,1,9,32,1,3,1.085738771,3360,59,8,711,708,3,23239,23037,202,448,446,2,100
ef94c652c9b22b78bb37e6057cc42a46aad668b4,2,280,65,215,0,0,0,2,2,2,1,1,0.903116172,243,60,8,64,34,30,3358,1561,1797,29,21,8,99.82294618
ed34d9e69c9fc4b8f892dc5e04ead625d57e4ace,0,0,0,0,0,0,0,0,0,0,0,0,0,0,1,0,0,0,0,0,0,0,0,0,0,100
c10a53eb89f7ec90aff6e8da5121f62f2f0e7eed,2,1,23,22,0,0,0,1,3,91,2,2,0.650022422,131,65,10,16,21,5,808,887,79,11,13,2,100
6834e146de163b5f6a441410a72fefb8db96944e,3,278,0,278,3,0,3,1,1,0,1,3,1.429653872,0,61,9,17,0,17,1443,0,1443,13,0,13,99.75273755
6f1025f7729540f943e8df8d99f282ca98b96f57,0,0,0,0,0,0,0,0,0,0,0,0,0,0,0,0,0,0,0,0,0,0,0,0,0,100
125dbef1e59ff808a62e4f5a7d265aafbcf6bf08,7,17,5,12,0,0,0,2,11,98,1,6,2.313100666,694,4,0,122,122,0,5286,5182,104,49,49,0,100
c370bee5cd5a483f20ad9780639888b4fdb41418,0,0,0,0,0,0,0,0,0,0,0,0,0,0,62,9,0,0,0,0,0,0,0,0,0,100
0c4aa7b42ac4827c30665583fe9189fd00537bd7,0,0,0,0,0,0,0,0,0,0,0,0,0,0,63,9,0,0,0,0,0,0,0,0,0,100
b022bda86d1fae722d849e39d249aea1ff1866ad,0,0,0,0,0,0,0,0,0,0,0,0,0,0,1,1,0,0,0,0,0,0,0,0,0,100
c85c74269327487a5fe607ea85ebc56d3b5650ef,19,2709,41,2668,11,0,11,1,6,35,1,9,3.576684587,1087,64,10,504,196,308,23303,8380,14923,250,108,142,97.40987049
a825142e7eeffb155aac6d830cd2fe14638c2827,0,0,0,0,0,0,0,0,0,0,0,0,0,0,2,2,0,0,0,0,0,0,0,0,0,100
3d5f279caea2b9349a05b3a7316ef19e2ca8cb11,7,500,12,488,1,0,1,1,4,5,1,4,1.17782161,1053,65,11,195,165,30,8725,7639,1086,94,77,17,99.16955017
d0d6c2c359f5e4afaaeabbd9e32331c688405c2f,2,41,10,31,0,0,0,2,2,10,1,2,0.977417818,152,0,0,19,15,4,1570,1353,217,13,11,2,100
5378f0cffb818d4d96a7032de6f038ec83edf2ee,1,3,3,0,0,0,0,4,9,308,1,1,0,185,12,1,37,37,0,1346,1346,0,8,8,0,100
0c496c20769fc0c9ac8ef209b1f2e08baee38c80,0,0,0,0,0,0,0,0,0,0,0,0,0,0,4,4,0,0,0,0,0,0,0,0,0,100
2f6c8bc708b5eff52ba5fcf51b9608faadda1608,2,587,0,587,2,0,2,1,1,0,1,2,0.870409704,0,66,10,58,0,58,3313,0,3313,35,0,35,99.82811963
1c6de7fe50260b3648d758093c08a4701abb95f4,2,258,0,258,2,0,2,1,1,0,1,2,0.933025295,0,67,11,27,0,27,1343,0,1343,12,0,12,98.60188745
23979472c904ccb399478bf1f240fc027245480c,0,0,0,0,0,0,0,0,0,0,0,0,0,0,5,5,0,0,0,0,0,0,0,0,0,100
dcda538252728d87f36bf140145f04d14a763cd3,0,0,0,0,0,0,0,0,0,0,0,0,0,0,36,0,0,0,0,0,0,0,0,0,0,100
85e13e599b2ad304359477c90ea8e7abb6f314e5,0,0,0,0,0,0,0,0,0,0,0,0,0,0,6,6,0,0,0,0,0,0,0,0,0,100
823cd2a83063bf232d25d3f58c08ab1fa8e06319,0,0,0,0,0,0,0,0,0,0,0,0,0,0,13,2,0,0,0,0,0,0,0,0,0,100
3e278cdc2c60d6d193d53157512c68b2a3ed58de,0,0,0,0,0,0,0,0,0,0,0,0,0,0,37,1,0,0,0,0,0,0,0,0,0,100
b2d0a4dbcce81cb7294cf5384c9f818b857429cd,0,0,0,0,0,0,0,0,0,0,0,0,0,0,0,0,0,0,0,0,0,0,0,0,0,100
f9b55f56ca8f3e6bcb9fba17067252cd039336d9,0,0,0,0,0,0,0,0,0,0,0,0,0,0,14,3,0,0,0,0,0,0,0,0,0,100
587e5790460b1b05eb7d9263fb49aecf3f59f480,0,0,0,0,0,0,0,0,0,0,0,0,0,0,7,7,0,0,0,0,0,0,0,0,0,100
2f579a95b426b60153f5ff999f32a22f74d61e45,0,0,0,0,0,0,0,0,0,0,0,0,0,0,0,0,0,0,0,0,0,0,0,0,0,100
a35e387745d3303e03efb9b63b9e31ae97ade812,0,0,0,0,0,0,0,0,0,0,0,0,0,0,8,8,0,0,0,0,0,0,0,0,0,100
d62738a271e9e4da30c91973502b9f3850ac914d,1,0,0,0,0,0,0,1,1,0,1,1,0,12,0,0,2,2,0,61,61,0,1,1,0,99.85754986
d03b239cb3372a4326b920d932eca5e12cd016d7,1,33,0,33,0,0,0,2,3,139,1,1,0,85,1,1,4,3,1,938,798,140,4,3,1,100
cb372d61114f9b74415fae2ddba5a4c6f3b53c2f,0,0,0,0,0,0,0,0,0,0,0,0,0,0,2,2,0,0,0,0,0,0,0,0,0,100
7a0d9c7c4536cb9f5e455ff4cec662fe8fcd31a8,1,13,103,90,0,0,0,3,3,75,1,1,0,55,9,0,4,3,1,606,500,106,4,3,1,100
f7554f921b614ae9121e41b626f32f2562d42f15,0,0,0,0,0,0,0,0,0,0,0,0,0,0,38,2,0,0,0,0,0,0,0,0,0,100
a2a5a3d8a66d77be07fe435ed597417c4950fe69,0,0,0,0,0,0,0,0,0,0,0,0,0,0,39,3,0,0,0,0,0,0,0,0,0,100
56686c058541bb13732641b99aef8fccff8490a0,0,0,0,0,0,0,0,0,0,0,0,0,0,0,9,4,0,0,0,0,0,0,0,0,0,100
62332345be7bc5859be53aacad2ded1c4299ddb8,0,0,0,0,0,0,0,0,0,0,0,0,0,0,40,4,0,0,0,0,0,0,0,0,0,100
2aec26b7ab65a9d121354fcd252908c9d712b8e0,0,0,0,0,0,0,0,0,0,0,0,0,0,0,5,0,0,0,0,0,0,0,0,0,0,100
0e9316904b51b9e64ef1d128fe9cc788f6762295,0,0,0,0,0,0,0,0,0,0,0,0,0,0,0,0,0,0,0,0,0,0,0,0,0,100
070473f5fc6ce723ccdb037e6dc6d172c579a0f7,14,28,23,5,0,0,0,2,6,12,2,9,1.756032344,1283,66,0,149,161,12,8247,10169,1922,98,139,41,98.42632332
9ac36dec91a215d53b855225f0c813b24ce85b9d,4,80,24,56,0,0,0,2,7,298,1,4,1.553348555,792,15,2,64,62,2,6639,6190,449,29,29,0,100
b38e017f8978b8d8b2fa58d76ba4c8bb54026951,4,8,8,0,0,0,0,2,12,119,1,1,2,390,68,2,77,77,0,2814,2814,0,29,29,0,100
6277d28c852e5ef7eeeb42d7cc3db4d69ebe59b6,2,58,2,56,0,0,0,2,10,67,1,2,0.979868757,683,1,0,83,72,11,6016,5651,365,57,51,6,100
f1065a62f1016b84e0faed364eece504edb473ef,2,65,3,62,1,0,1,1,6,0,1,2,0.430551867,159,16,3,31,28,3,1199,891,308,8,6,2,99.8564765
acd3aa8dd7408934c2b810ac380ef2dc1adfc038,19,494,74,420,2,0,2,2,9,202,1,14,3.120146128,1890,5,0,303,262,41,18225,15769,2456,153,132,21,98.52838122
6f5c84ee2f7e2d70dd27c7e60c84866aeb3e2bd0,1,4,3,1,0,0,0,5,10,42,1,1,0,185,6,1,36,37,1,1365,1346,19,8,8,0,100
609ea40c2e8ab3b35b645f4238d2f66afc120fb5,2,35,12,23,0,0,0,1,5,350,1,2,0.550984443,151,69,3,18,14,4,1305,1128,177,11,10,1,100
10bc425f31cfcd8db1d1007bb0a0916800443c23,0,0,0,0,0,0,0,0,0,0,0,0,0,0,11,6,0,0,0,0,0,0,0,0,0,100
3a4023382b24d3fc3b874820c9bd81317ee00656,0,0,0,0,0,0,0,0,0,0,0,0,0,0,67,1,0,0,0,0,0,0,0,0,0,100
65fa059e4bc927bf3ba94bec5babd911bd759e19,0,0,0,0,0,0,0,0,0,0,0,0,0,0,12,5,0,0,0,0,0,0,0,0,0,100
7972a9093530ed85dad4c5e236ec023ec6f05bcd,2,53,12,41,1,0,1,1,4,56,1,2,0.937456171,207,70,2,31,29,2,1347,1113,234,12,10,2,99.82882574
23ff817ebdd3b63be69ad9b6c493b41bb0be4880,3,111,7,104,0,0,0,3,16,151,1,3,0.682584279,515,71,3,48,41,7,4799,4300,499,23,18,5,99.96580027
812fe75c30a826c460b59e9fc056c69d0d91b876,2,49,11,38,0,0,0,2,5,160,1,2,0.999198354,141,2,1,28,24,4,1145,1001,144,15,13,2,100
297173ce386e1369bd00706377fc1c37e46d5e10,0,0,0,0,0,0,0,0,0,0,0,0,0,0,14,7,0,0,0,0,0,0,0,0,0,100
4bfb09c49fbc6204ce8b826887d99beff414f84a,0,0,0,0,0,0,0,0,0,0,0,0,0,0,68,2,0,0,0,0,0,0,0,0,0,100
4de80b35efe220142c3d5f4ad8793690ac77f6d6,2,6,1,5,0,0,0,2,3,380,1,2,0.863120569,117,10,1,25,24,1,1357,1306,51,13,12,1,100
d6d3d45725d7371e560beea42a2788237aab2052,11,251,76,175,1,0,1,2,8,248,1,8,2.627830272,1740,3,0,209,178,31,15597,14198,1399,81,69,12,97.66403298
21ec01417a3359372958a1c645c23ddbfdb197e3,0,0,0,0,0,0,0,0,0,0,0,0,0,0,15,6,0,0,0,0,0,0,0,0,0,100
61351aabd979e014c48dfc7e0e4f290bd093cdfe,4,195,1,194,3,0,3,1,3,45,1,4,1.557671988,17,17,0,17,3,14,905,93,812,15,3,12,99.75903614
b9bb5ef78408713d5561aa0afbc9e9e5afdfaeda,1,1,0,1,0,0,0,3,6,108,1,1,0,193,18,1,30,30,0,1405,1405,0,6,6,0,100
66e60f1a5e400f76225fbc652ec2d82ce179a1a7,0,0,0,0,0,0,0,0,0,0,0,0,0,0,1,0,0,0,0,0,0,0,0,0,0,100
cc0afd62879740445d81ac3cf2da6b7b46afecff,0,0,0,0,0,0,0,0,0,0,0,0,0,0,16,4,0,0,0,0,0,0,0,0,0,100
43603592428cbbcf2a7c3f7cf3ccd35be0d96ba1,0,0,0,0,0,0,0,0,0,0,0,0,0,0,41,0,0,0,0,0,0,0,0,0,0,100
82eb7713d54d38b6cfcbabccd34485de24efe9f5,0,0,0,0,0,0,0,0,0,0,0,0,0,0,17,5,0,0,0,0,0,0,0,0,0,100
8c4b0f1db94d02f390aae571bdc8085dc81ddbe1,0,0,0,0,0,0,0,0,0,0,0,0,0,0,42,1,0,0,0,0,0,0,0,0,0,100
b80f7e0bcc8af59c663b8b260fab6f802ee725ca,0,0,0,0,0,0,0,0,0,0,0,0,0,0,18,5,0,0,0,0,0,0,0,0,0,100
c5d55efd6d20599d246abecd1b96164d983badca,0,0,0,0,0,0,0,0,0,0,0,0,0,0,43,2,0,0,0,0,0,0,0,0,0,100
a07c824c1edc679a4828c905609b69ce60cd46bd,0,0,0,0,0,0,0,0,0,0,0,0,0,0,19,6,0,0,0,0,0,0,0,0,0,100
57798e225db1641db8f326fbcd540a14e8374c70,0,0,0,0,0,0,0,0,0,0,0,0,0,0,4,1,0,0,0,0,0,0,0,0,0,100
6f0d58ce55fc765fb01f033bac826001e8b1bedc,2,7,7,0,0,0,0,2,7,50,1,2,0.985228136,198,18,0,31,31,0,1198,1199,1,8,8,0,100
115ae56d894226b606a3b3353c02a991a0454a33,0,0,0,0,0,0,0,0,0,0,0,0,0,0,20,7,0,0,0,0,0,0,0,0,0,100
e43a72f2f6d69ad2a474b6bb5969ba38bdaa5bae,0,0,0,0,0,0,0,0,0,0,0,0,0,0,5,2,0,0,0,0,0,0,0,0,0,100
e31705029fd7518bd03c22eece0c2a8eb1187abf,91,313,239,74,0,0,0,2,17,190,2,49,5.909854142,10221,7,0,1374,1376,2,78874,77947,927,697,705,8,98.30388693
dcf10d9f61d9358e6a8ac6bb64c7b681953056c3,0,0,0,0,0,0,0,0,0,0,0,0,0,0,69,1,0,0,0,0,0,0,0,0,0,100
118970bd34f4089776ace67c10edc6d86c55967b,14,98,99,1,0,0,0,1,8,133,1,4,2.875333496,1891,72,0,282,282,0,11933,11935,2,99,99,0,100
d36129d471e276c94f332ee315e2e93b6137e5a1,3,100,10,90,0,0,0,2,6,95,1,3,1.337633002,338,73,1,44,37,7,2664,2332,332,17,15,2,100
b117932954e08fc99d2b5db7894234f5ffdd0cc0,0,0,0,0,0,0,0,0,0,0,0,0,0,0,6,3,0,0,0,0,0,0,0,0,0,100
45f0d5b637480433796aaa5be4be7d42ba57a5da,0,0,0,0,0,0,0,0,0,0,0,0,0,0,7,4,0,0,0,0,0,0,0,0,0,100
857520c42f50defb0a9f9e4e743411207e2f6252,0,0,0,0,0,0,0,0,0,0,0,0,0,0,44,3,0,0,0,0,0,0,0,0,0,100
2dcac3c2494c055488577f94afa12f47c103a5e4,1,6,0,6,0,0,0,2,2,57,1,1,0,21,8,5,3,2,1,254,214,40,3,2,1,100
5418a6a7fbdf32f1fff8fa042498524e89091ee9,7,646,0,646,6,0,6,1,8,45,1,7,2.308740544,45,1,0,81,4,77,4048,268,3780,32,4,28,99.49312093
42c55de1767d7297ad587f3f26b37bd677550594,0,0,0,0,0,0,0,0,0,0,0,0,0,0,8,1,0,0,0,0,0,0,0,0,0,100
1cf6cc9432e9e2ddace02360db26064225064472,2,119,10,109,1,0,1,1,2,286,1,2,0.583019417,14,9,2,6,1,5,909,182,727,6,1,5,99.85606333
05d29e7cb5b1958e79cbfa6d576ab48b40aa508f,4,94,22,72,0,0,0,1,5,105,1,3,1.453065426,478,70,2,43,42,1,3932,3438,494,33,32,1,99.46351931
aed9b6a57bd0bdf306eae0431dabf76641a0ef46,0,0,0,0,0,0,0,0,0,0,0,0,0,0,19,1,0,0,0,0,0,0,0,0,0,100
b39477e0e7a0e1b10374e6fa6b6d7a107021c102,0,0,0,0,0,0,0,0,0,0,0,0,0,0,45,4,0,0,0,0,0,0,0,0,0,100
b390c6d16a43a5907a742ab3690cf29bb76ea80d,0,0,0,0,0,0,0,0,0,0,0,0,0,0,46,5,0,0,0,0,0,0,0,0,0,100
e1401d01ecc87e652931aaada4bc7500df984da2,0,0,0,0,0,0,0,0,0,0,0,0,0,0,2,0,0,0,0,0,0,0,0,0,0,100
7eee44eada5683bf24b94133676d5684171a7322,2,126,31,95,0,0,0,2,6,80,1,2,0.955018809,173,19,2,27,18,9,1980,1305,675,17,11,6,100
f6c595253eee72f60f52c0762f4ffc60eb5a872b,0,0,0,0,0,0,0,0,0,0,0,0,0,0,74,2,0,0,0,0,0,0,0,0,0,100
8e51c9ceda921bd905afa2bb88c95da9b5abaada,2,5,5,0,0,0,0,1,4,369,1,2,0.721928095,79,75,3,9,9,0,616,616,0,8,8,0,100
ddf665843d1fa3b15af7aea53184eaa498d1f5dd,0,0,0,0,0,0,0,0,0,0,0,0,0,0,47,6,0,0,0,0,0,0,0,0,0,100
8321067d43525350e3ebd6be72fa897aca95842e,2,12,4,8,0,0,0,3,3,509,1,2,0.69621226,436,10,3,54,54,0,3682,3660,22,19,19,0,100
d97c1bb8148dc58dcdddd4519b62cedb1847b45c,2,22,11,11,0,0,0,3,11,134,1,2,0.884963636,603,20,3,61,59,2,5343,5288,55,54,53,1,100
226c57cd04c4152a6c934cad14ecbce4a5c794a6,1,10,12,2,0,0,0,1,3,14,1,1,0,106,71,2,13,13,0,709,709,0,11,11,0,100
9c1369c74a1b63da9bdef3eadf1931ed1c0d12f8,23,149,30,119,0,0,0,2,12,183,2,19,4.180869203,3568,20,2,342,336,6,33572,32162,1410,190,187,3,97.35636235
d85494cec5c5d6ac68086e58bb5276ec1a974f0a,0,0,0,0,0,0,0,0,0,0,0,0,0,0,9,5,0,0,0,0,0,0,0,0,0,100
2e2bea430dfbd6a1455c1893713ea72447d5476a,0,0,0,0,0,0,0,0,0,0,0,0,0,0,11,4,0,0,0,0,0,0,0,0,0,100
6e53fd2b1afe1553c6bc2a6d80d5233e1573da42,0,0,0,0,0,0,0,0,0,0,0,0,0,0,12,5,0,0,0,0,0,0,0,0,0,100
66df134cebe26400b0b9e3935a2c2745fdf4186c,0,0,0,0,0,0,0,0,0,0,0,0,0,0,76,4,0,0,0,0,0,0,0,0,0,100
d7784d437121088425555e1100936dc6b13498f3,0,0,0,0,0,0,0,0,0,0,0,0,0,0,13,6,0,0,0,0,0,0,0,0,0,100
7aea4ba35d1a931d72898bffd9725be3075fe8ca,0,0,0,0,0,0,0,0,0,0,0,0,0,0,3,1,0,0,0,0,0,0,0,0,0,100
c7bf73b462d2b807ed5b389ad591ef13baa0c408,1,8,6,2,0,0,0,2,3,150,1,1,0,240,10,2,38,38,0,1640,1607,33,15,15,0,100
daa9a5ea7ed5476cae51622d1e8c43603ab11f02,3,229,102,127,2,0,2,1,5,6,2,2,1.469843259,455,11,2,81,68,13,3582,3084,498,22,13,9,99.23398329
d03a363f8b9aaca962bf4b3052e37909889563be,9,206,202,4,0,0,0,2,12,52,1,6,2.420745436,1002,72,2,112,113,1,7027,7033,6,77,78,1,100
dbb56cb5e85425e75970cffb62593e5ef7f90578,3,638,1,637,2,0,2,1,5,119,1,3,0.897095499,20,73,3,40,1,39,2452,146,2306,27,1,26,99.75736568
b1c89df6f0503e82d5a9c4b7ac9c9e82ea810491,12,522,35,487,4,0,4,2,13,17,2,6,2.519306746,1485,77,1,315,322,7,13123,16340,3217,165,219,54,95.89273591
f7906e181ff41d9198c7aeca2f5426a6c0ec84c0,9,58,8,50,0,0,0,3,8,303,1,9,2.776211085,717,12,3,98,94,4,5900,5484,416,57,53,4,100
f4e1065b6d270f67009fadf78f709a422cbd3b9d,21,219,160,59,0,0,0,3,10,99,2,18,3.843276993,3554,13,4,466,456,10,28560,27944,616,222,215,7,99.40318302
5b3667f899cbaaa8b758db177d31ec02dffef0d5,4,383,137,246,1,0,1,3,14,4,1,3,1.590695466,580,74,2,86,58,28,5425,4315,1110,56,42,14,99.63708347
4a915ca0ef98bb9003f47b0a363633d92933becb,2,22,0,22,0,0,0,4,12,53,1,2,0.994030211,623,14,5,62,61,1,5547,5404,143,57,56,1,100
8ec1b5d799d497d5df51ec353b80e24530a7f0a1,0,0,0,0,0,0,0,0,0,0,0,0,0,0,14,3,0,0,0,0,0,0,0,0,0,100
054a4eaeea1d402d76ab4eb0836951654b784696,4,86,26,60,1,0,1,3,11,32,1,4,1.660120954,652,15,4,89,87,2,5542,5357,185,38,33,5,99.86820428
5e3951671c1e5978b8fe957e5cb55ab88b107588,0,0,0,0,0,0,0,0,0,0,0,0,0,0,75,3,0,0,0,0,0,0,0,0,0,100
057b6ccf61b2bd925fa1b49decb755fdc0e94a76,31,997,381,616,6,0,6,2,18,110,2,17,3.741019309,3292,76,4,523,485,38,27975,25862,2113,310,280,30,93.38959212
2bca7d88285ff52abfcd95ebf1d208006420e97e,0,0,0,0,0,0,0,0,0,0,0,0,0,0,48,0,0,0,0,0,0,0,0,0,0,100
59f8f03acbf66d5ac63f9156546833b0c98f57f2,0,0,0,0,0,0,0,0,0,0,0,0,0,0,21,0,0,0,0,0,0,0,0,0,0,100
181327402871317aa1a638851a2c1cfdfc385bca,0,0,0,0,0,0,0,0,0,0,0,0,0,0,2,0,0,0,0,0,0,0,0,0,0,100
2bb14b8da119ae0c30427e6513717c6a75789ca2,0,0,0,0,0,0,0,0,0,0,0,0,0,0,0,0,0,0,0,0,0,0,0,0,0,100
319c39e5a0017aa71cad9f55990a64225911e0b3,6,34,30,4,0,0,0,4,7,338,1,5,1.625647267,1927,16,2,342,342,0,12454,12543,89,166,166,0,100
2fd7f95c240769a0c0002819aa1a180fd0592c99,1,23,4,19,0,0,0,5,9,96,1,1,0,160,0,0,36,29,7,1516,1287,229,8,8,0,100
354cb6ddce7f5313fb140fd3ab8521f9dce0c35f,2,77,42,35,0,0,0,4,12,23,2,2,0.972882927,696,77,3,144,143,1,5892,5633,259,67,66,1,100
1734f5fcf872f9a45442c77bdd84a93dbc309177,0,0,0,0,0,0,0,0,0,0,0,0,0,0,78,0,0,0,0,0,0,0,0,0,0,100
670f50ae3b949502e660d9e15a10a1da6a0c6fd4,20,1206,714,492,5,0,5,2,16,56,1,9,3.090041404,1700,78,4,187,187,0,13639,12063,1576,143,133,10,98.6235119
e46539a9802930e99eafbba7c74680e0fb48eaa3,1,13,25,12,0,0,0,4,7,36,1,1,0,409,22,1,46,46,0,3592,3667,75,18,18,0,100
35ceddc041bed09fb4abe6d1b81e0376073a65b0,0,0,0,0,0,0,0,0,0,0,0,0,0,0,17,3,0,0,0,0,0,0,0,0,0,100
f304d3da165d06432e003fef6ac8e489f85a9edc,0,0,0,0,0,0,0,0,0,0,0,0,0,0,18,4,0,0,0,0,0,0,0,0,0,100
cf15a3d2344cba01b9682dbd6b51ba8efb4459bd,1,1,1,0,0,0,0,1,2,44,1,1,0,259,79,1,54,54,0,2167,2168,1,23,23,0,100
e15f4ba09ff34476f9ce07f11ab6360a28e99023,80,190,112,78,0,0,0,2,14,326,2,60,5.853634427,9039,19,3,1222,1229,7,72274,72205,69,674,674,0,100
ba2722e7a7097fc92db5e741d11423eae8543f0e,19,372,151,221,2,0,2,3,15,167,1,8,3.064928734,2344,15,0,254,236,18,20357,19291,1066,190,186,4,98.09630459
a96c4ed2ef4de70b6012d2992d43123d5d4831f1,0,0,0,0,0,0,0,0,0,0,0,0,0,0,79,4,0,0,0,0,0,0,0,0,0,100
b36f4b2fbf8cc4578ef3f39ac4d8306544f6bcb4,9,779,118,661,4,0,4,1,16,9,2,7,2.242162117,1161,0,0,223,158,65,14639,9470,5169,141,104,37,97.88182832
506610cb99c74bb1161a0dad1f407a1489fd8801,16,39,52,13,0,0,0,2,11,146,1,14,3.388580668,2776,20,4,357,359,2,20284,20275,9,170,171,1,99.74452555
64a49adad0df51c9b87422be8edd9cf1fff90dac,0,0,0,0,0,0,0,0,0,0,0,0,0,0,23,2,0,0,0,0,0,0,0,0,0,100
ffae676cb10caf14b8e3e5ca9c87ea1d5d08f4d1,23,1362,262,1100,13,0,13,1,17,48,1,5,3.962686874,3962,1,1,947,868,79,35236,29353,5883,630,568,62,92.21282593
ec41e732170ebf80c00a8a9013a390f7ffa48899,6,265,101,164,2,0,2,4,9,23,1,5,2.275366951,680,16,1,86,70,16,6938,6093,845,43,27,16,92.32394366
befeb439e70aa45a051597e513f5ae9d9145864a,7,76,84,8,0,0,0,2,19,189,1,5,2.287966673,765,80,1,77,76,1,6474,6386,88,38,40,2,93.27929753
accfce8f9826d0d33613f750ad8cfb62adf2a4f5,0,0,0,0,0,0,0,0,0,0,0,0,0,0,4,0,0,0,0,0,0,0,0,0,0,100
f3376755c9df896ed5b0082faad4712d1e99b1ee,4,335,107,228,1,0,1,2,7,89,1,3,1.85712724,281,81,1,76,41,35,2841,1802,1039,44,19,25,98.32285115
a0cddc6d0d8c5437add1be757ff42c94d42fa09c,2,97,80,17,0,0,0,4,5,125,1,2,0.398986013,303,21,0,21,21,0,3119,2820,299,21,21,0,100
80ea2fa9b1018ac3a5fe4016b0915258d58e1ddf,0,0,0,0,0,0,0,0,0,0,0,0,0,0,80,0,0,0,0,0,0,0,0,0,0,100
64df1374b298c9c4a06bdf6c00f82a16845a987e,0,0,0,0,0,0,0,0,0,0,0,0,0,0,5,0,0,0,0,0,0,0,0,0,0,100
e7fcc755c915c7643be6fcf4867d4a1a7cbc8506,0,0,0,0,0,0,0,0,0,0,0,0,0,0,21,0,0,0,0,0,0,0,0,0,0,100
09cb50288f3044e30e6674fca03ef2d05483cff8,5,245,5,240,1,0,1,1,2,120,1,2,2.188063008,725,82,0,124,93,31,6190,4566,1624,65,54,11,93.90012642
763f2fc4220caac8e9b4b994e5a6987b43a21bd3,2,173,115,58,0,0,0,2,6,104,1,2,0.562746819,355,83,1,53,47,6,2896,2536,360,20,18,2,100
52aa580505ec8b2b0b43244345aa05e39c756650,0,0,0,0,0,0,0,0,0,0,0,0,0,0,3,0,0,0,0,0,0,0,0,0,0,100
56ff50c3d2da31992004ea066de356965f7adf4b,18,1951,369,1582,9,0,9,3,18,35,1,6,3.727927172,3882,2,0,879,767,112,37035,26883,10152,554,484,70,98.92098851
9ec2cdcdc4675737fec15f9e958b46f17268a227,2,329,32,297,0,0,0,3,8,102,1,2,0.999950183,341,0,0,46,25,21,3899,2669,1230,22,18,4,100
2db6e35b895ca60698b1f1150e0772ed71dc59c4,2,61,14,47,0,0,0,7,19,8,1,2,0.984426898,786,84,2,112,108,4,6657,6069,588,80,78,2,100
56e7f4113e55541c9eafa1fb91a75bec2403b375,0,0,0,0,0,0,0,0,0,0,0,0,0,0,81,1,0,0,0,0,0,0,0,0,0,100
368e7ad63641e3c505ee6e3d335ecabfa60b8003,26,606,266,340,5,0,5,2,9,216,1,18,3.90174434,2844,85,3,462,423,39,24953,22972,1981,230,208,22,96.360601
d1fcda6043fe608167cde616214e4059663fb131,0,0,0,0,0,0,0,0,0,0,0,0,0,0,82,1,0,0,0,0,0,0,0,0,0,100
acfadb3e852d76d8c4431126e9a74b2520cb5405,12,38,41,3,0,0,0,5,13,149,2,10,3.17914333,1793,1,1,383,383,0,13491,13491,0,165,165,0,100
cd3bb4f8ddf1155422785d324aedb51832551a67,0,0,0,0,0,0,0,0,0,0,0,0,0,0,3,0,0,0,0,0,0,0,0,0,0,100
5a5d42b8583fef320ddfd52131915195935b1b73,25,282,45,237,0,0,0,2,14,225,1,18,3.734326673,2519,86,2,393,346,47,22724,21316,1408,207,183,24,97.43677375
0219e56a9eb67adf10ece1c2201041f91008a43a,5,126,52,74,0,0,0,5,11,110,1,5,2.006708012,910,87,3,113,96,17,7456,7075,381,48,37,11,99.45394976
c74c7de27007d192e55c62f84e9b1b9089fd9cdf,6,59,85,26,0,0,0,3,17,153,2,6,1.75594924,821,88,4,126,126,0,5530,5733,203,75,77,2,100
fa6f3df51b881e84aa7a9525f24c627fa28ca62e,34,1198,250,948,6,0,6,4,20,202,1,26,3.843238543,3017,22,0,472,386,86,29986,24267,5719,244,193,51,98.83424408
9890018af0b6df3efba07927e72fc4aeb752cabb,0,0,0,0,0,0,0,0,0,0,0,0,0,0,23,1,0,0,0,0,0,0,0,0,0,100
f3ca3c05ef6d95a6f3bc5123e4dc07482c3e2752,9,1176,201,975,5,0,5,3,7,107,2,5,2.721805628,2424,24,0,685,590,95,20498,14684,5814,419,360,59,99.53186892
cc29dcab841d6b06c338da829d3f3a8541cdef5b,0,0,0,0,0,0,0,0,0,0,0,0,0,0,83,1,0,0,0,0,0,0,0,0,0,100
ad8724eed0af784fcd6a822a11842d86aefc8832,7,658,104,554,3,0,3,2,6,258,1,6,2.207422602,669,89,3,127,80,47,8259,5548,2711,54,29,25,99.57188726
75d122d1e4c3c7d7c4bd9e3fe3bdc67a133de463,10,293,106,187,1,0,1,1,16,188,1,8,2.673401603,1257,90,4,200,161,39,10284,9353,931,84,73,11,99.85815603
fd77ec329e96490e8401e300ac4104bf3f4a9901,2,56,0,56,0,0,0,3,7,68,1,2,0.954434003,409,84,2,58,53,5,3234,2896,338,24,20,4,100
8340c0e25d04f13c2ded2cb37159d9644d00ccff,6,1052,852,200,0,0,0,7,20,74,1,3,1.836171337,3420,3,0,813,796,17,24343,23230,1113,551,537,14,100
ddca4d82947aceef19ed7c2de7cd0e49475774c9,4,8,8,0,0,0,0,1,7,20,1,3,1.75,433,24,2,47,47,0,3147,3147,0,27,27,0,100
84a36a650571ffefa61380d928285cdd758d0af0,0,0,0,0,0,0,0,0,0,0,0,0,0,0,0,0,0,0,0,0,0,0,0,0,0,100
57c38af1c014a8c9158c51b6d5f9042536b59047,10,502,240,262,3,0,3,2,9,137,1,5,2.926031058,806,11,0,100,80,20,6882,5678,1204,66,48,18,98.93390192
a11e85c5582ebe4077ffb90378c8f81bb5fd6637,0,0,0,0,0,0,0,0,0,0,0,0,0,0,6,0,0,0,0,0,0,0,0,0,0,100
1be4fcb0243453863b6aefe0213fe9f0afed5718,25,1548,966,582,13,0,13,2,7,119,1,11,4.044642627,1430,91,5,206,153,53,14722,11942,2780,104,75,29,98.30268741
73cb6575cbfd44a40289583b891da138f7f78ce8,0,0,0,0,0,0,0,0,0,0,0,0,0,0,92,6,0,0,0,0,0,0,0,0,0,100
dd99533e0511495bdb27b2a23a0e07a13e35309f,0,0,0,0,0,0,0,0,0,0,0,0,0,0,2,1,0,0,0,0,0,0,0,0,0,100
2531b728b66aea1688fc3a34847c8878f80d717d,0,0,0,0,0,0,0,0,0,0,0,0,0,0,2,0,0,0,0,0,0,0,0,0,0,100
e4d54a2784a571ec84d5eb31f801f788b96bec7e,0,0,0,0,0,0,0,0,0,0,0,0,0,0,3,2,0,0,0,0,0,0,0,0,0,100
0ae9c4b4878787eef61cb379830d9a0bab6892dc,0,0,0,0,0,0,0,0,0,0,0,0,0,0,93,7,0,0,0,0,0,0,0,0,0,100
c5bbf5acef05de16a18db9397745a6795427f6b8,16,785,73,712,4,0,4,2,5,344,1,11,2.827874773,802,25,1,166,109,57,10576,6743,3833,100,65,35,99.61605585
1d632646e87720ea0695e85e6d4b72fdeeea95dc,0,0,0,0,0,0,0,0,0,0,0,0,0,0,94,5,0,0,0,0,0,0,0,0,0,100
9dcec28a0890a5f3996e33a7ec04492491148e2d,0,0,0,0,0,0,0,0,0,0,0,0,0,0,25,1,0,0,0,0,0,0,0,0,0,100
f6c253f44fe7ca5a6b31c46075f537940751c934,0,0,0,0,0,0,0,0,0,0,0,0,0,0,7,1,0,0,0,0,0,0,0,0,0,100
d7147e32d9f4f279bc779d4e1d39d691b43c3d35,0,0,0,0,0,0,0,0,0,0,0,0,0,0,17,0,0,0,0,0,0,0,0,0,0,100
29646550ce3b775668a4439b23677ad86a4dcf80,0,0,0,0,0,0,0,0,0,0,0,0,0,0,18,1,0,0,0,0,0,0,0,0,0,100
22ea8e3205c0f2bfe6c538dc2f10e90f92ff597c,1,21,0,21,0,0,0,7,21,42,1,1,0,558,19,2,47,44,3,4881,4777,104,43,42,1,100
80b8aee6a47047ea84f99037977ec7a4717d15aa,0,0,0,0,0,0,0,0,0,0,0,0,0,0,95,1,0,0,0,0,0,0,0,0,0,100
a6299fd75378cc8e29673c7f45d4b2c8e7b0437f,0,0,0,0,0,0,0,0,0,0,0,0,0,0,1,0,0,0,0,0,0,0,0,0,0,100
b7cd3ea82e27cde52ba81e87086f7ddaf612beaf,0,0,0,0,0,0,0,0,0,0,0,0,0,0,4,0,0,0,0,0,0,0,0,0,0,100
610146efb5f61cf7b7ea04982619a9efa14365ca,0,0,0,0,0,0,0,0,0,0,0,0,0,0,0,0,0,0,0,0,0,0,0,0,0,100
246acff0f41f9c569687b1715f7c7115283c1f2a,1,1,97,96,0,0,0,2,2,62,1,1,0,97,26,1,22,22,0,560,560,0,10,10,0,100
9e15cb6e24872620ec4bf3c183d15dd6292b153d,3,666,0,666,3,0,3,1,1,0,1,3,1.491091991,0,0,0,74,0,74,3653,0,3653,29,0,29,99.72289574
0e8abc48e5f6b29fb382371ad26bb165cf6e5f25,0,0,0,0,0,0,0,0,0,0,0,0,0,0,1,0,0,0,0,0,0,0,0,0,0,100
7abd7e8a231c6cbe9ee4ab23a5df1e97344f5212,0,0,0,0,0,0,0,0,0,0,0,0,0,0,27,2,0,0,0,0,0,0,0,0,0,100
84d347195a817e70fb792b4b240151b7654b1a9c,17,3906,7,3899,15,0,15,1,4,47,2,8,3.436670772,124,96,1,523,31,492,18821,717,18104,326,15,311,96.82854311
898d2360c6344eb88698f17974e7a17760b316a3,3,0,31,31,0,0,0,4,21,87,1,3,0.659459212,733,28,2,54,55,1,6314,6494,180,28,29,1,99.55877718
1097f361309daf29db4958296cd38e4a7ffc407d,1,72,86,14,0,0,0,1,2,80,1,1,0,135,97,2,13,13,0,1024,1347,323,10,10,0,100
a12faeb0eafc4e10c79975160c55686ba2b7fd19,3,14,2,12,0,0,0,4,8,233,1,3,1.121640762,1209,98,3,170,169,1,9118,9020,98,43,43,0,99.93736298
1f83fdcba7d04242be23fe7462f72267d476bc7e,8,71,29,42,0,0,0,2,8,434,1,4,2.139257809,497,99,4,84,82,2,4097,3898,199,37,36,1,100
164d602d87ee6203514b27897f68bfa9aa1f0377,3,428,436,8,0,0,0,1,2,6,1,1,0.940725993,1540,100,5,250,250,0,7608,7630,22,169,169,0,100
41fc0ddc9881d9cfdd8bae129c0bb7800a116d4c,0,0,0,0,0,0,0,0,0,0,0,0,0,0,4,0,0,0,0,0,0,0,0,0,0,100
b34037202775f78733cd21cc0fb4159991f29cd3,11,620,90,530,2,0,2,2,17,64,1,8,3.076013503,1445,85,0,261,216,45,13082,10972,2110,108,85,23,99.53285581
1e1b658b76f5c959bcebdf824372eea0d680d3f0,0,0,0,0,0,0,0,0,0,0,0,0,0,0,0,0,0,0,0,0,0,0,0,0,0,100
8b4fa79d19be992ad270df7d1780db7f4b8ce176,0,0,0,0,0,0,0,0,0,0,0,0,0,0,5,1,0,0,0,0,0,0,0,0,0,100
e416a7d7852fb1a7566681d0d3f55cd256d1332e,1,1,0,1,0,0,0,3,7,252,1,1,0,235,101,6,39,39,0,1885,1857,28,14,14,0,100
55b3e7ea80953a3bbfad5ec43b85d17e8ed287e6,73,6450,0,6450,73,0,73,1,1,0,1,13,5.856746873,0,22,0,474,0,474,38006,0,38006,294,0,294,92.67747345
a61dbcf7ed69768b2342b292460815e5eee0db07,17,800,55,745,4,0,4,1,2,0,1,8,2.832494602,646,4,0,137,71,66,10195,5287,4908,91,47,44,99.56896552
e662849932a74187708b0037042c6b06d4750116,42,2316,465,1851,10,0,10,1,3,0,1,7,4.419300697,2588,23,1,390,241,149,36966,27453,9513,271,156,115,98.57393045
818b0b17b131d875259178e61e59d32d02ae792a,26,1266,209,1057,8,0,8,1,18,177,2,11,3.985348872,1950,86,1,307,250,57,17349,13651,3698,219,162,57,98.92077508
27ee490960614dfd890acdab443c6b242ce2cdb8,23,582,135,447,2,0,2,4,22,157,3,16,3.027605943,2936,102,7,489,437,52,26566,23272,3294,263,247,16,97.00279401
134a23311c51693381fb52e6a90026420ff61b63,42,1431,427,1004,8,0,8,1,23,157,1,27,4.760769664,4074,24,2,567,475,92,41088,34014,7074,286,224,62,94.06735751
22591a7cbe7c373b8744caf8a96d1b358e0d419e,1,2,0,2,0,0,0,2,3,15,1,1,0,69,25,3,7,7,0,577,563,14,6,6,0,100
29a0c186788bcbd5d1147c91bf03d654e1f04245,12,665,205,460,2,0,2,2,23,130,2,6,2.149641417,2097,103,7,267,224,43,19880,16392,3488,183,164,19,96.05585497
b2e46f57402536dc984a80db4e923975bb9015b0,0,0,0,0,0,0,0,0,0,0,0,0,0,0,29,1,0,0,0,0,0,0,0,0,0,100
c793308cbd44e4cdbc223b141ed89978d8a52acb,0,0,0,0,0,0,0,0,0,0,0,0,0,0,8,0,0,0,0,0,0,0,0,0,0,100
2c9299eec1c4712425a2fc6d43337e0bdd8abbb2,0,0,0,0,0,0,0,0,0,0,0,0,0,0,9,1,0,0,0,0,0,0,0,0,0,100
8b6fc2e60f8021e7e2e4896d836e7e739393491f,0,0,0,0,0,0,0,0,0,0,0,0,0,0,0,0,0,0,0,0,0,0,0,0,0,100
68a334a8717d2a6b82f7f9651c57bc75e256ba97,0,0,0,0,0,0,0,0,0,0,0,0,0,0,0,0,0,0,0,0,0,0,0,0,0,100
f1435a6a75f016294920ac328ba79474fbf129e1,1,13,0,13,0,0,0,2,2,60,1,1,0,282,5,0,22,22,0,2206,2164,42,18,18,0,100
39059e5be07796550e8ff7dd054e1e1d2ac93e75,0,0,0,0,0,0,0,0,0,0,0,0,0,0,104,2,0,0,0,0,0,0,0,0,0,100
f3987370311e8013764385d6861e56f72832bb16,0,0,0,0,0,0,0,0,0,0,0,0,0,0,12,0,0,0,0,0,0,0,0,0,0,100
4fba50a86406dc8c46f7d18e3288ece2a9014f5b,2,31,0,31,0,0,0,4,5,317,1,2,0.869137581,299,1,0,36,31,5,2885,2684,201,17,14,3,100
8f12a76e0f84b62645f84fbcc9334af0dbc56ad1,0,0,0,0,0,0,0,0,0,0,0,0,0,0,30,1,0,0,0,0,0,0,0,0,0,100
64ff4694bbdc3d7584b931f571a91bff74d56874,0,0,0,0,0,0,0,0,0,0,0,0,0,0,49,0,0,0,0,0,0,0,0,0,0,100
d0965d54d4aec60e3e0cf94df13e81b966159cdb,1,5,2,3,0,0,0,2,3,181,1,1,0,173,6,1,31,30,1,1196,1174,22,9,9,0,100
340e92383192962d2de6990146949ac53b5c8056,0,0,0,0,0,0,0,0,0,0,0,0,0,0,87,0,0,0,0,0,0,0,0,0,0,100
27b0d6e31de94317b085766349a892395f0d3309,7,22,10,12,0,0,0,2,24,314,1,7,2.387015896,1077,4,0,98,95,3,9260,9119,141,49,49,0,100
468bbdf60a9d415bb961976dee88912003ccb2f7,0,0,0,0,0,0,0,0,0,0,0,0,0,0,7,2,0,0,0,0,0,0,0,0,0,100
2f9158e0f8d8e2a150c6f116c8f6359190b79b49,1,1,1,0,0,0,0,2,3,21,1,1,0,176,2,1,22,22,0,1530,1534,4,3,3,0,100
88d72339f19f02e7264ccf21c7976a3f06df9d74,0,0,0,0,0,0,0,0,0,0,0,0,0,0,20,0,0,0,0,0,0,0,0,0,0,100
c13ee82656830e131f929e443930465c475ff4eb,0,0,0,0,0,0,0,0,0,0,0,0,0,0,6,0,0,0,0,0,0,0,0,0,0,100
98dc7659a8ce86f5ced1324b0832f8950c6a65a9,43,1311,909,402,11,0,11,1,14,257,3,22,4.899270611,3298,105,1,474,450,24,27513,27424,89,246,256,10,96.42686994
dae102b0228b969d4e685a81dd6df25e59f63cb5,11,143,30,113,0,0,0,2,15,66,2,10,2.223926954,2445,106,2,277,256,21,20703,19995,708,118,115,3,100
e03636d8d3fa18bbd3ed53cd55e66b81eb84603d,1,0,9,9,0,0,0,3,10,0,1,1,0,339,31,1,32,35,3,2452,2542,90,12,12,0,100
aef84636a3427da20b1d54acfe1b8de23e2aaf97,0,0,0,0,0,0,0,0,0,0,0,0,0,0,26,0,0,0,0,0,0,0,0,0,0,100
7b8d90036952c2911269632fa8c11bda958cd48d,1,154,122,32,0,0,0,2,2,85,1,1,0,130,107,3,16,9,7,1580,1362,218,6,6,0,100
3766b87bb4125d32867cd82cf9a3e96e0c61a8ed,0,0,0,0,0,0,0,0,0,0,0,0,0,0,32,2,0,0,0,0,0,0,0,0,0,100
06863d3f051e2c5ea007503454e5572be7ca7df7,0,0,0,0,0,0,0,0,0,0,0,0,0,0,27,1,0,0,0,0,0,0,0,0,0,100
90fe0d8551847e2fdd1871035338d2181b28bffe,0,0,0,0,0,0,0,0,0,0,0,0,0,0,1,0,0,0,0,0,0,0,0,0,0,100
09f13b2f908ea200796291c03a359329ac8f2edd,0,0,0,0,0,0,0,0,0,0,0,0,0,0,10,0,0,0,0,0,0,0,0,0,0,100
a2452a25caffdd8c35fd9efe0ed49ce0dd2e3781,0,0,0,0,0,0,0,0,0,0,0,0,0,0,108,3,0,0,0,0,0,0,0,0,0,100
a48d16e30e2c6e89a49d430fa44db3dcc76447ae,0,0,0,0,0,0,0,0,0,0,0,0,0,0,33,2,0,0,0,0,0,0,0,0,0,100
ccdb4c71850670c7190d5e2824d3cdd0a6e65238,0,0,0,0,0,0,0,0,0,0,0,0,0,0,11,1,0,0,0,0,0,0,0,0,0,100
2724bf66c4556147435a74f11df509c75d3f8fc5,0,0,0,0,0,0,0,0,0,0,0,0,0,0,1,0,0,0,0,0,0,0,0,0,0,100
eb209f5c9400b81720a866ef5dd1817f73226f44,0,0,0,0,0,0,0,0,0,0,0,0,0,0,8,2,0,0,0,0,0,0,0,0,0,100
34614cc9006a77826ed729f2c8a40f99bd84d4b4,0,0,0,0,0,0,0,0,0,0,0,0,0,0,50,1,0,0,0,0,0,0,0,0,0,100
fccb67aecca199d7aebd14b16debff4bf16f8acd,0,0,0,0,0,0,0,0,0,0,0,0,0,0,0,0,0,0,0,0,0,0,0,0,0,100
8f1dc5af946e30ec280c99f6620a5de4f46ffe27,3,46,10,36,0,0,0,1,13,78,1,1,1.031746535,172,109,4,30,28,2,1360,1264,96,15,13,2,100
58775bc488addd1e274ed58679db448689128e49,0,0,0,0,0,0,0,0,0,0,0,0,0,0,9,3,0,0,0,0,0,0,0,0,0,100
81677fd906a01a768777682ebf7caed44708c86e,0,0,0,0,0,0,0,0,0,0,0,0,0,0,88,1,0,0,0,0,0,0,0,0,0,100
4c114a51ff730782f6d0584312d7c100a604e50a,0,0,0,0,0,0,0,0,0,0,0,0,0,0,28,2,0,0,0,0,0,0,0,0,0,100
339f95ed3b940071f55545a3a912cbd94de0911f,0,0,0,0,0,0,0,0,0,0,0,0,0,0,51,1,0,0,0,0,0,0,0,0,0,100
7e21ad3c79a337bdc8007c4af8bdd3109c1e7332,10,689,49,640,4,0,4,1,5,148,1,4,2.17186497,385,34,3,126,66,60,6728,2923,3805,79,46,33,97.0407197
ab80e7b18ba1fb18adeb7645fda9440a9644d34e,12,1541,435,1106,3,0,3,1,24,209,1,6,2.632855873,4013,110,5,1026,859,167,32712,27123,5589,672,571,101,99.83579639
7c1a56549cf99b013aa2f6022121dc6ff581c0fd,0,0,0,0,0,0,0,0,0,0,0,0,0,0,89,1,0,0,0,0,0,0,0,0,0,100
ba73309502eed5dabedec1276d1101c83568a6de,0,0,0,0,0,0,0,0,0,0,0,0,0,0,26,0,0,0,0,0,0,0,0,0,0,100
0e629f3be53836e0d49adb9a3144a91360226791,2,13,6,7,0,0,0,2,2,146,1,2,0.949452015,388,1,0,67,66,1,3266,3202,64,27,26,1,100
1ef8cd8ff692b29d1042548a903092b0a0d88c4d,15,115,10,105,0,0,0,1,4,105,1,6,3.600552024,1470,27,1,155,144,11,15307,14445,862,96,87,9,98.29020333
d30d8b9df0746dcfb90044ca243c7dfdeb395066,0,0,0,0,0,0,0,0,0,0,0,0,0,0,10,2,0,0,0,0,0,0,0,0,0,100
e6992d56816c37f8f63274a5a1ce33d37d69dc68,2,375,24,351,0,0,0,4,8,216,1,2,0.915769153,449,2,0,98,58,40,5201,3234,1967,34,24,10,100
eb08d145f00166ab73316714f96fdb8d53de0f79,0,0,0,0,0,0,0,0,0,0,0,0,0,0,29,1,0,0,0,0,0,0,0,0,0,100
84f336b372be271abb563b1a19f2af462fe6de2d,0,0,0,0,0,0,0,0,0,0,0,0,0,0,28,2,0,0,0,0,0,0,0,0,0,100
2ecc55ba17591b9216a6cf47d116c53608b9e59f,0,0,0,0,0,0,0,0,0,0,0,0,0,0,6,0,0,0,0,0,0,0,0,0,0,100
58d5318a0a9a40ea33c63d83885c11115eacd32c,0,0,0,0,0,0,0,0,0,0,0,0,0,0,11,2,0,0,0,0,0,0,0,0,0,100
2ecabaa8c0e7dab929726f8da48b98de623953ab,1,0,1,1,0,0,0,3,8,151,1,1,0,62,13,0,5,5,0,605,605,0,3,3,0,100
29d7cb378835b819b326660ed59aca4becbf7099,0,0,0,0,0,0,0,0,0,0,0,0,0,0,12,0,0,0,0,0,0,0,0,0,0,100
df44f077a97d0495fea511f5d9f900e4d3a25147,0,0,0,0,0,0,0,0,0,0,0,0,0,0,12,2,0,0,0,0,0,0,0,0,0,100
187ef373a6cc0f89696349acc35ddeddbfd836ef,1,1,0,1,0,0,0,4,11,66,1,1,0,260,35,1,40,40,0,2210,2203,7,9,9,0,100
55062fb79a85722c909906874e0772f51b18953d,0,0,0,0,0,0,0,0,0,0,0,0,0,0,7,1,0,0,0,0,0,0,0,0,0,100
41b5b1050cf29e5dcb5d0c36b5a9dbd1cafa745e,0,0,0,0,0,0,0,0,0,0,0,0,0,0,5,0,0,0,0,0,0,0,0,0,0,100
cb44090b0a3f7df6950cf27d43ebb399d5005403,0,0,0,0,0,0,0,0,0,0,0,0,0,0,111,1,0,0,0,0,0,0,0,0,0,100
8fe52c9a126bbfbb82472f48e1f162f128e35694,0,0,0,0,0,0,0,0,0,0,0,0,0,0,90,1,0,0,0,0,0,0,0,0,0,100
bec84db776a08b55594bf2ac78613d58b0a65b90,0,0,0,0,0,0,0,0,0,0,0,0,0,0,36,1,0,0,0,0,0,0,0,0,0,100
b6786aaf030122e83b82ad63c828f68f3754d8ec,0,0,0,0,0,0,0,0,0,0,0,0,0,0,0,0,0,0,0,0,0,0,0,0,0,100
8c264f8e7345620c2a6c155d8d32e396ce30ec91,0,0,0,0,0,0,0,0,0,0,0,0,0,0,21,0,0,0,0,0,0,0,0,0,0,100
fbce3b5f9e396be997c315f39c6749d39b9105a3,0,0,0,0,0,0,0,0,0,0,0,0,0,0,91,1,0,0,0,0,0,0,0,0,0,100
19e0e715d30670612b0ad826ed133ba138bdc20f,0,0,0,0,0,0,0,0,0,0,0,0,0,0,92,2,0,0,0,0,0,0,0,0,0,100
cac696d7dbf9bec57cc9a59f599bded48186ca70,0,0,0,0,0,0,0,0,0,0,0,0,0,0,1,0,0,0,0,0,0,0,0,0,0,100
6e1e322eff001882153900f840b8387bc2a19c40,3,179,158,21,0,0,0,7,25,48,1,3,0.38590936,1343,112,1,152,151,1,10327,10045,282,111,110,1,100
58fa1f69cf14436b54414f660ff11c2c48c99c6f,0,0,0,0,0,0,0,0,0,0,0,0,0,0,22,1,0,0,0,0,0,0,0,0,0,100
ffe2d934089ba6c63513759a9a740c1e34660132,0,0,0,0,0,0,0,0,0,0,0,0,0,0,23,2,0,0,0,0,0,0,0,0,0,100
5dd87886d6288b3f65e4f26e88ef10dcc82895fe,8,243,5,238,2,0,2,1,3,120,1,5,2.474512158,370,29,1,50,36,14,4950,3290,1660,42,32,10,99.81785064
bf2528fd3f4d474164ddf497459cd2421df3e4bb,21,709,303,406,3,0,3,1,14,575,1,16,3.678549028,2718,113,2,284,252,32,26101,23092,3009,142,126,16,96.52232443
68bd6c52055b34460ff1823a31daae1f60985e1a,0,0,0,0,0,0,0,0,0,0,0,0,0,0,114,3,0,0,0,0,0,0,0,0,0,100
f36db22eba256209d494f2ab3eda4f0c2b2448d7,0,0,0,0,0,0,0,0,0,0,0,0,0,0,30,1,0,0,0,0,0,0,0,0,0,100
47e5aa70adfd2fb000e412c3a6b6d06c91e2809c,0,0,0,0,0,0,0,0,0,0,0,0,0,0,93,3,0,0,0,0,0,0,0,0,0,100
29e7c70dfe946667e907ae0767f47da895e722e5,7,6,9,3,0,0,0,4,14,250,1,7,2.739572262,1469,37,2,173,173,0,11913,11962,49,68,68,0,100
494643c38a64834a05ab3c6c2615aab6e9450a4e,0,0,0,0,0,0,0,0,0,0,0,0,0,0,24,3,0,0,0,0,0,0,0,0,0,100
1d27a32d5fe20ecb57a0cc143c1cb707f79ad20c,8,67,31,36,0,0,0,2,5,494,1,2,2.62544405,697,115,4,95,90,5,5830,5596,234,59,56,3,97.55988359
38d26d4328eee058b3515dae38e02565a4669f4e,0,0,0,0,0,0,0,0,0,0,0,0,0,0,38,3,0,0,0,0,0,0,0,0,0,100
716bda326f26b60c98318cdc1cc949b351a0b71a,1,2,2,0,0,0,0,1,3,69,1,1,0,61,30,1,6,6,0,666,666,0,4,4,0,100
e08b7d47f3f644e12a9abb59bd3901d93c6d34af,0,0,0,0,0,0,0,0,0,0,0,0,0,0,39,2,0,0,0,0,0,0,0,0,0,100
082b218fb80ec8049cf7143d2a1c9a1537dd41dc,0,0,0,0,0,0,0,0,0,0,0,0,0,0,8,0,0,0,0,0,0,0,0,0,0,100
8cf109da180ee9f80984b0408afed799fa6c7c43,0,0,0,0,0,0,0,0,0,0,0,0,0,0,9,1,0,0,0,0,0,0,0,0,0,100
876a5fc1379e0027d82941d956bd85660bc2c2ac,0,0,0,0,0,0,0,0,0,0,0,0,0,0,31,2,0,0,0,0,0,0,0,0,0,100
21b79dc8eb0ffd7f0a3ea87744cef3d792456af7,0,0,0,0,0,0,0,0,0,0,0,0,0,0,13,0,0,0,0,0,0,0,0,0,0,100
4662c775c033fec3e23b8df138ca489b5a96fea3,0,0,0,0,0,0,0,0,0,0,0,0,0,0,40,3,0,0,0,0,0,0,0,0,0,100
0d5fdf419fdb2ad863eb531fa101f0f4ecae3497,2,42,3,39,0,0,0,2,2,86,1,2,0.26231122,289,31,1,45,43,2,2164,1926,238,18,16,2,100
8532e2848c4767405f4bfe6501c251b1aab54f01,0,0,0,0,0,0,0,0,0,0,0,0,0,0,2,0,0,0,0,0,0,0,0,0,0,100
64b66f28a5410b095c2a64e7e66b9ee9776c4949,0,0,0,0,0,0,0,0,0,0,0,0,0,0,14,1,0,0,0,0,0,0,0,0,0,100
e375936a17ee0ce743d5d9f4446ea21dee474450,0,0,0,0,0,0,0,0,0,0,0,0,0,0,25,1,0,0,0,0,0,0,0,0,0,100
b3e7222f1c4fb527ff3b18e8bb47383528d2eb57,0,0,0,0,0,0,0,0,0,0,0,0,0,0,41,4,0,0,0,0,0,0,0,0,0,100
53990090e554aff0873ef8ddf1a492fcb05604c9,0,0,0,0,0,0,0,0,0,0,0,0,0,0,13,0,0,0,0,0,0,0,0,0,0,100
9a5e1ba73ddf1d7154fff6f41fa9b9e41fed3328,0,0,0,0,0,0,0,0,0,0,0,0,0,0,14,1,0,0,0,0,0,0,0,0,0,100
345eba8d5940f2789e5a860eb51e8fa9f003c676,3,39,11,28,0,0,0,1,2,315,1,2,1.563233259,263,32,1,37,34,3,2499,2360,139,23,21,2,100
4b3ccac3649d9ed384774fe0573aa1812b87e5a8,0,0,0,0,0,0,0,0,0,0,0,0,0,0,116,1,0,0,0,0,0,0,0,0,0,100
1277b6c3229ee4b7cb066902ac56e03145c18157,16,74,44,30,0,0,0,2,25,235,1,12,3.167073635,2531,52,0,317,315,2,22122,21679,443,153,151,2,100
6c836d13635fcf1639ea7b8adbaf1ba4051c4f1c,6,164,56,108,2,0,2,1,14,96,1,5,2.102059067,394,117,2,57,48,9,3544,3193,351,34,27,7,99.88695456
c1c212117d6123f2897a606fedbb2583fb3bb9c3,5,50,6,44,0,0,0,3,15,92,1,4,2.038078977,840,118,3,100,96,4,6784,6505,279,46,43,3,100
be03076599544f2baedb1b3010ad50625b2f32ae,4,50,15,35,1,0,1,3,7,27,1,2,1.783800594,622,119,4,71,71,0,5148,5007,141,39,40,1,99.95485327
c0b0825235ce5c26649282c43f3c57f092864f94,11,287,97,190,1,0,1,3,15,113,1,7,3.212871552,1584,33,2,232,205,27,13041,12045,996,98,91,7,99.932341
47e2b735ea682e7d647e3eaafac89a192a783e86,6,270,143,127,0,0,0,3,4,169,1,6,2.21433572,551,0,0,56,54,2,5099,4786,313,42,40,2,100
5e0cce220dca80c996d173b16b9721fccb373821,0,0,0,0,0,0,0,0,0,0,0,0,0,0,0,0,0,0,0,0,0,0,0,0,0,100
ce381f3e0391c15d0ec36b2e383dea270e7d613f,0,0,0,0,0,0,0,0,0,0,0,0,0,0,3,0,0,0,0,0,0,0,0,0,0,100
fee758b3fb2277067421a95054c3e328730decda,1,16,6,10,0,0,0,3,5,8,1,1,0,186,120,4,35,33,2,1299,1249,50,12,12,0,100
64473d4e8399e71d0ac1a81b6e78e72b982e42f8,3,92,3,89,2,0,2,1,8,3,1,2,1.274563158,129,121,5,28,23,5,1255,946,309,14,11,3,99.88741274
356881ad22edc7c08d8a8f3812192333210f3c8e,1,50,0,50,0,0,0,2,4,156,1,1,0,21,122,6,8,2,6,295,134,161,7,2,5,100
e2197316df5754aba601134ecce19b12092b6f37,8,569,246,323,4,0,4,1,16,94,1,7,2.90287236,1194,34,3,145,123,22,10961,9489,1472,65,48,17,99.77558348
7ef929ae4b998468beb3ef08fe57e37ff04fad4e,0,0,0,0,0,0,0,0,0,0,0,0,0,0,0,0,0,0,0,0,0,0,0,0,0,100
08f95dc8f5588dc9d50e204410ca3d09f84f3c8b,0,0,0,0,0,0,0,0,0,0,0,0,0,0,15,2,0,0,0,0,0,0,0,0,0,100
ae05f38d8728bcc8737b0a4261ab7df35710b97f,0,0,0,0,0,0,0,0,0,0,0,0,0,0,42,1,0,0,0,0,0,0,0,0,0,100
1a0e8f252a7a59fc6328b6fa008bc1f45387ac5e,0,0,0,0,0,0,0,0,0,0,0,0,0,0,3,0,0,0,0,0,0,0,0,0,0,100
61105c71520909674985e90acc0c33a54bcc559e,0,0,0,0,0,0,0,0,0,0,0,0,0,0,32,0,0,0,0,0,0,0,0,0,0,100
f127c6dcfd8c2a2d19314b98eb3840da90d2ab44,1,23,1,22,0,0,0,3,9,257,1,1,0,128,33,1,17,14,3,1181,1015,166,7,6,1,100
9dc8c3a707bbdd4ac2070d5e29a558abde63f360,0,0,0,0,0,0,0,0,0,0,0,0,0,0,35,1,0,0,0,0,0,0,0,0,0,100
74bc236d56a9d6c96105bb2bd2b5f719c5bb3bff,0,0,0,0,0,0,0,0,0,0,0,0,0,0,94,0,0,0,0,0,0,0,0,0,0,100
8779eb3fe6d2767d6b79d665adec735380cf2d61,0,0,0,0,0,0,0,0,0,0,0,0,0,0,95,1,0,0,0,0,0,0,0,0,0,100
85872bd68698149692c97a48dfe41a78435dcc99,0,0,0,0,0,0,0,0,0,0,0,0,0,0,16,1,0,0,0,0,0,0,0,0,0,100
e31ed2f7d2420fc9f68b0dbf5b6a9a5b53ac6453,0,0,0,0,0,0,0,0,0,0,0,0,0,0,15,0,0,0,0,0,0,0,0,0,0,100
1e9acc72e3642c372cb84cab52fee91e96276e22,0,0,0,0,0,0,0,0,0,0,0,0,0,0,36,1,0,0,0,0,0,0,0,0,0,100
d5abcf429dad3c284a5f2469c0fb99713844be02,0,0,0,0,0,0,0,0,0,0,0,0,0,0,17,2,0,0,0,0,0,0,0,0,0,100
43e529fe003b84c585555be9f25a4ff49d769132,0,0,0,0,0,0,0,0,0,0,0,0,0,0,34,2,0,0,0,0,0,0,0,0,0,100
d0e1ba5089eb08187fd36c55fbe40539ef1f7890,6,134,66,68,0,0,0,4,19,392,1,2,2.002035684,657,35,3,93,90,3,5921,5400,521,38,35,3,99.91043439
605a3cc6d29d0ac1377270b1455819645f4a95bc,0,0,0,0,0,0,0,0,0,0,0,0,0,0,16,1,0,0,0,0,0,0,0,0,0,100
5b72da7be0521fc16e887dd4a1c958ceaeaa6510,25,321,2062,1741,1,0,1,2,13,674,1,16,3.781984092,2114,43,1,160,302,142,12403,16934,4531,84,192,108,99.24242424
61cbab46e3e262e006e59c28eaa9192d0f7aaaab,3,173,68,105,1,0,1,1,3,142,1,2,1.142519795,97,44,2,20,17,3,1350,780,570,9,6,3,99.9113082
7d6121bfd3bd622940e9f411ac87b56d29755596,17,894,63,831,5,0,5,1,14,354,2,10,3.241545395,1144,123,0,271,201,70,12770,8755,4015,119,87,32,99.66799469
30d0e2a6faa1c1205522758e5fd15f35ebc9fcbb,26,1015,518,497,1,0,1,2,26,357,2,8,2.653330962,5811,124,1,1241,1156,85,44079,41093,2986,798,752,46,99.93377483
f523c179585bea3a61f99c694d2752fc6ceb7a3b,3,74,31,43,0,0,0,2,3,315,1,3,1.184021404,371,45,2,53,46,7,3350,3156,194,25,20,5,100
de2c871abf3e259311281743952eb465362cf90c,8,182,14,168,0,0,0,6,27,38,1,7,2.493335085,2277,125,2,317,311,6,20091,19468,623,171,167,4,100
b76bcd5f2405db122c2bf9d19128f9efb20b8458,1,186,170,16,0,0,0,3,4,251,1,1,0,176,2,0,23,22,1,1623,1530,93,4,3,1,100
d52f574f8294e453ecad3871526858a0c3c2033d,0,0,0,0,0,0,0,0,0,0,0,0,0,0,17,0,0,0,0,0,0,0,0,0,0,100
095be23dce0f818a98a1fc587053d133ca542856,0,0,0,0,0,0,0,0,0,0,0,0,0,0,18,0,0,0,0,0,0,0,0,0,0,100
df94ed40523db375b0bac4601a7efffa5a1fede5,27,673,265,408,1,0,1,5,26,388,3,20,4.052702896,4482,46,0,685,620,65,36265,34316,1949,343,306,37,99.10067997
a5b13777a92418155da61864e98fc24cde866501,228,2172,858,1314,11,0,11,1,27,169,4,87,6.348111027,28495,18,1,4499,3237,1262,217187,162174,55013,2465,2138,327,87.34887737
ab87bdf673e151da4b6352da6b0f4a6957f4777b,0,0,0,0,0,0,0,0,0,0,0,0,0,0,26,0,0,0,0,0,0,0,0,0,0,100
cc7bbc94870f0e0d5026c14ac710ca8882d0589b,2,948,36,912,0,0,0,5,7,355,1,2,0.021105167,257,19,1,33,17,16,10394,3138,7256,30,14,16,100
87f652215cbe9e611029f5269f6c2b30aaa8f229,4,35,14,21,0,0,0,4,17,185,1,4,1.332871542,922,36,0,113,113,0,8116,7980,136,40,40,0,100
df270feeab5ca435ad32438351dfe56a310700c5,0,0,0,0,0,0,0,0,0,0,0,0,0,0,19,2,0,0,0,0,0,0,0,0,0,100
f7a94f2e631227f035c63ad258c124c0cd582189,0,0,0,0,0,0,0,0,0,0,0,0,0,0,20,3,0,0,0,0,0,0,0,0,0,100
50e521b0077d098fdc89562d7aa9b95398ce7bb6,0,0,0,0,0,0,0,0,0,0,0,0,0,0,96,0,0,0,0,0,0,0,0,0,0,100
a8f35363ffdd1e20bc7a64b7107d270f9667be3b,0,0,0,0,0,0,0,0,0,0,0,0,0,0,21,4,0,0,0,0,0,0,0,0,0,100
fc6614b18c73d339293bb76e682569523feb041a,0,0,0,0,0,0,0,0,0,0,0,0,0,0,27,1,0,0,0,0,0,0,0,0,0,100
7cd39316a4e7587c84efbfa2d8da503d1a6640a7,4,18,5,13,0,0,0,3,8,254,1,3,1.618838682,420,97,1,59,58,1,3098,3034,64,25,24,1,100
dcec5a7cfb7f8b6544af8ab137dab3f75de9c49a,20,192,62,130,0,0,0,2,28,79,3,12,3.456803435,1758,126,0,328,293,35,14296,13515,781,155,147,8,100
cf165ff306764641a2c7991ff93cf48228d7910d,4,210,23,187,3,0,3,1,2,6,1,3,1.793151531,412,28,2,80,65,15,3427,2603,824,26,22,4,99.85065074
a9b01d1e373091662f4dff3ac3acf7cec181e103,0,0,0,0,0,0,0,0,0,0,0,0,0,0,37,1,0,0,0,0,0,0,0,0,0,100
bfc4786df55d522597d87c01872982bc9ec7923f,3,315,1,314,2,0,2,1,2,9,1,2,1.108867333,305,29,3,82,53,29,3982,2439,1543,24,20,4,99.85090522
dcf768297cdc62be1400cf5dbc5db28820900a43,0,0,0,0,0,0,0,0,0,0,0,0,0,0,0,0,0,0,0,0,0,0,0,0,0,100
886ed7a00501c7ccb98ed8296cab9ded3e0a62fd,0,0,0,0,0,0,0,0,0,0,0,0,0,0,4,0,0,0,0,0,0,0,0,0,0,100
29aad8b4abc9993915616bfac3f18c739c2c7103,0,0,0,0,0,0,0,0,0,0,0,0,0,0,14,0,0,0,0,0,0,0,0,0,0,100
eaa52f6231faf9445fdb49031d308609aa4db14c,0,0,0,0,0,0,0,0,0,0,0,0,0,0,98,2,0,0,0,0,0,0,0,0,0,100
b9125c8307b5e8f5b77eeb6f4b96004cf52dc4f9,2,57,1,56,1,0,1,1,2,665,1,2,0.767651587,48,0,0,6,5,1,594,375,219,3,2,1,99.95742869
afe6fd56ee727092dbc66b065df4ff6c7b467bb0,2,213,6,207,1,0,1,1,7,17,1,2,0.71456172,249,1,0,76,60,16,3161,1792,1369,36,22,14,99.07582441
954b5ea13fc04cb8c9ae277d57a75cfb16956772,0,0,0,0,0,0,0,0,0,0,0,0,0,0,1,0,0,0,0,0,0,0,0,0,0,100
57d2764c318c8ec7d37d8a3f11e4609e35078285,3,80,13,67,0,0,0,2,4,246,1,3,1.097308442,336,99,3,37,34,3,3660,3202,458,30,29,1,100
a8bcbf0b4e30cb5803d5bb99a30dd988d8375b32,0,0,0,0,0,0,0,0,0,0,0,0,0,0,38,2,0,0,0,0,0,0,0,0,0,100
0d1923f83aee6630f1112cd7f9d20514726272f0,1,0,176,176,0,0,0,2,2,15,1,1,0,126,100,4,0,12,12,0,1119,1119,0,12,12,99.07582441
cf7043c59b1091c59b06cb14ca9d332a727fc3ea,25,1664,91,1573,21,0,21,1,12,59,2,17,4.174078851,359,39,2,171,61,110,11490,2834,8656,94,24,70,98.5375159
3d6b049b8799235b580a275024c18f6092fc8942,2,10,0,10,0,0,0,1,7,406,1,2,0.468995594,275,40,3,29,29,0,2605,2526,79,16,16,0,100
a0e756bf9a0f8dc4401a0dbac81b23ba87c16616,0,0,0,0,0,0,0,0,0,0,0,0,0,0,37,0,0,0,0,0,0,0,0,0,0,100
309d8097a91cc40e46f187f672d651b00cdd90fa,0,0,0,0,0,0,0,0,0,0,0,0,0,0,101,4,0,0,0,0,0,0,0,0,0,100
50abfa44101642fc5413014f5cdc144e8bd618a5,2,219,0,219,0,0,0,2,2,66,1,2,0.939453207,341,127,1,77,47,30,3583,2266,1317,26,19,7,100
240b69f8c303a8e5103c9d5d0a22b0d061e043fe,0,0,0,0,0,0,0,0,0,0,0,0,0,0,3,0,0,0,0,0,0,0,0,0,0,100
28a974037e016b21902a176cb0e0e36b65ddb24a,3,0,4,4,0,0,0,2,2,66,1,2,1.5,762,0,0,151,151,0,6023,6063,40,75,75,0,100
ba9ddda6d742a0df96e24a1573f44482020c25fb,0,0,0,0,0,0,0,0,0,0,0,0,0,0,102,4,0,0,0,0,0,0,0,0,0,100
577ff80e3bdd5c690cfee3783f73003eb7470aab,3,17,10,7,0,0,0,2,16,310,2,2,1.297231328,289,103,5,67,67,0,2033,2016,17,36,36,0,100
5c0ac32d19e3805ec4b7ac587ed196e0431f8b35,0,0,0,0,0,0,0,0,0,0,0,0,0,0,104,6,0,0,0,0,0,0,0,0,0,100
badc6cf9739a31800abee1cfccbcf9930b130fa7,13,127,128,1,0,0,0,2,18,191,1,11,2.879267543,2439,41,3,298,295,3,18980,18847,133,132,130,2,99.9155227
9355a04650af443bb67b94c7055ca82c07c7cf5d,0,0,0,0,0,0,0,0,0,0,0,0,0,0,0,0,0,0,0,0,0,0,0,0,0,100
e206f2508ef7e7d798510df76ccfeb38b9530e89,5,544,2,542,4,0,4,1,2,15,1,4,2.007003328,676,30,0,92,56,36,9052,5852,3200,71,52,19,99.76793249
ae50723a5e890f23ef5d5029bcdb5c8c9b327a82,0,0,0,0,0,0,0,0,0,0,0,0,0,0,42,4,0,0,0,0,0,0,0,0,0,100
ba46fa734d868c78b3e75c86210d947ed7621f0e,8,268,28,240,2,0,2,3,5,183,1,7,2.035358869,647,31,1,102,64,38,7844,6864,980,54,32,22,99.83154348
7e0375390baba6a3a4c115a71bb7a3d473ccbdf7,8,631,48,583,5,0,5,4,19,123,1,3,2.687777321,434,38,1,111,65,46,6372,3345,3027,59,26,33,99.66435914
c99df8ff1f5488f432084aa2a1f9d9001b8a1a31,0,0,0,0,0,0,0,0,0,0,0,0,0,0,47,0,0,0,0,0,0,0,0,0,0,100
7b9f20c937c471632faae789520f15f63b3617e1,2,25,5,20,0,0,0,3,4,1036,1,2,0.881290899,170,0,0,23,23,0,1599,1448,151,8,8,0,100
ec959d20efa72e9868d87a02d9407bbaad34c4c8,94,991,879,112,0,0,0,2,29,357,3,56,6.251338045,12458,39,2,2011,2027,16,95583,93063,2520,797,797,0,100
14bcc0389431879b1d97ae53f8a8a6e7079bed46,2,12,4,8,0,0,0,3,5,44,1,2,1,331,0,0,53,52,1,2614,2561,53,23,22,1,100
19096fe62c4728d326bfc87b2aa831c6aec3d5b2,10,448,11,437,1,0,1,1,2,27,2,9,2.915676383,593,43,4,92,61,31,9904,5902,4002,40,27,13,99.83267099
27ab28923107b18b90bbe1c0c360aa3f1e338666,1,10,9,1,0,0,0,3,3,92,1,1,0,104,40,3,11,11,0,1097,1061,36,7,7,0,100
b2375a1f1c66b19dc6a82cbcc8242741cdf65451,5,504,24,480,3,0,3,2,2,36,1,3,2.14214122,96,128,1,53,7,46,2757,501,2256,46,5,41,99.83302025
c08cd07f36cd9bf2608a586a209bf809130a069a,31,567,323,244,1,0,1,2,7,65,3,13,3.516234982,5194,32,2,636,611,25,44544,40898,3646,423,410,13,94.92884346
42fff741109bf8c7d919f3028368c94bec8ce66e,5,243,11,232,0,0,0,1,3,21,2,4,1.47443981,454,44,3,75,53,22,6525,4381,2144,36,29,7,100
df25d81c41b7ad5381ac8ff9f42c320ba72f43dd,0,0,0,0,0,0,0,0,0,0,0,0,0,0,45,4,0,0,0,0,0,0,0,0,0,100
ed689cc617045ebd1c81bf45095642789392c5e9,0,0,0,0,0,0,0,0,0,0,0,0,0,0,6,0,0,0,0,0,0,0,0,0,0,100
c7d8b7344ac0bd08d2183c340caeb4c074c3b0bc,0,0,0,0,0,0,0,0,0,0,0,0,0,0,46,5,0,0,0,0,0,0,0,0,0,100
3d4751315ff3e4b12531d7e51158f67bfa0f178b,0,0,0,0,0,0,0,0,0,0,0,0,0,0,7,1,0,0,0,0,0,0,0,0,0,100
813adf2dac1b4c07c0e4ae134366c61388ff5b67,49,1967,217,1750,14,0,14,4,19,117,3,29,4.952876568,4322,129,2,694,416,278,48029,46810,1219,380,234,146,94.92957746
3f0e17cf98d31b1143ee4d365c87f0e850df252a,4,23,4,19,0,0,0,4,6,485,1,3,1.584160077,481,130,2,67,61,6,4002,3881,121,33,31,2,98.01595859
de154b0c84e13801a0117b8eed5db5898fce5739,0,0,0,0,0,0,0,0,0,0,0,0,0,0,47,5,0,0,0,0,0,0,0,0,0,100
7d554444e7701eb4e8787d3c395f65b94db762c4,0,0,0,0,0,0,0,0,0,0,0,0,0,0,5,0,0,0,0,0,0,0,0,0,0,100
f072ed231f9acdf0957f0244b6402b2ecd9403a0,16,1021,86,935,3,0,3,1,13,181,1,12,3.231152497,1097,22,0,248,154,94,13042,8689,4353,134,89,45,99.75652944
b3148a18280a4fa50020f4a757dc526c404e0df5,2,19,5,14,0,0,0,3,5,111,1,2,0.918295834,162,1,0,25,24,1,1440,1292,148,10,9,1,100
3d95fdf906993c8d65b76a7e1311c7fb295e19b1,4,181,0,181,2,0,2,1,3,603,1,3,1.352097943,128,131,3,36,27,9,1582,898,684,12,8,4,99.88964908
82bf89ba4ada583ac68dbb44e7fd658ad45e8337,2,2,2,0,0,0,0,2,3,74,1,2,1,344,132,4,65,65,0,2453,2449,4,17,17,0,99.97795414
86b0f137e29a78a5ec849a8dbf0cb8a2e5bb3dbe,0,0,0,0,0,0,0,0,0,0,0,0,0,0,6,1,0,0,0,0,0,0,0,0,0,100
adb378f35cc76c1e7172b2d60cb225a8c59b88b9,0,0,0,0,0,0,0,0,0,0,0,0,0,0,53,0,0,0,0,0,0,0,0,0,0,100
02bc58782963379c7367db1d7f0254dba7c0df36,0,0,0,0,0,0,0,0,0,0,0,0,0,0,48,5,0,0,0,0,0,0,0,0,0,100
1f9a7916407f7ee12f0168f2f244bda04b345b27,0,0,0,0,0,0,0,0,0,0,0,0,0,0,49,6,0,0,0,0,0,0,0,0,0,100
073d6b50def2ebd21e0f9c87b4d039e6dabf7616,24,1735,466,1269,11,0,11,3,21,26,1,6,3.841964987,1858,105,0,238,189,49,17968,13955,4013,169,126,43,92.10032818
5a6370a630fb51a69cd5313e74ab694d68ade187,0,0,0,0,0,0,0,0,0,0,0,0,0,0,50,6,0,0,0,0,0,0,0,0,0,100
73dc16e7a40edb38de6657074c22860647441148,1,15,25,10,0,0,0,2,3,106,1,1,0,311,33,1,54,54,0,2474,2476,2,19,20,1,100
f2a5e5695c3a90b1406a0ee37fdc2fb7944177ca,3,5,19,14,0,0,0,2,7,27,1,2,1.534337198,454,51,7,22,24,2,5019,5113,94,19,21,2,99.42167463
ae1dc3a4aa31cfd6b4af7558dbb2fc0314f80a29,0,0,0,0,0,0,0,0,0,0,0,0,0,0,106,1,0,0,0,0,0,0,0,0,0,100
22268576039babc1dd9ee65a5a6a11ade49a7258,3,0,13,13,0,0,0,1,7,248,1,3,1.460484681,124,52,5,6,6,0,961,1100,139,5,5,0,100
d64afbc3f38e81d462d45f99efb21deec49e6b55,4,24,11,13,0,0,0,8,30,210,2,4,1.853996121,790,53,6,135,135,0,7251,7137,114,57,57,0,100
1d89c3183720ec1ad295b56a7d5ef52aca19dc17,3,128,8,120,0,0,0,3,8,24,1,3,1.182389356,239,107,2,22,17,5,1814,1472,342,19,15,4,100
38d41fe67dee15728b50d930f20d8b19ad935009,4,281,60,221,0,0,0,1,9,24,1,2,0.93114948,533,108,3,55,47,8,4241,3317,924,42,36,6,100
ebfbe9d5edfc07109bdeaf8ccf88f4ca44221aae,3,71,7,64,0,0,0,1,5,174,1,2,1.198415391,635,109,4,70,68,2,4563,4137,426,59,57,2,96.70892248
8059c9fd49cbe174abd2ab92c1efff8842e0b3b0,1,2,1,1,0,0,0,2,6,600,1,1,0,122,110,5,17,17,0,831,826,5,15,15,0,100
f34affdb25422f19f8e70a91b7a796a15a7745a5,3,90,2,88,0,0,0,2,5,51,1,3,1.180773672,647,54,6,83,74,9,7254,6803,451,31,29,2,100
174964832eafba927ae4e7aa407d2a1100a8b776,2,22,11,11,0,0,0,2,3,97,1,2,0.845350937,244,133,2,30,28,2,1579,1506,73,6,4,2,100
a2bae0bce4d0739c5b1b7e5d803ee1c44ea529ca,5,482,0,482,5,0,5,1,1,0,1,4,2.079394356,0,2,0,42,0,42,2361,0,2361,29,0,29,96.4268352
d5dbfc20cb42708c27e9a02c5f7eacac98604745,2,213,0,213,2,0,2,1,1,0,1,2,0.998075296,0,34,1,19,0,19,1098,0,1098,12,0,12,96.63438257
c8e84fa3be89901013168d15df38b8a58265148a,0,0,0,0,0,0,0,0,0,0,0,0,0,0,0,0,0,0,0,0,0,0,0,0,0,100
9bc9e0c524ab41c2d4df1f45f20fc58f4799103d,0,0,0,0,0,0,0,0,0,0,0,0,0,0,7,0,0,0,0,0,0,0,0,0,0,100
a9079f546345d449647daf4f681d5d259d0829cd,2,58,0,58,0,0,0,3,8,146,1,2,0.70074955,195,134,1,19,14,5,1928,1628,300,9,8,1,100
7f9f86c005eb5d9d966d33df95cd060e2f8784bb,5,31,3,28,0,0,0,2,5,602,1,4,1.841816815,1401,135,2,210,204,6,10765,10554,211,58,57,1,99.83641038
8560d2dfc96dd0215ca50acc3148300e7ef2ad75,0,0,0,0,0,0,0,0,0,0,0,0,0,0,136,3,0,0,0,0,0,0,0,0,0,100
8ee9eb8007ce3c0bbca553e8c4b5d861300d1a00,0,0,0,0,0,0,0,0,0,0,0,0,0,0,4,0,0,0,0,0,0,0,0,0,0,100
cd14cbeefec6afc7aee9efcc288c9482d67d9657,0,0,0,0,0,0,0,0,0,0,0,0,0,0,4,0,0,0,0,0,0,0,0,0,0,100
1a4f19c86ed94742c08e8e264a7bb45ff9ad27a6,1,35,20,15,0,0,0,3,4,43,1,1,0,309,111,4,56,54,2,2552,2474,78,20,19,1,100
c73c7af1dc3cb6502517bc7ac1d37c631ec3dbe5,3,156,12,144,0,0,0,1,2,45,1,3,1.436699573,360,112,5,46,33,13,2910,2321,589,33,26,7,98.93395133
8ef18d31ab927acad7798c6c32252ca27c8e8b46,2,39,16,23,0,0,0,1,4,20,1,2,0.225363639,564,113,6,49,47,2,4235,4094,141,36,36,0,100
38eebd59ce2884ead7f3797ff98f7308409e05dd,8,923,103,820,1,0,1,3,17,101,2,7,2.23556971,1381,137,4,303,192,111,16106,11459,4647,148,93,55,99.79329352
31d99f122e89d81590df84f66c2dc9fb336a03b8,0,0,0,0,0,0,0,0,0,0,0,0,0,0,138,5,0,0,0,0,0,0,0,0,0,100
91a017b6dcefc250bfd67cecf9803cb59015d213,3,618,0,618,2,0,2,1,2,64,1,2,1.056862208,188,139,6,95,33,62,5432,1026,4406,29,7,22,99.90829895
37e8ca7e22f0a16c9bbccd9d9896942f230a11b8,0,0,0,0,0,0,0,0,0,0,0,0,0,0,114,7,0,0,0,0,0,0,0,0,0,100
7a3de6737b964abbdcdc876695b50f29bf5d531e,13,480,96,384,5,0,5,3,8,147,1,8,3.252111686,856,55,1,91,80,11,9426,7327,2099,63,50,13,99.25017042
0bbc51d6858c67015ec7dde3105069f4a678d518,0,0,0,0,0,0,0,0,0,0,0,0,0,0,115,4,0,0,0,0,0,0,0,0,0,100
dd7118197ea09550192d82161cda4e0614a62b35,6,963,9,954,5,0,5,1,5,18,1,4,2.142341677,157,140,6,124,25,99,6412,1131,5281,60,5,55,99.75264223
f79214be9bcabca3b8b9411e17915c2de5236ea8,0,0,0,0,0,0,0,0,0,0,0,0,0,0,56,1,0,0,0,0,0,0,0,0,0,100
224d3d5e2b8c17ca4414ad7d7846dafee0b06d3b,9,89,89,0,0,0,0,1,9,391,1,5,2.500403547,1039,57,2,92,93,1,9031,9027,4,62,61,1,99.61806336
f0ae85fb71bf1d102d9b72f6b413a89abe8b4bd4,2,16,4,12,0,0,0,3,4,108,1,2,0.970950594,1323,141,7,193,192,1,12118,11992,126,120,119,1,100
6ff39ae380d82fb5805f4092806b846332c3c8b8,2,132,40,92,0,0,0,1,3,24,1,2,0.891014185,370,116,5,43,36,7,2987,2592,395,30,25,5,100
ea65a37c04c2e0d8fad1f1ea024af39ae56049ca,0,0,0,0,0,0,0,0,0,0,0,0,0,0,8,1,0,0,0,0,0,0,0,0,0,100
7768ff673cb4a7a62180d16fdb92dc0f4123f4f1,2,57,0,57,0,0,0,3,3,142,1,2,0.879135767,719,142,8,110,97,13,5633,5239,394,36,33,3,100
ccb5a0bdd4cb7d04c0d1f23359215ffb643774b5,0,0,0,0,0,0,0,0,0,0,0,0,0,0,23,0,0,0,0,0,0,0,0,0,0,100
b0c6e68ce5a3e9caa12711cf76aed1776d3745db,2,104,8,96,0,0,0,3,7,229,1,2,0.69621226,502,48,0,54,48,6,4861,4166,695,30,28,2,99.97749775
269d42e923c23835871c9bbc23c4ab0c6007abc4,0,0,0,0,0,0,0,0,0,0,0,0,0,0,143,9,0,0,0,0,0,0,0,0,0,100
3828160625c6617db99d9a640fdb6b84d4f91f4f,2,35,5,30,0,0,0,3,4,2,1,2,1,771,144,10,119,110,9,5864,5633,231,39,36,3,100
2afe9d7f5d277e52928946e7b53267aa5115ae0a,2,142,37,105,0,0,0,3,5,122,1,1,0.689517501,542,117,6,96,82,14,4580,4122,458,44,38,6,100
545f358a11c91c40807855024d0169d59561c83d,20,793,136,657,6,0,6,2,10,57,2,11,3.196013959,1654,58,3,267,202,65,20195,16572,3623,131,81,50,99.3315508
95db8b40e76d07aa4344d7b05f0f0c14ed24f59f,6,66,16,50,0,0,0,3,6,261,1,4,2.025796098,367,35,0,51,42,9,3646,3136,510,30,28,2,100
309d3757df50a2dda0ac4396750e292e76926c5d,2,376,0,376,0,0,0,4,5,6,1,2,0.88832603,798,2,0,163,119,44,7978,5864,2114,45,39,6,99.97793469
40c93527e2a693ec6580dc0d09356dfa3b525aa4,31,2249,54,2195,14,0,14,4,11,21,3,16,3.761926068,2968,49,1,469,322,147,41818,28997,12821,245,170,75,98.81915592
ba9532de39bc7fb455050fea977bd4c543dc8c82,0,0,0,0,0,0,0,0,0,0,0,0,0,0,118,7,0,0,0,0,0,0,0,0,0,100
76947ad528d79fc0c6b924b8337948ed916f3e12,0,0,0,0,0,0,0,0,0,0,0,0,0,0,119,8,0,0,0,0,0,0,0,0,0,100
6017c5974a868f94ef86b9493ee0d244ffd2df65,2,35,39,4,0,0,0,2,4,56,1,2,0.974024864,254,145,8,34,30,4,1614,1579,35,6,6,0,100
2c56a13e53065954a853cc33a19b569b686cb70d,2,40,3,37,0,0,0,3,6,171,1,2,0.99022469,714,146,9,109,103,6,5061,4852,209,58,56,2,100
2ae1f5adf8428832550f99bcc4cc76645597851a,0,0,0,0,0,0,0,0,0,0,0,0,0,0,20,0,0,0,0,0,0,0,0,0,0,100
f03c1c36ed1bce84cf5e1f8746e1cd6799f516c4,1,1,2,1,0,0,0,2,4,18,1,1,0,205,147,8,25,25,0,1389,1408,19,12,12,0,100
9b7bf7cd75197bff009520df77d91bc4d258fcb0,0,0,0,0,0,0,0,0,0,0,0,0,0,0,148,9,0,0,0,0,0,0,0,0,0,100
c642a9558f806b3a49c6cca1aefc4b32799a9a4d,0,0,0,0,0,0,0,0,0,0,0,0,0,0,120,6,0,0,0,0,0,0,0,0,0,100
f9710ebeedbc9fb703a0d466fd1fef5261ab6c31,2,16,17,1,0,0,0,1,2,6,1,2,0.684038436,684,50,2,57,57,0,5698,5752,54,29,29,0,100
695e90401cf371993c7d08e6ab073a928d08cecb,8,79,55,24,0,0,0,3,5,146,1,5,2.583670902,1692,1,0,282,282,0,13786,13537,249,138,138,0,100
87ff7b73b95f1aa1ac3d710ddab7ca67d800562c,0,0,0,0,0,0,0,0,0,0,0,0,0,0,24,1,0,0,0,0,0,0,0,0,0,100
c18faaa94cd9b99bd88612899b5baed897a7681c,22,1298,307,991,1,0,1,5,20,672,2,13,3.235262781,2266,41,0,425,340,85,24342,19590,4752,251,204,47,99.82657706
529ea6cc41051bb7bd0b94ad471dc124d0e00e61,0,0,0,0,0,0,0,0,0,0,0,0,0,0,9,1,0,0,0,0,0,0,0,0,0,100
5f13e14be57e3a4375ae6fe63c8debf3803d6e44,0,0,0,0,0,0,0,0,0,0,0,0,0,0,51,3,0,0,0,0,0,0,0,0,0,100
64490b60f5e270bf10fb07d86f726ec63806a259,2,16,7,9,0,0,0,1,8,26,1,2,0.558629373,715,52,4,104,100,4,6307,6282,25,29,28,1,100
4a074beccb17eadd6c1ef0c3101f040442358643,0,0,0,0,0,0,0,0,0,0,0,0,0,0,121,3,0,0,0,0,0,0,0,0,0,100
e3900c4dbd2dea183d6b7048ffda421d79d5daa9,3,634,153,481,0,0,0,4,10,192,1,3,1.123695994,549,122,4,106,74,32,6574,4069,2505,60,29,31,99.91325092
cd7257e126752dcb5aff1c75d89948565d9dd838,0,0,0,0,0,0,0,0,0,0,0,0,0,0,59,0,0,0,0,0,0,0,0,0,0,100
b005563fe6c7f4555a2dd07d20766976ada0ebf9,3,89,5,84,0,0,0,2,3,38,1,3,1.420025848,743,53,3,90,71,19,6755,6071,684,46,42,4,100
eaae515076ee51be9709753855df35bf204808c1,0,0,0,0,0,0,0,0,0,0,0,0,0,0,60,1,0,0,0,0,0,0,0,0,0,100
a46be91ae68739cc9fbd6af200cad2915b7192d3,0,0,0,0,0,0,0,0,0,0,0,0,0,0,2,0,0,0,0,0,0,0,0,0,0,100
696a454a6c0da0ff68712af56c254cfcd7a94bda,0,0,0,0,0,0,0,0,0,0,0,0,0,0,61,2,0,0,0,0,0,0,0,0,0,100
e2de1caa4d800fa62e34786b788cf9b9c1df9709,0,0,0,0,0,0,0,0,0,0,0,0,0,0,62,3,0,0,0,0,0,0,0,0,0,100
e5d876371e523294598bfdb80a9332fa8917a08f,17,973,64,909,9,0,9,2,12,65,2,12,3.570804204,346,63,4,125,35,90,7533,2688,4845,71,26,45,99.04389396
cc84b6a50620447959c2ded4957a88ab329ba18c,8,526,293,233,0,0,0,3,6,183,1,4,2.004801932,4919,36,0,1066,1047,19,35297,33974,1323,719,707,12,100
0b5a2e7a819c8505658cfe671150cdec053125eb,0,0,0,0,0,0,0,0,0,0,0,0,0,0,1,0,0,0,0,0,0,0,0,0,0,100
ac0e05f0168d8431b9e0a45c0be93f8179ee9e45,0,0,0,0,0,0,0,0,0,0,0,0,0,0,123,2,0,0,0,0,0,0,0,0,0,100
353bc8b3be70c5b3da10ae98445521c31ae16568,2,161,1,160,0,0,0,3,8,198,1,2,0.843758206,436,2,0,94,72,22,4529,3471,1058,39,31,8,100
7b6a3da6d6612e61b3bde33ccf50f0638b6072fa,9,655,19,636,5,0,5,2,2,48,1,4,2.844913904,325,149,0,112,38,74,5510,2063,3447,54,25,29,99.71794315
2fbb98e7da670b0f9170648cf0b8bfe259e7e65f,0,0,0,0,0,0,0,0,0,0,0,0,0,0,64,5,0,0,0,0,0,0,0,0,0,100
0cc0e2ee0748cb88637b26810b016fcae1e594a3,1,11,1,10,0,0,0,2,3,40,1,1,0,190,2,1,26,26,0,1397,1307,90,12,12,0,100
6ffff0299e75664dc36bbd014668a019cd1d00f2,4,64,24,40,1,0,1,2,6,95,1,4,1.769110552,599,150,1,110,107,3,4953,4814,139,45,43,2,95.63802083
d69101a8d10620b04e90ef7f9c1885847bf0111e,0,0,0,0,0,0,0,0,0,0,0,0,0,0,65,6,0,0,0,0,0,0,0,0,0,100
a8fd8ea0c37ffe0fdd87a54e9be9808fba16acfb,3,82,1,81,1,0,1,3,9,226,2,3,0.594747726,456,66,7,78,74,4,5033,4542,491,29,25,4,99.95646495
15d5b7d3ea6b1be3bb5281146810076756cb7daf,1,1,0,1,0,0,0,2,3,41,1,1,0,298,42,0,49,49,0,2235,2233,2,17,17,0,100
3fc8c84b95ce724179bec50e015c892c829e7c5f,0,0,0,0,0,0,0,0,0,0,0,0,0,0,67,8,0,0,0,0,0,0,0,0,0,100
eddbda88e4872479f1a78c3000cc6cf56f3567a6,0,0,0,0,0,0,0,0,0,0,0,0,0,0,54,2,0,0,0,0,0,0,0,0,0,100
b5f4fcd457e2a5fdf8a663bbf4a771ba29ecf43c,0,0,0,0,0,0,0,0,0,0,0,0,0,0,3,1,0,0,0,0,0,0,0,0,0,100
830e5ccf4f68e54d49618ab6a7e881d580d7042e,0,0,0,0,0,0,0,0,0,0,0,0,0,0,4,2,0,0,0,0,0,0,0,0,0,100
b47c9a57260faa006173980a765cd565af7f12dd,0,0,0,0,0,0,0,0,0,0,0,0,0,0,151,2,0,0,0,0,0,0,0,0,0,100
7f3eb2a4c102aac1566ea969c4c1cde4e8942bdc,3,99,46,53,0,0,0,3,10,66,1,3,1.439868363,971,55,1,100,93,7,10586,10319,267,29,29,0,100
d5afb7284d65a8583fbc5f3f627a6460f4ac8284,0,0,0,0,0,0,0,0,0,0,0,0,0,0,10,0,0,0,0,0,0,0,0,0,0,100
bbfe29a9792813f5aedfaa6b6f1d2437f6961333,0,0,0,0,0,0,0,0,0,0,0,0,0,0,11,1,0,0,0,0,0,0,0,0,0,100
39bb856762739ecd2103e3b67eed76d4fb655eaa,0,0,0,0,0,0,0,0,0,0,0,0,0,0,12,2,0,0,0,0,0,0,0,0,0,100
942aaaf2219d58af4d08744b49a90e7cf34b751c,0,0,0,0,0,0,0,0,0,0,0,0,0,0,13,3,0,0,0,0,0,0,0,0,0,100
4ee55702e2cab2d20c05c7f4a6a23d225d8799ad,0,0,0,0,0,0,0,0,0,0,0,0,0,0,0,0,0,0,0,0,0,0,0,0,0,100
67cba8130af3a804e1aa5ccf6ea64c9e9e1a07bf,9,179,82,97,0,0,0,4,15,129,1,8,2.465532129,1559,124,0,178,171,7,15274,15097,177,65,61,4,100
4f7081aa7b572b31ea66a42ba9ce96c8f8ca5c09,5,12,12,0,0,0,0,6,10,688,2,4,2.188721876,687,5,3,113,113,0,4881,4881,0,60,60,0,100
4c908b95b86068bb412daa82f458fc1626d99050,5,15,20,5,0,0,0,3,6,1059,1,3,1.88291419,417,6,4,86,86,0,2760,2809,49,48,48,0,100
fef8833c153fabef597084f4aace8303d9f7116e,0,0,0,0,0,0,0,0,0,0,0,0,0,0,125,1,0,0,0,0,0,0,0,0,0,100
73623ec74232765849f40480add9117da67c11d5,3,168,10,158,0,0,0,3,4,49,1,3,0.464787333,669,68,1,87,84,3,5649,4705,944,30,28,2,100
243ff1f720a5d128e116e6ac8813f503ea2784f8,0,0,0,0,0,0,0,0,0,0,0,0,0,0,5,0,0,0,0,0,0,0,0,0,0,100
32a0a9da89f7480fdc6a15a93eebf8df05fb0ecf,4,145,56,89,0,0,0,2,5,46,1,4,1.454597116,1130,69,1,105,98,7,9492,9134,358,45,41,4,99.54108392
aee018476ab11c1728c69703c545bae56b5a9827,0,0,0,0,0,0,0,0,0,0,0,0,0,0,70,2,0,0,0,0,0,0,0,0,0,100
cc111ec984a78db43c4df222851f59280ff5eff9,54,1968,603,1365,11,0,11,1,21,280,3,17,4.860799791,4982,152,1,653,550,103,51563,45828,5735,432,361,71,98.8263421
ad9851afff3f4b351d26571df651c06b811db1da,0,0,0,0,0,0,0,0,0,0,0,0,0,0,21,0,0,0,0,0,0,0,0,0,0,100
b4aa0859a2a8f7b53d52c7332e5975d443a77ca2,0,0,0,0,0,0,0,0,0,0,0,0,0,0,126,2,0,0,0,0,0,0,0,0,0,100
892aec3573d300b3531be6b5d05ef50b7d4ed710,1,1,0,1,0,0,0,4,18,224,1,1,0,232,127,3,15,15,0,1901,1894,7,11,11,0,100
1cd819a6b6cc4e2c1bb30f4cb9c632f1f2cdac51,2,9,2,7,0,0,0,3,7,10,1,1,0.945660305,498,71,3,11,11,0,6377,6339,38,7,7,0,100
cf6058938cb0c16ec5bc10e0301f3e92cd802af5,0,0,0,0,0,0,0,0,0,0,0,0,0,0,25,0,0,0,0,0,0,0,0,0,0,100
a25de0fc1423a4ba4b931e50c65322ce1511ba08,0,0,0,0,0,0,0,0,0,0,0,0,0,0,26,1,0,0,0,0,0,0,0,0,0,100
1c12e22df03b53981ca8cef426ab26f263f289c0,5,140,2,138,0,0,0,2,4,290,1,5,1.609568469,386,153,1,41,31,10,5411,3842,1569,29,23,6,100
128d4e7a823ae63800c1828908ed33757ca0857d,1,2,2,0,0,0,0,3,8,3,1,1,0,235,15,0,7,7,0,2833,2827,6,4,4,0,100
5243366c48ef8d485af678e7c48b5f34170007b2,0,0,0,0,0,0,0,0,0,0,0,0,0,0,14,4,0,0,0,0,0,0,0,0,0,100
131a15ef73a4c9d2b6568887135dbbed5ba5ebfc,12,1021,243,778,0,0,0,2,12,64,1,7,2.217393999,2509,56,1,409,343,66,25464,21012,4452,170,148,22,99.1416309
cf404f77d16daca5692f6197575bcc56c58fc2a9,7,22,16,6,0,0,0,2,10,654,1,4,2.094024715,644,0,0,108,108,0,3962,3962,0,50,50,0,100
62de8bd8f1dff43a319ae9b58c69876cd23211e7,1,0,6,6,0,0,0,4,13,2,1,1,0,486,57,1,79,79,0,4488,4530,42,28,28,0,100
5c41bf7f39064c31fa12766adbb8b66edfe3bcae,0,0,0,0,0,0,0,0,0,0,0,0,0,0,22,1,0,0,0,0,0,0,0,0,0,100
191d5d84ae5ff9f7c464555c6a1285d9c5a702bf,5,364,227,137,0,0,0,4,7,90,1,3,0.546558299,4438,154,2,1037,1014,23,32435,31804,631,686,676,10,100
2488842bdfc8bf394558be93bc9bb6017759fa57,0,0,0,0,0,0,0,0,0,0,0,0,0,0,6,1,0,0,0,0,0,0,0,0,0,100
e5b0d7c1495c69932261c034e5339eb87c83faad,0,0,0,0,0,0,0,0,0,0,0,0,0,0,15,1,0,0,0,0,0,0,0,0,0,100
383d798c7827e916068f89ff362a6ecccb550241,0,0,0,0,0,0,0,0,0,0,0,0,0,0,128,2,0,0,0,0,0,0,0,0,0,100
358e40bd17d5de2a380a91115eaee9ebd3a453f6,7,171,10,161,1,0,1,1,14,212,2,6,1.742679377,659,72,3,88,81,7,7657,6626,1031,44,39,5,99.59410382
17d1ac348138fe029e4a341c54201fc6b4b50448,0,0,0,0,0,0,0,0,0,0,0,0,0,0,129,1,0,0,0,0,0,0,0,0,0,100
001fb13347c612de6feeaab7de21819ebefef2b6,0,0,0,0,0,0,0,0,0,0,0,0,0,0,0,0,0,0,0,0,0,0,0,0,0,100
f7b0a1602f78b862912117a7c99a115a9db0203c,0,0,0,0,0,0,0,0,0,0,0,0,0,0,130,2,0,0,0,0,0,0,0,0,0,100
c225fc49b3e97b488a3b11770266b7ed5a19e984,0,0,0,0,0,0,0,0,0,0,0,0,0,0,23,1,0,0,0,0,0,0,0,0,0,100
d5b9a96b11355246a2d93ee56a3ead205741545d,0,0,0,0,0,0,0,0,0,0,0,0,0,0,131,3,0,0,0,0,0,0,0,0,0,100
c4c930f7c5ca16972a9edf6c072c67d7b5ac2316,0,0,0,0,0,0,0,0,0,0,0,0,0,0,24,1,0,0,0,0,0,0,0,0,0,100
fd896fbebe9d5e77eb11d1ce953ab2b55cc84387,27,2134,1352,782,3,0,3,1,14,181,2,16,3.179421117,4245,73,1,572,451,121,41973,36176,5797,264,190,74,96.64469742
2d5209ebf7b7876a7da8a3908cb7808f0ad22615,0,0,0,0,0,0,0,0,0,0,0,0,0,0,132,3,0,0,0,0,0,0,0,0,0,100
a6b5eddd10e970c20cd815f6b73aec870aa95be7,1,57,34,23,0,0,0,2,7,1,1,1,0,814,58,0,69,61,8,7509,7383,126,27,27,0,100
fd4a6d16407476366afe339342c2ed0d6d88faf9,2,79,1,78,1,0,1,1,6,109,1,2,0.337290067,68,74,1,12,8,4,978,507,471,10,7,3,99.92493901
768a6fada36bdb03be63052024d59ad3754d616d,14,191,254,63,0,0,0,4,15,37,2,9,2.872078636,3193,75,2,421,430,9,28407,29685,1278,171,179,8,100
4a089900ad477b8e261ab2a2a7d4cafeaec21eca,15,1427,432,995,5,0,5,4,16,31,2,9,3.432160674,1951,133,4,272,239,33,23539,19292,4247,110,85,25,96.58682635
995b20170f460df4fc121fec0f3946857d748426,3,59,15,44,0,0,0,2,9,74,1,3,1.17309918,729,134,5,94,94,0,5791,5612,179,41,41,0,96.94488818
8022f2c8c4e9018a15a4f04d0a66f8bc0ea653c3,3,51,0,51,0,0,0,1,10,27,1,3,1.489352812,393,76,3,28,24,4,4685,4258,427,18,16,2,100
59fe1b453279bf5c7df627ea656c762b3a98e777,1,226,0,226,0,0,0,5,8,422,1,1,0,617,25,1,33,29,4,12390,10033,2357,32,28,4,100
a1408d787f740f6abc78842898bc1ab819def7d7,0,0,0,0,0,0,0,0,0,0,0,0,0,0,135,4,0,0,0,0,0,0,0,0,0,100
d07833a25470bafafdeee5e9e4054cb4a013bedb,0,0,0,0,0,0,0,0,0,0,0,0,0,0,16,0,0,0,0,0,0,0,0,0,0,100
0f8a323ddabf93617da514ccba66ea8a408893bd,0,0,0,0,0,0,0,0,0,0,0,0,0,0,37,0,0,0,0,0,0,0,0,0,0,100
5a1bb67849054708db880bec72d6dc813d642859,0,0,0,0,0,0,0,0,0,0,0,0,0,0,7,0,0,0,0,0,0,0,0,0,0,100
f08440481bb95e135e59deadc6f6fd35775c66a2,1,0,130,130,0,0,0,2,2,818,1,1,0,105,136,3,0,15,15,0,894,894,0,1,1,99.92488263
c749b51730f7fd24a900da31c3fe2072a54086bc,6,1601,548,1053,1,0,1,1,8,90,1,3,2.1118992,3963,21,0,1134,982,152,30473,25599,4874,746,636,110,99.96243426
05cb59b4fcacf558df1653fca82aad4fc9a42437,0,0,0,0,0,0,0,0,0,0,0,0,0,0,137,3,0,0,0,0,0,0,0,0,0,100
548617185d58224dd74a2345be03d3f9af35b2a1,2,341,0,341,2,0,2,1,1,0,1,2,0.919270251,0,1,0,32,0,32,1791,0,1791,17,0,17,99.9249531
e9729269d7511134ff40ccee1312f1df3632a2cb,0,0,0,0,0,0,0,0,0,0,0,0,0,0,138,4,0,0,0,0,0,0,0,0,0,100
25214225923e16b21d9fdf4ae7f522738aee2649,3,5,5,0,0,0,0,2,3,315,1,1,1.521928095,611,26,1,115,115,0,3576,3576,0,23,23,0,100
0caa9cd2be4d8223019c0721dfb745e3d211c9b8,0,0,0,0,0,0,0,0,0,0,0,0,0,0,8,1,0,0,0,0,0,0,0,0,0,100
b43b3cc3cd78fcd35351650d895655488c230554,11,830,226,604,6,0,6,2,12,89,1,4,2.637984565,1329,139,4,238,205,33,12146,10717,1429,144,114,30,99.73836666
43bbab8f5a5afc4c76d655fc8930d7d458fc818a,0,0,0,0,0,0,0,0,0,0,0,0,0,0,38,1,0,0,0,0,0,0,0,0,0,100
2e78df67c12a6fcad726551128e9753ad36d5ee9,0,0,0,0,0,0,0,0,0,0,0,0,0,0,27,1,0,0,0,0,0,0,0,0,0,100
610540ef034b7bd2555acb347f5c9be20a485954,3,156,0,156,2,0,2,1,5,441,1,2,0.998759299,23,5,0,11,4,7,961,124,837,7,3,4,97.76133561
37587689e9feadeb54465aa7319f114a4e11255b,0,0,0,0,0,0,0,0,0,0,0,0,0,0,155,0,0,0,0,0,0,0,0,0,0,100
6ca08b9f598b649d60c6b6468164a374b7f6f555,1,2,1,1,0,0,0,2,2,858,1,1,0,15,1,0,1,1,0,129,108,21,1,1,0,100
d9ed1bad1f5b2e2471fbea11353f2947f7f52e13,0,0,0,0,0,0,0,0,0,0,0,0,0,0,140,3,0,0,0,0,0,0,0,0,0,100
c4cee6af64eda4db4da3eff86abab7d4ae4ec56a,0,0,0,0,0,0,0,0,0,0,0,0,0,0,43,0,0,0,0,0,0,0,0,0,0,100
d446da8e707b1069576b049452484e088a3eeede,0,0,0,0,0,0,0,0,0,0,0,0,0,0,141,2,0,0,0,0,0,0,0,0,0,100
adb024070d5d098909fb3800875d0042aeb27c92,0,0,0,0,0,0,0,0,0,0,0,0,0,0,39,1,0,0,0,0,0,0,0,0,0,100
3f0b1b7b4a002d3f364bd2aee7b5921c0435c4a4,7,685,0,685,7,0,7,1,1,0,1,2,2.642410526,0,156,1,82,0,82,3152,0,3152,39,0,39,99.69207082
196da12c43337d019a52b99bf6178fbda45f886d,0,0,0,0,0,0,0,0,0,0,0,0,0,0,142,2,0,0,0,0,0,0,0,0,0,100
76bed5d754fcf358809f0be7a034758b9b20fc5e,6,101,36,65,0,0,0,2,14,578,1,4,2.247285142,752,157,2,64,55,9,6303,5874,429,45,43,2,100
3612a89216bd57c40a1bc3e27853c6146b471e1e,0,0,0,0,0,0,0,0,0,0,0,0,0,0,40,1,0,0,0,0,0,0,0,0,0,100
fc8723e461d655e315d0b51acd1a31f82b4efd1f,0,0,0,0,0,0,0,0,0,0,0,0,0,0,143,3,0,0,0,0,0,0,0,0,0,100
0518408513ed54df8dbe234027b353bed2e61943,0,0,0,0,0,0,0,0,0,0,0,0,0,0,27,0,0,0,0,0,0,0,0,0,0,100
3b10f84cc49993a1c5917f54be6ca313c8d780c4,0,0,0,0,0,0,0,0,0,0,0,0,0,0,59,0,0,0,0,0,0,0,0,0,0,100
2d9d7a5f6302267edafba772268145e76751795c,0,0,0,0,0,0,0,0,0,0,0,0,0,0,60,1,0,0,0,0,0,0,0,0,0,100
8a61b96b6b01b247a8ff8d800730378b8da23471,0,0,0,0,0,0,0,0,0,0,0,0,0,0,28,1,0,0,0,0,0,0,0,0,0,100
01c26a77b1041204b0bbbc544cc0a5d02e9339a8,0,0,0,0,0,0,0,0,0,0,0,0,0,0,144,2,0,0,0,0,0,0,0,0,0,100
3381b853dca1c08a7a083593045dec2c7d4d92db,0,0,0,0,0,0,0,0,0,0,0,0,0,0,29,2,0,0,0,0,0,0,0,0,0,100
9108072756b6ffeedade985d3cd52ef7338cd61a,2,42,23,19,0,0,0,4,8,154,1,2,0.871683617,253,77,0,31,30,1,2124,2089,35,7,7,0,100
0996b7348eca14fea1b1b3c4dd57861b3a30bdeb,16,1018,5,1013,15,0,15,3,4,6,2,3,3.756628479,164,158,0,133,33,100,5945,1000,4945,50,7,43,99.39047619
e821391895f0f3523b4e05ae5d639c13b0113855,25,1168,1829,661,2,0,2,3,17,336,2,18,3.342922074,4948,44,0,508,603,95,41948,44506,2558,217,312,95,99.48873319
c559ed7e1838ec71344eae3d9e37771db2641635,2,246,0,246,2,0,2,1,1,0,1,2,0.947435136,0,159,1,25,0,25,1480,0,1480,11,0,11,99.88647114
6f869ae55addc884e6734bef72c854db478b6ee4,0,0,0,0,0,0,0,0,0,0,0,0,0,0,45,1,0,0,0,0,0,0,0,0,0,100
43243758cedee803ef610b74b4f42b4ec1d7a1c6,1,2,1,1,0,0,0,2,3,313,1,1,0,72,2,0,6,6,0,655,634,21,3,3,0,100
e127797e63ecd3af2d9aa8fc062e36e28015aac6,3,151,0,151,3,0,3,1,1,0,1,2,1.582202756,0,160,2,14,0,14,513,0,513,5,0,5,99.86784973
55a737921348514ad7a7d9fab86d169c3b6c3304,0,0,0,0,0,0,0,0,0,0,0,0,0,0,61,2,0,0,0,0,0,0,0,0,0,100
2dd01b17782af7756776b8e07afe3661ac19bb0a,48,4638,974,3664,33,0,33,1,11,98,2,13,4.921681669,2697,145,1,560,338,222,33085,20514,12571,389,183,206,88.48589522
6afd95fabf870424177384538ce4685e77fa585c,6,55,48,7,0,0,0,2,9,486,1,5,1.726189656,987,78,1,61,61,0,10774,10413,361,41,41,0,100
5d3e73ab95adf0c8f49c3f821975740e365df91a,26,1654,301,1353,16,0,16,2,6,309,2,7,4.013986446,953,161,3,269,115,154,14014,7065,6949,151,50,101,95.75733545
a262f87f0c31637d76a77a538976673c87188eeb,5,212,21,191,2,0,2,4,14,274,2,4,1.700476824,598,162,4,90,75,15,5276,4382,894,34,28,6,99.81913183
7aa08aef118de330e610cd45d3ac66ed7327439d,1,19,3,16,0,0,0,3,5,24,1,1,0,163,163,5,37,33,4,1050,979,71,8,7,1,100
0df6678c87b550fa2dcec81d0fef1af5a1c20a37,0,0,0,0,0,0,0,0,0,0,0,0,0,0,46,2,0,0,0,0,0,0,0,0,0,100
0cd4a8300dc56e97bfa1adb6c68a7e1585c7ccea,0,0,0,0,0,0,0,0,0,0,0,0,0,0,62,1,0,0,0,0,0,0,0,0,0,100
4bb6d836a6e2dc0f7ab751ca1093aa95905723f6,0,0,0,0,0,0,0,0,0,0,0,0,0,0,3,1,0,0,0,0,0,0,0,0,0,100
01b8e7ab2c55a925240f1465c938db8600eeb944,4,221,99,122,1,0,1,5,17,112,1,3,1.579006088,466,164,5,78,64,14,4368,3825,543,32,21,11,99.91974318
173ce5084dba9fbead2f690075c58c5daaf29e7f,0,0,0,0,0,0,0,0,0,0,0,0,0,0,47,1,0,0,0,0,0,0,0,0,0,100
9d582eacd670908ef076da0cef4bd9f566c892c8,0,0,0,0,0,0,0,0,0,0,0,0,0,0,48,2,0,0,0,0,0,0,0,0,0,100
40411d4bdbb729d0e38e69a15a06970738a4b969,0,0,0,0,0,0,0,0,0,0,0,0,0,0,49,3,0,0,0,0,0,0,0,0,0,100
acb8b9287e8b6a2a0ced60855f0e5d6e6c343062,1,30,24,6,0,0,0,3,5,275,1,1,0,108,50,4,3,3,0,1454,1418,36,3,3,0,100
35d81cb9d1e7cac9d13b64bc3baaf6f6b3354d82,4,94,363,269,0,0,0,5,11,128,2,3,0.947940544,1180,79,1,50,57,7,10476,13133,2657,34,31,3,100
24822dddc68c264f59723f5e17d423cd497f6807,0,0,0,0,0,0,0,0,0,0,0,0,0,0,146,1,0,0,0,0,0,0,0,0,0,100
a421df228b66d2100c29c2adee4248f35a70cafb,1,2,7,5,0,0,0,4,5,428,1,1,0,256,4,1,15,15,0,2350,2381,31,15,15,0,100
92c2e22e6cd50c122c9da1e8f6190a812eb01efb,1,2,1,1,0,0,0,2,2,989,1,1,0,20,5,2,1,1,0,153,137,16,1,1,0,100
878003a3caf55380bd9e5898a9abe848586a278b,40,169,147,22,0,0,0,4,31,385,3,31,4.574839126,7824,165,4,1163,1151,12,63942,64098,156,523,515,8,100
6f2679919a9e6c9f3a146d52b10c6dbe2ce55180,0,0,0,0,0,0,0,0,0,0,0,0,0,0,147,1,0,0,0,0,0,0,0,0,0,100
0c6aad8c7c7affd6c898e1dd7663833a71ba63de,0,0,0,0,0,0,0,0,0,0,0,0,0,0,41,0,0,0,0,0,0,0,0,0,0,100
9be0d858452ebc836e812d665c55a5481fa6fea2,2,55,0,55,0,0,0,2,3,571,1,2,0.929942935,116,0,0,23,17,6,1357,920,437,6,4,2,100
a285b83ee0153cecf24132b4aed70250040a83b0,0,0,0,0,0,0,0,0,0,0,0,0,0,0,148,2,0,0,0,0,0,0,0,0,0,100
1c9437c41c4eb626bd44193ec6545f9356f3f7b2,0,0,0,0,0,0,0,0,0,0,0,0,0,0,9,0,0,0,0,0,0,0,0,0,0,100
08745719120fd8d42e36c728a405966ad64f20b7,0,0,0,0,0,0,0,0,0,0,0,0,0,0,1,1,0,0,0,0,0,0,0,0,0,100
644e951c8b2c33b5e52602a814d91012c3b325b1,6,40,4,36,0,0,0,3,18,369,2,6,1.734619401,782,166,2,128,121,7,6229,5946,283,73,71,2,100
124becd1a35d00e620d4eaed5d5d84c0abbe8ba9,0,0,0,0,0,0,0,0,0,0,0,0,0,0,42,1,0,0,0,0,0,0,0,0,0,100
567d106b1fbe86e828f3c4068024df42b2f4ddc0,0,0,0,0,0,0,0,0,0,0,0,0,0,0,63,1,0,0,0,0,0,0,0,0,0,100
23113a6337a3fc4d0bfbb708303b30bf8122f23f,20,2206,933,1273,11,0,11,3,18,42,1,10,3.614718415,1832,80,1,314,205,109,25389,17423,7966,164,99,65,99.28158052
3d3c43c716b0a6d58b57d6d5ba83109bc49661e4,20,933,2206,1273,0,0,0,3,17,74,1,9,3.614718415,2732,80,1,205,314,109,17423,25389,7966,99,164,65,99.28158052
c26abbbaeaeea3551e218cb9aa8ba97b32655958,3,62,51,11,0,0,0,1,2,20,1,3,1.155627176,445,43,2,67,36,31,3047,2041,1006,38,32,6,99.79939819
c5b6a6f27c36856a07597f512115baa975b5ad74,23,2257,995,1262,11,0,11,1,18,80,2,13,3.746940078,2290,51,4,379,253,126,28301,20492,7809,202,141,61,99.08183633
06305052a186ff911d204c755804e7225d05bf28,23,995,2257,1262,0,0,0,1,17,67,2,12,3.746940078,3177,149,3,272,360,88,20470,28199,7729,137,206,69,99.08183633
fcff0596c7d2b2546d89283fb90fbc8c10b31f1f,10,221,126,95,0,0,0,3,14,613,1,7,2.60322569,1254,6,2,162,142,20,12913,12055,858,97,92,5,99.95987159
38b7d5e339320e71cd4d35d31b8d118a3e6d0be7,0,0,0,0,0,0,0,0,0,0,0,0,0,0,51,4,0,0,0,0,0,0,0,0,0,100
f525dcfd75056554c96ad759559ebff628e2fb5f,40,2917,1246,1671,14,0,14,1,19,136,3,26,4.351772,4041,167,2,672,511,161,46595,36653,9942,369,286,83,98.90416418
67d6c0edd731f528af759ca11de875cbf77f6b2c,13,283,177,106,0,0,0,1,14,476,2,10,3.051933941,1699,168,3,229,178,51,15960,14096,1864,135,124,11,99.76251732
31f3aa8cb0f4c3821c264e375aa14eda207adcb0,27,942,2719,1777,0,0,0,1,17,106,1,15,3.949004006,3532,150,4,301,465,164,20671,31628,10957,147,239,92,99.14308489
e5f24f7bdce6a119adb8be543752d458f721d48d,0,0,0,0,0,0,0,0,0,0,0,0,0,0,28,0,0,0,0,0,0,0,0,0,0,100
48d9d25696a71ff07791b86348dc978db7a56a9d,0,0,0,0,0,0,0,0,0,0,0,0,0,0,52,1,0,0,0,0,0,0,0,0,0,100
fa86663ecdb166f889c9c0c4c34373aec68dbd30,0,0,0,0,0,0,0,0,0,0,0,0,0,0,10,1,0,0,0,0,0,0,0,0,0,100
9b25084c83e484b8119caf134a473fcb6306fa6a,27,2729,952,1777,14,0,14,2,19,106,1,16,3.940904583,2237,169,4,465,301,164,31628,20671,10957,239,147,92,99.14308489
8cc8aab8b7c5fb103c4375f47d47754492547bb1,5,401,114,287,0,0,0,4,12,559,1,4,1.602274615,508,170,5,107,70,37,6130,4193,1937,58,37,21,99.86160538
15b98dea48d9cab327f00a3a6a3e2117c0bbd214,29,1030,3094,2064,0,0,0,1,17,110,1,16,4.143395998,3939,0,0,317,518,201,22141,35035,12894,159,272,113,99.02468153
e59059bd9707a6ca46c4137d796b8f2943f06b43,4,26,26,0,0,0,0,1,11,199,1,4,1.816819471,795,167,0,136,131,5,6493,6477,16,70,69,1,100
fa5cff2c3534c5d30f265b0118faffe971e5063b,0,0,0,0,0,0,0,0,0,0,0,0,0,0,3,0,0,0,0,0,0,0,0,0,0,100
5f08ba0b1dbe6ba19e8525055f639ecdb85291fc,2,699,125,574,0,0,0,3,5,679,1,2,0.971935791,201,1,0,135,11,124,8934,2000,6934,15,6,9,100
e265b369192613335335514bc842f6aebe016d3e,4,51,2,49,0,0,0,4,6,397,1,4,1.422003249,469,7,0,44,40,4,4519,4227,292,30,28,2,99.9397953
b48ab93c65f04a7e25f1c0de20c260582fed30bc,0,0,0,0,0,0,0,0,0,0,0,0,0,0,11,0,0,0,0,0,0,0,0,0,0,100
1006d9d6e473d56d5ada2e7ff3011b98f047ec7c,29,3103,1039,2064,14,0,14,2,19,165,1,17,4.136070496,2391,3,0,519,318,201,35128,22234,12894,273,160,113,99.02429311
84cac7e85f6b8421063f329d647be9bc82ea5f4c,0,0,0,0,0,0,0,0,0,0,0,0,0,0,82,0,0,0,0,0,0,0,0,0,0,100
9b4b40278086b881803a8c82e7eebb47d83847f7,29,1030,3094,2064,0,0,0,1,17,99,1,16,4.143395998,3945,151,0,318,519,201,22234,35128,12894,160,273,113,99.02429311
e22479e62fab2ae64de1ab803e0f9f0a5fab98b3,29,1456,890,566,8,0,8,4,18,252,2,16,4.152747168,2671,81,0,497,413,84,27744,23233,4511,235,198,37,98.97959184
7b68f188185b0eb6b3b0b70f98ce6b36bb22c46f,0,0,0,0,0,0,0,0,0,0,0,0,0,0,8,1,0,0,0,0,0,0,0,0,0,100
486be49e71f3db4d9934dfa1af3e222078df09dd,0,0,0,0,0,0,0,0,0,0,0,0,0,0,0,0,0,0,0,0,0,0,0,0,0,100
1d95b8316a18097747be116a0276c56b894fb79c,21,1522,147,1375,11,0,11,1,22,450,1,8,3.500590629,1246,168,0,303,194,109,16200,10317,5883,135,80,55,96.4622188
9fb0d06e644597032da58c5df020a841b93d19c0,5,9,9,0,0,0,0,3,23,390,1,1,2.281036113,584,169,1,97,97,0,4474,4474,0,43,43,0,100
abb152b83631001ad067849dfaefd2d4e3b0cdb4,6,44,57,13,0,0,0,2,23,476,2,4,2.17389535,1081,170,2,136,136,0,8537,8618,81,61,61,0,100
a7a41a55aa79b7fa3f64c51a4d968f011e8b11d1,85,4136,4050,86,17,0,17,1,21,119,3,41,5.516130873,8110,83,1,1208,1168,40,73423,70243,3180,592,564,28,94.79425837
cdbe7ac1f291c8d5be505973aaf01aa1d8a91920,2,128,3,125,1,0,1,2,3,43,1,1,0.233828262,255,84,2,58,39,19,2912,2329,583,28,13,15,99.88149319
8bc7732e4c904085e4f78469abded84635971632,87,4031,4292,261,18,0,18,2,23,242,3,40,5.562479173,8756,171,3,1201,1228,27,71974,75136,3162,573,609,36,94.68044393
03a4aa3846773065d51086167a28fb4c37d7b2a9,0,0,0,0,0,0,0,0,0,0,0,0,0,0,29,0,0,0,0,0,0,0,0,0,0,100
37662d3bd8a4162bef4474be7ab60a2fabbe3e2f,2,43,1,42,0,0,0,1,2,24,1,2,0.510787823,272,172,4,37,34,3,2588,2361,227,13,12,1,97.37140696
26c5d3065bd7a635699083e8131d4a7629bf3b4d,0,0,0,0,0,0,0,0,0,0,0,0,0,0,173,5,0,0,0,0,0,0,0,0,0,100
e69ce213aaad84fd49d972c329a4bf4bf7d4b2ad,0,0,0,0,0,0,0,0,0,0,0,0,0,0,30,1,0,0,0,0,0,0,0,0,0,100
85d12475cf363f0b9d6bdd973ec9860550f73980,1,15,3,12,0,0,0,2,2,1121,1,1,0,72,44,0,7,5,2,884,824,60,5,5,0,100
9c5d9d76644fc07bae36644906f52e0422f33d0e,5,377,53,324,2,0,2,3,4,639,1,5,1.72226411,143,45,1,41,23,18,3116,1194,1922,20,10,10,99.86520316
52dd9fb852bef5998dac83109ac6e122860be489,2,15,1,14,0,0,0,1,2,188,1,2,0.543564443,197,152,1,22,21,1,1371,1310,61,17,16,1,100
e3eeec38a66e1f10c296c110d47bc8bc3e995629,0,0,0,0,0,0,0,0,0,0,0,0,0,0,153,2,0,0,0,0,0,0,0,0,0,100
46ad9d93b4385da0f8668f2ba84212d54d00ba4b,21,1892,0,1892,21,0,21,1,1,0,1,7,3.861933033,0,174,6,161,0,161,10610,0,10610,69,0,69,98.7077157
3083b471fe912bc74d27017834e6c80ff177680e,45,3278,690,2588,14,0,14,6,22,418,2,13,4.650495202,3257,154,2,499,373,126,29234,24716,4518,369,271,98,95.49963262
5ed9631a2936ec60d0ea6557ca4396cffdadc688,0,0,0,0,0,0,0,0,0,0,0,0,0,0,175,7,0,0,0,0,0,0,0,0,0,100
f715d6dbaf7ab4272c2e51430f4da13c8f688916,161,5034,9637,4603,18,0,18,1,21,94,5,69,6.489670856,14935,85,2,1666,1893,227,100623,114688,14065,905,1026,121,92.67833616
9e95d4b61410c8033f0a4ea51e831566d5d933d3,162,9545,5106,4439,50,0,50,1,23,254,5,68,6.487219246,12461,155,3,1929,1628,301,117119,98812,18307,1045,881,164,92.67833616
19b237de27eed37ee87eca6d8e2198083fdb88d7,1,6,4,2,0,0,0,6,19,84,1,1,0,534,9,0,94,93,1,4609,4601,8,38,38,0,100
0d847cf5f91dc0d3b3b6838eb4b4de4aa2cf2fec,2,23,10,13,0,0,0,7,32,347,1,2,0.999337504,665,16,0,65,61,4,6231,6076,155,29,28,1,100
0ab39a32b61104812a6a9e69e999e7053e3e7e90,0,0,0,0,0,0,0,0,0,0,0,0,0,0,53,0,0,0,0,0,0,0,0,0,0,100
ab4f8e65e13aaea3a10491290a7411b3b6dc955e,8,474,57,417,4,0,4,1,3,119,1,5,2.824562267,710,156,0,109,85,24,6528,5084,1444,82,63,19,99.76639712
46bc63dbcfe9f0ddabfd4821958962a2dac9378e,8,308,379,71,0,0,0,4,23,155,2,7,2.23694395,1578,157,1,177,201,24,10867,11698,831,129,133,4,99.94611101
3ba9ae25126bc393e3b9307f4ffe63ac66a909f4,3,70,4,66,0,0,0,1,23,81,1,3,0.873637455,783,176,0,90,88,2,7222,6930,292,35,34,1,100
a8b555dcc9f548d7b91789a46d9435b4d8b17581,7,257,58,199,1,0,1,2,20,537,2,6,2.439605875,1009,1,0,183,167,16,9325,8528,797,75,67,8,99.96408046
ed50d48bb47cf3f301884f6e18fe4efc8c1b91f1,1,11,40,29,0,0,0,5,24,9,1,1,0,324,158,2,50,52,2,2049,2143,94,32,34,2,100
438893b78c852e34d7edb965840500a78503d299,0,0,0,0,0,0,0,0,0,0,0,0,0,0,12,0,0,0,0,0,0,0,0,0,0,100
62d1a1bf7e8b9b3ee2f260c358719ea5080c9045,7,358,76,282,1,0,1,1,21,46,1,3,1.915251274,694,159,3,83,72,11,5540,4583,957,59,48,11,99.8925309
ea6992fd943c552c41565c7a320804cb58b733bd,0,0,0,0,0,0,0,0,0,0,0,0,0,0,46,0,0,0,0,0,0,0,0,0,0,100
eb5b2d42b83901c05c15e00b9c3c5bce5dd72ab9,2,7,3,4,0,0,0,2,5,154,1,2,0.970950594,281,177,1,34,35,1,2158,2108,50,21,22,1,100
7ef4b7703e75538f96764cb3efafe8db5afba126,192,6726,11053,4327,28,0,28,0,31,93,5,84,6.791870684,17781,86,0,2014,2210,196,127539,137826,10287,1108,1229,121,92.21433906
53124d97d09baafcf6d84eb291f6a3828289ec7c,193,10966,6803,4163,58,0,58,1,32,229,5,83,6.788973834,15637,6,0,2232,1991,241,138617,127332,11285,1237,1096,141,92.21433906
bfe90ef1e579be53a14d9fd0e4dc19fc6a81baf0,2,62,14,48,0,0,0,6,15,530,1,2,0.913847287,405,178,2,42,38,4,3944,3604,340,23,20,3,100
f8b7c5852310a088bd15ca5d21ba4f98b51521be,0,0,0,0,0,0,0,0,0,0,0,0,0,0,160,4,0,0,0,0,0,0,0,0,0,100
1d3e7fcd7db64e7cb6d986802240fcbae174ae91,0,0,0,0,0,0,0,0,0,0,0,0,0,0,10,1,0,0,0,0,0,0,0,0,0,100
3fcbf8b4e4e38f9c50842b8af857092b091c7c40,2,65,10,55,0,0,0,2,5,584,1,2,0.970950594,221,179,3,42,36,6,2148,1809,339,19,16,3,100
82212ba818a0ef3b92505e8d144487c69a8d4a44,2,110,22,88,0,0,0,2,24,72,1,1,0.995856066,495,161,5,56,52,4,4716,4437,279,26,22,4,98.99168583
08252f59b2df1f4ef149b899c944f6a8a0aa049e,0,0,0,0,0,0,0,0,0,0,0,0,0,0,54,1,0,0,0,0,0,0,0,0,0,100
daf543b10423c2cfc2b740e39647ef4eb3863872,0,0,0,0,0,0,0,0,0,0,0,0,0,0,64,0,0,0,0,0,0,0,0,0,0,100
e0949142dd682a84e59fea09066de8024f106f13,0,0,0,0,0,0,0,0,0,0,0,0,0,0,55,2,0,0,0,0,0,0,0,0,0,100
a41611b1ae2bb17fa9333ef6f965749652e95538,0,0,0,0,0,0,0,0,0,0,0,0,0,0,56,3,0,0,0,0,0,0,0,0,0,100
b5bf9a98725f866a7fee6470a8e763d17cc69ffd,6,311,52,259,0,0,0,1,10,239,1,2,2.13255817,425,162,4,97,86,11,3186,2474,712,81,65,16,100
37e3fd32c256ddc129eb7c1363d78e9095a39748,5,853,453,400,0,0,0,4,14,415,2,5,1.741518843,1366,163,4,261,257,4,11400,10991,409,146,123,23,99.28683249
1c5435ccbe96c03e59c6a18d681da43561769dba,7,345,9,336,2,0,2,1,33,358,2,7,2.163050074,802,180,3,234,193,41,8186,6428,1758,100,81,19,99.32114883
2b4f0b84062d65f9400421d66ec3b7d6d093bebf,5,159,17,142,2,0,2,1,8,424,1,3,1.483477312,230,181,4,66,56,10,2476,1771,705,27,25,2,99.75584234
f8d7843e93e410147257cca40d83b2c2d4963f1b,214,7343,12971,5628,28,0,28,0,31,99,5,94,6.934016011,21013,87,0,2541,2804,263,149333,163859,14526,1356,1535,179,90.77178118
d0a4e4c0f15d6b05371e97be19177729b1b33243,178,11878,2977,8901,63,0,63,1,33,270,5,80,6.642477751,14531,89,1,2663,2039,624,153675,116048,37627,1466,1080,386,91.98173516
832296f0d4615bf95aed1c0742362c6127bd733a,5,178,73,105,0,0,0,2,16,130,1,4,1.723421847,1142,65,0,106,103,3,12371,11999,372,57,55,2,100
3bb926df5d253a907bbf8dab4b76b78dd32993ea,50,1725,5002,3277,0,0,0,4,20,130,2,27,4.960946213,7229,164,2,618,981,363,38735,61572,22837,346,521,175,98.76118376
ac05638160288b32535b986adbeb8f14e594e740,4,26,8,18,0,0,0,2,16,372,1,2,1.620642776,158,82,0,11,10,1,1483,1313,170,8,7,1,100
1b1a45b7e9c2b8c451f970028b4fe310ef9b7894,0,0,0,0,0,0,0,0,0,0,0,0,0,0,0,0,0,0,0,0,0,0,0,0,0,100
ca4644ba5e94c579fed6a7c7d1e8bea05fe9ba9c,0,0,0,0,0,0,0,0,0,0,0,0,0,0,0,0,0,0,0,0,0,0,0,0,0,100
d7edce974341a6fca0e8e87b11baed5ad0d5d0c1,4,110,21,89,1,0,1,2,3,387,2,3,1.771095465,279,11,0,38,32,6,2190,1896,294,19,17,2,99.01281607
a17c1adfd4cca63a49ef542c21cef90b18c74be0,0,0,0,0,0,0,0,0,0,0,0,0,0,0,65,0,0,0,0,0,0,0,0,0,0,100
b9453aabd781c7c67258d9506af176fbcab85be1,1,231,84,147,0,0,0,7,16,26,1,1,0,145,57,0,25,9,16,2139,1400,739,16,5,11,99.86197378
9ce4ba5a9c8febc3a3ed6992f73f99396d7248a9,15,454,39,415,1,0,1,4,21,369,3,8,2.941731815,1464,165,1,246,233,13,11067,9702,1365,164,152,12,94.08082976
20eaed239b2552d0823d34f571b63d941c352bc9,5,298,26,272,3,0,3,2,3,349,1,4,2.253752501,278,58,1,38,25,13,3302,2108,1194,25,17,8,99.81416094
4458085f2a0302084f44cbbf785c0629ad21919f,0,0,0,0,0,0,0,0,0,0,0,0,0,0,66,1,0,0,0,0,0,0,0,0,0,100
bc16e68252de98846bba58aafb2d7d445caac9c1,77,5159,2818,2341,21,0,21,1,23,236,4,41,5.370593996,7426,66,0,1282,967,315,76884,57491,19393,715,573,142,92.21056376
a99cadb018b96cf96955df4b6e4acade28530a41,77,2804,5181,2377,4,0,4,2,21,204,4,40,5.373227975,9440,0,0,967,1282,315,57516,76957,19441,573,715,142,92.21056376
71a015fabc47b23ea0c5400fa239fee9f5c0d194,3,91,20,71,0,0,0,2,13,219,1,3,1.304144763,542,8,0,42,38,4,6276,5764,512,26,24,2,99.8515219
eb3366656de643e7436f7cf280561b94f3921c65,41,4627,1048,3579,23,0,23,2,23,175,2,20,4.659262487,2529,9,1,654,343,311,45986,23143,22843,359,178,181,98.84041966
4116b99070849ffefd3b9b00ed7f4df2078594e7,43,1105,4630,3525,0,0,0,1,20,82,2,20,4.699795174,6533,83,0,514,817,303,35604,58017,22413,240,420,180,98.84041966
e25031905a3c85aeadd2063486abaa38c94a1eb4,4,68,7,61,0,0,0,1,13,230,1,4,1.600759715,1738,84,1,235,229,6,15644,15246,398,93,92,1,100
49f851e0b8c2ffa1cdd7c8f169bed3dfa07cf35c,85,9938,3196,6742,49,0,49,2,24,145,2,30,5.511625992,6208,69,3,1312,783,529,93012,54156,38856,693,370,323,95.13839603
1304582ed5aac68fa679e16b7df41dc064f7f93d,85,3199,9941,6742,1,0,1,1,20,59,2,30,5.51173784,11431,67,2,783,1312,529,54156,93012,38856,370,693,323,95.13839603
bc06f71d8ca43532c32da8b3273956198658b197,0,0,0,0,0,0,0,0,0,0,0,0,0,0,68,2,0,0,0,0,0,0,0,0,0,100
7dad389eeb68bbded4a52843ff3ccf56fd1606a5,0,0,0,0,0,0,0,0,0,0,0,0,0,0,69,3,0,0,0,0,0,0,0,0,0,100
7a071f6d64794267f40a0ef1810bd7deaf044eeb,87,10088,3197,6891,50,0,50,2,24,165,2,32,5.536082704,6218,91,0,1322,783,539,94113,54226,39887,700,370,330,97.2796518
7be65162a7e80111a7fed9d95a6fad3b8e93b7d9,87,3201,10092,6891,1,0,1,1,20,59,2,32,5.536220962,11566,1,0,783,1322,539,54226,94113,39887,370,700,330,97.2796518
5303c5ead73a4f07a4f5f56ce61c7385dbc74d24,0,0,0,0,0,0,0,0,0,0,0,0,0,0,166,1,0,0,0,0,0,0,0,0,0,100
c14c7869228132ad6e6cae8b9914f669ac6b489d,2,253,85,168,0,0,0,2,2,102,1,2,0.985403027,155,167,1,34,34,0,1914,1367,547,21,15,6,99.96289425
3a3bba47c2c96f10d781b03e1573ce63acbcf3cd,18,572,78,494,3,0,3,6,19,464,1,9,3.109368296,1272,168,2,225,203,22,11044,10010,1034,125,108,17,99.59221501
63cd4143345002e152b731e533a689eb6d308f5d,0,0,0,0,0,0,0,0,0,0,0,0,0,0,85,2,0,0,0,0,0,0,0,0,0,100
acab9436d028cf047e21948f604f5dab1507a983,11,78,26,52,0,0,0,3,10,464,3,8,3.13673554,2107,182,0,234,226,8,16703,16254,449,168,167,1,99.87037037
39e22fa1b343b08fe2dcb0debdb78df5e3909a0a,2,422,110,312,0,0,0,4,8,953,1,2,0.990805075,344,169,3,61,40,21,3426,2427,999,38,27,11,99.96297668
0eeb3a3794b471b029aee2f6fb936206168c0486,0,0,0,0,0,0,0,0,0,0,0,0,0,0,86,2,0,0,0,0,0,0,0,0,0,100
9348c608175afd311177b82fe31737f2f984c175,119,10405,4624,5781,48,0,48,2,24,126,4,50,5.853197115,10261,70,1,1787,1313,474,121880,85293,36587,1003,712,291,96.66727042
939eb73bce9cd7f7af58d95e9201fc08d2f9b92e,118,4532,10465,5933,4,0,4,3,20,156,4,48,5.841474657,15175,170,4,1298,1786,488,84727,122074,37347,707,1002,295,96.66727042
dbcc52cd658a07a923b656c07c16a5c15f697ec6,0,0,0,0,0,0,0,0,0,0,0,0,0,0,171,5,0,0,0,0,0,0,0,0,0,100
45e3ed87ca4aceda7c8387389fc3a286ee5264d9,0,0,0,0,0,0,0,0,0,0,0,0,0,0,172,6,0,0,0,0,0,0,0,0,0,100
a68d031b01fe677d84abb0d25aca4f2ceaf90c53,126,11620,4651,6969,49,0,49,2,25,128,4,53,5.981837245,10878,71,2,2082,1456,626,134703,90303,44400,1161,767,394,96.8568314
b6808f76134260e8a3c24c7641d6e4a235ef48e1,127,4691,11709,7018,4,0,4,3,20,153,4,53,6.002918005,17407,173,7,1528,2161,633,95523,140328,44805,805,1197,392,96.8568314
95e65284980bbe5ce07cd2decb6ce66023c5c84f,129,11655,4796,6859,49,0,49,2,25,134,4,56,6.019517655,11574,60,0,2162,1543,619,140159,96089,44070,1198,810,388,96.8568314
523c38cf6399e2e3974a51a2cd0fe47e096b0bdf,154,6001,11962,5961,13,0,13,3,34,187,4,63,6.266910202,19202,59,0,1832,2402,570,114768,154819,40051,991,1338,347,91.44968332
1b9828e6a68fd39fd308ebb80f1d79cd490ceaec,12,486,11,475,2,0,2,4,25,525,2,10,2.299459696,2233,183,1,300,240,60,21148,19061,2087,166,139,27,99.80916031
ae1d3eb9adfa678553c59c8abdc3fe90aaf1a5ae,0,0,0,0,0,0,0,0,0,0,0,0,0,0,70,0,0,0,0,0,0,0,0,0,0,100
40796c06ad96ae45dd853925fbae8c26509f6c2f,2,89,19,70,0,0,0,4,9,20,1,2,0.710676854,474,174,8,65,61,4,3680,3426,254,40,38,2,100
edec7b18bc40e40f35916489ba2fde2ca4916dc5,4,9,9,0,0,0,0,4,11,416,2,4,1.657742727,1391,184,2,115,115,0,12315,12315,0,51,51,0,100
8202cd2425b699afb5c6fb11cbb59b0fcbf4f82d,2,289,13,276,0,0,0,4,10,0,1,2,0.909211579,504,175,9,85,65,20,4749,3680,1069,50,40,10,99.03047091
aed4ffcb24cf9a95c1347cccd5dd79fce7c77a6b,168,12149,6922,5227,51,0,51,2,33,115,4,75,6.348603069,16657,72,2,2667,2172,495,175209,137704,37505,1498,1171,327,90.49679765
32d132b3f8ac7d915180882934d38504263d86ae,170,6970,12231,5261,15,0,15,3,34,198,4,74,6.343503204,22399,87,2,2301,2799,498,144243,181570,37327,1258,1576,318,90.47948762
77570464b4db205c3a3b95fcc3a0e8f7f6a1c540,0,0,0,0,0,0,0,0,0,0,0,0,0,0,71,1,0,0,0,0,0,0,0,0,0,100
f241f87f87523f2c6f2203b3f316cff0fd3f20b4,171,12164,7030,5134,51,0,51,2,33,119,4,77,6.347717878,17521,92,0,2804,2317,487,181598,144708,36890,1581,1260,321,90.47948762
41708876336d009b3a2ff2c533bdf0294af1477b,87,3716,642,3074,14,0,14,3,34,333,4,50,5.196461563,11096,189,3,1631,1425,206,101099,89062,12037,971,846,125,93.33011116
0717cfc25acc80b80121b424bed93db7014a1376,12,128,59,69,0,0,0,2,26,22,1,8,2.939444363,3235,190,4,365,358,7,25560,25029,531,206,206,0,95.69048382
e7233b0f82f372e6b1339de56a115fa7e4581f07,1,1,1,0,0,0,0,2,3,20,1,1,0,701,190,4,64,64,0,5752,5752,0,45,45,0,100
4768561921b01eb11c14149ed9f8a07a7b0149f0,0,0,0,0,0,0,0,0,0,0,0,0,0,0,192,6,0,0,0,0,0,0,0,0,0,100
4c4452e59c93306a049e6879f7b6fed2ee86c74e,2,132,117,15,0,0,0,4,15,31,1,2,0.530744567,615,193,7,86,83,3,5151,4969,182,38,36,2,100
828ab71346b458b73cb14d42d68e7471ead7fa4e,98,3658,11734,8076,2,0,2,1,21,85,2,38,5.728573131,13804,0,0,1014,1686,672,63484,112006,48522,479,903,424,93.60165119
0e4842799f8a3afa15074cb121bdbd205e50fb58,95,11721,3302,8419,52,0,52,2,26,101,2,35,5.697431171,6979,194,7,1659,940,719,110224,60211,50013,888,438,450,93.63823934
10271c41b1df2815041317a36f7b65def5dab831,0,0,0,0,0,0,0,0,0,0,0,0,0,0,98,3,0,0,0,0,0,0,0,0,0,100
b081e80c07819fdaad0e5014790ddf02b2909c80,95,3315,11732,8417,1,0,1,1,21,74,2,35,5.696154965,13577,185,2,940,1659,719,60222,110224,50002,438,888,450,93.63823934
a89a72c3b2ceb5066fd7a310636507ce274c66ad,95,11719,3301,8418,52,0,52,2,26,101,2,35,5.697851187,6980,196,9,1659,940,719,110222,60222,50000,888,438,450,93.63823934
0bb358009f1823fd19682ddb18d00aefa1441bf6,97,3636,11748,8112,1,0,1,1,21,72,2,37,5.746229773,14222,176,6,1037,1744,707,66203,114971,48768,496,938,442,93.52839931
36b20297b7f385202387b22087a5e85d92e55bc7,2,52,9,43,0,0,0,3,15,22,1,2,0.998254569,769,88,1,112,107,5,6662,6314,348,45,43,2,100
742734885a215a4a9a363b8e5a88c37fd8e3010d,0,0,0,0,0,0,0,0,0,0,0,0,0,0,177,4,0,0,0,0,0,0,0,0,0,100
53d074f895e658efca10f046866c33e153010640,0,0,0,0,0,0,0,0,0,0,0,0,0,0,178,5,0,0,0,0,0,0,0,0,0,100
29d6e900c23b9808cb486a153313125cf8d290e4,0,0,0,0,0,0,0,0,0,0,0,0,0,0,72,2,0,0,0,0,0,0,0,0,0,100
e30f77a023983235a0cb835d977f146ee02d8045,0,0,0,0,0,0,0,0,0,0,0,0,0,0,2,0,0,0,0,0,0,0,0,0,0,100
2bf6650327359ded34d1f96540f13051b8e5c471,95,11779,3324,8455,52,0,52,2,27,101,2,35,5.701322657,7014,99,3,1665,945,720,110860,60570,50290,892,440,452,93.62508615
e7efd48d1402b1619c4ab5fc36ce4a7c5b0a058d,95,3344,11799,8455,1,0,1,1,21,68,2,35,5.700554989,13635,3,1,945,1665,720,60570,110860,50290,440,892,452,93.62508615
ed4dfb93641c9c9a84b61b5daddbebd962b3b20c,95,11779,3324,8455,52,0,52,2,27,101,2,35,5.701322657,7014,176,2,1665,945,720,110860,60570,50290,892,440,452,93.62508615
6a325cb5b5971fb7e2e3ab8d4407cccab0c784ec,95,3344,11799,8455,1,0,1,1,21,68,2,35,5.700554989,13635,89,2,945,1665,720,60570,110860,50290,440,892,452,93.62508615
b575da15c0ed6802c4e789e930e65059b9703355,0,0,0,0,0,0,0,0,0,0,0,0,0,0,179,5,0,0,0,0,0,0,0,0,0,100
6159c6f997851fabe1b3c21cc0e06bf49c49d9f7,95,11779,3324,8455,52,0,52,2,27,101,2,35,5.701322657,7014,100,4,1665,945,720,110860,60570,50290,892,440,452,93.62508615
975923e8d98ccd410c065ec5514f59f5ef89b260,2,8,30,22,0,0,0,3,19,17,1,2,0.74248757,375,177,1,36,36,0,2330,2580,250,29,29,0,99.98284734
1767727a70c05c9e611fa9b0474e6900ad9594cd,0,0,0,0,0,0,0,0,0,0,0,0,0,0,16,0,0,0,0,0,0,0,0,0,0,100
b06bb5f4860c656023b9c357dfa83c2f0244b9ef,95,3353,11786,8433,1,0,1,1,21,68,2,35,5.698378848,13614,180,4,945,1665,720,60570,110610,50040,440,892,452,93.64231564
2ee6cc7e0b448d8d27f56f873e2c15a603c53917,0,0,0,0,0,0,0,0,0,0,0,0,0,0,90,2,0,0,0,0,0,0,0,0,0,100
436cec43737bf0e38659c598cc8098509763fedf,0,0,0,0,0,0,0,0,0,0,0,0,0,0,4,2,0,0,0,0,0,0,0,0,0,100
165c0e716342d743460123a9de6303178ed32830,20,911,723,188,10,0,10,1,20,63,2,19,3.629229585,3204,88,0,424,380,44,28078,25927,2151,206,188,18,99.43152455
4e586ac553daed1eb8322b2bbc4d83fcbdfb89d8,8,723,29,694,1,0,1,2,21,174,1,8,1.987875107,2564,11,0,362,298,64,24381,21299,3082,172,136,36,99.86273164
622d50a168ef7056377d3a3143bc47d2d57ad67f,12,0,882,882,0,0,0,0,16,48,1,11,3.184521141,831,91,3,18,126,108,1546,6779,5233,16,70,54,99.56903982
e0fc47582e65e9daf1a0c85dc1b1657166ff14f5,95,11775,3342,8433,52,0,52,2,27,101,2,35,5.699354572,7014,10,0,1665,945,720,110610,60570,50040,892,440,452,93.64231564
3a6fb38e55c1b8b9c1fa9ec74ed233c68a18d076,0,0,0,0,0,0,0,0,0,0,0,0,0,0,12,0,0,0,0,0,0,0,0,0,0,100
81282de288d94b1fa8c57917ff6a34079eca77e1,0,0,0,0,0,0,0,0,0,0,0,0,0,0,183,7,0,0,0,0,0,0,0,0,0,100
c4c790dbe4c481c8f19293ef9d6134539674d253,4,131,12,119,0,0,0,2,9,599,1,3,1.447000185,1932,197,2,280,262,18,16707,16080,627,173,165,8,100
4519f72104b294c2f0eb8135181a3fa68eee9088,0,0,0,0,0,0,0,0,0,0,0,0,0,0,0,0,0,0,0,0,0,0,0,0,0,100
55d46b0ec630fc926a6deeafaa079ae3841a3677,1,1,1,0,0,0,0,3,6,911,1,1,0,289,0,0,38,38,0,2192,2192,0,13,13,0,100
be9a9219875f8c6a2b0c07aa7b2d62484983d932,0,0,0,0,0,0,0,0,0,0,0,0,0,0,5,3,0,0,0,0,0,0,0,0,0,100
fc9ff85368c2a974d30ad6ccdb73a4cc26fd025c,0,0,0,0,0,0,0,0,0,0,0,0,0,0,1,1,0,0,0,0,0,0,0,0,0,100
097ce95030e31bf9bd2af74aa56dc03348f7fef7,3,174,7,167,0,0,0,1,18,765,1,3,1.549241349,514,198,1,81,67,14,5155,4128,1027,46,39,7,100
93276f87b7dfb41b6fd1e6aa6d42895e422fe912,0,0,0,0,0,0,0,0,0,0,0,0,0,0,105,5,0,0,0,0,0,0,0,0,0,100
d90f7cfdedd3435bfc4c081600e4dbca052aef21,1,3,1,2,0,0,0,5,25,251,1,1,0,312,184,6,50,50,0,2059,2049,10,32,32,0,100
4eb9a8ebca733bbae96e7e19e9064c5e71666884,0,0,0,0,0,0,0,0,0,0,0,0,0,0,185,5,0,0,0,0,0,0,0,0,0,100
f183d987ab1c9856c585c45b0f9f549aadccb65f,3,267,0,267,2,0,2,1,7,71,1,2,0.978523009,25,199,2,31,4,27,1084,140,944,14,3,11,99.91429551
b2a22b81a3d763be81be0746b608fecf2e09c04e,2,28,6,22,0,0,0,2,4,484,1,2,0.733537929,162,47,0,28,23,5,1638,1357,281,6,6,0,100
cbdaee174dc81280efb0f2aaa8e0028f0c930281,15,1264,57,1207,9,0,9,2,35,167,1,8,3.38873144,1110,200,3,263,183,80,13637,7709,5928,161,115,46,95.58538163
9cee51eb2c428eb7bf3aa791f5ec1293ed36c43a,147,5008,13809,8801,12,0,12,2,34,121,4,68,6.300669617,20376,60,0,1826,2572,746,114154,165612,51458,950,1404,454,91.91853887
f30e9cc1fb9b6985e7ad7582c764d035b5cb0e1e,123,13625,3429,10196,62,0,62,2,35,144,4,53,6.035864516,11270,4,0,2428,1564,864,152633,93776,58857,1329,805,524,92.54019293
7af11b626e2d30aaaf7c01c364295b0b407fae49,27,357,1675,1318,1,0,1,0,18,71,2,23,4.358500045,3311,186,3,233,363,130,18662,26545,7883,129,205,76,99.28386409
28f4b570493eda0a23317f520b89cb370e606ca0,1,56,0,56,0,0,0,2,3,87,1,1,0,729,79,0,62,61,1,7033,6508,525,25,24,1,100
4544da7010114af4332ff236949b12a96c457f39,1,2,1,1,0,0,0,3,3,1041,1,1,0,145,5,0,23,23,0,830,816,14,23,23,0,100
75d6a72a3867d1f89dbec8dc059870482ac81e94,0,0,0,0,0,0,0,0,0,0,0,0,0,0,0,0,0,0,0,0,0,0,0,0,0,100
ae915a02ce90fb9b4c03166e7b57f8aa2a5d7890,0,0,0,0,0,0,0,0,0,0,0,0,0,0,31,0,0,0,0,0,0,0,0,0,0,100
a4bec95b9fc0b5b82c4462ff13636071b11ab1f8,0,0,0,0,0,0,0,0,0,0,0,0,0,0,32,1,0,0,0,0,0,0,0,0,0,100
0c20fd1a3a809a8ad2e8cc280a2a5382f3d5a7e8,0,0,0,0,0,0,0,0,0,0,0,0,0,0,62,0,0,0,0,0,0,0,0,0,0,100
2a1cbbbf2029faec0b265e83f270a31e75ef9d9a,16,72,70,2,0,0,0,5,13,448,4,14,3.291154608,1968,80,1,363,363,0,13469,13423,46,222,222,0,100
3a2675e5f5fee0d461d75fde128b482e7e2a920a,0,0,0,0,0,0,0,0,0,0,0,0,0,0,2,0,0,0,0,0,0,0,0,0,0,100
f43453830469b7fad14b59c95ad8122f320a4b05,22,1199,553,646,1,0,1,2,36,349,2,16,3.502990886,4320,81,2,602,540,62,39209,35437,3772,314,296,18,97.58418741
52bd310fcce68dad15eead57f1113092a30d9791,0,0,0,0,0,0,0,0,0,0,0,0,0,0,82,3,0,0,0,0,0,0,0,0,0,100
dbbf624367f8a3fb5d78352be0d9a2dec0533923,94,3774,3765,9,23,0,23,2,35,395,4,60,5.742979862,10994,63,1,1399,1350,49,87392,86260,1132,794,736,58,96.36949202
aceca469a83d17c033ea7a47ff82c61962319b3a,93,3668,3881,213,12,0,12,3,36,253,4,60,5.745108305,10916,83,4,1339,1410,71,85531,88043,2512,733,797,64,96.36949202
39ae9f4642073d3d4f0fa423339dd97f85974588,100,4297,3804,493,26,0,26,2,35,367,4,60,5.839341487,11033,107,0,1458,1350,108,92047,86260,5787,840,736,104,95.93672907
f316d15f082415f44d22bb124818ec116985ba1f,8,158,48,110,0,0,0,2,13,0,2,8,2.456935515,949,64,2,80,70,10,10162,9134,1028,62,55,7,99.63915201
3e5ef41d9b8639fb1155686e615c02a59b735397,14,914,47,867,6,0,6,2,19,0,1,10,3.153819439,852,108,1,215,62,153,13308,8191,5117,114,47,67,99.70104634
a5a51399d2eafd2535d79bb13ee0d4d8eb2e2d23,5,160,1,159,0,0,0,2,7,0,1,5,2.037976456,803,109,2,72,59,13,9999,8495,1504,42,35,7,99.98514116
b580a69f1d9d3346171d749dcd6f791a9bc6d894,40,1530,624,906,1,0,1,3,36,392,4,32,4.117574325,7430,5,1,1064,985,79,63862,58759,5103,578,551,27,97.63869132
8763fba2ff579b37b6af82822fc4b2c4390665a8,0,0,0,0,0,0,0,0,0,0,0,0,0,0,110,3,0,0,0,0,0,0,0,0,0,100
6bac842d7ad2819c56412837d8befb603ef15f35,68,2409,4990,2581,12,0,12,0,18,152,2,34,5.521174013,4898,48,1,319,688,369,25027,43502,18475,176,384,208,98.10616533
e78bc530260aa622e8263cda2b94be99194dffb5,69,4857,2514,2343,33,0,33,1,21,373,2,35,5.514355083,3251,111,4,676,332,344,42765,25857,16908,381,179,202,98.10616533
d0e87576944b6370eb1d9a0c98d0450f2c51f052,10,231,53,178,2,0,2,2,8,3,1,7,2.709894051,1211,112,5,172,155,17,13168,12176,992,104,93,11,99.80871704
9d4842f3d6f355d449d51f3c6ac02f2c904c295d,6,276,137,139,1,0,1,4,22,12,1,6,2.16482355,1457,66,3,145,138,7,13349,12798,551,77,64,13,99.94527295
f1f5dda4c643394c12ab9f4501c5b806adb21129,5,41,5,36,0,0,0,1,9,16,1,3,1.962200219,275,67,4,39,36,3,2521,2322,199,16,13,3,100
6c90724d8d4f06c453128f860eff51037f1870d8,14,239,124,115,0,0,0,2,20,7,2,8,3.356866101,1590,113,6,228,301,73,16119,15935,184,145,141,4,100
44a6f6f11d8d750f176f53d6032e46c90f88d9e4,71,2412,5461,3049,12,0,12,0,18,148,2,35,5.543542295,5204,33,2,319,646,327,25027,45786,20759,176,419,243,98.00664452
ccdbeff5076553382091d4b9423ed48ccdba10ee,0,0,0,0,0,0,0,0,0,0,0,0,0,0,201,0,0,0,0,0,0,0,0,0,0,100
7dff4def23a7c839ea599a120ab6d4cf5b9bbbef,69,5262,2293,2969,34,0,34,1,22,371,2,33,5.465218077,2878,202,1,603,286,317,42863,22398,20465,401,158,243,98.07692308
4e1dd5d8bb38eec54be3dba6c9de2b95fba60448,68,2158,5467,3309,11,0,11,0,18,131,2,33,5.485872059,4977,13,0,275,617,342,21669,43807,22138,155,407,252,98.07692308
a1e25a4bf618e544b2062bf7f7f25bec0029956a,0,0,0,0,0,0,0,0,0,0,0,0,0,0,0,0,0,0,0,0,0,0,0,0,0,100
1b2bdff53106694a9223ecc97f7ce9d0a78b4b09,0,0,0,0,0,0,0,0,0,0,0,0,0,0,14,1,0,0,0,0,0,0,0,0,0,100
d5eb56a967ac7b925d0a843c027a2b0dde66de06,76,5348,2386,2962,34,0,34,1,22,331,2,38,5.561291247,2969,3,0,609,286,323,43259,22398,20861,407,158,249,98.07692308
2b6959b46db79256d12b8522385212559cabada2,8,296,6,290,0,0,0,4,15,26,2,8,2.345742357,1685,114,6,182,168,14,18790,16234,2556,109,100,9,99.46443285
b445bfe242123e544c1fef41e2ab5bdc07dbc56e,0,0,0,0,0,0,0,0,0,0,0,0,0,0,4,1,0,0,0,0,0,0,0,0,0,100
09a7f18994dc8254ca158139c44258cb7f1107ec,0,0,0,0,0,0,0,0,0,0,0,0,0,0,5,2,0,0,0,0,0,0,0,0,0,100
897266598b7984884d6cf8a6a699fe902e792483,0,0,0,0,0,0,0,0,0,0,0,0,0,0,115,2,0,0,0,0,0,0,0,0,0,100
756ceedc3d3567f3508478eaa5ed29f12c22688a,1,1,1,0,0,0,0,3,6,56,1,1,0,98,116,3,19,19,0,778,778,0,7,7,0,100
037b50b9a829d7292db1148fc628d9231da499e1,0,0,0,0,0,0,0,0,0,0,0,0,0,0,6,0,0,0,0,0,0,0,0,0,0,100
3e7785920e8f0c5aadf36e05dbcfa69252cc5574,0,0,0,0,0,0,0,0,0,0,0,0,0,0,7,1,0,0,0,0,0,0,0,0,0,100
7967f358c6c4b8437935c43e54179126e48e248f,3,471,424,47,0,0,0,2,23,39,1,3,0.072726073,792,68,2,80,68,12,7690,7145,545,35,19,16,100
afb9607dfbbaf89f06a30823bf668523bb7b6f9a,0,0,0,0,0,0,0,0,0,0,0,0,0,0,117,3,0,0,0,0,0,0,0,0,0,100
52de126fc746181d6aac8ce002d6b814fd1e6cb5,0,0,0,0,0,0,0,0,0,0,0,0,0,0,6,3,0,0,0,0,0,0,0,0,0,100
5b3e2c337b3772bcd7d18cedac75877bbe6f7735,0,0,0,0,0,0,0,0,0,0,0,0,0,0,8,2,0,0,0,0,0,0,0,0,0,100
14dcb2d90581835d8206c65918c24e8cb04bfd06,0,0,0,0,0,0,0,0,0,0,0,0,0,0,7,4,0,0,0,0,0,0,0,0,0,100
2b0060b0663ba3fa34047afdfe2fa856fe9007e8,68,2296,5942,3646,11,0,11,0,18,131,2,33,5.383922374,5221,63,0,275,643,368,21669,46908,25239,155,432,277,98.16462736
9064cca0317881176471c51abd16e99bf2ad7b10,79,6005,2551,3454,36,0,36,1,23,303,2,40,5.514350355,2982,69,1,648,286,362,47764,22398,25366,440,158,282,98.09642907
d8a5922b4cc5b20be7cb08f333a861241c365fd5,0,0,0,0,0,0,0,0,0,0,0,0,0,0,6,0,0,0,0,0,0,0,0,0,0,100
b29833cc5db4efca2a6e9025042baf705fb347c6,5,35,4,31,0,0,0,4,17,26,1,4,2.148030159,939,118,4,124,118,6,7460,7277,183,78,75,3,100
05316a4d989d7546058e73b3a75eef435f2608a0,2,23,23,0,0,0,0,2,11,22,1,2,0.755375413,821,119,5,73,73,0,8361,8393,32,38,38,0,100
73dc63e671b55d22d251f4be1c217259f4f5dc71,10,589,542,47,2,0,2,1,18,908,1,7,2.533528449,1413,71,3,135,131,4,12257,11897,360,78,74,4,99.76567884
7a8c246748a2c9e8c5b9230800b075dd99a7f3a4,9,75,5,70,0,0,0,2,21,15,2,8,2.558050484,1658,120,6,186,173,13,15352,14754,598,113,110,3,100
ba0a6092c97d23c118c2b5780c2559c2f849a220,0,0,0,0,0,0,0,0,0,0,0,0,0,0,121,7,0,0,0,0,0,0,0,0,0,100
bce9b903fbd3436ea0c41eb8d75da279e16ce922,0,0,0,0,0,0,0,0,0,0,0,0,0,0,9,3,0,0,0,0,0,0,0,0,0,100
8a926dd5a4501df8c7ef51b526ad5e4d752a5e19,5,35,15,20,0,0,0,2,19,10,1,5,1.935441045,1211,122,8,145,142,3,9959,9817,142,92,89,3,100
4fb9201670acf9960087f004f8858e99c0a87981,84,2914,6920,4006,14,0,14,0,18,167,3,41,5.647043906,6601,187,0,365,777,412,29856,57782,27926,209,512,303,97.91550862
d9e1f381cc1ae9edfbffc7216abffdbd8f942c09,93,6886,3177,3709,38,0,38,2,24,367,3,47,5.70923796,4097,72,4,774,376,398,58127,30585,27542,511,212,299,97.72193842
6b70571d6de3951c98269bbf5b38e8b69deddfab,0,0,0,0,0,0,0,0,0,0,0,0,0,0,123,9,0,0,0,0,0,0,0,0,0,100
076a6a197df629d3b04e0757320e7681ea2fb3d9,0,0,0,0,0,0,0,0,0,0,0,0,0,0,124,10,0,0,0,0,0,0,0,0,0,100
308c2b27b9b234c0c84c343dfc45b3617b027e64,79,2892,7035,4143,14,0,14,0,18,149,2,39,5.624642991,6364,15,0,331,753,422,27998,56943,28945,186,493,307,97.72193842
5eff97fbe4a99b4d9fdec1010cfa3358cf182ddd,13,214,97,117,0,0,0,4,26,355,1,5,3.087936353,1599,188,1,169,155,14,10640,10095,545,129,119,10,99.84541877
14e80b3c229ea2e5a8d615c87d822d4b44d8ec98,103,7058,3368,3690,38,0,38,2,25,381,3,50,5.832252594,5751,125,10,955,564,391,70388,42275,28113,630,339,291,97.56266445
9fdccba371c1f1e0dcb79e00a7207a934b79b64c,0,0,0,0,0,0,0,0,0,0,0,0,0,0,126,11,0,0,0,0,0,0,0,0,0,100
401bd7a180dad4ff805fd6e5840ab826ee4e94b7,96,3143,7227,4084,14,0,14,0,26,188,3,46,5.789266385,8711,189,2,595,1008,413,44167,73512,29345,360,658,298,97.56266445
6fb50a18d75c3694c75596ab45bcc7531711eec7,5,79,28,51,0,0,0,1,8,343,1,2,1.552102269,946,190,3,108,102,6,6379,6148,231,84,79,5,100
3bfbf018a9c3e1c74dc934901446b5111a0ada03,16,1432,2,1430,12,0,12,2,8,38,2,6,3.563434995,341,191,4,145,60,85,8072,1917,6155,108,38,70,97.56624424
e66cfc80e6a6fa53110c3f2fa8ee0d31ea997bf6,124,7089,4912,2177,38,0,38,2,25,344,3,57,6.132112759,8109,8,0,1126,828,298,79595,57992,21603,747,532,215,95.4744732
c6d0721b8f02752cea9f91acb29042ca9ddf0bc9,118,5031,7255,2224,29,0,29,0,26,164,3,53,6.137641829,9747,192,5,844,1139,295,58701,80222,21521,547,752,205,95.40830743
09826da85eddb014a4b718233d53480220b1f5dd,127,7089,5291,1798,38,0,38,2,25,340,3,59,6.186855677,8355,10,0,1126,855,271,79595,59430,20165,747,550,197,95.40830743
c7a3dc230a8fdfbbefcbe3a04c9c5cc05bc74853,118,5031,7255,2224,29,0,29,0,26,164,3,53,6.137641829,9747,193,6,844,1139,295,58701,80222,21521,547,752,205,95.40830743
3cb088c06e3b5749cf32c37dada395aff9ea41d2,1,110,22,88,0,0,0,1,2,14,1,1,0,90,194,7,9,7,2,870,547,323,8,6,2,100
113ac0d3a3377969705578069f2a371e1d8ad453,0,0,0,0,0,0,0,0,0,0,0,0,0,0,195,8,0,0,0,0,0,0,0,0,0,100
29cbdcc43c66080e1464e4c9c365c63a3f9035b1,128,7091,5381,1710,38,0,38,2,25,345,3,60,6.190169309,8599,34,0,1163,894,269,81463,61621,19842,767,572,195,95.40830743
661e23e274d2bf88370d8feb5e5dbf1b82f15124,9,138,35,103,0,0,0,2,22,453,2,6,2.788888186,1028,187,0,128,120,8,7310,6702,608,94,89,5,98.36395333
d32bd50d43aae87af9ec12d2daea83b2f4eca342,2,33,14,19,0,0,0,4,22,451,1,2,0.925225328,303,188,1,27,25,2,2172,2089,83,22,21,1,100
f5eaef3c24e939ef14757eb2db4b758e71d33fca,35,2225,126,2099,15,0,15,3,26,195,2,13,4.491126946,2939,17,0,438,305,133,27929,19133,8796,329,225,104,97.44680851
9455c4ee3f6962c47140522dc4c0f2a243695e8d,4,61,66,5,0,0,0,1,1,0,1,2,1.989833653,651,198,7,59,28,31,4347,3812,535,45,28,17,97.54518072
62310743a0c1d4a27db47a89cf79496d594c8bcf,38,192,2286,2094,0,0,0,3,25,210,2,15,4.630072109,4835,84,0,354,456,102,23057,31370,8313,262,349,87,95.69426383
f5f765cafcd985a323b5774ff86fe6d43f6186d2,3,262,174,88,0,0,0,4,26,124,1,3,0.786711441,751,189,2,90,84,6,5634,5156,478,59,55,4,96.72037644
3d84ea4290b9439b97b549a8e8158b6fe4bfa8f2,54,2744,760,1984,16,0,16,3,23,118,2,18,4.634388148,4901,199,5,591,649,58,40313,69759,29446,445,454,9,95.41051294
2720e537e698fdb278757c1e0fb968d5887c9d90,54,794,2750,1956,1,0,1,3,27,187,2,18,4.65870685,6156,190,1,466,736,270,32357,68708,36351,346,511,165,95.41051294
a97e575f3bf6285d9893c2bc63d70a05784e22ea,0,0,0,0,0,0,0,0,0,0,0,0,0,0,85,1,0,0,0,0,0,0,0,0,0,100
33792c2411099d530998ee827c2cd5dc7ba5e4a0,0,0,0,0,0,0,0,0,0,0,0,0,0,0,11,0,0,0,0,0,0,0,0,0,0,100
02a12806b098c5a09a0bc89e925527ae9bdfae1d,0,0,0,0,0,0,0,0,0,0,0,0,0,0,86,2,0,0,0,0,0,0,0,0,0,100
fb623f6c7fcd6f36e5e4f394779e5c36dc78e2c4,54,2750,794,1956,16,0,16,3,23,118,2,18,4.65870685,4920,200,2,591,649,58,40313,69759,29446,445,454,9,95.41051294
cad2f4086a29f25a5ae2aeaf70d0933776df3681,4,296,164,132,0,0,0,2,10,23,1,4,1.111076492,957,18,0,106,98,8,7480,6694,786,74,69,5,99.91852697
8b2f297fb58df1c2f01fa34a9d2ed5ccd183a7ce,53,226,2314,2088,0,0,0,3,27,192,2,17,4.761495554,6245,73,0,466,764,298,32357,76272,43915,346,545,199,95.44444444
91c410fd2016d8776aba650b41239c971b706d01,0,0,0,0,0,0,0,0,0,0,0,0,0,0,0,0,0,0,0,0,0,0,0,0,0,100
b84c8740db5fbd05f3876aee3cb5532622a6b9dd,0,0,0,0,0,0,0,0,0,0,0,0,0,0,191,2,0,0,0,0,0,0,0,0,0,100
f83f0ac06622e091a09d9f256f817e7235c63e53,53,2314,226,2088,15,0,15,3,10,119,2,17,4.761495554,4920,203,4,599,630,31,41099,67353,26254,450,441,9,95.44444444
1545978e169a01e4a06735b8713c8fa65373a394,4,135,29,106,0,0,0,1,3,70,1,3,1.58635176,395,204,5,40,34,6,3205,2703,502,29,24,5,100
3372aa360315b537ee675ecb7d79fcd6885ba13c,53,226,2420,2194,0,0,0,3,27,192,2,17,4.716882449,6315,9,0,466,770,304,32357,76774,44417,346,550,204,95.44444444
15194c3b4e7d9d9d161b0ddfa556395b34cfef7c,0,0,0,0,0,0,0,0,0,0,0,0,0,0,16,0,0,0,0,0,0,0,0,0,0,100
0d34e77cdb0c9104c848808800158492620c7d9b,0,0,0,0,0,0,0,0,0,0,0,0,0,0,17,1,0,0,0,0,0,0,0,0,0,100
08fe1cff1430c71205d62e375cbacd6906e4fc4e,0,0,0,0,0,0,0,0,0,0,0,0,0,0,192,2,0,0,0,0,0,0,0,0,0,100
fa3be8d32ccadcd11edad046cbd063cec3a20624,57,2958,226,2732,19,0,19,3,10,114,2,18,4.829042556,4920,205,4,639,630,9,43743,67353,23610,482,441,41,95.29467681
4f0b608d77ebed3025ba0accedec440b3270cb18,57,226,2958,2732,0,0,0,3,27,175,2,18,4.829042556,6662,74,1,466,804,338,32357,78916,46559,346,577,231,95.29467681
fbabfcad49581b531a7b7eb755a561a030a2bc06,57,2958,226,2732,19,0,19,3,10,114,2,18,4.829042556,4920,19,1,639,630,9,43743,67353,23610,482,441,41,95.29467681
1723a0eae57adcfc4a2efe2422f52fbed4c237e7,0,0,0,0,0,0,0,0,0,0,0,0,0,0,35,0,0,0,0,0,0,0,0,0,0,100
9c9e29547837e648723920329c3b7fea6211f0db,3,17,3,14,0,0,0,3,6,283,2,3,1.278897903,469,208,6,57,53,4,3567,3310,257,38,38,0,100
c0fb26258f9a78d375a50dd5d746404130dfe06b,3,97,28,69,0,0,0,2,23,462,1,3,1.138588584,295,209,7,24,21,3,2634,2302,332,15,12,3,99.9351176
ff1f9cf52b31ae866eb3de1cf8993af97af1790f,3,285,0,285,3,0,3,1,1,0,1,3,1.407268828,0,49,0,20,0,20,1561,0,1561,14,0,14,99.88660295
ebdaf5f905829d8ff59814bb3555666217f85abb,0,0,0,0,0,0,0,0,0,0,0,0,0,0,13,0,0,0,0,0,0,0,0,0,0,100
b872fdcd0a54f41165e93d0e3635635a09e61ef8,0,0,0,0,0,0,0,0,0,0,0,0,0,0,87,0,0,0,0,0,0,0,0,0,0,100
7e222fa47aedc4ab3bafec54590ec0bc73b5f75c,3,65,22,43,0,0,0,2,3,64,1,3,1.178541761,577,210,4,42,41,1,5012,4499,513,32,31,1,99.93517018
de533063c26c8a2462dbfff33228a949c4a96c97,35,1186,723,463,5,0,5,2,28,309,2,17,4.696191628,5844,127,0,732,715,17,49694,47232,2462,408,389,19,99.23626909
feb9153a610e7cc384055c5d07b5c1dcf8b81923,0,0,0,0,0,0,0,0,0,0,0,0,0,0,14,1,0,0,0,0,0,0,0,0,0,100
891bf4952ab8eceabcb44659e7498d62005b6aa2,0,0,0,0,0,0,0,0,0,0,0,0,0,0,88,1,0,0,0,0,0,0,0,0,0,100
269b91d015c67b0ae49a78e5c457408e1b431c25,0,0,0,0,0,0,0,0,0,0,0,0,0,0,18,0,0,0,0,0,0,0,0,0,0,100
5bfc08c57f1129b7d185ac7257197775ed3bdb5e,3,118,27,91,0,0,0,2,5,60,2,2,0.952862073,594,211,4,45,43,2,5026,4908,118,28,27,1,100
e482366726b07173fbc9ff9b084b851596e13005,0,0,0,0,0,0,0,0,0,0,0,0,0,0,75,1,0,0,0,0,0,0,0,0,0,100
3467ffdb13aad22ab1e4065a0b6715b99371aa23,11,725,20,705,8,0,8,1,5,9,1,4,3.206720719,377,212,5,68,33,35,5592,2844,2748,59,29,30,99.69235751
747220f000188557bfa860b48f6eb4bc49758d4a,3,81,172,91,0,0,0,2,19,400,1,3,0.765105569,832,128,1,61,60,1,9312,9068,244,46,45,1,100
1f1b9cdd3cef7557ff68b7ab33693161b142ef1d,0,0,0,0,0,0,0,0,0,0,0,0,0,0,76,2,0,0,0,0,0,0,0,0,0,100
060d17e992a73bc5b65bb9a52d044a3f672ba2c1,0,0,0,0,0,0,0,0,0,0,0,0,0,0,213,6,0,0,0,0,0,0,0,0,0,100
3d923cde8711dcc463c2d27cb2b67275b9172112,15,737,180,557,4,0,4,5,37,1158,1,8,2.98645503,1694,50,1,246,189,57,17014,14059,2955,127,93,34,99.83904716
f153375fad65e75a10ce490b4a5f29f7e82f70dd,0,0,0,0,0,0,0,0,0,0,0,0,0,0,89,2,0,0,0,0,0,0,0,0,0,100
9b6710053894d8a39880cb8157a0e603ed542cb7,0,0,0,0,0,0,0,0,0,0,0,0,0,0,90,3,0,0,0,0,0,0,0,0,0,100
90c5e1d2896b8a95bd6c928e3dab96f1fd85167c,8,263,121,142,0,0,0,3,20,251,1,7,2.449334351,1855,214,6,215,206,9,18513,17922,591,105,100,5,99.75949976
647896604f938ca195bf25885651f9be3e897c71,0,0,0,0,0,0,0,0,0,0,0,0,0,0,36,0,0,0,0,0,0,0,0,0,0,100
621415067dc727838da8e14925c15120b0e479de,0,0,0,0,0,0,0,0,0,0,0,0,0,0,129,2,0,0,0,0,0,0,0,0,0,100
08f3de0fe31fefa828952cbe76456580a4697630,11,338,120,218,1,0,1,5,38,87,2,9,3.129366831,1922,51,1,205,197,8,17472,15907,1565,90,88,2,99.95206136
28542ad64cf63f17b728b4b1c0e995a8973767f7,20,1500,1130,370,5,0,5,4,39,368,2,11,2.88542453,2188,130,3,265,231,34,18385,16901,1484,141,102,39,96.81145274
bf32fef6a4a02c5b21ec1f6d97fbd83de78a996e,2,80,0,80,0,0,0,4,4,478,1,2,0.998195879,378,131,3,76,62,14,2916,2362,554,47,39,8,100
2531c3e19e6c2887a2242da830d7178e6973b8ab,0,0,0,0,0,0,0,0,0,0,0,0,0,0,215,4,0,0,0,0,0,0,0,0,0,100
d44a392567e35022bfb35a787b55aff3447ac60e,4,70,28,42,0,0,0,2,18,350,1,4,1.183689604,859,132,4,93,93,0,7944,7498,446,49,49,0,100
0c0602c75d9660717920a547bcb9e76d58b6571e,0,0,0,0,0,0,0,0,0,0,0,0,0,0,77,2,0,0,0,0,0,0,0,0,0,100
739782ab71f6e571ff459d1844a77b533abbdbea,0,0,0,0,0,0,0,0,0,0,0,0,0,0,216,5,0,0,0,0,0,0,0,0,0,100
0ba18026222f004316b96633780509c71934121e,0,0,0,0,0,0,0,0,0,0,0,0,0,0,37,1,0,0,0,0,0,0,0,0,0,100
0e037edad913955d3b6754ca9cf42b329cd84160,8,122,264,142,0,0,0,4,21,32,1,7,2.453570625,1907,20,0,206,215,9,17922,18513,591,100,105,5,98.46002621
eee99630270e08412e589b99afafbb2246f88af5,0,0,0,0,0,0,0,0,0,0,0,0,0,0,12,0,0,0,0,0,0,0,0,0,0,100
d0411f63bb2e08f1cca81a25117fd640689bb413,3,68,15,53,0,0,0,2,24,452,1,3,0.187956898,229,6,0,17,15,2,2280,1998,282,9,9,0,100
fefbb376fad0526116ed91035408bfeb72059d9c,3,29,25,4,0,0,0,3,6,240,1,2,0.921871944,237,11,0,18,18,0,2038,1947,91,11,10,1,100
9b6260fd4b9ecf355864b77c8889d27539623381,0,0,0,0,0,0,0,0,0,0,0,0,0,0,10,0,0,0,0,0,0,0,0,0,0,100
fdfca3b2675d0dfcdf7960c5db789a8c9386b5db,0,0,0,0,0,0,0,0,0,0,0,0,0,0,1,0,0,0,0,0,0,0,0,0,0,100
bf6b07f7cbea3d210878554c7ce7a1bc091b59ee,0,0,0,0,0,0,0,0,0,0,0,0,0,0,78,0,0,0,0,0,0,0,0,0,0,100
b9461e76506988ad51d6fc0f3a442909945048f2,0,0,0,0,0,0,0,0,0,0,0,0,0,0,217,0,0,0,0,0,0,0,0,0,0,100
85cd21aa0f5045184c168248dc2b81c1cfd41ddd,7,251,11,240,1,0,1,1,19,890,2,5,1.656155398,1268,79,1,136,112,24,12913,11867,1046,104,88,16,99.95145631
7bba8be0cb77136459c25af697163d76fcf45100,0,0,0,0,0,0,0,0,0,0,0,0,0,0,15,0,0,0,0,0,0,0,0,0,0,100
c6b1b3ccd7f937342c5723ca0a952a4900efc5cf,1,10,2,8,0,0,0,4,5,62,1,1,0,175,52,0,29,29,0,1040,1024,16,29,29,0,100
b5712af5b78ff8c6e5e3d3f3c68552204fa7d877,1,133,164,31,0,0,0,5,6,1362,1,1,0,127,53,1,19,20,1,1095,1018,77,6,7,1,100
3e73391ed518e6d4e2f87a37745a34581782236b,9,1193,6,1187,3,0,3,1,24,385,2,6,1.660854232,694,133,0,180,101,79,11411,5245,6166,104,54,50,96.65055824
42068d95192e7346bf0179399193a6afe01d9925,0,0,0,0,0,0,0,0,0,0,0,0,0,0,54,2,0,0,0,0,0,0,0,0,0,100
61b1ede0bdfd28b04a3783371deb935d293df998,2,518,157,361,0,0,0,4,6,808,1,2,0.943906063,755,0,0,198,135,63,12177,8934,3243,23,15,8,100
0303d240573a96d0bc007f3c753bc8f8fca5b308,0,0,0,0,0,0,0,0,0,0,0,0,0,0,38,0,0,0,0,0,0,0,0,0,0,100
0e2a4348465406ad3aca7614bc38a71571b63b83,2,9,12,3,0,0,0,1,2,16,1,2,0.702466551,646,134,1,59,59,0,5669,5662,7,32,32,0,100
0c4c622b927d1ba3161779dc2e745d5b74ae06b6,0,0,0,0,0,0,0,0,0,0,0,0,0,0,13,0,0,0,0,0,0,0,0,0,0,100
e7e19fbb6491fa47d3794aebdac0280164afeb29,94,2135,5575,3440,1,0,1,0,36,226,4,46,5.267874856,14144,203,0,1351,1646,295,99911,119340,19429,691,877,186,94.69115192
8bf3b6ec9c6871daadcaa2341d01082d2584e341,91,6237,2261,3976,24,0,24,1,37,489,4,46,5.293006227,9690,75,0,1495,1170,325,105707,84584,21123,789,599,190,92.58706468
fcd644ca77394d48d460c460b672a23d6594f49b,0,0,0,0,0,0,0,0,0,0,0,0,0,0,81,3,0,0,0,0,0,0,0,0,0,100
3c4c069b6f29824122dd93ac6f234ef1d0363e9d,0,0,0,0,0,0,0,0,0,0,0,0,0,0,135,2,0,0,0,0,0,0,0,0,0,100
bfa7491f160abc3e01bb1c6f1c3927eb5cec7021,0,0,0,0,0,0,0,0,0,0,0,0,0,0,91,0,0,0,0,0,0,0,0,0,0,100
05d309f916c0eb45a287a105f44e16e93e3c378e,2,84,7,77,0,0,0,5,11,237,1,2,0.815603451,1637,92,1,240,236,4,15061,14531,530,139,137,2,100
575ba03b9d91d96bf5c2bd1dbee95681ae3131d0,2,67,44,23,0,0,0,1,11,238,1,2,0.800392208,338,218,0,34,30,4,2394,2146,248,25,25,0,100
d599efb08021a85317680ef52ad2e50405621647,6,801,18,783,5,0,5,1,10,66,1,2,2.322724198,514,219,1,122,77,45,7492,3771,3721,66,34,32,99.74632166
12e3ae548af6bd408a31fde0d1d8cf23cefdf325,0,0,0,0,0,0,0,0,0,0,0,0,0,0,55,3,0,0,0,0,0,0,0,0,0,100
952b707dfba7d584dfe10cb650c3e5ddf6c4789d,0,0,0,0,0,0,0,0,0,0,0,0,0,0,39,1,0,0,0,0,0,0,0,0,0,100
e0f9b48e0675637baa7366efd755b228bbd925a6,0,0,0,0,0,0,0,0,0,0,0,0,0,0,14,1,0,0,0,0,0,0,0,0,0,100
e1a957be3b44986799fb9672536bce43705bd6fa,2,22,14,8,0,0,0,4,6,986,1,2,0.503258335,284,82,2,52,51,1,2674,2601,73,15,15,0,100
42fc699ce1df04fd065d131293a8322a095c1e9c,0,0,0,0,0,0,0,0,0,0,0,0,0,0,220,2,0,0,0,0,0,0,0,0,0,100
89a2beda4f07911c8b3cd7dee8a2c3426838d161,8,233,170,63,0,0,0,4,31,96,1,4,2.453783722,2141,221,3,215,216,1,18756,18455,301,128,127,1,94.47986577
b4d76f98ee96727762acf875e3d74843c98b581a,0,0,0,0,0,0,0,0,0,0,0,0,0,0,11,0,0,0,0,0,0,0,0,0,0,100
4ef65e09ea4a1eac8abf89521e5a999faeca1f37,3,81,54,27,0,0,0,2,4,748,1,3,0.985677245,449,83,1,70,63,7,4116,3709,407,29,22,7,96.33145615
877b510146456f2eed6eb12c35b1124c35b00aa5,2,76,2,74,0,0,0,4,20,16,1,2,0.235193382,1131,222,4,97,93,4,10478,9974,504,48,44,4,99.9844624
e81a5c102375d3b7f9692a561760ff8f8526a6ec,0,0,0,0,0,0,0,0,0,0,0,0,0,0,93,0,0,0,0,0,0,0,0,0,0,100
d749961daaa77624e1cb6878548479d86c8fe668,4,88,108,20,0,0,0,4,12,317,2,4,1.418790043,808,223,3,68,69,1,5843,5960,117,50,48,2,100
285ba5eb604f2e286f72641308a1424234739402,10,228,425,197,0,0,0,4,32,336,2,8,2.039604621,1179,224,4,106,123,17,8431,9777,1346,87,96,9,98.71616396
30fafe5df16386a99274b871a291a708963eaae9,1,6,0,6,0,0,0,2,2,995,1,1,0,118,94,1,16,15,1,783,753,30,15,14,1,100
f8776f559c7fa9dcbf857ce29636a45b3a38791b,0,0,0,0,0,0,0,0,0,0,0,0,0,0,0,0,0,0,0,0,0,0,0,0,0,100
2263983761e77b7eec52f70f5e8f8001bac83125,0,0,0,0,0,0,0,0,0,0,0,0,0,0,95,2,0,0,0,0,0,0,0,0,0,100
ec3b98f762ce3726ed9a33abdb446957d1865dca,12,992,298,694,7,0,7,3,33,73,1,6,3.073801582,835,225,4,157,107,50,10182,6774,3408,110,69,41,98.4729292
c4f5c55e2914b6d29811942fd0f331184141f30f,0,0,0,0,0,0,0,0,0,0,0,0,0,0,15,0,0,0,0,0,0,0,0,0,0,100
eb2aee1820cae811c6491d68aed32ccc055922e4,12,646,296,350,1,0,1,4,9,137,1,9,2.85865684,1955,226,4,251,233,18,18942,16548,2394,134,114,20,99.31666408
693dab5e547d9513b6ed661aa62143c2d1e0bd1a,0,0,0,0,0,0,0,0,0,0,0,0,0,0,96,3,0,0,0,0,0,0,0,0,0,100
90582b30902b9506d16547c0cdac16e8a7e3a66e,4,166,11,155,0,0,0,1,2,80,1,2,1.567873586,424,227,5,59,43,16,3962,3034,928,42,30,12,99.96877927
b8e426c755a5969e24dba50f5d8fa81d1ccb472d,2,710,0,710,2,0,2,1,1,0,1,2,0.963050863,0,0,0,68,0,68,2746,0,2746,28,0,28,99.92200905
2e6caa908c0b7708281d76b6744d63706fe610b2,11,667,265,402,2,0,2,4,15,884,1,5,2.75124073,1063,228,5,126,103,23,11124,8119,3005,77,65,12,99.10630292
ec118557cb6a9bfe91528702c7bf093977fa80d7,1,8,6,2,0,0,0,1,3,3,1,1,0,151,229,6,18,18,0,918,914,4,9,9,0,100
e4d793a55a56a01fa101c8da77d92f99325ba539,1,1,1,0,0,0,0,2,2,98,1,1,0,115,40,0,24,24,0,1007,1007,0,8,8,0,100
d7d4fd9afb19e2bd2e66babb7e1514a19eae07d0,116,356,728,372,3,0,3,2,7,316,2,57,4.676881955,14164,97,4,1949,3856,1907,117816,302046,184230,812,2240,1428,91.17464264
d8bd35d192e1a141ea2773dae40c58b3b60a7802,0,0,0,0,0,0,0,0,0,0,0,0,0,0,16,1,0,0,0,0,0,0,0,0,0,100
9e026e3e902769dae364b4c4acf64e00839d24f5,0,0,0,0,0,0,0,0,0,0,0,0,0,0,84,0,0,0,0,0,0,0,0,0,0,100
74ec7fedd48135123092b2a638ed1f2e2f57530c,40,359,296,63,0,0,0,1,12,966,1,14,4.102433251,9152,56,0,1227,1231,4,70905,70252,653,594,594,0,100
7f073b863c5ab5a420b34f83f27297a7674640bf,0,0,0,0,0,0,0,0,0,0,0,0,0,0,85,1,0,0,0,0,0,0,0,0,0,100
adbe94530e0783aeee976e765e3e57c0907c2854,0,0,0,0,0,0,0,0,0,0,0,0,0,0,0,0,0,0,0,0,0,0,0,0,0,100
d1b534f31afc2f241d5ea656eeab5268cc39b84b,0,0,0,0,0,0,0,0,0,0,0,0,0,0,230,5,0,0,0,0,0,0,0,0,0,100
8c1171fa5bcc1c4a015d9160b626f452c1533330,0,0,0,0,0,0,0,0,0,0,0,0,0,0,231,6,0,0,0,0,0,0,0,0,0,100
0dc9fc8fe862c6a43f25bf9c61bbd38a36d3bbc8,6,417,39,378,4,0,4,1,1,0,1,3,2.301962003,269,57,1,41,20,21,3868,2510,1358,31,18,13,99.61732741
7089086cfc8c070a48d80b3884ad396ebb025238,0,0,0,0,0,0,0,0,0,0,0,0,0,0,16,0,0,0,0,0,0,0,0,0,0,100
9e717a525ddca986130f4208fb6c558eaaa56eab,0,0,0,0,0,0,0,0,0,0,0,0,0,0,58,2,0,0,0,0,0,0,0,0,0,100
74658e97a55aeac612a70689850d352d907adf96,0,0,0,0,0,0,0,0,0,0,0,0,0,0,17,0,0,0,0,0,0,0,0,0,0,100
ef69acd0d911ddde2dec17544eb1a844b7b79bee,8,861,6,855,3,0,3,1,25,370,1,5,2.056441939,308,136,0,71,19,52,7407,2495,4912,32,11,21,99.77081742
309ce65f863d2532ca29a1c779bda02c1d42ee4d,0,0,0,0,0,0,0,0,0,0,0,0,0,0,137,1,0,0,0,0,0,0,0,0,0,100
862244721fef7ba7389000cc2f3d0756bb07d69d,2,1,37,36,0,0,0,2,2,41,1,2,0.175565026,108,59,2,10,12,2,664,752,88,4,6,2,99.8630137
39fa0f134fbf4d16da2001792971135d9f24cf4c,9,298,65,233,1,0,1,4,11,1307,1,7,2.609176385,1299,232,0,198,205,7,10614,10092,522,106,100,6,97.73011897
aa85ffab39b50eeff46b47c68bc670c5e7c6a1d0,0,0,0,0,0,0,0,0,0,0,0,0,0,0,98,0,0,0,0,0,0,0,0,0,0,100
2c99257c970a5e8b29157a5fe52e74769ecd3444,0,0,0,0,0,0,0,0,0,0,0,0,0,0,138,2,0,0,0,0,0,0,0,0,0,100
d4498e6c512aac37e734fb9e970a3f466632c95c,0,0,0,0,0,0,0,0,0,0,0,0,0,0,60,1,0,0,0,0,0,0,0,0,0,100
f43035c02ef01f07ff382bbf136eb1bada727fbb,26,1704,656,1048,9,0,9,3,26,546,1,15,3.973997548,2555,99,1,407,276,131,24980,18575,6405,216,145,71,98.47658756
46b4c15a0c91569cc02ed71fa5bb91f3b6e2a572,0,0,0,0,0,0,0,0,0,0,0,0,0,0,17,0,0,0,0,0,0,0,0,0,0,100
65910d9e7a720ac47a8584510ab75f59c0c9f362,0,0,0,0,0,0,0,0,0,0,0,0,0,0,41,0,0,0,0,0,0,0,0,0,0,100
575d6ef09a13950377d6b0b7ba8419ab2ee7a6f9,0,0,0,0,0,0,0,0,0,0,0,0,0,0,12,0,0,0,0,0,0,0,0,0,0,100
01d66880d99f5f46770b0f02755f4e9d86980cf5,3,62,6,56,0,0,0,2,14,236,1,3,1.498751273,493,139,0,63,60,3,4920,4383,537,37,36,1,100
16e353b0d8c710eb64bad1188d8329d6872380e4,0,0,0,0,0,0,0,0,0,0,0,0,0,0,13,1,0,0,0,0,0,0,0,0,0,100
8e111e8ae09516e3c13138586e9c26fabe9fc981,0,0,0,0,0,0,0,0,0,0,0,0,0,0,1,0,0,0,0,0,0,0,0,0,0,100
1b6ef88c79d60022542cda7e9abbea7e720773cc,5,104,42,62,0,0,0,2,19,446,1,5,1.519829746,856,233,0,114,118,4,7596,7278,318,62,57,5,100
0cf78d223f24eaf7112bfb7fb52d8778f8a1a2fa,5,229,33,196,1,0,1,1,6,384,1,3,2.283448154,415,234,1,35,27,8,3887,3067,820,28,24,4,99.93633615
9641aec6284102d16db2fbfd1dc5960d6767008a,2,87,10,77,0,0,0,3,10,526,1,2,0.977728774,352,235,2,49,42,7,3214,2621,593,28,24,4,99.9363564
b89f066663b651d11abdf302da034d863559ce4e,0,0,0,0,0,0,0,0,0,0,0,0,0,0,14,0,0,0,0,0,0,0,0,0,0,100
4d420f4d1704b2da4e725de3fda4c08d97691611,3,111,13,98,0,0,0,2,4,165,1,2,1.143436049,722,140,0,85,75,10,6877,6143,734,55,48,7,100
22834879017355fa456f42a6e71a3ed44d0b43fe,1,60,23,37,0,0,0,1,7,6,1,1,0,227,236,3,16,15,1,1929,1849,80,15,14,1,100
36946ff09aadd54bebb503e89121d996f9242cc9,0,0,0,0,0,0,0,0,0,0,0,0,0,0,141,1,0,0,0,0,0,0,0,0,0,100
5e9cf705ef5feb1d723f584c1b6134bcc1eda9cf,7,186,71,115,1,0,1,1,10,1563,1,2,2.322851083,805,100,0,98,95,3,6679,6198,481,52,50,2,99.9522749
14dfdc69317f71388e63cd58e2064dc41f6934e5,69,1159,158,1001,0,0,0,2,16,1151,1,27,4.97969834,5548,101,1,1178,1178,0,40503,40462,41,654,654,0,97.94995964
d275a958cb5b7bbab533d273dff80bc1e3e65fd0,2,88,3,85,0,0,0,2,15,68,1,2,0.591672779,442,142,2,51,48,3,4966,4070,896,26,23,3,100
2fb8524ab46047aaf408691ac1d3143836371ab4,0,0,0,0,0,0,0,0,0,0,0,0,0,0,237,4,0,0,0,0,0,0,0,0,0,100
792e7962f32b8154cd501edb65fa3fb5819758dc,0,0,0,0,0,0,0,0,0,0,0,0,0,0,2,0,0,0,0,0,0,0,0,0,0,100
cc30c0e21656fa95b488adb47a3c9fcec94af67a,2,39,0,39,0,0,0,3,11,788,1,2,0.391243564,626,19,0,52,48,4,6359,6036,323,28,26,2,100
fec36c7ed0b2d29f4dc48574adf02c7fcb13e5fb,2,185,60,125,0,0,0,1,2,506,1,2,0.927526588,124,238,2,22,13,9,1023,473,550,15,9,6,100
2d2cec749c52659f4cf5b9177047b018222a13cd,43,2235,1546,689,10,0,10,2,22,605,1,24,4.678490807,5222,143,3,649,672,23,47955,49339,1384,367,368,1,98.3757178
42ce88e05c60e3e2a7005e9804b2e74332951d0a,0,0,0,0,0,0,0,0,0,0,0,0,0,0,18,0,0,0,0,0,0,0,0,0,0,100
6d41526c3eff511e5fe11368c6f3f0a837507ba1,12,1016,46,970,6,0,6,2,7,479,2,7,3.143093511,1145,144,2,202,145,57,14665,8493,6172,103,63,40,99.70525626
34a1fd513c8f27b130b6ba8edbb3d4a1ed463993,4,174,3,171,3,0,3,1,4,228,1,3,1.594724995,17,145,3,10,1,9,830,153,677,6,1,5,99.90215264
15119cb16b30862e6fbba3662407ca4db4c59a3a,0,0,0,0,0,0,0,0,0,0,0,0,0,0,20,1,0,0,0,0,0,0,0,0,0,100
e781237284698812f6ce4ac5847684e7a65135b8,0,0,0,0,0,0,0,0,0,0,0,0,0,0,19,1,0,0,0,0,0,0,0,0,0,100
1ae45a97dc73ee468f6d45052fbfa63c3bca19b8,4,28,25,3,0,0,0,3,13,1090,1,4,1.675967408,566,239,2,75,75,0,3955,3955,0,45,45,0,100
143901b018fff7008415e08351f32a63095b357e,0,0,0,0,0,0,0,0,0,0,0,0,0,0,15,0,0,0,0,0,0,0,0,0,0,100
91368e1ee3565a91a46ad8d2d3639fecce320e84,1,24,7,17,0,0,0,1,2,8,1,1,0,184,146,3,11,11,0,2398,2124,274,9,9,0,100
9c69ffc8559830096a6138a5ef8fb3c31ea5bca3,1,8,0,8,0,0,0,5,7,48,1,1,0,390,86,0,34,33,1,3507,3482,25,21,20,1,100
0c774ab921ff4271611bdf9d3bb7ad3978d3f7b0,1,0,0,0,0,0,0,1,1,0,1,1,0,264,87,1,61,61,0,2107,2107,0,22,22,0,99.93483219
ef1ce3c3d82758452fb63ca9d5cee31d266031ee,3,238,29,209,2,0,2,1,8,75,1,2,1.458216428,161,240,1,24,9,15,2202,1307,895,16,4,12,99.90232785
e63faf84f1b227c44b2d6b224b89c74449bcf0cc,0,0,0,0,0,0,0,0,0,0,0,0,0,0,241,2,0,0,0,0,0,0,0,0,0,100
ab9241d3df5edcd4d6ae84a72f552b0773d50954,0,0,0,0,0,0,0,0,0,0,0,0,0,0,18,0,0,0,0,0,0,0,0,0,0,100
17b31b48f59627a9e768a5cbe0be7ac55b5b04f8,0,0,0,0,0,0,0,0,0,0,0,0,0,0,20,0,0,0,0,0,0,0,0,0,0,100
af28bba3a651f7a92642acd66db9b6d3a27d45d6,2,11,0,11,0,0,0,3,6,282,1,2,0.845350937,292,19,1,43,42,1,1944,1838,106,12,12,0,100
2f1af5cc50ba0e5e940885a1eaf5096c40a49072,0,0,0,0,0,0,0,0,0,0,0,0,0,0,16,0,0,0,0,0,0,0,0,0,0,100
8bb7a27cd97a4d6e513f073463b9e62e96387f3d,0,0,0,0,0,0,0,0,0,0,0,0,0,0,88,2,0,0,0,0,0,0,0,0,0,100
88d3ca8a51f7b1ee059df4f1458dbceefd090e15,0,0,0,0,0,0,0,0,0,0,0,0,0,0,17,1,0,0,0,0,0,0,0,0,0,100
4da899043ffdb222f8a928cd30bc0f47b99c632a,0,0,0,0,0,0,0,0,0,0,0,0,0,0,147,0,0,0,0,0,0,0,0,0,0,100
cad679a5948ce0ee9866e61bbf75b1f5f255682c,0,0,0,0,0,0,0,0,0,0,0,0,0,0,21,0,0,0,0,0,0,0,0,0,0,100
cf7fcaeb3cb22755cf732505a2d6fc62783d7af9,1,31,17,14,0,0,0,5,9,48,1,1,0,143,242,0,10,9,1,1159,1085,74,4,4,0,100
a1c257c6a583ba705d5e551fb5e7f5c9862097ac,12,194,86,108,2,0,2,2,10,604,1,5,2.773215392,1674,148,1,172,167,5,13119,12593,526,122,121,1,99.90248659
14efe83e3a8d9ba7c2bef35061fc9829ee0e61f8,112,153,136,17,0,0,0,5,22,26,2,49,4.506816143,10938,89,1,1499,2229,730,84206,244430,160224,823,1430,607,90.79665917
64b079044f6840fc0bcb1bf9cb665790f37900f4,0,0,0,0,0,0,0,0,0,0,0,0,0,0,149,2,0,0,0,0,0,0,0,0,0,100
54aa46ee44a329504559f417790324c175f5af6a,1,19,20,1,0,0,0,2,2,338,1,1,0,261,90,1,36,37,1,1905,1887,18,10,10,0,100
8d7ce165050619abf3d8be600ba4c8655b6ad0ed,0,0,0,0,0,0,0,0,0,0,0,0,0,0,150,3,0,0,0,0,0,0,0,0,0,100
46e8625865100b35ee69fe6499e8bda56197fbcd,0,0,0,0,0,0,0,0,0,0,0,0,0,0,18,1,0,0,0,0,0,0,0,0,0,100
57095488f28a017e290e021fea65412e7240e8da,23,1051,152,899,6,0,6,3,15,921,2,16,3.853027373,1606,91,2,258,167,91,18586,13203,5383,169,116,53,98.71634314
80ae71f5ebeb3c6761951a70871fee208448f3e1,0,0,0,0,0,0,0,0,0,0,0,0,0,0,3,0,0,0,0,0,0,0,0,0,0,100
2f2c80244b34e8182f72e6f4dc98a2940194eaa0,57,308,271,37,2,0,2,5,23,60,2,31,4.565760679,6932,151,4,864,842,22,59596,60611,1015,470,480,10,96.48241206
3a61933ed4fb6ec00286f4c13a22c372adf8d0dc,0,0,0,0,0,0,0,0,0,0,0,0,0,0,152,4,0,0,0,0,0,0,0,0,0,100
dc273a5be628c458ad0b25380d55536cd37b7a4f,2,180,12,168,0,0,0,5,13,350,1,2,0.999295444,1012,92,3,103,84,19,10733,9446,1287,79,68,11,100
d6763a8fad94e7b25bdf03e7b896eb435852c8e5,0,0,0,0,0,0,0,0,0,0,0,0,0,0,102,0,0,0,0,0,0,0,0,0,0,100
c58062a263927a4c41edd0315d58077e0a91446a,0,0,0,0,0,0,0,0,0,0,0,0,0,0,21,0,0,0,0,0,0,0,0,0,0,100
b6d8cade6aec7fe6290d4fd5660ff205de06bd64,0,0,0,0,0,0,0,0,0,0,0,0,0,0,93,4,0,0,0,0,0,0,0,0,0,100
7f6ad42e534eeaf9423f33c3a6ea1d3d131049f5,0,0,0,0,0,0,0,0,0,0,0,0,0,0,94,5,0,0,0,0,0,0,0,0,0,100
c453b1edf27a4a2883e4c055246d939218908ebb,2,188,4,184,1,0,1,1,2,180,1,2,0.528761721,239,153,5,33,26,7,3062,1901,1161,16,10,6,99.7761194
51d1c812c1e45f57da8c27fe37fd13797707884e,38,185,195,10,2,0,2,1,10,74,1,16,2.567879643,4078,154,6,493,150,343,33138,18827,14311,260,99,161,97.83537034
fd6bbcc4ab9862ce0891bd7570a7654dcd68ea46,1,0,0,0,0,0,0,1,1,0,1,1,0,266,155,5,20,20,0,2225,2225,0,13,13,0,99.94146912
f99cc54d367c1f36433f7a41e1c89e7bf75786fb,0,0,0,0,0,0,0,0,0,0,0,0,0,0,156,6,0,0,0,0,0,0,0,0,0,100
024aa201bc4cbe00af71c57b9e0fe27b51305030,0,0,0,0,0,0,0,0,0,0,0,0,0,0,243,0,0,0,0,0,0,0,0,0,0,100
4390e38c2460624734ead7ab6f9fff3738471c4e,0,0,0,0,0,0,0,0,0,0,0,0,0,0,103,0,0,0,0,0,0,0,0,0,0,100
f3f5c9743f515d8902b4580c765ad9d2b64aa63b,0,0,0,0,0,0,0,0,0,0,0,0,0,0,61,0,0,0,0,0,0,0,0,0,0,100
e1d1901395d7b135deb48c3c4af5a94ed35fbaa4,0,0,0,0,0,0,0,0,0,0,0,0,0,0,95,0,0,0,0,0,0,0,0,0,0,100
57bbab2c899877ddb114082bff111444b3089b00,0,0,0,0,0,0,0,0,0,0,0,0,0,0,157,0,0,0,0,0,0,0,0,0,0,100
d92e0a2102306ce6d6b6b2a8c986590b030d4a88,0,0,0,0,0,0,0,0,0,0,0,0,0,0,0,0,0,0,0,0,0,0,0,0,0,100
fb80e32e04f5e02ba1b10bd1a915047e42480819,0,0,0,0,0,0,0,0,0,0,0,0,0,0,42,0,0,0,0,0,0,0,0,0,0,100
adf477d90cf23bc757641b3e74bdb2ed9b242f04,0,0,0,0,0,0,0,0,0,0,0,0,0,0,19,0,0,0,0,0,0,0,0,0,0,100
5a3fd55683fe7d6d35c1d7e293c9853a057a384b,0,0,0,0,0,0,0,0,0,0,0,0,0,0,104,1,0,0,0,0,0,0,0,0,0,100
fcd681d10256c3cc44722cff694d08649ea27673,0,0,0,0,0,0,0,0,0,0,0,0,0,0,4,0,0,0,0,0,0,0,0,0,0,100
b8df052fabe4e00a1a30e20f958f6e07c4fb4fef,0,0,0,0,0,0,0,0,0,0,0,0,0,0,96,1,0,0,0,0,0,0,0,0,0,100
2653157862740fc05ce8b3a8dcf4745a9f996c23,0,0,0,0,0,0,0,0,0,0,0,0,0,0,5,1,0,0,0,0,0,0,0,0,0,100
506c18cb5abe3a8ec1d660af9350382e085c6e15,0,0,0,0,0,0,0,0,0,0,0,0,0,0,6,2,0,0,0,0,0,0,0,0,0,100
22cc622d6f08cfa77c06dea2df7f4c56edc1862e,6,614,82,532,2,0,2,1,3,296,1,6,1.863908704,558,7,0,144,85,59,8017,4467,3550,64,34,30,99.94150336
3b0446006c327b7dea494b3a0bcbb9de4f662d5a,5,319,11,308,2,0,2,1,3,451,2,3,2.027944909,267,1,1,50,30,20,2723,1592,1131,33,20,13,99.91235758
a6281d30ae82216dfe2c37576884a67b72e74ab7,0,0,0,0,0,0,0,0,0,0,0,0,0,0,105,1,0,0,0,0,0,0,0,0,0,100
373ac513b0779c9399fce299094560a0261a6590,9,202,12,190,1,0,1,4,24,343,1,8,2.410722076,1144,158,1,166,154,12,10973,9959,1014,110,100,10,99.97081144
9b70adf1d7f716c4a301af10c6726c40ecb1f3dc,2,11,11,0,0,0,0,5,14,288,1,2,0.439496987,1595,97,1,189,189,0,13608,13596,12,100,100,0,100
ccb5bec1dd101850c18faee128bbca77af815880,0,0,0,0,0,0,0,0,0,0,0,0,0,0,244,0,0,0,0,0,0,0,0,0,0,100
bfe662d6e7b07f8340067d7aaeb976068617b6b1,2,363,363,0,0,0,0,1,2,22,1,2,0.992492606,389,8,1,59,59,0,3384,3384,0,28,28,0,100
b9a130ca96774add38865d3934ed61ca19599b87,135,34,31,3,0,0,0,1,1,0,1,39,3.256156761,15357,159,1,1911,1620,291,123775,111510,12265,1094,945,149,92.50991335
3754ff33f6cd149ffca57474d744e0298d4c172a,8,130,34,96,0,0,0,2,21,404,1,5,2.35917265,1192,98,1,111,108,3,10952,10094,858,70,68,2,100
2dd753e4b69fe1b85b7604a8d0e20af8ecea0ae8,1,1,0,1,0,0,0,2,2,137,1,1,0,56,99,2,10,10,0,451,438,13,5,5,0,100
a8f2d3a2814315da950f24ec74bacc3b8f44b1f2,0,0,0,0,0,0,0,0,0,0,0,0,0,0,100,3,0,0,0,0,0,0,0,0,0,100
dbf8bf9dd0f7140092ba789ff048c2f6beeb79c6,0,0,0,0,0,0,0,0,0,0,0,0,0,0,101,4,0,0,0,0,0,0,0,0,0,100
e16ff316ae1a05f88a1f515ba2040d6cddab1d3f,0,0,0,0,0,0,0,0,0,0,0,0,0,0,106,0,0,0,0,0,0,0,0,0,0,100
a1487ec104c0ebb7e3383499b445726dbe5de142,3,22,1,21,0,0,0,2,8,153,1,3,1.409844941,539,160,1,100,95,5,4421,4297,124,53,50,3,100
5bd7e010c2f389c2c14476337df982f2e781af8d,0,0,0,0,0,0,0,0,0,0,0,0,0,0,20,0,0,0,0,0,0,0,0,0,0,100
3c1317360243398eef8097edcea5f7c1a0bb2f59,7,331,14,317,2,0,2,1,26,848,1,6,1.850234447,443,102,4,80,57,23,5197,3375,1822,53,35,18,99.83749446
9621ec7dbd740e0fe37d12f283b4e7a7e0f0178f,0,0,0,0,0,0,0,0,0,0,0,0,0,0,7,0,0,0,0,0,0,0,0,0,0,100
38b8a7824a3ceed829215c8ce4ecad963ebf449e,9,831,132,699,7,0,7,2,2,46,1,4,3.131478456,193,161,1,79,25,54,5181,1480,3701,48,11,37,99.76435935
ee1b2c34d329a4fffbb6e900fe06112eda7bc8cd,0,0,0,0,0,0,0,0,0,0,0,0,0,0,8,1,0,0,0,0,0,0,0,0,0,100
09bbdf30e1ecef88b67755d12d407a39ce44536c,0,0,0,0,0,0,0,0,0,0,0,0,0,0,22,0,0,0,0,0,0,0,0,0,0,100
a2a46e6567c78e5066c0d3360d7838d1a5851fa7,25,59,621,562,0,0,0,3,10,536,2,13,2.375645817,2272,162,1,313,2286,1973,12985,73444,60459,191,978,787,98.64964039
f2f3bb4877b02ce40e9712a9bd0c91f6e4d40d75,0,0,0,0,0,0,0,0,0,0,0,0,0,0,245,0,0,0,0,0,0,0,0,0,0,100
c9604c255aa596202c6fb348fca3aa9816c0b297,1,22,15,7,0,0,0,1,2,2303,1,1,0,119,103,0,9,9,0,1034,979,55,9,9,0,100
02f88a313068a876e20227a2347cedafb4cec0ae,14,50,1717,1667,0,0,0,2,3,231,1,3,3.694888943,1656,246,1,53,194,141,4506,14045,9539,23,98,75,97.92775939
87928824509c5f6ab314375be720dd64d8361cf4,5,424,2,422,4,0,4,1,2,19,1,2,1.488291166,42,163,1,34,5,29,3003,398,2605,18,2,16,99.85891648
c8f2c9affd8e3b2ed9b99cf7eb9ac7b61e4d37a2,0,0,0,0,0,0,0,0,0,0,0,0,0,0,104,1,0,0,0,0,0,0,0,0,0,100
bf673a2e9c00a59716e70feea55d581af91145f1,5,262,35,227,0,0,0,2,2,100,1,4,1.572459938,762,247,2,114,99,15,7590,6246,1344,74,60,14,98.59310345
891ebd5ce4391bcf3260cff3db20f08d27ea21fa,0,0,0,0,0,0,0,0,0,0,0,0,0,0,21,0,0,0,0,0,0,0,0,0,0,100
42ce5add9ae5b20bb3667e81e8aaa148f48a4d42,5,1068,653,415,1,0,1,2,5,582,1,3,1.656051489,882,164,1,142,100,42,9342,7642,1700,97,68,29,99.97298757
f36bba7c0ed6a2cff3f30de73d7e2650e03681a6,2,7,0,7,0,0,0,4,8,1321,1,2,0.985228136,145,23,0,22,22,0,1112,1053,59,10,10,0,100
5425f8f97a7d3620d7dd2e0a9d26f692b58963fb,0,0,0,0,0,0,0,0,0,0,0,0,0,0,21,0,0,0,0,0,0,0,0,0,0,100
b516a75417a01b080462acdcf61b7101f8e67d0d,0,0,0,0,0,0,0,0,0,0,0,0,0,0,22,1,0,0,0,0,0,0,0,0,0,100
753e8ea6693abfe762fc5f7d186bde8d71609fc4,0,0,0,0,0,0,0,0,0,0,0,0,0,0,23,2,0,0,0,0,0,0,0,0,0,100
7e39143caf841fdb576caa417ce33110ba123270,0,0,0,0,0,0,0,0,0,0,0,0,0,0,105,0,0,0,0,0,0,0,0,0,0,100
43f74fc91a24ea2b24f5a41038cdf46d3d883fa1,1,3,3,0,0,0,0,1,2,620,1,1,0,192,62,0,13,13,0,1530,1530,0,12,12,0,100
ed63eac260e442f8c6f17dd93f6d87fc946cae0d,8,122,80,42,0,0,0,2,3,120,1,6,2.260329593,1441,248,0,120,114,6,13103,12824,279,90,90,0,99.59178119
5e1e3bd2e2876a6774b9c50d72115332f0bc15ee,0,0,0,0,0,0,0,0,0,0,0,0,0,0,22,0,0,0,0,0,0,0,0,0,0,100
65681a0a0888576725663347e52deafe8ca94a1a,0,0,0,0,0,0,0,0,0,0,0,0,0,0,9,0,0,0,0,0,0,0,0,0,0,100
6306c935d71150456c2adbd0702001ae6b88fe38,0,0,0,0,0,0,0,0,0,0,0,0,0,0,10,1,0,0,0,0,0,0,0,0,0,100
625653513849e4e848b96582d920fb193a4c961f,0,0,0,0,0,0,0,0,0,0,0,0,0,0,23,1,0,0,0,0,0,0,0,0,0,100
8a5e7e7d348922477faf1717b8556d81e950b762,0,0,0,0,0,0,0,0,0,0,0,0,0,0,24,2,0,0,0,0,0,0,0,0,0,100
855de4a21ceb33bb608d7eb8100397eae294d81a,0,0,0,0,0,0,0,0,0,0,0,0,0,0,106,1,0,0,0,0,0,0,0,0,0,100
340827f2569767056698ac38cf4517dc866c4e06,0,0,0,0,0,0,0,0,0,0,0,0,0,0,107,1,0,0,0,0,0,0,0,0,0,100
8c4b53dae73067e05cfcdac42ceb9c562bf4c2fd,2,37,14,23,0,0,0,2,2,200,1,2,0.139232999,373,108,2,52,48,4,3550,3424,126,26,23,3,100
0239432b967bc176d20d6965544be582f54ae0e9,5,29,2,27,0,0,0,4,6,2290,1,3,2.2517951,226,24,0,35,30,5,2522,2309,213,24,20,4,100
771d66b5a806f9c0f1c53c1782977e00fa26917a,20,1686,69,1617,5,0,5,2,21,580,3,16,2.319792784,2636,2,0,638,448,190,31546,19833,11713,330,176,154,99.4259158
3bea6adfd44ac7d4b04f42c38ccd46ab5796dab1,0,0,0,0,0,0,0,0,0,0,0,0,0,0,25,1,0,0,0,0,0,0,0,0,0,100
f6054a46d6ba56396e61f26eeeb08ec47a40a498,146,825,617,208,0,0,0,3,17,895,5,103,6.503112983,23683,0,0,2912,2913,1,208163,206128,2035,1556,1556,0,100
88f4d2cefe4bbb389732da3b4f5cbcf02b7b949a,34,667,192,475,1,0,1,3,5,63,1,31,4.443922929,5850,109,1,802,748,54,62194,58667,3527,331,283,48,99.72903401
5e93677d38889fdd34d4f6a93ab0e8099bf01c7b,1,17,12,5,0,0,0,5,6,857,1,1,0,178,3,0,29,29,0,1086,1040,46,29,29,0,100
7219606fd56258c3037c73e5709f2144702fe37a,0,0,0,0,0,0,0,0,0,0,0,0,0,0,110,1,0,0,0,0,0,0,0,0,0,100
4ab1fdba2f93cfb90dea55d315fb7f45c63d2fa6,0,0,0,0,0,0,0,0,0,0,0,0,0,0,24,0,0,0,0,0,0,0,0,0,0,100
e6ca3c71d8120516afcf816be2cda81093088b72,0,0,0,0,0,0,0,0,0,0,0,0,0,0,165,0,0,0,0,0,0,0,0,0,0,100
1a6d77fd74e37950ced4ae1620d9ee9d80cdc4b1,0,0,0,0,0,0,0,0,0,0,0,0,0,0,166,1,0,0,0,0,0,0,0,0,0,100
888c4bc8f353ea0424f28919ab33b5f4ad861d25,0,0,0,0,0,0,0,0,0,0,0,0,0,0,25,1,0,0,0,0,0,0,0,0,0,100
edc449ffa6be51749f6a3b100bf6a0a33755e50c,0,0,0,0,0,0,0,0,0,0,0,0,0,0,26,2,0,0,0,0,0,0,0,0,0,100
5eed6663f2689e160be0a525c8e423961cd2269f,0,0,0,0,0,0,0,0,0,0,0,0,0,0,20,0,0,0,0,0,0,0,0,0,0,100
67fa5a403b01d0f7c8607c06e63f9d06f8b8cbc1,1,13,9,4,0,0,0,7,7,1598,1,1,0,274,4,0,45,45,0,2168,2124,44,27,27,0,100
3b96474ee3b82e9d254b466d5997321b90a6f8c5,1,1,1,0,0,0,0,5,8,588,1,1,0,108,25,0,22,22,0,641,641,0,9,9,0,100
c402e6442d8d699eef5aa5464cd91347160b082c,41,378,376,2,0,0,0,3,18,611,3,32,4.845457931,5940,111,1,829,828,1,48763,48532,231,426,425,1,99.78509066
722eb66a6a6a1208185e238f29864d95c673f404,0,0,0,0,0,0,0,0,0,0,0,0,0,0,27,2,0,0,0,0,0,0,0,0,0,100
b1536d73fd33707357f0b0274443d63f9487454c,1,14,4,10,0,0,0,2,2,192,1,1,0,318,249,0,22,22,0,2621,2547,74,22,22,0,100
0e2eadf7dc7aa9db3e77f97b43c5846625162059,0,0,0,0,0,0,0,0,0,0,0,0,0,0,5,1,0,0,0,0,0,0,0,0,0,100
92220ced649b14d90fd7bc27b66a3d2eca651475,0,0,0,0,0,0,0,0,0,0,0,0,0,0,28,1,0,0,0,0,0,0,0,0,0,100
3a666d5d8d6489882bcc32ded5f53bb5225c3ab1,0,0,0,0,0,0,0,0,0,0,0,0,0,0,6,1,0,0,0,0,0,0,0,0,0,100
eaee9f84f27c9fcf35cf2b0492352016b5b88b76,0,0,0,0,0,0,0,0,0,0,0,0,0,0,167,0,0,0,0,0,0,0,0,0,0,100
080e074e9d3861f102e74a46a30f6b90ac2da1c9,0,0,0,0,0,0,0,0,0,0,0,0,0,0,250,0,0,0,0,0,0,0,0,0,0,100
d693e282342afb8e67a57744ee3505262295dd35,0,0,0,0,0,0,0,0,0,0,0,0,0,0,26,0,0,0,0,0,0,0,0,0,0,100
03e0977ffa0815f129fcb5a1340f6a2b2f0212c6,0,0,0,0,0,0,0,0,0,0,0,0,0,0,11,0,0,0,0,0,0,0,0,0,0,100
895fe493f38fd85abd3e0f14df507293b977ccfe,0,0,0,0,0,0,0,0,0,0,0,0,0,0,112,0,0,0,0,0,0,0,0,0,0,100
50b5c50d93db92ff0d13de7d640187b614fd5de6,0,0,0,0,0,0,0,0,0,0,0,0,0,0,0,0,0,0,0,0,0,0,0,0,0,100
bb9a244d81feb54bc93456310f57a92d63cea38f,0,0,0,0,0,0,0,0,0,0,0,0,0,0,27,1,0,0,0,0,0,0,0,0,0,100
67b4d0b2c84f7f370890c1caf639459a4c40b37a,0,0,0,0,0,0,0,0,0,0,0,0,0,0,113,0,0,0,0,0,0,0,0,0,0,100
e645ffe34a98617b91261738477358c760bb60cf,0,0,0,0,0,0,0,0,0,0,0,0,0,0,0,0,0,0,0,0,0,0,0,0,0,100
37a8e2e8211dd2c8a56c8e75b516e3029c421099,0,0,0,0,0,0,0,0,0,0,0,0,0,0,251,0,0,0,0,0,0,0,0,0,0,100
d0d64d4ad227711b3cf842bca2965087ed191f59,0,0,0,0,0,0,0,0,0,0,0,0,0,0,28,0,0,0,0,0,0,0,0,0,0,100
581a43f870de3940cadd9cf8170d43a598f89640,0,0,0,0,0,0,0,0,0,0,0,0,0,0,1,0,0,0,0,0,0,0,0,0,0,100
df6e18154c508cd803095d31f8ff9cf96e05406b,0,0,0,0,0,0,0,0,0,0,0,0,0,0,2,1,0,0,0,0,0,0,0,0,0,100
eb1dda62eccc5f6e9ae402d743b11564b4506ba5,0,0,0,0,0,0,0,0,0,0,0,0,0,0,29,1,0,0,0,0,0,0,0,0,0,100
6c064b76e2252776cde64280b9ee15091339cf5a,0,0,0,0,0,0,0,0,0,0,0,0,0,0,114,1,0,0,0,0,0,0,0,0,0,100
fb3986e3ec6c39838fec2cf96020d84dd2ff86bc,0,0,0,0,0,0,0,0,0,0,0,0,0,0,30,2,0,0,0,0,0,0,0,0,0,100
8686f5265e68a5fb861f944b4b3b086c807618f2,2,30,3,27,0,0,0,1,8,1004,1,2,0.532835063,324,252,1,19,19,0,2724,2631,93,18,18,0,100
604a106f74ba0d2151e805b261f04b91a14fa2f6,0,0,0,0,0,0,0,0,0,0,0,0,0,0,107,0,0,0,0,0,0,0,0,0,0,100
12e16df4c340be169ff0d0190c732948fdcd2e44,0,0,0,0,0,0,0,0,0,0,0,0,0,0,253,1,0,0,0,0,0,0,0,0,0,100
fca9ebf0dc945bea485be334e4fcfcbe7ed179cf,0,0,0,0,0,0,0,0,0,0,0,0,0,0,115,1,0,0,0,0,0,0,0,0,0,100
97d7e46f53376303e18540075b0aa53198b0a1cb,1,30,23,7,0,0,0,6,7,1591,1,1,0,170,108,1,39,26,13,1446,1390,56,20,20,0,100
650c6cb39ae089c9bd8d8b039cd6a67140dbf085,0,0,0,0,0,0,0,0,0,0,0,0,0,0,29,0,0,0,0,0,0,0,0,0,0,100
20688203662663571ac02e6d5c80394ed0c0e206,0,0,0,0,0,0,0,0,0,0,0,0,0,0,31,0,0,0,0,0,0,0,0,0,0,100
fc4bf498dc39a00715ec772a3ad4f9368b532101,0,0,0,0,0,0,0,0,0,0,0,0,0,0,254,2,0,0,0,0,0,0,0,0,0,100
101d4275ce09b819b2312407e427469370f69ef8,7,69,178,109,0,0,0,1,9,842,1,4,1.974111471,822,255,3,49,63,14,5924,6200,276,38,52,14,98.1498137
657028bc7f69fb7b4d54fae22b3c3fcb5d88b61b,1,1,13,12,0,0,0,4,9,834,1,1,0,86,256,4,24,25,1,553,629,76,9,9,0,97.68912987
1ece1ed0d2ac85d3d8114c45b555a657e2521be8,0,0,0,0,0,0,0,0,0,0,0,0,0,0,12,0,0,0,0,0,0,0,0,0,0,100
ebed1db10644d769f23ef7266d8365adca7c13cb,0,0,0,0,0,0,0,0,0,0,0,0,0,0,30,1,0,0,0,0,0,0,0,0,0,100
9b4979d69319436af5a65fd52bc555f794aa5029,0,0,0,0,0,0,0,0,0,0,0,0,0,0,31,2,0,0,0,0,0,0,0,0,0,100
19dd9b173b5fbe3c4dc1e08a5d0498a1c441c6bc,1,6,1,5,0,0,0,3,7,332,1,1,0,330,257,2,17,17,0,2765,2730,35,13,13,0,100
b8ea1e22aebdd4e228f4c278c3171c18af664de4,0,0,0,0,0,0,0,0,0,0,0,0,0,0,116,0,0,0,0,0,0,0,0,0,0,100
83effe49b5b996af16f68b67c6e998010a51513f,0,0,0,0,0,0,0,0,0,0,0,0,0,0,109,0,0,0,0,0,0,0,0,0,0,100
b71ddceeefb4efc677f800c66ca65fae46f4a45a,411,9314,10477,1163,0,0,0,2,25,1024,5,168,7.914924166,57886,110,1,4710,4748,38,490702,506504,15802,3574,3563,11,94.0312976
0da31ba17a522b5afb5186d819e70999c4702e77,0,0,0,0,0,0,0,0,0,0,0,0,0,0,13,0,0,0,0,0,0,0,0,0,0,100
e57a795dc0f4781a9807bb08570b2b3948b79a97,0,0,0,0,0,0,0,0,0,0,0,0,0,0,14,1,0,0,0,0,0,0,0,0,0,100
dbacbc3cae9173466de14bbc49f7e49bf45b11e0,0,0,0,0,0,0,0,0,0,0,0,0,0,0,117,0,0,0,0,0,0,0,0,0,0,100
8fa25664fdff439ba28492bf43e26788691ec84b,0,0,0,0,0,0,0,0,0,0,0,0,0,0,63,0,0,0,0,0,0,0,0,0,0,100
1252573eab087e87fb2938f8651c5b0b393aca9e,2,2,2,0,0,0,0,3,4,1517,1,2,1,133,0,0,13,13,0,758,758,0,12,12,0,100
