CommitID,NMF,TotalAddLines,TotalDeleteLines,LC,FileAdd,FileDelete,NAD,NDEV,NUC,AGE,NS,ND,Entropy,LT,EXP,REXP,CommitComplexity,LastCommitComplexity,CFC,CommitTokenCount,LastCommitTokenCount,NCC,CommitMethodNum,LastCommitMethodNum,NMC,a2a
b38bdc89ccb582ef006d84d726aebf63b35ccafe,16,2,28,26,0,0,0,1,2,0,1,4,3.831401845,6454,3,3,1279,1279,0,27719,27884,165,864,864,0,100
42cbc4dd743d0072aea113d13788f9324eb193e0,0,0,0,0,0,0,0,0,0,0,0,0,0,0,4,4,0,0,0,0,0,0,0,0,0,100
e6584f2f7490ee77caad0c349866c5c395ec086a,1,0,965,965,0,0,0,1,2,2,1,1,0,535,5,5,0,139,139,0,2911,2911,0,61,61,99.64028777
9d8d5d02e365b7b76477422d3740b692592db8c7,1,0,1,1,0,0,0,1,2,2,1,1,0,21,6,6,0,0,0,24,24,0,0,0,0,100
b9183699ba5e4eb2335772077f2b0d8918767fb8,255,34413,28019,6394,136,0,136,1,3,0,1,16,7.329483177,18605,7,0,5133,3853,1280,118311,82529,35782,2550,2016,534,12.60096931
46e7dbf647b3ae5653e242218f7723f0b0dd5e89,267,26695,81,26614,121,0,121,1,2,0,2,20,6.21745267,21031,8,1,9050,4649,4401,221789,74393,147396,4483,732,3751,14.0562249
67410de676d5a77588829e97edbe1e251839f99d,1,0,162,162,0,0,0,1,2,0,1,1,0,130,9,2,0,20,20,0,464,464,0,10,10,99.84686064
bf8ffa5ced5bda9a67d87fc43bd4336509112e74,282,15602,19826,4224,17,0,17,1,2,0,2,24,7.198327621,37258,10,3,9422,9030,392,230040,221325,8715,4669,4473,196,95.45454545
f025bd4015c8b5969bdcf8f71a16674c42060105,1,1,1,0,0,0,0,1,3,0,1,1,0,103,11,4,25,25,0,681,675,6,14,14,0,99.71035482
00652be8fdb0007e6b0b624a370b9837c2854019,1,4,1,3,0,0,0,1,3,28,1,1,0,183,12,5,70,70,0,1151,1151,0,29,29,0,100
1fede626e2cad16f7bb4d77dd9fc3270a8b6b331,721,98481,4732,93749,439,0,439,1,4,0,6,38,7.990156963,36427,13,6,25054,9422,15632,622276,230046,392230,10849,4669,6180,59.93044822
b9636bb8786de3ffbc3c897f4fe5f38e979c9df7,8,75,3,72,0,0,0,1,4,0,3,3,1.514705607,3077,14,7,822,822,0,19053,18555,498,610,610,0,100
7a6d34e95f66e916e44b844b1ce6551ba8169539,490,98492,92160,6332,0,0,0,1,5,0,6,27,7.583389986,75739,15,8,19425,19423,2,476309,475649,660,7899,7896,3,100
3feb467900547ecac8be5acadcdb02f79433db33,107,0,22832,22832,0,0,0,1,5,0,1,7,6.028548787,14475,16,9,0,3746,3746,0,95986,95986,0,1820,1820,93.06099608
26ee3648c3985b0e9b69201c3725a37518759aee,11,29,100,71,0,0,0,1,4,0,3,5,2.527949339,5907,17,8,1384,1395,11,44752,44951,199,357,362,5,100
4bc5b3bd0f9b0df5259b93666555f1a45b6f0f57,3,5,11,6,0,0,0,1,3,3,1,3,1.561278124,2831,18,8,831,831,0,17906,17946,40,285,285,0,100
4ddf63ea3f0ed80c6efa8877201d909900965244,50,54,219,165,0,0,0,1,6,0,4,20,5.006329922,21105,19,9,5911,5934,23,135517,136350,833,1738,1749,11,99.91052789
7cf69d8bccc218d9013f81574916e9ae06afbd68,584,4118,4041,77,0,0,0,1,7,0,5,23,8.351267806,84964,20,10,20723,20723,0,504224,504224,0,8708,8708,0,100
e27f636729b8e1fe67f8f6fdb741c962f04fe9cb,20,30,35,5,0,0,0,1,7,0,2,10,4.127579206,6462,21,11,1491,1491,0,46846,46846,0,460,460,0,100
1baedb7e8a81e33e731ade1bd35a13ae01683224,1,2,0,2,0,0,0,1,6,0,1,1,0,2340,22,12,455,454,1,18996,18968,28,97,97,0,100
6577d2f166a07688870db4014961ec1f8b5b4ead,3,38,62,24,0,0,0,1,6,0,2,3,0.797081082,492,23,13,84,87,3,3072,3178,106,34,32,2,95.82654059
32baa428fe8f575255f2e18987689d05d04f58b3,5,46,27,19,0,0,0,1,7,0,2,4,2.031809676,1185,24,14,343,341,2,8335,8258,77,81,79,2,99.96405464
2d8ee34a01f6e0b08b2be44f15e434d16523ea9d,13,227,135,92,0,0,0,1,6,0,3,6,2.500160738,3321,25,13,734,718,16,21028,20473,555,364,360,4,95.76133029
9fd87ae45c1be381de35d7a1f14233d9de4e7905,0,0,0,0,0,0,0,0,0,0,0,0,0,0,26,14,0,0,0,0,0,0,0,0,0,100
6936fc0d59ddfdbd903580572acd198cd53b86e5,1,28,31,3,0,0,0,1,7,6,1,1,0,408,27,15,127,128,1,2952,2962,10,20,20,0,100
99eb918da3e5dbf1253a57e2b0a2b41f666457a4,4,93,2,91,1,0,1,1,7,7,1,3,1.400166176,1593,28,16,407,388,19,11664,11171,493,151,148,3,99.82121573
19b401bcc7a1059ac04de3a9abce2d3a99121cf1,4,23,9,14,0,0,0,1,8,4,2,3,1.257531873,1201,29,17,332,331,1,8417,8354,63,90,89,1,100
89f6359ebc163a62f246fc2c9057b6b7071d7ece,4,16,44,28,0,0,0,1,7,10,2,3,1.352753401,1798,30,18,297,300,3,10657,10793,136,214,216,2,100
f9eb746445e84c4d2fab223175ed54cdac45cede,1,24,0,24,1,0,1,1,1,0,1,1,0,0,31,19,2,0,2,78,0,78,2,0,2,95.7439896
7d1c8fccafcd31919a79edf46969c5662e2704b5,447,79858,2072,77786,345,0,345,1,9,0,8,30,7.610331904,43435,32,20,24698,11664,13034,631741,273214,358527,9020,3918,5102,74.65152297
aad47c26bdcb9edfef7f2022d1605d0f7b698a90,22,3,59,56,0,0,0,1,8,0,2,8,4.142609047,8461,33,21,2571,2575,4,60241,60615,374,841,842,1,99.97980614
b108a39e7ec1719df17034f9f0083477be816951,945,0,0,0,0,0,0,1,10,0,8,38,0,140977,34,22,34167,34167,0,877749,877749,0,14019,14019,0,100
a1f4fd3eb0c3e7e80f73c1a06bc0cb7c29249503,7,206,251,45,0,0,0,1,8,0,3,3,2.077364893,4241,35,23,1130,1130,0,29559,29559,0,327,327,0,100
09e89d9cbb2523696e19ac6c1bca52d6b3b6ebe1,1,12,12,0,0,0,0,1,6,0,1,1,0,357,36,24,100,100,0,2111,2111,0,40,40,0,100
fc9321f35e252d60186482393d63e967587af2d2,3,10,38,28,0,0,0,1,9,0,2,2,1.554585169,4296,37,25,1266,1268,2,27043,27095,52,337,339,2,100
7bd0d044e3b65fc046fce6fccad65a8d85d5ced4,2,12,6,6,0,0,0,1,7,4,1,1,0.764204507,446,38,26,110,109,1,2631,2604,27,45,45,0,100
958386b2b2d4e5a68da35c9ca6401817adb92286,1,0,1,1,0,0,0,1,3,5,1,1,0,571,39,27,143,143,0,4715,4729,14,31,31,0,100
b028e31507fc194b4e57bbb3ce4a5fd78fa2f98e,1,1,3,2,0,0,0,1,6,5,1,1,0,52,40,28,9,9,0,225,228,3,7,7,0,100
ca8633ab49759e186ca79a4d9c66c394c16693f5,3,5,3,2,0,0,0,1,10,3,3,3,1.5,1948,41,29,445,445,0,12367,12363,4,190,190,0,100
7f6a84d433fc5a0a52cdeae06e5b7a955e59076c,1,11,38,27,0,0,0,2,8,5,1,1,0,632,0,0,125,131,6,3587,3759,172,43,47,4,100
775c33d4fc177c010f40400bd3e2085d787cfac8,1,2,2,0,0,0,0,2,7,11,1,1,0,454,1,1,120,120,0,3235,3233,2,20,20,0,100
aafabcf1694d1627c0b48db51b26f409e4c1700a,1,35,14,21,0,0,0,2,6,11,1,1,0,74,2,2,9,4,5,570,495,75,7,3,4,100
7ded1815868d29a41f78c767e6234bbcf08a8532,1,1,2,1,0,0,0,2,7,11,1,1,0,1135,3,3,221,221,0,6495,6495,0,186,186,0,100
a9bb3a637797351178d7a33745e834519005ee61,1,74,63,11,0,0,0,2,5,14,1,1,0,804,0,0,75,75,0,7551,7445,106,35,35,0,100
42136d9d12d3e718f84d2d84c2bc9019efb1c264,1,0,2,2,0,0,0,2,4,8,1,1,0,688,1,1,136,136,0,4146,4155,9,86,86,0,100
98e8533cb0c6418329cb9a7b1d4514fbeca4720e,0,0,0,0,0,0,0,0,0,0,0,0,0,0,4,4,0,0,0,0,0,0,0,0,0,100
884ff1b86393b49d0d88fc95a7b80511dd9cb7c3,24,661,610,51,0,0,0,2,10,0,2,7,2.590165503,15443,0,0,4431,4419,12,99786,99573,213,1443,1436,7,96.42058166
3b1cb17cbae7af2b985e3e7c11833282d1db58a2,73,995,886,109,0,0,0,2,11,0,7,21,4.681041182,32035,0,0,8426,8423,3,216820,216285,535,2730,2727,3,99.25976932
e9aa22eddc521128fa8dd0a97215eb0dfee5388c,2,2,2,0,0,0,0,3,9,0,1,1,1,1390,5,5,223,223,0,8385,8385,0,188,188,0,99.94865651
bbb2d060b004901c62301d5e9cbd28bbb68f9302,2,15,35,20,0,0,0,3,10,8,1,1,0.40217919,1198,42,27,229,235,6,6849,7007,158,192,195,3,99.98288843
0201c01e30861eee40f5f30d5c54ee68b4e6e06b,0,0,0,0,0,0,0,0,0,0,0,0,0,0,6,6,0,0,0,0,0,0,0,0,0,100
5556a4085c4386547d32e7904c421d79d03bb629,1,2,2,0,0,0,0,1,3,18,1,1,0,409,43,26,85,85,0,2759,2759,0,31,31,0,100
3c702ef0d146ec04efad3f03bb774324d64f729a,0,0,0,0,0,0,0,0,0,0,0,0,0,0,7,7,0,0,0,0,0,0,0,0,0,100
c3845a42323def46e5249873f2b189c3dd7c4dcb,0,0,0,0,0,0,0,0,0,0,0,0,0,0,8,8,0,0,0,0,0,0,0,0,0,100
5c61ff4970eccaac3a30e313e057c4c8fa74cd35,0,0,0,0,0,0,0,0,0,0,0,0,0,0,9,9,0,0,0,0,0,0,0,0,0,100
01d05dfbb8c073735d0b98f56f5a4a13366706a8,0,0,0,0,0,0,0,0,0,0,0,0,0,0,10,10,0,0,0,0,0,0,0,0,0,100
1fc9187ac7a2dc3a2c812ed139146eb8760e75d0,0,0,0,0,0,0,0,0,0,0,0,0,0,0,11,11,0,0,0,0,0,0,0,0,0,100
2209bd4050d8a99ecbcc86dc295135e00bd28e55,0,0,0,0,0,0,0,0,0,0,0,0,0,0,12,12,0,0,0,0,0,0,0,0,0,100
1a41108b1bb67b2d617b46d152453b7426c99704,0,0,0,0,0,0,0,0,0,0,0,0,0,0,13,13,0,0,0,0,0,0,0,0,0,100
22a112d4dae148ee0fab72e7499c3db9896bc241,0,0,0,0,0,0,0,0,0,0,0,0,0,0,14,14,0,0,0,0,0,0,0,0,0,100
a57637c783898c5dc6623beb1416d310f37120de,0,0,0,0,0,0,0,0,0,0,0,0,0,0,15,15,0,0,0,0,0,0,0,0,0,100
f41a4a8942155903251a4778855a07a946991a17,0,0,0,0,0,0,0,0,0,0,0,0,0,0,16,16,0,0,0,0,0,0,0,0,0,100
52ccceb9c450115e20058a068d17485e8387fb65,0,0,0,0,0,0,0,0,0,0,0,0,0,0,17,17,0,0,0,0,0,0,0,0,0,100
f217051f5668553406cdeb9f7ebd6600166f2a09,0,0,0,0,0,0,0,0,0,0,0,0,0,0,18,18,0,0,0,0,0,0,0,0,0,100
8c8a0a923dc8b84614a363704dd5ce53bda0d942,0,0,0,0,0,0,0,0,0,0,0,0,0,0,19,19,0,0,0,0,0,0,0,0,0,100
0bf2166ede8a848174331605897bb2fed84a4f98,1,2,0,2,0,0,0,2,6,3,1,1,0,51,44,26,7,7,0,271,253,18,4,4,0,100
f75ef7b7f93714ee6e4ae6f9dc8d2dc7cffa9af2,1,6,6,0,0,0,0,2,3,20,1,1,0,136,20,20,47,47,0,741,741,0,3,3,0,100
b79f86b6a78d2dde8b82082ffea8bfad9273dca4,0,0,0,0,0,0,0,0,0,0,0,0,0,0,21,21,0,0,0,0,0,0,0,0,0,100
64db31069570bd99547f26c77d8f8174c8d7d0a1,3,10,1,9,0,0,0,3,11,11,2,2,1.348587896,1826,45,26,357,357,0,10853,10796,57,273,273,0,100
650ca6f27f3fa50965004a5c656420e1b188f897,1,0,3,3,0,0,0,2,9,6,1,1,0,62,46,27,8,8,0,323,344,21,5,5,0,100
1236605135400dd42e4942d25cff310ac304dac0,11,1,13,12,0,0,0,2,12,0,5,7,3.378783493,6502,47,27,1851,1851,0,44801,44925,124,523,523,0,100
7268ed8f805241fd4e21343020d301f827c381af,1,4,2,2,0,0,0,2,7,24,1,1,0,280,1,1,69,69,0,1662,1662,0,19,19,0,100
c105fe6094531558832760a4eafc1218aff30714,3,2,53,51,0,0,0,2,7,26,2,3,0.527765223,235,2,2,27,35,8,1099,1303,204,14,17,3,100
1a6d7d547cdbf79c6bc06c93b6e636f167f00fb9,0,0,0,0,0,0,0,0,0,0,0,0,0,0,3,3,0,0,0,0,0,0,0,0,0,100
604703c6d1e9c9920eaa09932d027007acd37617,3,100,21,79,1,0,1,2,5,30,1,2,0.935308956,407,4,4,66,51,15,3252,2887,365,39,35,4,99.94868286
5698420f656b38a55691742e6b33971fbe068abc,0,0,0,0,0,0,0,0,0,0,0,0,0,0,22,22,0,0,0,0,0,0,0,0,0,100
3b6518f17455c07a475412311a950bded5701fbc,1,4,2,2,0,0,0,2,5,11,1,1,0,1022,1,1,305,305,0,7559,7543,16,84,84,0,100
979d2340e93eaaa9f273a100dbe78e42ea9ed400,137,2195,2340,145,0,0,0,2,12,0,4,14,5.95774745,41055,5,5,10710,10648,62,274306,273934,372,4437,4434,3,96.3624447
f279a6790b13829dda3c0c741bd6f97a93159dc4,3,45,3,42,0,0,0,3,13,6,1,2,1.559607479,1948,6,6,400,393,7,11799,11649,150,255,252,3,100
696cbee04b6d5d27e1473f3feac5ba227e37987c,1,2,0,2,0,0,0,3,10,8,1,1,0,2134,7,7,664,663,1,14138,14124,14,203,203,0,100
2fd7381e5342d83861504517d3ab27d2b5569a79,3,31,4,27,0,0,0,2,11,28,2,3,1.097081714,528,8,8,147,144,3,3753,3597,156,28,27,1,100
a95e7007cf7cf208b8dbade6b633cfb1d2d164fc,1,1,2,1,0,0,0,2,3,35,1,1,0,817,9,9,222,222,0,5866,5866,0,38,38,0,100
72398bcea0e300802ed74db167649a28c1c2d88c,1,1,0,1,0,0,0,2,13,12,1,1,0,655,48,20,187,187,0,4658,4651,7,60,60,0,100
803e15990dbd28a5ee35523d82c24d2b5aaf3dff,1,11,4,7,0,0,0,2,3,36,1,1,0,141,23,23,37,35,2,651,631,20,26,26,0,100
eb96e89f4d55d240fdfcb3ea236492f84312a8af,1,394,378,16,0,0,0,1,6,36,1,1,0,288,49,21,42,42,0,2456,2281,175,23,23,0,100
e889cd2aefeed17de3b84a58c586e3a44e5feacf,5,9,20,11,0,0,0,2,11,12,2,5,1.776662152,3458,50,22,840,841,1,24707,24764,57,314,314,0,100
021c4b85d5dc7e09d9339482fe0ddeacb40af7cd,1,2,1,1,0,0,0,3,7,11,1,1,0,259,2,2,68,68,0,1546,1537,9,28,28,0,100
a98213071a3b218813ea11c6a69d276945ef13e3,3,6,7,1,0,0,0,3,8,17,2,3,1.548580607,3477,10,10,1052,1051,1,22442,22422,20,355,355,0,100
20d59900983f720ec9636da82e802a318dc44812,1,1,2,1,0,0,0,3,7,12,1,1,0,1006,11,11,302,303,1,7400,7407,7,83,83,0,100
b2e1912dc7dd87c741ee2855a740e964454f74f1,9,79,22,57,0,0,0,2,9,23,4,5,2.172131263,2407,12,12,614,604,10,16222,15953,269,340,337,3,100
3f82b8aec0fc19d320402e5705d09308fc6e1a57,1,6,2,4,0,0,0,2,7,41,1,1,0,665,13,13,261,260,1,4718,4699,19,26,26,0,100
df439896898c5fa9510c50863c917a5f54e4313f,1,5,0,5,0,0,0,2,8,0,1,1,0,669,14,14,263,261,2,4740,4718,22,26,26,0,100
b3f8f9de489afbc4bfa18bacaf8e3101944c0510,2,61,16,45,0,0,0,3,12,3,1,2,0.761587787,3295,3,3,1073,1061,12,21582,21371,211,342,338,4,100
f2a266c4c2dde0124814c16776f020c120a8ccf2,3,62,66,4,0,0,0,1,13,0,1,3,1.272112072,3362,15,15,1078,1084,6,21769,21839,70,345,347,2,100
a6b57c2e9cdfd3524d507ef220e85a1781acc4f2,1,9,7,2,0,0,0,3,8,2,1,1,0,1005,16,16,304,302,2,7419,7400,19,83,83,0,100
eb333839db0a818146534fa48745197f5008df6d,3,95,66,29,0,0,0,3,14,5,2,2,1.23930653,5383,17,17,1738,1718,20,37872,37682,190,400,399,1,100
0167f87b325cca36dcde23eb43ee5fea5155953b,1,60,0,60,1,0,1,1,1,0,1,1,0,0,18,18,11,0,11,246,0,246,9,0,9,99.96855346
bc10dd2efd0ab6bd196eecc51d0b31275709ec3d,1,0,4,4,0,0,0,2,6,27,1,1,0,134,19,19,34,34,0,957,972,15,3,3,0,100
d1df9344fe663afd0b67f4f81e0b302393647e42,3,9,9,0,0,0,0,2,8,16,2,2,1.224394445,1126,20,20,372,372,0,7206,7206,0,89,89,0,100
77e7d9737910e0c4ca99a23d95e0b1dada447e9e,2,6,3,3,0,0,0,2,9,18,2,2,0.503258335,1437,21,21,480,479,1,10375,10354,21,85,85,0,100
ca83f07b459322422b7916f04307b81a553ca193,1,1,1,0,0,0,0,2,8,47,1,1,0,414,22,22,137,137,0,2435,2435,0,61,61,0,100
1a2d048f3df28611a51888d74599285664d3ed30,3,41,0,41,1,0,1,2,10,15,1,1,0.695733808,1284,4,4,402,400,2,9089,8961,128,66,66,0,99.68289202
f70f99e638dad59987486faa23597cfd077c7a10,1,6,10,4,0,0,0,2,5,3,1,1,0,2573,23,23,795,795,0,18759,18811,52,171,171,0,100
8c2c40dfe133a1493d5b0d5b8e26ce16eaf5b0d0,1,42,17,25,0,0,0,3,10,30,1,1,0,2330,5,5,459,455,4,19086,18996,90,99,97,2,100
8e668339157786e48087de6f33432b8337d86716,1,12,11,1,0,0,0,3,11,0,1,1,0,2346,6,6,458,459,1,19050,19086,36,99,99,0,100
f7f225f96dbde0c6ec46a67cf0f8c0a512eb221b,8,23,26,3,0,0,0,3,12,5,2,5,2.41228193,8676,24,24,2412,2411,1,59289,59278,11,617,617,0,100
d293c449b1d8a6288a93b700029a2811a2e9e416,1,6,6,0,0,0,0,3,13,0,1,1,0,2340,25,25,458,458,0,19048,19048,0,99,99,0,100
b499aded0d302ea393559215aafc6ceea242452d,1,3,2,1,0,0,0,2,10,12,1,1,0,695,26,26,276,277,1,4896,4901,5,27,27,0,100
1e6d57eb5504f67179eb90224c8d243b5d324078,1,41,3,38,0,0,0,2,5,33,1,1,0,810,27,27,292,280,12,6060,5892,168,70,68,2,100
f44dd067d8e1a724e92ee054adbcc0392b5389b1,0,0,0,0,0,0,0,0,0,0,0,0,0,0,7,7,0,0,0,0,0,0,0,0,0,100
6234f8d3da7d38864cf7c8460a23113a51313f01,83,467,406,61,0,0,0,1,14,0,4,27,5.301242816,24955,51,9,6673,6687,14,167630,167142,488,2191,2197,6,94.14219919
a120874a44f75cb61362a741f1e204a89fd20ab6,4,53,1,52,0,0,0,2,6,56,1,1,1.945684857,672,2,0,198,186,12,3997,3740,257,85,80,5,99.92143512
5bef32e5164bca30a252b9863e6fcc8f4051b00a,2,43,30,13,0,0,0,2,9,19,2,2,0.576291461,625,28,27,179,174,5,4260,4155,105,64,64,0,100
fd74642a178aa6fbbece1db6ea89aa161eba78d5,1,30,26,4,0,0,0,2,6,62,1,1,0,132,29,28,36,35,1,805,784,21,7,7,0,100
3e758faf25866656ffe70054c9ebaf88d00483ef,1,5,5,0,0,0,0,2,15,5,1,1,0,657,30,29,188,187,1,4686,4678,8,60,60,0,100
07a13ab9086bca3880846953da5d29b6246ac076,2,11,2,9,0,0,0,4,15,21,1,2,0.89049164,2925,3,1,632,630,2,23019,22959,60,136,136,0,100
aba057d644f135f324b1f5878ded921536b9127b,17,291,143,148,0,0,0,2,16,28,5,9,2.96779113,4277,31,26,968,938,30,27512,26721,791,510,501,9,91.1497105
174bbd211f7b592a702a549f42f2385a7282ce1e,1,1,2,1,0,0,0,2,11,0,1,1,0,123,32,26,25,25,0,776,778,2,12,12,0,100
132602e3d20efd612f21835bd48c2f9aebaa300f,1,2,1,1,0,0,0,2,12,0,1,1,0,122,33,27,25,25,0,784,776,8,12,12,0,100
26ae2fa31c9efe109e0fa7ab73326a1650582b4d,1,2,2,0,0,0,0,2,14,3,1,1,0,486,34,28,151,151,0,3601,3601,0,24,24,0,100
0821efea407c5dfca8c4b359deb5038c06dd4404,1,18,7,11,0,0,0,2,7,22,1,1,0,108,35,25,26,23,3,691,604,87,11,11,0,100
daf1f35793c8fb17850579d24fd6d18a3c1e1249,1,2,1,1,0,0,0,2,8,0,1,1,0,119,36,26,28,26,2,726,691,35,11,11,0,100
c8af68ac7db71fb2fd8a3829da4df64050ba6208,1,0,3,3,0,0,0,2,10,17,1,1,0,146,52,1,34,34,0,899,914,15,20,20,0,100
2ccc2426791f4846704098e8564753faad665442,25,221,188,33,0,0,0,2,9,58,2,6,3.919138374,10431,37,20,2923,2914,9,74829,74327,502,995,989,6,100
69b83ac3ffdc0421d5a8c68a7d825bc87169a91b,17,169,109,60,0,0,0,2,10,34,1,3,2.693470095,6113,38,16,1734,1726,8,43352,43258,94,773,768,5,100
eb2b5e65516d55cb7fd75c92f7a70c0216f28104,1,1,1,0,0,0,0,2,7,0,1,1,0,2044,39,17,688,688,0,14255,14254,1,252,252,0,100
037a45d7e4a7b57146b33c70598b9376374f21de,90,589,514,75,3,0,3,2,7,46,2,3,6.251710037,8081,40,14,1685,1745,60,51358,50291,1067,916,951,35,97.46265603
978bc40091963f9a89f08b64a4163687a0d9fec7,1,6,2,4,0,0,0,2,7,80,1,1,0,949,41,14,293,292,1,6504,6479,25,84,84,0,100
9de53954861ed7f57e92be0c1054befec56d0af2,26,232,83,149,0,0,0,2,9,32,2,5,3.612151935,5315,42,14,1385,1341,44,35180,34435,745,611,591,20,100
d5bb522c34f07740b5a89ecae4c51ede74fbe51b,6,55,10,45,0,0,0,2,9,57,2,5,1.131096423,2854,43,15,818,804,14,22406,22208,198,266,262,4,100
6f0a7f67da77101bd7bf2d82ee518e40485b279f,6,304,15,289,2,0,2,3,7,32,2,3,1.472342017,1015,24,0,313,272,41,9401,7845,1556,181,154,27,92.51052921
d13c9fa4f6d136e83c86d4c0c7259149c5dd9857,0,0,0,0,0,0,0,0,0,0,0,0,0,0,0,0,0,0,0,0,0,0,0,0,0,100
ac98ba5c8084f6cb8d8973c31b7b907dbee63b53,0,0,0,0,0,0,0,0,0,0,0,0,0,0,25,1,0,0,0,0,0,0,0,0,0,100
1aec5d3dde6d8e96e9bf537b74e87a149df29c20,2,196,1,195,1,0,1,1,8,1,1,1,0.958542393,953,8,0,325,293,32,7138,6504,634,107,84,23,99.91088932
9246ee92bcf12e0282905be4a1fdb8156c275664,0,0,0,0,0,0,0,0,0,0,0,0,0,0,9,1,0,0,0,0,0,0,0,0,0,100
9af2df4d096a08955ed878f15654d0ca4c192cb2,1,25,2,23,0,0,0,2,7,90,1,1,0,89,26,2,11,9,2,693,570,123,9,7,2,100
4436a3d90f94407f5f077dd0d6e3c05909b2aee1,0,0,0,0,0,0,0,0,0,0,0,0,0,0,27,3,0,0,0,0,0,0,0,0,0,100
086ecd6507e40f333d461e28486bff7bb5cf88fb,0,0,0,0,0,0,0,0,0,0,0,0,0,0,28,4,0,0,0,0,0,0,0,0,0,100
bad3cba9b6813965426ef26bd2fa7f46e3065858,0,0,0,0,0,0,0,0,0,0,0,0,0,0,29,5,0,0,0,0,0,0,0,0,0,100
3aaa66ee7fe41ab26559c4593cb75a832e09229e,2,7,0,7,0,0,0,2,12,66,1,1,0.863120569,1253,44,13,405,403,2,9016,8988,28,68,67,1,100
6e262960ae1b0d3a853a25dc514ab208afe139bc,1,36,20,16,0,0,0,3,5,66,1,1,0,666,10,2,160,153,7,4755,4780,25,49,48,1,100
d0f15b881a4bbccb062c8da0c83873a2d27496b2,1,26,16,10,0,0,0,3,6,0,1,1,0,672,11,3,159,160,1,4852,4755,97,49,49,0,100
0e41d092c9addfb0be271274764a448859aaf1f7,0,0,0,0,0,0,0,0,0,0,0,0,0,0,53,1,0,0,0,0,0,0,0,0,0,100
8fbfa8aeccd40d57dff2929d5993f0b441ccf834,0,0,0,0,0,0,0,0,0,0,0,0,0,0,30,6,0,0,0,0,0,0,0,0,0,100
746ebdfdc93bdc6a389a3e4fd869d8ac8a5ff7cd,1,36,43,7,0,0,0,3,7,1,1,1,0,682,45,14,161,159,2,4864,4852,12,49,49,0,100
fe71475a594d1023cbbc8a52316413a9f1d823c0,3,89,130,41,0,0,0,2,10,18,2,2,1.109450622,1488,46,15,456,463,7,9556,9635,79,163,169,6,100
323fce145e915b04a79fdfede0ea6256b9c76eb3,0,0,0,0,0,0,0,0,0,0,0,0,0,0,31,7,0,0,0,0,0,0,0,0,0,100
dcb47f0fe406c5d926c2d0e654b6690a15111cf1,4,5,4,1,0,0,0,2,16,47,2,4,1.974937501,2599,54,2,503,503,0,20487,20463,24,119,119,0,100
caffb7740578354566d57ff172ffdd15029c2be0,0,0,0,0,0,0,0,0,0,0,0,0,0,0,32,8,0,0,0,0,0,0,0,0,0,100
8adfc84d9cfeb01a217d726a20b55df41a487448,1,14,8,6,0,0,0,2,6,53,1,1,0,78,33,9,17,14,3,497,444,53,12,12,0,100
45c89bd4556cdf21f7fc96327298a06825c51377,1,1,2,1,0,0,0,2,7,0,1,1,0,83,34,10,17,17,0,493,497,4,12,12,0,100
96e534a165efa3d67c094919deafd96c17ceacf0,3,6,4,2,0,0,0,2,17,0,1,3,1.485475297,2477,55,3,478,478,0,19709,19703,6,107,107,0,100
f37d9f8d615cae73b620186f930a49dd0e402be2,1,3,3,0,0,0,0,2,8,0,1,1,0,82,35,11,17,17,0,502,493,9,12,12,0,100
dc1f0bf2046cf08d9484a287dee02ff058961ca4,0,0,0,0,0,0,0,0,0,0,0,0,0,0,36,12,0,0,0,0,0,0,0,0,0,100
5ff49b37b9dc7ba70fb247e3ca1931f65a99c1c4,1,0,10,10,0,0,0,3,4,93,1,1,0,262,37,13,57,59,2,1692,1762,70,18,19,1,100
de9352568f505999397c84d55766e1926b75db2a,1,1,0,1,0,0,0,3,5,0,1,1,0,253,38,14,57,57,0,1696,1692,4,18,18,0,100
cd9c6c198670281096dc69b68687a32a77e0c5ef,0,0,0,0,0,0,0,0,0,0,0,0,0,0,39,15,0,0,0,0,0,0,0,0,0,100
21480988416884d986c0616f3635ea5c026a1799,1,1,1,0,0,0,0,3,10,81,1,1,0,237,12,4,47,47,0,1482,1478,4,18,18,0,100
47ead9315d338cb0dfd8e79c2fc6cdbe8a3608e0,1,4,1,3,0,0,0,2,7,105,1,1,0,279,56,3,74,73,1,1795,1778,17,24,24,0,100
163cc2a22c9662fe79dd8eeacc0fd9fb197a6565,22,328,418,90,2,0,2,2,10,48,3,9,3.263458879,6639,47,10,1789,1812,23,43571,44123,552,638,637,1,99.92880028
01735b123429e17033650fbe1c30506820e7af6a,222,372,372,0,0,0,0,2,13,0,6,20,6.778971525,31010,57,4,6995,6995,0,187626,187626,0,2776,2776,0,100
582c83b29b9e825ab80208737e1d4c88bb7859d5,1,36,2,34,0,0,0,3,11,1,1,1,0,1122,40,16,353,345,8,8637,8437,200,98,98,0,100
c39b7141ce03379cd66f7799a46cf3c019ba3fdc,1,1,1,0,0,0,0,3,12,69,1,1,0,696,41,17,276,276,0,4901,4900,1,27,27,0,100
423b0a418af03102a95b1c7472665d5cd7c57b11,11,231,44,187,0,0,0,2,18,83,1,4,2.728666817,11329,4,0,3260,3216,44,77996,77143,853,888,874,14,100
fe6352fca14a1f26a6e24642d858fd1d5b08664c,1,213,0,213,1,0,1,1,1,0,1,1,0,0,5,1,21,0,21,1215,0,1215,7,0,7,99.96443812
4f4b1b29fe9e7b777ce631a17d729c96463a1a31,1,3,3,0,0,0,0,2,6,1,1,1,0,59,6,2,15,15,0,258,265,7,4,4,0,100
fc9b67f556c66a87c4054a19081b31564d66bb46,1,10,11,1,0,0,0,4,11,1,1,1,0,1479,7,3,493,494,1,10026,10031,5,131,131,0,100
2b66092a806d138821519d64f00675c1b8556789,2,3,4,1,0,0,0,2,7,0,1,1,0.863120569,86,8,4,18,18,0,321,324,3,5,5,0,100
5240ea8612e6a1b94dfa4ff26c347cc362e2c777,1,0,0,0,0,0,0,1,2,10,1,1,0,157,9,5,21,21,0,1215,1215,0,7,7,0,100
c1a146714e70b5c64d67916acde8c2aa2b5cd753,1,1,0,1,0,0,0,3,8,10,1,1,0,61,48,4,16,16,0,275,275,0,4,4,0,100
8676abb0ada7d957799c44096cb5af0c0fe917f0,0,0,0,0,0,0,0,0,0,0,0,0,0,0,42,16,0,0,0,0,0,0,0,0,0,100
b34fec7e38ddfec969f1573711939be648e7d04b,0,0,0,0,0,0,0,0,0,0,0,0,0,0,43,17,0,0,0,0,0,0,0,0,0,100
253407b69c4584af56d2d43e731e3073316fa67e,19,1160,552,608,6,0,6,1,11,31,3,3,3.591928171,2362,13,3,594,587,7,15497,14173,1324,359,354,5,95.00372856
890ae1a7022e116d0c82e94384c74de24f6f00e6,1,27,0,27,1,0,1,1,1,0,1,1,0,0,14,4,0,0,0,39,0,39,0,0,0,98.41913255
56d5f6469eeaab2918c170deb779019ef3f841ec,1,31,21,10,0,0,0,3,10,21,1,1,0,97,44,14,18,17,1,685,644,41,6,5,1,100
7e30623c7b5a30c2a9c9761736d8d493e2a8c968,79,2072,2527,455,1,0,1,2,10,15,4,6,5.6241531,10720,49,3,2356,2438,82,70742,72229,1487,1051,1111,60,94.08955224
1e5d09ce2f95e2c77fe85ba91b48990607f673ab,3,95,0,95,3,0,3,1,1,0,1,1,1.567615989,0,50,3,6,0,6,241,0,241,6,0,6,99.38398357
812e184e89c3bf7166a95f2e77ac88fbedc70854,1,22,15,7,0,0,0,3,15,77,1,1,0,486,45,13,153,151,2,3665,3601,64,24,24,0,100
609b2da6e8704545c1c1704a1f8633ded2779619,0,0,0,0,0,0,0,0,0,0,0,0,0,0,46,14,0,0,0,0,0,0,0,0,0,100
bbe10e18ba3b478342ee5e84d246b9420103ac9f,0,0,0,0,0,0,0,0,0,0,0,0,0,0,47,15,0,0,0,0,0,0,0,0,0,100
554f55f46efb1c4d897dcf585e501a7042ee9c70,1,0,1,1,0,0,0,3,10,3,1,1,0,64,51,4,0,0,0,403,403,0,0,0,0,100
37aa91d2af0c35b7edee57763afa02d0901db0b8,3,20,29,9,0,0,0,3,13,54,3,3,0.774517861,3544,52,5,1185,1188,3,24943,24999,56,267,267,0,100
ddf3631bccc471ac555b527aaaf7a835ad79aa65,5,160,24,136,4,0,4,2,4,22,1,2,1.998059036,96,53,6,19,8,11,1123,525,598,15,6,9,99.83452841
3b2f6a720dcf71073f25fde87f02c522c9eb8f80,1,1,1,0,0,0,0,2,7,33,1,1,0,295,48,11,86,86,0,1865,1865,0,31,31,0,100
25e80a994e6e50afb0e146066cf6e0185e4b8af7,1,3,2,1,0,0,0,5,13,6,1,1,0,1471,49,12,492,491,1,10003,9992,11,131,131,0,100
da1961910bef256a5ef3c39e729a7fe9b34fb43c,2,2,2,0,0,0,0,3,14,18,1,2,0.811278124,1607,54,7,522,522,0,10959,10955,4,141,141,0,100
1defd23037cbe55ef05902efc21d11b9a2afe972,6,146,36,110,0,0,0,1,15,44,2,3,1.751846255,5053,10,6,1535,1513,22,33956,33445,511,484,477,7,99.92657856
f56a7555a7f05be898ab6dbe11ff7de6246a8231,1,11,2,9,0,0,0,3,9,12,1,1,0,2573,50,13,797,795,2,18879,18832,47,171,171,0,100
1e95734015c0aa6009b42355a3cfeccb57c4fb2f,10,299,16,283,3,0,3,3,12,44,3,6,1.906217471,1872,55,8,481,457,24,15623,14117,1506,144,127,17,96.66072297
2dfe77f2ca4a79ea2f6a1c4a1b533a8419121b00,1,8,0,8,0,0,0,4,13,1,1,1,0,1057,11,7,322,321,1,7308,7259,49,95,95,0,100
d1e7a817d2bf5c08d61a4f275cf85c1318d70397,1,33,33,0,0,0,0,3,11,77,1,1,0,988,56,9,297,297,0,7256,7258,2,82,82,0,100
6ac482c68fb8f57ce68202f73f623142b1c86cc5,4,5,6,1,0,0,0,2,9,82,2,3,1.980825936,984,57,10,241,243,2,7783,7788,5,61,61,0,100
832d913520d909b587cd52ae16e63773965a17ad,10,254,4,250,3,0,3,3,15,7,3,4,2.677677965,4946,58,11,1517,1506,11,32403,31793,610,370,361,9,99.8985066
d78bcae002c96b508c04b912c8635389848d0b5e,1,2,1,1,0,0,0,5,16,0,1,1,0,3601,51,11,1090,1089,1,22333,22321,12,280,280,0,100
8a9c647907d9cd3207f0cbac9bce9b4caab298ac,1,1,1,0,0,0,0,4,14,4,1,1,0,1063,12,8,322,322,0,7309,7308,1,95,95,0,100
912c1262d6165fa39e55101bb8ef480cc047c04a,0,0,0,0,0,0,0,0,0,0,0,0,0,0,1,0,0,0,0,0,0,0,0,0,0,100
a9eaf4683bbbebb82101b9114516c132ef907780,26,33,36,3,0,0,0,2,17,137,2,3,4.492815131,6286,59,11,1796,1797,1,36091,36107,16,640,640,0,100
30345610fa7099ff7734cb22599f19361bc7ff04,1,1,1,0,0,0,0,4,15,2,1,1,0,1226,52,11,402,402,0,8891,8891,0,66,66,0,100
868cc7bc4e27b145b561dcb1e9976497a080faa5,1,1,1,0,0,0,0,3,8,150,1,1,0,1230,53,12,352,352,0,7487,7487,0,93,93,0,100
7bff3b437313dd363d2eb7f39db4bd021afe7dfc,1,2,2,0,0,0,0,2,3,167,1,1,0,442,2,1,150,150,0,2769,2769,0,80,80,0,100
c863a7a489528b90d24604b8e0573b4dfc541f54,1,2,2,0,0,0,0,3,9,0,1,1,0,1230,60,12,352,352,0,7487,7487,0,93,93,0,100
9650a1a20b7d2e49ae1c391168488d13114483c3,4,6,6,0,0,0,0,3,10,74,4,4,1.918295834,1219,3,2,270,270,0,8551,8551,0,108,108,0,100
cfcca495210ecd8e8656dccf8fb892b808707262,2,18,1,17,0,0,0,4,18,18,1,1,0.629249224,5743,13,9,1758,1756,2,36550,36489,61,483,482,1,100
913e54c93c2b03adadfb505ce4374c5de3f8818e,2,3,10,7,0,0,0,4,19,0,1,1,0.89049164,5755,61,13,1758,1758,0,36525,36550,25,483,483,0,100
72f7b6b963a533542eeaddaac629481db62ca277,5,14,10,4,0,0,0,4,16,13,2,5,2.197338796,3897,62,14,1101,1096,5,28280,28230,50,338,337,1,100
fcd072a2c59869c4cd6a8eb8ee715675a6c33dbc,1,18,0,18,0,0,0,2,8,11,1,1,0,295,54,12,93,86,7,1988,1865,123,32,31,1,100
a5d552f940b7830cc252d10aaccf630249626b13,7,56,27,29,0,0,0,2,12,69,1,3,2.341348148,4643,63,15,1378,1369,9,32582,32408,174,611,608,3,100
7846adbf3f732c3258e88c326445044387385fb3,1,0,254,254,0,0,0,2,5,45,1,1,0,212,64,16,0,33,33,0,1677,1677,0,16,16,99.88400754
c6c683e8acfc4b188fa4af2f0293a43a33e39a4c,4,44,6,38,0,0,0,3,10,91,2,3,1.25628769,1506,55,13,407,394,13,9567,9324,243,112,111,1,100
47edcb8edce8dc6b0c384af53e6a679aa68f1abd,2,57,6,51,0,0,0,2,11,11,1,1,0.503258335,724,65,17,219,206,13,5876,5642,234,55,51,4,99.89855072
20e0762e43734170fd7d97297693382329877b33,1,6,2,4,0,0,0,3,17,102,1,1,0,663,56,14,191,189,2,4736,4714,22,61,61,0,100
b2e013390714dcd4506e99f9aacfe4abda09ce93,1,4,5,1,0,0,0,2,7,0,1,1,0,93,57,15,24,25,1,540,563,23,9,9,0,100
65e0a48a81e192817b54ef896e42bd6efb97e538,1,12,0,12,0,0,0,3,6,52,1,1,0,254,58,16,60,57,3,1760,1696,64,19,18,1,100
53dbcdf35c9fa6a0db7bf29516008e1e08bcc12b,1,12,0,12,0,0,0,5,20,5,1,1,0,3606,59,17,1093,1090,3,22449,22347,102,281,281,0,100
a7cfbfc4c92e7e0a59d74c2c413467377660fbc9,8,68,45,23,0,0,0,3,17,53,1,3,2.755388835,4560,66,18,1445,1443,2,31364,31333,31,369,366,3,100
944f8ad22ce488e96f13e3748d2942dc174dbe56,6,92,33,59,0,0,0,4,18,118,2,5,2.333932547,3029,60,18,907,898,9,20812,20651,161,278,275,3,95.06054812
02c9ce3ca796592e45b04f3a42c8922b38ea2305,1,10,5,5,0,0,0,3,18,3,1,1,0,667,61,19,191,191,0,4753,4736,17,61,61,0,100
0c34969609d0b3f22bba81f37476a87f33d0f4b7,0,0,0,0,0,0,0,0,0,0,0,0,0,0,62,20,0,0,0,0,0,0,0,0,0,100
d746a3fd7cebeb045abc3cc699e8fc8ba306fc5f,0,0,0,0,0,0,0,0,0,0,0,0,0,0,63,21,0,0,0,0,0,0,0,0,0,100
05865aef893c7df2db70c984750457910dca6354,3,69,3,66,0,0,0,4,19,15,1,2,0.982681732,4934,14,5,1303,1286,17,36939,36617,322,333,329,4,100
9789c93caf60d7725d266cbb97ecefea85b1fa19,0,0,0,0,0,0,0,0,0,0,0,0,0,0,64,22,0,0,0,0,0,0,0,0,0,100
52e2d38ed9da84f6a27e4be0e82e59e5049e3462,0,0,0,0,0,0,0,0,0,0,0,0,0,0,15,6,0,0,0,0,0,0,0,0,0,100
9b8351c60e9d1378d1f0c6ce5fd254e17e779d62,0,0,0,0,0,0,0,0,0,0,0,0,0,0,65,23,0,0,0,0,0,0,0,0,0,100
9ba388d243a54186d07445a3bcac8fb0c0da1bca,1,8,7,1,0,0,0,2,9,9,1,1,0,312,66,24,94,93,1,1994,1988,6,32,32,0,100
b7aa94749e22b1ecf4e6b0a6e625dd2e2f4af5bf,1,3,0,3,0,0,0,3,5,98,1,1,0,810,67,25,222,222,0,5878,5866,12,38,38,0,100
d47e1d1f1896a0b72cdd7775335cb2529bd3207f,1,1,1,0,0,0,0,2,3,182,1,1,0,130,68,26,15,15,0,759,746,13,7,7,0,100
7740c7842c018e58916f09ed174389c840ec0eef,0,0,0,0,0,0,0,0,0,0,0,0,0,0,69,27,0,0,0,0,0,0,0,0,0,100
2c31d9c6df811638f27bd7dac8608766a4a499e1,28,913,604,309,6,0,6,3,19,51,6,10,3.853015345,5212,15,2,1106,1082,24,33797,33064,733,537,520,17,99.28724163
cdcfea47d4568f69783c6733b27dfbc33e3ba621,30,680,967,287,0,0,0,2,20,13,5,10,3.501052555,9044,67,18,2482,2521,39,57980,58918,938,802,819,17,99.64138426
480a42df4a036e53f0a06813d7b3412213cc610c,4,104,111,7,0,0,0,2,7,105,1,1,1.203081478,936,68,19,201,195,6,6131,6037,94,78,78,0,100
4efc384cbdfb85e9fd53ffd781d7652c9f3ac3bd,3,18,17,1,0,0,0,2,13,18,1,2,1.05853744,3720,58,0,1190,1190,0,26103,26111,8,483,483,0,100
d85ea93d3a3db769f2b82c1ff27674ab1bd7c0ae,1,1,1,0,0,0,0,2,10,0,1,1,0,2049,59,1,689,689,0,14285,14285,0,253,253,0,100
68572a9197e1a668442ef463d193686c37c12c09,3,27,24,3,0,0,0,2,21,3,2,2,1.022420704,1192,69,19,333,333,0,8023,7966,57,114,114,0,100
d090d717f457135a1ba4b86f00b24b04e743d56f,2,3,6,3,0,0,0,2,6,2,1,1,0.764204507,533,70,19,118,118,0,3535,3538,3,42,42,0,100
7a74bedd70382da65b0e63170bde3158a29a2fe2,2,9,4,5,0,0,0,2,5,75,1,1,0.779349837,133,71,20,28,24,4,763,726,37,15,15,0,100
a9089d2688a7255e120391a51510332518d2e406,1,0,4,4,0,0,0,2,7,8,1,1,0,68,72,20,15,16,1,227,238,11,14,15,1,100
ed0d6b1fec099a0a8e1302c259b242e6cdf87596,1,14,15,1,0,0,0,3,6,20,1,1,0,68,73,21,14,14,0,217,217,0,14,14,0,100
b7f2721aff3d9b22e02f1bbc2aec49de0612c5d6,4,12,6,6,0,0,0,2,12,22,1,2,1.684977448,2864,74,20,909,908,1,20572,20544,28,308,308,0,100
5dea14f301ea4cca21d73783080615d02ab89afc,1,39,2,37,0,0,0,3,6,45,1,1,0,94,70,22,18,13,5,797,651,146,6,5,1,100
aa6309af3504e477306917de68dc0fa4c7fb8b67,0,0,0,0,0,0,0,0,0,0,0,0,0,0,60,2,0,0,0,0,0,0,0,0,0,100
ce937180b47ab142cdc9467719ba02ffe14ad0e8,1,4,4,0,0,0,0,3,10,35,1,1,0,2578,61,3,797,797,0,18899,18879,20,171,171,0,100
a8c1fad16c19a92ea3585965cc4ca08459d01723,1,2,0,2,0,0,0,2,3,201,1,1,0,76,71,21,5,5,0,336,328,8,3,3,0,100
d3956a7d98811c749774afa8731c14a5330909b5,1,11,3,8,0,0,0,3,11,3,1,1,0,2578,72,22,800,797,3,18949,18899,50,171,171,0,100
62bc6c997c859f5b028df18e99c484b28864109b,21,167,130,37,0,0,0,2,22,36,5,9,3.474136863,12120,75,18,3189,3173,16,77964,77599,365,1071,1069,2,100
9a40eb69b0aea72c05c0c3812b1b03561b820d84,3,268,0,268,3,0,3,1,1,0,1,1,1.453891844,0,76,18,20,0,20,1187,0,1187,17,0,17,99.87452949
26a3499fe56803d29b8421fec6c404a46b68f5df,1,3,10,7,0,0,0,3,7,11,1,1,0,114,77,19,18,18,0,791,797,6,6,6,0,100
9a52726ea2806bd8b43891ec800b399c91bc727b,5,98,9,89,0,0,0,4,16,32,2,2,1.813689514,2820,16,1,870,852,18,18834,18396,438,216,208,8,100
5b9c773c814b1e29c1d58e59e299ff5403ee46a1,1,4,2,2,0,0,0,4,9,0,1,1,0,32,17,2,0,0,0,113,113,0,0,0,0,100
46736c60188513202e3cb40c87e1bf89aa09586c,2,9,4,5,0,0,0,2,23,10,2,2,0.391243564,693,78,19,187,186,1,4815,4767,48,60,60,0,100
a55664495e2f40371a979e5b59286e957573c13b,1,1,1,0,0,0,0,3,7,0,1,1,0,813,73,22,222,222,0,5880,5878,2,38,38,0,100
9443b9f9bc9783b6591b88be3b5ae039fe5b1884,1,1,1,0,0,0,0,3,8,0,1,1,0,813,74,23,222,222,0,5878,5880,2,38,38,0,100
c6537ccba6e8735d08c658249bbe763fcb145316,14,187,38,149,1,0,1,4,22,97,2,2,3.340625855,10617,16,4,3249,3230,19,68554,68180,374,1228,1212,16,99.92843085
7522db86fdbb787f68368ef13d3cc7fbd47d065f,14,38,187,149,0,0,0,4,23,0,2,2,3.340625855,10702,17,5,3230,3249,19,68180,68554,374,1212,1228,16,99.92843085
3620b80ce40370af5ff7f7be399975919a07465e,1,7,3,4,0,0,0,5,20,33,1,1,0,2377,75,21,470,468,2,19160,19146,14,101,101,0,100
7baaaf4b760248e0e5fdf63903b00f15a4485f78,1,8,6,2,0,0,0,3,12,3,1,1,0,351,18,3,84,85,1,2275,2247,28,23,23,0,100
e1e96406e898ba85af2f6fc47939522d6e8b9758,1,15,0,15,0,0,0,2,5,210,1,1,0,209,76,22,65,62,3,1487,1406,81,9,9,0,100
24c51d9fe60896520b2a810fbc6f88ff019a0d35,1,19,5,14,0,0,0,3,13,0,1,1,0,354,19,4,87,84,3,2363,2275,88,24,23,1,100
98d1da1fba419b8c6aec97dacbd4496a367c9b90,5,49,47,2,0,0,0,3,17,0,2,2,2.151160098,1878,20,5,583,581,2,12790,12788,2,131,132,1,100
bd340fbe15afd807dfed403a005c1d2a02ba1a8d,14,233,64,169,1,0,1,4,24,0,2,2,3.181729188,10617,18,4,3251,3230,21,68706,68180,526,1229,1212,17,99.92843085
d833950424c4f7242d0b512ae72333225cd3705a,1,0,7,7,0,0,0,5,23,0,1,1,0,2159,19,5,673,675,2,14274,14302,28,204,205,1,100
f104321da80a5a17170f910b2ecb63fa331aee26,1,3,1,2,0,0,0,5,24,0,1,1,0,2154,20,6,674,673,1,14288,14274,14,204,204,0,100
b198cb7305340d7115488cec7596986b083fb6e1,0,0,0,0,0,0,0,0,0,0,0,0,0,0,62,4,0,0,0,0,0,0,0,0,0,100
5eb55ee87ae11f41c4bf3f7b617ef742f5b9d28c,1,3,4,1,0,0,0,2,8,113,1,1,0,111,77,16,11,11,0,688,693,5,9,9,0,100
cc25d2a53624e545694a63467de78969bafffa01,0,0,0,0,0,0,0,0,0,0,0,0,0,0,78,17,0,0,0,0,0,0,0,0,0,100
f74ac8b6b9f8d6f5c4fdae6798018458687741fc,1,33,10,23,0,0,0,3,9,192,1,1,0,141,79,17,30,29,1,1003,937,66,6,6,0,100
923eb32d31d08edc9526a6f6ce9c4ca30357e738,4,57,19,38,0,0,0,5,25,4,1,1,1.583903774,3023,21,7,987,976,11,20217,20099,118,285,277,8,99.94634234
9fb0a9a6f5220d62e6002e1f1235782439b84abc,2,8,3,5,0,0,0,3,12,2,1,1,0.994030211,700,22,6,257,256,1,5013,4996,17,49,48,1,100
bc9422ea5d04f5432989a973b94771cd864a9b50,0,0,0,0,0,0,0,0,0,0,0,0,0,0,63,5,0,0,0,0,0,0,0,0,0,100
e30632b60b26430fe4f95dd3f5a3bd79c4a36f9f,2,33,25,8,0,0,0,3,13,12,2,2,0.735508582,250,79,12,39,39,0,1657,1593,64,11,11,0,100
bdae6535ecc59a972cc27a9ca65971d063512f41,16,265,287,22,1,0,1,4,26,60,3,5,3.392045416,11824,80,13,3578,3588,10,77752,77696,56,897,899,2,99.94635193
f18ea3dd3359f73a9c384e632d6316d639a10b38,1,1,0,1,0,0,0,3,8,167,1,1,0,186,80,10,36,36,0,1319,1312,7,13,13,0,100
174ae93d41ed8b35ee1ae6490b0baa88b9f990b2,5,82,57,25,0,0,0,4,21,14,2,3,1.769227493,2278,81,14,687,688,1,15480,15590,110,194,198,4,100
afe9acd57616e633d7c4a2278a3885621ba7e3e6,1,2,2,0,0,0,0,2,8,170,1,1,0,413,82,14,103,103,0,2688,2688,0,49,49,0,100
17b27d44d0a26ceb91c4494905e2e2660a713309,0,0,0,0,0,0,0,0,0,0,0,0,0,0,83,15,0,0,0,0,0,0,0,0,0,100
c1a857c915857cea20155f7fb4c180b631717c8a,1,1,0,1,0,0,0,1,1,0,1,1,0,12,84,16,4,4,0,63,63,0,4,4,0,99.92849482
88acae75c16b0f9307377283fee34c0ad3980417,1,0,10,10,0,0,0,3,13,60,1,1,0,1150,81,11,350,354,4,8587,8644,57,98,98,0,100
8785be46e71c65c4d87ab59203c17771d9faec26,7,234,81,153,0,0,0,2,26,102,3,4,2.303201264,6341,85,16,1842,1827,15,38730,38362,368,662,644,18,99.9463807
5337ce10d0a4f00c3b04ca6bfe5cc05a76020afc,3,13,12,1,0,0,0,2,27,111,2,3,1.553520951,4302,86,17,1301,1300,1,27639,27597,42,330,330,0,100
361a77c4512821081185300504fa88b304cfbdbd,1,2,1,1,0,0,0,2,3,230,1,1,0,686,87,18,200,199,1,4711,4707,4,99,99,0,100
d0bca27ecda3ec2021c614b6746fe3d36bcfefd8,2,15,5,10,0,0,0,2,28,52,1,2,0.721928095,3670,88,19,1100,1098,2,22743,22704,39,293,292,1,100
69d8dd3da9ebc66fe308e109b49744dc2c862d1d,3,35,15,20,0,0,0,2,6,179,1,2,0.764114055,315,89,20,40,40,0,2340,2158,182,29,29,0,99.98213009
1dbb7a90440054478141cf8dfb699529c52e847d,4,249,1,248,3,0,3,1,10,17,2,2,1.754459488,569,90,20,162,143,19,5760,4774,986,47,31,16,99.87506693
c0c4c3c7385bc672b7b70bd3daf1ec9687bd5c3c,10,147,75,72,0,0,0,2,19,128,3,8,2.074667606,7406,91,19,2325,2311,14,49486,49203,283,756,754,2,100
dc09b619548ae51e4b03625e723b3d7a8e5ff9ed,4,14,2,12,0,0,0,2,12,153,3,3,1.324460293,3700,92,18,927,925,2,28316,28224,92,230,230,0,100
27e8bd48497f9c6ee92e65cc9cf1a0f830ff362a,1,13,4,9,0,0,0,4,12,53,1,1,0,104,82,12,20,18,2,733,687,46,7,6,1,100
b25dfe66f43a8229d34a2620407a91abbe9f9e63,1,6,1,5,0,0,0,3,13,0,1,1,0,2588,83,13,803,802,1,18992,18974,18,171,171,0,100
223b81db2b560f521a628742a05c2bb59834b9f3,1,10,2,8,0,0,0,3,9,29,1,1,0,813,84,14,223,222,1,5907,5878,29,38,38,0,100
3ffad896247a6f74861d1025c4e071e092366027,0,0,0,0,0,0,0,0,0,0,0,0,0,0,85,15,0,0,0,0,0,0,0,0,0,100
ac1679d41cc43174affec904f1265abe3492cfb5,0,0,0,0,0,0,0,0,0,0,0,0,0,0,86,16,0,0,0,0,0,0,0,0,0,100
433475f6ad37062a00916c6a79f7ac08f35bdc4e,9,108,52,56,0,0,0,2,29,75,3,6,2.644544506,9613,93,18,2751,2713,38,68824,68364,460,673,671,2,100
1201726c3e25f489bd74608d816a3a06861eaf38,1,1,2,1,0,0,0,4,17,30,1,1,0,1137,64,4,227,227,0,6598,6608,10,191,191,0,100
2ada6c32922f40d755d48aab1ef69d1480773829,1,3,3,0,0,0,0,2,6,237,1,1,0,282,94,19,85,85,0,1419,1419,0,58,58,0,100
fe42d24e9beeeb6ccb7453bf01de8de3329b9600,1,9,7,2,0,0,0,3,5,32,1,1,0,177,65,4,45,45,0,1314,1270,44,14,14,0,100
54a3f158113cdb0d209c07ebcadd270121f77b11,1,1,1,0,0,0,0,3,6,0,1,1,0,180,66,5,45,45,0,1316,1314,2,14,14,0,100
34f6cb589e071d0158ecde59e917bf7109178b6e,1,8,0,8,0,0,0,3,13,4,1,1,0,1188,67,6,409,408,1,7430,7417,13,139,138,1,100
e61de9586c4567d143eded4f2471c9eeef0dda29,2,20,12,8,0,0,0,2,9,101,1,2,0.928362072,546,68,7,107,105,2,3455,3439,16,46,44,2,100
d3b3b3a2128236ff0b46627364def67a481481c5,1,1,1,0,0,0,0,2,10,0,1,1,0,112,69,8,12,12,0,692,692,0,10,10,0,100
5e5babb38cebb0f5009f7a87c4781adb1506f610,1,1,1,0,0,0,0,2,11,0,1,1,0,112,70,9,12,12,0,694,692,2,10,10,0,100
fb42b621b369d1e2e056f0fb1e9f8bf31a901d84,1,6,2,4,0,0,0,2,11,34,1,1,0,56,71,9,7,6,1,339,311,28,4,4,0,100
43f5348782f4600b745f5157a2d9ef7711052785,1,1,1,0,0,0,0,2,12,0,1,1,0,60,72,10,7,7,0,341,339,2,4,4,0,100
28910a737467b06f1fefb2d8acae8373664e82cc,7,48,7,41,0,0,0,3,15,24,5,5,2.558524074,780,73,11,157,150,7,5005,4785,220,54,48,6,99.83982915
dcf691a7273437ffc53336c2d41115ee566fe2dc,7,37,51,14,0,0,0,3,16,0,5,5,2.484874885,881,95,20,168,169,1,5496,5568,72,63,64,1,100
d490f545c48f2d63c88b176e47d30ad3e95df677,2,22,27,5,0,0,0,2,22,123,2,2,0.33228663,2504,96,21,500,501,1,19910,19918,8,112,111,1,100
0bc4acc2af7fad13bb2187759eddf748156a3ae6,3,15,5,10,0,0,0,3,17,20,2,2,1.054015773,761,97,22,186,183,3,4903,4867,36,59,57,2,100
d86e2fb29dfb7dd6f3354095d72c552448f2b10c,0,0,0,0,0,0,0,0,0,0,0,0,0,0,98,23,0,0,0,0,0,0,0,0,0,100
f54e9dcfd95cc8e351cef456fd86d69d65dfbd10,0,0,0,0,0,0,0,0,0,0,0,0,0,0,99,24,0,0,0,0,0,0,0,0,0,100
2fbc438887e051c505e926e2ddecb9c2676680a4,0,0,0,0,0,0,0,0,0,0,0,0,0,0,87,14,0,0,0,0,0,0,0,0,0,100
0c58bedbb68e3162ead70627a94d0ff9c32758fb,0,0,0,0,0,0,0,0,0,0,0,0,0,0,88,15,0,0,0,0,0,0,0,0,0,100
b42c74b6cbc96172399e76632d902ac3236f70f7,0,0,0,0,0,0,0,0,0,0,0,0,0,0,4,0,0,0,0,0,0,0,0,0,0,100
08d69d15a7f03fedfeb872caa9005b89c61560ff,3,32,11,21,0,0,0,2,12,93,1,3,1.337619137,2620,100,21,855,847,8,18970,18786,184,284,284,0,100
f27898f28082a42624d7dd5c7768523ef6b16f61,44,136,141,5,0,0,0,2,19,131,5,16,5.104365613,20396,101,22,5699,5788,89,137460,137584,124,1914,1914,0,100
6937856e2b5e1261d7773abd7c45230ca6ddb844,4,221,13,208,2,0,2,1,13,75,2,3,1.606305319,683,102,23,222,197,25,5895,5016,879,64,54,10,99.91123735
72594b2ac8692a2502f5ef89902e74b9b3089ef4,1,2,10,8,0,0,0,2,14,2,1,1,0,2064,103,24,690,693,3,14345,14398,53,253,253,0,100
c8b5b2746e56b5fac35f96fb2b5a82c2705abb79,7,87,103,16,0,0,0,3,18,16,4,5,1.941477449,4310,104,25,1221,1213,8,30301,30044,257,293,287,6,100
907647550c98bcaa444bc0baa8637e8d1e23f66b,1,4,0,4,0,0,0,2,8,77,1,1,0,683,105,25,204,203,1,4550,4540,10,149,148,1,100
fe3fac675032237b8b67c3dd1a97be79dd4b5798,1,1,4,3,0,0,0,3,10,54,1,1,0,459,106,26,135,135,0,2503,2503,0,118,118,0,100
0d902a68d358c61623afc6ed4456f7decdae670d,0,0,0,0,0,0,0,0,0,0,0,0,0,0,89,8,0,0,0,0,0,0,0,0,0,100
fb00d685bd39405ac3f36019e2efcf138134265a,0,0,0,0,0,0,0,0,0,0,0,0,0,0,90,9,0,0,0,0,0,0,0,0,0,100
e2f38567a1e4a2aa68e659b4d8b902108cf87793,0,0,0,0,0,0,0,0,0,0,0,0,0,0,91,10,0,0,0,0,0,0,0,0,0,100
e6647fcc34a6cd8c8de78a05ffa2c6687ea8d0a1,2,160,0,160,2,0,2,1,1,0,1,1,0.909736123,0,5,1,12,0,12,614,0,614,10,0,10,99.91139465
c000408cce1d54c8f8e35fe343f02fc14b437ac8,0,0,0,0,0,0,0,0,0,0,0,0,0,0,6,2,0,0,0,0,0,0,0,0,0,100
ca7a599c96047ddc7225fc1b1e93f590480cd49f,1,22,3,19,0,0,0,1,2,0,1,1,0,86,7,3,12,8,4,572,499,73,6,6,0,100
d1554f3d5473f2ca6e788d1fbb4f10544712db29,0,0,0,0,0,0,0,0,0,0,0,0,0,0,92,10,0,0,0,0,0,0,0,0,0,100
8898d531768d793bb5943477fc0f2de92fc80958,0,0,0,0,0,0,0,0,0,0,0,0,0,0,93,11,0,0,0,0,0,0,0,0,0,100
697ca0ce66512e132def0b5b5581b863879ad071,0,0,0,0,0,0,0,0,0,0,0,0,0,0,94,12,0,0,0,0,0,0,0,0,0,100
ad0c62208011cccbdafcb3ec721880b8ef94fad5,0,0,0,0,0,0,0,0,0,0,0,0,0,0,95,13,0,0,0,0,0,0,0,0,0,100
e7fae8f6593335fd09353b99b7de1d459996638e,0,0,0,0,0,0,0,0,0,0,0,0,0,0,96,14,0,0,0,0,0,0,0,0,0,100
5bb9249ee1c3a53f70c982162890b701afd6e31e,0,0,0,0,0,0,0,0,0,0,0,0,0,0,97,15,0,0,0,0,0,0,0,0,0,100
27563987ef2d4d4dc88e22070a8c3152ae310ca0,4,762,173,589,3,0,3,1,6,74,1,3,1.517656639,133,8,3,82,19,63,2299,607,1692,33,6,27,97.13284486
ea81e824352cfcaf5753b467c8477c667a3a1902,1,7,9,2,0,0,0,2,2,1,1,1,0,33,74,0,2,3,1,100,105,5,1,1,0,100
1af459a4966d5f5a2c03fdd00331c2cc6a40c277,1,7,4,3,0,0,0,2,3,0,1,1,0,32,75,1,2,2,0,123,100,23,1,1,0,100
228bee20435260e4e4b6df115d6432fcb13f61de,1,4,5,1,0,0,0,2,4,1,1,1,0,35,9,4,2,2,0,119,123,4,1,1,0,100
753468d8a19f1c6dcac94ea3fd12ed30791d6fab,1,1,1,0,0,0,0,2,3,299,1,1,0,116,10,5,15,15,0,785,785,0,6,6,0,100
ba1d28973531251d4b3c74cab8c1321cf0e74347,2,3,2,1,0,0,0,2,11,38,2,2,0.970950594,400,107,3,84,84,0,2370,2370,0,30,30,0,100
2ed7c2db2abb03d34a9855b3cdf473226f3511e7,4,73,174,101,0,0,0,1,7,0,1,3,1.381316924,469,108,3,61,81,20,2037,2313,276,31,33,2,99.88417547
971c846c1047ce96e06a576ecf5d6ef186db6f68,2,112,0,112,2,0,2,1,1,0,1,1,0.999079718,0,98,9,10,0,10,314,0,314,9,0,9,99.91319444
d54ad1c46b9b3b64aadebfbcdccaf15b08a35e2d,2,30,0,30,0,0,0,1,2,6,1,1,1,58,99,10,10,10,0,314,314,0,9,9,0,100
10a9e2e7ba58d25c13e628043726d379c8329630,0,0,0,0,0,0,0,0,0,0,0,0,0,0,11,6,0,0,0,0,0,0,0,0,0,100
0a96982e61dadc190d809790e41da922ba715bfb,3,245,1,244,2,0,2,1,12,44,2,2,1.425636001,445,76,2,141,119,22,4199,3181,1018,29,20,9,99.92777698
a493e790b7d3a560bcb52872c6aa709dc5b95877,44,0,89,89,0,0,0,3,30,86,6,16,5.114692038,17091,77,3,4646,4647,1,112216,113098,882,1557,1558,1,95.33701988
ac59115c104bca204e9fd0ac5999d0fc7c9995b2,1,22,20,2,0,0,0,4,13,0,1,1,0,484,109,2,128,128,0,3421,3420,1,21,21,0,100
1355d880ac4e30366c18f4709f97daa221b727f8,0,0,0,0,0,0,0,0,0,0,0,0,0,0,100,8,0,0,0,0,0,0,0,0,0,100
8b2e03262154b21e07f016f99a4775abc06f097e,0,0,0,0,0,0,0,0,0,0,0,0,0,0,101,9,0,0,0,0,0,0,0,0,0,100
caa1ea4543411cd254d218b1baaa748ebad1633f,4,118,23,95,1,0,1,1,14,77,2,4,1.547612397,630,78,4,151,143,8,4825,4340,485,31,26,5,99.9070488
fbc9da9dfe3bc8d9aff204143854227f5190b031,0,0,0,0,0,0,0,0,0,0,0,0,0,0,102,10,0,0,0,0,0,0,0,0,0,100
22226fc0f4b49f5cdb16792e0901d94ae7d838b7,0,0,0,0,0,0,0,0,0,0,0,0,0,0,103,5,0,0,0,0,0,0,0,0,0,100
b4077bd6a64f73fd28c210f265d5ef8b089199dd,4,57,2,55,0,0,0,4,23,95,2,3,1.333929945,3473,104,6,1031,1020,11,23669,23446,223,286,283,3,100
9623c5c6f81b96e1d3f2587fd4697a93aefa3a45,36,1462,156,1306,7,0,7,4,31,109,4,9,3.786071787,20462,110,3,6024,5841,183,148797,141439,7358,2149,2074,75,99.69054619
607b863ec2f407f631e98fd205879661efa6f84c,0,0,0,0,0,0,0,0,0,0,0,0,0,0,111,4,0,0,0,0,0,0,0,0,0,100
346f6a0d0c9206778358f4d51869a85fa27a44e0,1,8,2,6,0,0,0,3,15,17,1,1,0,270,79,5,75,74,1,1727,1683,44,24,24,0,100
9e85e90c1e11a8267c181060518a44fb9ec81bf4,0,0,0,0,0,0,0,0,0,0,0,0,0,0,80,6,0,0,0,0,0,0,0,0,0,100
cd65ce1c4dad2c8d0382db07d573f28497791142,1,0,1,1,0,0,0,3,15,20,1,1,0,105,112,5,9,9,0,637,643,6,5,5,0,100
9a2a9072617ffffca3bbbb6713ca337f6d286b88,1,6,0,6,0,0,0,4,15,19,1,1,0,486,113,6,130,128,2,3437,3421,16,21,21,0,100
a568c52040139323c78e39a1e04d81452aab93e7,0,0,0,0,0,0,0,0,0,0,0,0,0,0,81,7,0,0,0,0,0,0,0,0,0,100
05f7fac8637ae3f5c524e1aaf35ebd4f09798db8,1,429,414,15,0,0,0,3,5,22,1,1,0,230,82,8,39,36,3,1301,1216,85,23,23,0,100
92343313fbb0b935fbbc0cfb32bfc14df6b27aac,3,28,8,20,0,0,0,3,16,146,2,3,1.002329251,492,114,7,134,131,3,3441,3351,90,38,38,0,100
eb777be3acbda2ac8823278e8c8cd275fc3fa30d,5,309,140,169,1,0,1,5,21,51,1,3,1.498560595,4485,83,9,1232,1200,32,29477,28645,832,503,494,9,99.96909765
7ad13de0b760c4a3addeb8f5495b8680bdf87927,1,15,0,15,0,0,0,1,2,0,1,1,0,37,84,10,8,8,0,264,264,0,3,3,0,100
0e02efdfbfd49cac5b26f607fd7f29de68186b38,0,0,0,0,0,0,0,0,0,0,0,0,0,0,105,7,0,0,0,0,0,0,0,0,0,100
3b9fa1f25aa4e19b858e43e3ad8710e2b7dbdba4,6,95,94,1,0,0,0,3,21,123,2,5,1.556558883,3334,115,8,884,884,0,20520,20486,34,451,452,1,99.44504393
8efffbdd4b07489628d6a33730b99b2a8ebcbf8e,3,159,0,159,2,0,2,1,2,27,1,1,0.865403851,48,116,9,17,5,12,966,151,815,12,5,7,99.92313605
535d6a9f9452fd93672d99dd8e05a50beb281b81,1,373,414,41,0,0,0,3,6,1,1,1,0,241,12,4,35,39,4,1206,1301,95,21,23,2,100
71ed42e8c59e6ba343f8bb80a3d7355a52b3886a,1,6,5,1,0,0,0,2,2,84,1,1,0,81,13,5,6,6,0,478,468,10,4,4,0,100
b40ba51347b7761d8462988b730879530e39c954,2,130,0,130,2,0,2,1,1,0,1,1,0.937456171,0,117,10,9,0,9,466,0,466,7,0,7,99.92325403
e94e4937a40ad4309205a816db8328c3a27f1979,0,0,0,0,0,0,0,0,0,0,0,0,0,0,106,8,0,0,0,0,0,0,0,0,0,100
286c870c34982406249acbcc8e799b817178ab2f,3,270,72,198,1,0,1,2,8,181,1,2,1.079517143,133,14,6,35,15,20,1478,820,658,17,7,10,99.96933456
42e0745224c06689c515c57ceddfd74ea012df16,1,3,3,0,0,0,0,2,2,0,1,1,0,94,118,11,19,19,0,689,689,0,8,8,0,100
46291a1b1e80cc4d144b82fdbd806756aaaa0dd8,0,0,0,0,0,0,0,0,0,0,0,0,0,0,107,9,0,0,0,0,0,0,0,0,0,100
824959c34021d204d86cb829af8ee2d0eec22b7f,0,0,0,0,0,0,0,0,0,0,0,0,0,0,108,10,0,0,0,0,0,0,0,0,0,100
83695d690cd01a5cba5451275a144be3f4122974,0,0,0,0,0,0,0,0,0,0,0,0,0,0,109,11,0,0,0,0,0,0,0,0,0,100
cf56e213a91bcbb7ad1e888a454155b001b28557,0,0,0,0,0,0,0,0,0,0,0,0,0,0,110,12,0,0,0,0,0,0,0,0,0,100
fd57bd62ddb18cb8cd0f69185df0155d1b3a4794,1,33,27,6,0,0,0,2,11,258,1,1,0,143,85,11,35,34,1,913,899,14,21,20,1,100
fb770599b09eb179ec9b9a9815941290468175e7,3,30,20,10,0,0,0,2,17,77,3,3,0.667073001,1691,119,12,519,516,3,12154,12114,40,165,164,1,100
de3f43a5cdfd6549a20861de50a911920bbd563f,2,6,70,64,0,0,0,1,5,318,2,1,0.74248757,181,86,10,34,43,9,694,901,207,24,32,8,99.96933456
227e4b79b98e5e1a70c4abd3134fc34f06b1d242,0,0,0,0,0,0,0,0,0,0,0,0,0,0,111,12,0,0,0,0,0,0,0,0,0,100
ead07f40c0d84df2b305344935e41b3addcd0a3d,16,225,29,196,0,0,0,2,5,148,5,11,3.97320503,602,112,13,114,118,4,3762,3825,63,68,72,4,99.96931574
779f7dc45257f41441b546ab64b2a3572c8e4623,0,0,0,0,0,0,0,0,0,0,0,0,0,0,113,14,0,0,0,0,0,0,0,0,0,100
f0e9c97321e9d4285387d5575da15d3b35ae7437,0,0,0,0,0,0,0,0,0,0,0,0,0,0,114,15,0,0,0,0,0,0,0,0,0,100
089ec41d3e062444386914d68c0afb0a54b1cdd6,0,0,0,0,0,0,0,0,0,0,0,0,0,0,115,16,0,0,0,0,0,0,0,0,0,100
c0de579ae7ec7fd18a56d57fb5d1cc3419ade8e6,0,0,0,0,0,0,0,0,0,0,0,0,0,0,116,17,0,0,0,0,0,0,0,0,0,100
63530f00101a4084effd8386079df398ea6cb65d,0,0,0,0,0,0,0,0,0,0,0,0,0,0,117,18,0,0,0,0,0,0,0,0,0,100
e06b1c5346c1363ab00fc992e0671be31b480f4e,0,0,0,0,0,0,0,0,0,0,0,0,0,0,118,19,0,0,0,0,0,0,0,0,0,100
ef56f8281b890ae9a6514c1892ae18c0e0c8a0f9,0,0,0,0,0,0,0,0,0,0,0,0,0,0,119,20,0,0,0,0,0,0,0,0,0,100
07677763d4121ec923f4c1e0fbc4bbc6b710015f,0,0,0,0,0,0,0,0,0,0,0,0,0,0,120,21,0,0,0,0,0,0,0,0,0,100
813bb892237825153ffa6b7f739393a49d8b12dc,0,0,0,0,0,0,0,0,0,0,0,0,0,0,121,22,0,0,0,0,0,0,0,0,0,100
3e8f9d931a85f9264153e64ac97b4e9144a3f7f5,0,0,0,0,0,0,0,0,0,0,0,0,0,0,122,23,0,0,0,0,0,0,0,0,0,100
a3749e810b79ed05490ede512b3853e8b24e95a1,0,0,0,0,0,0,0,0,0,0,0,0,0,0,87,8,0,0,0,0,0,0,0,0,0,100
3e5f4357f185e198d85e408cbeeba4e01b846d80,7,0,12,12,0,0,0,2,3,23,1,2,2.688721876,397,88,9,48,48,0,1440,1528,88,41,41,0,100
54cb8933e3f2c9b41bbd39c7014441ef3391ffbb,2,6,7,1,0,0,0,1,11,290,1,2,0.89049164,507,89,10,150,150,0,3128,3140,12,46,46,0,100
db2128fe02c99ebd61032b5a91df1e33a3c9e86c,1,9,0,9,0,0,0,2,4,228,1,1,0,44,120,10,6,5,1,240,196,44,3,2,1,100
301580c06901f378a1d5ddb5555fbf6347e1c126,39,348,165,183,0,0,0,3,25,162,3,6,4.036261871,11654,90,11,3623,3602,21,77993,77160,833,1189,1177,12,94.13219054
bda2015398ba033ef966ad69bb6b5c8c7d3979af,3,34,1,33,0,0,0,2,22,63,2,2,1.423916145,1769,91,12,335,332,3,10747,10665,82,237,235,2,100
a5f3ae42bf81ae12a8816ce74356a8c5f0b67430,4,31,30,1,0,0,0,4,24,72,2,2,1.966665652,2128,92,13,416,416,0,13487,13485,2,254,254,0,100
72741efc851ce1e0302bb352f3fcccf866704dd7,0,0,0,0,0,0,0,0,0,0,0,0,0,0,93,14,0,0,0,0,0,0,0,0,0,100
330654d226614fc769cd7b48717f204380c727e6,1,39,5,34,0,0,0,1,8,296,1,1,0,199,94,15,52,46,6,1387,1278,109,26,23,3,100
3a5185700f95200faffad4a355688ad488993234,6,49,5,44,0,0,0,3,25,68,3,4,2.360388078,2999,95,16,657,651,6,19235,19091,144,389,385,4,99.92882562
728413153f275ae045275e04ca32fc2432bce149,1,19,9,10,0,0,0,2,10,2,1,1,0,837,121,11,297,293,4,6129,6082,47,69,69,0,100
08a615efad89b2cdb3a97dd7725e6c1a01237938,2,370,0,370,2,0,2,1,1,0,1,1,0.993160358,0,123,20,25,0,25,1408,0,1408,15,0,15,99.9111427
cf517aa22497980eee0b912670300a85914c83da,1,0,9,9,0,0,0,1,2,0,1,1,0,126,124,21,17,17,0,547,571,24,12,12,0,100
b653ae9976b3257f2a8af7f19ef43723a9700722,1,0,1,1,0,0,0,2,2,38,1,1,0,358,96,17,20,20,0,2665,2672,7,16,16,0,100
54d9735689246539c022fe547deb16d9870f9e12,3,21,4,17,0,0,0,2,21,60,2,3,1.224381458,867,97,18,267,264,3,5683,5607,76,96,95,1,100
9a7139c9a0ad0f9cf5f660d1e7d6863f9868c95a,0,0,0,0,0,0,0,0,0,0,0,0,0,0,125,21,0,0,0,0,0,0,0,0,0,100
f6067b25fb44f81d3d4a74ef063adddaf9cd6597,0,0,0,0,0,0,0,0,0,0,0,0,0,0,126,22,0,0,0,0,0,0,0,0,0,100
fff0cd889ad4921aee34bcaf528814d64a6ab533,0,0,0,0,0,0,0,0,0,0,0,0,0,0,127,23,0,0,0,0,0,0,0,0,0,100
82c4e2693217165165f8c553eead56deda37a502,0,0,0,0,0,0,0,0,0,0,0,0,0,0,128,24,0,0,0,0,0,0,0,0,0,100
70f3162159f289a294ee3e2a7637925619601424,0,0,0,0,0,0,0,0,0,0,0,0,0,0,129,25,0,0,0,0,0,0,0,0,0,100
dd5c64694d0c4bc827c62293787ded784a24c6e7,1,1,1,0,0,0,0,2,9,8,1,1,0,219,130,25,53,52,1,1391,1387,4,26,26,0,100
ab148526d3bc48ebf9e07f133fc5c4bb78982946,0,0,0,0,0,0,0,0,0,0,0,0,0,0,98,19,0,0,0,0,0,0,0,0,0,100
32ced33fd59f3abd13e9ea2ace01319fdfd4cfbd,1,0,2,2,0,0,0,4,26,16,1,1,0,668,99,18,187,187,0,4678,4690,12,61,61,0,100
3fdf607c584b948dbf155f34d5300d6200d4077d,1,1,3,2,0,0,0,3,15,63,1,1,0,111,100,18,12,12,0,688,691,3,10,10,0,100
66f6d907d5b7c251ec0bd4f22a5815a93e59270e,1,12,19,7,0,0,0,3,13,33,1,1,0,153,131,26,34,35,1,921,913,8,20,21,1,100
15cb2cdf7cf6f481691e92dede407dd89268d141,1,20,12,8,0,0,0,3,14,0,1,1,0,150,132,27,35,34,1,944,921,23,21,20,1,100
b9570f6dd5257eec8799ed728ea3731c071aeb56,0,0,0,0,0,0,0,0,0,0,0,0,0,0,133,28,0,0,0,0,0,0,0,0,0,100
11de85694c9a932b103074533334d51935572cbf,0,0,0,0,0,0,0,0,0,0,0,0,0,0,134,29,0,0,0,0,0,0,0,0,0,100
99bd6a7b544b02d10339bdf51e4fcaac7396c42f,0,0,0,0,0,0,0,0,0,0,0,0,0,0,135,30,0,0,0,0,0,0,0,0,0,100
25b0d9628e3e1d87d567aaa213b1cd452d9fe880,0,0,0,0,0,0,0,0,0,0,0,0,0,0,136,31,0,0,0,0,0,0,0,0,0,100
07dadf55644a2a1c293722250b78103669b27222,0,0,0,0,0,0,0,0,0,0,0,0,0,0,101,16,0,0,0,0,0,0,0,0,0,100
8015a253b6672fca2ae5e8ab208003001136d7f1,1,1,1,0,0,0,0,3,10,157,1,1,0,819,102,15,223,223,0,5907,5907,0,38,38,0,100
16f78782dd4bd189a15d1d1d13b7045872411a91,2,86,6,80,1,0,1,1,18,27,2,2,0.921876486,1143,103,16,355,352,3,8905,8590,315,99,97,2,99.96450124
ca45e3292a7520b58bf31adf2b4ac099ce6416d6,1,1,1,0,0,0,0,5,32,75,1,1,0,3652,137,14,1098,1098,0,22675,22684,9,290,290,0,100
970f6476220315a836c71641d2b262b6e7b959a3,3,2055,2037,18,0,0,0,2,11,242,2,3,1.285389397,1380,15,0,355,350,5,8910,8809,101,226,225,1,100
dbcdfb9ff98a38845ce0e89daf3a6b848e682281,1,3,1,2,0,0,0,3,7,350,1,1,0,136,16,1,36,36,0,817,805,12,7,7,0,100
eb9a626945d62e44112259e777f54db833063682,1,5,1,4,0,0,0,2,5,413,1,1,0,90,138,7,19,19,0,424,405,19,17,17,0,100
b8710bea03a9354dbbb6bed2a23a50d6d4dd46c9,2,1285,1285,0,0,0,0,3,12,0,1,2,0.546560889,810,0,0,182,182,0,5753,5753,0,56,56,0,100
a836ea3f347426e104e639ce83b20cbd8ab4ce2e,0,0,0,0,0,0,0,0,0,0,0,0,0,0,1,1,0,0,0,0,0,0,0,0,0,100
87dc2aad7c2a8f11639dc0b4f875137728b93a65,1,24,3,21,0,0,0,2,3,416,1,1,0,125,122,0,35,32,3,1017,985,32,10,8,2,100
d5fb9486ba9d56875f20d44affe031c19273de13,0,0,0,0,0,0,0,0,0,0,0,0,0,0,123,1,0,0,0,0,0,0,0,0,0,100
ee33aa7af3ed765aee95e38773b042c1e5194fbe,1,8,4,4,0,0,0,2,4,0,1,1,0,133,124,2,36,35,1,1040,1017,23,10,10,0,100
4a03860c2f4dab8a169bf6968e23d91795d42f55,1,13,9,4,0,0,0,2,6,417,1,1,0,103,21,0,25,25,0,579,560,19,9,9,0,100
db25f08565e48ea639e9c7dcf5feb6905efc5d30,1,1,1,0,0,0,0,2,8,294,1,1,0,201,22,1,44,43,1,1169,1166,3,12,12,0,100
e54b0c19086fdbc764e6ea67c86251021bf11b8e,40,3140,2679,461,4,0,4,1,14,326,2,4,3.922010084,5443,125,3,1238,1315,77,39613,34574,5039,481,575,94,98.83185841
d44b353278a4985314a8543a166e255c88df754c,0,0,0,0,0,0,0,0,0,0,0,0,0,0,126,4,0,0,0,0,0,0,0,0,0,100
770abf1aa83527c77a1ed984246d55376f68533e,1,15,0,15,0,0,0,2,8,0,1,1,0,1080,127,5,218,215,3,9261,9188,73,57,56,1,100
db174a951274655dd18c63ad7d36a75124949e01,1,1,1,0,0,0,0,2,9,0,1,1,0,1090,128,6,218,218,0,9261,9261,0,57,57,0,100
7b91f912736827bfa84787a725889889a5ba90f7,1,72,12,60,0,0,0,2,10,0,1,1,0,1090,129,7,235,218,17,9753,9261,492,57,57,0,99.92919101
d85fbdee04a52287feddf4bb628b0d48d16a2bc2,1,2,1,1,0,0,0,2,11,0,1,1,0,1148,130,8,236,235,1,9759,9753,6,57,57,0,100
9dcdd3a35d12192efff07ca0eef80578ca7659c9,1,3,1,2,0,0,0,2,11,266,1,1,0,484,131,9,111,110,1,3618,3596,22,51,51,0,100
600d949140636d03582c919c963bd58a2d27e824,1,24,0,24,0,0,0,2,12,7,1,1,0,1149,132,10,236,236,0,9993,9759,234,57,57,0,100
6dff15b02f9dfad0424932d6940ec69ecf33b98c,1,3,0,3,0,0,0,2,6,9,1,1,0,57,133,11,14,17,3,330,357,27,5,5,0,100
0ffb985316140a49fb1e0c868e97f57d7f6c9ace,1,3,2,1,0,0,0,3,19,41,1,1,0,1150,139,2,354,354,0,8621,8618,3,98,98,0,100
74589c8ae1859472b711ff924599e66cd9eb7da6,1,35,3,32,0,0,0,4,22,78,1,1,0,371,134,12,118,111,7,2934,2795,139,21,20,1,100
148d8f8df2969cc4a57347f3128c682f2491c1b4,1,9,1,8,0,0,0,3,7,288,1,1,0,137,140,2,32,31,1,1048,1018,30,11,11,0,100
dfca20d46580f52ae2c4f75f450e1c30d96e0cb4,1,10,6,4,0,0,0,4,14,117,1,1,0,1236,23,2,356,353,3,7620,7565,55,94,94,0,100
d6dbadaa3cc643b201ca478885e3bde9d77543ed,2,155,78,77,0,0,0,2,13,5,1,1,0.235959417,1229,135,13,269,250,19,10875,10323,552,65,62,3,100
d8be93089cba9c9a129ea229d91fede7ef23c02d,0,0,0,0,0,0,0,0,0,0,0,0,0,0,136,14,0,0,0,0,0,0,0,0,0,100
597930f15a699dc1411fb8372e865cd1938dbb6e,6,154,4,150,0,0,0,2,33,180,2,2,1.401459658,6220,137,15,1782,1775,7,37738,37103,635,693,690,3,100
4e85c5eb84746ed18b23230fc7aae81bd635b4d8,1,3,3,0,0,0,0,2,14,3,1,1,0,1227,138,16,251,251,0,10512,10511,1,60,60,0,100
53614b371f55034b142374263fe640eb75181f07,1,4,2,2,0,0,0,3,6,353,1,1,0,48,141,3,6,6,0,277,248,29,5,5,0,100
847b33aa6eaba2ea1f8ccd1009baccea79b08f22,1,4,5,1,0,0,0,4,17,111,1,1,0,1614,142,4,484,485,1,10262,10279,17,169,169,0,96.90836653
d823825a34b49a2a01be0f6609aa2f8aa1683d39,1,39,1,38,0,0,0,2,15,0,1,1,0,1227,139,17,260,251,9,10648,10512,136,64,60,4,100
f48441c17a1b21f54e2ec62d3529ba748a62d9ef,1,1,1,0,0,0,0,3,13,0,1,1,0,872,140,18,237,237,0,5318,5318,0,175,175,0,100
87b5ae1f4fdb4eec9040b0f1dee729c3507ea683,1,2,2,0,0,0,0,3,16,188,1,1,0,2583,141,19,795,795,0,18963,18963,0,171,171,0,100
3db7e32a564cf92a88e5a16d7fee6aeebd62e98a,3,10,4,6,0,0,0,4,20,88,1,1,1.378783493,2705,24,3,827,827,0,18157,18123,34,172,172,0,100
264356a23f3044a9e67d76aa47cd437dacdf5276,11,181,84,97,1,0,1,1,27,161,2,6,2.794972617,2931,104,0,670,661,9,19360,18964,396,350,338,12,99.9133574
d98ca1d91d3487601eb27fd7d14f0b52732f72ba,1,3,3,0,0,0,0,3,7,6,1,1,0,50,143,5,7,6,1,280,277,3,5,5,0,100
25988d27930732c5a23930a753c0a81aab28f8b3,1,3,1,2,0,0,0,3,6,359,1,1,0,56,144,6,14,13,1,333,315,18,5,5,0,100
fee371db063db7e4eb1172603b4bd0b07a115c1d,1,1,1,0,0,0,0,3,20,15,1,1,0,1150,145,7,354,354,0,8626,8621,5,98,98,0,100
aecff50b27d17904a7b9cb6de00df032f01425dd,12,811,492,319,1,0,1,4,24,171,2,5,2.544499842,7062,142,17,2027,1945,82,53133,51416,1717,569,538,31,99.97118986
8b6406724b5a9cd55a911eb5df394dd7b21bb18d,4,123,16,107,0,0,0,2,24,191,2,3,1.870574879,1194,143,18,328,314,14,8685,7923,762,99,95,4,100
414a5d474ded76552c2da2e70be0702a7efc426c,1,2,1,1,0,0,0,5,12,255,1,1,0,255,0,0,75,75,0,1957,1948,9,9,9,0,100
fdabcf6f03f4d31b5ca088050f334c218b9ca058,1,1,1,0,0,0,0,5,16,138,1,1,0,490,1,1,130,130,0,3437,3437,0,21,21,0,100
2508046403febefacc2ce5ac7e51605c22601021,1,1,1,0,0,0,0,2,3,467,1,1,0,223,2,2,67,67,0,1466,1466,0,26,26,0,100
89f0148fb31b9ece4d57a11872c0ed110a67eef4,1,2,0,2,0,0,0,5,13,146,1,1,0,758,3,3,232,231,1,4430,4405,25,122,122,0,100
8264feb2d63bbdd6a681cdc634ba781be7af0fac,1,3,0,3,0,0,0,2,6,467,1,1,0,158,4,4,43,42,1,928,920,8,19,19,0,100
6c4a0dd4afdd5d18d52419924759a99618a5ff1a,1,52,12,40,0,0,0,2,9,342,1,1,0,1014,144,15,365,358,7,6818,6603,215,83,81,2,100
6cb121e192041b65410fa2af968921c908b14d14,2,30,4,26,0,0,0,4,17,57,1,1,0.430551867,2714,17,0,817,815,2,19937,19846,91,178,178,0,100
4611bf9e43f0782f13216ea14f763e4e5c39a86e,3,68,16,52,0,0,0,2,8,189,1,1,0.683880789,757,105,1,175,164,11,5225,4998,227,67,65,2,100
a255da6f654abbe8e70783a0b492bf64656cc2a1,2,236,0,236,1,0,1,1,4,120,1,1,0.170895224,525,106,2,88,49,39,4882,3490,1392,23,6,17,99.89936745
056ecf52fdf1ec47bba26ed8b1a8026c1d568687,2,14,5,9,0,0,0,2,34,249,2,2,0.485460761,3827,145,3,1144,1141,3,23831,23790,41,303,302,1,100
4bbf599c45d74f9b0cd6d9dd9901bcfd0259e2f1,4,129,47,82,0,0,0,4,18,172,1,4,1.615978031,4667,107,2,1358,1343,15,35250,34734,516,308,306,2,100
04e07ebd0ba7d110d7e0ac6b101f507f71e7433a,1,61,0,61,1,0,1,1,1,0,1,1,0,0,108,3,3,0,3,345,0,345,3,0,3,99.97128087
942599e797a96bf78a1f416d7069ad2d7d417099,1,25,0,25,0,0,0,2,4,252,1,1,0,125,109,4,24,20,4,936,819,117,10,9,1,100
f69eb137143b7b67f947e4be25ddc1d8a02ff496,0,0,0,0,0,0,0,0,0,0,0,0,0,0,110,5,0,0,0,0,0,0,0,0,0,100
3e6410b75de317b93eb0fbefa0e40d408999ea7e,5,86,6,80,0,0,0,3,7,220,2,3,1.921883091,3262,25,0,909,890,19,24459,23935,524,257,254,3,91.80955552
2013fb55b79f43abade103b3f854e0a9573b1227,1,2,2,0,0,0,0,2,14,39,1,1,0,356,146,4,100,102,2,2139,2153,14,41,41,0,100
f5e4742f17b9926075f2867b47e6eafb3089f60a,1,2,1,1,0,0,0,4,28,56,1,1,0,652,26,1,183,183,0,4595,4586,9,61,61,0,100
663fbe62e3bb6da5942464b9c524cbef7e2d186e,2,119,3,116,1,0,1,1,14,19,2,2,0.60365225,760,147,3,246,232,14,4941,4430,511,126,122,4,99.96039604
61c87ac3a12bdfc19cdb00406c756af04ec46062,1,5,2,3,0,0,0,5,29,186,1,1,0,2170,148,4,683,682,1,14429,14422,7,205,205,0,100
64fe22b628ede17101f0f36f5b6c04d8e5e5de80,1,0,3,3,0,0,0,5,30,0,1,1,0,2170,149,5,683,683,0,14429,14429,0,205,205,0,100
05073135390b204c9433d94abce9120b00489816,1,6,2,4,0,0,0,6,31,2,1,1,0,2170,5,0,683,683,0,14439,14429,10,205,205,0,100
799fc69719837bf717d5bbe391dcdbe7d0ffada5,1,10,7,3,0,0,0,6,32,9,1,1,0,2172,146,0,684,683,1,14456,14439,17,206,205,1,100
9549416b5f2352773eff80ed462eecbee8a19ccf,1,1,1,0,0,0,0,6,33,2,1,1,0,2175,147,1,684,684,0,14455,14456,1,206,206,0,100
c6121be5837579a4e311380b34f90ebc9066fe2a,1,0,1,1,0,0,0,5,25,60,1,1,0,2540,111,6,498,498,0,20854,20861,7,97,97,0,100
9851f6274855162bc6dd6e95cd06adf782c5e1a2,1,10,1,9,0,0,0,4,7,36,1,1,0,149,148,2,24,22,2,984,956,28,8,7,1,100
6055a34b4215b472dce012d28ead7a2a7c6f8f19,2,34,1,33,0,0,0,3,11,288,2,2,0.985228136,836,112,7,258,246,12,6451,6150,301,61,61,0,100
6eae1a37ae235f06f0ec729519a19101d3e7cd95,1,1,1,0,0,0,0,2,4,178,1,1,0,122,149,3,10,10,0,759,755,4,4,4,0,100
3dd1c4316503194058d260ebc5fe6753e50949bc,3,8,22,14,0,0,0,2,26,60,2,3,0.674679923,4269,150,5,1091,1097,6,34238,34429,191,180,180,0,100
430d90f05f3bb1512cb07b632e629cd0fdab15b1,1,5,17,12,0,0,0,5,27,0,1,1,0,2525,151,6,489,492,3,20610,20663,53,96,97,1,100
b7c7a47aac588b33749bf29b2113ba4dafb1755b,3,61,57,4,0,0,0,3,6,27,2,2,1.121896975,1927,27,2,534,533,1,14572,14468,104,160,161,1,100
218a000b84a4a8c6b74bb9de4dc604d720c04f66,2,30,19,11,0,0,0,3,7,0,2,2,0.911342376,1345,28,3,361,359,2,10511,10432,79,81,80,1,91.15378799
8303c814194e3b4ff0b8a045216a4cd43e74fb90,4,86,6,80,0,0,0,2,7,368,2,2,1.240740049,1576,29,4,439,420,19,10472,10119,353,104,99,5,100
c87c187f102faa5c4e541ae3a387a54625f7dafe,0,0,0,0,0,0,0,0,0,0,0,0,0,0,113,6,0,0,0,0,0,0,0,0,0,100
49857ff1e88ee3d62af4cd3a692dad039eec5037,16,16,16,0,0,0,0,4,7,193,1,9,4,1682,150,4,132,132,0,10868,10788,80,83,83,0,100
7afa9075e14139daf15f18e221c907d9e4a144a4,0,0,0,0,0,0,0,0,0,0,0,0,0,0,151,5,0,0,0,0,0,0,0,0,0,100
a6e07e50409f33e648a85095869174eb16db9c17,1,7,7,0,0,0,0,3,12,17,1,1,0,318,114,7,94,94,0,2064,2064,0,32,32,0,100
97b23ebb90401a82d1d010f1286bb162ab74d4ac,1,4,10,6,0,0,0,1,6,543,1,1,0,110,115,4,25,26,1,522,560,38,12,12,0,100
3edddc612523ccb3e54a3fee8b9431d5cef45b3c,1,23,9,14,0,0,0,2,10,13,1,1,0,549,116,5,169,164,5,4527,4387,140,29,29,0,100
d58ba3b25be046a2963d362b5addb4b104592212,1,0,4,4,0,0,0,4,17,79,1,1,0,127,117,6,33,33,0,860,888,28,9,9,0,100
c7128669c7e1f439f45c62d07b58e8add38343d2,5,21,3,18,0,0,0,3,35,299,2,3,2.17353321,4570,118,7,1335,1332,3,28753,28674,79,354,354,0,100
ef67680a55f3b38643c9e485b0736d3066cd2eb4,1,4,0,4,0,0,0,2,4,344,1,1,0,78,152,6,5,5,0,342,336,6,3,3,0,100
bb7bf5940928786ce650ef9e3f6c0fb4c84d57ce,1,19,10,9,0,0,0,5,16,99,1,1,0,1245,18,0,363,356,7,7689,7654,35,94,94,0,100
f0be9e1af1d077653d3a34ebd066a1bd412c9157,1,1,1,0,0,0,0,3,5,396,1,1,0,62,153,7,15,15,0,437,447,10,2,2,0,100
fa5eb3a7af517f27625cc53ad25dba21b6555466,1,1,1,0,0,0,0,3,5,396,1,1,0,64,154,8,15,15,0,451,461,10,2,2,0,100
4f0c54211df547e848b6a7605b2f255563634fda,1,120,0,120,1,0,1,1,1,0,1,1,0,0,119,8,10,0,10,617,0,617,7,0,7,99.97554414
396efa6ae6e2d33623e5b73603440058aa6ca6b5,1,59,0,59,0,0,0,3,7,299,1,1,0,202,0,0,57,40,17,1869,1458,411,14,12,2,100
a40baca27321510f108fade1d09a2c043ec52634,1,14,13,1,0,0,0,2,9,129,1,1,0,201,120,9,44,44,0,1169,1169,0,12,12,0,100
e2665ce5dd6e60ba7c2c6e8b4cb310461e87d66c,1,5,2,3,0,0,0,4,29,42,1,1,0,653,152,2,183,183,0,4638,4595,43,61,61,0,100
4a5e42ff8b34f37099247171de7f29c5e746c95d,1,7,2,5,0,0,0,4,21,102,1,1,0,1229,155,9,403,401,2,8960,8936,24,66,66,0,100
7f2613e39414c83c1e9d8e131bd23921e4e8d6ec,1,3,0,3,0,0,0,3,11,155,1,1,0,819,156,10,224,223,1,5931,5907,24,38,38,0,100
b37a0f0ecf2554f7337df6bdd3f8b4709430277a,1,3,3,0,0,0,0,4,19,48,1,1,0,2609,157,11,802,802,0,19238,19238,0,172,172,0,100
6b78680b274b6c1109d269f9472f8659d6e65f84,1,1,1,0,0,0,0,4,20,0,1,1,0,2609,158,12,803,802,1,19241,19238,3,172,172,0,100
fd0e25dae6c3e61c043b6063e8bd617a93387946,5,19,10,9,0,0,0,4,21,163,1,3,2.200786167,5694,153,3,1845,1843,2,41892,41818,74,391,391,0,100
d88af9faaf114aba1df5d6478164d749f80a8a2d,1,1,1,0,0,0,0,3,5,11,1,1,0,570,154,4,184,184,0,4090,4090,0,32,32,0,100
45d90fd282c670634b8e8eea9debc9167e9b42c8,11,246,6,240,2,0,2,4,22,207,4,4,2.502802576,3217,6,0,1022,988,34,22818,21738,1080,314,295,19,99.93892757
95544768f628b62e02947fcbd00d61bd98ec90e6,1,4,0,4,0,0,0,6,17,15,1,1,0,1254,7,1,364,363,1,7711,7689,22,94,94,0,100
5dddb15cb39cddfeb8e59002fa6e1be35a5a6a26,1,6,4,2,0,0,0,2,6,561,1,1,0,93,8,2,27,27,0,484,480,4,7,7,0,100
81c9a795ca2d6134120a82d73e60493ab48ed787,2,33,4,29,0,0,0,2,34,240,1,2,0.405977038,2282,155,5,705,701,4,15176,15018,158,218,214,4,100
4a0ea7646bc1dcbd0adb6064c4e9fa1dee408309,2,6,4,2,0,0,0,3,10,219,1,2,0.970950594,741,30,3,146,146,0,4321,4308,13,55,55,0,100
d1d0ef02609b5cc123d1b91fbf1a77087cb7a22d,1,14,2,12,0,0,0,4,18,120,1,1,0,1612,159,11,487,484,3,10352,10262,90,169,169,0,97.08333333
6e079939b51e4f60070fe3e34232f4d49bc67c43,0,0,0,0,0,0,0,0,0,0,0,0,0,0,121,10,0,0,0,0,0,0,0,0,0,100
2c5377f687d087b94b56bfb5e3b2b5ba4fd3d684,1,1,1,0,0,0,0,4,19,2,1,1,0,1624,160,10,487,487,0,10360,10352,8,169,169,0,100
d9c26d9a8d1a68acf4ae5ffa8d5c933c9cfa14dd,0,0,0,0,0,0,0,0,0,0,0,0,0,0,161,11,0,0,0,0,0,0,0,0,0,100
74823f7cd073325590ba79e8bc12de02832577ab,1,0,1,1,0,0,0,4,30,32,1,1,0,656,31,2,183,183,0,4629,4638,9,61,61,0,100
5f76ea2eaff5fb3dd8c4ad5c6ed1d5554f5065a3,1,9,11,2,0,0,0,5,36,35,1,1,0,3663,156,4,1104,1105,1,22748,22759,11,292,292,0,100
22f77ef4d21994610bd250e99230555ad56fb4d8,1,8,0,8,0,0,0,3,13,272,1,1,0,148,162,12,32,30,2,985,961,24,6,6,0,100
62358d36d15d4b50d95b4e8726dac4715dba9a25,1,3,3,0,0,0,0,3,14,0,1,1,0,152,163,13,32,32,0,985,985,0,6,6,0,100
24cf4c939e58914168c4e548c25a2c3d977022b7,1,9,1,8,0,0,0,6,18,21,1,1,0,1257,164,14,366,364,2,7754,7711,43,94,94,0,100
0273937971eb0769d11e789dc33a222d826e8e8e,1,2,1,1,0,0,0,6,19,0,1,1,0,1263,165,15,366,366,0,7754,7754,0,94,94,0,100
e4bf0444a43d336d54f05765cef4bcc1ca623f04,0,0,0,0,0,0,0,0,0,0,0,0,0,0,166,16,0,0,0,0,0,0,0,0,0,100
17c6580e4ce21e706513f77586372d9bf257a244,1,1109,1108,1,0,0,0,4,14,139,1,1,0,872,19,1,237,237,0,5324,5318,6,175,175,0,100
372e8999818a52181a73befbae0ba0fb7eb9b357,4,132,126,6,0,0,0,2,15,175,2,2,0.910357505,1655,157,5,424,424,0,9971,9943,28,264,264,0,100
f7b7f37f73bb45c2cda9203714c5517f8f52eded,0,0,0,0,0,0,0,0,0,0,0,0,0,0,167,15,0,0,0,0,0,0,0,0,0,100
a85d58d56a94d4aa33f4bf319ff1544c36902473,0,0,0,0,0,0,0,0,0,0,0,0,0,0,122,4,0,0,0,0,0,0,0,0,0,100
6a688205601ebb9e94e047797af7f664de946df1,0,0,0,0,0,0,0,0,0,0,0,0,0,0,168,16,0,0,0,0,0,0,0,0,0,100
593977b05a4ff67f5ebd27d2ab3c84999d2ccca9,0,0,0,0,0,0,0,0,0,0,0,0,0,0,169,17,0,0,0,0,0,0,0,0,0,100
4cb55c62109ba9f062163e5f15e8f4a56e059ad6,0,0,0,0,0,0,0,0,0,0,0,0,0,0,170,18,0,0,0,0,0,0,0,0,0,100
67a73ee0eaa0a903730d5fb1d5f3ffa5f0ca5f68,0,0,0,0,0,0,0,0,0,0,0,0,0,0,171,19,0,0,0,0,0,0,0,0,0,100
aeafc39d3d198e90624fa2895918911204caefd6,1,134,114,20,0,0,0,4,8,44,1,1,0,94,20,2,10,8,2,594,549,45,7,6,1,100
2ac1bcccbb4070da2c86bfee4c7368d9466141ca,5,249,7,242,2,0,2,4,18,133,4,4,1.982233308,360,172,19,100,68,32,3198,2096,1102,46,32,14,94.60083064
11e3835d5fe57c2277fb7b2f563fe5f532e3f21d,4,4,4,0,0,0,0,2,28,221,1,3,1.75,4959,158,6,1002,1002,0,42206,42181,25,214,214,0,100
862cd158ed5acee7361881860548c03444d01dd6,1,4,0,4,0,0,0,5,16,6,1,1,0,874,2,0,237,237,0,5352,5328,24,175,175,0,100
a11158d51a359bd51af3df5b0e03d7cbb50f93d8,1,11,10,1,0,0,0,4,5,0,1,1,0,157,32,2,21,21,0,1237,1220,17,7,7,0,100
cde63a43060c630a4ec641d127ecccf05bb05384,1,278,0,278,1,0,1,1,1,0,1,1,0,0,3,1,43,0,43,918,0,918,22,0,22,99.96833439
a5dcfc91fa956627c66d3100717c308e3855d6c0,1,0,1,1,0,0,0,1,2,0,1,1,0,227,4,2,43,43,0,907,918,11,22,22,0,100
2e0c5d576c5e210bfb1d0a8d799a20284f971a27,1,1,1,0,0,0,0,3,17,236,1,1,0,1266,159,6,428,427,1,7959,7951,8,144,144,0,100
0b60936d33c10ed2e8a95403bbb2bd43a3d312a8,0,0,0,0,0,0,0,0,0,0,0,0,0,0,123,2,0,0,0,0,0,0,0,0,0,100
3c58b8840cfe65a2cbe4283897c846e18919311e,1,6,7,1,0,0,0,3,9,351,1,1,0,438,21,2,96,95,1,2775,2763,12,36,36,0,99.77876106
84763ce94e62154937436105a043d55b9e958a35,0,0,0,0,0,0,0,0,0,0,0,0,0,0,124,3,0,0,0,0,0,0,0,0,0,100
9b78cd5441f1e550ad5a9c074dadeade1f16ed40,0,0,0,0,0,0,0,0,0,0,0,0,0,0,173,14,0,0,0,0,0,0,0,0,0,100
d826caf71175811a23214b4e23545aee7625d7ed,8,136,24,112,1,0,1,5,37,37,3,3,1.759932258,6623,22,3,1825,1816,9,39346,38919,427,702,697,5,99.96845426
8d288589c2a595c4df5dc2099ba567d040109e46,0,0,0,0,0,0,0,0,0,0,0,0,0,0,160,5,0,0,0,0,0,0,0,0,0,100
326df83bb224167f9abc408ac90173666d146d78,2,4,6,2,0,0,0,6,38,8,1,1,0.881290899,4106,23,4,1202,1202,0,25548,25548,0,329,329,0,100
c13e2baab7aa0c71ad6fafbc9c6527e1393a2894,1,5,2,3,0,0,0,4,6,14,1,1,0,158,33,3,21,21,0,1257,1237,20,7,7,0,100
485cfd37ca2e810c0cdc6bc897fe73109bfd5e3c,2,198,0,198,2,0,2,1,1,0,1,1,0.86596535,0,125,4,27,0,27,1031,0,1031,14,0,14,99.92122262
859da3f913d8b4f0b142fe872d78847f958f0614,1,7,18,11,0,0,0,3,9,257,1,1,0,109,24,5,25,27,2,646,686,40,11,11,0,100
a2be03e9cb6e94c488c1475650eaf3ab05da7ee6,8,47,23,24,0,0,0,4,22,413,1,4,2.822657336,3378,161,5,970,965,5,24401,24272,129,247,242,5,100
0a072b8a50dc376cccb5662915e0f9a1b2763c32,1,2,2,0,0,0,0,4,10,0,1,1,0,100,162,6,26,25,1,650,646,4,11,11,0,100
7ea424bf0b36d6be115976fa6134877116fc2dee,1,1,0,1,0,0,0,4,9,387,1,1,0,379,25,6,135,134,1,2983,2978,5,11,11,0,100
a384218429534d2f81e7437ca532d49b3596a60d,1,5,1,4,0,0,0,1,2,24,1,1,0,75,174,12,11,9,2,411,377,34,3,3,0,99.21334172
02f2cedb734be0d4f9b4b340359544fd7707e477,67,4389,0,4389,67,0,67,1,1,0,1,7,5.834567803,0,175,13,454,0,454,13905,0,13905,407,0,407,87.7672209
7f523e0ba9a8b62339868a0a7b22f4509e450a72,0,0,0,0,0,0,0,0,0,0,0,0,0,0,176,14,0,0,0,0,0,0,0,0,0,100
195d5ddd6cad75d5e2786e2b44c0b42e23a7a8b0,1,4,2,2,0,0,0,4,11,0,1,1,0,100,177,15,28,26,2,669,650,19,11,11,0,100
3bacfce53cb4931ac70e1f12cf859f08902cd16a,0,0,0,0,0,0,0,0,0,0,0,0,0,0,178,16,0,0,0,0,0,0,0,0,0,100
b8d375034630bd12c4be3035356f346e5d5f07ff,0,0,0,0,0,0,0,0,0,0,0,0,0,0,179,17,0,0,0,0,0,0,0,0,0,100
d36faee0ab706ab8663b7b6686a23fa1946160bc,66,0,0,0,0,0,0,1,1,0,1,6,0,3196,180,18,411,0,411,13016,2442,10574,387,0,387,95.19408503
ecf428bd69d9c31f08ae3f8dc9cca5573a3ce2bc,0,0,0,0,0,0,0,0,0,0,0,0,0,0,181,19,0,0,0,0,0,0,0,0,0,100
7d0839f9ff14644050133a19edcb61d030432602,1,13,3,10,0,0,0,1,2,3,1,1,0,186,182,20,36,35,1,1497,1425,72,11,11,0,100
e14378f7f32bfbaa59e558b8c29ff42ff3e71c0c,6,162,38,124,0,0,0,2,39,370,2,4,2.444868,4842,26,7,1430,1414,16,30235,29600,635,419,418,1,99.66604824
db07362e27df097fa707f5007c68ee219efdbb09,40,40,40,0,0,0,0,1,2,0,1,5,5.321928095,2111,183,21,295,295,0,8525,8565,40,295,295,0,100
ac5aa0823db7e643462d13f921275ec806114414,0,0,0,0,0,0,0,0,0,0,0,0,0,0,184,17,0,0,0,0,0,0,0,0,0,100
01eddbee801b1b87daabf5d89921ea0907a10d9d,0,0,0,0,0,0,0,0,0,0,0,0,0,0,185,18,0,0,0,0,0,0,0,0,0,100
1bef88aeb7a48b39d0f326ba29e2387f192fda06,0,0,0,0,0,0,0,0,0,0,0,0,0,0,186,19,0,0,0,0,0,0,0,0,0,100
611932c86bbb6368de2e48069144cb9b7b28e3a6,0,0,0,0,0,0,0,0,0,0,0,0,0,0,163,5,0,0,0,0,0,0,0,0,0,100
7a2330ce3bcb238be8df2295e13c49b2994cf5ed,2,58,46,12,0,0,0,4,31,26,2,2,0.391243564,1101,164,6,284,281,3,7525,7452,73,97,97,0,100
dfc102beba2406c0a6065e665b710431245673cc,5,51,85,34,0,0,0,2,40,26,1,3,1.835183775,4535,27,5,1341,1348,7,27701,27872,171,379,380,1,99.68460111
4efc5d69972193ee57032dce319cf1b42e0d65b1,2,45,53,8,0,0,0,3,32,243,2,2,0.14372617,733,165,5,183,186,3,5032,5105,73,61,61,0,100
8974a099084986706a14419fa3e2298541ee50e1,3,8,7,1,0,0,0,3,19,0,1,2,1.429473298,789,166,6,229,229,0,4750,4749,1,83,83,0,100
09e7aab7778db72e6412625f39a9557d6a2646be,2,20,0,20,0,0,0,6,35,300,1,1,0.881290899,2319,9,0,724,721,3,15391,15320,71,220,217,3,100
4f102a7c77a321699663e9fba7449725e52d86ba,4,52,37,15,0,0,0,2,4,543,1,2,1.456252726,1360,10,1,424,419,5,9625,9560,65,171,166,5,100
1b446958f5699c2adecb3163ab9ce44b873b2f57,2,9,3,6,0,0,0,2,14,218,2,2,0.811278124,1031,167,6,287,286,1,6875,6861,14,92,92,0,100
372b83736d50dba2a81f947b4bfd8220b8f62ed4,1,4,18,14,0,0,0,3,8,116,1,1,0,1086,168,7,281,283,2,8570,8666,96,53,53,0,100
e3f8a96205c51c43a986e804a34846252e8c29a8,1,3,1,2,0,0,0,5,15,140,1,1,0,768,34,0,237,237,0,4516,4503,13,122,122,0,100
018cf3278a4f28f012bef3f8942273492404f737,1,2,1,1,0,0,0,5,16,0,1,1,0,768,35,1,237,237,0,4519,4516,3,122,122,0,99.98145401
0b8bf2818c3b5fbb1699a3f222eb30de87844638,1,37,12,25,0,0,0,4,25,182,1,1,0,403,126,1,125,122,3,3136,3001,135,22,22,0,99.88870339
82a62a6b7800f0c218102c62232667390ef1d071,1,9,1,8,0,0,0,3,4,399,1,1,0,150,11,2,44,42,2,1198,1123,75,8,8,0,100
2d3871b86b89e4c19e9831f1361472d7387bda34,4,37,3,34,0,0,0,3,41,60,3,3,1.466990818,6875,1,0,2044,2038,6,46108,45875,233,524,522,2,93.44647048
7eb91d0ec9eb7690db32f5f8cedb7f336325d2fa,1,210,211,1,0,0,0,5,9,0,1,1,0,173,2,1,27,27,0,1117,1121,4,9,9,0,100
65bd1f02e386c0e8b11fdd444b7b8caabbe8d081,1,5,5,0,0,0,0,4,33,18,1,1,0,655,169,6,183,183,0,4651,4629,22,61,61,0,100
e20afb3134610518c408ce1870446de4c19689d3,1,36,42,6,0,0,0,3,14,27,1,1,0,445,127,1,98,98,0,2814,2823,9,36,36,0,99.80725425
2a95f80f442ecf25a03aef34023cd98756bc1b0d,9,30,110,80,0,0,0,3,36,259,2,4,1.438945405,8035,12,3,2109,2118,9,54915,55377,462,976,981,5,100
7db81e3d6cf042ac474a1fe41f7d9c90f2f7dec3,8,49,45,4,0,0,0,6,30,145,5,6,2.804098878,8389,128,2,2211,2207,4,61485,61455,30,475,475,0,100
53f19cbb4ff42fbd87bf1b8082b87af7524c31b2,11,0,729,729,0,0,0,1,3,44,1,1,3.366176363,577,187,0,0,84,84,0,2243,2243,0,84,84,99.56055546
5ae6e7594f265d2af44c6f34a0c666b23f956cf4,4,3,36,33,0,0,0,4,42,16,3,3,1.476542775,6907,28,1,2038,2044,6,45875,46104,229,522,524,2,93.23609845
4bf637f0747fcbba281b2ad2442475336cea8dfe,5,9,3,6,0,0,0,2,13,366,2,3,2.251629167,1591,170,6,434,430,4,12179,12151,28,126,125,1,100
7303bcd5d5fee247520eb5d105f5b4a5ab7776f7,1,3,2,1,0,0,0,2,8,47,1,1,0,79,29,2,17,17,0,408,400,8,12,12,0,100
31010aa2ac0c335615d6479f3d7d8e5a728c23b4,1,1,1,0,0,0,0,2,3,313,1,1,0,119,129,3,17,17,0,547,547,0,12,12,0,100
560f89510239d75b1a0db97dffcb9cbc21ab9e32,4,90,18,72,2,0,2,1,43,55,1,2,1.791239401,4814,130,4,1345,1338,7,29771,29501,270,490,487,3,99.90606801
661f673890c076b8d6532d5f704434bc508a1fe5,1,11,15,4,0,0,0,1,2,0,1,1,0,35,131,5,4,5,1,213,247,34,2,2,0,100
dc797ab923c30a788dd9af28509791018484b7ac,4,34,19,15,0,0,0,3,27,91,3,3,1.593575552,1692,132,6,370,368,2,10699,10622,77,223,223,0,100
af1796f17c9602f0cb069d27848a4081f9aa7374,0,0,0,0,0,0,0,0,0,0,0,0,0,0,133,7,0,0,0,0,0,0,0,0,0,100
6e30b565b7ec7e409d40985b72a8ab98477ce84b,0,0,0,0,0,0,0,0,0,0,0,0,0,0,30,3,0,0,0,0,0,0,0,0,0,100
ebe1b5711e4347898cd8e7f4e7a9b7baa18dea26,2,10,10,0,0,0,0,3,28,4,2,2,0.468995594,1247,171,4,240,241,1,7318,7328,10,199,199,0,100
afce8f543abfbcbe81eb87c7ed5e22c1879e44a5,4,265,1,264,3,0,3,1,3,171,2,2,1.579941926,52,172,5,31,7,24,1333,240,1093,24,6,18,99.868791
1af233a0b3b7ad19ed14aa1b0a297269f7905e97,1,3,0,3,0,0,0,2,5,186,1,1,0,140,134,8,24,24,0,940,936,4,10,10,0,100
d2c748d1094f295243c7a3b9efe2b937d8bc9b0b,34,68,32,36,2,0,2,1,5,72,1,9,3.463065955,1892,135,8,288,278,10,8578,8406,172,255,250,5,99.83168132
69c34cd385cfd06409b8009af5c9a681233d26b1,1,41,0,41,1,0,1,1,1,0,1,1,0,0,136,9,2,0,2,216,0,216,2,0,2,99.86925663
0b90c67a8bb2932037c4311e8afb7d85a6c3902e,5,176,17,159,1,0,1,1,6,400,3,5,1.623237978,523,137,10,155,124,31,4008,3112,896,65,55,10,99.94400896
9bfc9cf1905f30a3a80204858ac4f49d5c824d22,14,614,393,221,0,0,0,3,44,372,2,3,1.66541322,6929,188,1,1858,1824,34,41216,40515,701,721,701,20,100
d35bc8a306444ed25e7322d023e46c4a1d64e60a,1,2,0,2,0,0,0,5,11,30,1,1,0,156,3,0,24,24,0,992,984,8,8,8,0,100
b5bab78e043329c97b0ddac1558bd595e5a522aa,4,81,3,78,2,0,2,6,24,67,3,3,1.392925129,2757,138,10,869,858,11,18281,17943,338,237,229,8,99.79550102
853fb319ba81e2ad589ac6a7ce47b45de0a2749d,5,228,79,149,2,0,2,2,15,124,2,4,1.970858739,1052,139,11,282,266,16,7281,6479,802,132,122,10,99.16201117
148519ba2a119cb7926a1fac38890cfae6c778c6,1,0,1,1,0,0,0,1,2,0,1,1,0,75,140,12,19,19,0,481,492,11,8,8,0,100
1da2bd72406d807b3b9c069b4006ee60627552cb,0,0,0,0,0,0,0,0,0,0,0,0,0,0,189,1,0,0,0,0,0,0,0,0,0,100
fabdf10407d6d4061c51f0b44bdb48819f1d2df3,4,170,9,161,2,0,2,1,7,141,2,2,1.379927862,300,173,2,89,78,11,2562,1900,662,20,12,8,99.90648962
17c21b7bea5af79cf23d07c793982406b1529966,0,0,0,0,0,0,0,0,0,0,0,0,0,0,31,1,0,0,0,0,0,0,0,0,0,100
4ce16ed9d3abe5c8d98a9384607aba8648378674,0,0,0,0,0,0,0,0,0,0,0,0,0,0,32,1,0,0,0,0,0,0,0,0,0,100
229f24547add9fdf5c7414cf98895bf85f83e9d6,5,176,25,151,3,0,3,1,45,57,2,3,2.02960814,4103,174,1,1246,1238,8,26600,26104,496,337,329,8,99.86937862
eb27482080af614ff7e387b9659e72571f8ce029,4,12,2,10,0,0,0,1,31,16,2,3,1.778328354,3031,175,2,634,637,3,24237,24582,345,140,142,2,99.85091316
123fce5b60bd33aebfe864e5c2c781a366302913,2,127,0,127,2,0,2,1,1,0,1,1,0.93086371,0,176,3,10,0,10,482,0,482,8,0,8,99.90690747
68e4f9a85b9f2a2067daaaa3d56dfac522fdb3a2,1,1,1,0,0,0,0,2,6,606,1,1,0,31,190,2,0,0,0,104,104,0,0,0,0,100
ae2d8685e1221f3a8ab8a96cc20f2b2cd2aa208f,4,79,21,58,0,0,0,4,25,260,1,3,1.134067026,3873,13,0,1153,1145,8,28778,28404,374,238,236,2,99.96278377
91cc43267670049486cc609091cc07ddb339cef0,1,10,3,7,0,0,0,2,7,618,1,1,0,142,191,2,45,39,6,1031,983,48,10,10,0,100
442c1cee4870edc0916191e1872ae8223496e84f,12,215,52,163,0,0,0,4,20,354,3,5,2.928765936,7659,4,0,2251,2221,30,54766,54015,751,836,826,10,92.71800473
9b61ded11bf1ea63c174e7a2d63fd7e6e5fe1e60,2,10,25,15,0,0,0,4,9,10,1,2,0.994693795,482,177,4,124,126,2,3500,3583,83,28,28,0,100
df02d831e2dce80e0d00ec0febf0c708f02bacb3,3,20,12,8,0,0,0,5,26,355,1,2,0.776973436,2605,178,5,829,826,3,17848,17805,43,232,232,0,100
f7aef4581483be989ba84eed1ea71ce0f043c17c,8,211,55,156,2,0,2,2,21,201,2,2,2.373242079,2921,179,6,801,789,12,18603,17936,667,347,337,10,99.76868327
fee930886b9c0f3e177d6257d60b158d5f2d9654,11,155,141,14,1,0,1,4,22,57,3,4,2.842794229,6776,5,1,1993,1993,0,46633,46595,38,780,780,0,99.8401421
3a5d06436c7528885763e69ae6eee539fedb668e,0,0,0,0,0,0,0,0,0,0,0,0,0,0,192,2,0,0,0,0,0,0,0,0,0,100
1679c05c89203f9d8d0c3f1ea1cfdc64943564a5,11,121,212,91,0,0,0,4,23,0,3,5,3.087074601,7633,180,6,2201,2216,15,53808,54214,406,796,801,5,100
fe900d97fe9bf9b6e26ac24654a3936a106f9546,0,0,0,0,0,0,0,0,0,0,0,0,0,0,141,0,0,0,0,0,0,0,0,0,0,100
3d929be1707797d4d7078e0776686ee783c11895,0,0,0,0,0,0,0,0,0,0,0,0,0,0,193,3,0,0,0,0,0,0,0,0,0,100
8167400e51e6148aed5f4bef1c9fb737b659abd3,36,596,1178,582,3,0,3,2,26,106,2,12,4.742286958,4682,181,7,785,891,106,27040,31241,4201,302,354,52,98.50531244
57f9f3af1da42be60f8d73594d4d1300909a83d9,3,100,0,100,2,0,2,7,22,23,2,2,1.266216723,1269,0,0,378,367,11,8179,7788,391,102,94,8,99.90870915
10bdc61b91d2cf8c98ea72b42343f76865feee72,1,0,3,3,0,0,0,5,24,15,1,1,0,1628,194,4,487,488,1,10407,10449,42,169,169,0,100
f023f58562aeebe2ee9c456c06720de782b70116,3,47,4,43,0,0,0,4,9,135,2,2,1.540052788,2039,1,1,654,647,7,14835,14622,213,110,107,3,100
cf7ae01b0801ca78089f69712f854cee6482a37d,0,0,0,0,0,0,0,0,0,0,0,0,0,0,2,2,0,0,0,0,0,0,0,0,0,100
24538f54312528209b933e34f082447d85af60f6,0,0,0,0,0,0,0,0,0,0,0,0,0,0,195,5,0,0,0,0,0,0,0,0,0,100
9c25f9bdf555dd57de22e5cbbc9b73cce7c0c000,2,6,7,1,0,0,0,3,10,0,2,2,0.619382195,1343,142,1,477,477,0,10384,10384,0,66,66,0,100
9e8e265d6ce4c198945b534489f02838870e8ae3,2,239,6,233,0,0,0,6,15,122,1,1,0.068354517,250,6,2,99,31,68,2938,1442,1496,21,12,9,100
4754f0921c4ee9b574e0c5c68b1c83854e9dd43d,1,5,5,0,0,0,0,6,16,0,1,1,0,374,5,0,94,94,0,2600,2596,4,18,18,0,100
6fe50aa4337eb318ebbcb13ba84909c1df22dc9b,1,7,5,2,0,0,0,6,17,0,1,1,0,374,7,3,94,94,0,2616,2600,16,18,18,0,100
729c7af474c36b7aa626a1fb0ebba38049dbad96,3,45,2,43,0,0,0,2,26,251,1,1,0.846522904,3054,8,4,914,910,4,22575,22289,286,200,198,2,100
5d18f26c10dcb37624aefb0ed7d51301f89731ea,1,0,1,1,0,0,0,6,19,0,1,1,0,406,9,5,97,97,0,2876,2876,0,19,19,0,100
fa68b7dcad4816271de67ec62de6d53c615f0cb6,0,0,0,0,0,0,0,0,0,0,0,0,0,0,3,3,0,0,0,0,0,0,0,0,0,100
7bd43ff2e045047c103546f546ba024de3b70593,3,11,10,1,0,0,0,2,27,0,1,1,1.165784052,3088,143,2,916,914,2,22613,22575,38,200,200,0,100
cf47647dcd43bfeb207abfd2ca4fa17ca3a05de8,0,0,0,0,0,0,0,0,0,0,0,0,0,0,6,1,0,0,0,0,0,0,0,0,0,100
db2a53ff2dacb94f9bb2cf2f721994604d73b921,1,0,17,17,0,0,0,6,21,0,1,1,0,413,10,6,99,100,1,2852,2940,88,19,20,1,100
80f7795fefebd6776293ad0c51417e0fccdbeadd,6,53,75,22,0,0,0,4,11,297,2,3,2.037362126,2612,182,5,800,804,4,18461,18590,129,162,163,1,100
e541936463b4b6be3ab05ded5b2ed224b4692d6b,2,10,10,0,0,0,0,2,6,778,2,2,0.881290899,203,14,0,52,52,0,1193,1188,5,16,16,0,100
814637ca6cd89f237450d24469732b86b91b73b5,11,358,180,178,2,0,2,1,28,352,2,4,2.689003864,4083,144,3,1119,1125,6,28563,28364,199,300,293,7,97.79398684
7f998f10f13ea84a66b5da405f0f11a990dca0c8,1,1,1,0,0,0,0,6,29,0,1,1,0,2621,145,4,806,805,1,19329,19325,4,173,173,0,100
57442b70592e83218b1d9ac78c972364308e20d1,2,19,1,18,0,0,0,1,2,0,1,1,0.881290899,109,146,5,10,8,2,640,538,102,4,4,0,100
c5d82a70d54136f47033d934e822f397f28f20d2,1,3,0,3,0,0,0,4,18,25,1,1,0,2072,15,1,696,695,1,14448,14431,17,255,255,0,100
1773160684ce1f6fb932571b9a2c08023777a9ae,0,0,0,0,0,0,0,0,0,0,0,0,0,0,4,4,0,0,0,0,0,0,0,0,0,100
1c8f82b810845758084831d294b39a10279333fb,3,19,17,2,0,0,0,3,19,0,2,3,1.215914384,2277,183,6,753,748,5,15713,15641,72,271,271,0,100
8ece757233957518b2cf30b67f7a9103acf4bced,2,8,5,3,0,0,0,6,30,2,1,2,0.89049164,2898,147,6,884,882,2,20993,20979,14,203,203,0,100
60a1e54f07a491213603b7881d7ae8615556fd2a,3,265,87,178,2,0,2,1,14,78,2,2,1.447387175,585,184,7,188,172,16,4930,4055,875,48,37,11,99.87849332
31c7a575e76d55b120444962fa999d17fc7e2c06,1,0,1,1,0,0,0,4,15,0,1,1,0,588,185,8,175,175,0,4128,4139,11,37,37,0,100
bd93bfa284315130c4f9e9a65d091925ffa919f4,9,31,35,4,0,0,0,1,31,0,2,4,2.880203944,3961,148,7,1087,1087,0,27142,27180,38,284,284,0,99.75677554
15e1289b9583f8e9c9d98d38dcf6d9654aaf1011,0,0,0,0,0,0,0,0,0,0,0,0,0,0,196,5,0,0,0,0,0,0,0,0,0,100
0570f6b3bcfeda4831c10182c71b2f5834d77e16,0,0,0,0,0,0,0,0,0,0,0,0,0,0,5,5,0,0,0,0,0,0,0,0,0,100
82d274abd6499417d3917215f0f24d4894e25453,0,0,0,0,0,0,0,0,0,0,0,0,0,0,197,6,0,0,0,0,0,0,0,0,0,100
840644fcc5332740c9c5f466b968c1cd8afab6b3,6,140,42,98,1,0,1,4,32,4,3,4,2.141628537,3247,149,8,953,934,19,23449,22994,455,247,240,7,99.89570659
af2550bb054bc9ec79aa02d9fa1953765b930da0,1,18,6,12,0,0,0,5,18,0,1,1,0,449,198,7,113,110,3,3015,2906,109,50,50,0,100
4b6bade66a47e01754817c20d3b01e907fa4fd62,0,0,0,0,0,0,0,0,0,0,0,0,0,0,199,8,0,0,0,0,0,0,0,0,0,100
d62996fd2fd76a7097b4656f24fa35b9ea1fdc6d,0,0,0,0,0,0,0,0,0,0,0,0,0,0,6,6,0,0,0,0,0,0,0,0,0,100
7fd119e840cc8f6968abe82bf789cf3086f02779,0,0,0,0,0,0,0,0,0,0,0,0,0,0,7,7,0,0,0,0,0,0,0,0,0,100
89b0cf69b1d27462e4b1e604957cd792a4b340f3,0,0,0,0,0,0,0,0,0,0,0,0,0,0,150,9,0,0,0,0,0,0,0,0,0,100
f041ba09598a7bcc559c69f4ccdd2e8c87bb9747,0,0,0,0,0,0,0,0,0,0,0,0,0,0,151,10,0,0,0,0,0,0,0,0,0,100
24299b365e8e131d1593587fec3aecd87fb7e6c7,0,0,0,0,0,0,0,0,0,0,0,0,0,0,152,11,0,0,0,0,0,0,0,0,0,100
d86ba0eed3c07ef5ae0d6b1cb71ad1ee26d5980b,1,1,1,0,0,0,0,3,15,206,1,1,0,152,153,12,32,32,0,985,985,0,6,6,0,100
82c71f6dcec66e480f9414e277ddfe22b783926a,0,0,0,0,0,0,0,0,0,0,0,0,0,0,154,13,0,0,0,0,0,0,0,0,0,100
0806fd5b4409f45f86af4c92a648feaee3990b6d,6,108,20,88,2,0,2,5,25,129,2,3,2.098227149,2301,200,8,653,648,5,14838,14673,165,243,237,6,95.6654768
b4a3a77840af840f9cd2800b717c585a3c135e5e,17,462,57,405,3,0,3,2,46,217,4,4,2.992676857,10029,186,5,2992,2955,37,66517,64480,2037,886,864,22,99.90036533
3885031a892f077661112ee0654a59970ac76191,9,375,1,374,5,0,5,3,32,69,3,5,2.959424787,4686,187,6,1250,1188,62,37192,35554,1638,319,289,30,99.08955471
8b20d692e7fc188f665ac4746e8d259dc833bf3e,0,0,0,0,0,0,0,0,0,0,0,0,0,0,8,8,0,0,0,0,0,0,0,0,0,100
4ea1c3f7389ec4954561e1b4739eecb988b20899,19,285,0,285,0,0,0,1,4,86,4,12,4.247927513,1325,9,9,292,292,0,9401,9401,0,125,125,0,100
794ca05eedf517100ab9c4b7011af1f23d641b54,0,0,0,0,0,0,0,0,0,0,0,0,0,0,10,10,0,0,0,0,0,0,0,0,0,100
7713ecf104e329c5b6d533e024723e9c92ef1b5c,0,0,0,0,0,0,0,0,0,0,0,0,0,0,11,11,0,0,0,0,0,0,0,0,0,100
640cddad04c525af1122fbf8d6e2fde8a13adfb8,1124,14707,11245,3462,0,0,0,3,47,0,9,63,10.13410513,156156,201,7,36543,36543,0,969656,969656,0,15160,15160,0,100
aec27a30bf9d8d4e7fe1cde6a1830d10eb064119,0,0,0,0,0,0,0,0,0,0,0,0,0,0,12,12,0,0,0,0,0,0,0,0,0,100
09dad99722254c43ee6346de45c4022046c6f2d6,0,0,0,0,0,0,0,0,0,0,0,0,0,0,13,12,0,0,0,0,0,0,0,0,0,100
b0ba394a5739dff642a15d5279935cdbe8da50d7,0,0,0,0,0,0,0,0,0,0,0,0,0,0,14,11,0,0,0,0,0,0,0,0,0,100
47ffcea019732c32655bd3b875af3c1b52ff261f,0,0,0,0,0,0,0,0,0,0,0,0,0,0,15,12,0,0,0,0,0,0,0,0,0,100
022abc1b4e56169cbbd608ba5feb6ba45c65571f,0,0,0,0,0,0,0,0,0,0,0,0,0,0,202,6,0,0,0,0,0,0,0,0,0,100
1af9d83d1b590589d0552c51e674851ae418c834,0,0,0,0,0,0,0,0,0,0,0,0,0,0,203,7,0,0,0,0,0,0,0,0,0,100
0df6a69703ffbbdbc2cdc715d09c6969d69bf7a7,1,9,9,0,0,0,0,6,25,11,1,1,0,350,11,0,72,72,0,2336,2317,19,18,18,0,100
30f204251018ca448a4e66c7b3d000fa67c69d85,1,6,7,1,0,0,0,6,26,0,1,1,0,351,12,1,72,72,0,2336,2336,0,18,18,0,100
0f66458d4c1f410e9c71aa7ccac54c7427f27f8d,3,131,23,108,0,0,0,3,27,8,2,2,1.406999859,501,13,2,110,86,24,3603,3092,511,26,25,1,100
c816683d08ae06aff267e1909a44e12cf4584d21,2,12,12,0,0,0,0,3,7,0,1,1,0.918295834,256,14,3,37,37,0,1301,1289,12,7,7,0,100
0bc9685aa77959c9898853af18789859fb14412f,2,3,3,0,0,0,0,3,8,0,1,1,0.918295834,256,15,4,40,37,3,1319,1301,18,7,7,0,100
129360ace992869aefdde406527456c51a550686,3,130,132,2,0,0,0,3,28,0,2,2,1.325222374,604,16,5,104,113,9,3611,3633,22,26,26,0,100
b74ad208bde285b8b019c228112f322c186595bd,1,120,0,120,1,0,1,1,1,0,1,1,0,0,204,5,3,0,3,489,0,489,2,0,2,99.93389522
3f48eca25ad0300a78325a2894704fa7c2a30d4b,0,0,0,0,0,0,0,0,0,0,0,0,0,0,205,6,0,0,0,0,0,0,0,0,0,100
42f0d50d02b0699d7dd805a25aa6a99dd625c396,0,0,0,0,0,0,0,0,0,0,0,0,0,0,206,6,0,0,0,0,0,0,0,0,0,100
149011a3df2985a1b27be38b3d4601cf92c582ed,0,0,0,0,0,0,0,0,0,0,0,0,0,0,207,7,0,0,0,0,0,0,0,0,0,100
c1486499a441607a7b0ac1c47300db0b76df0cfc,0,0,0,0,0,0,0,0,0,0,0,0,0,0,208,8,0,0,0,0,0,0,0,0,0,100
9b43b9d30829f8524c76bb4489686e6bdb42fc21,0,0,0,0,0,0,0,0,0,0,0,0,0,0,209,9,0,0,0,0,0,0,0,0,0,100
5d8c645682e476fcde3e83dd657758ab9a8f4baf,0,0,0,0,0,0,0,0,0,0,0,0,0,0,210,10,0,0,0,0,0,0,0,0,0,100
78a8f126a1c0d6a040cea5e0da5bbdf363ebf412,0,0,0,0,0,0,0,0,0,0,0,0,0,0,211,11,0,0,0,0,0,0,0,0,0,100
0460c1113b5b270a41f2734742645d7b1cc2ff4e,0,0,0,0,0,0,0,0,0,0,0,0,0,0,212,12,0,0,0,0,0,0,0,0,0,100
68d9b38133fc0674a992b25a8521b82805f9024f,0,0,0,0,0,0,0,0,0,0,0,0,0,0,213,13,0,0,0,0,0,0,0,0,0,100
24dc0c7f7e8d1fe15a888d3ba3749bc4bb0a6d4d,0,0,0,0,0,0,0,0,0,0,0,0,0,0,214,14,0,0,0,0,0,0,0,0,0,100
ce3abf8a7b7c399fb03cee3b3da8f3de4d8f2cc1,0,0,0,0,0,0,0,0,0,0,0,0,0,0,215,15,0,0,0,0,0,0,0,0,0,100
9b05b6305de99beeb2eabee6331a62b6d4565c24,0,0,0,0,0,0,0,0,0,0,0,0,0,0,216,16,0,0,0,0,0,0,0,0,0,100
44c97873fbc1677650d6ed7cf21406c26cf61703,1,4,4,0,0,0,0,5,13,29,1,1,0,799,188,2,74,74,0,7412,7399,13,35,35,0,100
9e044de7a7846432d1684a7873a8a434d95f23da,1,8,0,8,0,0,0,7,48,29,1,1,0,3703,189,3,1116,1113,3,22986,22944,42,295,295,0,100
6bad8ff71558cc7207a7a6098ef14f69a3e19863,1,1,1,0,0,0,0,7,16,30,1,1,0,685,217,16,163,163,0,4897,4894,3,49,49,0,100
0e7feca04a29f354abc476d55252bab968a87f3f,3,82,49,33,0,0,0,5,34,30,1,2,1.193309735,4400,155,0,1139,1133,6,33532,33423,109,275,273,2,100
14ba7eed94c2a637b5619838d95d04d0c32ed517,1,2,1,1,0,0,0,2,9,30,1,1,0,152,156,1,45,45,0,1038,1031,7,10,10,0,100
f7770883a4e9f8f002dd2d99287903be577b2dd4,2,24,7,17,0,0,0,5,35,15,1,2,0.938315352,3612,157,2,843,836,7,28296,28170,126,193,193,0,100
0819749391cecd16bfae12b78f1b21ae424eb94a,2,3,4,1,0,0,0,2,29,16,1,2,0.863120569,1148,218,17,348,348,0,7829,7829,0,102,102,0,100
b2beaec63446c937b69de2e73d2b7acda96b1549,3,74,8,66,1,0,1,1,36,1,2,3,1.104778537,3625,158,3,848,843,5,28594,28299,295,196,193,3,99.9669749
7d7e303f849f6cbb139f11e1620a9a03d977a3be,4,114,0,114,4,0,4,1,1,0,1,3,1.998000884,0,159,4,0,0,0,134,0,134,0,0,0,99.81869128
a99763cf63446fac33964fbf7ce6244de54e1deb,5,65,50,15,0,0,0,1,2,0,1,4,2.321928095,136,160,5,3,3,0,402,402,0,3,3,0,100
43c931014a4719ccebab8e7cd6173d45ee6bcaaf,5,16,7,9,0,0,0,4,30,35,2,3,1.96396346,2090,161,6,486,486,0,13224,13204,20,245,245,0,100
d5d214c1821cb78f4bf644cf0c1fe2d5cb092f69,1,27,7,20,0,0,0,5,21,53,1,1,0,2086,17,4,705,701,4,14620,14525,95,255,255,0,100
a044af3287e0ec164de9d0b6841998369860045f,1,4,3,1,0,0,0,5,22,0,1,1,0,2100,18,5,705,705,0,14632,14620,12,255,255,0,100
bcc3b67223feefb2b379df3afb66295555f4a5c1,3,261,0,261,3,0,3,1,1,0,1,1,1.581845905,0,19,3,29,0,29,788,0,788,24,0,24,98.9454302
d7d400b818b752add7bf3e061e1b1870a682afe8,0,0,0,0,0,0,0,0,0,0,0,0,0,0,20,4,0,0,0,0,0,0,0,0,0,100
2f4cafdcfb6f0333538602b794a11e084d19cd3f,1,7,7,0,0,0,0,3,13,58,1,1,0,564,219,15,169,169,0,4527,4527,0,29,29,0,100
e422a7d179d7f153927f3685acab59c1dcefb9fd,1,7,0,7,0,0,0,3,14,0,1,1,0,564,220,16,171,169,2,4572,4527,45,29,29,0,100
2f07532f22d11c9d1c43ab51022bfdb18fe1a3db,0,0,0,0,0,0,0,0,0,0,0,0,0,0,162,7,0,0,0,0,0,0,0,0,0,100
33aa3cb59f4be199e547db25e23da212b8b0de98,0,0,0,0,0,0,0,0,0,0,0,0,0,0,7,0,0,0,0,0,0,0,0,0,0,100
80671afcbf5802e3340c65ebda7e7bdf9bec75af,6,521,10,511,5,0,5,1,5,9,2,2,2.511541413,157,163,8,91,37,54,3113,1078,2035,40,7,33,99.74533107
d9fbb9cc11df15d29964f620f2fb467e5b6d6b73,1,23,2,21,0,0,0,6,37,33,1,1,0,2522,164,9,502,501,1,20633,20600,33,97,96,1,100
23beb964c591d2c6dac0a3f3b7828fcfcfcc67b8,1,7,28,21,0,0,0,5,23,20,1,1,0,2101,21,4,701,705,4,14525,14632,107,255,255,0,100
a92785fea6938eebd85f1a6f8ed7d29fe20307cf,0,0,0,0,0,0,0,0,0,0,0,0,0,0,221,2,0,0,0,0,0,0,0,0,0,100
59bd5b0d3f891f16d7f9ca93dea13b40c082c11d,3,0,261,261,0,0,0,2,2,18,1,1,1.581845905,216,16,0,0,29,29,0,788,788,0,24,24,98.95174709
a461910160707b08dd4a9cb1cf95ba04bd27c357,0,0,0,0,0,0,0,0,0,0,0,0,0,0,222,3,0,0,0,0,0,0,0,0,0,100
9eaec94118049ad189d237519d9dc366a4a7733c,1,112,0,112,1,0,1,1,1,0,1,1,0,0,22,5,13,0,13,498,0,498,5,0,5,97.27191413
15b0b59f25f755a96a6fdebf9d94a61e208ecbde,1,63,33,30,0,0,0,3,12,80,1,1,0,614,165,4,133,125,8,3687,3600,87,46,43,3,100
add6a29be4017c1cf670034811ab5942f756ce94,1,0,1,1,0,0,0,3,13,0,1,1,0,631,166,5,133,133,0,3672,3687,15,46,46,0,100
4a15b9c39ed31f94034e8a4cad59d29a22b870cb,1,10,144,134,0,0,0,3,6,42,1,1,0,263,223,2,37,62,25,1078,1916,838,7,11,4,99.98631262
f98ecf4d22e974ac3f5c0baf7134dc0a4a24e57c,1,0,78,78,0,0,0,2,2,42,1,1,0,61,224,3,0,3,3,0,283,283,0,3,3,99.95890411
81e89bcd80c73dad3e457906b6efcf58c1823e32,1,1,1,0,0,0,0,2,6,105,1,1,0,32,225,4,0,0,0,101,101,0,0,0,0,100
e041fe0d4de6baebefcbc34a3ff1962212535b5b,2,44,1,43,1,0,1,1,9,55,1,2,0.566509507,199,226,5,77,72,5,1388,1202,186,36,31,5,99.9725802
04397f562eeffeeb521527f12bfe9ab8bb83a93e,1,9,3,6,0,0,0,3,15,51,1,1,0,570,227,6,174,171,3,4645,4572,73,29,29,0,100
bc0c353ef0533d23863758c4bb5fce9008f2170f,1,0,1,1,0,0,0,3,16,0,1,1,0,577,228,7,174,174,0,4632,4645,13,29,29,0,100
fcad0cdca75753f2a84a4e9719822c9901dd0f19,0,0,0,0,0,0,0,0,0,0,0,0,0,0,0,0,0,0,0,0,0,0,0,0,0,100
75e59a4e65374caaa1318ad0f8e06b77826ffea4,1,0,1,1,0,0,0,2,3,114,1,1,0,693,229,8,91,91,0,5212,5212,0,79,79,0,100
0e19b714ac65fd9ad833ccaf39d43d72a63ee768,0,0,0,0,0,0,0,0,0,0,0,0,0,0,230,9,0,0,0,0,0,0,0,0,0,100
e5cc6d8f802b13cedf4587d1bb2d7b2046d16026,0,0,0,0,0,0,0,0,0,0,0,0,0,0,231,10,0,0,0,0,0,0,0,0,0,100
87d118290c5eb7eaf87415cd38254e5a1b4e728d,0,0,0,0,0,0,0,0,0,0,0,0,0,0,8,0,0,0,0,0,0,0,0,0,0,100
3599a48964ae3894a34220efe3ed936a5656728f,0,0,0,0,0,0,0,0,0,0,0,0,0,0,232,9,0,0,0,0,0,0,0,0,0,100
4870d3ffc9c2dca7afcbd167d00e60874eedb516,0,0,0,0,0,0,0,0,0,0,0,0,0,0,233,10,0,0,0,0,0,0,0,0,0,100
c634dcb4d81b286fe77bc1cffdd92c811116948c,1,1,1,0,0,0,0,5,11,140,1,1,0,1077,33,0,281,281,0,8570,8570,0,53,53,0,100
e8fb1e420becd7b5c18b64f3b2247181283b540c,0,0,0,0,0,0,0,0,0,0,0,0,0,0,34,1,0,0,0,0,0,0,0,0,0,100
1ef670d2f68df88890e7131813e8c68912e04cdc,1,1,1,0,0,0,0,3,3,143,1,1,0,100,35,2,24,24,0,526,526,0,12,12,0,100
4d23f445c608f4ebd5e688d22362150d4f758618,0,0,0,0,0,0,0,0,0,0,0,0,0,0,9,1,0,0,0,0,0,0,0,0,0,100
5463700d6c7e120241dde074d2d8aa25c01b3fda,10,1480,1,1479,9,0,9,1,13,15,2,4,2.884096492,672,167,0,326,133,193,10492,4100,6392,152,84,68,91.96202532
0a5619ef1c642e527dc2b31d3e1c1ebefa13e713,0,0,0,0,0,0,0,0,0,0,0,0,0,0,168,1,0,0,0,0,0,0,0,0,0,100
aea920d171c315bdc8944cce7fb2ba069b82c0f1,2,6,2,4,0,0,0,4,5,162,1,1,1,163,169,2,34,34,0,934,934,0,8,8,0,100
aa3353d34d49a3c2e5ee5c329d501d6d003f9e8e,3,89,2,87,1,0,1,2,3,88,1,1,0.304101408,130,170,3,17,14,3,853,511,342,16,14,2,99.94394619
273045b321a61bc2b0cbb25bc9269323341e21bb,0,0,0,0,0,0,0,0,0,0,0,0,0,0,10,1,0,0,0,0,0,0,0,0,0,100
2e8b28c4c227bcb1ed31db7119cc1a2d74f31050,1,9,5,4,0,0,0,7,17,146,1,1,0,685,36,0,165,163,2,4929,4897,32,50,49,1,100
43eb43898a43f2419cd86564a50c2e661f65e5b2,1,1,1,0,0,0,0,4,13,177,1,1,0,283,234,0,78,78,0,1667,1668,1,30,30,0,100
d72a5ad309c7641a3f8a84931004c93c5a9d070d,1,9,3,6,0,0,0,6,29,160,1,1,0,348,235,1,75,73,2,2363,2314,49,19,19,0,100
0091bcabe301f0264765729b418d30a10523d53c,0,0,0,0,0,0,0,0,0,0,0,0,0,0,236,2,0,0,0,0,0,0,0,0,0,100
5cda1770a06ce547c83e4544d5647df93a83ce1b,0,0,0,0,0,0,0,0,0,0,0,0,0,0,237,3,0,0,0,0,0,0,0,0,0,100
b7aac8426207e30e320a9a7dd6b17a90e3f0f649,0,0,0,0,0,0,0,0,0,0,0,0,0,0,238,4,0,0,0,0,0,0,0,0,0,100
90d053f4ef217ae2c3644f9d6258a6d5510260d0,1,1,1,0,0,0,0,5,30,150,1,1,0,1507,37,1,494,494,0,10233,10233,0,135,135,0,100
ee3c0b1dc4867f257c6a9283f31b644052510c6a,1,97,0,97,1,0,1,1,1,0,1,1,0,0,23,0,8,0,8,468,0,468,3,0,3,99.96270048
d384dcb8fd3dffd1c04e91ef96a147d8bac5a4de,1,7,0,7,0,0,0,4,6,186,1,1,0,475,24,1,197,195,2,2818,2799,19,49,48,1,100
f026af58cd50053116d8aad238f2e041ba76d8a5,5,28,4,24,0,0,0,5,34,134,1,1,1.755311305,5987,25,2,1839,1832,7,42920,42755,165,488,488,0,100
1a130afb05ed4fd791884f403e516822fb2dc9ad,1,11,0,11,0,0,0,6,12,45,1,1,0,1077,26,3,284,281,3,8666,8570,96,53,53,0,100
3aac689d569860c61a18b6c5f6afa8f9150e112d,0,0,0,0,0,0,0,0,0,0,0,0,0,0,27,4,0,0,0,0,0,0,0,0,0,100
04b873a44995ee31e1dd74005055cd7a6cb47baa,0,0,0,0,0,0,0,0,0,0,0,0,0,0,28,5,0,0,0,0,0,0,0,0,0,100
a4e1584fe3a6f4aeab8077b9fd29db67affe02ff,0,0,0,0,0,0,0,0,0,0,0,0,0,0,29,6,0,0,0,0,0,0,0,0,0,100
e0e176ab83beed65cd9e21c9cfed8628f80553ca,1,2,2,0,0,0,0,6,13,0,1,1,0,1086,30,7,284,284,0,8666,8666,0,53,53,0,100
9f0a7ff545b581cb39a11e27787ff5e792793daa,1,49,0,49,1,0,1,1,1,0,1,1,0,0,171,4,2,0,2,164,0,164,2,0,2,99.90669901
79827a90f673b12d008d87c689898a53a35b0826,1,1,1,0,0,0,0,2,3,194,1,1,0,37,239,5,2,2,0,111,108,3,1,1,0,100
8bf89a655ad5413adc21e3c1434ddd196658c382,1,97,0,97,1,0,1,1,1,0,1,1,0,0,31,8,8,0,8,472,0,472,3,0,3,92.90245157
e59f995429d8c1ce5984b1d57465a3941433144a,1,0,97,97,0,0,0,1,2,11,1,1,0,80,32,9,0,8,8,0,468,468,0,3,3,99.96830428
1921d6cc598bc697587a6fd8365b19caca098249,1,0,0,0,0,0,0,1,1,0,1,1,0,80,33,10,8,8,0,472,472,0,3,3,0,92.86571772
a39a2dace9d2b76f2e7ac7c70d6f1c5643ee80ee,1,5,1,4,0,0,0,6,38,133,1,1,0,2526,38,2,503,502,1,20656,20633,23,97,97,0,100
cc8ac0bc6424ecb46d4ee7893ab0c2df0bbce91a,1,10,3,7,0,0,0,3,5,16,1,1,0,102,240,6,29,28,1,675,637,38,3,3,0,100
bd51cad23f96e2febfdcde4abc83350b11aeba4d,1,11,3,8,0,0,0,6,14,16,1,1,0,1086,241,7,286,284,2,8681,8666,15,53,53,0,100
578c987ac494c90f837f3915c1b945aedaec8d78,1,0,1,1,0,0,0,2,2,7,1,1,0,80,172,1,8,8,0,457,472,15,3,3,0,100
be91d228c537529c5bb7a9681a083b2e422ce0e5,1,28,7,21,0,0,0,5,25,20,1,1,0,2090,173,2,707,703,4,14669,14562,107,255,255,0,100
cbb7bded12af4b523c0c4823a2db42cda1a2463a,1,1,1,0,0,0,0,5,26,4,1,1,0,2105,242,8,707,707,0,14672,14669,3,255,255,0,100
39f1071085c02dfb4a4d94f1f508c2e82dc44cf7,9,216,152,64,4,0,4,1,31,111,3,6,2.480303012,2034,174,3,348,366,18,12251,12197,54,247,246,1,99.70160388
0dde3fdbfaea302b83efcec42483fa8925e24d93,1,2,0,2,0,0,0,4,17,0,1,1,0,275,175,4,0,0,0,1844,1844,0,0,0,0,100
843c86153aaa9b7999d1cc77221c85b851682a1d,0,0,0,0,0,0,0,0,0,0,0,0,0,0,34,11,0,0,0,0,0,0,0,0,0,100
e65f53b43de6707db3515c17daa40a9103a558aa,2,213,0,213,1,0,1,1,10,109,1,1,0.574067138,169,36,0,52,29,23,1355,775,580,28,9,19,99.92555369
c1c32b4d8cb3bfc8200833c41e42141c4d045c22,1,4,4,0,0,0,0,4,7,219,1,1,0,97,17,0,17,17,0,614,613,1,5,5,0,100
49445edc837dd9793f9a97679e6a7181888d0f91,1,92,0,92,1,0,1,1,1,0,1,1,0,0,176,5,9,0,9,488,0,488,7,0,7,99.96281145
058c174bef04520e4801447716b5c9203567a56f,1,5,0,5,0,0,0,3,4,221,1,1,0,183,18,1,32,32,0,1006,998,8,12,12,0,100
f34e22efe4dfef99f3c9abe6fccdbcb3f37adb2b,1,5,0,5,0,0,0,4,4,83,1,1,0,100,177,6,25,24,1,544,526,18,13,12,1,100
5a23d0455d010e292433ab4b1a0ec4214dfb171c,1,4,0,4,0,0,0,3,10,226,1,1,0,210,178,7,40,39,1,1467,1431,36,11,11,0,100
ffdbc5ae9c3768807406413eda8a36cbc93db50d,4,80,11,69,0,0,0,2,18,118,1,2,1.44517108,653,179,8,146,135,11,3926,3673,253,60,56,4,100
1b9d1e2d1258b3147929e5b27bedc23714a32964,6,149,31,118,1,0,1,3,20,148,3,4,2.069854738,1292,180,9,343,342,1,8341,8010,331,109,97,12,99.90709773
7db9a7fae5397c99d72efb63b018436a0294a151,4,17,13,4,0,0,0,5,27,72,1,2,1.425605199,3304,35,5,1018,1017,1,23405,23393,12,315,314,1,100
5c4a8c7e73e3997f69969f0ae0315dee57bc0a26,4,74,16,58,0,0,0,3,18,228,2,3,1.908078268,868,181,10,216,214,2,5811,5607,204,52,51,1,99.98142645
9975362f1f43b4f1c7bea9d3fb02c27c03f098de,4,161,75,86,0,0,0,6,35,87,1,3,0.398973492,3663,36,5,1155,1135,20,26404,26112,292,253,250,3,100
0b356dfc0dc4e7e1a80e17801ded076e8173b5a7,0,0,0,0,0,0,0,0,0,0,0,0,0,0,37,6,0,0,0,0,0,0,0,0,0,100
85b2e766cae4a55e9e32442cc889a56b8fee0d65,11,2826,24,2802,3,0,3,4,17,158,5,7,1.921644978,3096,243,4,1512,858,654,36121,21984,14137,451,277,174,99.40387481
1bded00298c66f51c8814b6391c32e3721495ed2,1,48,0,48,1,0,1,1,1,0,1,1,0,0,182,10,2,0,2,150,0,150,2,0,2,100
21909df2ecea737a475d2d18ec33712570dc832a,4,20,3,17,0,0,0,3,9,179,2,3,1.241524204,409,183,11,100,98,2,2105,2064,41,61,60,1,100
0c517d163e355f85ca40673db15a991693bc2d4a,87,1617,350,1267,1,0,1,4,49,154,7,25,4.83249478,36987,19,2,10142,10055,87,257464,251471,5993,3047,3018,29,89.66314399
8b5a7f68a0016e7d5b5ac9a1c913794dccdcecd7,98,587,584,3,0,0,0,4,50,36,9,29,4.66281503,43069,244,4,11568,11568,0,294965,294965,0,3371,3371,0,100
e286a915d570b48956e93105bb84321a89659aad,2,41,3,38,1,0,1,1,14,122,2,2,0.510787823,489,184,12,113,111,2,3739,3622,117,53,51,2,99.97042295
d99571342fcb93179e63b217749bfac60ef85fe9,1,1,1,0,0,0,0,4,10,248,1,1,0,93,185,11,0,0,0,593,593,0,0,0,0,100
774e7b5b8c3a07ef01fdeb5d38f1c4bb59dda9b0,12,204,8,196,1,0,1,1,37,200,2,5,2.618364339,4656,186,12,1326,1308,18,34008,33069,939,433,422,11,96.02289404
0826b7a717cf3023b16a15da0d8da3e35522222d,1,2,1,1,0,0,0,6,14,89,1,1,0,674,20,3,133,133,0,4104,4104,0,84,84,0,100
2f5d52b7e703327cc6047b641d66e79f860c2bf0,1,1,1,0,0,0,0,7,41,9,1,1,0,2572,187,13,505,505,0,20928,20924,4,97,97,0,100
124f615eb51b063bbf2856cd487d168b1da5f839,1,1,1,0,0,0,0,7,42,0,1,1,0,2572,188,14,505,505,0,20928,20928,0,97,97,0,100
50332f053a10efb0f223cc893a6d80a9f36a26da,0,0,0,0,0,0,0,0,0,0,0,0,0,0,11,0,0,0,0,0,0,0,0,0,0,100
dfba4dff7d9ee94a8464b5e4b8be9b2c5839bdd4,2,19,4,15,0,0,0,5,38,134,1,1,0.987692509,3340,38,3,1014,1012,2,24306,24228,78,275,274,1,100
b0513545077e6040f601ca7424e00bdd7879f2b2,0,0,0,0,0,0,0,0,0,0,0,0,0,0,12,1,0,0,0,0,0,0,0,0,0,100
6b6a4b57e4e40f39abc9d1793840b81e095323e8,1,4,4,0,0,0,0,6,33,23,1,1,0,400,39,4,95,93,2,2604,2588,16,20,20,0,100
3408ef1e0c40231ad877c8e45b71ca7ae6f071f6,1,55,0,55,1,0,1,1,1,0,1,1,0,0,189,12,2,0,2,242,0,242,2,0,2,96.35248547
4b6b578f2b4ea6b140f0e27007830a872ef10f89,1,1,1,0,0,0,0,3,3,266,1,1,0,98,190,13,9,9,0,631,629,2,7,7,0,100
96a7367ec5d9e68412eb6c7ddc9f9816c70217aa,0,0,0,0,0,0,0,0,0,0,0,0,0,0,13,2,0,0,0,0,0,0,0,0,0,100
7d6c0afa45acb46d8120e1663e4c65b4900dd220,1,3,7,4,0,0,0,5,10,34,1,1,0,229,191,9,37,37,0,1227,1261,34,23,23,0,100
62ae83f3b5a0eca67b5a5c4ae6cd01c4f6b3ac23,0,0,0,0,0,0,0,0,0,0,0,0,0,0,37,0,0,0,0,0,0,0,0,0,0,100
b8bb8404a9c1da1dd22ac8b414f7496ee033acbd,10,649,85,564,1,0,1,3,8,131,3,5,2.574417132,1262,14,3,376,303,73,10392,7770,2622,148,114,34,99.94569153
25fbdab82bfa714ed3fded62d7322b0603fb6656,0,0,0,0,0,0,0,0,0,0,0,0,0,0,192,8,0,0,0,0,0,0,0,0,0,100
a275b7aefb43a9de0e183cbaff5de9b0489e59e2,22,1080,6,1074,4,0,4,1,39,144,3,6,3.652322392,8127,40,2,2445,2295,150,61535,57152,4383,690,606,84,97.53794891
b761732fdf60ee4207aaca6002e63f9dbf1bea84,10,1229,0,1229,10,0,10,1,1,0,1,3,3.167319006,0,41,3,102,0,102,4124,0,4124,81,0,81,99.51008103
462cf31ed5e389054d0c57e9eb7f79f43023c000,1,75,72,3,0,0,0,1,2,0,1,1,0,226,42,4,22,22,0,1628,1628,0,9,9,0,100
0260d8de471d132c570e33e747f01488272dd260,1,1,1,0,0,0,0,5,24,47,1,1,0,414,39,0,96,96,0,2607,2606,1,29,29,0,100
1c9f0ae0ae9c4861d9f0181b3f0174dffb7eb87a,4,257,2,255,3,0,3,1,43,9,2,2,1.640075504,2572,21,1,537,505,32,21862,20928,934,112,97,15,99.86884017
f12af8d977ce4f637af7616895bc151b76e41ea6,2,61,0,61,1,0,1,5,16,23,1,1,0.46377735,261,40,1,72,62,10,1972,1832,140,27,21,6,99.96258885
99950ad3ff9d4d9adbf104dab04f3a3e036e384f,1,1,1,0,0,0,0,5,9,62,1,1,0,97,22,1,17,17,0,614,614,0,5,5,0,100
a5d1acd44ec6f9a2a47d7fcda05bd51ae9ab9a82,3,121,2,119,2,0,2,1,10,96,2,2,1.5060317,422,23,2,100,92,8,3219,2910,309,39,31,8,99.90659443
168c0076c819a99e91bd8782834987a5903cdfc5,7,160,35,125,0,0,0,4,51,220,1,2,1.991648956,5341,43,5,1599,1571,28,34112,33342,770,431,427,4,100
9ce0bed09d42b3cefa40a8091607e65e7ddf7aeb,3,146,0,146,3,0,3,1,1,0,1,1,1.441320951,0,193,5,8,0,8,410,0,410,7,0,7,99.79500559
e2556dd6b2567ac13f838ebf796d40c228eb6dd5,2,97,0,97,2,0,2,1,1,0,1,1,0.96592124,0,194,6,5,0,5,361,0,361,4,0,4,99.81412639
a5ed9f701dcb37ffd020e5333bcd0c28b26d650d,14,1771,1771,0,0,0,0,1,3,0,3,5,3.663063259,1080,44,6,163,163,0,5975,5975,0,124,124,0,100
19dc613dd0ad379cb2806fc7dcf16992c43da66c,1,1,1,0,0,0,0,1,2,8,1,1,0,36,24,3,2,2,0,130,128,2,2,2,0,100
126ed03a3b7bc4c66fa50c867a760c9fd6d37380,1,20,8,12,0,0,0,5,8,59,1,1,0,541,45,7,55,52,3,3697,3597,100,7,6,1,100
9316b8157d3d5c3f91bf9612c944dc462198cb5b,2,14,8,6,0,0,0,1,3,5,2,1,0.684038436,259,46,7,52,51,1,1418,1391,27,36,36,0,99.92573338
c70b70b30f95f27bd7352b0eb92b79b39444662a,14,49,49,0,0,0,0,1,34,10,3,4,3.598977192,3321,47,8,863,863,0,21759,21759,0,320,320,0,99.92573338
e634400c112155152e0229334cb5094ddbb5bdc2,2,0,0,0,0,0,0,1,1,0,1,1,0,124,48,9,21,0,21,470,314,156,17,0,17,99.85146677
502d6488de4dcf3035a47f05a52e9ee34681482b,2,0,0,0,0,0,0,1,6,0,1,1,0,124,49,10,21,0,21,470,314,156,17,0,17,99.85146677
092729c11c78b2f04206db04a8f2ababd40eadea,2,102,0,102,2,0,2,1,1,0,1,1,0.999722648,0,195,6,6,0,6,300,0,300,6,0,6,96.00778968
b50530274b695420b35c1119df83b6720b78321d,1,87,0,87,1,0,1,1,1,0,1,1,0,0,196,7,4,0,4,361,0,361,4,0,4,99.95678479
dbf7ab273e954f11b4b89052483ad7d652604320,1,59,0,59,1,0,1,1,1,0,1,1,0,0,197,8,2,0,2,236,0,236,2,0,2,99.95683453
3ddd88b576b4531b96a96e963d6c5f6fb69fa51c,1,0,2,2,0,0,0,1,2,0,1,1,0,73,198,9,4,4,0,339,361,22,4,4,0,100
7a6a81d713316ade9771ac825db7ccaaa16d1283,2,12,1,11,0,0,0,3,11,184,1,2,0.89049164,152,199,10,18,16,2,842,789,53,10,9,1,100
6b45d6ed968f0e4d8aa1d71ae587ee8720cfc110,0,0,0,0,0,0,0,0,0,0,0,0,0,0,200,10,0,0,0,0,0,0,0,0,0,100
747226b1d6dc6d57fd28332b4c2a4b0c4ad7a59c,58,4094,424,3670,23,0,23,4,52,105,6,12,4.611770756,23321,201,10,7016,6501,515,173618,157555,16063,2286,2077,209,89.87447699
8c1710ed6376296daf967b32a7f48332ec1f3654,6,150,31,119,0,0,0,5,14,11,3,3,2.099504261,898,202,11,183,164,19,6425,5704,721,71,65,6,99.91991992
8586e0fef3bf69757db2a9c27aaff91270ed1785,0,0,0,0,0,0,0,0,0,0,0,0,0,0,50,10,0,0,0,0,0,0,0,0,0,100
58533057a0aa95e53342c4a3ed9c50dfed859a44,0,0,0,0,0,0,0,0,0,0,0,0,0,0,203,12,0,0,0,0,0,0,0,0,0,100
9f6b7039976805d2b95793992e9c2ef84025b80a,1,7,7,0,0,0,0,2,2,2,1,1,0,292,245,0,74,74,0,1900,1907,7,33,33,0,100
b83db9322909051f0253d0fc5ec754f7afe0cbce,0,0,0,0,0,0,0,0,0,0,0,0,0,0,246,1,0,0,0,0,0,0,0,0,0,100
0243702b35421949b0353d3b08de04cfcdec7fea,4,147,33,114,0,0,0,1,53,3,2,2,1.315270847,6523,204,13,1953,1936,17,42483,41874,609,559,548,11,100
61c0800712155ce4f0422dfc2edf0c74dbf517c7,0,0,0,0,0,0,0,0,0,0,0,0,0,0,205,14,0,0,0,0,0,0,0,0,0,100
ffec0204a14cd23d0e271c746353102dee681e1b,0,0,0,0,0,0,0,0,0,0,0,0,0,0,206,14,0,0,0,0,0,0,0,0,0,100
2bc4c4a5526bcf90de8a552f4feaf389a603af9f,1,14,8,6,0,0,0,4,32,109,1,1,0,1148,207,15,231,231,0,6678,6678,0,195,195,0,100
872d00888d786f97f027946f59cd9c1962487fec,4,38,35,3,0,0,0,3,3,71,1,2,1.590319542,596,38,0,133,133,0,4073,4014,59,56,56,0,100
7ca46cf69d63c6e21f9495ece70e7dd6b210c7e2,12,500,324,176,2,0,2,6,36,91,4,4,2.594739828,2311,51,11,605,581,24,15180,14678,502,247,229,18,89.30437622
a1d28857fa6cff6a6374b5f10d747b8538af9cdf,3,181,1,180,2,0,2,1,15,40,1,3,1.05940096,1091,25,4,304,286,18,9230,8681,549,71,53,18,99.93111999
6128ddbc2d8477628e08c53363657f71b6fcca1a,1,25,33,8,0,0,0,5,9,23,1,1,0,552,52,12,53,55,2,3652,3697,45,6,7,1,100
f61968f30255063c02971f041a0111e5dcf84220,2,19,2,17,0,0,0,5,22,171,1,2,0.702466551,344,39,1,86,83,3,2389,2326,63,31,30,1,100
97b94f6aa90375ea6f39533144e4bf9477813a01,1,18,1,17,0,0,0,3,5,327,1,1,0,50,247,2,7,6,1,283,251,32,2,2,0,100
17ecf6753a58c57389d13c87de235c1ee5aa5a3c,1,10,0,10,0,0,0,2,2,6,1,1,0,52,248,3,3,2,1,210,193,17,2,2,0,100
a8fc8dfa769b21bbe4534b4a4e62746f7d1f9ba1,1,33,35,2,0,0,0,2,3,0,1,1,0,57,26,4,2,3,1,394,210,184,2,2,0,99.68358784
60d4f7cd70dd150c0ec96f84ed371d9e1c691547,0,0,0,0,0,0,0,0,0,0,0,0,0,0,15,0,0,0,0,0,0,0,0,0,0,100
4150e7f566680cf07ab70a58faa6b12f26b6574a,11,97,18,79,1,0,1,3,22,205,1,2,2.72544839,1470,27,3,275,269,6,7765,7562,203,133,129,4,99.95876855
3c17af735143df69f6bfbc49c028f5b152405c31,1,9,3,6,0,0,0,5,17,44,1,1,0,267,41,0,68,66,2,1886,1868,18,21,21,0,100
a361f6a148d5d352f21e72c282052ac2e266805c,1,2,2,0,0,0,0,3,12,24,1,1,0,156,249,4,46,46,0,1057,1064,7,10,10,0,100
17fcd0021173ca14645cc82027102c354f825193,0,0,0,0,0,0,0,0,0,0,0,0,0,0,208,13,0,0,0,0,0,0,0,0,0,100
890d16047e3b1feabfd12134168589feb8bc13d2,2,102,2,100,1,0,1,1,4,169,1,1,0.826165428,51,40,2,7,3,4,541,195,346,7,3,4,99.9725501
c34fb4e80ef3597fc11c72640cc80d222d1fe282,5,347,3,344,1,0,1,1,22,110,3,3,1.530932189,2953,41,3,1015,953,62,20788,19396,1392,405,357,48,99.04681805
9382677eb148b417ae0328330e858cb6396c1a4c,9,354,19,335,6,0,6,3,41,50,2,4,2.93454996,2743,42,4,873,850,23,19508,18646,862,268,249,19,98.43885516
156a7ffdd0b76fd00d8f31f763717d73a2e7fb6a,1,106,62,44,0,0,0,2,2,16,1,1,0,168,250,5,29,26,3,1406,1157,249,11,11,0,100
a5010b4a788bfddea3bb5de7cf791fe39e549828,1,2,1,1,0,0,0,6,23,2,1,1,0,1330,251,6,445,445,0,8302,8301,1,149,149,0,100
e466dee5f960aa7f989f87d6e9b6387708efe5e1,1,1,1,0,0,0,0,2,3,1,1,1,0,210,252,7,30,29,1,1410,1406,4,11,11,0,100
dd1ea2703283aa3ba4795f00b19a994e7ef9db11,1,2,1,1,0,0,0,2,4,0,1,1,0,210,253,8,31,30,1,1414,1410,4,11,11,0,100
d5ef5d1f3db5251683f1888da5353fb765584fe2,1,10,0,10,0,0,0,3,5,342,1,1,0,273,209,14,50,48,2,1611,1561,50,22,21,1,100
0b1b37dbbaa60d6fc732fc1a580388786009449f,3,9,7,2,0,0,0,6,24,228,2,3,1.579434003,1904,210,15,588,587,1,12095,12086,9,211,210,1,100
79c7b280d3cf397fb5527420a12565fd2c2b99b6,1,2,1,1,0,0,0,2,5,1,1,1,0,211,53,7,32,31,1,1420,1414,6,11,11,0,100
09e13c4ad887fbcec2532d175e6f761f1fe5b72e,1,1,1,0,0,0,0,4,20,35,1,1,0,318,211,16,83,83,0,2026,2025,1,24,24,0,100
fa39addf827a6ef14492389574e89055906efd49,1,9,0,9,0,0,0,2,5,21,1,1,0,226,212,17,23,22,1,1669,1624,45,9,9,0,100
d260d34d69be456f78f195fc2fb075dcfa2aa4fb,1,8,4,4,0,0,0,2,6,0,1,1,0,232,213,18,23,23,0,1677,1669,8,9,9,0,100
86e47000db1e081076ed16ef2873bb71e6e93c70,4,40,22,18,0,0,0,7,28,207,2,2,1.876932412,2613,214,19,782,783,1,17203,17173,30,170,167,3,94.90600364
63c3748900811032ec5dc4e5e42d9745cfc53c4f,2,88,1,87,1,0,1,5,21,172,2,2,0.436094664,452,215,20,120,110,10,3323,2906,417,58,50,8,98.17581381
b7fe66357b6c964613866b773da5c2739c513e09,1,17,2,15,0,0,0,4,19,345,1,1,0,113,216,21,12,10,2,763,683,80,5,5,0,100
4c9a7258697bc5e2bc62f12a58979ace59f8b1f1,0,0,0,0,0,0,0,0,0,0,0,0,0,0,16,1,0,0,0,0,0,0,0,0,0,100
60f59740f509071e75a705168fcf1b49540ecaeb,1,4,3,1,0,0,0,7,45,39,1,1,0,2960,217,16,612,612,0,23974,23974,0,120,120,0,100
5c9642d5f47c319d2279382c60141ebcb65cd3b0,29,582,93,489,0,0,0,5,46,87,5,10,2.861478436,13765,43,5,3363,3331,32,103397,101696,1701,946,926,20,100
8ba0483bf7273d3e26d88a4ac39762861afc0869,0,0,0,0,0,0,0,0,0,0,0,0,0,0,54,4,0,0,0,0,0,0,0,0,0,100
99ecf9564bc9f260bde9f702b2a79b121414345a,1,21,6,15,0,0,0,3,3,2,1,1,0,59,28,3,9,8,1,310,300,10,3,2,1,100
26b0e498455ffc4062ff4d06feec1d18ea560572,1,28,2,26,0,0,0,5,9,56,1,1,0,592,55,2,178,175,3,4264,4153,111,80,80,0,100
4e81825171676204c7e3ccaeaddbf679f0c5a590,1,2,28,26,0,0,0,6,10,0,1,1,0,606,44,5,175,178,3,4153,4264,111,80,80,0,100
ecc36a0f37420761683ddb164f8686ef04731dd9,1,18,0,18,0,0,0,1,2,255,1,1,0,28,254,7,5,5,0,156,156,0,5,5,0,100
e59b9deab9ebe7d077867122e35060a641e24476,0,0,0,0,0,0,0,0,0,0,0,0,0,0,218,10,0,0,0,0,0,0,0,0,0,100
c014c925382f115e067fb9265d9c49f96aaf17f9,2,37,2,35,0,0,0,5,11,183,2,2,0.73206669,682,56,3,201,197,4,4750,4613,137,91,90,1,100
4463c743f014fa7a707f55bf18e73098cc66dd4d,0,0,0,0,0,0,0,0,0,0,0,0,0,0,255,8,0,0,0,0,0,0,0,0,0,100
7ae341d308956ec3bfe6a73cdb9a864a4923d0fe,1,2,1,1,0,0,0,2,6,25,1,1,0,212,57,4,33,32,1,1429,1420,9,11,11,0,100
485527ae0872028121f29eb5b7fd27f75efb5b4a,1,1,14,13,0,0,0,2,4,17,1,1,0,160,219,11,29,30,1,1014,1132,118,6,6,0,100
88f293dec94ee995603f7c4b895cc26bffb0ac67,1,17,23,6,0,0,0,6,29,129,1,1,0,2108,45,5,707,708,1,14655,14684,29,257,256,1,100
8d1dacad825e9ec3115596170b0cc13b2d2278b3,4,178,4,174,1,0,1,1,38,108,3,3,1.335970532,1878,42,1,431,414,17,12532,11688,844,267,256,11,99.9687011
6cd259f310fb0feab604805ffd0578e85513b64c,15,564,36,528,10,0,10,1,16,67,2,3,3.748017875,2647,29,2,748,720,28,20025,18350,1675,253,230,23,96.57555283
71f44f884e20bc6b08e339115bf14dc09a1ee8e5,1,2,1,1,0,0,0,6,35,86,1,1,0,478,46,6,109,109,0,3226,3218,8,26,26,0,100
f9fcb11a351987564238341644efb1c96073b504,1,1,1,0,0,0,0,4,8,3,1,1,0,114,256,7,29,29,0,780,781,1,8,8,0,100
784de8a57c599f43f5f26764b1dcd43e7f8a5be1,1,4,1,3,0,0,0,5,16,375,1,1,0,640,16,0,243,243,0,4826,4809,17,35,35,0,100
9bebf551fc6be90240c858a05119cc71776d6c53,0,0,0,0,0,0,0,0,0,0,0,0,0,0,257,7,0,0,0,0,0,0,0,0,0,100
6316c57e975766d06575ad8a0a9b4dab9561bc1e,0,0,0,0,0,0,0,0,0,0,0,0,0,0,47,4,0,0,0,0,0,0,0,0,0,100
62f09afea9eaef64c213d888c50e457445d5635b,0,0,0,0,0,0,0,0,0,0,0,0,0,0,220,11,0,0,0,0,0,0,0,0,0,100
778ab2a393ad53356f5b24f059f45f56e48e4dd4,130,2193,1070,1123,16,0,16,1,54,186,3,19,5.249646776,15109,221,12,3120,3049,71,88651,84606,4045,1308,1268,40,96.55924023
007154980bea0a83d541872cddfb060f603ceb0f,2,2,2,0,0,0,0,4,11,0,1,2,1,106,222,11,4,4,0,488,486,2,3,3,0,100
4e8936a70606269f985ee7aefa3d98816a0fbc9c,1,0,2,2,0,0,0,3,12,0,1,1,0,152,223,12,0,0,0,1108,1108,0,0,0,0,100
032bf10ce6cddfe45122c01a88cb341e17ab3b97,1,8,8,0,0,0,0,1,2,0,1,1,0,37,224,13,0,0,0,149,149,0,0,0,0,100
6de7e5f5812d642864fc91da4851569160fdec67,1,0,1,1,0,0,0,4,12,0,1,1,0,67,225,14,0,0,0,375,388,13,0,0,0,100
0a40e8c9a40d16300a94f7c46de76129327ee810,0,0,0,0,0,0,0,0,0,0,0,0,0,0,226,15,0,0,0,0,0,0,0,0,0,100
8dd6857f67991d646727bfd3597d8b5b9b03d69f,11,377,12,365,6,0,6,1,47,19,2,3,2.878275741,3964,227,16,881,831,50,32292,31150,1142,238,205,33,99.66319166
dda1e8ef6f2ac6aacf75934425aa00fae9355838,20,137,41,96,1,0,1,7,37,64,6,9,3.440793195,12269,228,17,3276,3268,8,82944,82579,365,1171,1167,4,99.38936204
ede9dcbd61b0705da92e82dddb00d0d14e504639,2,25,18,7,0,0,0,1,6,0,2,2,0.518569732,193,229,18,35,32,3,1213,1171,42,7,7,0,99.87029831
e26e15496eda708f4e519328c834a4d08eccb25f,5,177,20,157,2,0,2,1,13,0,1,2,2.123485546,369,230,19,61,47,14,2520,2029,491,55,47,8,99.16789036
8c28c6bcbd2a4df40197db2a3e49fad68771c450,1,13,5,8,0,0,0,4,21,0,1,1,0,125,231,20,13,12,1,803,756,47,5,5,0,100
b0c5cfe69a76e3db981a0940350e37292fc59c1b,1,8,2,6,0,0,0,5,15,73,1,1,0,261,232,21,77,73,4,1805,1763,42,14,13,1,100
89ec5482cbb790df7c2057da3bdd878397890c92,1,1,1,0,0,0,0,5,16,0,1,1,0,266,233,22,77,77,0,1806,1805,1,14,14,0,100
ebcec6e55b3c475146e7a113e773f296fffd602f,16,166,166,0,0,0,0,1,22,0,2,4,3.056005451,3128,234,23,617,614,3,20429,20296,133,301,301,0,99.67277487
fb1c554c4bd6ab1d0b3fe62699b194cd0df03ec9,1,4,3,1,0,0,0,5,24,0,1,1,0,202,235,24,57,57,0,1407,1405,2,13,13,0,100
3d22005bad92bb23973d8620a1b1e2649c772e46,1,1,0,1,0,0,0,4,35,0,1,1,0,1170,236,25,235,235,0,6777,6770,7,199,199,0,100
7977291bea0d92b3356319a8dba1a1e9a273e751,1,9,10,1,0,0,0,8,48,0,1,1,0,2974,237,26,613,612,1,24098,24041,57,119,120,1,100
eaeebf20c7e89466748e4c872a6c15a732351382,11,134,9,125,0,0,0,4,40,282,1,2,1.923174211,4201,48,5,1166,1149,17,29840,29267,573,325,318,7,100
52d7ab797565c7b182a87128eb0a484a7e9237a7,1,4,2,2,0,0,0,6,37,0,1,1,0,533,238,27,121,121,0,3613,3602,11,30,30,0,100
56f6b437909815b1974c391d6496a1c4c5f87382,20,51,38,13,0,0,0,5,22,87,2,3,3.337528656,3622,239,28,731,731,0,23268,23294,26,232,232,0,99.14128321
b0cddf4e2d87d5a4f3c19d24cec89c4df4b9660d,1,13,0,13,0,0,0,3,6,58,1,1,0,56,240,29,8,7,1,323,283,40,2,2,0,100
071a9abbbbf852ddd8fbba083d2b139e4b340dc4,1,3,0,3,0,0,0,5,12,16,1,1,0,737,30,2,179,179,0,4540,4531,9,44,44,0,100
ee05926f192d6bf9ac7bedf95cef008baafdf528,0,0,0,0,0,0,0,0,0,0,0,0,0,0,31,3,0,0,0,0,0,0,0,0,0,100
f40b551d1a91db6caa242b0f6e53d178b1b10f2a,0,0,0,0,0,0,0,0,0,0,0,0,0,0,17,0,0,0,0,0,0,0,0,0,0,100
92d78bc296477c88dd1acec549ac3246f65d0cde,1,0,1,1,0,0,0,2,3,14,1,1,0,88,32,3,8,8,0,456,460,4,6,6,0,100
d45627fe6af3b094702cc9418f722df31ad5708a,0,0,0,0,0,0,0,0,0,0,0,0,0,0,18,1,0,0,0,0,0,0,0,0,0,100
dc576a1c4afa81cdb4952abfb881b0cfabdd4c25,0,0,0,0,0,0,0,0,0,0,0,0,0,0,19,2,0,0,0,0,0,0,0,0,0,100
0a8239e6a7bf455916717796af49e9aa42a83798,1,0,1,1,0,0,0,6,20,19,1,1,0,384,241,23,112,112,0,2420,2431,11,39,39,0,100
953df22c39958570aecb6e2ccda1533d46f173a6,2,52,0,52,0,0,0,4,38,19,1,1,0.74441318,947,49,5,262,256,6,6594,6349,245,80,78,2,100
99730c3a5a4d9ebb37e588020a51d23f01747eff,1,1,1,0,0,0,0,4,7,21,1,1,0,39,242,24,4,4,0,100,100,0,3,3,0,100
99029c0bda34b758108f0b95f44a341086c7ca37,2,2,2,0,0,0,0,2,4,20,1,2,1,146,243,25,13,13,0,855,855,0,13,13,0,100
62b3725596582caa622cd068de3f28a6bd8fa976,6,78,11,67,0,0,0,5,26,42,3,5,2.305934403,3231,33,4,723,717,6,23581,23314,267,222,220,2,100
8e629a10713786240ea6032a4c2efd3d1c4dc691,1,1,1,0,0,0,0,3,10,295,1,1,0,201,244,26,72,72,0,1232,1232,0,31,31,0,100
ad0bbc51059539c5a12bac40dcc0cc33e5f50eee,1,2,1,1,0,0,0,2,7,406,1,1,0,62,245,27,10,10,0,363,362,1,5,5,0,100
c70bee289857fadb9c00818269cb7cee933e0c59,0,0,0,0,0,0,0,0,0,0,0,0,0,0,258,4,0,0,0,0,0,0,0,0,0,100
ba7de16762aae34c360d85f97886079e858c1aeb,1,16,17,1,0,0,0,4,19,167,1,1,0,119,246,28,12,12,0,704,724,20,10,10,0,100
e959466d1dfb8749fe4a8e8c99743ce73513391c,2,29,4,25,0,0,0,3,41,43,1,1,0.61361902,2953,247,29,870,867,3,21357,21319,38,203,200,3,100
3fa609873b76746455b7c0355de7ac4dda52a14e,1,4,4,0,0,0,0,3,7,0,1,1,0,284,248,30,51,51,0,1621,1621,0,23,23,0,100
065d3e2f59afff648660be408f864eca30153054,1,1,1,0,0,0,0,6,42,0,1,1,0,2678,249,31,819,819,0,19736,19736,0,180,180,0,100
614c53df588fcad64a4fcb449b9f06132d2314f5,31,523,69,454,8,0,8,4,49,11,5,12,4.223404346,11841,259,3,2988,2950,38,80820,79369,1451,1068,1051,17,88.53618719
e89b51c4c6d48d867b893c3332f683a282451781,26,1236,70,1166,11,0,11,1,38,85,3,10,3.894171978,8897,250,30,2557,2428,129,64298,59590,4708,999,939,60,87.97972484
849e10a3918de964c3344db992ac7e1aa64c2df9,1,4,3,1,0,0,0,1,2,0,1,1,0,201,251,31,43,43,0,1166,1156,10,16,16,0,100
cbe8908430182f696b2f41a9848fab4db62a4187,2,6,4,2,0,0,0,1,2,2,1,1,0.881290899,163,252,32,9,9,0,908,906,2,7,7,0,100
87b9e53ad2909017a103736d9e4858c6851a24a6,0,0,0,0,0,0,0,0,0,0,0,0,0,0,253,33,0,0,0,0,0,0,0,0,0,100
fefe7f2df137f529e3c3ce7beb4698e09bedabd3,0,0,0,0,0,0,0,0,0,0,0,0,0,0,254,34,0,0,0,0,0,0,0,0,0,100
3a78ec68ac785a50a7bbe337f6963e33f621589e,1,13,0,13,0,0,0,1,7,29,1,1,0,472,255,35,72,72,0,3472,3472,0,43,43,0,100
a7777cb075dc6b6dc58d25562e772346d3209a8a,1,17,7,10,0,0,0,5,14,2,1,1,0,69,256,36,9,5,4,404,357,47,2,2,0,100
44db5768cd2f7e0f3793f156f76365105ee4bd87,18,121,209,88,0,0,0,4,39,190,6,8,2.993923406,4425,43,0,927,926,1,26177,26621,444,530,532,2,99.93603071
a61ecf0ff078add1667c72229e8111a5317721c9,1,0,2,2,0,0,0,4,39,0,1,1,0,1119,257,37,238,238,0,6590,6598,8,202,202,0,100
5affd1274fc1e236e34612d9164a4a916c71f131,3,6,3,3,0,0,0,3,28,277,2,2,1.530493057,1450,50,3,460,460,0,8731,8713,18,164,164,0,100
4dae2231cc3253d8d98590476d839500268584f8,3,41,6,35,0,0,0,4,24,30,2,3,1.413943107,1896,51,4,351,350,1,14276,14144,132,126,125,1,100
8500feee82da1dadbc37833ce22aa2626bbe8828,1,9,1,8,0,0,0,8,55,32,1,1,0,3657,52,5,1106,1102,4,22936,22872,64,273,273,0,100
dbc7cec4461774c7e951ea453f87ac01e9398d15,0,0,0,0,0,0,0,0,0,0,0,0,0,0,258,38,0,0,0,0,0,0,0,0,0,100
8274867a5498acbf954157f850b0feb9a721ba81,2,14,11,3,0,0,0,3,8,56,1,1,0.855450811,320,259,39,71,69,2,2260,2242,18,10,10,0,100
a3b0778071fae55483972d516e2c9321e82f92e5,3,53,9,44,0,0,0,4,39,37,2,3,1.191453154,2371,260,22,726,719,7,17205,16963,242,210,207,3,100
8fc59246172b643d9dd517bf4419167693d9ddcf,2,4,3,1,0,0,0,2,8,105,1,2,0.985228136,181,261,20,27,27,0,1135,1127,8,9,9,0,100
bbbe5ad85a1ccc96e677c112249edf34cc9cc5e1,0,0,0,0,0,0,0,0,0,0,0,0,0,0,262,21,0,0,0,0,0,0,0,0,0,100
6d1c3bfd9723f3b2350a05363573b1c53b8062d4,1,8,3,5,0,0,0,6,43,26,1,1,0,2678,263,22,821,819,2,19780,19736,44,180,180,0,100
caa4b76fe246bebf47ada251d5e84e0ada35b2bb,2,57,2,55,0,0,0,2,7,231,2,2,0.289986047,200,34,2,32,32,0,1882,1531,351,11,11,0,96.67945937
7d9724ac004489042af95932629ecb152033c34a,1,5,5,0,0,0,0,3,8,437,1,1,0,81,20,2,18,18,0,373,398,25,18,18,0,100
a3a74cc233a91b442857d81b00c78e5b86e799de,5,69,9,60,0,0,0,6,44,193,1,1,1.819649235,6196,264,23,1870,1861,9,44342,44072,270,623,619,4,100
f33cb3d9eb2341a6b05ec28d3c8ec7317323cd4d,3,57,2,55,0,0,0,6,30,172,2,3,1.287848447,2055,44,1,669,660,9,14219,13996,223,152,150,2,100
1242abf2d5464c4048fdb62a17f7cee12c190798,1,3,1,2,0,0,0,4,10,203,1,1,0,177,17,0,45,44,1,1018,1010,8,19,19,0,100
d022b18ad57f1407ec45141cf373315d9b8e24dc,16,1034,11,1023,9,0,9,1,45,97,4,7,3.338762289,6716,265,24,2224,2092,132,51908,46877,5031,686,621,65,98.78808864
cd66165d7631cb9e0ad04875acb5869d7a4f8a9e,1,1,1,0,0,0,0,6,46,1,1,1,0,2784,266,25,846,846,0,20553,20553,0,187,187,0,100
6d5fe3bb8ada4d0aceb5d6221140637dc60ab47d,2,21,12,9,0,0,0,6,31,8,2,2,0.799048521,1503,45,2,495,493,2,10836,10820,16,88,88,0,100
7c07cc6d1da3313455114ffe00b120ab8d1a2ba6,1,13,3,10,0,0,0,6,32,0,1,1,0,1266,46,3,410,409,1,9252,9190,62,67,67,0,100
4157d0931b02517754649fb5d92ea80cf6633cf7,0,0,0,0,0,0,0,0,0,0,0,0,0,0,267,25,0,0,0,0,0,0,0,0,0,100
3d8748c427a095b896ce1ecfca0b5ab91b34617e,1,1,1,0,0,0,0,4,12,141,1,1,0,119,53,3,12,12,0,669,669,0,7,7,0,100
a4bf964c089bb70e48abb4d78f35327317264c49,6,88,113,25,0,0,0,4,47,105,2,3,2.195792865,3786,0,0,1037,1033,4,26531,26670,139,236,235,1,100
efc6e371b72e345b4802dc5c9d841b4db88028fd,1,1,8,7,0,0,0,5,11,4,1,1,0,85,54,4,9,9,0,409,415,6,2,2,0,100
5e590a951ee9a24d3c019f8eb67ced2d819261a0,2,19,12,7,0,0,0,7,48,4,1,1,0.708835673,3368,1,1,980,979,1,24615,24590,25,220,219,1,100
809cb370030c72970ed499c3003aa5400b3a276e,2,47,1,46,1,0,1,1,50,22,2,2,0.249882293,2983,268,10,618,615,3,24289,24148,141,121,119,2,99.91410411
44c08403ac2b61eb1d022a5bf7b5df4778efb1f2,1,2,2,0,0,0,0,8,51,2,1,1,0,2983,269,11,617,615,2,24156,24148,8,119,119,0,100
884d6b5460be23e12f82f29501f07b5b771e012d,1,1,1,0,0,0,0,8,52,9,1,1,0,2983,55,2,617,617,0,24158,24156,2,119,119,0,100
c8ca563046840fc285b8f8d3b626882d69b1cd42,1,1,1,0,0,0,0,3,11,467,1,1,0,204,47,3,44,44,0,1169,1169,0,12,12,0,100
861e3971960d8b570c725d6c0bf7ce2d2ef59321,0,0,0,0,0,0,0,0,0,0,0,0,0,0,35,1,0,0,0,0,0,0,0,0,0,100
c0cf40564898fbf464b6782e674aa26ea4031182,1,1,0,1,0,0,0,7,42,17,1,1,0,582,2,2,133,133,0,4031,4027,4,32,32,0,100
7524219f6a3291c382287b41db5dcd72cb35a995,7,128,30,98,0,0,0,7,33,62,4,4,2.388438107,3888,56,3,1020,1016,4,27742,27247,495,251,248,3,100
cea8ab57d16578c0a087b642ae3b9a88780148cf,3,84,25,59,0,0,0,4,40,195,1,1,1.138246211,1044,48,4,311,299,12,7153,7021,132,108,107,1,100
5d4d50df96e29335937e5fb12df0b6787d5c525e,2,37,9,28,0,0,0,7,49,15,1,1,0.713146749,3372,3,3,983,980,3,24790,24619,171,222,220,2,100
91917c406cd68298a501a2eea1605fdc4e8c73e2,1,3,1,2,0,0,0,3,10,478,1,1,0,474,18,1,108,108,0,3054,3039,15,61,61,0,100
89b030c3d17855b38301bc84934d82bcc32b0ad1,4,54,3,51,1,0,1,1,40,49,2,3,1.468858882,1923,36,1,357,354,3,11916,11826,90,244,242,2,99.96567113
12840cafbf0b0ebe84c5d8fb76b38b4b1e543fce,5,45,9,36,0,0,0,2,13,239,1,4,2.121319553,1000,37,2,201,197,4,6128,5933,195,63,60,3,100
6f43ce7d40f545a2fd88f0feb752aab16985157c,2,28,3,25,0,0,0,7,22,261,2,2,0.770629069,536,57,2,152,148,4,3446,3333,113,48,46,2,99.98284146
a92418ddd6d486cff60d3c377dda16149ca2297c,1,5,2,3,0,0,0,4,8,260,1,1,0,126,38,3,23,23,0,769,756,13,19,19,0,100
bb527a1e882b9aff495a02b14a31231651487ef6,7,132,97,35,1,0,1,7,34,20,4,3,2.286193584,3763,270,0,984,984,0,26442,26416,26,238,238,0,99.91422199
60062e27a246a951a024366e5b23dbdd55e98350,9,1098,9,1089,5,0,5,1,43,37,2,2,2.27409217,3291,58,2,1095,986,109,25163,20407,4756,389,327,62,94.05505827
5a48e90100e6fdaa4cee76a1a927679cba0eefd7,1,32,23,9,0,0,0,6,31,158,1,1,0,441,59,3,128,126,2,3290,3269,21,22,22,0,100
fab1a92046f60999aa6428f2f27a9fdf1056bba4,1,5,0,5,0,0,0,5,9,509,1,1,0,256,4,2,58,57,1,1898,1869,29,14,14,0,100
5ef181ab94a302d439ef4e406fcdda7785a57048,1,6,5,1,0,0,0,3,7,513,1,1,0,152,271,1,36,36,0,876,853,23,12,12,0,100
a817af2993dcf0bcf035369c2027491ca5b23d5a,0,0,0,0,0,0,0,0,0,0,0,0,0,0,260,0,0,0,0,0,0,0,0,0,0,100
abff87ef35a30b70609b4fc3943c1651b3df3a20,0,0,0,0,0,0,0,0,0,0,0,0,0,0,261,1,0,0,0,0,0,0,0,0,0,100
03d19774c2c6a63b49a3b95f5b3095af146015b3,1,1,1,0,0,0,0,9,56,98,1,1,0,3664,0,0,1106,1106,0,22942,22936,6,273,273,0,100
cafd3d7a62acc533e53a059e8685e0f7d5190e5d,0,0,0,0,0,0,0,0,0,0,0,0,0,0,21,0,0,0,0,0,0,0,0,0,0,100
22e5530d0c819cfdc15e629d3c92657c8ed992dc,1,4,4,0,0,0,0,7,21,17,1,1,0,1109,272,2,288,288,0,8839,8839,0,53,53,0,100
704fc1b513699dc83de37248839bdb5e72e1bd07,1,8,8,0,0,0,0,6,22,41,1,1,0,283,1,1,0,0,0,1898,1898,0,0,0,0,100
4fb0c28dc295eb9318fbf8f6c5f664e315f40b79,1,3,3,0,0,0,0,7,50,52,1,1,0,2806,60,3,849,849,0,20751,20751,0,190,190,0,100
8c6e31a1d98955516d9d66e292a186069cf1b13d,1,2,1,1,0,0,0,4,6,530,1,1,0,84,39,1,15,14,1,446,433,13,13,13,0,100
a1fb5b7f72e7947c30570b44feb6e0b9934d60d7,2,97,5,92,0,0,0,3,25,265,1,2,0.818955502,1967,61,4,354,346,8,16498,15951,547,149,141,8,100
027c4724491724f771a3c803d132ec0dfc90507d,0,0,0,0,0,0,0,0,0,0,0,0,0,0,273,3,0,0,0,0,0,0,0,0,0,100
31e436df3c015ff70a0ba4fa8e0ec493e4cef358,1,1,1,0,0,0,0,4,9,41,1,1,0,128,40,1,23,23,0,769,769,0,19,19,0,100
151cf2d034e904110ac1d19747319034943753de,12,879,34,845,6,0,6,1,11,227,2,3,3.045214177,2728,41,2,934,827,107,22238,18509,3729,298,234,64,99.78423237
2d6fbb5d13861f3b2f28fbd2ad7b604a19c96904,7,12,163,151,0,0,0,1,5,0,2,2,2.014316796,681,42,3,100,123,23,3213,3778,565,56,73,17,100
cc5e5a36fa28670e6e6bb1a74eae359a2c6cd8ab,1,6,1,5,0,0,0,5,10,305,1,1,0,118,2,2,28,26,2,668,632,36,9,9,0,100
6529b65e43933b9b43bba56c17ced080ed17802d,0,0,0,0,0,0,0,0,0,0,0,0,0,0,262,2,0,0,0,0,0,0,0,0,0,100
eb6a63c2c7ba02c84107770028049d4e2c976007,0,0,0,0,0,0,0,0,0,0,0,0,0,0,263,3,0,0,0,0,0,0,0,0,0,100
5b67b240f1d53eae36fba27611c501003cf700a7,1,10,7,3,0,0,0,5,18,101,1,1,0,871,264,4,235,235,0,6302,6280,22,44,44,0,100
7eabf992bb15cdb47740e8b65c3d3ab29f38be2a,1,0,0,0,1,0,1,2,3,8,1,1,0,0,274,3,0,0,0,0,0,0,0,0,0,99.96686547
716b008346b7511e9d1da43ef25d1a8e170955f8,0,0,0,0,0,0,0,0,0,0,0,0,0,0,275,4,0,0,0,0,0,0,0,0,0,100
09c894a368c7956e2490eeadc2002a6612ebbe8e,2,61,1,60,1,0,1,1,44,21,2,2,0.205592508,2249,276,5,716,713,3,15204,14931,273,213,211,2,99.96686547
cdd318578e9f49168457008677ad99ab66b80cd0,0,0,0,0,0,0,0,0,0,0,0,0,0,0,265,5,0,0,0,0,0,0,0,0,0,100
935d55d4fe460779c39f135d5af3fba51fa257c5,0,0,0,0,0,0,0,0,0,0,0,0,0,0,266,6,0,0,0,0,0,0,0,0,0,100
86f79ae640c19d8a1bd9ec858238434e13769d23,0,0,0,0,0,0,0,0,0,0,0,0,0,0,62,2,0,0,0,0,0,0,0,0,0,100
c2752e27dade4f4bfc84cb214d622bc179922752,1,1,1,0,0,0,0,6,31,118,1,1,0,2105,277,5,708,708,0,14666,14670,4,258,258,0,100
aca5f3351df8b7fae0cf79ae1ead5af2e1abdd5a,0,0,0,0,0,0,0,0,0,0,0,0,0,0,63,3,0,0,0,0,0,0,0,0,0,100
a20d36c121387f0e2036069bbcf6a4458d3849f1,4,24,6,18,0,0,0,4,51,234,1,2,1.640223929,4204,64,4,1217,1215,2,30536,30499,37,265,263,2,100
e08320284e96533d5caa460c8f75c8bf18e06b73,0,0,0,0,0,0,0,0,0,0,0,0,0,0,278,5,0,0,0,0,0,0,0,0,0,100
c4f8a37d911c97314a22c82432a3274bfbec6888,14,725,7,718,0,0,0,4,23,160,2,2,2.834343346,1940,279,6,383,351,32,12734,11075,1659,306,274,32,98.02728917
436329886453fab535edb7f130d3ba83983a0d1f,0,0,0,0,0,0,0,0,0,0,0,0,0,0,280,7,0,0,0,0,0,0,0,0,0,100
45cf3bf49c315906b41ce4ffcc04f6029a32dca9,0,0,0,0,0,0,0,0,0,0,0,0,0,0,281,8,0,0,0,0,0,0,0,0,0,100
be0582a5e905f52497939d3f986c937db5cc9f1d,0,0,0,0,0,0,0,0,0,0,0,0,0,0,65,5,0,0,0,0,0,0,0,0,0,100
ba6274a19e6255e384c27a0d6cf9ffe5290beec0,1,2,2,0,0,0,0,7,16,149,1,1,0,640,66,6,133,133,0,3968,3968,0,84,84,0,100
61c789dbafbf174d3089d28c83646d0f56704c97,5,79,6,73,1,0,1,4,17,227,2,5,1.489507552,860,267,5,290,284,6,5998,5744,254,69,64,5,99.96737357
302019514727e10cdf72bb0352e92c098c376ff6,0,0,0,0,0,0,0,0,0,0,0,0,0,0,67,7,0,0,0,0,0,0,0,0,0,100
647cbf2ae73570e4ac67fe3fcea16a2a237503bd,0,0,0,0,0,0,0,0,0,0,0,0,0,0,268,6,0,0,0,0,0,0,0,0,0,100
92919929f81a32dd451c1f2116dbbcf4acff860d,0,0,0,0,0,0,0,0,0,0,0,0,0,0,3,1,0,0,0,0,0,0,0,0,0,100
cb2a061dc7b46245b5ff4ee2478ffdb848a01315,3,126,0,126,2,0,2,1,7,79,2,2,1.194173734,673,43,3,208,196,12,4928,4512,416,128,118,10,99.86955813
eb4c3074466c1db18a2bb099854791219b30f9ec,0,0,0,0,0,0,0,0,0,0,0,0,0,0,44,4,0,0,0,0,0,0,0,0,0,100
a282456a912774bb1f662ac1bd0e55e8cb139622,0,0,0,0,0,0,0,0,0,0,0,0,0,0,45,5,0,0,0,0,0,0,0,0,0,100
9e5cc06fcb99006eea60d88c91451b2ea86331ca,3,143,2,141,2,0,2,1,30,44,2,2,1.359555106,1342,46,6,463,451,12,8882,8373,509,161,153,8,99.83705394
8a67bc28130b71818bb704068468b4c27d06addd,0,0,0,0,0,0,0,0,0,0,0,0,0,0,47,7,0,0,0,0,0,0,0,0,0,100
1af3d93ca73f0b315d11229dab94709c235e164d,1,0,5,5,0,0,0,3,8,579,1,1,0,72,4,2,14,15,1,285,304,19,13,14,1,100
35fb37ea380649a203db65d78c972f1206a509b9,0,0,0,0,0,0,0,0,0,0,0,0,0,0,48,8,0,0,0,0,0,0,0,0,0,100
b50c73f35711d2d965dfa4fe9918f14504d628b7,2,5,8,3,0,0,0,5,18,299,1,1,0.995727452,1023,282,8,378,378,0,7756,7792,36,46,46,0,100
e487d35da68bc0332546d1a16f0cdc9e9baa64f0,2,79,1,78,1,0,1,1,12,0,2,2,0.337290067,381,283,9,139,135,4,3347,2965,382,14,11,3,100
ddd0791346cfdce3612e60608d35e5c952deb898,1,1,0,1,0,0,0,6,19,548,1,1,0,592,68,6,176,175,1,4139,4134,5,37,37,0,100
1f92ab584254fc29e93f3246e1f798ea4d74afb9,1,2,2,0,0,0,0,7,52,29,1,1,0,2810,284,10,850,850,0,20772,20772,0,191,191,0,100
80d2c39020e4aa201d1bc066db6d97044863e1a1,3,34,6,28,0,0,0,4,53,134,1,2,0.820061935,3533,49,6,1012,1007,5,25906,25707,199,246,244,2,100
2f2e39991d5c6485183d03c3d1051f4fb5ce0ee9,1,18,0,18,0,0,0,5,10,353,1,1,0,207,69,7,39,36,3,1495,1421,74,8,8,0,100
6a26ae253154f94e39fbc686f636d8fb4a47d08c,3,33,7,26,0,0,0,8,54,11,1,2,1.467034028,3874,50,7,1090,1087,3,28290,28185,105,261,259,2,99.93488524
cd2f9e978ee6bb3da2c2272e9259c9bec683faef,0,0,0,0,0,0,0,0,0,0,0,0,0,0,285,8,0,0,0,0,0,0,0,0,0,100
73b35874f032a84d4d9ada3dbb49b18777641019,1,8,6,2,0,0,0,7,45,44,1,1,0,2249,286,9,715,714,1,14945,14935,10,211,211,0,100
98ef3d9063e9a115e30960d010cb029171686005,8,176,34,142,1,0,1,5,31,147,5,5,1.927257713,4048,287,10,1122,1110,12,26177,25464,713,503,496,7,97.59644825
ac83668ffa1941c8534cf6417391af4cdb70cab5,1,0,1,1,0,0,0,8,46,3,1,1,0,598,5,0,136,136,0,4150,4154,4,33,33,0,100
9776c5bdfebc5e3b29a3d2af5ea04f77c161c04f,1,2,1,1,0,0,0,2,2,186,1,1,0,34,288,11,3,3,0,91,91,0,2,2,0,100
c3ba59f3e7f9e279fd9d99c199a3d7fe1d342a3f,1,0,133,133,0,0,0,1,2,0,1,1,0,106,289,12,0,10,10,0,665,665,0,8,8,97.59644825
f187b3d9954f1cd2fac201890a848001565075fb,0,0,0,0,0,0,0,0,0,0,0,0,0,0,290,13,0,0,0,0,0,0,0,0,0,100
bc9d60fe3bda89a1b300b68328ac7bb6067ff491,2,7,16,9,0,0,0,5,23,0,1,1,0.886540893,723,291,14,200,202,2,4296,4336,40,68,68,0,100
830cc35014e422f0bdf6b43cb7e1c709560876f1,34,3455,0,3455,33,0,33,4,8,5,1,2,4.882647502,126,292,15,321,32,289,16969,839,16130,242,7,235,96.0430564
18cc4b932f6a8335829d05ffab176c9f5ab03f0e,1,22,2,20,0,0,0,5,5,154,1,1,0,71,49,0,16,14,2,394,356,38,7,5,2,100
e5556e0fe56f630396f688228f9e10199344aa71,5,11,691,680,0,0,0,1,46,39,2,2,1.026203146,3676,70,5,986,1053,67,20407,23538,3131,327,345,18,99.97160704
3ca7d9d4d6bef1267b6d6af85ea74c20a87ee93d,0,0,0,0,0,0,0,0,0,0,0,0,0,0,293,11,0,0,0,0,0,0,0,0,0,100
af4ea13a2c02f4fb217eb72469267e244916f917,6,250,2,248,4,0,4,1,11,78,2,3,2.323017781,597,294,12,204,190,14,4471,3895,576,96,90,6,99.87235853
a710a30b547330217138b08b7ac7b8ab224b41a3,1,96,0,96,1,0,1,1,1,0,1,1,0,0,295,13,9,0,9,439,0,439,6,0,6,99.94336684
9b42c2d7a0c460e89bec53cbc477a9a4e9bd5fc5,1,1,1,0,0,0,0,2,4,617,1,1,0,70,296,14,7,7,0,296,294,2,2,2,0,100
10de9ba4eb3bb6382291d16e468459f533cf65a1,1,2,2,0,0,0,0,2,5,1,1,1,0,70,297,15,7,7,0,296,296,0,2,2,0,100
c96881a214f41e4d7c6bed174dd132057bcca42a,1,1,0,1,0,0,0,5,25,17,1,1,0,579,50,1,176,176,0,3408,3399,9,64,64,0,100
6f44b557361bf54f044e73bfae36499e28d4242e,72,4535,290,4245,34,0,34,6,57,117,6,17,5.46830551,19100,303,10,5374,4918,456,157353,133866,23487,1462,1258,204,90.71869821
74683912e3c0de85f4c003e132af6a50a42511ba,2,100,7,93,1,0,1,1,15,200,2,2,0.506365745,485,304,11,132,124,8,4776,4332,444,33,25,8,99.88731487
f875a5e98bde4e707ceb37d7df0bcc656b7e8a8b,4,53,23,30,0,0,0,1,55,127,3,4,1.294995075,4172,305,12,1243,1239,4,30967,30740,227,307,305,2,100
da9c4ba7217417a0acab754dc358c9462c83fa8f,1,0,4,4,0,0,0,1,3,0,1,1,0,106,306,13,11,12,1,633,645,12,9,10,1,100
0346483ada11099fc0756621e405a42cb1b5fae8,1,1,0,1,0,0,0,1,4,0,1,1,0,103,307,14,11,11,0,633,633,0,9,9,0,100
02f0a83dded42a7a66271e40bb422681d3b11b6c,1,29,12,17,0,0,0,5,21,249,1,1,0,369,308,15,104,101,3,2328,2212,116,42,41,1,100
3ebf5a9a07213dfd1d1584862364592a005ddcdb,1,3,1,2,0,0,0,3,11,429,1,1,0,445,309,15,161,161,0,2909,2898,11,25,25,0,100
1dcd7b1d7508133a9fc805dace7a7f49355e58f2,1,2,2,0,0,0,0,8,56,8,1,1,0,2837,310,16,856,856,0,21044,21044,0,194,194,0,100
d4e978f5aeb420aa295a166e0f35770e5b181932,5,10,5,5,0,0,0,4,14,407,1,1,2.321928095,1022,311,17,183,183,0,6316,6301,15,73,73,0,100
4c2efed65b06efe4dfceb6cf499bd6fe6e4ffd9c,1,28,5,23,0,0,0,1,2,313,1,1,0,66,312,17,13,9,4,588,381,207,9,8,1,98.26086957
e1dccc1872e9fa517851e54dccd5d6e264c5caba,3,114,1,113,2,0,2,1,20,116,2,2,1.03688138,773,51,0,249,236,13,4974,4527,447,132,121,11,99.91947173
aa5259d5210a6ba6e9adc11d37db2cc733725715,2,36,0,36,0,0,0,2,2,0,1,1,1,73,313,16,11,11,0,434,434,0,11,11,0,100
6ea5a81c9380521adb3c0c7839a06194c9e148f3,1,1,1,0,0,0,0,6,25,180,1,1,0,526,51,1,117,117,0,3354,3354,0,40,40,0,100
46ce1f5af7dea3fa25e037618779d6dc2d2f92bf,0,0,0,0,0,0,0,0,0,0,0,0,0,0,314,17,0,0,0,0,0,0,0,0,0,100
4fb39b9590374407c6d06bd48f6e9c6e9bac3505,1,78,0,78,1,0,1,1,1,0,1,1,0,0,315,18,3,0,3,320,0,320,3,0,3,99.79049154
21ec1613390ffe25d4ab8ffcc0ce3e5155940eef,1,5,3,2,0,0,0,1,2,0,1,1,0,64,316,19,3,3,0,340,320,20,3,3,0,100
99bb160daeec3c60b2fa1cbd4fb8fe7780fc3fdc,1,5,2,3,0,0,0,3,6,661,1,1,0,122,317,19,16,16,0,726,690,36,8,8,0,100
c231cc814fed7c904880c3bb396d5be31d8fe397,1,0,2,2,0,0,0,3,7,0,1,1,0,125,318,20,16,16,0,708,726,18,8,8,0,100
fad6f352012ad403752eee463a5b6b3456fc0d74,3,52,5,47,0,0,0,3,10,140,1,2,1.189731917,264,319,21,57,51,6,1759,1528,231,23,18,5,100
5018dfaa88189d72909b45ccde5cd722ed2bae10,40,1873,428,1445,11,0,11,4,58,231,5,13,3.887586561,17626,320,22,4933,4773,160,123571,117350,6221,1885,1791,94,98.8190233
1946a9b0364cfffd39b4ca625dbdebcd8042b375,1,14,4,10,0,0,0,6,28,33,1,1,0,444,269,0,104,102,2,2818,2792,26,33,33,0,100
30024007cda04b1c6625f22fe4f49a64078047c4,1,5,0,5,0,0,0,4,13,681,1,1,0,1187,270,1,439,435,4,9265,9206,59,54,54,0,100
5472692b411e87032a95e60ea0833b35b94695a0,1,1,1,0,0,0,0,4,10,141,1,1,0,128,271,2,23,23,0,769,769,0,19,19,0,100
55720f220bb769a21cb3161f240a9f7937d27dd6,2,62,12,50,0,0,0,4,57,26,1,1,0.244765082,2982,52,1,886,880,6,22189,21987,202,205,204,1,100
1928eeb61111b92c0b594ce8286be973671d47e7,1,1,1,0,0,0,0,9,59,21,1,1,0,3541,272,3,1042,1042,0,21864,21863,1,267,267,0,100
c97cd70b3e41db250a1b06e624dc233d5e271a85,1,24,11,13,0,0,0,5,19,39,1,1,0,320,273,4,80,80,0,2341,2251,90,23,23,0,100
860a260fe282a7fa1ea7911079484ac3e2a0f2d1,0,0,0,0,0,0,0,0,0,0,0,0,0,0,53,2,0,0,0,0,0,0,0,0,0,100
5e650f0ce356afea167d81c53b4ebd9203031cc2,1,2,2,0,0,0,0,8,58,2,1,1,0,2863,274,5,862,862,0,21229,21226,3,195,195,0,100
e503930afa3b607e55818d38f11ff9205553807a,1,1,0,1,0,0,0,4,12,88,1,1,0,145,54,2,38,38,0,1103,1092,11,10,10,0,100
d3fb4cabf89d9c80054a481cc6679158be665402,1,2,1,1,0,0,0,4,5,483,1,1,0,185,6,0,32,32,0,1010,1006,4,12,12,0,100
88aa0ce910a9ea15033c6289337d8aec94445f09,0,0,0,0,0,0,0,0,0,0,0,0,0,0,52,0,0,0,0,0,0,0,0,0,0,100
a54f84262450b1cafe497ed0b058f1e9bd5f31bc,4,71,5,66,0,0,0,4,59,380,3,3,1.331582702,3147,53,1,931,920,11,23202,22889,313,219,216,3,100
38f41d870ee28de236a4bde5fa5331c04771eebf,2,32,1,31,0,0,0,3,60,50,1,1,0.684038436,2948,54,2,874,872,2,21689,21613,76,199,198,1,99.88950276
111098f1b3af2a8cb65618a78eb1bc9b53d6bddb,1,3,2,1,0,0,0,5,16,70,1,1,0,483,55,3,124,124,0,4307,4300,7,25,25,0,100
c00f3b5b788775703494a1566be6529d70e4f724,2,164,0,164,2,0,2,1,1,0,1,1,0.931870917,0,56,4,20,0,20,664,0,664,9,0,9,99.92112321
265be5d1bdd5da5debf62bb1cfb0906c195d7f8b,1,21,1,20,0,0,0,4,11,58,1,1,0,141,321,0,43,40,3,991,933,58,11,10,1,100
45eb530812221b3e2b0a4d095a703ea4b95a6f2a,1,8,2,6,0,0,0,4,13,20,1,1,0,146,55,3,40,38,2,1166,1103,63,10,10,0,100
485372b3f66bff883a422b3de8966279a57589de,1,17,1,16,0,0,0,4,11,485,1,1,0,131,322,1,34,31,3,904,779,125,10,10,0,100
787b57a486877f695c55c54f7709428df18e64d9,1,34,18,16,0,0,0,6,29,52,1,1,0,452,275,0,109,104,5,2916,2818,98,34,33,1,100
2c18b555c7f51d194efa6035f581a5bd65c950ac,1,5,1,4,0,0,0,5,22,491,1,1,0,992,57,5,299,298,1,7303,7284,19,83,82,1,100
7bd70d36dbf8737fb279beedcde7c46b95481c3b,1,1,1,0,0,0,0,5,23,0,1,1,0,995,58,6,299,299,0,7303,7303,0,83,83,0,100
008b249c241dae1cc91a2c74f0621afc8947a5fa,10,412,3,409,6,0,6,1,55,109,3,5,3.047953243,5204,323,2,1380,1326,54,41191,39689,1502,335,305,30,99.54481243
f185a0fe7b0d2316dff65237025caf53cd5d3fce,0,0,0,0,0,0,0,0,0,0,0,0,0,0,324,3,0,0,0,0,0,0,0,0,0,100
84205d6d5040a9af6c14c86d9effc814a96abf73,1,1,1,0,0,0,0,1,3,3,1,1,0,241,325,4,64,64,0,1583,1577,6,12,12,0,100
ab88266f2aa9f0a95baa64f264efeb3ff79665b2,4,101,3,98,1,0,1,2,42,223,2,2,1.843532336,803,326,5,208,198,10,5579,5278,301,78,71,7,99.87503905
a3c2d2a4874a3dd4d9c291367c5ad0497f45d6f8,1,1,1,0,0,0,0,4,8,761,1,1,0,242,0,0,60,60,0,1798,1798,0,16,16,0,100
e868210ca0b3c8a6b11f382ea0e403b4f85451df,1,7,0,7,0,0,0,9,60,83,1,1,0,3541,59,2,1043,1042,1,21879,21864,15,268,267,1,100
69ee1ce7f0f6b819a38128ffeddbb5c235942af9,6,96,84,12,0,0,0,2,2,36,2,2,2.584962501,279,23,0,38,38,0,1091,1091,0,30,30,0,100
e11e2078af240018cc60fca04a8d6ded282d95d1,0,0,0,0,0,0,0,0,0,0,0,0,0,0,327,2,0,0,0,0,0,0,0,0,0,100
288355f4ad85efabcaeae95e6e4b3ef49f82fb95,0,0,0,0,0,0,0,0,0,0,0,0,0,0,24,1,0,0,0,0,0,0,0,0,0,100
4fda4e948461aa05d836fa25e3f2a2698f46e6da,1,4,0,4,0,0,0,5,24,54,1,1,0,995,60,1,300,299,1,7313,7303,10,84,83,1,100
82cd11cb197b73cac01eb888875b1bba6202b609,1,5,1,4,0,0,0,5,41,307,1,1,0,1120,61,2,240,239,1,6615,6602,13,203,203,0,100
4140d243a4b4c65cdaa9d43589c4c25263cbdb2b,0,0,0,0,0,0,0,0,0,0,0,0,0,0,25,2,0,0,0,0,0,0,0,0,0,100
6f29454e48415ac92f14e407119a69dfcddea9c4,1,10,2,8,0,0,0,4,13,563,1,1,0,1026,328,1,242,240,2,6187,6157,30,129,128,1,100
5a0b5b39e7c6fe354e722ab467bdf355ddd3ff85,1,48,36,12,0,0,0,1,3,375,1,1,0,152,329,2,27,27,0,1064,1057,7,9,9,0,99.92199688
26ef9ddabbb3deb3f7fb8f8145ddc3131ec51e5c,1,6,3,3,0,0,0,8,21,159,1,1,0,700,330,3,166,166,0,5027,5022,5,50,50,0,100
07c046a077f265309f6844938824f9562cce286e,2,97,37,60,0,0,0,1,4,195,2,2,0.941186437,255,331,4,47,31,16,1875,1643,232,27,11,16,100
d621aa765d1a4185c557c078092e27f8881f6228,1,1,1,0,0,0,0,5,15,163,1,1,0,463,1,0,98,98,0,3193,3193,0,34,34,0,100
0d3bc96fcb3ce692bf088c5cab91cfa309013a32,1,4,0,4,0,0,0,8,47,214,1,1,0,597,7,0,136,136,0,4162,4150,12,33,33,0,100
2933147f53d43377613e9d51d51f9a55df75346e,1,5,1,4,0,0,0,3,4,572,1,1,0,270,332,5,61,60,1,1706,1688,18,39,39,0,100
d4a2929a579f5a484ee5893330bb88cc64464aa0,28,968,52,916,12,0,12,6,61,140,3,7,3.272115739,14732,333,6,4086,4021,65,107844,102503,5341,1064,1027,37,99.54982925
72f7d7ce4365d531bc1111fee278256bd994a21f,9,162,2,160,0,0,0,1,2,0,1,1,3.16955325,547,334,7,44,44,0,4335,4335,0,27,27,0,100
8c4cf9511edfc1a505ae639204b14f06a12ce739,13,507,108,399,3,0,3,3,61,278,3,6,2.791103516,5849,335,7,1628,1597,31,43884,41419,2465,463,440,23,99.75308642
3d3cb67c5a5144afd49d23195a3ae0f50595ed98,1,18,0,18,0,0,0,1,2,0,1,1,0,232,336,8,17,17,0,1914,1914,0,16,16,0,100
206f0f04e1d6d28b7a1a8c7166bf7e5e366b5dde,2,4,4,0,0,0,0,1,28,0,2,2,0.811278124,1432,337,9,379,379,0,10759,10769,10,114,114,0,100
8464ea75f10492f7f815ccd1c3604dc238f8cfc0,2,1,18,17,0,0,0,4,62,86,1,1,0.485460761,3162,338,10,926,928,2,23106,23210,104,215,216,1,100
240d356314bb8662101ac87c1e2e97ebf829c4b2,2,6,1,5,0,0,0,6,29,210,1,2,0.863120569,1672,62,0,474,473,1,12522,12470,52,149,149,0,100
7f797f0226382b919e7353060d108d9e519e90dc,1,7,2,5,0,0,0,6,27,170,1,1,0,547,71,0,123,123,0,3482,3481,1,43,43,0,100
92d1334e52ad95bc637260eb60b32b03598e61b8,1,5,2,3,0,0,0,6,33,192,1,1,0,487,339,11,137,136,1,3544,3531,13,24,24,0,100
4d9a6759db880b67adf9cd233528da021524dc99,4,127,3,124,1,0,1,2,17,397,2,2,1.637067817,552,56,0,147,135,12,4159,3731,428,38,30,8,98.8863109
3aa60007ddf8ead90b2fa5aa4c44f731dfa86e04,2,13,0,13,0,0,0,3,26,113,1,1,0.89049164,1271,340,8,281,280,1,8172,8152,20,196,195,1,100
13dd4f22526a57f27c1b4bbb89619b11af31815a,5,188,12,176,3,0,3,6,21,14,3,3,2.301608702,508,341,9,163,147,16,3861,3334,527,49,40,9,99.90691902
95018cef64b459002d572ac0c1452e6ad8500cea,1,3,1,2,0,0,0,5,9,235,1,1,0,481,342,10,162,161,1,2968,2960,8,83,83,0,100
72aefb149b493ca812d2dd03fc555ca8b1a6e961,0,0,0,0,0,0,0,0,0,0,0,0,0,0,343,11,0,0,0,0,0,0,0,0,0,100
8d18daabd722e39dae258ab33f74c561b4965496,6,447,1,446,2,0,2,6,63,60,1,3,1.476541536,4995,57,1,1440,1371,69,37983,35784,2199,369,357,12,93.27436113
a8f6d3c116564b1af3bbbc8319ba0715c042750a,19,499,138,361,0,0,0,5,64,325,3,5,3.482824615,16200,8,1,4804,4751,53,112495,111366,1129,1451,1410,41,100
6a29ebffe46e6e3d61d41a3b87442a94307a73a6,1,44,0,44,1,0,1,1,1,0,1,1,0,0,344,12,2,0,2,125,0,125,2,0,2,99.92302758
5a1faec4719c40ee0769901f2b4a959084e67cd9,8,128,6,122,0,0,0,1,30,386,2,5,2.115661724,2275,345,13,545,531,14,16594,16156,438,191,187,4,99.80749487
d4454e5a1f0793345269a9985d094f88f892a0b0,0,0,0,0,0,0,0,0,0,0,0,0,0,0,346,14,0,0,0,0,0,0,0,0,0,100
2a45dc5929232f897d20240d2891836dabff020d,1,16,11,5,0,0,0,6,28,24,1,1,0,547,347,12,123,123,0,3487,3482,5,43,43,0,100
2a612c105315ff1b994a868505a65523e19690b0,2,33,31,2,0,0,0,7,18,6,1,1,1,513,348,13,136,137,1,3588,3597,9,28,28,0,100
78f5a95b2b21290f26e467de86bc97db483ee52c,1,4,3,1,0,0,0,6,29,0,1,1,0,550,349,14,123,123,0,3492,3487,5,43,43,0,100
37c4e9148a7c6246c339a8b87285b686a8d812ae,1,2,2,0,0,0,0,6,30,0,1,1,0,551,350,15,123,123,0,3479,3492,13,43,43,0,100
b2a10e285f70f888e21ffd02ff09122986556a1e,3,5,20,15,0,0,0,5,51,12,2,2,1.01543128,2566,9,1,757,759,2,16916,16948,32,228,230,2,100
0b4ce34920fbf2fb358447bd1aa209d03098b8f3,1,7,2,5,0,0,0,9,65,18,1,1,0,2949,351,13,889,888,1,21842,21813,29,206,206,0,100
badc4b924fb4f3632b2d74439b9ee0b5904ef962,1,1,2,1,0,0,0,6,31,14,1,1,0,551,352,13,123,123,0,3481,3479,2,43,43,0,100
70f3a94b36c3fc63924dd0748513023fd8372faa,1,7,8,1,0,0,0,9,66,1,1,1,0,2953,72,1,889,889,0,21842,21842,0,206,206,0,100
8d161ff99e1e4f1f0bfa4b2c5e590abc590df42d,1,2,2,0,0,0,0,4,13,426,1,1,0,240,353,14,86,86,0,1646,1646,0,21,21,0,100
d24bec6ed61bde32111ec1ee3c8de77f9a05c1c1,2,88,4,84,1,0,1,1,32,0,2,2,0.713146749,550,2,0,128,123,5,3769,3481,288,47,43,4,99.97431947
18e83a09b18fde4721af69123fd4c7799bcca00e,2,135,7,128,1,0,1,5,9,262,2,2,0.929588304,422,354,15,172,155,17,3581,3012,569,60,53,7,99.96149897
62c8c548d90295d92e5aacd3adcdce0e785bf553,6,278,1,277,5,0,5,1,11,145,2,2,2.302490014,65,355,16,42,16,26,1178,284,894,25,4,21,99.8590647
171dc5d46aeb2084b2fc2f92079033117b413ac4,6,65,19,46,0,0,0,1,12,0,2,2,1.213513256,301,356,17,50,42,8,1467,1178,289,30,25,5,100
64d0ea816673b6f36f88c363891ecb2136993dda,2,105,8,97,1,0,1,1,31,11,2,2,0.564914151,1224,357,18,377,370,7,9741,9182,559,106,99,7,99.59303065
a747db9443a0408c58221d36ce9c6103e8010be2,10,584,37,547,0,0,0,3,52,422,3,6,1.60472549,3765,358,19,1177,1107,70,27355,24477,2878,341,298,43,100
4d336b2a2cf354fecce2f8931ca1f6702efbe1d5,2,43,30,13,0,0,0,1,33,4,2,2,0.805804911,609,3,1,127,128,1,3769,3769,0,46,47,1,100
8ba8ffffc429b766f6e5ee3b4e30af23848075e7,1,7,4,3,0,0,0,1,3,0,1,1,0,61,4,2,4,4,0,290,288,2,3,3,0,100
18c90bbd0be9031ca3f32f0f19c2c48221c3834f,2,34,3,31,0,0,0,2,16,429,2,2,0.494182935,347,359,19,72,69,3,3062,2865,197,14,13,1,100
012efc034c6f6cb751ad6854bfab18f86ad2fd68,3,10,1,9,0,0,0,6,63,49,1,2,1.435371391,5335,360,20,1619,1618,1,33909,33861,48,435,435,0,100
de14ad6630a17d4c4ea27133e825479f5f01c61d,4,47,56,9,0,0,0,6,34,174,2,4,1.349109379,1020,361,21,217,220,3,6226,6275,49,83,85,2,100
24d2a42c227c3e1662d4ecf17b16149174d19ec0,1,2,4,2,0,0,0,7,35,0,1,1,0,544,63,0,121,121,0,3431,3435,4,42,42,0,100
b92f6420af0222aa71877aa737d3456f000bb409,1,28,7,21,0,0,0,4,11,206,1,1,0,128,58,2,25,23,2,805,769,36,20,19,1,100
ebe3fdbd6db6950db13142e9e686f2e232948082,2,14,2,12,0,0,0,4,4,591,1,2,0.69621226,206,5,3,13,12,1,1455,1418,37,9,9,0,100
b74fc3188122a96bc3404cb69825e372cbf383f0,1,27,11,16,0,0,0,5,13,12,1,1,0,154,6,4,47,43,4,1031,991,40,12,11,1,100
c767561f9dd1a6363fc5f14b28af58e796d86dec,0,0,0,0,0,0,0,0,0,0,0,0,0,0,7,5,0,0,0,0,0,0,0,0,0,100
024faa31d75a55a619b1e59ff40b7523c24c4c84,5,216,1,215,4,0,4,1,12,45,2,2,2.03041924,1198,64,1,356,337,19,8311,7814,497,266,248,18,99.88634929
3f439edc57637940063ce9c72a1c528587e165ff,10,473,4,469,8,0,8,2,14,90,3,3,3.134823547,558,362,22,230,184,46,4913,3568,1345,61,38,23,99.82367758
754eb8d60c03222e6d6c5adb9ebe1b17cbfe38e1,2,49,46,3,0,0,0,1,36,6,2,2,0.700369149,606,8,6,127,125,2,3741,3721,20,46,45,1,100
2a3ee08d92302b82349f1e9e3d7964d01d7f9a04,0,0,0,0,0,0,0,0,0,0,0,0,0,0,9,7,0,0,0,0,0,0,0,0,0,100
12839b6bd9090eb84d1944584c9ea73aaa8b44fa,27,4717,0,4717,27,0,27,1,1,0,1,3,4.22019149,0,65,2,792,0,792,19372,0,19372,469,0,469,93.05889079
d5e577c921d462c70b210b2a714885449ef7c5f2,0,0,0,0,0,0,0,0,0,0,0,0,0,0,363,19,0,0,0,0,0,0,0,0,0,100
903170b333f09bfb8dc2a53c0ac091ee12999c8a,1,1,1,0,0,0,0,5,14,715,1,1,0,283,5,0,78,78,0,1667,1667,0,30,30,0,100
fd7eae62104e624c16ee22695293f77c82259991,0,0,0,0,0,0,0,0,0,0,0,0,0,0,364,20,0,0,0,0,0,0,0,0,0,100
c61d81ade6f149b5193e5818eaaa06bd41b53e0f,11,91,195,104,0,0,0,1,2,0,1,3,2.612676121,1222,66,3,205,230,25,6829,7572,743,101,116,15,95.36
8051804dbdc6bddbc27f5fe677bcfd80379d83e6,0,0,0,0,0,0,0,0,0,0,0,0,0,0,67,4,0,0,0,0,0,0,0,0,0,100
321ede95ee2fce8f7741085e67134ab5cff3abf2,1,94,94,0,0,0,0,5,12,895,1,1,0,76,10,8,5,5,0,410,410,0,5,5,0,100
0033a6b3d97a468fe7c08a6cb46a66fdd57a0da3,3,33,3,30,0,0,0,9,67,35,1,2,0.716175748,3858,59,1,1098,1095,3,28298,28199,99,261,260,1,100
81cb7e17f98946e4455e055f075d958900c2f576,2,51,0,51,1,0,1,1,18,22,1,2,0.322756959,643,60,2,134,133,1,4077,3997,80,85,84,1,99.96744085
99bf6d14f8f9097fe4298475f8653608a224cbca,0,0,0,0,0,0,0,0,0,0,0,0,0,0,61,3,0,0,0,0,0,0,0,0,0,100
94f233f0d813cb6d7b1becde6a1367c8e93f1d8f,0,0,0,0,0,0,0,0,0,0,0,0,0,0,62,4,0,0,0,0,0,0,0,0,0,100
8de471e541db40d7addf3d245e39fc97629869e8,0,0,0,0,0,0,0,0,0,0,0,0,0,0,73,1,0,0,0,0,0,0,0,0,0,100
07d26ee05aa0ef4eb29f842c945283e6247d7c4b,3,190,0,190,3,0,3,1,1,0,1,1,1.392109939,0,11,9,13,0,13,448,0,448,12,0,12,99.92410279
eaf452dcc266505f148c28b3558f5e052df6d89f,19,1208,66,1142,12,0,12,1,3,7,1,5,3.820965513,1214,68,5,392,251,141,12126,7717,4409,181,110,71,99.50059711
763fd3e5a3fb2c4fb634b238610ab02000c5a822,1,14,0,14,1,0,1,1,1,0,1,1,0,0,69,6,1,0,1,84,0,84,1,0,1,99.97824668
68f25ced8476904f212e35ace817b706cb4ba453,2,32,6,26,0,0,0,1,3,10,1,2,0.998000884,259,70,7,42,39,3,1883,1646,237,18,17,1,100
7ca1cfe20c1aadfc2ce5230fd4c8d13deea9a093,1,10,1,9,0,0,0,6,27,50,1,1,0,151,6,1,22,21,1,975,963,12,7,6,1,100
4b45bd587755c0f5c7f7f3eb992e2c90abdca471,1,4,5,1,0,0,0,6,12,21,1,1,0,292,10,0,65,66,1,2092,2117,25,20,20,0,100
caa400cbb335869941d547038008b23f6a7769d5,1,0,1,1,0,0,0,6,21,65,1,1,0,861,19,0,233,233,0,6214,6216,2,43,43,0,100
8a811f69ea4908955a2c07699110e51135098700,10,94,23,71,0,0,0,1,4,8,1,3,2.926203795,1442,71,8,309,300,9,9460,9038,422,122,120,2,99.94562262
11fba5a6123d00c60474673ecf55481f25b25ad5,0,0,0,0,0,0,0,0,0,0,0,0,0,0,72,9,0,0,0,0,0,0,0,0,0,100
3d2cbcb7a9eba556bb0dace51df0daba0843b148,1,3,2,1,0,0,0,1,5,0,1,1,0,209,73,10,33,33,0,1453,1436,17,13,13,0,100
1c0b264517c0f07ec91eeb9c94139d447c208c18,1,10,14,4,0,0,0,1,4,0,1,1,0,431,74,11,106,106,0,2890,2916,26,45,45,0,99.35282303
1c738c44122bf4b79bd61c058851803e1d445440,0,0,0,0,0,0,0,0,0,0,0,0,0,0,365,7,0,0,0,0,0,0,0,0,0,100
ff42968eed5a7a90fcb4245f6b25bce56659d150,1,18,0,18,0,0,0,1,2,3,1,1,0,12,75,12,1,1,0,84,84,0,1,1,0,100
325aa77bc15aaa0dc0c0118186525af232f2be36,677,81626,447,81179,676,0,676,1,12,1,2,38,8.840306233,934,366,8,7248,223,7025,334536,6655,327881,5476,90,5386,73.9241043
d2f5b73e91268dd4cb5b0f57b11794029eea4709,0,0,0,0,0,0,0,0,0,0,0,0,0,0,367,9,0,0,0,0,0,0,0,0,0,100
3735e9a54e3670d778afd56fae8d0d1f5e11cc35,0,0,0,0,0,0,0,0,0,0,0,0,0,0,368,9,0,0,0,0,0,0,0,0,0,100
1b74811ed9742ff972caca854d3d3aaa04f82532,2,0,79,79,0,0,0,1,2,0,1,1,0.948410389,70,369,10,0,4,4,0,379,379,0,2,2,93.93078512
699f06e06c7e07a37442bf7534aa02e3873d3f96,0,0,0,0,0,0,0,0,0,0,0,0,0,0,370,11,0,0,0,0,0,0,0,0,0,100
31778f01a870ec37820def46e4dd802a8fd8eb66,1,12,4,8,0,0,0,6,28,4,1,1,0,159,7,2,23,22,1,987,975,12,8,7,1,100
4ab1384b430897c394ebf24d2d3d39c74152c1d8,1,2,10,8,0,0,0,1,2,1,1,1,0,77,371,12,5,5,0,318,383,65,4,4,0,99.92359997
7d44e7a355b9611f37ed0122f4a3e69bdfb335ab,99,320,225,95,1,0,1,1,41,1,2,8,4.990913414,8759,372,13,1264,1251,13,45646,45057,589,821,817,4,98.23445318
de8a4760c8b7df2186cd831733b8fdc095dbc736,21,122,937,815,0,0,0,1,68,133,3,8,1.990666502,12064,373,13,3269,3277,8,77311,80231,2920,891,897,6,99.97313994
c457053f9459293915fb41d1cdea09e014a0175d,20,242,1274,1032,0,0,0,1,6,7,1,3,3.567809167,2727,76,13,453,584,131,13194,16747,3553,210,279,69,99.5347269
161527339af62ec2b0cd4dafc663cde6dc59041a,2,7,1,6,0,0,0,6,69,7,1,1,0.543564443,3846,63,5,1134,1133,1,28348,28304,44,251,251,0,100
a7648a78c557498082be8b00f6e637066223d5e0,3,4,1,3,0,0,0,1,4,7,1,3,1.521928095,960,374,14,195,195,0,6382,6359,23,88,88,0,100
ec7bd83e1afb1f08ff8f809331526c5186f61b62,1,14,3,11,0,0,0,4,12,209,1,1,0,144,64,5,35,34,1,951,904,47,10,10,0,100
6bb87e620310fbd6be0493485dca9e9bc910985c,3,3,3,0,0,0,0,3,19,251,1,2,1.251629167,1370,375,10,218,218,0,8787,8789,2,103,103,0,100
1d57a1fdaac3f984a582b250244c811a7d7ed58d,0,0,0,0,0,0,0,0,0,0,0,0,0,0,74,1,0,0,0,0,0,0,0,0,0,100
4c70963f1a990787ffa2495016b5142c0fbd0747,0,0,0,0,0,0,0,0,0,0,0,0,0,0,75,2,0,0,0,0,0,0,0,0,0,100
c5309299b58fc75bd2f537776c5cc1c2b1e97b02,1,61,1,60,0,0,0,3,8,494,1,1,0,111,376,11,41,28,13,934,615,319,22,20,2,100
699f043cd24ab24ff7445ce9d9486fb5c6be1298,3,113,2,111,2,0,2,2,2,30,1,2,1.106418574,48,377,12,16,6,10,520,135,385,12,6,6,99.9594046
c3e2f01204f028ef4563d17cd192a15bead36f27,1,12,20,8,0,0,0,2,3,23,1,1,0,206,8,2,14,14,0,1257,1234,23,8,8,0,100
c4af04617ebb18551f6cf57e80b798e110da18a6,4,171,1,170,3,0,3,1,18,82,3,3,1.75591892,910,9,3,325,316,9,7036,6628,408,75,69,6,99.82446665
e097063b0a2079bd03fc680dacf30782c35305e6,1,1,1,0,0,0,0,1,2,332,1,1,0,57,378,13,7,7,0,348,348,0,4,4,0,100
177111b5598e4301c2d4e2de7c86b7e0a8acef88,1,1,1,0,0,0,0,6,9,104,1,1,0,269,10,4,67,67,0,2112,2112,0,16,16,0,100
66d6230a417972e229a60375201f788e8085dde2,2,21,0,21,0,0,0,1,5,485,1,1,0.998363673,145,379,8,17,15,2,882,749,133,15,13,2,99.97977755
9ece24ade3a94b1227bfd40ae9b37b9def386291,2,42,2,40,1,0,1,1,32,43,2,2,0.439496987,1223,380,8,373,370,3,9274,9174,100,101,99,2,99.98651928
527b09ce6ecde12d1037a8ef9a86312d3dbe6971,1,2,1,1,0,0,0,4,10,317,1,1,0,230,65,2,54,54,0,1679,1672,7,9,9,0,100
a4600fbe98636abf2f72904852008ea09b8793bc,2,116,2,114,1,0,1,1,14,119,1,2,0.213579815,153,66,3,49,40,9,1498,1166,332,19,10,9,99.89236461
ca9828726d333c043d4a3a97d5276f97591077c2,1,1,2,1,0,0,0,4,15,7,1,1,0,154,67,4,40,40,0,1166,1170,4,10,10,0,100
7487d735074888a211080ea8cb23296b86a4ab41,1,1,3,2,0,0,0,5,10,119,1,1,0,483,381,6,161,162,1,2960,2968,8,83,83,0,100
c3ad06e8ff12a3f1836114695adfb8c4f9ddeaa7,1,2,2,0,0,0,0,5,15,78,1,1,0,283,11,3,78,78,0,1667,1667,0,30,30,0,100
64402ea7daab354dbffa85e029dc7df739c1df66,4,193,213,20,0,0,0,7,12,105,1,1,1.178922327,423,12,4,66,77,11,2200,2615,415,18,15,3,97.64829332
1b76c6df24d3c731b475e0ede5a56dcec6b89d3e,1,1,1,0,0,0,0,5,22,317,1,1,0,380,382,7,104,104,0,2328,2328,0,42,42,0,100
f67ace749ae8e55cd9dc85b5c989353ea4b05899,1,1,1,0,0,0,0,8,20,36,1,1,0,647,13,5,133,133,0,4024,4024,0,84,84,0,100
86e17fc21069e755f498ac6cc30c3aa687cc7960,1,1,1,0,0,0,0,6,33,12,1,1,0,1223,383,8,370,370,0,9178,9174,4,99,99,0,100
777818d28332d67a9716d91b1dc8ec900d986b2d,1,27,18,9,0,0,0,3,12,507,1,1,0,204,384,9,46,44,2,1231,1169,62,12,12,0,100
f3dd4c039797ee3498d5bffeac16415474680216,5,206,1,205,3,0,3,1,31,86,2,3,1.878403659,1503,385,10,515,493,22,10351,9374,977,191,175,16,99.96003882
126358f0e4f9aa200fb4e880fde8437295dbf071,2,10,4,6,0,0,0,3,15,282,1,1,0.749595257,618,386,11,169,166,3,3748,3714,34,87,87,0,100
b4d72d5843aab0d7b08b28e0bf07859a47419c67,12,5,35,30,0,0,0,7,57,264,3,6,3.52304692,9336,14,6,2156,2176,20,71279,71465,186,544,544,0,100
85c7a33365815ecc5b630ae5ce9b51f60b2ad7cb,3,54,0,54,0,0,0,1,2,0,1,1,1.584962501,135,387,12,18,18,0,903,903,0,14,14,0,100
ba5d11b43b0d6182812998c347a94d4af768c6fe,1,21,10,11,0,0,0,7,35,1,1,1,0,493,15,7,141,139,2,3621,3565,56,25,24,1,100
282c8e0c5b8b7a0035d437405fb848b93935ab90,2,98,4,94,0,0,0,1,20,330,2,2,0.462749059,388,388,9,98,85,13,3000,2575,425,32,27,5,100
d93ac261adc022453b16d2879805057fd6205773,2,4,4,0,0,0,0,5,18,874,2,2,1,185,16,6,35,35,0,990,990,0,21,21,0,100
4bed57d778e9478d2e823f65666c4168be37e542,0,0,0,0,0,0,0,0,0,0,0,0,0,0,389,10,0,0,0,0,0,0,0,0,0,100
aff3abd8ed44880a8369288cfa623db5c393c76b,1,2,2,0,0,0,0,3,11,116,1,1,0,97,390,9,8,8,0,548,548,0,6,6,0,100
5f0094893ea6783a6a7795679a35b250f6232198,1,1,1,0,0,0,0,3,11,455,1,1,0,86,391,4,0,0,0,516,516,0,0,0,0,100
b949f7adc591c3fd7af601037325929e60afe8d0,1,1,2,1,0,0,0,4,11,59,1,1,0,231,76,0,54,54,0,1672,1679,7,9,9,0,100
635ee199fef8533ed5a176e07d40b75dc8a66074,0,0,0,0,0,0,0,0,0,0,0,0,0,0,68,0,0,0,0,0,0,0,0,0,0,100
831bd55051cccfaad51dde9923e19584d236062f,2,33,6,27,0,0,0,4,70,74,2,2,0.6789539,3143,69,1,944,941,3,23352,23293,59,220,218,2,100
57ca9afbdd20903f4fab7d14f876f34d6f911e85,4,7,8,1,0,0,0,2,7,404,2,2,1.96559623,537,11,0,87,87,0,3914,3906,8,35,35,0,100
438b877006e9d71d683d12f95f975e2355878784,1,4,2,2,0,0,0,7,23,96,1,1,0,861,12,1,233,233,0,6227,6221,6,43,43,0,100
2d0a3c91578d9994dca0204abcb463e9fa548828,1,6,4,2,0,0,0,7,24,8,1,1,0,863,70,2,233,233,0,6249,6227,22,43,43,0,100
9dadffffc19228783088509e22c2d42181d02295,1,15,5,10,0,0,0,6,13,116,1,1,0,291,71,3,64,65,1,2085,2092,7,20,20,0,100
6af619cd891e793efe4c239f4e4815b89d119d49,1,5,9,4,0,0,0,5,12,702,1,1,0,226,77,1,37,37,0,1208,1229,21,23,23,0,100
b2c1e8f16ffb4fa129249ba88deba4d762adc6c3,77,18384,25236,6852,3,0,3,1,65,563,5,23,4.606211282,22545,392,4,4516,5380,864,122519,141552,19033,1616,2007,391,99.40486409
608a906aafd965e5c0bb8877f7d41be43b443874,0,0,0,0,0,0,0,0,0,0,0,0,0,0,78,2,0,0,0,0,0,0,0,0,0,100
dbb722f5eca9d0e8b45080adb38faa939ac105f7,1,0,3,3,0,0,0,7,25,5,1,1,0,865,13,2,233,233,0,6242,6249,7,43,43,0,100
315a34884886d0718761e39611b71112b4c9dbc2,3,83,1,82,1,0,1,1,20,65,3,3,1.300059781,996,17,0,343,336,7,7288,6960,328,89,85,4,99.97705633
1b8ccc624535f77995636062f8a684f6618b585d,2,4,4,0,0,0,0,4,21,0,2,2,0.811278124,1011,18,1,341,341,0,7036,7036,0,87,87,0,100
6b5e0c6967d20d19e77954cdbc8ccb4367c86f00,1,3,3,0,0,0,0,3,9,20,1,1,0,61,393,2,9,9,0,327,335,8,2,2,0,100
6aa8fd3c35857d83ca7b0a5f7c66938f537d9912,1,6,6,0,0,0,0,6,33,23,1,1,0,1636,190,0,487,486,1,10466,10459,7,169,169,0,100
79b23557d3e9ee16dbd11a52d82a64aec45c7039,1,1,2,1,0,0,0,2,2,25,1,1,0,231,72,4,54,54,0,1672,1679,7,9,9,0,100
999ce2e670eef2def0a0b89f4bb62dbe74b6a4fa,7,324,0,324,5,0,5,1,42,46,2,2,2.430017656,1252,394,2,413,381,32,9237,8529,708,131,110,21,99.91407951
ee8155bb60ddfdc94e94b8973455c599072a6c27,1,0,6,6,0,0,0,6,29,141,1,1,0,167,19,2,23,23,0,952,987,35,8,8,0,100
36c68c49f59f948967d31f690c7858b40bcea3a9,1,12,7,5,0,0,0,8,50,166,1,1,0,613,14,3,144,139,5,4260,4240,20,34,34,0,100
dd7014a527968468f63b2dcb37a2f9175b0c9492,1,18,8,10,0,0,0,6,22,655,1,1,0,525,395,3,139,138,1,3813,3706,107,21,21,0,100
690cb80eb9682a71dd72e8d09df0ef35ade309e3,1,1,1,0,0,0,0,4,22,682,1,1,0,268,396,4,54,54,0,1668,1666,2,23,23,0,100
1b5aac791d776726ada8fdc6b39ec71d13262f3e,1,2,0,2,0,0,0,8,23,32,1,1,0,774,20,3,238,238,0,4542,4534,8,121,121,0,100
9c19356c7c2b5690c8b487b4ee05ba92297847c4,2,9,4,5,0,0,0,3,12,870,1,1,0.89049164,469,191,1,118,118,0,3593,3567,26,85,85,0,100
ea8b942364fce79b0fae42b9ac94be7c3f58907b,1,9,2,7,0,0,0,3,3,329,1,1,0,86,192,2,11,9,2,480,455,25,6,6,0,100
8803104f41504069e171cbe47c5e4fbc7fd63cb2,0,0,0,0,0,0,0,0,0,0,0,0,0,0,397,4,0,0,0,0,0,0,0,0,0,100
5196ae0bc27d4d50ef468aa9b5334155c89a8dcb,1,2,2,0,0,0,0,8,36,269,1,1,0,1296,21,4,415,415,0,9415,9415,0,68,68,0,100
50b81e6d7706d8f28aab8110086b1d7f114c1b45,8,127,8,119,0,0,0,7,34,648,2,4,2.462584413,3400,15,1,927,902,25,26060,25555,505,250,242,8,100
810e401dbe638f655e9e72cd52e0209853a7a0b6,3,197,0,197,2,0,2,1,4,140,1,1,1.235549362,80,22,5,28,8,20,1300,357,943,20,8,12,99.97139424
07cd1728a1148a37bb64216241d3bde4330ec5ba,1,30,0,30,0,0,0,2,2,166,1,1,0,117,16,2,12,10,2,819,699,120,9,7,2,100
31c47a6c04a3c7d024ccd1318ca06e7696c222e8,1,4,4,0,0,0,0,8,37,18,1,1,0,1296,23,4,419,415,4,9463,9415,48,68,68,0,100
fe45f77f038d058b28c4b667cf91e4e13161489f,2,9,6,3,0,0,0,4,26,336,2,2,0.970950594,1317,73,0,293,293,0,8461,8446,15,94,94,0,100
316ced44c4537a9c3b1e7e11a7e06a0038465a14,1,2,1,1,0,0,0,4,10,0,1,1,0,455,74,1,60,60,0,2210,2210,0,51,51,0,100
a35b53b27f1ad9b72ac2ae715031f5dfccd9b1e9,1,9,2,7,0,0,0,6,25,519,1,1,0,460,75,2,112,111,1,3004,2976,28,51,50,1,100
016f0bf61ecbfcacbbfe94a7bf5f3754440f7245,1,9,1,8,0,0,0,6,26,0,1,1,0,463,76,3,112,112,0,3004,3004,0,51,51,0,100
a08388e8bedfe098bdd88919c935089af90469aa,0,0,0,0,0,0,0,0,0,0,0,0,0,0,79,0,0,0,0,0,0,0,0,0,0,100
2ba16b488a9bd2fcab2865871e469a00f1dd5b1c,1,10,6,4,0,0,0,9,51,56,1,1,0,618,24,3,144,144,0,4284,4260,24,34,34,0,100
18a3db781b0e3275f83f9cd4b014c06f8f43af47,9,174,64,110,1,0,1,1,43,310,3,5,2.53112921,4612,398,0,1374,1355,19,31126,30640,486,574,568,6,98.59480612
d78e76aa5addbfdfa92fa5fc93142c325c250ab1,1,1,1,0,0,0,0,5,7,44,1,1,0,368,25,2,86,86,0,2939,2938,1,17,17,0,100
bd2afc3f70b3fc8f1f132403dfc7ae98fb5a0a60,9,441,107,334,1,0,1,4,18,541,3,4,2.553200355,1511,77,4,280,258,22,8961,8046,915,145,134,11,99.90796417
a2beac443c14c6952394428b5a4ea065133e334a,1,1,1,0,0,0,0,1,2,0,1,1,0,53,78,5,5,5,0,204,204,0,3,3,0,100
a5c80fd9e16d7a0fe47a3069b7435a4141165780,0,0,0,0,0,0,0,0,0,0,0,0,0,0,26,3,0,0,0,0,0,0,0,0,0,100
78ff71749c19643a0b74f0a68e1c351f262106b3,0,0,0,0,0,0,0,0,0,0,0,0,0,0,79,6,0,0,0,0,0,0,0,0,0,100
0f32d376687fd1515a4cd9b8953e14b666499e93,13,1287,107,1180,2,0,2,1,33,412,3,6,3.089252786,6847,80,5,2108,1937,171,54206,47885,6321,808,756,52,99.97553816
14eeab2c00efc8df2ad15b35136e85c63852158c,1,8,2,6,0,0,0,2,3,234,1,1,0,230,17,0,18,18,0,1573,1544,29,17,17,0,99.98165923
40fec0073eed73711f9f92b334fe716929057434,0,0,0,0,0,0,0,0,0,0,0,0,0,0,81,4,0,0,0,0,0,0,0,0,0,100
efcc2577a608e944098c4aa727f4d4b0f5867585,2,7,5,2,0,0,0,7,35,78,1,2,0.979868757,1326,82,5,389,389,0,9818,9790,28,104,104,0,100
a31dfaa31f4181956b7430fb9ec590b68ffd2c8e,4,197,4,193,1,0,1,1,20,321,2,3,1.239660657,752,83,6,217,205,12,5515,4742,773,73,63,10,99.96332742
33e094c6f1aa4e900bd5a149f8b1d718640d9c1b,3,101,3,98,0,0,0,2,36,166,2,3,0.796465549,1410,77,0,406,395,11,10588,10074,514,129,122,7,99.9755546
63850bed0bf56ae1a6527cdf8efc8890cbeadbef,2,0,2,2,0,0,0,7,37,3,1,2,1,1328,18,1,389,389,0,9804,9818,14,104,104,0,100
b796e1710f4572bee7e20f8e7c2851205ddbb8b2,1,7,4,3,0,0,0,3,3,195,1,1,0,202,19,2,42,40,2,1267,1237,30,6,6,0,100
3f9dcdbb761fa29847e028db7cc6309966028659,1,5,2,3,0,0,0,7,38,2,1,1,0,1231,20,3,373,372,1,9253,9234,19,99,99,0,100
b585833c0c69866d50fbc8edb441ae2364a50df6,1,2,2,0,0,0,0,3,4,2,1,1,0,205,21,4,42,42,0,1269,1267,2,6,6,0,100
df0902d4cf600a5abf4172fa86e5b4d397e7aa6a,1,0,3,3,0,0,0,4,6,465,1,1,0,186,84,5,32,32,0,1006,1010,4,12,12,0,100
31870894320c738e8d7776382892305d9b99b94d,1,11,7,4,0,0,0,5,10,879,1,1,0,315,22,5,92,92,0,2205,2176,29,13,13,0,100
d35bc879cbce9b8a241efee9c9ebe62664605927,0,0,0,0,0,0,0,0,0,0,0,0,0,0,85,6,0,0,0,0,0,0,0,0,0,100
01e08029e93ceb75f24297fc3471f3afe299620d,1,3,1,2,0,0,0,7,39,2,1,1,0,1234,23,6,373,373,0,9264,9253,11,99,99,0,100
5a16e92bd964f4e7afd08af2a133c83ef0be44a0,1,93,43,50,0,0,0,3,5,3,1,1,0,205,24,7,55,42,13,1462,1269,193,15,6,9,100
a63b6d3e73e2a71549e401015f6426bc5dd1a262,0,0,0,0,0,0,0,0,0,0,0,0,0,0,27,0,0,0,0,0,0,0,0,0,0,100
c27bed9d7b3d2f14eddc7d8ca4a159ee544aa661,3,192,0,192,3,0,3,1,1,0,1,2,1.559843138,0,399,0,16,0,16,810,0,810,16,0,16,99.95723624
4ac794ee69824a61b24c9e6b64890be63514150e,1,14,8,6,0,0,0,2,2,1,1,1,0,68,86,7,3,2,1,502,468,34,2,2,0,100
956065baa001a4c69149d666566e9343d173b4c7,1,2,1,1,0,0,0,3,6,13,1,1,0,245,25,8,55,55,0,1468,1462,6,15,15,0,100
b4ac7e2f415bf1640c9b308da6763bb4952d2e0c,1,1,1,0,0,0,0,6,12,210,1,1,0,982,28,1,277,276,1,7093,7084,9,62,62,0,100
8c756bf65566e8ed69794a03c10716b1c3d83350,1,1,1,0,0,0,0,8,24,134,1,1,0,775,87,6,238,238,0,4542,4542,0,121,121,0,100
3a5e61238d9e472053230df7a46e79f9ec3c3c37,4,284,1,283,2,0,2,4,71,125,2,3,1.302998135,3048,88,5,948,911,37,23379,22368,1011,250,214,36,99.9877885
b3f87ba1ec0288c6b6dabf2c15c2a8c5c66f9cc9,1,3,1,2,0,0,0,7,34,147,1,1,0,1638,26,8,487,487,0,10491,10466,25,169,169,0,100
99a69bef3315bc0434be8a54281b3f1802fbe6f8,1,17,0,17,0,0,0,7,13,18,1,1,0,982,27,9,282,277,5,7251,7093,158,62,62,0,100
689eec175b9b0743785fec5db31cada6bd1fea59,2,35,8,27,0,0,0,4,7,621,1,2,0.933025295,217,28,10,39,35,4,1268,1086,182,17,15,2,99.99389574
b2bd03567df6a5f3b936f65288bd84df9ebeca97,3,17,15,2,0,0,0,4,72,0,1,2,1.389355747,4188,29,11,1220,1220,0,30426,30510,84,287,285,2,100
b2ba44fcfd365b03c2e53e5cc4aa1226a0a7f7a3,0,0,0,0,0,0,0,0,0,0,0,0,0,0,89,6,0,0,0,0,0,0,0,0,0,100
11f4d0d7ad451519c662521d289c3853eb2cd61b,1,9,6,3,0,0,0,4,14,172,1,1,0,232,29,2,54,54,0,1483,1458,25,26,26,0,100
47f681a7b504c0a5ebed6e7bce44bcd1f7d236ae,4,12,19,7,0,0,0,5,10,810,1,1,1.533107672,212,30,10,31,30,1,899,966,67,27,27,0,99.99389574
8a56c75597fbc4d7ff1291e1a7ab9947053b6180,1,7,2,5,0,0,0,4,9,2,1,1,0,199,31,11,37,37,0,1152,1112,40,14,14,0,100
72df500c6e4eb583bfc5dd826c7c343a800b8be2,1,33,7,26,0,0,0,3,7,24,1,1,0,246,32,12,59,55,4,1569,1468,101,15,15,0,100
dcada1323742967f4e066cc88ac1d9ed46f16102,1,5,1,4,0,0,0,7,23,144,1,1,0,532,33,13,140,139,1,3841,3813,28,21,21,0,100
81fc3ab6051257667d115e120de98ed650d4d54d,1,4,0,4,0,0,0,4,10,2,1,1,0,203,34,11,37,37,0,1160,1152,8,14,14,0,100
93e15d846c2338b979d8a08408bce95c31c4598f,1,3,1,2,0,0,0,3,8,2,1,1,0,259,35,12,61,59,2,1591,1569,22,15,15,0,100
534778acf8a25814e153af4ea88d636b011ab2c0,5,783,0,783,5,0,5,1,1,0,1,2,1.851951081,0,78,0,77,0,77,2435,0,2435,52,0,52,99.91461332
1ad21f614c3f40cbc115fb1ac4c4a7d47b58d452,1,23,6,17,0,0,0,1,2,0,1,1,0,261,79,1,46,47,1,1798,1813,15,22,22,0,100
8f97a2aea35130f6eea10fc12d210e5c6985a7e2,1,1,1,0,0,0,0,1,2,506,1,1,0,87,80,2,16,16,0,557,555,2,5,5,0,100
45693d4e7ac426b9ea68565e7a04413a2c6d551d,3,59,75,16,0,0,0,1,66,72,2,3,1.094372904,4357,81,3,1224,1232,8,27412,27610,198,312,313,1,100
2d217257d9a6e169d8ea1aea9e2f906192d16784,1,1,0,1,0,0,0,5,8,668,1,1,0,177,36,11,44,44,0,1211,1207,4,10,10,0,100
c1e5f27724f3b4a39d9624a8758d56c2a3ee6b0f,1,9,0,9,0,0,0,6,13,105,1,1,0,221,37,12,41,39,2,1581,1495,86,8,8,0,100
dbbd1236f235a86f672b3f21bedaf2ee5672b34c,6,1312,1171,141,0,0,0,4,35,681,2,4,1.677276648,2947,38,12,839,795,44,20717,19686,1031,323,314,9,97.83650732
faa0f26cddae6869271257634c6b5b74689fc345,11,313,94,219,0,0,0,4,20,944,1,2,1.56379198,1497,39,13,341,299,42,12686,11145,1541,168,140,28,100
93417f99e370124cf2e4dfc5a8988b14ae061eaf,4,41,14,27,0,0,0,7,73,40,1,3,1.688263717,4357,40,14,1242,1240,2,31683,31629,54,279,277,2,100
d1aa6a2c48ad00711befb7d237a435ddd1c3973a,1,1,1,0,0,0,0,7,28,0,1,1,0,876,41,15,237,237,0,6316,6316,0,44,44,0,100
48b1fb5a370ea5969116332cb486c95e4934c77d,6,58,4,54,0,0,0,4,21,413,1,2,1.607472411,1103,42,16,261,246,15,9250,8724,526,91,86,5,100
89b296fd544c25a36d0abb11f6cd0b6333542068,2,55,17,38,0,0,0,4,14,258,2,2,0.88797632,450,82,4,91,90,1,3204,3023,181,34,33,1,100
794305c2f1372a70cff0071ec71cc70b9ca9f78e,4,94,18,76,0,0,0,1,42,292,2,3,1.774379173,2200,83,5,431,423,8,14533,14151,382,251,246,5,100
1fda19f8b7f147a70ac79b4ee642c032e2905a5d,1,3,3,0,0,0,0,6,24,0,1,1,0,287,84,6,0,0,0,1931,1931,0,0,0,0,100
8a80d753a31e71ce07f24e7069b7ff5e71e30c03,3,28,29,1,0,0,0,4,74,61,1,1,1.24560943,3845,43,13,1090,1089,1,27776,27746,30,259,260,1,100
ffbc73ffa6d85735666fd0ec98ae30f418d42d93,1,2,1,1,0,0,0,5,8,706,1,1,0,640,90,0,189,189,0,4523,4518,5,32,32,0,100
a4d905f3455ee6b6f2a594baf1961cc73234fffe,3,19,2,17,0,0,0,4,75,8,1,2,1.267770216,3870,91,1,1140,1137,3,28098,28049,49,260,258,2,100
110e3ff4b02aa1482d3f0e931539bbf616b006bc,1,2,1,1,0,0,0,3,10,35,1,1,0,255,30,0,58,57,1,1539,1528,11,15,15,0,100
ddc42e807837f340306dbbf2e9f04255f8437539,1,9,1,8,0,0,0,9,53,17,1,1,0,615,44,8,143,142,1,4290,4250,40,33,33,0,100
63c48992274fce84b2c08bf8bbe6df024736557c,8,463,3,460,7,0,7,1,11,158,2,2,2.733181049,280,85,3,95,74,21,3471,2401,1070,33,16,17,99.88950276
d965db72710b34fb1547dc616caedaaf75af565e,3,41,7,34,0,0,0,3,11,199,1,1,1.208215626,341,45,7,70,62,8,1995,1785,210,19,19,0,99.93790534
f1ac625b2c931ee1cb99e4eb98fdcbd8d523b781,2,5,1,4,0,0,0,8,53,829,2,2,0.918295834,2354,86,4,727,726,1,15611,15587,24,218,218,0,100
545c6732c887dc77040eff00fc0dad89312d6729,2,2,2,0,0,0,0,3,4,0,1,1,1,115,46,7,12,12,0,458,454,4,4,4,0,100
981c023e0eef7b60570a59fc5ba992804f7bb7e8,0,0,0,0,0,0,0,0,0,0,0,0,0,0,92,2,0,0,0,0,0,0,0,0,0,100
b589da8070870f1ed50f8c50c715962323220ed6,3,159,49,110,1,0,1,1,58,229,2,3,1.16040664,3314,400,0,708,705,3,27108,26660,448,136,133,3,99.97240237
4d668a44dd3ced73ac00d9846ed608423b3cb790,1,2,2,0,0,0,0,2,9,236,1,1,0,421,401,1,88,88,0,2284,2278,6,50,50,0,100
8fb7ca2b5b1777fcf96e123368ba3f4c31da6cb5,2,11,6,5,0,0,0,1,5,663,1,1,0.787126586,355,402,2,71,71,0,2286,2244,42,26,26,0,98.93595391
96dd926f4ae1073067637009ed88cbe2a103e1fb,6,182,5,177,1,0,1,3,67,364,3,3,2.267105158,6065,403,3,1659,1643,16,36649,36023,626,638,629,9,99.96005858
6f6634bbadcd9649e60474bce9c54473c4db34b6,1,2,1,1,0,0,0,6,28,0,1,1,0,1089,404,4,283,283,0,6723,6716,7,198,198,0,100
8db8e5302edd28abe8b5d324b43c9f89a273f3b7,4,272,79,193,0,0,0,1,7,236,1,2,1.353866597,508,405,5,109,81,28,3890,3075,815,61,54,7,100
547438ed18be883a33b5b8175ca0e72a8225c64c,5,21,6,15,0,0,0,6,38,721,2,4,1.652978954,2605,406,6,790,786,4,18423,18337,86,191,190,1,100
e8702b1ed361253335472ac7431d600890219bd6,4,59,14,45,0,0,0,10,68,386,1,2,1.264607886,5258,407,7,1415,1407,8,32298,32091,207,526,522,4,99.98669682
f17afddbd61836465de97ebc985a0170f062734f,2,31,20,11,0,0,0,1,3,0,1,1,0.999722648,375,408,8,70,67,3,1983,1950,33,43,42,1,100
97a94847f6c6620b934255f2ecf30bb9493e11c5,5,85,27,58,0,0,0,1,76,504,2,3,1.943329447,4328,409,9,1221,1210,11,32101,31665,436,292,288,4,100
c9c6aadc8599b8b3392d4c5dbc6b7c9ba9673e8d,0,0,0,0,0,0,0,0,0,0,0,0,0,0,410,10,0,0,0,0,0,0,0,0,0,100
1ac94263ac362cf4a75b364588dda48529c2d12a,2,35,4,31,1,0,1,1,44,0,1,2,0.73206669,1140,411,11,244,244,0,6743,6705,38,206,206,0,99.98670213
f183c42b90690fd31f7d1fd12cd92fbb0ef17459,1,1,1,0,0,0,0,5,12,105,1,1,0,101,412,12,23,23,0,373,373,0,20,20,0,100
753be68e244bc14ec66807ba6457d1fa2211d9c6,7,521,1,520,6,0,6,1,14,0,2,3,2.498253161,383,413,13,170,136,34,4925,2984,1941,44,11,33,99.90701382
1a45d110a24eb8b2d8f1189100bff289201b3b12,9,252,28,224,0,0,0,1,77,678,2,4,2.069320755,5767,414,14,1537,1497,40,41536,40003,1533,589,575,14,100
629977fb1c2a25ba7ce2dd38fe0062866f73b48f,2,38,2,36,0,0,0,4,78,74,1,1,0.168660931,3235,415,15,961,953,8,23977,23753,224,229,228,1,100
5ee728e3327f4754f73381b10f13505bb243a27d,1,12,0,12,0,0,0,1,2,236,1,1,0,155,416,16,33,32,1,1016,985,31,7,6,1,100
12c0a094ee5976bf95253c04e5c3fb02f9221344,2,59,1,58,1,0,1,1,2,304,2,2,0.2108423,217,417,17,83,80,3,1762,1514,248,13,11,2,99.94026681
06ab9692d54c04d83f7da4e940bed16be3c70783,1,10,3,7,0,0,0,3,14,887,1,1,0,156,418,18,48,46,2,1080,1061,19,10,10,0,100
90332224f77bea9341d080d76e7d06b31471697f,1,20,5,15,0,0,0,1,4,0,1,1,0,202,419,19,46,43,3,1251,1166,85,16,16,0,100
ef098b3acdd46d28f91b162fdcfa027a9983866a,0,0,0,0,0,0,0,0,0,0,0,0,0,0,420,20,0,0,0,0,0,0,0,0,0,100
b3c7e8290c61cfc3ca72a4947f0ea28d5dd174ec,1,1,1,0,0,0,0,2,5,1024,1,1,0,57,421,21,7,7,0,257,256,1,7,7,0,100
0c346ba7ce5cb061ee8207193bc813140a39cc11,0,0,0,0,0,0,0,0,0,0,0,0,0,0,93,3,0,0,0,0,0,0,0,0,0,100
514a4bb907c5e6bbab34a758008240347ef11830,2,0,14,14,0,0,0,3,5,4,1,1,1,115,47,4,8,12,4,390,458,68,4,4,0,100
71519b08080107dae13867c760f224a2cde54b5b,2,124,57,67,0,0,0,1,69,20,2,2,0.910752544,3816,87,4,1106,1086,20,24343,23861,482,300,295,5,100
7ac8321f27ecea79ded5cfa8a7e20c6656c2e90d,3,244,0,244,3,0,3,1,1,0,1,2,1.541365952,0,88,3,20,0,20,845,0,845,16,0,16,99.95355318
e00c6e8f80434fd07b1dd438780cb3d964303392,4,247,2,245,3,0,3,1,11,29,2,3,1.616540842,319,89,4,111,92,19,3132,2205,927,25,13,12,99.95359321
a8e0dc180e8b360c4e72eca7c131b2826eceaedd,9,387,117,270,2,0,2,4,79,181,3,5,2.552859341,3892,90,5,1110,1071,39,29589,27991,1598,288,278,10,99.93377483
689d1c5385c326b9ca71ee428e75957ff719dbcf,0,0,0,0,0,0,0,0,0,0,0,0,0,0,94,4,0,0,0,0,0,0,0,0,0,100
f62ea1ab0d2922377368ca5d31bbcbea57ecbc3c,6,249,3,246,3,0,3,1,80,235,3,5,1.665383141,4387,91,6,1333,1312,21,33233,32360,873,337,322,15,99.94708645
d1a165bc613d54bd9ff9baa2ca0fbca8305b70f0,2,99,0,99,1,0,1,7,27,88,2,2,0.561028486,463,92,7,127,112,15,3488,3004,484,57,51,6,99.98678123
37cb4af35de27c75ac6f5acffaed0f1ba82cc12f,2,12,6,6,0,0,0,7,45,138,2,2,0.964078765,1643,93,8,388,385,3,10387,10320,67,231,231,0,100
fb78813259657a71df227168478c9c0b9e5488ae,15,409,27,382,2,0,2,5,70,614,4,8,3.081486947,5787,95,3,1670,1609,61,38243,36603,1640,441,410,31,99.97357294
976a5e1faf9df64b40ede8586c345def1454cf4e,1,9,0,9,0,0,0,4,6,41,1,1,0,200,96,3,37,37,0,1364,1340,24,13,13,0,100
82e61ba0d578fba28ae987cafdc29e3b211a45f7,2,944,6,938,1,0,1,3,11,162,2,2,0.077283457,421,80,0,253,88,165,5786,2284,3502,117,50,67,99.96038296
e3dbdac15947253e9073840e3759603e82380188,1,32,10,22,0,0,0,9,54,48,1,1,0,620,48,1,146,143,3,4412,4290,122,33,33,0,100
2b3f7ec90c3a834917232f4cdf27d00d0f62905a,3,1,8,7,0,0,0,5,81,53,1,1,1.224394445,3505,49,2,1017,1018,1,25399,25425,26,242,242,0,100
ff4a96e707337123c3e94ba641b504101dd05c79,15,557,105,452,3,0,3,1,23,660,2,5,3.407638127,6801,94,7,2037,1976,61,50964,48725,2239,528,508,20,99.91427064
6868b1cc4a104a7224510ad5be5869372ffbe80c,11,332,103,229,3,0,3,6,24,39,2,6,2.874573156,3942,95,6,1149,1136,13,29638,29134,504,226,219,7,99.91433843
d52998d0744c99c87110ae2657740eb20055b352,1,11,4,7,0,0,0,1,3,0,1,1,0,59,96,7,0,0,0,302,302,0,0,0,0,100
54d1a24320ffae8bada3281bf28d28490de284c3,1,31,30,1,0,0,0,3,6,9,1,1,0,74,97,7,14,14,0,305,296,9,10,9,1,100
bae08e93e4f310b5b6499c3ea4adc4f890761fc2,1,4,3,1,0,0,0,2,4,203,1,1,0,137,97,2,22,22,0,574,574,0,21,21,0,100
1aa44030d62809dd419f94f4d48dc353ee135952,2,883,7,876,1,0,1,1,10,187,1,2,0.074012162,269,31,0,251,67,184,5136,2112,3024,202,16,186,97.61294
de790be2adcdb631bc486f806ab42bef4e694ee0,5,155,7,148,2,0,2,4,19,512,2,3,1.929537177,1206,50,2,321,308,13,9919,9315,604,86,77,9,99.96123731
25a69ffe0a49d07e3db2533856737c7613d6d58c,4,278,9,269,2,0,2,2,20,200,2,2,1.623958044,758,51,3,174,143,31,6702,5493,1209,67,47,20,99.96901147
1ad09239b378a4c495a8a35cd61cda8b807b22d0,2,53,1,52,0,0,0,2,39,491,2,2,0.999010271,1614,98,7,515,506,9,11168,10851,317,147,143,4,99.95354599
50aaa9764abc4c606488b1c0493403a351b6a26a,1,4,1,3,0,0,0,2,5,0,1,1,0,103,99,8,9,9,0,643,643,0,8,8,0,100
13e48971736a7727f65293895c175ef992c30d1e,3,38,13,25,0,0,0,4,43,483,2,2,0.630594179,2468,100,9,793,784,9,16924,16798,126,237,235,2,100
2a588d6a2bcf8982dcc98aa0a8388740bfea8352,2,26,8,18,0,0,0,5,15,75,1,1,0.977417818,218,101,7,56,56,0,1281,1281,0,17,17,0,100
c7a906314641bc2a3f7d997422028686938c1d55,1,4,1,3,0,0,0,5,17,121,1,1,0,475,32,1,127,127,0,2855,2845,10,66,66,0,100
89e7531398352ba214faa845098ba773562bdc70,1,23,39,16,0,0,0,10,55,39,1,1,0,639,102,8,138,146,8,4352,4412,60,34,33,1,100
07919b9becd533a113949dce397a2d6ba1879f69,1,3,2,1,0,0,0,1,2,69,1,1,0,113,103,8,22,21,1,866,853,13,3,3,0,100
cc85528f693f18b625aa6bfc94c19583028e4582,3,27,2,25,0,0,0,3,15,869,2,2,1.563192201,415,104,9,84,80,4,2475,2314,161,37,35,2,100
026c96d5138612108237ed46c9b015006ecdf5ce,3,217,14,203,1,0,1,1,16,0,2,2,0.667792073,391,105,8,101,78,23,3094,2311,783,40,31,9,99.98452252
85b0b0b45b143f28ba4422107708f77aa710b160,2,10,7,3,0,0,0,5,17,0,1,1,0.977417818,394,106,9,79,79,0,2357,2330,27,32,32,0,100
b2812a4cce25e17a52519036f3a7a66298a4d1ef,5,441,2,439,4,0,4,1,34,43,2,2,2.286406269,2199,52,2,797,734,63,16967,15377,1590,316,272,44,99.9226844
436eefcbba8cc0eb8d0962b63a2e03d397f9e1ee,0,0,0,0,0,0,0,0,0,0,0,0,0,0,107,10,0,0,0,0,0,0,0,0,0,100
854eda8a197e09c206879aa84a64e84d9c075f72,1,3,1,2,0,0,0,8,54,100,1,1,0,2303,108,11,724,723,1,15304,15294,10,215,215,0,100
94814adc3985f88f0c421af765f18abda50f2b69,1,1,3,2,0,0,0,8,55,0,1,1,0,2305,109,12,723,724,1,15294,15304,10,215,215,0,100
434319cfee6140b6eac8cc136f039de50de59b83,3,80,0,80,2,0,2,1,56,0,2,2,1.237841069,2303,110,13,726,723,3,15464,15294,170,217,215,2,99.96138698
89695ec253f59efcafe9aafb2d14afb6f6fc2edb,2,17,2,15,0,0,0,1,35,2,2,2,0.629249224,2323,53,3,758,753,5,16090,16019,71,279,278,1,100
6e3aca63ec90da0198073a1697a556dbe493cbc2,1,4,1,3,0,0,0,7,8,522,1,1,0,701,111,13,205,205,0,4779,4772,7,103,103,0,100
efdbbd7a92403727019425cf1441b621bcd45403,1,3,0,3,0,0,0,10,71,64,1,1,0,3579,112,14,1058,1057,1,22149,22111,38,272,272,0,100
fec65630fd5b0d6759b0d921e01e201ab8dd1c0b,0,0,0,0,0,0,0,0,0,0,0,0,0,0,113,15,0,0,0,0,0,0,0,0,0,100
948c38e3329d56fa751835dbe0f89d910f775d9f,0,0,0,0,0,0,0,0,0,0,0,0,0,0,98,0,0,0,0,0,0,0,0,0,0,100
c7e78fc80dc0a37f48de261b67f4ccba50338c5e,5,18,8,10,0,0,0,4,9,715,1,2,2.031821334,1237,114,12,333,331,2,8212,8171,41,178,178,0,100
d58c648f8073db88c0cee62c3fb854caf4e8da65,0,0,0,0,0,0,0,0,0,0,0,0,0,0,12,0,0,0,0,0,0,0,0,0,0,100
f9a27b57c51605ccb1b64a30c219c3790eb407a7,0,0,0,0,0,0,0,0,0,0,0,0,0,0,13,1,0,0,0,0,0,0,0,0,0,100
b52e229a24eee5fa79a1c83e5b38f187ae691a54,0,0,0,0,0,0,0,0,0,0,0,0,0,0,99,1,0,0,0,0,0,0,0,0,0,100
ae2653996247585d74f41dc7e20e5d181a4c7835,0,0,0,0,0,0,0,0,0,0,0,0,0,0,100,2,0,0,0,0,0,0,0,0,0,100
4c0bf1be10ca50cf8a02fb2e7c58ff52f862ca5f,11,692,4,688,6,0,6,5,59,72,3,6,2.842273911,6630,115,13,1776,1701,75,52775,50227,2548,466,416,50,99.86123959
b4c557d0c052726037f32430f038d059fc9aceaf,9,523,2,521,7,0,7,1,10,52,2,3,2.86106384,883,116,14,296,239,57,8341,6486,1855,102,72,30,99.76910644
8cfa25c524d914ce02eef0df7435c8199931ff32,5,139,3,136,0,0,0,4,27,120,1,3,2.164826486,2952,54,2,761,736,25,21190,20581,609,332,322,10,98.02072837
2ed656a2a0bdf6bc719fab7d7870974fbe8b1fbc,1,18,0,18,0,0,0,2,3,35,1,1,0,114,422,0,22,22,0,866,866,0,3,3,0,100
37d610ca2ccf499479ea0cfb36ca91fcc5e0946e,9,197,34,163,6,0,6,1,21,154,3,3,2.738493265,1173,193,0,377,358,19,9341,8503,838,143,126,17,99.90544374
98802147f761d93873462aa6aa0038a8926ec421,1,6,9,3,0,0,0,7,11,3,1,1,0,488,55,3,105,106,1,3905,3922,17,19,19,0,100
62a8c5c32fabb111044748457b86357df962f74b,11,858,2,856,9,0,9,1,21,0,2,3,3.138787478,1438,56,4,456,359,97,14039,10676,3363,245,168,77,99.8585001
388754a28024505a7d523f066c112537e94fa831,5,90,0,90,0,0,0,1,2,0,1,1,2.321928095,69,194,1,17,17,0,517,517,0,14,14,0,100
315cc2d1555925da6f62b808976792676ec2bcea,2,30,9,21,0,0,0,3,82,96,1,1,0.619382195,3185,117,14,943,941,2,23411,23302,109,221,220,1,100
1111ee16ff9fdb72c7e5d12dd0afad6ddda2be5c,3,217,1,216,2,0,2,1,17,26,2,2,1.124953562,1197,118,15,466,441,25,10012,9321,691,75,54,21,99.95964216
0ed72e477aede848019da088446361fc9d82dbf3,0,0,0,0,0,0,0,0,0,0,0,0,0,0,423,1,0,0,0,0,0,0,0,0,0,100
134b37a753e7d250109a61adcc04547c1611cef1,0,0,0,0,0,0,0,0,0,0,0,0,0,0,101,3,0,0,0,0,0,0,0,0,0,100
997a094135bb07d9ae7f08764db4a18819eaf9b9,0,0,0,0,0,0,0,0,0,0,0,0,0,0,119,9,0,0,0,0,0,0,0,0,0,100
2254791f9b374a141a09782c1ee06bdee567e923,0,0,0,0,0,0,0,0,0,0,0,0,0,0,120,10,0,0,0,0,0,0,0,0,0,100
72b5b4def8efa363969427f24d614d72905e648a,1,4,4,0,0,0,0,9,83,12,1,1,0,3126,121,11,936,936,0,23086,23086,0,219,219,0,100
5fc632784f03b31ba961b2ee549f0f1ef5bc0d96,0,0,0,0,0,0,0,0,0,0,0,0,0,0,122,12,0,0,0,0,0,0,0,0,0,100
3d81f8652f85ffc83d728c92fc2262c64c64e17c,0,0,0,0,0,0,0,0,0,0,0,0,0,0,81,0,0,0,0,0,0,0,0,0,0,100
191f26d72d58b992ee7a6f82c6973681a3bdc275,3,15,1,14,0,0,0,3,84,535,2,3,1.419736718,3577,102,4,1030,1029,1,25823,25776,47,275,275,0,100
1cf3826ae8217fc6cac2e390a70e65b6b9a14d0b,0,0,0,0,0,0,0,0,0,0,0,0,0,0,103,5,0,0,0,0,0,0,0,0,0,100
64dbe4c9241e0360819a7e6fa77ead4d35d9d295,0,0,0,0,0,0,0,0,0,0,0,0,0,0,104,6,0,0,0,0,0,0,0,0,0,100
9174b3f1742e0d17eeaa874690cf2dca2752b97d,1,21,5,16,0,0,0,7,28,1028,1,1,0,1277,123,12,368,365,3,7875,7812,63,96,94,2,100
5f138fe08d3ab7a404f766c564ca58ff9b006801,5,320,0,320,5,0,5,1,1,0,1,1,2.153888532,0,124,13,17,0,17,966,0,966,15,0,15,99.91937651
adb9a6e3de600f51d4ea3ddf4070d892f97a0688,0,0,0,0,0,0,0,0,0,0,0,0,0,0,33,0,0,0,0,0,0,0,0,0,0,100
4af04f30d9a38628d5bfe88cb28219de61087f0c,5,388,6,382,3,0,3,1,13,112,3,4,2.156462059,1059,125,11,395,340,55,9135,7457,1678,162,134,28,99.95302959
68f051fccf0e33e1a822f7741efec3f0602ddf4f,28,2065,1,2064,26,0,26,6,22,15,2,4,4.172604649,1083,105,6,539,368,171,14392,7757,6635,213,81,132,99.59983994
c67f4e6054438dc053c69277e3dad25e530e627a,1,18,0,18,0,0,0,1,2,0,1,1,0,376,106,7,24,24,0,3117,3117,0,14,14,0,100
2d7faf24b1827f2465ff2f818d45678dd75ca7bd,0,0,0,0,0,0,0,0,0,0,0,0,0,0,107,8,0,0,0,0,0,0,0,0,0,100
3b91451d1669c3b8025730bcacc0e4f0d385eb61,3,42,13,29,0,0,0,1,2,30,1,1,0.448747124,284,126,11,35,33,2,1820,1582,238,27,25,2,100
6ae99af762b82f03a2a72df2e21aba0e6bf6f1c4,3,208,0,208,3,0,3,1,1,0,1,1,1.518163424,0,127,12,16,0,16,590,0,590,11,0,11,99.95359629
8cb82a6f330d3fb6032750fc94236ffaa43ad01a,3,26,30,4,0,0,0,2,20,561,2,3,1.270386255,1217,128,13,231,233,2,9077,9088,11,78,78,0,100
b29b9b6c7619e5785d80769881a16a95503bf79c,2,35,2,33,0,0,0,6,41,605,1,2,0.877962001,1899,129,14,615,611,4,13284,13110,174,163,160,3,100
bea15fff475ba4235b54925602b3ba7c53189cbf,6,281,2,279,5,0,5,1,41,22,2,3,2.338006895,1238,130,15,389,374,15,9899,9279,620,111,99,12,99.92716679
6d8a5879847076701ea01abd98b004d0e1836530,0,0,0,0,0,0,0,0,0,0,0,0,0,0,131,16,0,0,0,0,0,0,0,0,0,100
043b0596b888f03b8ac25cdd694a05026b870dc8,1,131,0,131,1,0,1,1,1,0,1,1,0,0,132,17,14,0,14,655,0,655,8,0,8,99.98676899
45651cee86e2b0fd09d9ba131c25b5f668c0412d,7,1172,469,703,4,0,4,7,28,72,2,5,1.533844879,673,133,18,212,138,74,7859,4360,3499,102,63,39,99.90081333
49d5f19a684dc48ce579a9eeaffb04ca9a49996e,0,0,0,0,0,0,0,0,0,0,0,0,0,0,34,1,0,0,0,0,0,0,0,0,0,100
b683569de095f7e9d24606816f5d09d88e12f3e2,2,12,11,1,0,0,0,7,29,8,2,2,0.828055725,1214,134,18,335,332,3,8455,8444,11,106,106,0,100
3b00de3b261f4b0dd28b8da7500c7b81dad2d132,5,186,36,150,1,0,1,1,9,361,2,2,2.157911437,684,135,19,194,175,19,5567,4933,634,73,60,13,99.98017184
aba5ddc7fbd2bd3dc3233d33f121c83b8d573bf8,0,0,0,0,0,0,0,0,0,0,0,0,0,0,108,7,0,0,0,0,0,0,0,0,0,100
e41e1dd9761c718861e69afd2c44e85da02daa7d,3,149,5,144,2,0,2,1,5,207,2,2,1.192334586,273,109,8,72,61,11,2275,1706,569,47,39,8,99.96696836
a7464c7e0a4162d4a574d3d31190b3ac11828eb2,2,378,0,378,2,0,2,1,1,0,1,1,0.98833683,0,136,19,52,0,52,1867,0,1867,33,0,33,99.92736877
a6216d10db96705ca23113b68ced81b86c5712f8,2,36,0,36,0,0,0,1,2,0,1,1,1,248,137,20,52,52,0,1867,1867,0,33,33,0,100
e97d6d15985fa8f0100ee1e4931e5337ed497d65,1,35,24,11,0,0,0,2,2,401,1,1,0,78,57,2,10,9,1,482,419,63,2,2,0,100
ce3f368ab0b7e56515803e55a399dc3f94e0f0b4,1,17,3,14,0,0,0,4,9,311,1,1,0,129,110,9,32,30,2,757,703,54,12,12,0,100
62a6555c8975a950294cf681ef27eed1a0cb61d9,1,1,2,1,0,0,0,4,10,0,1,1,0,139,111,10,31,32,1,745,757,12,14,12,2,100
b53a58f948719d8299a91584966bf2381701004e,1,6,7,1,0,0,0,4,11,0,1,1,0,138,112,11,31,31,0,744,745,1,12,14,2,100
4668ea4e7792f624f48a7c6c275eb2f5f05998bc,1,1,1,0,0,0,0,8,58,52,1,1,0,2307,20,0,725,724,1,15332,15325,7,215,215,0,100
053ad36618e2671bb5896023be8554e28d575965,2,6,2,4,0,0,0,1,36,72,2,2,0.811278124,2336,58,1,758,758,0,16102,16090,12,279,279,0,100
446b85a6ae50f6f66215af6263af373b45e5e6be,12,964,34,930,6,0,6,5,17,107,1,4,3.072228835,605,138,19,237,116,121,6856,3456,3400,97,43,54,99.9076639
9ebfe800a5cffc4116d0fa3023d8427d6a1a63bb,5,210,1,209,4,0,4,1,22,9,2,3,2.004101451,768,139,20,200,191,9,7088,6412,676,47,39,8,99.94073098
610023adee027bfa7124b3764df0b8fed5e2a672,1,36,0,36,0,0,0,1,5,0,1,1,0,152,140,21,25,21,4,1118,1004,114,10,8,2,100
237c092ebb1dd885954e4a93c476ff70554c7bf2,2,18,5,13,0,0,0,7,23,12,1,2,0.666578358,1437,141,22,395,391,4,11210,11159,51,124,123,1,100
352d799756bfed3eae503285fdd694d716b6405e,1,2,1,1,0,0,0,9,59,1,1,1,0,2307,35,2,725,725,0,15332,15332,0,215,215,0,100
e5a363e6519c503e0db2b1dccb37e2c0931bbea9,1,7,2,5,0,0,0,6,18,1,1,1,0,240,14,0,79,78,1,1647,1623,24,19,19,0,100
122229bb9ae9d39f56c0c76c9bbd386d446d9d34,0,0,0,0,0,0,0,0,0,0,0,0,0,0,15,1,0,0,0,0,0,0,0,0,0,100
0bbc9463fd13b437f2852080f2dc54007272759d,9,1087,0,1087,9,0,9,1,1,0,1,2,3.049186291,0,16,2,127,0,127,3577,0,3577,62,0,62,99.86202365
2a5964a540a3c29a2925ec4adadeb891c61e6985,1,1,1,0,0,0,0,5,16,156,1,1,0,214,21,1,54,54,0,1478,1478,0,12,12,0,100
0d3812fcb5429531cb0fadc2f5ea61bd84bb1f07,9,512,15,497,4,0,4,4,13,517,3,4,2.26825975,807,142,23,268,216,52,6458,4639,1819,126,88,38,99.88195947
ffa2851f892bb81549e395235e9be7ef06046f09,0,0,0,0,0,0,0,0,0,0,0,0,0,0,143,24,0,0,0,0,0,0,0,0,0,100
6dbe8a9e57ee2a66d2b760e4114761332ada00f3,3,66,0,66,0,0,0,4,22,578,1,3,1.109841067,1528,144,25,437,418,19,12552,12148,404,177,173,4,100
e7c3df714b731eeff96af2c3347948aef5020a03,3,326,0,326,3,0,3,1,1,0,1,1,1.511186063,0,145,26,25,0,25,1321,0,1321,23,0,23,96.72064777
7432d1e1ef6abc0cf01ca594dbe990a98b0fedae,1,1,1,0,0,0,0,1,2,9,1,1,0,119,146,27,29,29,0,769,771,2,12,12,0,100
5396a66b2bead214285ec2b5363edb40838a5556,0,0,0,0,0,0,0,0,0,0,0,0,0,0,36,3,0,0,0,0,0,0,0,0,0,100
c8895c6978546e325bd0fdde985965144e44a57a,2,3,1,2,0,0,0,1,2,8,1,1,1,101,147,24,11,11,0,335,321,14,10,10,0,100
ffb59c35fcd7b8d6adf658bc794bcaff465ced32,3,69,4,65,0,0,0,1,24,5,2,3,1.06937547,1614,148,25,433,417,16,12502,12127,375,171,169,2,100
f4845dae9b5767ea7fb4a26c631c4b28b0c49243,8,955,15,940,7,0,7,1,15,1,2,2,2.912370672,677,59,2,354,204,150,8804,4798,4006,170,85,85,99.86818371
404cbbf99bad44d769250020bc38a2f499d152ea,1,1,2,1,0,0,0,9,60,12,1,1,0,2308,37,4,724,725,1,15325,15332,7,215,215,0,100
aae12606650335c92930c6a369d799828bbae058,14,765,13,752,6,0,6,8,39,254,3,7,3.10412292,5236,149,23,1766,1666,100,42121,39222,2899,362,311,51,99.91005328
d5820cb4c62dd7ca76d962a145b850b995e23662,0,0,0,0,0,0,0,0,0,0,0,0,0,0,82,0,0,0,0,0,0,0,0,0,0,100
fd15719a4ba9863172ed7a8286662caf2b7f9e21,4,45,28,17,0,0,0,7,30,65,2,3,1.886791728,2076,195,0,536,533,3,13463,13316,147,282,281,1,100
d76c646acce071248efeeb3426013e31f89d0e14,5,101,14,87,0,0,0,7,36,147,4,5,1.908197465,2750,150,20,741,721,20,18348,17841,507,272,265,7,100
cf0985e5245ee4786d672f5c15b62ab81874ed06,0,0,0,0,0,0,0,0,0,0,0,0,0,0,38,4,0,0,0,0,0,0,0,0,0,100
a7b9f8f7f3998834b1e44a3104861d8cf3627250,0,0,0,0,0,0,0,0,0,0,0,0,0,0,39,5,0,0,0,0,0,0,0,0,0,100
d9712537da439387b0be0dabea96e82a03187c70,7,56,24,32,0,0,0,1,44,246,4,4,2.575231686,4131,151,18,1202,1192,10,27827,27684,143,298,297,1,100
c1d9abd216644255f1484c2a2c56a43879acd570,1,0,1,1,0,0,0,7,32,0,1,1,0,586,152,19,153,153,0,3931,3940,9,55,55,0,100
ff93b1d6e693df0e93c441ee68788f8d206515e4,3,26,18,8,0,0,0,1,7,362,1,2,0.865856617,648,153,20,130,127,3,4659,4599,60,60,57,3,99.97926028
4dd92231c58e966fd7fbd710ad7ece745782a064,2,5,1,4,0,0,0,8,37,26,2,2,1,2293,154,16,679,678,1,15228,15191,37,221,221,0,100
0d5f08efd9e70d07e57acd0c79e831b2b9d46a11,3,272,0,272,3,0,3,1,1,0,1,2,1.380678266,0,155,17,23,0,23,1014,0,1014,13,0,13,99.95162739
3ee2f9e40e7bed5c539a743885603dbd6e02252f,3,0,27,27,0,0,0,1,2,38,1,1,1.584962501,295,156,18,35,35,0,1813,1813,0,16,16,0,100
04c292c761a2fa8563dc66bea702ed381e910cec,2,452,4,448,0,0,0,5,14,1084,1,1,0.072537183,1617,157,15,517,416,101,12286,9816,2470,348,293,55,100
322689a573483d14cdd807b5881f707a1ff8a3f9,1,4,0,4,0,0,0,10,56,131,1,1,0,621,60,1,139,138,1,4363,4352,11,34,34,0,100
f0126e921f716ce057b9f72e52868dae0b323a48,9,432,62,370,3,0,3,1,26,351,2,4,2.293271284,2796,158,10,846,810,36,23283,21260,2023,189,166,23,99.82080088
d435a69c6b8a7580a364e425fc18f2797a7388b4,0,0,0,0,0,0,0,0,0,0,0,0,0,0,159,10,0,0,0,0,0,0,0,0,0,100
00c27c654af529e1c71d5c696f4f66edf1e17305,2,11,3,8,0,0,0,6,33,358,1,2,1,1969,160,11,643,641,2,12081,12046,35,222,221,1,100
912b9a37f7b7803d656c2ca1098f043491d49089,4,294,0,294,4,0,4,1,1,0,1,2,1.70942571,0,161,12,13,0,13,1189,0,1189,13,0,13,99.93814008
36abd7cb6233fdcc9aba8154e72d81c32f6207e5,0,0,0,0,0,0,0,0,0,0,0,0,0,0,83,1,0,0,0,0,0,0,0,0,0,100
42f2f394fbadb894079389c4e69cb0193a4beb94,1,12,3,9,0,0,0,4,6,180,1,1,0,270,162,13,77,75,2,2010,1956,54,25,25,0,100
62c0cba64bab3d23a4d59bd70e97910d0fed5322,3,5,10,5,0,0,0,3,8,3,1,1,1.530124965,339,163,14,76,77,1,2433,2445,12,24,25,1,100
cb3e1705f59e37319e9aa34f4a1220cd0d542f24,4,60,6,54,0,0,0,7,46,183,1,3,1.958563302,3169,164,15,742,733,9,20595,20382,213,361,358,3,100
8fc909c19cbbf27f1b2e5168a6b2dadd40024f95,1,249,88,161,0,0,0,5,15,15,1,1,0,1399,196,1,367,343,24,9422,8657,765,184,184,0,100
15f6ece8199e04be48d1f452b523e291f17c9b7a,2,8,2,6,0,0,0,9,85,655,1,2,0.468995594,3465,61,1,1015,1014,1,25687,25657,30,237,236,1,100
991f5a7dcebf7d21cb6d3c8f50f11fc4e189e732,0,0,0,0,0,0,0,0,0,0,0,0,0,0,165,16,0,0,0,0,0,0,0,0,0,100
aa1516f04b61ae6c10253ef06b853970e1efe5fb,8,320,36,284,1,0,1,1,27,307,2,4,2.326413342,3057,166,15,928,886,42,25518,23895,1623,163,147,16,98.26004659
650161a88762d60ab2fe1544dc6fe7680817fdcd,4,180,2,178,2,0,2,1,37,34,2,2,1.446162586,2340,62,2,775,758,17,16654,16102,552,295,279,16,99.96129731
2988f75fc32af9baf16c1978782dfed6dcc37076,1,1,0,1,0,0,0,10,72,145,1,1,0,3582,167,12,1058,1058,0,22149,22149,0,272,272,0,100
a60fab2d7eef3c7cad40ca7c598e1f90ec2c01ad,1,9,1,8,0,0,0,7,12,122,1,1,0,484,168,13,107,105,2,3945,3905,40,20,19,1,100
0ea75e720ebfea378b0412d6a0f96c6ad6374795,2,55,0,55,0,0,0,2,3,45,1,2,0.980597441,162,63,2,26,20,6,1190,938,252,15,10,5,100
939b122c09432e54083d751469c56ad48aff9fb6,2,36,19,17,0,0,0,1,10,35,1,1,0.305400571,322,169,7,81,77,4,2603,2502,101,22,22,0,100
079aa06091a9337a1f5087f904c332d590659c82,1,16,1,15,0,0,0,4,8,1298,1,1,0,70,84,0,17,14,3,455,396,59,5,4,1,100
52a0f630978ee7687057e5eda128f67233a98939,0,0,0,0,0,0,0,0,0,0,0,0,0,0,113,0,0,0,0,0,0,0,0,0,0,100
8e6db6cb65c2acca6812b30f56e56ff48000a02f,3,7,3,4,0,0,0,9,61,386,2,2,1.370950594,3519,85,1,1089,1088,1,24011,23991,20,294,294,0,100
4aa64410ad95dc18d774e58e8dc6eb3ce30a1532,4,343,0,343,4,0,4,1,1,0,1,1,1.968476102,0,86,2,30,0,30,1124,0,1124,23,0,23,99.93041058
a904e327287363459ea896987433b26c868713d5,0,0,0,0,0,0,0,0,0,0,0,0,0,0,114,1,0,0,0,0,0,0,0,0,0,100
b3951a1c11d590598c34b3c256c7abb789441444,0,0,0,0,0,0,0,0,0,0,0,0,0,0,115,2,0,0,0,0,0,0,0,0,0,100
a098b86d735fdd0f0ee41a56e5a1d5728dcf4b64,2,4,3,1,0,0,0,4,14,130,1,1,0.985228136,439,64,2,124,124,0,3244,3237,7,39,39,0,100
e047748e7720d7e9438c71aed130fea48615abe6,1,1,1,0,0,0,0,1,2,99,1,1,0,127,170,5,25,25,0,735,735,0,20,20,0,100
cd5014ee5405c2d2c62d9fbdd9f081a1c0132939,2,2,1,1,0,0,0,6,34,52,1,2,0.918295834,1973,171,4,643,643,0,12081,12081,0,222,222,0,100
2f75495c57ff27b2fdabbd19a3026e717c125550,0,0,0,0,0,0,0,0,0,0,0,0,0,0,116,3,0,0,0,0,0,0,0,0,0,100
666d189db9227c6b2a3b4df720e9be3177b1de18,0,0,0,0,0,0,0,0,0,0,0,0,0,0,117,4,0,0,0,0,0,0,0,0,0,100
2c86e1d910a70166240d67967a89628430b4ce2c,0,0,0,0,0,0,0,0,0,0,0,0,0,0,118,5,0,0,0,0,0,0,0,0,0,100
caf46298d63a6c95ff3becfb5ffac246a84275c7,0,0,0,0,0,0,0,0,0,0,0,0,0,0,119,6,0,0,0,0,0,0,0,0,0,100
e165e502d58728c76d0980fb4f6d5804a0395c70,0,0,0,0,0,0,0,0,0,0,0,0,0,0,120,7,0,0,0,0,0,0,0,0,0,100
05a8f028812e53acc5a2a68e65df6f32f66668ae,0,0,0,0,0,0,0,0,0,0,0,0,0,0,121,8,0,0,0,0,0,0,0,0,0,100
5600a778c90171bc0f1023f79930ac082570ad44,1,5,3,2,0,0,0,1,6,642,1,1,0,347,172,3,82,82,0,2474,2458,16,27,27,0,100
9803879ff9053a5b1cfedcfae3943dabbce5025b,1,3,1,2,0,0,0,6,29,16,1,1,0,605,173,4,188,186,2,3562,3543,19,66,66,0,100
7a7957d8ccd1bfb2cba2fb933a1989406984a2dd,0,0,0,0,0,0,0,0,0,0,0,0,0,0,122,8,0,0,0,0,0,0,0,0,0,100
1706670152d7dc09528b246fe54503876963f74a,17,550,88,462,4,0,4,1,42,346,3,5,3.551731945,4236,174,4,1233,1175,58,30283,28482,1801,337,318,19,97.74207877
85b44d83d5d1edab60b653a35d176b61079c02e4,1,5,1,4,0,0,0,7,33,119,1,1,0,585,175,5,153,153,0,3951,3931,20,55,55,0,100
07c6b1e5ddce7069c8bab7149ecf0a365a43bd88,2,5,4,1,0,0,0,4,60,287,2,2,0.764204507,3297,40,0,683,683,0,26291,26270,21,149,149,0,100
baa01d79dd0a9f35195ce46828b3f38e3faf93d5,5,314,5,309,3,0,3,1,38,102,2,3,2.120087001,2585,65,0,806,780,26,19124,17827,1297,310,288,22,99.94318585
022688859011ee2df4d6b29f0501d9833e65d9f1,4,152,5,147,0,0,0,3,73,542,2,2,0.508306443,5027,197,0,1486,1478,8,31802,31182,620,438,434,4,99.8293758
ab424921005d872958cae6583a44af1e089b65d1,2,3330,3259,71,0,0,0,2,62,388,2,2,0.086879737,2349,0,0,732,726,6,15821,15500,321,220,217,3,100
b1f1d3250caeab882e5c806ff15daedb9ae929b3,0,0,0,0,0,0,0,0,0,0,0,0,0,0,123,5,0,0,0,0,0,0,0,0,0,100
f0ad75d7fdfbe0deb4beb660e839123529082bc7,4,410,16,394,3,0,3,1,74,2,2,2,1.80620095,3582,41,1,1097,1058,39,23588,22145,1443,300,272,28,99.95018148
50ff3ed6933dbd115dfc9d84551b3613ec6f29ed,2,18,16,2,0,0,0,1,75,0,2,2,0.322756959,3707,42,2,1072,1071,1,22951,22945,6,277,277,0,100
e7867662bdad88588a7f67df310ef44f4564dd2e,3,101,25,76,0,0,0,3,86,786,2,3,0.234819962,3585,0,0,1069,1053,16,26267,25868,399,318,312,6,100
050a99a3e4e767988a50aae0f370526b2cf3ca77,1,58,58,0,0,0,0,8,14,0,1,1,0,173,1,1,38,38,0,1101,1101,0,14,14,0,100
229220b9221f1233afa31bd42a6ff3fa4cdb68bd,1,20,0,20,0,0,0,3,3,31,1,1,0,390,43,3,34,30,4,2606,2479,127,12,12,0,100
d31d40f5110297385b7570e517a7c6a814093be0,3,12,6,6,0,0,0,2,2,178,1,3,1.299736764,327,44,4,44,42,2,2077,2048,29,21,20,1,100
7b11877e36d29fb1f23aaa0734e56267cfa33b2f,2,16,26,10,0,0,0,2,3,89,1,2,0.702466551,213,45,5,36,41,5,1155,1224,69,15,17,2,100
99dc9d8a66d0b127174e6e25913311ea3cc9d5ad,3,20,20,0,0,0,0,1,76,12,2,2,0.921928095,3795,46,6,1086,1087,1,23252,23255,3,291,291,0,100
212ddcefc9c9b68fa16138f217c86463aa77baed,4,101,6,95,0,0,0,1,28,182,2,4,1.585581782,1958,66,0,528,514,14,15191,14583,608,134,131,3,100
5128ee06a47e780278ec3e7023aae2aa1936e4dd,2,52,0,52,0,0,0,1,29,4,2,2,0.137099479,1471,67,1,420,411,9,11205,10938,267,107,106,1,100
83f526a3f086e90241efa89da88f9525d368c6aa,0,0,0,0,0,0,0,0,0,0,0,0,0,0,124,0,0,0,0,0,0,0,0,0,0,100
7131ef0748b7b979c14eb0401f285fdc81e8a196,6,411,1,410,4,0,4,1,30,2,2,3,1.882065166,1789,68,2,534,506,28,15127,13491,1636,144,122,22,99.93602047
16e7a11f8197ee21fe1ed15a46a7535432972fb6,1,7,2,5,0,0,0,1,4,70,1,1,0,30,176,0,1,1,0,97,97,0,1,1,0,100
e2388e9b3cb5f983623c968459d36a4d8c81c59c,11,821,19,802,6,0,6,1,18,481,2,2,3.041626345,1120,69,3,381,287,94,10131,6957,3174,195,125,70,99.90063875
1e4aa60859d0a2a6ef90ab1d6c56dfb90ea7805b,3,20,0,20,0,0,0,5,87,138,1,2,1.076297626,4625,2,0,1372,1369,3,34040,33972,68,335,333,2,100
ac40fde3f1bded71a16c8c5dd4846d81f1dc9ea5,1,3,2,1,0,0,0,8,32,0,1,1,0,1289,3,1,396,396,0,9492,9490,2,101,101,0,100
e23ea92319dd33ff98dc475f71e8d8a269926113,1,1,9,8,0,0,0,2,8,84,1,1,0,361,125,1,92,92,0,2532,2607,75,38,38,0,99.99290981
703a2b9b600817f96ed3d7ba1024fabf50184dc9,3,4,13,9,0,0,0,5,88,3,1,2,1.548565226,4640,4,2,1370,1372,2,34015,34042,27,333,335,2,100
c49f0e17d6b1f02970acd15dee527b25784d01e1,3,56,2,54,0,0,0,6,15,153,1,2,1.233230506,642,1,0,145,134,11,4249,4043,206,44,42,2,100
044764a395220342b5843c2ffebd7197baa04b4f,1,2,14,12,0,0,0,9,16,4,1,1,0,202,2,1,45,48,3,1251,1280,29,15,16,1,100
660371bfd58544926996c1c42c395e59097ba7ea,0,0,0,0,0,0,0,0,0,0,0,0,0,0,126,2,0,0,0,0,0,0,0,0,0,100
284bd408f875e6525c4337b2387d761f396ca2f0,0,0,0,0,0,0,0,0,0,0,0,0,0,0,127,3,0,0,0,0,0,0,0,0,0,100
f01e6bd0d472949feaf6485ec65d3ebb37767701,1,31,9,22,0,0,0,5,8,1676,1,1,0,214,47,0,59,59,0,1440,1250,190,47,47,0,100
e1bd3c4dcbe89521ecd7aefd04df01e5f34963be,73,468,441,27,0,0,0,4,77,872,6,22,4.487816747,33990,128,4,8794,8794,0,233299,233640,341,2490,2490,0,100
b9476a8ae8357528aa70300abadcad10c7816126,19,94,103,9,0,0,0,2,45,840,2,4,3.361385809,3118,129,5,767,767,0,19581,19686,105,264,264,0,99.97873095
995c6a4acc0183dc76cd4c477b47bf515334ce00,36,234,197,37,0,0,0,4,23,782,2,6,4.414414455,8234,130,6,2076,2077,1,51133,50773,360,1040,1040,0,100
7c1c9fca60d884d27b270070ad85857e196d7cfd,2,15,4,11,0,0,0,1,63,74,2,2,0.949452015,2433,48,1,742,738,4,16224,16126,98,220,220,0,100
509f41c801b7b02d5825372620c29cf612646570,0,0,0,0,0,0,0,0,0,0,0,0,0,0,49,2,0,0,0,0,0,0,0,0,0,100
1a378e13f9847f903fbe4ace6b3bd972c11979d3,9,258,267,9,0,0,0,2,19,17,2,2,2.712428967,1364,5,3,289,289,0,7628,7614,14,170,170,0,100
54d4d0d07d5405670c84823ee2701f497f384538,5,283,1,282,4,0,4,1,21,31,2,3,2.099927784,645,3,2,273,244,29,5808,4837,971,61,35,26,99.93623804
3cc3bfe87ca7b93256042caa08ddaab91a543246,1,4,4,0,0,0,0,2,5,628,1,1,0,168,198,0,32,32,0,1313,1289,24,18,18,0,97.46219892
675ee185650f2e5f00850a568443abe4385e8bfa,1,5,5,0,0,0,0,6,12,26,1,1,0,545,50,3,53,53,0,3647,3647,0,6,6,0,100
7e24608f524188e5b019777d85d01a2b4dd62d9a,1,1,1,0,0,0,0,8,30,437,1,1,0,880,6,2,239,239,0,6352,6352,0,44,44,0,100
f55dff2069f4a1dc2f27d7e5a9dd126bcc5a2d67,1,7,2,5,0,0,0,6,10,444,1,1,0,643,51,4,191,190,1,4574,4537,37,32,32,0,100
ea9378fc9646f9fe771ace35fc2d8cbb0d88bc56,2,237,2,235,1,0,1,1,13,3,1,2,0.611408686,545,52,5,67,53,14,4250,3647,603,9,6,3,99.98360656
e11d0f7e12f8ee4e98860847a4901c59a48f8346,4,14,3,11,0,0,0,1,7,364,2,2,1.783859344,224,177,0,19,18,1,1055,984,71,13,13,0,100
5550d8dbb53e2b5bbff4dddac060a93c33d7ceff,5,92,92,0,0,0,0,2,22,30,2,3,2.018450471,881,70,0,273,273,0,5808,5808,0,61,61,0,100
75b9ca7fa3588428083f6fedb9b398f710065726,0,0,0,0,0,0,0,0,0,0,0,0,0,0,178,1,0,0,0,0,0,0,0,0,0,100
02608cc658571514e87a57f1b477330dfdef782e,8,294,62,232,3,0,3,1,11,193,2,3,2.597727576,865,131,1,232,208,24,6601,5980,621,97,78,19,99.94266525
ef910bb684662b53bc7785ef626597e7078acf37,2,78,2,76,1,0,1,6,20,131,1,1,0.995938608,260,179,2,89,80,9,2014,1750,264,22,20,2,99.98363071
1ae20fc27761a143cf09c058bd9f87202289bfb3,7,100,134,34,0,0,0,7,43,49,3,3,2.268487857,4112,132,1,1069,1069,0,29328,29354,26,253,253,0,99.92627181
25c31398f15b5bf6a9bac71f4891e818791c4ffd,3,251,2,249,1,0,1,6,21,272,1,2,0.254279848,437,180,3,145,99,46,4022,2868,1154,42,30,12,99.95900631
9d40841d48636bff9246b2ddc6fb3005dd8c9374,5,48,92,44,0,0,0,1,8,70,2,2,1.888274985,294,181,4,15,24,9,1083,1327,244,13,17,4,100
64a1293f51096d78eddb7bf993cf3c5ebccd7193,0,0,0,0,0,0,0,0,0,0,0,0,0,0,182,5,0,0,0,0,0,0,0,0,0,100
031f525d4f15b930340fed274ac4f4f8ff7c67f4,4,43,4,39,1,0,1,3,64,451,3,3,0.923940734,2495,22,0,771,768,3,16515,16391,124,234,232,2,99.98360924
bb937f36342618164196ab21230576a349dea445,15,248,3,245,0,0,0,4,43,905,5,6,3.866736529,8366,7,0,2538,2488,50,54777,53693,1084,809,767,42,100
68d48f948e8bf1f47648179fe0680040d1f23b1f,1,5,2,3,0,0,0,8,15,291,1,1,0,316,87,0,71,70,1,2224,2210,14,21,21,0,100
76c3cd36cc82dbf25112c3db1352131c42543107,0,0,0,0,0,0,0,0,0,0,0,0,0,0,183,6,0,0,0,0,0,0,0,0,0,100
2b1a1e69e2efd64e6ffdc4e4c866693f5d4427cc,2,173,173,0,1,0,1,1,9,453,1,2,1,108,133,2,23,23,0,577,577,0,5,5,0,99.97542192
9e67ec5ae8f6a665430a463fe2375a3ab170347a,1,0,0,0,1,0,1,4,10,0,1,1,0,0,134,3,0,0,0,0,0,0,0,0,0,99.98361462
7f7497dee386e713b5b17b73f1d56a8d7e7850c8,0,0,0,0,0,0,0,0,0,0,0,0,0,0,135,3,0,0,0,0,0,0,0,0,0,100
1617c44f57fb9f5d5eb2c32ac7a1c03dd0118c93,0,0,0,0,0,0,0,0,0,0,0,0,0,0,136,4,0,0,0,0,0,0,0,0,0,100
492a92a26043b75c470dd4be7908550f92d00577,6,128,21,107,0,0,0,5,34,750,2,2,1.802542006,2240,4,0,536,517,19,14421,13974,447,314,295,19,100
3f47c13c68f439f274c735862184cfb19c37b151,5,198,254,56,0,0,0,1,9,498,1,2,0.550690726,1111,184,2,275,263,12,7956,7007,949,190,189,1,100
c28c7830d52599fffb271c51e96fd414ca929645,1,2,1,1,0,0,0,7,44,32,1,1,0,1590,185,3,516,516,0,10732,10722,10,148,148,0,100
ef7f18f30c168b1cb4b046bfde99ac23cd9ba934,1,4,0,4,0,0,0,9,31,87,1,1,0,880,53,0,242,239,3,6403,6352,51,44,44,0,100
5bf35c3a409e2f4940b32ed8ea2ed419de4f6015,2,17,1,16,0,0,0,1,8,8,1,2,1,253,186,3,50,45,5,1822,1720,102,22,21,1,100
c60a95f77a9eb0f6156010cf9f33b9a987bf60c8,0,0,0,0,0,0,0,0,0,0,0,0,0,0,5,1,0,0,0,0,0,0,0,0,0,100
55b1fa6cd377b1e15ffff6b8b65eb94c241e02a5,6,437,3,434,5,0,5,1,15,24,2,2,2.375816473,503,8,0,158,111,47,5549,4027,1522,61,21,40,99.90994679
4c4219fc223dcfcaee24119825d5b63f31c2dc67,99,5710,2,5708,98,0,98,1,24,0,2,3,5.962046498,282,187,4,610,57,553,18981,1727,17254,488,26,462,98.35089695
c15fb7dfbb47a4f35221f057585a1799c27dca2d,7,437,44,393,4,0,4,5,7,350,2,4,2.488271997,602,137,2,187,156,31,5348,4015,1333,70,44,26,99.92882562
b45e0655df38e7e122f67290b65325f4d8336301,0,0,0,0,0,0,0,0,0,0,0,0,0,0,138,3,0,0,0,0,0,0,0,0,0,100
7a6ac4afc70176d61c90288e54100a2acfa01cce,7,44,437,393,0,0,0,5,8,0,2,4,2.488271997,906,139,4,156,187,31,4015,5348,1333,44,70,26,99.92882562
74c5f3078f30ec3c8c06b0b7c5601fb274eaa489,37,471,227,244,2,0,2,1,31,0,2,3,4.43254438,3830,188,4,810,790,20,22162,21081,1081,619,600,19,99.66795794
e78a1bc07924c7f70163929fe213e88a9002ca34,24,1833,27,1806,13,0,13,3,44,278,4,5,3.563817805,6900,9,1,2140,1932,208,56335,48857,7478,797,625,172,99.7005988
9946b6c19bb6445d8b975d2bb734329777cf7ec5,9,667,3,664,8,0,8,1,62,14,2,3,2.975803983,3063,10,2,696,629,67,27155,24731,2424,182,123,59,99.85087513
411382d4d925b083df7341f8076d7ab26dd4f70c,14,182,152,30,0,0,0,1,3,0,2,2,3.050575136,1756,189,5,366,362,4,10860,10488,372,317,311,6,99.96864958
82e702867e6164cdffe3840b122f3190e9d526bb,8,449,53,396,4,0,4,5,78,23,3,5,2.659527545,4184,140,3,1245,1214,31,27497,26148,1349,342,316,26,99.92950576
569641f0950e01c8abbaff6e23e2739a8a2f2c9a,1,9,8,1,0,0,0,6,20,306,1,1,0,1234,71,0,460,460,0,9623,9606,17,58,58,0,100
62e1deae8f372545fc7c95d9bdd986886f3d7db4,3,20,4,16,0,0,0,1,23,618,3,3,1.459147917,919,190,6,242,240,2,6507,6416,91,77,75,2,99.96868394
57d329d3c55c3805465df3299e37deaf144dfc02,1,1,1,0,0,0,0,1,10,27,1,1,0,233,191,7,45,45,0,1585,1585,0,16,16,0,100
66434c6ebfe308ad34ee066a93efadaa3948c1ab,2,48,1,47,0,0,0,1,10,451,1,2,0.475431646,161,192,8,23,18,5,1479,1095,384,12,10,2,99.96867413
243b68dbb74c15a4e9ed46da27b72eb4bfe4a09a,0,0,0,0,0,0,0,0,0,0,0,0,0,0,72,1,0,0,0,0,0,0,0,0,0,100
8f97b2248a2c3af6bd063dd04f3721c4378e26e9,2,28,3,25,0,0,0,7,42,521,1,2,0.205592508,1333,73,2,401,391,10,10043,9849,194,104,104,0,100
d1f498b59e7c8747911703f4255ab4014ab3061c,25,462,89,373,4,0,4,1,32,58,3,5,3.325996846,2460,193,9,484,465,19,15107,13745,1362,321,315,6,99.84350548
2bb40626e61a255bc68f0d53b6a1e0d709d9cd92,24,115,29,86,0,0,0,2,89,903,3,5,3.864377464,9629,74,3,2665,2649,16,68210,67687,523,1021,1012,9,99.96873779
979a6e373c5551d30214f0b668cdf3b0352e5796,9,925,0,925,5,0,5,1,44,394,3,4,2.806064771,2174,75,4,755,635,120,21450,16394,5056,323,246,77,99.87509758
11a57c87c55fe7040b316f5f9b8df06ca6910f02,4,106,12,94,0,0,0,8,32,34,2,2,1.086093421,2225,11,3,578,558,20,13726,13183,543,145,141,4,100
cabd3443976a6afa3e70d720e63e8e062d5580c2,0,0,0,0,0,0,0,0,0,0,0,0,0,0,6,1,0,0,0,0,0,0,0,0,0,100
debe82b8d0afcf2dbcbd4fc05ddd5aba39c5c83e,8,446,0,446,2,0,2,1,45,0,3,4,2.122358277,2492,76,5,739,671,68,21210,18704,2506,310,264,46,99.87500976
c1d791f6dd382e97eacd3760ab588acf57ec902c,4,284,7,277,2,0,2,9,33,35,3,3,1.938548421,1811,7,2,519,491,28,12180,11226,954,144,132,12,99.96088861
9c8b2d2cd844ecc73081c3baf281b13abd178843,6,452,89,363,1,0,1,1,11,79,1,3,1.506169653,985,194,8,220,175,45,9237,7001,2236,93,79,14,99.85159728
5d27c28dd4d66695164607d3391235f6d69c28c5,29,332,136,196,4,0,4,1,33,5,2,3,3.877148164,3174,195,9,634,623,11,18992,18469,523,476,468,8,99.70414201
47eab4981272f09860d5b7c67e5881d5e6b3fabd,7,499,13,486,6,0,6,1,11,1,1,1,2.697939646,533,77,6,248,170,78,6363,4036,2327,124,86,38,97.72528434
548ccbcf959025988fc9ee517ba1a0ef983ee449,1,2,2,0,0,0,0,3,5,1171,1,1,0,315,196,10,88,88,0,2061,2061,0,37,37,0,100
4cf216c21f19529884c181a0322b1fd54cbab1b4,4,64,6,58,0,0,0,6,37,631,3,3,1.978089365,2035,12,4,650,637,13,13937,13592,345,212,208,4,100
13027e218c36b88e093f9794f3fe129d29b495de,1,2,2,0,0,0,0,2,6,2,1,1,0,460,78,7,50,50,0,3499,3503,4,37,37,0,100
9ba8587238f7958b910e22de58c6d3bea6f3d9e0,1,11,6,5,0,0,0,1,1,0,1,1,0,173,17,0,21,20,1,1279,1261,18,7,7,0,99.97253502
0f7f03d8b0bfcfa33fb3bed73597af731e86cfef,4,22,13,9,0,0,0,1,65,156,3,3,1.611785936,4994,197,11,1483,1479,4,34873,34791,82,444,443,1,100
b3a9a1b0e03e99b9146f9651d125a57b59a2cd34,0,0,0,0,0,0,0,0,0,0,0,0,0,0,198,12,0,0,0,0,0,0,0,0,0,100
ead852dc38f623f3ec4cfa8a20be71a368211762,6,395,0,395,6,0,6,1,1,0,1,1,2.48741983,0,141,4,28,0,28,1372,0,1372,26,0,26,99.90397805
e63fbd5226b4811763b2235f500d3fbc2301a522,1,187,0,187,1,0,1,1,1,0,1,1,0,0,79,8,8,0,8,1142,0,1142,7,0,7,99.97259711
5256a6c516638034fe42f83d1e1ce153918c0b3f,8,493,2,491,7,0,7,1,3,3,1,1,2.419854492,765,13,5,155,90,65,6768,4433,2335,122,69,53,99.89056088
90f6d5ff800eb7031c6b32372f9d712fbd65c32f,2,39,0,39,0,0,0,4,12,302,2,2,0.988110837,1634,14,6,563,553,10,11208,10986,222,120,119,1,100
78dda5c2b720872d3898b47f6af18f01f25746f1,5,493,0,493,5,0,5,1,1,0,1,1,2.072153927,0,15,7,54,0,54,1690,0,1690,48,0,48,99.91809992
04900fe85c90b86e0becb5b2cb59ba4d08ae4cf8,3,101,2,99,2,0,2,1,3,260,2,2,1.28203756,230,8,2,61,54,7,1926,1672,254,14,9,5,99.92501704
3fd11d82ab93a7acec528643d09aaeb91c773741,0,0,0,0,0,0,0,0,0,0,0,0,0,0,142,5,0,0,0,0,0,0,0,0,0,100
0e6a3bd79db8745bcdc947723bb091354b206663,1,3,1,2,0,0,0,1,2,17,1,1,0,69,9,3,6,6,0,248,263,15,5,5,0,100
574d559860c58a74aead153305aef6dfc44a2fbd,10,343,255,88,0,0,0,1,79,58,4,6,1.499479044,7838,199,11,2137,2130,7,53007,52231,776,638,633,5,99.65376782
0500645b7a753dbf287c81b6bda473165b1ccc44,1,3,1,2,0,0,0,8,34,171,1,1,0,1288,80,9,397,396,1,9497,9483,14,101,101,0,100
16b7b1a7f797b720d9d48976f65055944773e911,0,0,0,0,0,0,0,0,0,0,0,0,0,0,143,6,0,0,0,0,0,0,0,0,0,100
c924cc2fc8b85d1c2369a8a0caa0b9f4dae7b245,8,294,6,288,3,0,3,9,45,80,4,4,2.329629881,4260,10,4,1325,1295,30,29446,28395,1051,347,328,19,99.95267072
6ff7d9a922d1b3f61fa2363529622e69f1d82b9d,2,9,129,120,0,0,0,8,16,255,1,2,0.473572925,984,16,5,247,270,23,6400,7223,823,74,77,3,100
ec531f3b9d22db7c12562c011609ca168a13a580,8,341,102,239,1,0,1,1,14,103,1,3,2.67014066,1083,200,11,232,199,33,8430,7292,1138,97,80,17,99.44935418
3f90c7eaa8b1c262ce752f3ebdc3a4336b0c8781,2,86,38,48,0,0,0,2,12,0,1,2,0.345117315,445,201,11,115,110,5,3145,3032,113,46,43,3,100
94efd58dd9e258e2de7436c767f179e136c49dfe,2,92,9,83,0,0,0,1,24,33,2,2,0.984030471,822,202,11,223,208,15,6525,6014,511,68,64,4,100
2759792aea8e2cd6bd62bcdca576967d5b6dd742,1,13,5,8,0,0,0,1,3,14,1,1,0,280,203,12,32,30,2,2094,2031,63,14,13,1,100
1437517d8cd232d348d3e0b198a3ebae7931114d,1,320,221,99,0,0,0,3,8,1473,1,1,0,235,81,9,35,23,12,2144,1694,450,19,9,10,99.97947736
fb7ab1908bfb6afe560f094ab70b9de860280ed0,10,217,23,194,2,0,2,2,11,738,2,2,2.008122806,1079,82,10,192,174,18,7440,6451,989,102,92,10,99.97263273
43a9847b9378bddad1cf8aca62b9bdbe041166bf,1,0,4,4,0,0,0,1,4,2,1,1,0,286,204,11,32,32,0,2061,2094,33,14,14,0,100
ca3464e0b1ab11048416449ba27eb7639971585c,0,0,0,0,0,0,0,0,0,0,0,0,0,0,11,0,0,0,0,0,0,0,0,0,0,100
f30eb247096dadff734ed7bf78ce94ebb4c391c9,1,0,1,1,0,0,0,6,12,444,1,1,0,770,205,1,229,229,0,5130,5145,15,122,122,0,100
44a4c38a1ed9a091a0ec79642a59037117f70085,0,0,0,0,0,0,0,0,0,0,0,0,0,0,206,1,0,0,0,0,0,0,0,0,0,100
cbbc7686737a780518a1ef9f99f49f62930156c4,8,533,30,503,1,0,1,1,47,404,3,4,1.757960538,4561,207,2,1333,1279,54,31934,29914,2020,534,507,27,99.97264583
0a20368e58467b25c12ba39792699fe7e48170e5,0,0,0,0,0,0,0,0,0,0,0,0,0,0,208,3,0,0,0,0,0,0,0,0,0,100
f491d6e361f7efb77d1174b927f46adf8fbf4a1a,5,17,19,2,0,0,0,2,7,426,1,5,2.255762073,819,144,0,87,87,0,5739,5750,11,60,60,0,100
4427455757f1ce8114826c935739e44980d0f62c,17,293,0,293,3,0,3,1,46,383,3,7,3.10183196,7423,83,0,2180,2145,35,54253,53049,1204,949,924,25,96.10226938
2309a59df503eafd89ecaa334d4964d0ea34b605,1,9,0,9,0,0,0,4,14,591,1,1,0,211,84,1,42,39,3,1286,1215,71,14,14,0,100
9ab2dd6c4ab1da7438f6f0265d876fa8bf4135e4,7,755,8,747,6,0,6,1,12,26,1,2,2.59351352,265,85,2,122,65,57,5220,2086,3134,64,16,48,99.88828599
500fc71ba3d07e3c453ace8c45e8d9593b458b3a,6,0,0,0,0,0,0,1,1,0,1,1,0,555,145,1,52,54,2,3058,7230,4172,48,30,18,99.80870397
b8ec28b38a20339c5edc4e6522a4570b2b9d570a,2,2,2,0,0,0,0,1,1,0,1,1,1,301,146,2,14,18,4,2217,2410,193,10,10,0,99.93623466
c99c9d24f968fbc2fb2542291ee20164518e6111,30,1606,39,1567,15,0,15,5,46,307,4,7,4.051122243,7961,17,0,2247,2035,212,64364,57438,6926,717,595,122,99.72180272
2e2618407db3815a5fb086521cd60b9196df7d6b,11,305,42,263,3,0,3,9,66,92,3,5,2.812218563,7159,209,4,2009,1993,16,47857,47000,857,646,634,12,99.94454567
b65b9b2471009fa3bd4b5da30286527a0b5172d5,0,0,0,0,0,0,0,0,0,0,0,0,0,0,210,5,0,0,0,0,0,0,0,0,0,100
1583426e01c38dd65d255a2eeb52cca475975fb7,1,9,0,9,0,0,0,5,9,1632,1,1,0,220,86,3,69,67,2,1500,1438,62,32,32,0,100
388c56f05ffb515eb4f61bb5461ef969b0a9cadd,4,57,2,55,0,0,0,5,21,524,1,4,1.10670575,2018,87,4,722,713,9,14612,14366,246,133,130,3,100
88f288b47a6238e3c77670fe56436ee8df94269b,3,54,35,19,0,0,0,2,27,3,1,1,0.423620534,1422,18,1,332,328,4,11743,11681,62,79,78,1,100
696388049b3a89248e265af7274bdb298ab91e0a,1,9,6,3,0,0,0,5,24,237,1,1,0,633,147,3,180,180,0,4993,4963,30,29,29,0,100
9e78d8caae2306b110743540b03929439e6ccea5,1,152,142,10,0,0,0,2,3,1634,1,1,0,49,88,5,9,8,1,336,318,18,7,6,1,100
7ce5b0dad89f76dbf15f07f36bc5036c6bc1c922,1,0,1,1,0,0,0,3,9,68,1,1,0,309,89,6,35,35,0,2142,2144,2,19,19,0,100
a09954b754fd34fa0fbd48b4efe4c8811c07992c,9,756,0,756,6,0,6,9,36,20,2,3,2.381799396,2418,19,2,700,612,88,18300,14945,3355,232,165,67,99.88927555
8c50f73fe4820ac25b5268553b8029c32d9c9f9e,1,1,1,0,0,0,0,5,25,3,1,1,0,636,148,4,180,180,0,4993,4993,0,29,29,0,100
cdc015fae893e37b1ec1f6b0aab2c5b0f17de5a4,2,64,2,62,1,0,1,5,27,52,2,2,0.918295834,283,211,6,63,57,6,1946,1753,193,28,26,2,99.96839943
0452a7c4abd4de99fd772f6e4de8ef78f1d8bdbb,11,511,19,492,4,0,4,5,28,386,3,4,2.023345599,1336,149,5,347,300,47,9700,7949,1751,185,151,34,99.92105471
fd42fb9d9e6fba26aee964ed7ab0fcd54f9428a4,8,113,100,13,0,0,0,4,15,291,1,6,2.568802181,1342,150,6,167,164,3,9467,9556,89,82,81,1,99.99211108
c848009334f2f1aefae8efb086dac8045de131ec,0,0,0,0,0,0,0,0,0,0,0,0,0,0,151,7,0,0,0,0,0,0,0,0,0,100
c21184bf11d2efd1085639340e56a49fd6289ed4,3,103,17,86,0,0,0,2,7,17,1,1,1.533631359,792,20,3,179,164,15,6803,6216,587,60,57,3,100
50f65873f5941e7c4eb7a3ff5bd929c162aa7397,3,3,3,0,0,0,0,3,4,1423,1,1,1.584962501,147,152,8,9,9,0,734,734,0,9,9,0,100
c5736acdf423b312fde13a86d34ec4932e22acc9,5,289,30,259,3,0,3,2,41,93,2,2,2.240874654,2382,153,9,807,769,38,17255,16420,835,306,281,25,99.94480801
d49fdb1ea206bc0a53c0afa9fa207c1a3ed1931d,19,755,15,740,5,0,5,1,47,286,3,6,3.266287007,4671,90,7,1316,1232,84,37105,33581,3524,567,519,48,96.43835616
8ee71283c9ebdf8d1ae8e95c46b65de5f4c05e92,1,0,1,1,0,0,0,1,2,0,1,1,0,157,91,8,6,6,0,1093,1110,17,4,4,0,100
017e518bbac1b9e0c1f67dd5cd1330cd54c02106,30,2170,20,2150,14,0,14,5,37,99,4,9,3.452388297,8317,12,0,2663,2421,242,66089,56822,9267,692,551,141,99.72159618
f1d2bf4bef6b479bfe9ee5eda2e5364bba7d67d5,2,106,0,106,1,0,1,1,14,545,2,2,0.832945824,229,92,8,68,57,11,2025,1462,563,22,18,4,99.9801666
209f90338886f9b6775523e4250da4a4ab003447,1,32,11,21,0,0,0,4,8,138,1,1,0,165,21,4,32,31,1,1380,1362,18,5,5,0,100
e3db0470bae458247d9ba54290c7579a8328c156,0,0,0,0,0,0,0,0,0,0,0,0,0,0,13,1,0,0,0,0,0,0,0,0,0,100
f78d5baea0285652ca40c353d38075f54418a119,0,0,0,0,0,0,0,0,0,0,0,0,0,0,154,9,0,0,0,0,0,0,0,0,0,100
94275568651e4c8a989803d03742f064ba33b8bf,0,0,0,0,0,0,0,0,0,0,0,0,0,0,155,10,0,0,0,0,0,0,0,0,0,100
e70fd12a5933871b1e937e77a1dba04330b31de6,0,0,0,0,0,0,0,0,0,0,0,0,0,0,93,7,0,0,0,0,0,0,0,0,0,100
89df4a75321f4066bb7a0a83d0fa03ace16e32bf,1,3,1,2,0,0,0,7,46,57,1,1,0,1588,22,5,517,516,1,10728,10719,9,148,148,0,100
da91c0bb568a7780edf41da63a39a668e446d63b,2,2,61,59,0,0,0,6,29,21,2,2,0.883222559,331,14,2,57,63,6,1772,1944,172,26,28,2,99.9801666
039693ca1ae55c1fa09a141dc0b4db1938b38a68,0,0,0,0,0,0,0,0,0,0,0,0,0,0,156,9,0,0,0,0,0,0,0,0,0,100
b936e8134af11721fb6817780d13f1a9770fe130,0,0,0,0,0,0,0,0,0,0,0,0,0,0,157,10,0,0,0,0,0,0,0,0,0,100
e80bac22d0a641f8d5812456365e241aa68a5aae,0,0,0,0,0,0,0,0,0,0,0,0,0,0,158,11,0,0,0,0,0,0,0,0,0,100
30b7c05468a0b82d3c13856aec3316bf990e236a,0,0,0,0,0,0,0,0,0,0,0,0,0,0,159,12,0,0,0,0,0,0,0,0,0,100
963e541fd268a6bf0c64194cf917b5199600a9cb,4,226,3,223,3,0,3,2,3,135,1,1,1.921392441,108,23,4,39,10,29,1392,661,731,30,7,23,99.94051553
f65c4aebcd5e2b90322dddffd7b8bf2f12007a54,3,25,8,17,0,0,0,8,28,30,1,1,1.095795255,1369,24,5,323,319,4,11137,10996,141,84,83,1,100
8e60655cd79ac8576706d66f842f74c18b12c614,7,351,11,340,2,0,2,1,48,10,3,4,1.905216944,2580,94,6,761,713,48,21477,19677,1800,301,277,24,99.97359039
1fdd52fb0a02e9b468970be8afce1364296200a5,0,0,0,0,0,0,0,0,0,0,0,0,0,0,160,12,0,0,0,0,0,0,0,0,0,100
672b5f0b45dfc6afe6ebaa3772bfdf1f1393a86c,1,17,2,15,0,0,0,7,26,234,1,1,0,398,199,0,114,112,2,2566,2504,62,39,39,0,100
295442d82f417e203a110bb2caac18e10b5fb3f2,57,3130,1555,1575,19,0,19,8,80,290,5,15,4.906224346,21742,212,1,5868,5730,138,147604,142523,5081,2474,2325,149,99.17349907
d00a4e6eb9cd320942ca774e460e9824383492bc,1,8,3,5,0,0,0,1,2,0,1,1,0,98,213,2,4,4,0,786,786,0,4,4,0,100
e47d83b051403c17e74df9464690fc42530566a5,1,5,2,3,0,0,0,1,2,66,1,1,0,245,214,3,27,27,0,1480,1442,38,20,20,0,100
6453c6434378ccc9c6976a97b310c40f3e259f04,11,338,37,301,1,0,1,10,67,520,4,5,2.524918774,8479,25,6,2710,2635,75,60963,59450,1513,658,643,15,99.97350467
819514f157d0c7c4a5cf9393525ddeead1b22be1,1,58,10,48,0,0,0,6,23,47,1,1,0,292,215,4,98,89,9,2194,1960,234,26,22,4,100
d81211251dbbae64b33c97dea89a96add465c03f,1,4,4,0,0,0,0,1,3,0,1,1,0,98,216,5,4,4,0,787,786,1,4,4,0,100
3c85ec758a4b6741df32d4542e64599f69adb3f3,3,74,3,71,0,0,0,2,24,297,2,2,0.650838804,968,26,6,297,292,5,7537,7062,475,59,57,2,100
47a0f41e728acbe80b1f1b1f2e6631252a5bb711,2,3,3,0,0,0,0,6,24,317,1,2,0.918295834,432,217,6,108,107,1,2846,2837,9,34,34,0,100
1ddbd610420d47beee737d18c7ebc23e9f762554,4,81,51,30,0,0,0,4,13,0,2,3,1.573862182,886,218,7,251,250,1,5556,5554,2,92,93,1,99.99337836
958c2b6d32d911daf5f624a154c02f91eabb468f,0,0,0,0,0,0,0,0,0,0,0,0,0,0,161,12,0,0,0,0,0,0,0,0,0,100
937d0f42f0eb7d0bb583fe2696666533a69549ba,9,30,315,285,0,0,0,10,68,0,2,3,2.413134084,6799,27,7,2160,2227,67,44118,45476,1358,553,566,13,99.97351169
e30261e55ac49090078c1cacd1d45a09a829fdb9,5,176,77,99,0,0,0,8,37,4,4,4,1.139464093,1144,219,8,236,215,21,8282,7538,744,116,110,6,99.98675321
4ed05803e164516f9e17d729635630c7bb46e2cb,7,136,30,106,1,0,1,7,36,2,4,5,1.63857097,3337,220,9,894,879,15,23258,22656,602,411,405,6,99.76250165
2065e905dd039558700a302bcec49232266b844b,3,43,17,26,0,0,0,1,42,2,3,3,1.054015773,2281,221,10,608,603,5,15346,15235,111,226,223,3,100
64329e007eb2ba4329d3f140f138e3c6a075b1c2,5,179,100,79,0,0,0,8,50,9,4,5,1.970700342,2733,222,10,714,701,13,20548,19963,585,237,233,4,100
8746348ea3352d60a0b2e33f36b165ed0d01eda2,0,0,0,0,0,0,0,0,0,0,0,0,0,0,15,3,0,0,0,0,0,0,0,0,0,100
c71522fa9a07b3546d0547bc32da8764267715bd,13,514,180,334,1,0,1,8,43,316,4,6,3.005574499,5553,223,11,1436,1413,23,37205,36039,1166,663,650,13,99.92770768
b7ca8734b96a91b81d46ffcb3f60d6b91100f0c3,2,20,5,15,0,0,0,1,17,0,2,2,0.989587521,406,224,12,72,72,0,2845,2762,83,28,27,1,100
592352e8b82ea0be9e44a4d2d6bff9f0f90abb6d,1,10,5,5,0,0,0,1,2,34,1,1,0,749,16,4,83,83,0,5224,5189,35,30,30,0,100
808f4a61740d6e6e28bac470b15e203ae20b0afc,1,9,4,5,0,0,0,2,6,41,1,1,0,335,162,10,43,42,1,3074,3049,25,5,5,0,100
f9c94752d7629a0cf6c5b82171d190c35abefb70,10,575,38,537,4,0,4,7,50,200,4,6,2.68875896,3077,225,13,723,665,58,21419,19467,1952,373,340,33,99.94089446
ddec73796c5104ce88e94a47609c1564cd42d507,2,54,2,52,0,0,0,1,19,2,2,2,0.985228136,609,226,14,138,129,9,4781,4491,290,60,57,3,100
5fd390856e9932e95fca0aa70e702d74cf5a9f34,1,1,0,1,0,0,0,9,40,3,1,1,0,570,95,5,135,135,0,3768,3755,13,62,62,0,100
d61b3b26a9083edd11543ce27a697480498d4597,0,0,0,0,0,0,0,0,0,0,0,0,0,0,163,10,0,0,0,0,0,0,0,0,0,100
4d5a6c5e562e7afa4305703807a9b67bd74688eb,10,372,3,369,2,0,2,9,38,92,2,2,2.864434571,2100,28,7,535,495,40,14195,12935,1260,201,178,23,99.96720236
7b5510cabcdbc156229d9014d3fa9c3e616da890,5,311,0,311,5,0,5,1,1,0,1,1,2.217529065,0,29,8,23,0,23,669,0,669,21,0,21,99.92137335
f7b6f944b2a917c839e4b6427479a83b3db702d4,0,0,0,0,0,0,0,0,0,0,0,0,0,0,227,15,0,0,0,0,0,0,0,0,0,100
c27f31a107aa9a9a94dedb2281a02a36c4c9b134,6,169,146,23,0,0,0,9,41,816,3,4,0.948341823,1870,228,16,452,437,15,10819,10355,464,204,193,11,100
2e07d6bc8f6edf431cb46b0960f2848a1acb56fb,0,0,0,0,0,0,0,0,0,0,0,0,0,0,17,5,0,0,0,0,0,0,0,0,0,100
f99be0c0e063e0d78870b5f012d3b423c1300d6b,3,167,6,161,1,0,1,1,3,562,1,3,0.408634596,312,18,6,38,33,5,1985,1408,577,23,18,5,99.97380485
b620c40e3e05b4c6bd9c9f411d3e038ba409a6af,7,219,2,217,0,0,0,3,81,577,1,2,2.377648415,6905,19,7,1842,1817,25,41499,40430,1069,735,727,8,100
fa86624289469ba7b864d015d6bcd46cec9d842a,2,80,9,71,0,0,0,7,48,787,1,1,0.80679555,742,20,8,197,189,8,5274,5008,266,63,60,3,100
c3691f5e887c9f561097702ae8f04d7ef3d485d4,3,35,18,17,0,0,0,4,37,484,1,1,1.193810315,1509,21,9,366,366,0,9310,9271,39,240,240,0,100
889ca9d6a44b0203fff8cc1e55e2d79380abb43a,2,2,2,0,0,0,0,1,23,14,2,2,1,1109,229,17,200,200,0,7665,7665,0,122,122,0,100
cff59ec5c2ada0502e507bc4f62220fd884c5cce,0,0,0,0,0,0,0,0,0,0,0,0,0,0,230,18,0,0,0,0,0,0,0,0,0,100
9f0a175b8d547b07390009237a82919e92c9fa65,1,7,7,0,0,0,0,8,18,8,1,1,0,301,96,5,64,64,0,2100,2099,1,21,21,0,100
b4a09c4dab3a45e3f555143cd88666d1f19f27a6,2,6,6,0,0,0,0,1,3,2,1,2,0.650022422,242,22,9,27,27,0,1341,1341,0,13,13,0,100
72ac31544f10531e4ee6b55214f29597646c06dc,2,15,5,10,0,0,0,9,42,536,2,2,0.970950594,1082,231,19,199,197,2,7193,7141,52,88,88,0,100
e2aea2d05a745eca2f2c47200c4461b7e716d1cf,6,81,10,71,0,0,0,6,50,106,3,4,1.999759645,4211,30,9,1296,1283,13,30132,29754,378,330,325,5,100
26b54075bb3969875b0778fb1939f8a37ff5d944,1,8,7,1,0,0,0,2,5,23,1,1,0,183,97,4,6,6,0,1306,1304,2,4,4,0,100
9c003aa909bfe868ecb23f4940aaf3e859bce7cf,1,4,4,0,0,0,0,1,4,44,1,1,0,178,98,5,9,9,0,1212,1212,0,8,8,0,100
6bbbb786c20890f2d4d54bca238690651e177758,4,348,0,348,4,0,4,1,1,0,1,1,1.950045602,0,31,9,70,0,70,1560,0,1560,32,0,32,99.9410802
72fa143e539c20012fa03224c489c36f9567a255,1,27,5,22,0,0,0,3,4,1543,1,1,0,93,99,6,16,13,3,573,488,85,6,5,1,100
ed3889ff690ee3bc974c5efad6a59b09f767da3e,1,13,11,2,0,0,0,3,5,0,1,1,0,111,100,7,15,16,1,610,573,37,6,6,0,100
16778feb2961a4e3fe0bc98e3ce70c761f2ae888,3,3,1,2,0,0,0,1,2,0,1,1,1.5,239,32,10,55,55,0,1330,1316,14,24,24,0,100
0416d6b54c83585ace5fab8280151b2af0c4c354,1,5,4,1,0,0,0,1,5,2,1,1,0,178,101,8,9,9,0,1208,1212,4,8,8,0,100
80aea14f18227ceafca32cc4a36f614280a7fcc9,2,6,1,5,0,0,0,2,37,237,2,2,0.985228136,1172,102,9,337,336,1,8407,8397,10,95,95,0,100
64be080321a7d0e33572b4b591dd6b41ff38ad46,1,3,1,2,0,0,0,2,3,15,1,1,0,753,103,10,83,83,0,5234,5224,10,30,30,0,100
32a6c11b0a0e5067d257be335bb77d3b7cb08ef0,1,0,1,1,0,0,0,3,6,6,1,1,0,113,104,11,15,15,0,603,610,7,6,6,0,100
0916d4b109fe103da7bd8d79d093a5ad1fc8182d,10,161,45,116,1,0,1,9,43,214,3,4,2.580834892,5492,232,20,1604,1590,14,36743,36331,412,776,770,6,99.96075096
ba62ff1aa34908c39155aeb00585ce164c942d91,1,2,2,0,0,0,0,1,2,1107,1,1,0,224,233,21,73,73,0,1290,1290,0,41,41,0,100
b20e5e7086270cd9b676b584fec5cf2f8715d126,0,0,0,0,0,0,0,0,0,0,0,0,0,0,164,8,0,0,0,0,0,0,0,0,0,100
5b558e5388dd98b3df44cc7e52a20b38684d5c32,1,2,0,2,0,0,0,10,51,14,1,1,0,1366,234,22,442,441,1,9977,9949,28,72,72,0,100
8a9595bed48728c8dde434b46c747b7c1b5a31a2,12,797,88,709,3,0,3,1,44,534,6,8,2.390327353,2378,235,23,809,690,119,19255,15788,3467,235,188,47,99.71856797
897a9120135cbf6677f11b122a1fc9c6ed15dc0c,1,2,1,1,0,0,0,5,8,85,1,1,0,78,236,24,17,16,1,455,448,7,2,2,0,100
1b7ff075c9146e7d4856ed7e1c1e051f253e76b6,14,798,40,758,7,0,7,1,69,56,3,6,3.276013788,6057,33,10,2016,1846,170,45621,41871,3750,665,593,72,92.12094132
a1f6b1550fdc7f59abf9da0c39c0c3cc686024d7,1,147,0,147,1,0,1,1,1,0,1,1,0,0,23,8,11,0,11,841,0,841,6,0,6,99.97411562
1d47f145476b3fe5e01629b136fd42dd8298f6c2,1,9,2,7,0,0,0,11,82,20,1,1,0,3686,200,1,1077,1077,0,22804,22781,23,278,278,0,100
7d0452763ae5b3abb09ac03a78dd146c33a7029f,8,633,21,612,5,0,5,1,34,12,1,2,2.560360722,3144,24,9,761,683,78,25544,23135,2409,200,153,47,99.89657847
3adf70a029dadfe5e5a5765b02f04c89af149244,3,269,0,269,3,0,3,1,1,0,1,2,1.3184459,0,165,4,19,0,19,1083,0,1083,8,0,8,99.93976422
2582d4de0b9d6aad08a9000817090a8d7b454ff4,2,0,20,20,0,0,0,1,5,36,2,2,0.934068055,327,237,14,78,79,1,1855,1932,77,26,27,1,100
556e09b69ff92fead71f523853a52d2f688b23d1,4,23,23,0,0,0,0,9,45,17,3,3,1.05340815,963,238,13,216,216,0,5925,5901,24,105,105,0,100
3fc7f54a01a61dbc9fabacec3f13b68762d4718c,16,1092,12,1080,5,0,5,1,83,123,3,8,2.875253466,8292,239,12,2196,2056,140,57511,52836,4675,914,860,54,91.8901454
f08e4e1791528a88645cfc6dff550955ae8e71b9,4,18,14,4,0,0,0,1,4,45,2,3,1.599730147,710,240,13,168,165,3,4820,4784,36,47,47,0,100
d1c23c2d9df241ec2c3247aa0dd5ef18eafaa261,4,201,5,196,2,0,2,1,32,97,2,2,1.843580616,921,105,9,233,218,15,8316,7659,657,60,48,12,99.97412946
1a643ec8996be5d39a278c6672b87a60a63208b5,1,0,1,1,0,0,0,11,84,2,1,1,0,3710,54,0,1080,1080,0,22858,22869,11,280,280,0,100
ba80c168064e490728bff405201f9588c0dfa29a,1,2,1,1,0,0,0,3,7,560,1,1,0,171,55,1,25,25,0,1119,1114,5,10,10,0,100
350dcbc92a2c2fcf52abf1f7500cda0e3fce6283,1,7,6,1,0,0,0,1,3,1,1,1,0,163,106,10,15,15,0,1381,1379,2,7,7,0,100
1a4223d35b6b97d188256ef5777b4a8fc12cdc72,1,28,11,17,0,0,0,9,46,3,1,1,0,506,241,12,117,113,4,3244,3166,78,63,61,2,100
357cf347c8162ccc680861ab17934eb1dfa1a353,12,503,35,468,2,0,2,1,70,114,3,8,3.000486181,7597,34,4,2359,2246,113,55211,52696,2515,791,758,33,99.97414283
1a407b6d6802202e9d7aa0f0882fbdb94213af55,1,9,2,7,0,0,0,2,6,36,1,1,0,184,107,11,6,6,0,1361,1306,55,4,4,0,100
679989fd16a96bd9f94c0a68face0374dfaa2b44,4,816,1,815,3,0,3,1,12,46,2,2,1.287549241,255,56,2,158,51,107,5023,1573,3450,72,26,46,99.96382242
40ec58ce0dcf3d57fd8cf1994482ecc58e9a6b31,5,428,2,426,4,0,4,1,5,0,1,1,2.313143035,341,35,5,140,47,93,4389,2379,2010,73,33,40,99.98966622
47c15ce621a9c074d557bc478238e43a299f5b8a,2,2,2,0,0,0,0,1,2,0,1,1,1,138,36,6,44,44,0,705,705,0,15,15,0,100
cfd133447f77965fc5ba7c9522d204f7b768cb44,2,24,7,17,0,0,0,1,3,5,2,2,0.99323382,233,242,11,41,38,3,1841,1702,139,15,14,1,100
f72b68bfbbe46ef6a6d93810b5081dd415fd15d6,8,716,8,708,6,0,6,1,18,174,3,3,2.617404632,771,37,4,292,217,75,7886,5089,2797,200,147,53,99.93286858
e2fef6a276ef70e789672f11b0971d1b8ab90336,9,674,12,662,7,0,7,1,35,3,2,3,2.845340169,1695,38,5,534,432,102,17004,13949,3055,135,80,55,99.96388961
9d7360cb35872203b416bdf3767f02f1c4158eb9,4,54,4,50,0,0,0,6,26,523,2,4,1.107994724,1437,243,11,331,326,5,12603,12204,399,90,89,1,100
62c76e42eaae0fef7a25ed69595cc9d94638d5e0,6,248,16,232,4,0,4,1,36,5,1,2,2.247792648,2455,39,6,646,625,21,19145,18413,732,149,126,23,99.95361064
22a0f837e110d422b945e80148e2c0f85412fef1,29,6238,123,6115,12,0,12,1,90,380,4,8,3.112886169,7871,57,3,2435,2127,308,75136,53967,21169,848,703,145,91.91513761
909c8381381f827b1cfdde1a88f4485a62adf194,1,15,6,9,0,0,0,2,3,104,1,1,0,107,25,2,13,13,0,548,544,4,5,5,0,100
094f9149691c3c8c49134817c2a6f0053346ffd6,1,1,1,0,0,0,0,1,5,229,1,1,0,356,244,7,99,99,0,2179,2179,0,61,61,0,100
b0a4367dd0f5e0a5492df595b621806d06375535,1,34,11,23,0,0,0,6,32,62,1,1,0,606,245,8,197,188,9,3760,3629,131,68,66,2,100
f5cc8d8b9c848cf1668fde797b7f0cd4afd53bc8,3,81,0,81,1,0,1,7,28,27,1,2,1.301045758,588,246,9,139,131,8,4036,3766,270,47,46,1,99.96662495
bf16127d1973594fdc5c1868521cf14228656527,1,4,0,4,0,0,0,1,3,25,1,1,0,301,247,10,86,84,2,1956,1930,26,29,29,0,100
a9c858b39ac525c3a0403c3aff8bb4b8f8f39880,4,13,16,3,0,0,0,7,29,3,1,2,1.664761722,2995,248,11,137,139,2,12195,12221,26,54,54,0,100
bcfb4e9c8379ec26d2c86876cdf34edc37e1979c,2,30,40,10,0,0,0,2,3,0,1,1,0.927526588,2616,58,4,27,27,0,9544,9660,116,27,27,0,99.96663052
75cf4c522f41e6dfcbac89a2905498085d7f728e,10,266,139,127,3,0,3,1,15,347,1,3,3.101337094,1509,249,12,291,283,8,10352,10481,129,123,110,13,97.13975984
d22fc6ab7c1a6827f1074d5af43a2e9faec9b2d9,1,1,1,0,0,0,0,4,6,1390,1,1,0,87,40,6,7,7,0,533,533,0,6,6,0,100
4d28f28b20ee8300fe6c68c914e1f0b2e0974c24,2,0,108,108,0,0,0,1,9,0,1,2,0.309543429,436,250,13,81,89,8,2505,2994,489,26,30,4,99.98332778
b811a6c43b6441dc59c549e09942ab3a5262b3ce,12,649,9,640,6,0,6,1,47,12,3,4,3.004741396,3541,41,7,1189,1054,135,27301,24384,2917,426,369,57,99.78369384
26a45518fdd70d2122e9fb271014a82a85508178,0,0,0,0,0,0,0,0,0,0,0,0,0,0,166,0,0,0,0,0,0,0,0,0,0,100
e11b753da59ea89db2a1fc419b0297ff358e9bc8,1,2,1,1,0,0,0,1,4,3,1,1,0,305,251,14,86,86,0,1962,1956,6,29,29,0,100
cc38e27eef7fe280d4ed916c4638d9b9aa43aac4,3,3,3,0,0,0,0,8,91,12,2,2,1.584962501,5152,59,5,1436,1436,0,36021,36021,0,475,475,0,100
efc6ba4735d62cb8a82ed2ce29096d149d516c4f,1,47,53,6,0,0,0,10,59,2,1,1,0,644,167,1,143,145,2,4451,4482,31,36,36,0,100
f3d17048635af85d302917744a3deb6bc62880b3,3,40,12,28,0,0,0,1,92,322,2,3,1.517649526,4475,168,2,1415,1409,6,33507,33352,155,287,286,1,100
a95c0f0f89dffb81fad5332154b9ff6c76228489,1,13,2,11,0,0,0,1,2,15,1,1,0,731,60,6,105,104,1,4471,4431,40,20,19,1,100
781c837812a85b066229b5b2335aaf8b4548f5e9,2,18,8,10,0,0,0,3,12,121,2,2,0.235193382,601,61,7,107,106,1,3885,3832,53,39,39,0,100
23145bf7ca4013fc60da59f260f2425fdb4c4b2b,6,83,4,79,0,0,0,4,33,379,3,3,2.453282776,1508,252,14,369,359,10,8667,8433,234,182,175,7,100
8bf4da08ff55a42ec65911e35b41e4759f9b43cc,1,5,6,1,0,0,0,1,3,3,1,1,0,741,62,8,104,105,1,4468,4471,3,20,20,0,100
730ff8813eed5a331787765e2beeb6e3c5155f4b,2,23,4,19,0,0,0,5,49,124,1,1,0.918295834,997,26,1,315,311,4,6804,6722,82,107,105,2,100
b611d3f34eff77e92aa885beb2f5a2e03aa53747,1,3,0,3,0,0,0,1,3,79,1,1,0,98,27,2,5,5,0,597,577,20,5,5,0,100
3e8f626668110f4fc27b43c32938677043fe9667,1,0,4,4,0,0,0,8,41,10,1,1,0,1345,28,3,351,351,0,8286,8300,14,218,218,0,100
deda5b3a40601bd6ce40eefef089111b19ebdc94,1,3,3,0,0,0,0,6,53,44,1,1,0,1233,29,4,261,261,0,7340,7342,2,220,220,0,100
0098cc1e254b07b459201a1b01217a2308ffdbd4,13,619,24,595,7,0,7,2,37,26,2,3,3.101603367,3030,42,8,777,703,74,24512,22215,2297,216,168,48,99.8756322
c3338d82ba42370e06177d801ba3fb07ad719a8b,1,0,3,3,0,0,0,2,6,0,1,1,0,285,43,8,32,32,0,2061,2079,18,14,14,0,100
2f3ef42f4f30c2c85490538e76fccdce471114f6,3,1,220,219,0,0,0,1,3,0,1,1,0.689173064,312,44,9,24,61,37,449,1740,1291,16,32,16,99.95031056
dff6bf561b60a0446dc5d8995fba7fb699742e6a,10,531,26,505,4,0,4,1,38,2,1,2,2.408217215,2835,45,10,756,682,74,23194,20695,2499,189,159,30,99.92551519
30ee661fdca6bb2c0a8ebf9296c62a2e1dcfd1e8,76,7530,14,7516,70,0,70,1,51,6,3,6,5.896135626,3229,108,0,1858,930,928,59818,24310,35508,965,340,625,95.19675004
19fd6b3927edd7a7d6b887698978aedfd3acd57e,1,15,6,9,0,0,0,1,2,67,1,1,0,243,253,10,72,71,1,2047,2010,37,21,20,1,100
4b31d54b3e5d20391301f6bb54537a80ae0a66cf,3,93,4,89,1,0,1,9,47,16,2,2,1.157878029,1865,254,11,476,468,8,11954,11530,424,283,281,2,98.45750655
cae33419ae4aab79500a8d574ff7873f005a955f,3,51,25,26,0,0,0,2,12,664,3,3,0.397505862,604,255,12,143,139,4,3985,3924,61,49,46,3,100
70cfcaaee150011087f228e648c2ec30ed865cb4,3,2,12,10,0,0,0,6,93,25,3,3,1.148834854,3468,63,6,1012,1014,2,25151,25180,29,240,242,2,100
b612d646209bc72c0948a8f7e6d03527a6bdb3cd,2,31,4,27,0,0,0,10,44,60,1,2,0.985228136,2400,46,9,788,784,4,16978,16880,98,285,282,3,100
b45109cec3f0541b97b8d436a3026bf5242f75cb,2,3,2,1,0,0,0,10,45,2,1,2,0.970950594,2415,109,1,788,788,0,16980,16978,2,285,285,0,100
dab2ec2eadeab4ddc09da398cec9f4e6b3221107,1,0,1,1,0,0,0,10,46,0,1,1,0,2266,110,2,758,758,0,15897,15910,13,275,275,0,100
f1d4abda2593f6f3e71b30df0d926f46f07c5a91,1,4,0,4,0,0,0,3,9,35,1,1,0,73,64,7,12,11,1,336,312,24,11,10,1,100
23b0b876741f7968141fa6a04124940b3a6a62cf,2,12,0,12,0,0,0,6,40,95,1,2,0.979868757,1333,256,12,387,382,5,9769,9697,72,108,107,1,100
de5e6c9ba9343d24e0ee992f5a54f98372ee1469,37,3333,6,3327,31,0,31,1,8,21,2,4,4.558990526,789,111,3,504,147,357,20289,5497,14792,329,57,272,98.91857051
1ece64d1df09297becfd9ff9387aec7d6ce93667,2,2,2,0,0,0,0,10,47,4,1,2,1,2415,47,8,788,788,0,16974,16967,7,285,285,0,100
ca9d49a5f46ac54fab6d7d1368b8348bac626241,2,8,4,4,0,0,0,1,2,74,1,1,0.811278124,82,169,3,5,5,0,266,258,8,5,5,0,100
a1917d1378d0ca3acee5175a9ba994caa31f9f87,14,317,27,290,1,0,1,9,52,243,3,8,2.278008759,7312,257,13,2137,2105,32,48290,46776,1514,714,697,17,99.95082543
4506244327679448c5622c388f4a6bb021425715,16,301,84,217,0,0,0,9,85,43,4,5,3.486840066,11993,258,14,3186,3157,29,76371,75107,1264,1188,1176,12,99.95785333
ab9d17f12e6e5bc2b784d7f4e5b4d45b47aac9b6,1,12,15,3,0,0,0,8,16,631,1,1,0,688,48,8,209,208,1,4882,4864,18,85,85,0,100
dfe19d2f4f70433b77d608846b3c4b5b746ef4a0,1,0,1,1,0,0,0,5,10,41,1,1,0,90,65,7,16,16,0,559,568,9,10,10,0,100
a375ef4fd9794fa341a916d75ef8bd3e0ed2b69c,3,47,10,37,0,0,0,1,19,0,1,1,1.557431962,547,259,15,131,128,3,3790,3696,94,75,72,3,99.98594914
c67cd5d0be03ee6dac397b4ca48304aaaeaed1c8,1,1,1,0,0,0,0,7,14,375,1,1,0,576,49,9,63,62,1,3797,3787,10,7,7,0,100
6e6cb3786cf600fde129f688093bf1edd62e581a,26,3518,5166,1648,11,0,11,8,86,170,4,4,3.597152419,10141,66,8,1924,1770,154,54982,53526,1456,719,639,80,96.12835976
393111b875f27b8d7269b4633c467d744e150853,8,168,210,42,0,0,0,2,55,54,4,4,2.331482887,2649,260,14,462,463,1,16513,16492,21,300,301,1,99.97624515
c5a3a56b482741c736e20816c96a2dfc41204cb1,2,4,2,2,0,0,0,2,2,1172,1,2,0.918295834,546,67,9,35,35,0,3433,3424,9,35,35,0,100
c8c43e40654365d68bebfa27b3d8d4e648dca869,5,20,0,20,0,0,0,2,2,1170,1,1,2.321928095,228,261,12,34,29,5,742,685,57,31,26,5,100
272c584af2f2522ebe458fd9a9424229b39b11da,3,12,1,11,0,0,0,9,54,17,2,2,0.773228349,4472,262,13,1374,1372,2,30475,30423,52,326,324,2,100
0e7c84ef81c1fa5b92a07f4604d00217479b831a,5,381,1,380,2,0,2,1,10,903,2,2,1.664454101,778,68,9,277,232,45,6401,5017,1384,114,89,25,99.98416719
d8da81082080655b7da3e0e8fb689c3986316543,19,236,41,195,0,0,0,1,52,33,3,8,3.63426135,7888,112,4,2167,2139,28,57475,56277,1198,924,913,11,100
28603688011e647783f34c44513a24bbd59de4e9,2,35,9,26,0,0,0,2,53,589,2,2,0.875663392,1737,50,8,467,460,7,13113,12939,174,129,129,0,100
44ffbd2f792b9fb9cd423b40b7c0b2b50baf629d,1,8,2,6,0,0,0,8,19,50,1,1,0,852,51,9,251,249,2,5765,5742,23,128,128,0,100
29a2d30a8a3af9ee28cf132f59732f3b061d0964,9,100,19,81,0,0,0,1,49,9,2,5,2.79260931,4494,113,5,1171,1168,3,32134,31574,560,452,451,1,100
6b40e7268302db484c11e3d69324f4e3fd12819e,4,226,1,225,3,0,3,1,8,13,1,2,1.533378754,87,263,10,31,15,16,1220,413,807,22,8,14,99.86543181
7c9ef84fb9a297025e1817557a9e54faa1d92e9d,4,38,1,37,0,0,0,1,54,10,3,4,1.763577314,2652,114,6,738,732,6,19701,19442,259,205,204,1,100
390f390b29bc859baca0ba4be551428d7f3c83fc,18,136,56,80,0,0,0,11,94,341,1,4,3.066466584,10669,30,4,2864,2858,6,76957,76383,574,834,833,1,92.91385868
a51486c7397bc7bff2969e7adad5ab29a4eec36f,0,0,0,0,0,0,0,0,0,0,0,0,0,0,31,5,0,0,0,0,0,0,0,0,0,100
cb271bfa1d343a9637e4120679f941d25457ffbc,6,699,3,696,2,0,2,1,18,562,1,5,0.717600976,621,32,6,156,90,66,6927,3935,2992,94,73,21,99.97117657
5a16f8f6f847ca3e5b5df77ff37d86d853dacbb1,2,18,2,16,0,0,0,2,19,45,1,1,0.881290899,324,33,7,79,75,4,2212,2071,141,25,25,0,100
469a10d909e987b32e0d278200cc2c336deb3a73,3,89,0,89,1,0,1,5,35,16,1,2,0.177575182,721,34,8,228,219,9,4486,4214,272,89,81,8,99.97695189
ff8d46578c84df4b581976a24d51970275845497,1,7,0,7,0,0,0,4,7,1578,1,1,0,85,170,1,16,15,1,461,446,15,14,13,1,100
65a82198173057b46ba40a157e65ebf38d79b0aa,18,1389,3,1386,15,0,15,4,4,104,1,3,3.613584028,355,35,9,153,33,120,8015,2621,5394,144,24,120,99.77573318
2e5a6e447884e01d772410f9e47949b6cd6c4694,2,5,1,4,0,0,0,8,46,142,1,1,0.650022422,2409,36,10,721,720,1,15655,15628,27,316,316,0,100
ed8ec0243236144cbc7f88a56e6a30cc9c8fcf72,3,73,17,56,0,0,0,6,23,24,1,3,1.074627699,1093,37,11,351,339,12,6885,6754,131,108,106,2,100
1d94611932b074f974c09843b14e95d56edf0e73,19,11,92,81,0,0,0,7,30,336,1,14,3.614939568,4840,171,2,686,692,6,31224,31943,719,384,386,2,99.34491598
2ee441dc78c7a00bce9b267e10480edb158d4fd0,1,2,0,2,0,0,0,8,36,20,1,1,0,529,38,12,116,116,0,3408,3408,0,34,34,0,100
2edc92d97f4aaf69897a14e45f2b6b2a18f9ca46,1,317,0,317,1,0,1,1,1,0,1,1,0,0,39,13,16,0,16,1478,0,1478,4,0,4,99.97739347
bb1bc8a39d556b290083e67a7980b0da9fe6b281,1,21,17,4,0,0,0,1,2,5,1,1,0,456,40,10,59,59,0,2601,2617,16,14,14,0,100
05c5ad096b3d2e06d55056d0a307aa90c4f1dcbd,1,3,3,0,0,0,0,12,95,5,1,1,0,3219,41,11,958,958,0,23599,23605,6,225,225,0,100
c5c53984975327f22e4ae1b9783229651007a9bb,15,441,87,354,3,0,3,1,16,393,2,4,3.100759772,1854,264,11,366,340,26,13518,12219,1299,163,146,17,99.79054628
944ee1607be9339a33da700791f8745e0988bf16,1,0,2,2,0,0,0,6,12,7,1,1,0,92,69,6,16,17,1,570,593,23,10,10,0,100
b00ef73b409f3c08dbab9d35fd81911808368d6c,1,2,2,0,0,0,0,7,15,25,1,1,0,576,52,6,63,63,0,3797,3797,0,7,7,0,100
ca000780721555642a86ccf77fc4bace3e7d8cd9,8,201,182,19,2,0,2,8,47,6,3,3,2.741823394,2481,70,7,608,609,1,15330,15354,24,321,321,0,99.92059441
6f253f050beebf194ad5b7bb2596830a152a4a57,11,296,54,242,2,0,2,1,96,12,3,4,2.955694311,8371,115,6,2510,2479,31,61212,60381,831,754,724,30,99.97731912
ed0f74a34b88e2a4b27f87a25a27045ef8ada79a,1,15,3,12,0,0,0,1,3,0,1,1,0,222,116,7,28,28,0,1584,1544,40,17,17,0,100
1d92b9a5c01e00062fe68ed33ffaa855fdb5a45c,1,2,3,1,0,0,0,3,9,51,1,1,0,179,71,8,26,26,0,1150,1168,18,10,10,0,100
9e683c761291fe923a8d0ee5b52ae7cc4bdd9a9d,2,451,114,337,0,0,0,2,97,1,2,2,0.355601538,3674,53,7,1047,1017,30,27789,26198,1591,244,239,5,98.02945338
7ad6a01e8409d41c39bdeb9965018cae0795fe5a,0,0,0,0,0,0,0,0,0,0,0,0,0,0,72,9,0,0,0,0,0,0,0,0,0,100
2d9f445cb880cd931f5ae02f737d322142867091,1,0,1,1,0,0,0,8,50,47,1,1,0,723,73,10,199,199,0,4948,4955,7,63,63,0,100
c3175eea3c3885286898170fae6b487b070f60b5,80,2625,182,2443,15,0,15,1,48,189,2,3,3.702130588,5342,265,9,935,933,2,29258,28018,1240,689,687,2,99.63519626
90b84c5d73db4d0d7fa3e5520358912961b59c43,1544,191083,191083,0,0,0,0,2,87,118,6,117,9.792408883,145973,172,3,21016,21016,0,786675,786675,0,13041,13041,0,100
b546423063fe7c1889f7764393102f423a699483,0,0,0,0,0,0,0,0,0,0,0,0,0,0,173,4,0,0,0,0,0,0,0,0,0,100
31ae5802525dc7948002eeb6c650a51b357e821b,1,24,1,23,0,0,0,5,15,218,1,1,0,220,54,6,47,42,5,1354,1286,68,16,14,2,100
f48b254ebace5b68341ba522f01c75c9f35fc2d3,22,1173,903,270,0,0,0,2,6,7,1,5,4.424696416,4951,55,7,722,616,106,36356,34129,2227,406,402,4,99.08383411
9d3a7899be4473e287831628fb20a336b36c8620,0,0,0,0,0,0,0,0,0,0,0,0,0,0,174,4,0,0,0,0,0,0,0,0,0,100
fac1cf7614c34fccd4e965c0ee2104d887bfc0fb,0,0,0,0,0,0,0,0,0,0,0,0,0,0,56,6,0,0,0,0,0,0,0,0,0,100
66f829f7eb658a8563e844112b2dbfdd181794b2,0,0,0,0,0,0,0,0,0,0,0,0,0,0,57,7,0,0,0,0,0,0,0,0,0,100
a4124b4743fefc0e755c9def9d6171cac17722bd,6,573,0,573,6,0,6,1,1,0,1,1,2.363638296,0,42,12,45,0,45,2077,0,2077,45,0,45,99.93007342
32796f751b23286fff8d38d7114daf315f7b8fce,43,1013,160,853,1,0,1,2,88,348,5,18,4.624584925,16959,266,5,4366,4284,82,108923,105084,3839,2289,2221,68,99.98502695
7e6ca9043ec603422c26dc7ff990b4a396a29dcd,4,44,9,35,0,0,0,3,72,11,3,4,1.556411811,4627,117,5,1198,1189,9,31302,31066,236,410,410,0,100
c7fabe7ff767d129f56f36fc4dcbcd44b9eb9744,1,59,21,38,0,0,0,3,8,0,1,1,0,1390,118,6,201,195,6,9250,9016,234,127,127,0,100
ad0c7db14c2c40f743c2b1bcf747618926a49afa,2,44,0,44,0,0,0,3,44,27,2,2,0.266764988,2836,119,7,676,672,4,18259,18021,238,291,291,0,100
f8bb2a83e63846ba98063d2d6bc172ba5782d5a4,37,429,353,76,0,0,0,9,55,57,2,10,4.269786801,15689,43,13,3022,3006,16,106877,106515,362,1101,1082,19,100
7f5471bae7437f50e3558456bcc8bc01ca77362b,1,1,1,0,0,0,0,4,4,30,1,1,0,114,0,0,13,13,0,801,801,0,7,7,0,100
d3b1a2e368b9df5924946fa48e971d09c4df7bc4,2,8,3,5,0,0,0,8,38,20,1,1,0.845350937,930,74,5,226,225,1,5821,5799,22,82,81,1,100
a5e3bdd592b4c963ff5b6549fa8a44f01e40363a,3,137,39,98,0,0,0,2,36,30,2,3,1.013575479,1473,44,14,331,318,13,9497,9119,378,113,109,4,100
80be256e13869d0f742e17596a8366826f861db5,4,171,3,168,1,0,1,1,98,73,2,3,0.609310903,3686,175,3,1096,1083,13,27848,27037,811,324,314,10,99.99002394
33ed6bfb7f4c9372cc2196394e6dc9dc2b9ee203,3,174,40,134,0,0,0,3,73,123,3,3,1.102296083,5041,120,5,1315,1296,19,33846,33105,741,600,598,2,100
f21f7b5ae5d52a2897fc96916ef20fb6f0f541a8,7,253,5,248,3,0,3,2,74,40,3,3,2.454270426,3416,58,5,987,950,37,24472,23411,1061,323,304,19,99.96511338
19371ce1747cfbec0f6ab22241e28304d27d59c2,1,6,1,5,0,0,0,10,63,344,1,1,0,3072,59,6,631,631,0,24857,24817,40,123,123,0,100
0aedae43701528f57b32dea534b5def3a576074d,1,2,2,0,0,0,0,7,13,75,1,1,0,226,1,1,47,47,0,1550,1550,0,15,15,0,100
a0a3418ae029a0037481d7fdce16de2dcfe930da,0,0,0,0,0,0,0,0,0,0,0,0,0,0,176,4,0,0,0,0,0,0,0,0,0,100
318d408ab7a17e2c3142885b9c6febc25a39d774,0,0,0,0,0,0,0,0,0,0,0,0,0,0,424,0,0,0,0,0,0,0,0,0,0,100
b6e661e24a3f5993ba24df9819e61f8ed028a115,174,876,698,178,0,0,0,4,99,205,7,28,6.686240692,72386,177,5,19034,19034,0,498041,498041,0,6473,6473,0,100
05e379036c593e0efd4fa9c019f0ae563f48c926,0,0,0,0,0,0,0,0,0,0,0,0,0,0,178,6,0,0,0,0,0,0,0,0,0,100
bb2c50ee43f3d0545907e3950abc29a418376606,0,0,0,0,0,0,0,0,0,0,0,0,0,0,179,7,0,0,0,0,0,0,0,0,0,100
b6f8f0f4ecaa16e04d3129adeb7280686cd97416,0,0,0,0,0,0,0,0,0,0,0,0,0,0,180,8,0,0,0,0,0,0,0,0,0,100
5e820a36c9910d9240ea24a89bac5ace670eeaf1,4,69,38,31,0,0,0,3,34,24,2,3,0.780931095,1411,121,4,324,318,6,10200,9952,248,110,108,2,98.26794757
616f8fdbeecc04527b49d616a71ed410f6472dc0,1,105,5,100,0,0,0,10,16,7,1,1,0,458,2,2,100,82,18,3380,2868,512,34,30,4,100
718370e1ef8ceaa48fedfa92b90dc49de6cb530b,27,3616,364,3252,6,0,6,2,63,48,4,6,2.289079947,7726,75,1,1696,1561,135,67008,55076,11932,745,782,37,95.04423
bb01292ce90b5ad2e733390bf4cfcb238989e1b8,1,2,1,1,0,0,0,11,64,0,1,1,0,645,76,2,148,147,1,4522,4518,4,36,36,0,100
983775de06089e3cd3b34c0e4f371ae0e2c969f2,1,2,2,0,0,0,0,11,65,0,1,1,0,646,77,3,148,148,0,4522,4522,0,36,36,0,100
bdce39ae282d7f9cb5d86eb5462f458a37d0146d,7,495,499,4,0,0,0,2,38,14,4,4,0.585468861,4080,78,4,642,634,8,26999,26968,31,167,167,0,100
4386138356b832aef316277d056098ddfec041db,1,15,2,13,0,0,0,2,5,0,1,1,0,828,79,5,173,171,2,4867,4828,39,19,19,0,100
b5d5ea2734d43a96a4855bfdaa5911cfcaf50278,3,150,150,0,0,0,0,2,2,12,1,1,1.545375983,128,181,7,16,16,0,435,435,0,12,12,0,100
dbeb9b4b615a89eedd4434bef6021a4e0d489ff5,0,0,0,0,0,0,0,0,0,0,0,0,0,0,182,7,0,0,0,0,0,0,0,0,0,100
df18282acdc95611ead9f4ff5f98d88ae96095cf,3,43,45,2,0,0,0,1,23,77,2,3,0.876917574,1038,122,5,167,174,7,7736,7919,183,126,125,1,100
05ebf66372e786be80199ba649343bf1b4eec667,2,47,1,46,0,0,0,2,6,513,1,1,0.842657877,186,123,6,22,19,3,934,763,171,17,15,2,100
3fc6ac211d90b587583c6bce49ebe82d90985c6b,2,1617,0,1617,2,0,2,1,1,0,1,2,0.99976797,0,267,1,287,0,287,7862,0,7862,125,0,125,99.9716022
d0cb71dd5997b2fd8c9460ec8992c0de088113bc,9,1013,1,1012,8,0,8,1,27,1,2,3,2.569367368,981,60,4,452,345,107,11579,7094,4485,153,72,81,99.88655701
258202232640dbfd7a66311f0f2b9c26a9577b34,0,0,0,0,0,0,0,0,0,0,0,0,0,0,268,2,0,0,0,0,0,0,0,0,0,100
96cb35ffa39c5898298884e20be62ce1a4614c96,2,9,5,4,0,0,0,2,12,7,2,2,0.749595257,514,269,3,61,59,2,3735,3719,16,46,45,1,100
921cd71acfbf78d44cfd621bddf45a7ef3fa6967,0,0,0,0,0,0,0,0,0,0,0,0,0,0,270,4,0,0,0,0,0,0,0,0,0,100
5580dd3ea634cf5b5e4593e69407311076d0e229,2,2,0,2,0,0,0,1,2,2,1,2,1,538,61,3,64,64,0,3465,3461,4,41,41,0,100
da5c1da5c625eb885edd132b40db68dbfaeb8d22,4,0,0,0,0,0,0,1,1,0,1,1,0,410,62,4,53,32,21,2144,616,1528,40,32,8,99.90933817
e4ec2cf90d954d9e8df9eeba94dcdfd98dfbe6a0,2,2,2,0,0,0,0,1,3,0,1,1,1,540,63,5,64,64,0,3465,3465,0,41,41,0,100
2901ea6e52b348dde119185181c33a5038f47922,5,267,4,263,2,0,2,3,35,17,2,2,1.802017888,2415,64,6,459,430,29,17960,16929,1031,200,174,26,99.96601144
be8731aafae9f336b96e7e7d985081f10178152a,4,39,47,8,0,0,0,3,35,35,2,2,1.149497339,1176,124,7,287,293,6,8214,8195,19,100,100,0,99.99433684
3b2585f39b0e61e6224b20b5b3201704a3aef59c,10,1154,1154,0,0,0,0,2,4,0,1,2,2.896520275,972,183,8,124,124,0,4849,4849,0,97,97,0,100
9202ab694482c7bd80936c3ad1e4afc175161c71,0,0,0,0,0,0,0,0,0,0,0,0,0,0,3,3,0,0,0,0,0,0,0,0,0,100
9d5066a2258da3f022f6a9104fd92727201dd77b,0,0,0,0,0,0,0,0,0,0,0,0,0,0,4,4,0,0,0,0,0,0,0,0,0,100
16c8b6d2dc6dd80f28c3c70d3ef93874f95bd3f4,5,49,5,44,0,0,0,2,57,62,3,5,1.780131836,2173,65,7,588,584,4,16110,15839,271,215,213,2,100
20b3559bbe7fd1b8b2445db618124869b2fa3978,3,8,10,2,0,0,0,5,51,275,1,1,1.351644115,750,45,2,151,151,0,4575,4576,1,84,84,0,100
62aabafc53492a5c0ff2f611f7c7bd63e75c1658,1,430,14,416,0,0,0,3,4,2180,1,1,0,49,5,5,56,4,52,2112,191,1921,17,3,14,99.97733968
69d01f2813a7d4bb95cdd1207ac4f7dae5cd0aba,7,5,156,151,0,0,0,2,25,65,2,5,1.635292285,4596,46,2,1260,1282,22,31884,32614,730,262,268,6,100
d00cf9d468a466d863c5fe977493bac7acd0aceb,5,66,10,56,0,0,0,2,25,503,2,2,1.643299097,1016,66,8,204,197,7,7547,7350,197,142,140,2,100
8c31381f18e93cf5337a15b1b80ecb97bcbc5b39,5,55,3,52,0,0,0,3,6,875,2,2,1.853640146,874,125,5,136,124,12,5974,5638,336,91,87,4,100
4da7ad37907cbe2c68b86d3d6b33429c06f85fe8,4,33,23,10,0,0,0,4,36,548,1,2,1.884948338,1193,126,6,309,307,2,8725,8665,60,106,106,0,100
ae182d488eb83ec9cb028492aa39245d689eddbe,0,0,0,0,0,0,0,0,0,0,0,0,0,0,80,5,0,0,0,0,0,0,0,0,0,100
372dea0106713ae4eaad2d567854828e3c41e09c,2,256,135,121,0,0,0,1,2,18,1,2,0.468184346,1140,271,4,308,287,21,8450,7862,588,140,125,15,100
f758a191ee6f552196e2f1da567e700e68e24f4d,2,21,1,20,0,0,0,3,6,62,1,2,0.945660305,506,127,7,73,71,2,3801,3689,112,33,33,0,100
171fe56aa21cb4d13021bf84478480df93fecd14,1,1,0,1,0,0,0,7,14,35,1,1,0,226,6,5,47,47,0,1559,1550,9,15,15,0,100
0398c0e7dd65e97e0e847960ad468b0d2d1e4505,5,128,6,122,0,0,0,3,10,84,2,3,1.892811433,883,67,9,130,119,11,6211,5752,459,84,76,8,100
e55f36f8135dc519a911b9a3352e8f12072c64a4,13,988,4,984,11,0,11,1,32,4,2,3,3.237839706,942,272,5,385,260,125,10061,6651,3410,184,80,104,99.86417657
affdc073d025fc279e35c8ac1f8ee6654f2a6302,2,44,9,35,0,0,0,3,37,13,2,2,0.803715924,995,128,8,261,254,7,7335,7132,203,77,77,0,100
21b41a50fe101d6003fac68b940032dd9bc1f0f9,2,22,2,20,0,0,0,2,13,45,2,2,0.650022422,498,273,6,56,55,1,3868,3650,218,43,42,1,100
9696252e4db87c33090e488e95331a1551bafac4,2,31,30,1,0,0,0,2,6,0,1,2,0.514091279,626,184,8,155,155,0,4421,4421,0,58,58,0,100
60988f8be80000b1b8bdf183eb1341ec9d851f9d,0,0,0,0,0,0,0,0,0,0,0,0,0,0,185,9,0,0,0,0,0,0,0,0,0,100
52391487639b5d75c00059e845a50e56f4547792,25,52,23,29,0,0,0,2,38,52,2,6,4.32842769,2324,129,8,429,422,7,12949,12715,234,228,228,0,100
5681d06afe179d6497de09715796e536ce842fd2,11,20,3,17,0,0,0,3,12,57,1,1,3.447262499,2295,68,8,305,305,0,13105,12993,112,215,215,0,100
b2f74fcbd53ccdec9432015b2136463920c41185,7,8,7,1,0,0,0,2,2,742,1,1,2.789898095,731,69,9,146,146,0,3966,3940,26,85,85,0,100
0daf1bffc8bef922263cee1cb5da605137fdcba1,7,145,10,135,1,0,1,10,57,354,4,4,2.056505157,3002,70,10,901,880,21,21927,21196,731,228,216,12,99.93787066
e4b87fd6b34dfb2b508b387bf8e365507509eb4f,2,97,7,90,1,0,1,1,22,37,2,2,0.706274089,503,18,0,138,133,5,3453,3030,423,71,67,4,95.37430743
d9039ca64064c99558efd6db6d15c4028ad63236,1,55,31,24,0,0,0,7,11,42,1,1,0,178,47,2,49,44,5,1272,1207,65,10,10,0,100
1da766bc55371aca8ce969286f148aef9ce874ea,1,12,2,10,0,0,0,7,50,42,1,1,0,1633,71,11,531,528,3,11005,10956,49,152,151,1,100
ff29a053dd6a6532ee4c7c6ac83e8a676c788d24,0,0,0,0,0,0,0,0,0,0,0,0,0,0,48,3,0,0,0,0,0,0,0,0,0,100
8bbf14978179d8b57542b5c22a4e7100f9388941,5,58,2,56,0,0,0,3,11,322,2,2,2.027479329,689,72,12,127,117,10,4382,4127,255,89,81,8,100
4d1b86e86040a38395e3bcb09fcf059ef161f05f,1,27,27,0,0,0,0,7,15,12,1,1,0,227,7,5,48,47,1,1582,1559,23,15,15,0,100
32fd2a52d179379b1ae6d386a54f134510f6bc04,3,10,2,8,0,0,0,3,58,16,3,3,1.040852083,2496,130,8,718,718,0,18527,18494,33,190,190,0,100
282b8770cd5267fad336614185b03849f5ca0d1d,1,1,1,0,0,0,0,3,9,8,1,1,0,160,73,13,6,6,0,623,623,0,3,3,0,100
f3b437ab7610e5c05214dbb5308518a389fb1a3c,4,128,13,115,0,0,0,3,40,24,2,3,1.489125834,2918,131,9,537,521,16,20255,19754,501,229,229,0,100
0e30a59b089f42449b6be82df8785e673d5a66f6,3,3,3,0,0,0,0,2,3,298,1,1,1.584962501,246,74,14,46,46,0,988,988,0,40,40,0,100
27935272ba02200b82e11bf959da5520ebfed37e,1,7,1,6,0,0,0,3,9,92,1,1,0,282,274,3,32,32,0,2055,2055,0,14,14,0,100
178f0a180a5d659f4f550c1bbacef77d4e4dd780,22,1470,280,1190,2,0,2,9,90,192,4,10,3.204573965,18587,275,4,5188,4955,233,130187,124674,5513,1491,1416,75,99.9549955
ffdf2648fd3ab9cf0fbe95dd6ee664524128c398,1,122,138,16,0,0,0,7,52,3,1,1,0,1669,276,5,537,540,3,11150,11252,102,155,156,1,100
2c7432cccdcd152515e206e1d753e10e8d219e68,2,13,0,13,0,0,0,2,9,98,2,2,0.391243564,670,277,6,123,122,1,5205,5123,82,56,55,1,100
0ffbce338fb0e286268173145bbe32fb81262a6f,9,65,39,26,0,0,0,7,66,23,3,4,1.787259507,7285,278,7,1642,1635,7,55630,55466,164,518,517,1,99.97000825
cf8647198ad31524f80c9ed7e52bbb68cb43b482,8,46,43,3,0,0,0,8,57,363,1,3,2.583091667,4181,279,8,1048,1048,0,28375,28262,113,431,431,0,100
a868ae3435a32b91bf5158b467126e1478f9bff4,15,330,204,126,0,0,0,7,59,52,3,6,2.992739494,11350,280,9,3439,3414,25,74956,74279,677,1194,1182,12,99.97000825
29a5f7acd2b9ffc433b7f191995b7981428a0e39,5,86,91,5,0,0,0,10,60,715,4,5,1.918280468,4088,281,10,1130,1128,2,30454,30250,204,257,257,0,100
9d52998c1ec5618d4c714c24a261458ad9af5244,7,97,134,37,0,0,0,9,54,325,2,2,2.044229644,4268,282,10,1302,1302,0,27577,27569,8,382,380,2,99.97750619
7adb7932e803f0d883fca183501a11d3c7db99bd,8,1761,669,1092,5,0,5,1,33,20,2,3,2.346408986,1239,283,11,514,319,195,14543,8450,6093,220,108,112,99.91011236
d86b15e30d60b33bb64acff76077b004446bc68d,0,0,0,0,0,0,0,0,0,0,0,0,0,0,284,12,0,0,0,0,0,0,0,0,0,100
09859699f9087e5d7200999cb8eae48bc04aa201,3,137,34,103,1,0,1,1,100,67,2,2,1.264817889,4120,19,1,1211,1203,8,30663,30098,565,276,270,6,99.98503442
8f182fc261de22ec0100e1e77612a3e83ffe4061,13,279,324,45,1,0,1,1,2,3,2,2,2.248251223,973,285,13,140,122,18,4709,4203,506,111,76,35,99.66335004
14ae1c34cf1481607b2f321b625014fed59d6e29,8,41,7,34,0,0,0,3,11,1709,1,2,2.4001532,803,186,0,191,183,8,4108,3928,180,103,99,4,100
1677b481b2783ee02aeba8c7175a0ae27d18fa92,7,323,7,316,3,0,3,3,91,45,2,2,2.46021569,8461,75,7,2354,2313,41,55478,54346,1132,698,667,31,99.94766355
bd50e177bb770396c10cec7ee8f85d0a01044ac4,3,129,3,126,1,0,1,1,39,62,1,2,1.178484019,706,49,2,154,142,12,4931,4435,496,51,45,6,99.96264475
02846623a8b393b5d4c5920a3a8e202bef1fe2aa,5,434,220,214,0,0,0,3,66,53,2,2,1.440353715,2673,50,3,627,580,47,19178,18046,1132,133,127,6,99.98506125
f9fd4837b316ad205d27cdf053cf51b757080f8a,8,388,11,377,3,0,3,3,42,54,2,3,2.715224601,4588,76,6,961,912,49,33277,31503,1774,313,283,30,99.94774169
861db8ddd022c1b27c9ab3bf36df80cf5517c046,2,14,5,9,0,0,0,3,67,67,2,2,0.485460761,3162,286,12,650,649,1,25394,25388,6,130,130,0,99.99253843
733c1ea7de1327a534834f1b5a4007f32887af20,1,147,135,12,0,0,0,8,50,18,1,1,0,1223,287,13,377,377,0,8694,8488,206,109,109,0,100
2c2e78149dd64bb5ce7e42687e5b55a1865eb838,6,569,3,566,4,0,4,1,55,20,2,3,2.318512503,1976,187,1,714,637,77,15858,13366,2492,240,194,46,99.93289091
6a36d5539842326ff83e315b17c93bc706607a06,1,0,3,3,0,0,0,6,14,9,1,1,0,362,188,2,115,116,1,2481,2496,15,46,46,0,100
22a5143d1f8bdbde57810be21d54a20cab17b1a5,1,9,5,4,0,0,0,2,7,74,1,1,0,780,51,2,90,89,1,5641,5588,53,29,29,0,100
6bccd91606d09db80dc8bf03ed6a23c47cf153fe,1,1,1,0,0,0,0,6,12,17,1,1,0,73,52,3,15,15,0,312,311,1,14,14,0,100
0392538775f9590ef9b977ed11f51b1e5dbd8adf,18,2677,41,2636,14,0,14,1,59,11,3,4,3.197282757,3087,288,14,1234,841,393,34327,20994,13333,718,360,358,99.74751225
ed82fda48c2c15ffc85a64096d606182db4c694b,3,79,10,69,0,0,0,3,60,757,3,3,0.915435255,3431,132,0,726,721,5,23617,23508,109,263,263,0,100
51224e586cacf34f39c357a4a76f1b4bbd0ce38e,0,0,0,0,0,0,0,0,0,0,0,0,0,0,53,4,0,0,0,0,0,0,0,0,0,100
89182580bbe3dfcb7b7cdebaae90339c94eab801,4,98,26,72,0,0,0,1,2,0,2,2,1.841972073,844,289,15,173,160,13,6648,6116,532,150,143,7,100
788064287d9387bdf07d9626d0712ef358d9f9bb,1,1,2,1,0,0,0,9,55,2,1,1,0,1267,290,15,325,325,0,7901,7901,0,219,219,0,100
b68eeddd7d28bff6ecb8701bc4c30ecc339911db,1,4,1,3,0,0,0,2,10,35,1,1,0,241,291,16,59,59,0,1730,1709,21,19,19,0,100
ce685d0a52ce8c6216fdc337b359f1bc37e791c2,2,6,11,5,0,0,0,1,6,24,1,1,0.522559375,646,292,17,163,163,0,4549,4561,12,60,60,0,100
8575b6c79eba4b4a3ffc17d388c83aa7ccb2887b,0,0,0,0,0,0,0,0,0,0,0,0,0,0,293,18,0,0,0,0,0,0,0,0,0,100
09a77eeae3b1e25244490f0c93dc159314a872f9,1,1,1,0,0,0,0,11,67,18,1,1,0,652,189,3,151,151,0,4573,4569,4,36,36,0,100
8321d31c89314e0f2478ffdc98d435279e21d065,0,0,0,0,0,0,0,0,0,0,0,0,0,0,294,19,0,0,0,0,0,0,0,0,0,100
2ef46be65e138358bdf1848ce9f7508b9fad68d5,0,0,0,0,0,0,0,0,0,0,0,0,0,0,295,20,0,0,0,0,0,0,0,0,0,100
6759d4151713a7652762bf30431d5eadd8e5024b,9,42,35,7,0,0,0,2,4,105,1,1,2.353718318,304,296,21,15,14,1,1593,1418,175,15,14,1,99.97779916
f0fb49b47c9a9b1f9fbfcee3f35a074a8842fd17,3,143,41,102,1,0,1,1,7,0,1,1,1.499274463,641,297,22,175,163,12,5087,4549,538,64,60,4,99.98520272
75dfd10c590f06f465cfb86169aa9bb397ae6db2,3,30,0,30,0,0,0,2,47,101,2,2,1.109227139,1726,77,2,530,525,5,10938,10786,152,192,189,3,100
95e9b554c694f23da994e4b63c880a38c7615356,0,0,0,0,0,0,0,0,0,0,0,0,0,0,0,0,0,0,0,0,0,0,0,0,0,100
03c2cce7f5c37cd7dc3a2e442dfe7d85d5bee69d,1,0,1,1,0,0,0,1,3,1,1,1,0,11,298,22,0,0,0,105,120,15,0,0,0,100
c67d0e668e45ad4ed4b97f8313b5ec2c2fed143c,1,23,4,19,0,0,0,2,8,1,1,1,0,202,299,23,29,25,4,1483,1421,62,10,9,1,100
fb85dc97e500bd338c3ddb3887691d2895487fb2,0,0,0,0,0,0,0,0,0,0,0,0,0,0,300,24,0,0,0,0,0,0,0,0,0,100
46c0110bef9568c301657b0237247c7b316a8e2e,1,0,1,1,0,0,0,2,5,1,1,1,0,26,301,25,0,0,0,38,45,7,0,0,0,100
240348ba69857c9a2bd8682b85ced40b7b1b8476,1,0,4,4,0,0,0,2,5,1,1,1,0,27,302,26,0,0,0,27,55,28,0,0,0,100
eb359de6a5dabd47cae3f24c5ca4ba3d7b787bbf,4,163,1,162,2,0,2,2,14,68,1,2,1.855068679,242,303,27,45,29,16,2231,1712,519,26,15,11,99.96302596
195525392c8e4d846f7cad03d8074e79719c5889,2,12,13,1,0,0,0,14,101,65,1,2,0.40217919,3451,8,0,1013,1013,0,25103,25107,4,242,242,0,100
9a8246799cada997ca2421760ac335ac29271d71,11,285,38,247,0,0,0,1,56,190,3,4,2.939193032,4653,304,28,1357,1316,41,32662,31594,1068,463,443,20,99.97042951
da176436242634acefa16f18d246302f54d9160c,2,4,7,3,0,0,0,7,102,29,1,1,0.845350937,3464,305,29,1009,1009,0,25242,25246,4,240,241,1,100
3182ed978e2ebd4d96d5b2f2af6295a446cb2ad9,6,296,14,282,3,0,3,3,17,391,2,3,2.378584303,2567,78,3,477,439,38,17370,16331,1039,238,211,27,99.94827459
c5f203f3f2920a059afddcf9228fcf04be2d4388,0,0,0,0,0,0,0,0,0,0,0,0,0,0,1,1,0,0,0,0,0,0,0,0,0,100
3eff16e07afd3ce6252574ded5a54920b2965c1f,3,273,7,266,0,0,0,2,10,30,2,2,0.408513458,1239,54,5,204,182,22,10984,9192,1792,67,63,4,100
f6f99775bf1929b1dc48a5001318b2ba21a48142,1,4,4,0,0,0,0,2,6,96,1,1,0,835,81,0,173,173,0,4871,4867,4,19,19,0,100
23bd8aa147ad5b1980a4db187930564bf7a44473,1,30,33,3,0,0,0,6,14,108,1,1,0,352,306,25,105,105,0,2669,2649,20,21,21,0,100
dc39b6320f6ca1eca3efd9ad863a6daed69326ef,1,31,27,4,0,0,0,8,61,10,1,1,0,1493,307,26,458,458,0,11292,11256,36,114,114,0,100
83bb518d7c6cf22eebfb384d42b8b5c65edeb6fa,2,14,5,9,0,0,0,2,11,125,1,2,0.949452015,708,308,27,132,131,1,5214,5163,51,62,61,1,100
321366581165d09d0020a23e540c031e2f48f013,1,1,1,0,0,0,0,9,43,110,1,1,0,1157,309,27,341,341,0,8434,8434,0,94,94,0,100
c0bf7e40d6ff57df1c5679c813192e0a8c82de28,48,2427,74,2353,28,0,28,1,6,36,1,1,4.453274601,719,79,4,211,17,194,16280,2392,13888,207,17,190,99.44224277
02a2830e2f585a97e1e85147fdb5977243174748,22,0,22,22,0,0,0,1,2,0,1,1,4.459431619,229,80,5,0,0,0,2143,2473,330,0,0,0,100
4606fffc375f7fd40f33189de55c38577995c4bd,3,88,44,44,0,0,0,3,18,762,2,3,1.005719205,2325,133,1,352,345,7,14536,14458,78,193,193,0,100
19bfc4139aa4eb18fe6ef2eb0c52e6484d8ee36b,0,0,0,0,0,0,0,0,0,0,0,0,0,0,2,2,0,0,0,0,0,0,0,0,0,100
5014430b9492ebdfb938e71215fb6f7897731643,0,0,0,0,0,0,0,0,0,0,0,0,0,0,3,3,0,0,0,0,0,0,0,0,0,100
c26d742712eb14ecab3fe54660d66ad56309133f,1,9,7,2,0,0,0,10,21,11,1,1,0,216,9,1,52,52,0,1453,1439,14,16,16,0,100
1f37b7725c30b6dde445598f24d30841fba87535,65,5945,10,5935,58,0,58,9,68,2,3,6,5.154549502,7384,55,6,2500,1963,537,73953,52362,21591,891,510,381,97.73371105
f221b1fa85174279010d0801f0b3d8f541129b46,2,110,1,109,0,0,0,3,19,154,2,2,0.339486,2066,134,2,280,273,7,13229,12867,362,162,161,1,100
13819e01f7d57a59ebc945e4bd33b4b4882863bf,2,4,5,1,0,0,0,7,14,143,1,1,0.99107606,396,10,2,82,82,0,2342,2343,1,38,38,0,100
90ef23a4a914626953407955d2dc6f53527c6eca,3,26,36,10,0,0,0,8,61,19,2,2,1.364318659,2847,56,7,691,686,5,21051,21015,36,135,134,1,98.70654257
f81e627b27627374ea9574c6811d51645ba7428a,1,88,3,85,0,0,0,1,2,41,1,1,0,31,57,8,7,1,6,540,94,446,5,1,4,100
862edc8fe177faede47a4ea09f7c3cdb9a4abff7,4,113,6,107,1,0,1,1,13,646,1,3,1.735236986,1046,20,0,342,333,9,7266,6715,551,150,144,6,98.67481461
094dff26da494ee77e3bc4fcc779cb1cded1517e,0,0,0,0,0,0,0,0,0,0,0,0,0,0,4,4,0,0,0,0,0,0,0,0,0,100
df96cc61297a92ceb7d045ff0b7598d85ef68b7b,2,142,3,139,0,0,0,2,3,25,1,1,0.216396932,1130,81,4,275,257,18,9527,8639,888,264,248,16,100
e1ccb46414ff014004ed2680abbb8edd1559bbd0,11,758,100,658,2,0,2,1,103,189,2,6,2.808922852,8058,58,7,2288,2202,86,61358,59005,2353,546,506,40,95.86886621
0b37738fb80c0cf19810dfc80b50763fdeeb03e8,1,41,5,36,0,0,0,2,5,13,1,1,0,480,82,5,32,29,3,4948,4645,303,30,27,3,100
4a1c275ed0353c4351355a8ee3daad738aef0dfe,0,0,0,0,0,0,0,0,0,0,0,0,0,0,5,5,0,0,0,0,0,0,0,0,0,100
9b64aea79e6617e8c04bb08b9bade8e5158704ad,1,8,9,1,0,0,0,2,4,0,1,1,0,730,83,6,140,140,0,5378,5378,0,129,129,0,100
d7ddfb10557c86a5019925a2874eaecf388b1c14,4,164,62,102,0,0,0,3,62,30,2,4,1.113224175,4559,135,3,811,786,25,31748,31126,622,300,299,1,100
cb115bcd16e1964c971f2fe7f38b9b6d3117c017,5,305,4,301,1,0,1,9,58,58,3,3,1.357404725,2524,6,6,516,497,19,16633,15572,1061,323,309,14,99.9851588
f029f2de8526da7bb464dfb893032e0b24893a92,2,145,59,86,0,0,0,2,6,13,2,2,0.752212173,676,84,7,88,71,17,6481,5974,507,66,53,13,99.92570027
9d30d4819e7b0ea84e2f9de67ae2a2bfb2531676,2,1,4,3,0,0,0,2,7,13,2,2,0.970950594,644,85,8,56,56,0,5735,5731,4,52,52,0,100
2203aedf4627ba496fc3fae34486db979a6f3920,4,16,10,6,0,0,0,2,8,0,2,2,1.743871818,1561,86,9,244,241,3,12386,12351,35,206,206,0,99.9106478
817be5bef689c595766b7a23e46341b649ee843f,1,0,2,2,0,0,0,1,2,4,1,1,0,52,21,1,2,2,0,333,333,0,2,2,0,100
20fb414d0272aad104c4ad2069bb600836377127,0,0,0,0,0,0,0,0,0,0,0,0,0,0,7,7,0,0,0,0,0,0,0,0,0,100
0b3dcc44334eb63dea824c63bbfd0f6a82548180,0,0,0,0,0,0,0,0,0,0,0,0,0,0,8,8,0,0,0,0,0,0,0,0,0,100
0af9c4e7756b2fb792fd995e405fcfc51706ddb2,0,0,0,0,0,0,0,0,0,0,0,0,0,0,9,9,0,0,0,0,0,0,0,0,0,100
63c9be27163974b4789c32c77eefe2c0a7fe6d0d,2,77,1,76,1,0,1,6,13,694,1,1,0.998102133,76,10,10,8,5,3,717,410,307,8,5,3,99.96275605
a5f85ac7f83690b8e896709b4b8f5c5a1351d515,3,130,58,72,0,0,0,2,9,0,2,2,1.263565664,1377,87,10,217,199,18,11536,11156,380,193,181,12,99.88840946
f6c64474ed64421f291244dc34e575ffc3a4c6a4,0,0,0,0,0,0,0,0,0,0,0,0,0,0,11,11,0,0,0,0,0,0,0,0,0,100
78f0f54dc33dbf1aec53f4ba46e932184f88c425,2,78,4,74,0,0,0,2,10,8,1,1,0.281193796,633,88,11,62,55,7,6160,5489,671,58,53,5,100
7b581bf651f156410f37366a8d4eab7a5888187d,2,14,4,10,0,0,0,2,12,46,2,2,0.764204507,702,310,22,134,136,2,5437,5367,70,57,56,1,100
76764564b12310c72b57f4c4169b0e616a1f3326,8,284,135,149,0,0,0,2,15,19,3,3,2.156338323,2267,89,12,449,415,34,18367,17326,1041,275,271,4,97.68821293
c7a2b9252cec11a102ca5a12bad05f583ac26c3a,0,0,0,0,0,0,0,0,0,0,0,0,0,0,12,12,0,0,0,0,0,0,0,0,0,100
e5e4cc122a732781f700895e28fae0d6c2beb878,7,592,0,592,6,0,6,1,8,327,2,3,2.101917517,34,59,8,56,0,56,1719,104,1615,26,0,26,99.8289003
2ce5299a7310130fa35d258e0dd14b65012980b0,10,198,10,188,0,0,0,3,63,387,3,4,1.743411316,5096,136,4,1128,1097,31,34555,33632,923,423,419,4,100
db43c7443df00fa4ddd99c970fb5d598033dc05e,3,72,14,58,0,0,0,2,5,17,1,1,1.103489192,785,90,13,218,208,10,6286,5928,358,171,164,7,99.97669179
e4488c40347a66bcf4121a34370fc77225fc1cb4,8,699,0,699,5,0,5,2,12,6,1,1,1.749948186,1249,91,14,128,87,41,14792,11064,3728,121,81,40,99.91461616
5fc3725de570c6c4153125138f80a03d50feef85,1,3,3,0,0,0,0,2,2,2,1,1,0,82,13,13,20,20,0,444,444,0,6,6,0,100
175554580def1de57ef4b2754fc57268fce3c665,4,435,43,392,1,0,1,1,3,177,1,2,1.540202372,218,190,1,51,19,32,3081,1091,1990,22,8,14,99.98449132
42ae6a69982dab8a5210377075ff740e2e5fd3e3,1,1,0,1,0,0,0,11,35,57,1,1,0,918,191,2,257,257,0,6678,6674,4,46,46,0,100
598c25f2b9877ab5a379e5e9a6f65c2dca406600,4,64,35,29,0,0,0,2,13,0,2,2,1.443174086,2085,92,15,314,305,9,16946,16683,263,240,238,2,100
ef204040c208c6250fda950dfbca58ea187619ad,1,0,1,1,0,0,0,11,69,15,1,1,0,664,192,3,153,153,0,4622,4626,4,38,38,0,100
9ef9654a992e1a4ba0a0885091d902ff8425e4dd,2,227,8,219,0,0,0,2,9,0,2,2,0.124372144,1197,93,16,180,176,4,9450,9136,314,158,156,2,100
f91a31dae419477d5746c2152ddcfd7609b9939e,4,197,17,180,0,0,0,2,14,10,2,2,0.369164035,1524,94,17,193,170,23,14041,11477,2564,136,113,23,100
f020bc6bf0a74d867560adff4d3e354d3a5ad760,0,0,0,0,0,0,0,0,0,0,0,0,0,0,14,14,0,0,0,0,0,0,0,0,0,100
097bda818cdc9d581e4027bff56db3d2557c4d72,0,0,0,0,0,0,0,0,0,0,0,0,0,0,15,15,0,0,0,0,0,0,0,0,0,100
768cd337b0effd973d77aa141577dea6d5b5009c,4,68,2,66,0,0,0,9,62,61,2,2,1.807632496,3197,95,18,927,909,18,22406,22094,312,207,204,3,100
70f55bdee8d87fbfde8b15524cbb2e204194cdd7,44,1841,842,999,16,0,16,1,56,27,4,7,3.657625934,11017,311,13,2368,2238,130,84149,77028,7121,1393,1335,58,93.02988186
f5ee1130eeb00bb3f4ff21dfc1fe21b94573f832,0,0,0,0,0,0,0,0,0,0,0,0,0,0,16,15,0,0,0,0,0,0,0,0,0,100
291e27eba9b36f28c8a87da81b23758e1f803f4e,390,2965,2238,727,0,0,0,2,35,65,5,77,6.730139339,55617,193,3,6057,6057,0,351768,351630,138,3832,3832,0,99.9811095
a224644c4c475b08fae3aa27cfb325b035982e0a,2,4,4,0,0,0,0,3,17,63,2,2,1,1365,22,2,240,240,0,7764,7764,0,74,74,0,100
26b83c830097e33710defe357b2e7bb1baa03068,1,6,6,0,0,0,0,1,2,140,1,1,0,225,82,1,7,7,0,1572,1605,33,5,5,0,100
0b49620ac97368fa456b4890ce17eaba1135965e,3,227,1,226,2,0,2,1,5,688,2,2,1.2630542,41,17,15,21,2,19,1277,174,1103,12,1,11,99.96852376
0a05d8023a8da1ecaa39c7bf543d58ba87c80c5d,1,6,6,0,0,0,0,1,2,140,1,1,0,248,83,2,6,6,0,1769,1796,27,5,5,0,100
056d211658334d66f631d6e54c0793214bea8824,0,0,0,0,0,0,0,0,0,0,0,0,0,0,18,16,0,0,0,0,0,0,0,0,0,100
6d91126dd6864347a5cb399df9ced0db82d51476,1,56,8,48,0,0,0,10,17,141,1,1,0,522,84,3,107,100,7,3583,3380,203,35,34,1,100
9638a84e376b3af7e8dac94a8db99189fe876200,18,1325,30,1295,8,0,8,3,17,2,1,1,2.028579669,2202,96,17,289,196,93,26567,17913,8654,264,183,81,99.83033807
3f28f44d3abecb485b99bfdcd1bfd8ecff3ce0fe,9,567,12,555,1,0,1,1,104,54,2,3,1.002035805,6094,85,4,1729,1615,114,44706,42580,2126,514,401,113,99.98745295
24c1e49edd5feabaf48c9deaa9e30827f66cd2f2,7,164,43,121,0,0,0,5,10,498,1,7,2.571774193,1403,86,4,180,157,23,10241,9575,666,95,95,0,100
e8e52d38ea4c2e327616c33b979c479fb3a6f373,1,12,12,0,0,0,0,14,105,5,1,1,0,3402,11,2,1000,1000,0,24529,24529,0,239,239,0,100
3a91680b6d90e1f1ee5703072a592bcf542957c9,0,0,0,0,0,0,0,0,0,0,0,0,0,0,12,3,0,0,0,0,0,0,0,0,0,100
b1e8eec3ce5d85ab2f31bc4b80499d8ad03c789d,3,127,88,39,0,0,0,3,64,15,2,3,0.805580412,3976,137,3,769,766,3,25900,25638,262,267,267,0,100
137d0883bdc24045f71eb3734e1cbf3092a82379,0,0,0,0,0,0,0,0,0,0,0,0,0,0,19,15,0,0,0,0,0,0,0,0,0,100
677ef4da30b74263beb38747a018b20d6ab7e530,1,2,0,2,0,0,0,1,2,12,1,1,0,89,20,16,4,4,0,562,526,36,3,3,0,100
5b536156091c505a90c0dc108da66aa0cd437ad0,10,331,51,280,4,0,4,8,57,26,3,5,2.975991292,3301,60,4,914,866,48,23373,22654,719,293,257,36,99.91223671
2e9f4187ccf0bfc07629e062a0af745806440761,1,28,2,26,0,0,0,11,71,12,1,1,0,666,194,4,157,153,4,4755,4659,96,39,38,1,100
b3ab297d62bc68bad48b15b7724cb54e25d652dd,0,0,0,0,0,0,0,0,0,0,0,0,0,0,195,5,0,0,0,0,0,0,0,0,0,100
a4a9dc17875a58c03be00da5430b7d039e980714,1,4,2,2,0,0,0,2,6,0,1,1,0,167,61,5,70,70,0,1000,991,9,22,22,0,100
9c601dfa0224796336f51f8201eb46011511d132,1,3,4,1,0,0,0,3,8,152,1,1,0,209,312,2,44,44,0,1525,1527,2,14,14,0,100
c20a2b254f46c4c50aed12b924660602d57c56ba,1,15,16,1,0,0,0,8,65,3,1,1,0,1549,138,3,480,481,1,11698,11720,22,116,115,1,100
130d1d4bd9a9b92ac5f522d318fe3aec7beea29d,0,0,0,0,0,0,0,0,0,0,0,0,0,0,21,17,0,0,0,0,0,0,0,0,0,100
a825aab23a1c198ef740349ef9818f9efcf1a78a,1,1,12,11,0,0,0,2,6,15,1,1,0,50,22,18,2,4,2,174,235,61,1,3,2,100
fcebb24e61b64dbd6557d6458d983ea00269a34f,39,1412,1435,23,0,0,0,2,18,6,1,1,3.715609725,2754,97,16,224,224,0,21016,21067,51,193,193,0,93.48229632
3464d8e9b877137a0b37095687845b4624b02c52,30,3081,2978,103,0,0,0,3,19,10,2,6,1.998075674,4574,196,6,347,370,23,33472,36967,3495,290,313,23,99.86288848
c1b842d49256339bc9c82441d3b956540e22e648,118,116,117,1,0,0,0,2,106,249,4,46,6.87058196,14457,197,7,2305,2305,0,87545,87545,0,1064,1064,0,100
87b66ae7647669e477182856d58fee04281fde30,1,6,6,0,0,0,0,8,66,3,1,1,0,1550,139,4,480,480,0,11689,11698,9,116,116,0,100
85bc7a5e8098d738d7344adb4c6d7d2c0d8cdb30,3,135,0,135,1,0,1,1,59,26,2,2,1.065422932,1555,23,19,270,263,7,9911,9513,398,231,224,7,100
c9e74d4c7a2bc50b1483289cecb47b8abf018bfd,0,0,0,0,0,0,0,0,0,0,0,0,0,0,24,20,0,0,0,0,0,0,0,0,0,100
b2a8732a8b6b872b803e4fab187aedc3f8d319bb,1,1,1,0,0,0,0,4,19,1,1,1,0,474,198,8,50,50,0,3659,3659,0,38,38,0,100
3c88ac3d20d871db3535a06d04735a9f7d2a7874,4,81,2,79,1,0,1,1,107,45,1,2,0.865226495,4073,199,9,1196,1192,4,29386,29117,269,310,306,4,92.73231973
0d6f1a02143b3fd12342fd783f0438d764759645,2,42,3,39,0,0,0,1,17,0,1,2,0.353359335,499,200,10,149,148,1,3402,3253,149,56,55,1,100
dbc271305fe826866cc6a850e336f13929b2abf9,2,30,0,30,0,0,0,2,3,99,1,1,0.970950594,266,140,4,42,38,4,1814,1624,190,28,26,2,100
49596dc4e61534de612f34573db3167e05ddf6d2,13,1069,308,761,9,0,9,6,36,84,2,3,2.964396469,1721,62,3,408,312,96,15508,12759,2749,156,89,67,99.87631749
0fa4a0c96567ebe6aa163817c54cd0cf5fc5e40c,2,33,6,27,0,0,0,2,41,38,1,2,0.779349837,764,25,14,163,159,4,4845,4721,124,55,54,1,100
08301b833b7140bd74c74a7a9be7feb00da6d30f,2,6,33,27,0,0,0,2,42,0,1,2,0.779349837,782,26,15,159,163,4,4721,4845,124,54,55,1,100
016d49b4c0e6e442c17545ee8219c9eafee553e5,19,1339,86,1253,13,0,13,1,108,7,2,5,4.026921013,4530,63,4,1388,1296,92,35924,32131,3793,421,323,98,99.88733301
2b942805f23b9aeb586ec6abe5b248e7f7f95ba1,10,662,100,562,1,0,1,8,60,103,3,6,2.208545318,2833,201,11,505,472,33,21151,18018,3133,316,305,11,94.53761878
54744110eb334a496d6f0957a70beb552196b7e2,2,32,6,26,0,0,0,8,67,19,1,2,0.485460761,1899,98,9,588,585,3,14524,14360,164,140,137,3,100
e80110bdd1029dc03dd3ff422c98458daf451478,1,20,19,1,0,0,0,6,10,196,1,1,0,616,13,2,179,179,0,3339,3308,31,175,175,0,100
cb98d4fc333b647fe0e9cef6b0de5399f0ddc597,2,48,18,30,0,0,0,4,109,10,2,2,0.773226674,3503,14,3,1022,1016,6,25171,25122,49,252,249,3,100
f90952b286ee393a5bde92cb1b1ffc690d275593,1,79,6,73,0,0,0,1,2,12,1,1,0,62,27,14,7,4,3,586,315,271,6,4,2,100
d4c227ef00e0dc440a22baa239b43d2475003e1a,5,183,46,137,0,0,0,2,92,23,2,4,2.003599281,6067,28,15,1519,1506,13,37858,37343,515,565,561,4,99.80888196
97caf21bb7dbe572929897fc69555a507d3f81f9,1,0,1,1,0,0,0,7,62,0,1,1,0,1278,29,16,271,271,0,7598,7604,6,230,230,0,100
96777b22055a750b37dc0ca8d3c333b1d979e1fb,1,1,3,2,0,0,0,9,44,0,1,1,0,637,30,17,131,131,0,4124,4129,5,39,39,0,100
35d97a14d323d12e263774612d7a995aaa238c72,1,5,3,2,0,0,0,2,2,203,1,1,0,96,87,5,14,14,0,727,707,20,7,7,0,100
e32f6f133741ecd8eb99633eb239bc9d0ed99e69,2,108,15,93,0,0,0,9,43,220,1,2,0.534943699,1160,88,6,355,338,17,8556,7918,638,117,110,7,100
21a2fadcc6281af26ee828004774fe6a703f3dc0,2,75,50,25,0,0,0,2,45,0,1,2,0.634309555,827,31,18,169,168,1,5219,5130,89,56,57,1,100
ae16f80278f798971e8a9c23014a3f38661e8fe1,0,0,0,0,0,0,0,0,0,0,0,0,0,0,32,18,0,0,0,0,0,0,0,0,0,100
d87574922602087faeff641fddf3f135440e9f00,1,1,1,0,0,0,0,4,6,36,1,1,0,143,15,4,23,23,0,832,832,0,11,11,0,100
751a60b393c495ababa80727ea18ad8563b2e2f5,2,4,27,23,0,0,0,9,44,2,1,2,0.345117315,1245,89,7,350,355,5,8405,8556,151,115,117,2,100
a6f5dad980f321cf0b7d2cda91bb855751357779,0,0,0,0,0,0,0,0,0,0,0,0,0,0,33,19,0,0,0,0,0,0,0,0,0,100
b3987f568c5403364ba6386898d5cee397ec2a2f,0,0,0,0,0,0,0,0,0,0,0,0,0,0,34,20,0,0,0,0,0,0,0,0,0,100
4b45efa82861aa7ff4accd7dfc1ea6941cc86e7a,0,0,0,0,0,0,0,0,0,0,0,0,0,0,35,21,0,0,0,0,0,0,0,0,0,100
1765ccbdd1bc4e307efd5de064d75e85076e653b,0,0,0,0,0,0,0,0,0,0,0,0,0,0,36,21,0,0,0,0,0,0,0,0,0,100
154a41cc1169d6d17b5904bdbd034714d16d23f9,0,0,0,0,0,0,0,0,0,0,0,0,0,0,37,22,0,0,0,0,0,0,0,0,0,100
549115f77c4551a21711646d43b522f4b7894817,62,1158,1,1157,0,0,0,3,7,43,4,14,5.953754472,1922,38,23,267,267,0,15069,15069,0,155,155,0,100
9168ab0032ab493513230bc696a4872006465a3a,0,0,0,0,0,0,0,0,0,0,0,0,0,0,39,24,0,0,0,0,0,0,0,0,0,100
4d5c43ad78b6b2c326bc53044c0efbf905771137,2,19,89,70,0,0,0,9,45,2,1,2,0.581321499,1224,90,8,338,350,12,7918,8405,487,110,115,5,100
f949bc9ccb6f2503056c0084ebc364024e0e545a,0,0,0,0,0,0,0,0,0,0,0,0,0,0,40,25,0,0,0,0,0,0,0,0,0,100
b99931efa8df7ffed2a695d8bc602ac8570532c4,0,0,0,0,0,0,0,0,0,0,0,0,0,0,41,26,0,0,0,0,0,0,0,0,0,100
be8b9808f680515ed3d662e2020028e694e7a170,18,1829,1473,356,3,0,3,1,26,31,3,3,2.784275572,4713,99,3,850,765,85,42018,36919,5099,706,608,98,97.57997355
5f2c7c3fae014589a0324b101c89d6d629a4c45e,1,2,2,0,0,0,0,3,5,1,1,1,0,114,42,25,25,25,0,714,714,0,14,14,0,100
fced775084bacbc1073a6e072b25aa3f032d58bf,1,2,1,1,0,0,0,3,6,0,1,1,0,114,100,4,25,25,0,714,714,0,14,14,0,100
8a2210c65ae3e854c51da82fdddbae5686583e8c,5,258,16,242,1,0,1,1,110,431,2,3,1.38464672,5100,202,8,1519,1499,20,37850,36377,1473,376,372,4,99.99044068
3a8ec9e18236f863b6b2922ba52e9140b4f81bef,1,2,3,1,0,0,0,1,3,43,1,1,0,410,313,1,108,107,1,3374,3388,14,58,58,0,100
4b7e773753ae7b24a3c0c3bdbdd71b8c0d8def5b,2,12,4,8,0,0,0,14,111,0,1,2,0.811278124,3927,203,9,1185,1183,2,28081,28025,56,297,296,1,100
44fa5e83ae1377a9a24d1d54eeaab834b80d264e,0,0,0,0,0,0,0,0,0,0,0,0,0,0,204,10,0,0,0,0,0,0,0,0,0,100
bace5f56977a04a37280668fff6167cd32f6b60f,2,83,18,65,0,0,0,9,46,6,1,2,0.525935984,1160,91,5,349,338,11,8370,7918,452,114,110,4,99.95704057
9c15e0b746bacb6883104990cb12a09025b66681,1,3,2,1,0,0,0,9,46,11,1,1,0,658,43,24,134,134,0,4268,4263,5,40,40,0,100
8ab85903ff1db66396d13f8f05c1ff8b120827c0,0,0,0,0,0,0,0,0,0,0,0,0,0,0,16,5,0,0,0,0,0,0,0,0,0,100
ff52a40fb4c44db2395b522cc1d696fdb4c851f2,2,6,2,4,0,0,0,5,8,136,1,2,1,909,17,6,120,120,0,5690,5661,29,32,32,0,100
a2c286bf3bd3cf40af683d019f01609fe997b44a,6,18,67,49,0,0,0,12,112,1576,1,2,1.317179338,4677,18,7,1313,1323,10,33223,33514,291,316,317,1,100
338d56bbf3484d38ed1788acfbb0d29d9fc91c7b,3,32,4,28,0,0,0,4,20,133,2,3,1.459147917,436,19,7,78,75,3,2943,2793,150,38,37,1,100
df986cb186e88c791f49a4a61fa6318fc5429489,0,0,0,0,0,0,0,0,0,0,0,0,0,0,205,11,0,0,0,0,0,0,0,0,0,100
2236c1833ecb454e69dee813ddb32933292c5e5a,1,1,1,0,0,0,0,10,63,56,1,1,0,1476,314,2,465,465,0,11124,11137,13,75,75,0,100
43de09873ba47f3c2da2e1fdc3b64cc60eb5bd54,1,4,20,16,0,0,0,3,9,39,1,1,0,208,315,3,37,44,7,1380,1525,145,12,14,2,100
6a8483460dad988b92e2c1938363f7269518a05d,1,0,13,13,0,0,0,4,8,4,1,1,0,158,316,4,22,23,1,895,1010,115,17,18,1,100
b961b8baa20c592d350349d2c83bf6dfc0a2df1d,66,1510,1615,105,10,0,10,1,64,6,5,11,4.648783865,15261,317,4,3308,3251,57,112398,110469,1929,1419,1400,19,99.86197049
d7a6e1a08b976fb1363599412b7e13258f865999,1,9,8,1,0,0,0,3,5,35,1,1,0,117,206,10,17,17,0,611,613,2,5,5,0,100
83bcadb624e11e6eb14a88f8c9453c7025d851f2,0,0,0,0,0,0,0,0,0,0,0,0,0,0,44,21,0,0,0,0,0,0,0,0,0,100
f503abe979c330e2bb4e893d32c19e6e85c2730e,0,0,0,0,0,0,0,0,0,0,0,0,0,0,45,22,0,0,0,0,0,0,0,0,0,100
9c0f517f555b71c65cd1b331a0349ec45debcda7,0,0,0,0,0,0,0,0,0,0,0,0,0,0,46,23,0,0,0,0,0,0,0,0,0,100
7b06c5cfbf04d203ba55920ff120c3e6469e69e9,2,48,5,43,0,0,0,3,18,58,2,2,0.883585086,619,92,5,76,74,2,3564,3433,131,62,60,2,100
27b0abd46bff16f4f2a44b6a4d3a0cad8367234f,2,278,0,278,2,0,2,1,1,0,1,1,0.953768774,0,47,24,15,0,15,986,0,986,14,0,14,99.97624816
edb329a475d953e021d56cf279885e153337ac6f,3,322,1,321,2,0,2,1,3,65,2,2,0.864239911,84,93,6,38,11,27,1952,430,1522,25,3,22,99.97625944
a972ec0de37dc65435718babd762cda3e24e823d,0,0,0,0,0,0,0,0,0,0,0,0,0,0,207,6,0,0,0,0,0,0,0,0,0,100
62be4544b36fcc2f9cd343c0dbbeb177bf6a9f29,7,466,51,415,2,0,2,9,50,148,3,4,2.360225424,4576,64,2,1298,1227,71,33381,31647,1734,330,306,24,99.87707437
6ee7af451cc1deb4143cf23eb01044e40333f8ad,4,127,15,112,2,0,2,1,59,13,2,2,1.767471027,1831,65,3,560,552,8,12453,12187,266,171,164,7,99.97646062
75c9605384b696951d2753477631ccf8bdfee64f,1,8,2,6,0,0,0,9,47,20,1,1,0,659,48,21,134,134,0,4288,4268,20,40,40,0,100
888ddb83c06405970b61e68d6731047478344260,1,68,22,46,0,0,0,1,1,0,1,1,0,107,49,22,13,7,6,862,586,276,6,6,0,99.98117293
5d1bd85ca843ab91f666129588621d6a74c34f5b,1,32,0,32,0,0,0,8,21,18,1,1,0,242,20,5,55,50,5,1841,1665,176,18,16,2,100
c63c10cfbf6420ca64886e4206031f7bfa205ab8,0,0,0,0,0,0,0,0,0,0,0,0,0,0,208,6,0,0,0,0,0,0,0,0,0,100
acd00ecc61969003d95dc081d6cf4e34826aa89f,1,21,0,21,0,0,0,3,11,76,1,1,0,270,50,19,36,35,1,1901,1704,197,13,12,1,100
c9d62822d4116bf745873f499b697b5b9715493b,2,36,23,13,0,0,0,1,12,9,1,2,0.994813175,920,318,5,201,194,7,6193,6119,74,100,100,0,100
8f2f9e1626b5e4efdf15e32c261038e5fdd2e2be,0,0,0,0,0,0,0,0,0,0,0,0,0,0,51,19,0,0,0,0,0,0,0,0,0,100
4c9be63dc661abcc91b727102d8ab72f9d92496b,3,108,0,108,2,0,2,1,19,24,2,2,1.389640912,552,209,7,115,107,8,3951,3626,325,42,35,7,99.9764717
e3a6af8f2471c2a91e71a58db005325e55ec4e42,0,0,0,0,0,0,0,0,0,0,0,0,0,0,210,8,0,0,0,0,0,0,0,0,0,100
d6ae199de7674cad164bb73c6ed9798b993f4120,23,1352,1117,235,1,0,1,1,22,21,3,4,2.879908763,6540,319,6,1110,1034,76,54336,52451,1885,812,777,35,99.93884943
70a0b7b1db04e45b2bc2b69bec031afd97a0b0f3,0,0,0,0,0,0,0,0,0,0,0,0,0,0,320,7,0,0,0,0,0,0,0,0,0,100
0d8b1dc074b3f565055ea8b07c0041490f587808,9,382,208,174,1,0,1,1,63,42,4,6,2.660291334,2919,52,19,510,485,25,18532,17821,711,316,309,7,99.99059443
0b0fb31bce1ac58e568786fb38a95a76ce701df6,6,181,12,169,1,0,1,1,23,3,2,2,1.775072132,1646,321,8,226,181,45,16562,15389,1173,159,143,16,99.9906015
7b0fda399fb64fe1110e5e3e002149998c21c001,1,0,18,18,0,0,0,9,52,202,1,1,0,590,322,9,129,135,6,3569,3687,118,73,74,1,100
e1f290e4df135d4ddfa0430870c96800f93a3760,0,0,0,0,0,0,0,0,0,0,0,0,0,0,211,9,0,0,0,0,0,0,0,0,0,100
472cf99ab4ee23a637a6072d408f2b5828d33578,1,0,2,2,0,0,0,3,3,227,1,1,0,63,53,11,9,9,0,247,255,8,8,8,0,100
bc9654cfc5ecd843023d1032f9208a83d91eff4b,3,31,9,22,0,0,0,1,2,61,2,3,1.061278124,145,54,12,19,15,4,634,539,95,9,5,4,100
46ea5bf7a601eb545ca624adec64aa55c3af2c16,0,0,0,0,0,0,0,0,0,0,0,0,0,0,55,12,0,0,0,0,0,0,0,0,0,100
77f181582e80977ea7bf5a594ad99ae5e0b3aa4e,0,0,0,0,0,0,0,0,0,0,0,0,0,0,56,13,0,0,0,0,0,0,0,0,0,100
7f0b0234c08e6fdbe92b2de1c6a3f4f36bea9fb4,1,34,25,9,0,0,0,8,37,60,1,1,0,379,212,8,117,116,1,2579,2522,57,31,30,1,100
453a6a96fa1f227c9420d04bbe82812418ba6d76,1,24,11,13,0,0,0,9,47,39,1,1,0,593,213,9,130,129,1,3864,3847,17,48,47,1,100
6c1cc88175825ccfc0714f74d25a20cc38eca1d6,0,0,0,0,0,0,0,0,0,0,0,0,0,0,57,14,0,0,0,0,0,0,0,0,0,100
79ad8c494365c952b23b50ced8db568e8435cc43,1,73,0,73,1,0,1,1,1,0,1,1,0,0,21,5,4,0,4,338,0,338,2,0,2,100
1c4fdebe83c4be330f0839d954a7aabac2505241,0,0,0,0,0,0,0,0,0,0,0,0,0,0,214,9,0,0,0,0,0,0,0,0,0,100
d389c4327bb23ce6ea261de45e0d2755e9b70431,0,0,0,0,0,0,0,0,0,0,0,0,0,0,22,2,0,0,0,0,0,0,0,0,0,100
0e055fb013c5713be573c5088c18320dc16764d4,1,66,19,47,0,0,0,2,4,71,1,1,0,179,215,9,40,30,10,1301,1103,198,10,9,1,100
4b70d52d9c7b8f3f8b61b27f67a5faa43eaddfac,10,359,42,317,2,0,2,1,113,61,2,3,2.855763836,7592,58,14,2191,2167,24,55128,53278,1850,575,556,19,99.97652472
ecf43f87f74dd869b7c7c661f57f8b2fe671a5fe,79,2763,1941,822,1,0,1,1,57,44,3,6,4.650691387,10318,323,6,2128,1938,190,78785,76763,2022,1157,1102,55,99.95300752
636bd5f2135cfeb387e7a534f2e134eb58be16b9,2,36,1,35,0,0,0,3,7,704,2,2,0.571354974,513,23,0,124,120,4,3602,3370,232,57,55,2,100
e57f03262621b025059bd9a2d2c669d9159ea2b6,7,288,94,194,0,0,0,2,13,0,1,1,2.298785458,1315,101,0,348,297,51,11280,10189,1091,171,161,10,100
44443b3ebd32780801c845a518ac59a7488b74d4,8,141,183,42,0,0,0,2,14,7,1,1,2.058758075,2088,324,6,436,430,6,15392,15289,103,288,288,0,100
e72c186ef19ba194ea3dcae6d33e7b0a47e4e77d,1,2,2,0,0,0,0,10,49,134,1,1,0,1427,59,11,477,475,2,8971,8955,16,167,167,0,100
3f15ecde4d8702353f8046d0f522f489de227c03,1,1,1,0,0,0,0,3,7,2,1,1,0,204,60,12,47,45,2,1505,1505,0,32,32,0,100
291f3142428888a44ff884e27f21b128d37f2a4a,5,270,122,148,0,0,0,3,13,1,1,1,1.91213594,974,102,1,357,245,112,9287,7880,1407,109,98,11,100
42f866712844648c2c56a0fa869fd3bccbd4ada4,1,2,3,1,0,0,0,3,9,1,1,1,0,267,103,2,103,103,0,2180,2191,11,38,38,0,100
fa64591c41d118dbda3c6ec48bb95e7735c9c37f,1,4,7,3,0,0,0,2,2,117,1,1,0,27,61,11,0,0,0,82,82,0,0,0,0,100
82c80100cc8e88630b1bfc34697d34eea6afc255,1,41,23,18,0,0,0,2,6,74,1,1,0,185,62,12,35,35,0,1107,956,151,16,16,0,99.98118621
bc5a51520f3efdea5f6f78b63fb663bed4f22810,8,614,0,614,8,0,8,1,1,0,1,1,2.77710905,0,63,13,47,0,47,1877,0,1877,38,0,38,99.91071848
717a3bb508c1f1e2ae3edb4ffd0403150c89a5b9,5,15,47,32,0,0,0,7,64,143,1,3,1.899157931,2107,23,3,396,396,0,13205,13254,49,256,256,0,99.98591417
6ec1122a7e72d3e5a35d05a8645a197c26590e20,0,0,0,0,0,0,0,0,0,0,0,0,0,0,64,13,0,0,0,0,0,0,0,0,0,100
2fc4ba2c454365b3fc62d1e7aac1eeb23e3a7661,2,239,4,235,1,0,1,1,2,4,1,1,0.981338736,107,65,14,39,14,25,1584,650,934,18,5,13,99.99060945
de7f5c1189feb70d76e4d7ee487c585efd6ca6eb,2,248,87,161,0,0,0,1,3,4,1,1,0.178421156,282,66,15,55,39,16,2263,1558,705,20,18,2,100
1fce44737bd0cd696fb8b904aafb1dd663093d11,74,3750,0,3750,74,0,74,1,1,0,1,10,5.730501184,0,216,7,214,0,214,11017,0,11017,197,0,197,99.26549207
03d9e24bc6a10c3bea737678606d74f7c6fb86fc,2,119,23,96,0,0,0,8,69,99,1,2,0.996419634,4803,217,8,1213,1194,19,36846,36497,349,288,285,3,100
9c6fbcbab3c3a2617da4550d4316e36e13d97ca1,0,0,0,0,0,0,0,0,0,0,0,0,0,0,218,9,0,0,0,0,0,0,0,0,0,100
db2082dea48a90a5c6b3158bf459cb9844821a9d,27,826,821,5,1,0,1,1,25,9,2,5,3.609076202,7561,325,6,1558,1552,6,64531,61663,2868,879,873,6,99.94480729
80dbd79952be22b5427c5ee44a11b9c67c4ff033,1,5,4,1,0,0,0,6,16,266,1,1,0,274,219,8,71,71,0,1751,1744,7,25,25,0,100
0f45f13fc297d6b73c12e3e0a0b0b155112d4457,12,453,12,441,6,0,6,9,51,195,2,5,3.280464237,2844,66,0,820,779,41,19546,18269,1277,240,215,25,99.93112948
ac12bb4ade57471e9eefa6f66ca9521c867d9adf,1,19,1,18,0,0,0,6,21,58,1,1,0,432,67,1,141,139,2,2616,2575,41,65,63,2,100
0ce16aef5f434631a8cf2670e20d8db49431b653,0,0,0,0,0,0,0,0,0,0,0,0,0,0,68,2,0,0,0,0,0,0,0,0,0,100
6473b9820a77684e16af425c5ddce64230d1d10d,1,30,13,17,0,0,0,4,9,126,1,1,0,62,24,3,6,6,0,429,318,111,4,3,1,100
278da3816f63e155405999f509dc02458b605e04,2,2,2,0,0,0,0,1,1,0,1,1,1,124,25,4,18,18,0,566,566,0,12,12,0,99.96329939
c2afd1cefd4c54bed03ae06435c61ec05eb0ec8c,29,773,600,173,1,0,1,9,54,207,4,6,2.525390142,7688,326,3,1785,1759,26,51974,51127,847,756,732,24,96.59004919
c24bc1d75c9c84887b684590a8501a1ab88e3c2f,6,114,10,104,1,0,1,2,58,86,3,5,2.152791374,1945,69,3,466,449,17,12648,12278,370,251,245,6,99.08781548
a1a94144bd0a9a26edcd0209e884b364782fd5d7,61,124,240,116,0,0,0,1,2,0,1,7,3.920902744,2714,220,8,183,183,0,8680,12610,3930,183,183,0,98.97370109
8730eddc2955d48e38d831f988c1bfc2d5e6e314,0,0,0,0,0,0,0,0,0,0,0,0,0,0,221,9,0,0,0,0,0,0,0,0,0,100
617e6ddff4e5a29c61eadf576efdf9ca523c37a2,3,281,13,268,1,0,1,2,5,2,1,1,1.146258149,391,67,10,95,61,34,3535,2319,1216,33,20,13,99.99083746
4c9e036e8a8c9a120d633dab5f14100923f684bf,1,1,0,1,0,0,0,9,34,59,1,1,0,204,68,10,34,34,0,1250,1250,0,13,13,0,100
10bd4e70de8de17ec165e1103fce62b6ae8c33ea,4,43,42,1,0,0,0,2,6,11,1,1,1.456601502,686,69,11,104,104,0,3891,3858,33,42,42,0,100
9ee5383721d40820f36cfbc30618b8a56e9b348b,1,11,2,9,0,0,0,13,93,105,1,1,0,3724,70,4,1080,1080,0,23010,22981,29,278,278,0,100
60fd64109c3b97f4d440dcdd6243f28415427fc2,3,235,5,230,1,0,1,2,7,0,1,1,1.033758519,508,70,12,111,86,25,4162,3212,950,37,24,13,99.99083914
1bdb8363f85b28a589b114e2487a7bee291d3517,2,258,1,257,1,0,1,2,8,0,1,1,0.988257676,482,71,13,120,91,29,4386,3341,1045,33,17,16,99.99084081
5bfc42f725e12153ad11550219e4313cd8568c58,2,245,1,244,1,0,1,2,9,0,1,1,0.994223031,560,72,14,133,106,27,4951,3897,1054,35,20,15,99.99084249
8597b330e59009860f0c3d890a6755cf47970028,37,2291,8,2283,33,0,33,1,78,6,2,6,4.93095312,4587,222,6,1376,1165,211,36976,29549,7427,635,502,133,93.6074878
5283bcd77d606369c021281bc904a2c257c4dd2a,10,1058,28,1030,6,0,6,2,66,4,3,3,2.161798307,2002,71,5,440,334,106,15702,12105,3597,302,259,43,99.92368077
9f62d5ebfa3fd85d2ca342da34ccfe5be552a45c,1,6,3,3,0,0,0,8,27,42,1,1,0,1260,223,7,467,467,0,9796,9790,6,58,58,0,100
dcaa13461e79e0f8ad417a16b51274ae2dd06c9c,6,216,95,121,0,0,0,2,14,78,3,3,1.638822179,812,327,3,182,171,11,5816,5257,559,72,63,9,100
ba49a316e7db2b2bf26d69701990335ad2a0e2eb,1,24,26,2,0,0,0,2,10,5,1,1,0,637,73,14,110,121,11,4381,4453,72,24,23,1,100
edf98f5f91940dd45c1d3c09972fff8aab81cedc,2,262,5,257,1,0,1,2,11,0,1,1,0.994640601,631,74,15,135,110,25,5458,4381,1077,37,24,13,99.98910675
b577460955ec26d03f1248e478f9a0eff0454ed5,2,223,1,222,1,0,1,2,12,0,1,1,1,709,75,16,149,125,24,5855,4937,918,39,27,12,99.98910913
08bafa5ef5aca9a136688109264eda6265627518,2,13,7,6,0,0,0,1,2,4,2,2,0.811278124,175,224,8,33,31,2,821,817,4,18,16,2,100
19d8d3f21d46201df8acabc2fd6223b0f06af950,1,1,1,0,0,0,0,1,3,0,1,1,0,95,225,9,14,14,0,446,446,0,11,11,0,100
717a0b18552a6814d12ba7a03ef05e9c28982725,5,193,29,164,0,0,0,2,13,28,1,1,1.54832158,1004,76,17,174,160,14,7141,6227,914,52,50,2,99.98366458
56ae0ae6ae48cd07156cb6c9e4048ad62df823cd,2,12,10,2,0,0,0,5,10,546,1,1,0.976020648,1082,94,0,278,279,1,6951,6925,26,180,180,0,100
8613683843edde3e1c0a2e122af078406b8af1e3,5,0,9,9,0,0,0,3,10,393,3,3,2.281036113,401,77,18,70,70,0,1796,1840,44,62,62,0,100
ea71783c57326c367e4d6d7f35a29b72cb4e7187,19,745,42,703,0,0,0,4,55,64,2,5,2.335686937,8978,226,10,2108,1974,134,71935,70075,1860,991,849,142,100
07a98e871b2676bc3c868e4ca0e652a6af9027f2,11,20,632,612,0,0,0,4,17,4,1,2,1.713188921,2848,328,3,621,741,120,18950,20523,1573,326,446,120,99.97821825
f6413764d5b41a83003a163b74023dce8398fb05,2,43,5,38,0,0,0,4,15,715,1,2,0.842657877,225,227,11,39,34,5,1436,1219,217,17,16,1,100
c8b99a764cad4ca0576e008fe11a50c7d1ff1ee4,0,0,0,0,0,0,0,0,0,0,0,0,0,0,72,6,0,0,0,0,0,0,0,0,0,100
ba73316f83faac377a018b5dd969956640dce103,0,0,0,0,0,0,0,0,0,0,0,0,0,0,78,17,0,0,0,0,0,0,0,0,0,100
47173558ef9f0a570e931c2d6d1e395f4bbf688d,1,3,1,2,0,0,0,7,15,185,1,1,0,257,228,12,51,51,0,1599,1593,6,26,26,0,100
00c27b1df4632f2710ccb2742096ebc83d27c128,0,0,0,0,0,0,0,0,0,0,0,0,0,0,329,4,0,0,0,0,0,0,0,0,0,100
edff099770b6fb5cdd116fbfa04c46e4a3dc5896,0,0,0,0,0,0,0,0,0,0,0,0,0,0,79,15,0,0,0,0,0,0,0,0,0,100
3231ac4a2aea10938f0b079d9dcc802247993729,0,0,0,0,0,0,0,0,0,0,0,0,0,0,80,14,0,0,0,0,0,0,0,0,0,100
17a0c1d9b283588ddddecfec8b399d96ea04a61d,2,39,28,11,0,0,0,1,14,49,1,1,0.193642805,1069,81,14,177,176,1,7295,7277,18,39,38,1,100
0927c83f780d90cd12f5c5b425df39e9f09f5cbb,1,5,1,4,0,0,0,6,19,138,1,1,0,78,229,10,14,13,1,453,424,29,11,10,1,100
b40e3a425e5898c9bc5d68c5e28859015c0a7559,0,0,0,0,0,0,0,0,0,0,0,0,0,0,230,11,0,0,0,0,0,0,0,0,0,100
c155c9ee2f0d9842e05029e9326cb520d776c9a4,1,101,69,32,0,0,0,1,3,83,1,1,0,145,82,15,11,10,1,882,792,90,10,9,1,100
229cb12699018513649fb58aacc522fbbca19158,1,1,2,1,0,0,0,2,12,21,1,1,0,321,330,4,89,89,0,2000,2007,7,36,36,0,100
6dd615ebc3ad41f462ce248c0e29608e239a16d1,1,1,1,0,0,0,0,2,13,0,1,1,0,320,331,5,89,89,0,2001,2000,1,36,36,0,100
aefd05089d3a1b2a84476e4c9cff838af0d1f8e5,0,0,0,0,0,0,0,0,0,0,0,0,0,0,83,16,0,0,0,0,0,0,0,0,0,100
21fec94f1920d3afbca52f5125a014fab6947b12,1,9,3,6,0,0,0,2,2,26,1,1,0,467,84,17,68,68,0,2539,2479,60,17,17,0,100
364ea73d6f53c9e9369c43701907d75a1b436cc6,16,2207,58,2149,4,0,4,3,27,56,2,2,1.508855614,2626,104,0,378,281,97,36785,22819,13966,340,246,94,99.30521631
c293165cb4c63c211969e440b9c514a0f5857c3a,4,2100,2100,0,0,0,0,2,2,0,1,1,1.00759802,1695,231,11,87,87,0,13522,13522,0,87,87,0,100
5cb32680a93055223beee3e42a45304f32a8684a,8,365,8,357,4,0,4,9,49,90,3,4,2.58435444,1594,73,3,458,427,31,11420,10428,992,166,138,28,99.94592256
78b694ff9a67fc7ccbe2bd0e01753bbae04ce6da,1,16,11,5,0,0,0,1,4,6,1,1,0,184,85,17,23,23,0,1079,1079,0,7,7,0,100
c487d103c1f473d3ae6f65fd8476dd4183c41a46,1,16,11,5,0,0,0,2,15,6,1,1,0,892,86,18,154,154,0,6216,6216,0,32,32,0,100
c23fb9660b5f20756957aa6782b5e1072bf73cc2,3,56,39,17,0,0,0,2,7,0,1,1,1.246631389,1874,105,1,101,100,1,16584,16661,77,101,100,1,100
8b98816386ff5860b74d657ed3ab5da48c0b260e,5,364,0,364,5,0,5,1,1,0,1,1,2.195870645,0,74,4,30,0,30,1187,0,1187,28,0,28,99.94058229
0adf13872e941840ad4d349d7e52dff0f96eff70,5,60,41,19,0,0,0,3,28,3,1,1,1.999803539,3297,106,2,243,239,4,30003,29641,362,212,211,1,99.96215603
f74c5d7a69fb3dda67fb26c1c0250d48e29fe359,29,1151,279,872,1,0,1,3,114,768,3,8,3.278255225,14116,107,3,4162,3990,172,103364,99712,3652,1549,1464,85,99.9729364
048419e89b2ccdfb3c3f32d86ec1dd4b81bda8a5,1,3,0,3,0,0,0,10,44,215,1,1,0,1157,87,15,342,341,1,8460,8434,26,94,94,0,100
bda625661f2b28c7cf8b57f9fc87dde5b5f234f5,10,284,158,126,0,0,0,4,18,28,2,2,2.74780105,4545,108,4,925,886,39,37776,36324,1452,560,549,11,100
37d9ceae261b396101069e116c9653adc41436a8,0,0,0,0,0,0,0,0,0,0,0,0,0,0,88,15,0,0,0,0,0,0,0,0,0,100
e21a38e64bf35856e53db98b31d317ce7c4a27bf,1,11,0,11,0,0,0,3,10,0,1,1,0,296,109,5,54,52,2,2109,2032,77,21,21,0,99.97835146
06d2be5bd4df849c42abb84d17caaf9af3dc7c81,8,0,67,67,0,0,0,1,4,38,1,1,2.990660119,817,89,16,83,83,0,2994,3370,376,82,82,0,100
0cf0922386fdc8e13f5ec79af77e2d02881a41c2,2,5,4,1,0,0,0,2,8,29,2,2,0.764204507,722,90,17,114,114,0,4002,3977,25,35,35,0,100
37c2620b1eb065b522cf91f1e132ea6812b71497,1,2,2,0,0,0,0,8,18,161,1,1,0,451,232,8,146,146,0,3007,3007,0,53,53,0,100
1b86a81c948382d8c7927d817a456c9f72aa6dd3,9,25,9,16,0,0,0,2,50,71,3,4,2.9542474,2365,91,18,442,439,3,14193,14148,45,177,174,3,100
07f597d281b01c896c00e791e13e90d3a60f319d,0,0,0,0,0,0,0,0,0,0,0,0,0,0,75,3,0,0,0,0,0,0,0,0,0,100
c47bd9ee3a2481bed43d77618699ad7d0974eca6,3,199,44,155,0,0,0,1,15,119,1,1,0.310940049,817,332,4,217,189,28,6238,5533,705,76,67,9,100
49f000f54a70c402671e7b73f5a06767576e94b4,18,1152,7,1145,13,0,13,1,59,7,2,4,3.314939579,2116,233,7,653,557,96,19830,15075,4755,445,382,63,99.83786413
3bfcd22c9e59b1e0cc1b3bed44fb097e2d405395,1,2,1,1,0,0,0,3,16,0,1,1,0,362,333,5,61,61,0,2400,2400,0,20,20,0,100
1f58f05c524045301acab4ba5fbe30fb2af34a07,1,12,7,5,0,0,0,1,5,109,1,1,0,653,334,6,166,165,1,4466,4436,30,88,88,0,100
c6e394d93681c7c9db6962a565d9245531732fa0,1,2,3,1,0,0,0,9,29,2,1,1,0,426,92,15,117,117,0,2538,2545,7,52,52,0,100
fc5d50bf1854d3b23cf3ad4c3c33e285525db789,2,30,17,13,0,0,0,1,2,0,1,2,0.342463772,291,234,7,46,45,1,2028,1856,172,20,20,0,99.93517718
5136bbc8d33fab04e782e915bb6669599870f099,3,208,0,208,2,0,2,1,73,29,2,2,1.559666161,686,235,8,179,157,22,5598,4737,861,48,39,9,99.97296859
001c9e4fd2a1fcbd2449be0f963b684096bc0c52,16,1170,306,864,4,0,4,3,60,44,2,4,3.099631972,4806,335,7,1166,1063,103,38052,33674,4378,798,743,55,99.94056945
7099c084fba4b1cf6a920f1c34d82a471ef343d3,12,259,29,230,1,0,1,1,29,377,4,4,3.057795455,4295,336,7,947,918,29,35289,34105,1184,693,673,20,99.96760084
ec35dff0935d976f2915d8cedf9e52f824fcd06e,0,0,0,0,0,0,0,0,0,0,0,0,0,0,236,8,0,0,0,0,0,0,0,0,0,100
7022d018dac496996b410d9244351bf7c49543d8,8,933,24,909,6,0,6,9,36,2,2,2,2.771442079,515,76,3,191,96,95,6910,3154,3756,99,43,56,98.56733524
81c7abc64e364c11cd139b38f738aaa3f0d7f948,0,0,0,0,0,0,0,0,0,0,0,0,0,0,237,9,0,0,0,0,0,0,0,0,0,100
e7f919169514d8b9af66265260a2407c48cab6ec,2,24,16,8,0,0,0,7,79,26,2,2,0.769192829,2776,238,10,854,854,0,18399,18379,20,257,257,0,100
b8610366f01e8956cff681c123dc2bef79bdb866,0,0,0,0,0,0,0,0,0,0,0,0,0,0,239,11,0,0,0,0,0,0,0,0,0,100
62a32c559684f1adbb9ba4c6ef84e6455cfc4769,3,88,22,66,0,0,0,4,18,18,1,1,0.742158245,816,110,6,307,285,22,7766,7184,582,94,93,1,100
60d17df05fe2aef2070125a46d4b2df6aecea093,3,192,138,54,1,0,1,9,38,4,1,1,1.400011779,641,77,4,135,137,2,4012,3924,88,52,49,3,99.9895703
e47be7dc3fbb2c12d215bfb71cb38b03f860f689,4,133,13,120,0,0,0,1,2,60,1,1,1.771852076,111,240,11,0,0,0,269,269,0,0,0,0,100
8c9c54e65212503a816b203b9f62fba552528f07,0,0,0,0,0,0,0,0,0,0,0,0,0,0,241,12,0,0,0,0,0,0,0,0,0,100
f4d7e532e3aa33376bc04b1a5653ce414d8d3277,1,201,0,201,1,0,1,1,1,0,1,1,0,0,78,5,14,0,14,976,0,976,12,0,12,99.98957465
a31b0ee95d8ff52426e5d0cb5767b99282990c67,2,5,0,5,0,0,0,9,38,190,2,2,0.970950594,287,93,12,46,46,0,1695,1661,34,23,23,0,100
b7b0b157772b65f3cc5ba20910f3eb109601ea2d,1,11,4,7,0,0,0,9,39,2,1,1,0,218,94,11,36,36,0,1362,1360,2,14,14,0,100
9658b657c2bc15c103a531dd5991f2abcc4cfbab,0,0,0,0,0,0,0,0,0,0,0,0,0,0,95,12,0,0,0,0,0,0,0,0,0,100
7c4cf09bcaca706d2de542e7da50b2c37831d44e,1,6,2,4,0,0,0,3,6,2,1,1,0,72,96,13,10,10,0,335,335,0,9,9,0,100
76e82998f6b25acdc827eddbefa42c32fc1c9df6,6,21,11,10,0,0,0,2,57,28,1,2,2.332554799,1383,242,11,344,342,2,8690,8626,64,178,176,2,100
1b128ce338602b085108faa64827bd37e540b6f5,41,2544,103,2441,35,0,35,4,43,79,3,4,2.479201284,1852,111,7,630,480,150,33807,13861,19946,271,141,130,99.45519639
ec483537da504f3ea5c4371fe096ba636211c0c6,5,315,3,312,3,0,3,3,13,109,2,2,1.973654396,846,112,8,173,135,38,7476,6312,1164,99,67,32,99.96385604
c295a07fbed39ea829ae71588d856694becf475f,1,0,8,8,0,0,0,1,2,108,1,1,0,105,97,14,5,5,0,627,643,16,5,5,0,100
856fde5686331650553c3bd659891f0ccee226ce,2,42,35,7,0,0,0,2,13,2,1,1,0.996956252,1948,337,5,190,189,1,18760,18736,24,151,150,1,99.98967689
ba84a115bc5240a7abb07348044f0a8890bfb7d1,2,24,2,22,0,0,0,3,19,85,2,2,0.840358672,798,95,0,116,115,1,4551,4428,123,76,75,1,100
91ab01643a872a6cf5626ff3cd2b1ecb1ab1e202,12,555,7,548,3,0,3,1,61,81,2,4,2.325295746,4405,338,6,1170,1076,94,34612,32127,2485,737,709,28,99.96388215
0928de75121791eadc3de940552f2fa20009dee1,2,1,5,4,0,0,0,3,13,11,1,1,0.918295834,313,113,9,85,86,1,2552,2562,10,18,19,1,100
a10a0a5d802e81cfc4a4b5cbb5a8b65853998250,2,16,14,2,0,0,0,2,14,0,1,1,0.918295834,1954,114,10,190,190,0,18760,18760,0,151,151,0,100
efaf681a466f83e92ef6ab75d9774fe1e1c4328c,0,0,0,0,0,0,0,0,0,0,0,0,0,0,98,13,0,0,0,0,0,0,0,0,0,100
803c4daaa437dd7e652ecc1c643d3bf7ef6a485e,0,0,0,0,0,0,0,0,0,0,0,0,0,0,99,14,0,0,0,0,0,0,0,0,0,100
8ca7664bd9192c64ca955266fa4969e4ddb642d9,3,17,9,8,0,0,0,3,30,5,2,2,1.314320487,1914,339,7,296,294,2,16262,16162,100,257,255,2,100
16344b5b33639767eecffa16c769b956633d14e2,2,20,17,3,0,0,0,4,4,386,1,1,0.99947302,112,100,15,26,24,2,460,398,62,16,16,0,100
53805483fc610b6f8491eec1e027ce99ca735553,7,163,75,88,0,0,0,8,69,18,2,5,2.000218665,6255,141,0,1938,1910,28,47256,46517,739,596,587,9,100
d35e668190ec027c629adfd74c40f76daa9e2edf,2,20,4,16,0,0,0,3,20,0,2,2,0.41381685,811,96,1,117,116,1,4610,4551,59,77,76,1,100
aa72c08d4469c3e7635e972d99674e2b9f30e407,2,43,14,29,0,0,0,3,7,75,2,2,0.934849024,524,243,11,80,68,12,4747,4573,174,58,57,1,100
d91fa6a2ac3fb4f2ba3af8aaa66121134765e3b8,1,0,17,17,0,0,0,2,4,0,1,1,0,362,244,12,25,25,0,2916,2941,25,25,25,0,100
5432ffecbb765de57791f414aa88c9dd88cd55c6,1,2,0,2,0,0,0,3,8,0,1,1,0,175,115,10,56,55,1,1820,1806,14,33,33,0,100
5f83298a9541a5a60ac8e4b3f44d1e541ed90039,1,2,1,1,0,0,0,3,9,0,1,1,0,177,245,13,56,56,0,1822,1820,2,33,33,0,100
b9d609a3b078e6964939da4096661a1f5355fe41,0,0,0,0,0,0,0,0,0,0,0,0,0,0,246,14,0,0,0,0,0,0,0,0,0,100
9706a82960827fbadef34bb49dbd63ebbf08fcc7,12,743,22,721,5,0,5,1,2,5,2,2,3.19508607,821,79,5,192,98,94,7671,4476,3195,111,64,47,99.93815389
3ae614fc269e45ba4af09c77a339b39c0650fe4b,3,287,2,285,1,0,1,1,15,81,1,2,0.287359662,410,340,8,101,71,30,4219,2686,1533,56,32,24,99.97940374
39cad9823184542f8318ebf4ce1b9b47bcea0424,4,51,18,33,0,0,0,3,19,573,3,3,1.92741315,1058,341,9,295,283,12,8698,8406,292,98,95,3,99.91260988
08d76bc36d0f7eb78d990cdd60c45360faf3f1be,2,113,8,105,1,0,1,3,12,1,1,1,0.540657228,252,101,14,51,46,5,1673,1474,199,22,18,4,99.97947139
385558d275a7fcbd237ee2ce72cdf40a660a8010,12,203,212,9,0,0,0,3,31,15,3,4,1.79812848,5198,342,10,650,647,3,48371,47186,1185,380,374,6,99.84111527
ff932542e851f486df77726ee5ea2c9fe65a901a,7,464,12,452,6,0,6,9,52,13,2,2,2.620955235,1552,247,15,485,439,46,11260,9533,1727,148,115,33,99.93349363
655ec577e9d0452d06a7ce74d6571a810605e220,3,38,60,22,0,0,0,5,11,286,3,3,0.512753111,421,248,16,85,84,1,2566,2532,34,58,58,0,100
931496e6ead4d36085f01fa15f260113eada1bdc,1,1,1,0,0,0,0,9,22,89,1,1,0,302,343,11,64,64,0,2108,2108,0,21,21,0,100
bde4708bacdcb7f2f95c9fc4a8967fcc7ca0d51c,9,480,636,156,0,0,0,2,62,38,3,5,1.774552622,4561,344,12,1143,1178,35,29259,29999,740,577,597,20,99.97954801
1f9f4d68ef6cc88fe2aa683bc858830b169d3f21,0,0,0,0,0,0,0,0,0,0,0,0,0,0,249,17,0,0,0,0,0,0,0,0,0,100
86ebcbe115b1ea0844d497ecbacbf737294c9118,1,1,1,0,0,0,0,4,8,219,1,1,0,835,250,18,173,173,0,4872,4871,1,19,19,0,100
17da1c9a7e4de4efcdcbeeeb2f3a63d88e4e55a8,4,158,6,152,1,0,1,3,67,80,3,3,1.735033651,1846,251,19,311,301,10,11810,11332,478,259,252,7,99.97955219
b5e893b5a732468e147c7c5060e1141b9c6d3474,0,0,0,0,0,0,0,0,0,0,0,0,0,0,88,0,0,0,0,0,0,0,0,0,0,100
5232b727949d00add9cb61e153cbbcdc9e13c769,13,87,58,29,0,0,0,4,80,1424,1,4,2.635182847,6813,252,20,1828,1826,2,47832,47561,271,578,576,2,100
7658c64e1656af28b965e2a6f1a55918951d38fa,2,217,0,217,2,0,2,1,1,0,1,1,0.978925731,0,253,21,19,0,19,1009,0,1009,15,0,15,99.97445461
df073249f5e60ddb0dddcdcbae701cef33517387,4,91,84,7,0,0,0,1,16,21,3,4,1.617860885,1384,102,13,255,253,2,9025,8924,101,61,60,1,100
1c9aef04817a35c00fe841469a562f79d4fcb0a2,11,652,469,183,3,0,3,2,32,47,1,2,2.070927801,4304,254,21,415,387,28,42478,41715,763,374,348,26,99.95407226
5b61d56ad26e55340124e6e16429fc594af2a2e8,1,1,1,0,0,0,0,3,21,9,1,1,0,358,116,6,92,92,0,2463,2461,2,52,52,0,100
d727e608007d979443661aebc005f6861b441334,0,0,0,0,0,0,0,0,0,0,0,0,0,0,103,11,0,0,0,0,0,0,0,0,0,100
33bd1d4aac2422f1925c8dbad100fe0239b51ace,0,0,0,0,0,0,0,0,0,0,0,0,0,0,255,22,0,0,0,0,0,0,0,0,0,100
a63acfca77b791ed24c4db25443bd7867cf09f5d,0,0,0,0,0,0,0,0,0,0,0,0,0,0,104,12,0,0,0,0,0,0,0,0,0,100
96c824a8e3b79de608e04613bf4d3314f7c86bb5,0,0,0,0,0,0,0,0,0,0,0,0,0,0,105,13,0,0,0,0,0,0,0,0,0,100
63cacaa1c9e1d63239d28daa99e7054b8f7646f6,12,218,22,196,1,0,1,9,51,155,3,8,2.810031064,3552,80,4,673,665,8,24845,23889,956,226,222,4,99.98470636
52ee68b7a18439ebb9cdc02ffa6ee451ec052539,1,0,1,1,0,0,0,1,2,38,1,1,0,75,256,23,6,6,0,443,452,9,2,2,0,100
5364ba58b989a2c7184cae9af1360fde62813657,1,0,6,6,0,0,0,2,3,15,1,1,0,182,257,24,30,31,1,1561,1589,28,23,24,1,100
baaec8148b70880ef52b269e0a5ee7c61f6bf005,27,1456,132,1324,9,0,9,2,49,17,3,7,3.499548693,6082,345,13,1716,1521,195,49807,43026,6781,903,806,97,98.05875103
a4a94f5331993bc50bf1f2168246e91c2864141f,3,9,2,7,0,0,0,3,28,613,2,2,1.309296668,3364,117,7,603,603,0,20387,20327,60,281,281,0,100
02f2f3db70f12bf05b88d4dabe7cf9dd141b5348,2,94,98,4,0,0,0,3,23,0,1,1,0.999686892,699,346,14,187,189,2,5431,5403,28,67,67,0,100
35be8fb0bac2415b6ab913d0fee6aeea86163893,0,0,0,0,0,0,0,0,0,0,0,0,0,0,106,14,0,0,0,0,0,0,0,0,0,100
a3f0d4104c3e95a5dbc1b5e1b7497953bfa72c1c,0,0,0,0,0,0,0,0,0,0,0,0,0,0,107,15,0,0,0,0,0,0,0,0,0,100
a84c76fea7ed36607245f8757770637074ed9d31,1,19,30,11,0,0,0,1,2,2,1,1,0,297,258,25,62,62,0,2133,2298,165,24,24,0,100
637880e8d3a9a522c0a5cd52852c533762e0f18f,0,0,0,0,0,0,0,0,0,0,0,0,0,0,108,15,0,0,0,0,0,0,0,0,0,100
e6a1e909880307159f4f17a000180da67a266653,2,162,289,127,0,0,0,3,24,9,1,1,0.04104867,1327,347,12,290,294,4,10164,10313,149,200,206,6,100
c1ac969c7d951967f1faa772c65bcfa34918326e,1,1,1,0,0,0,0,9,32,5,1,1,0,429,97,2,118,118,0,2579,2575,4,52,52,0,100
69b4dc2567191115acad660a7e8febf3ffc28c33,1,1,1,0,0,0,0,3,9,131,1,1,0,297,259,23,72,72,0,2441,2441,0,23,23,0,100
cbfd6b88dd152206de1c972f82600c001354a495,1,1,1,0,0,0,0,9,33,1,1,1,0,429,98,3,118,118,0,2583,2579,4,52,52,0,100
233e258cb8aec58d5b8d4309a8a3535011b5cd37,4,177,2,175,3,0,3,3,13,5,2,2,1.5623094,251,81,4,67,46,21,2115,1479,636,26,18,8,99.96379248
d5fdddb9bf4f6bab80fed3cba467334b425326f0,4,15,18,3,0,0,0,3,59,12,2,3,1.49111485,2665,348,11,335,336,1,21537,21560,23,219,219,0,100
38cd47a76d3cb3c8b702dd92cd0408cb99d38b3d,4,11,9,2,0,0,0,3,33,6,1,1,1.356779649,4018,260,20,269,269,0,38364,38390,26,269,269,0,100
a54f47dfc8e5f58f2f592447715958ee59887666,1,3,0,3,0,0,0,2,3,413,1,1,0,61,261,21,10,10,0,227,213,14,7,7,0,100
3b327b5fbb3fe45f6f691d738b16fa567d345541,4,196,2,194,3,0,3,1,12,312,2,2,1.645962561,322,262,22,110,92,18,2929,2212,717,28,13,15,99.96381868
1b769e629c3dfb32a5ab2a43bb91fff53e7b7bdb,1,20,17,3,0,0,0,1,4,90,1,1,0,95,263,23,14,14,0,499,446,53,11,11,0,100
2d120b6363cef07c892b62b59fe3c13c1e53ee38,13,179,141,38,0,0,0,4,60,238,3,6,2.08358557,5228,349,12,789,774,15,47897,46725,1172,498,494,4,100
3ec9136da70b2e1217f935c7011ad5099f47be5b,6,23,13,10,0,0,0,2,68,328,2,5,2.296806103,1662,264,24,321,321,0,9718,9633,85,262,262,0,100
fb2a45a739d463e21e76f16ce1b0db46b929a6b1,2,34,14,20,0,0,0,8,38,166,2,2,0.249882293,473,265,25,128,125,3,3072,2979,93,40,39,1,100
61b85e4b1a6ef5c23f2b8bc87a09facc78e818a2,1,1,1,0,0,0,0,2,3,0,1,1,0,87,266,26,8,8,0,400,404,4,8,8,0,100
538f1fd084c655850d5628e0bf7d8fc5273c29fd,1,10,10,0,0,0,0,8,17,143,1,1,0,128,109,16,13,13,0,876,860,16,4,4,0,100
9af553bc8d9fc945bea6c7c259cf1f53cf7d8dab,11,390,1,389,4,0,4,1,46,115,2,4,2.756348392,4828,82,3,1271,1242,29,35537,34009,1528,282,268,14,99.31594918
2b24b76a9c0b3b05139dc8629da4cd0351b7ca29,3,338,6,332,0,0,0,3,35,128,3,3,0.404191544,1769,118,7,321,283,38,18921,15953,2968,262,246,16,100
dc061e904fc55b102cf44f4669b407a593863803,17,759,451,308,3,0,3,2,50,18,3,6,3.396831015,5268,350,13,1314,1302,12,42094,40443,1651,710,690,20,98.71235828
45acdf357a50a0290d659b538d128b465365326d,0,0,0,0,0,0,0,0,0,0,0,0,0,0,110,16,0,0,0,0,0,0,0,0,0,100
5b68196cf1b235977c9134fe57f5ef694f8eafa1,5,267,4,263,3,0,3,8,37,57,2,2,2.119180552,1402,83,4,258,237,21,11134,10096,1038,83,62,21,99.96403063
d5f14ebc02e7da759ad6b834563dd4c010c68c0b,5,95,17,78,0,0,0,9,53,83,2,3,2.088470935,6728,119,6,1460,1442,18,44456,43927,529,419,413,6,100
3dda949ce4116cef303d8e332db03fc45178fd25,7,297,8,289,4,0,4,2,9,78,2,3,2.224141967,525,84,5,148,125,23,4040,3049,991,87,67,20,99.95379165
21cece4f71975db726f570815ae9554f4093143b,6,180,38,142,0,0,0,1,36,45,2,3,2.216501912,2678,351,11,650,638,12,25046,23942,1104,293,284,9,100
a445c1c4bdce6da2493a448459a6ea890ac6273f,2,127,2,125,1,0,1,1,15,150,2,2,0.304239351,359,352,12,129,115,14,3167,2481,686,54,46,8,99.9794756
6c2e3e2d03e22f0d0f9ffc4a35aef186f1070928,8,94,82,12,0,0,0,3,27,239,2,3,2.353363188,3941,267,24,1083,1075,8,27132,26963,169,313,309,4,100
a488a122cf639eb23b37ba23670758ce6b2eef40,4,17,6,11,0,0,0,3,81,119,2,2,1.685117934,5409,120,5,1306,1304,2,34851,34756,95,417,416,1,100
ccfbe6cd3187c1a585633c32e8db9486e591a099,12,159,68,91,0,0,0,8,115,60,2,4,2.558892464,9444,121,5,2855,2835,20,67257,66823,434,857,850,7,100
222e01d2f3215aafd876380e3ac270c37252a95d,7,158,161,3,0,0,0,4,37,8,2,2,1.825330578,5332,122,6,669,665,4,49843,49753,90,394,392,2,100
06bd0d64e7538fd2d682cc0eadb4767dac8f449b,1,13,29,16,0,0,0,3,8,0,1,1,0,1569,123,7,123,123,0,16328,16469,141,123,123,0,100
c9695c2fb9dbe35e35e6d41516727772f3370bd9,3,169,8,161,1,0,1,3,13,138,1,1,1.451847956,291,142,0,40,27,13,1631,1187,444,32,20,12,99.98974043
3f6ab72c529e9a464801bea27ed28d8974f13cde,8,19,15,4,0,0,0,1,10,31,1,3,2.395998871,836,268,21,109,107,2,4195,3394,801,85,84,1,99.8563808
cc29d284b84c12d03e77ee63054c8e8aaead99cb,1,4,6,2,0,0,0,3,18,9,1,1,0,515,353,10,150,150,0,4689,4689,0,143,143,0,100
a1e2f57eb9c485235c74ae883f006e2cd05692e2,2,11,0,11,0,0,0,5,12,1477,1,1,0.945660305,177,354,11,44,43,1,997,981,16,23,22,1,100
9eb8af5a727b21f201a4930c955cdcd11a38aaaf,4,321,0,321,1,0,1,2,26,273,2,3,0.115390632,2056,269,22,414,382,32,14689,13617,1072,179,171,8,99.97948297
befee1a50b3d15abccb37988adcc0f89b0ce5f5d,1,1,1,0,0,0,0,9,49,116,1,1,0,628,270,22,134,134,0,4085,4082,3,49,49,0,100
89a7f53db0e27a1f97be650fb56574dbc6bf261a,19,679,17,662,2,0,2,2,39,153,2,13,1.172248134,3266,271,23,630,509,121,23102,20089,3013,207,174,33,99.39878712
286f708d7dac808ebc91eaabce3041d54faf46d3,1,39,38,1,0,0,0,2,9,0,1,1,0,809,272,24,186,186,0,5630,5630,0,80,80,0,99.43030366
c8fa380048cca1b3e938b691eb25b438069e916a,3,3,11,8,0,0,0,3,19,0,1,1,1.577406283,1476,273,25,237,237,0,9222,9306,84,52,52,0,100
88dcd580d8c9f9c4b1bcca19f9d74638aaa9a681,18,0,5,5,0,0,0,1,2,12,2,2,0,6039,274,26,537,461,76,40055,40864,809,251,460,209,95.09660659
b8c7ce58ad5ce11a3d1103d1c77caf22b37623f4,0,0,0,0,0,0,0,0,0,0,0,0,0,0,275,27,0,0,0,0,0,0,0,0,0,100
25d3c8247b325c2ef1b5f4b776155684469db928,0,0,0,0,0,0,0,0,0,0,0,0,0,0,276,28,0,0,0,0,0,0,0,0,0,100
92fcf33575d4cae403591dde8737e4ce53ab9bc5,1,7,7,0,0,0,0,3,27,5,1,1,0,2309,143,1,283,283,0,13704,13704,0,149,149,0,100
dc316323ba0417aa55fbf63204c1bef53b85df7b,2,145,2,143,1,0,1,1,82,2,2,2,0.475431646,2395,144,2,780,764,16,16680,16031,649,231,223,8,99.94844475
49e554ac6c0d7903af79d516a0accb8fa8ba7b59,2,245,0,245,1,0,1,1,50,1,2,2,0.299261175,628,277,28,161,134,27,5011,4085,926,56,49,7,99.95417836
7e81b8c8b507abb09cdf086b236bb34d75821146,0,0,0,0,0,0,0,0,0,0,0,0,0,0,111,9,0,0,0,0,0,0,0,0,0,100
c7e032ceb729b1302d79ff6f2d5ace429e6a2e79,0,0,0,0,0,0,0,0,0,0,0,0,0,0,112,10,0,0,0,0,0,0,0,0,0,100
f4dfdf90b5d1acf6ea6789f56153bbc321c4422a,0,0,0,0,0,0,0,0,0,0,0,0,0,0,113,11,0,0,0,0,0,0,0,0,0,100
c35c13497b03903fe2aef6a5f96e37a9642a627d,2,3,1,2,0,0,0,2,45,49,2,2,1,1264,124,8,358,356,2,8985,8951,34,108,108,0,100
0e4769e43bd84d82cf2fce85d326431c72d71e54,0,0,0,0,0,0,0,0,0,0,0,0,0,0,278,24,0,0,0,0,0,0,0,0,0,100
814341420defa42f85c224b5c9f3da01048333e4,10,215,282,67,0,0,0,9,94,622,3,4,2.306648885,8792,355,10,2319,2315,4,52217,52238,21,1023,1020,3,99.90264017
4e6a98f6344ea3e1819415709468cc1294910adc,14,371,367,4,0,0,0,2,52,468,6,8,2.423732191,3799,356,11,837,827,10,24816,24771,45,303,285,18,94.8978539
30a7da0ba2c8f946d064dec4081d75a6fe380e30,2,437,4,433,1,0,1,4,28,5,1,1,0.99107606,2309,114,8,344,283,61,15884,13704,2180,183,149,34,99.99061033
b11cdae338f33e4f6b7c83fbd3faa28303acd4b5,1,52,23,29,0,0,0,1,2,23,1,1,0,141,357,12,38,31,7,1414,977,437,13,13,0,100
7065743f1766b69e3b56b23315f930dcf6930789,0,0,0,0,0,0,0,0,0,0,0,0,0,0,115,7,0,0,0,0,0,0,0,0,0,100
21d88cadc79848e5c678069478a036fbac439ddf,5,206,3,203,3,0,3,3,70,42,2,2,1.998319276,3791,125,7,768,745,23,30659,30016,643,206,188,18,99.96715003
5b9b5d77255684e2f9771f9e88146d85e9ab913e,0,0,0,0,0,0,0,0,0,0,0,0,0,0,116,7,0,0,0,0,0,0,0,0,0,100
382bafc874466e32efb8d67c3a92373b35dde932,0,0,0,0,0,0,0,0,0,0,0,0,0,0,117,8,0,0,0,0,0,0,0,0,0,100
2615a9b42666e867c50cf5537c91e6f2f4b58908,2,27,0,27,0,0,0,1,71,21,2,2,0.605186577,1753,145,3,518,515,3,13112,12938,174,131,130,1,100
bb7048d27c55141851d7f9496f17aae407eca4e4,7,410,8,402,5,0,5,1,46,8,3,3,2.681853149,1298,279,16,426,377,49,10422,9005,1417,159,124,35,98.13267109
7c8454767ef4a36d5a57d048ced52322dab996df,4,371,371,0,0,0,0,2,3,163,1,2,1.899843214,310,280,16,38,38,0,1246,1246,0,31,31,0,100
917b49befe6098d1c3bf4647eb8dbdf5974de92d,3,294,50,244,1,0,1,1,72,53,3,3,1.044155123,1766,146,4,547,524,23,15016,13328,1688,139,132,7,99.96595827
ee5506d3d4afdd0b5bdba676a70394fe22f462ce,1,163,163,0,0,0,0,2,2,2,1,1,0,132,281,14,12,12,0,1059,1059,0,6,6,0,100
a8b6502e243042940b66081f713e3e884e322ea1,0,0,0,0,0,0,0,0,0,0,0,0,0,0,282,15,0,0,0,0,0,0,0,0,0,100
e955866480671467d41fcc8e6ccf56222552e94a,6,74,69,5,0,0,0,4,61,61,1,2,1.91064845,2944,358,8,760,756,4,23536,23561,25,510,510,0,100
2d4993954f5c191f8fb3c3e66dd3312fcd3ac565,0,0,0,0,0,0,0,0,0,0,0,0,0,0,359,9,0,0,0,0,0,0,0,0,0,100
d45a82157e87e1be8cc0a90babd7b8e75e4789d7,1,23,24,1,0,0,0,3,11,74,1,1,0,193,360,9,49,49,0,1947,1935,12,34,34,0,100
388b18650f0f4f480ce64b73165fcbe3e51f88ca,3,68,4,64,0,0,0,2,83,101,2,2,0.431274123,2574,147,5,789,786,3,17340,16891,449,237,236,1,99.87331904
049c91707b870ef184f40e25c8295e374ddf36ed,1,1,0,1,0,0,0,3,3,465,1,1,0,57,148,6,10,10,0,176,169,7,10,10,0,100
9a4406038e22e14cd9a5b6ac96bb4cd2244dcb6f,4,62,2,60,0,0,0,9,54,63,2,2,1.540566949,1811,126,7,479,474,5,11291,11013,278,139,134,5,100
6303e9a753e205f16612bcd92ee7685446d849c9,2,8,5,3,0,0,0,6,12,72,1,1,0.995727452,1099,24,0,282,282,0,7027,7019,8,184,184,0,100
964ab657ce7d231ffdf74c96dc429933b0f16edc,23,1016,93,923,14,0,14,9,70,37,3,7,4.18936139,7995,283,16,2215,2128,87,54731,52587,2144,778,719,59,99.83914209
8a66927c2d37d91c9e55cfadc252a5c5c9eeec76,3,3,1,2,0,0,0,8,62,0,1,3,1.5,2138,284,17,571,571,0,14092,14092,0,163,163,0,100
ec43fccfff61d60efb19ea779a0a0f252a65b5a4,2,3,10,7,0,0,0,7,30,41,1,1,0.995727452,1757,85,2,464,463,1,11498,11478,20,94,94,0,100
f61ff608429d9705eca867b78dc881fb5890a956,0,0,0,0,0,0,0,0,0,0,0,0,0,0,285,18,0,0,0,0,0,0,0,0,0,100
e19c75a9c3e067ff75e6bd7444d8e18785418036,5,148,1,147,1,0,1,1,73,73,3,4,1.549167811,1917,127,8,565,546,19,14565,13912,653,153,145,8,99.99026669
4083018e380a5c8a08323a43dc49fa8dda3635e0,1,8,2,6,0,0,0,13,74,104,1,1,0,727,128,8,171,168,3,5035,4972,63,41,41,0,100
aedc261abc6fddb00f815e5c68906ef7b2e255fc,2,168,3,165,0,0,0,3,54,35,1,2,0.899743759,746,86,1,168,143,25,5725,4954,771,56,50,6,100
f68c531a5ba53768e00daa7fad5749f4ad31da6b,12,312,78,234,1,0,1,4,84,27,3,4,2.354790881,7224,361,8,1675,1653,22,57976,56559,1417,778,767,11,99.97567502
9177e9369af17d0ad68a95401a23db6555eb9077,1,8,14,6,0,0,0,1,2,2,1,1,0,77,129,9,3,4,1,341,377,36,2,2,0,100
f6ae418aa546bf481bf5079ade672c0aa41bf188,2,244,0,244,1,0,1,1,18,294,2,2,0.880286629,713,362,9,318,282,36,6449,5021,1428,39,27,12,99.99027332
f06d862ec60cd1ab679152e0c7c6588c3b6282e1,5,167,1,166,4,0,4,1,63,0,2,2,2.075458095,1773,286,18,584,571,13,12134,11741,393,175,163,12,99.95625334
39da6319dd33c1b22c9ff3ea4f228f5d7c7050da,1,0,11,11,0,0,0,1,2,2,1,1,0,138,363,10,12,12,0,1069,1069,0,10,10,0,100
6305be480bc3a82149f2c25b09a1980224e36e94,2,41,1,40,0,0,0,1,6,25,2,2,0.998363673,418,364,11,82,73,9,4251,3948,303,49,47,2,100
12015d3f1d0eb3210d41bf90ef16dd15f0e72eca,1,2,2,0,0,0,0,8,13,7,1,1,0,698,365,12,173,173,0,4427,4427,0,133,133,0,100
149dbef93b99ab50350f352a4864054c38ec863d,1,1,1,0,0,0,0,9,48,46,1,1,0,1678,366,13,450,450,0,13554,13554,0,80,80,0,100
250186fbcbf7b82437ae4e912cdcd92bab8640b8,2,83,1,82,1,0,1,1,29,97,2,2,0.276195428,980,367,14,349,344,5,7290,7091,199,76,72,4,99.99028372
78e93abb515193f3b1abd00ee9074186527fb110,3,21,1,20,0,0,0,4,49,167,1,2,0.831543549,4247,130,6,780,774,6,28924,28778,146,243,243,0,100
991cdcae7da3904a932bf9c5c453a6de0685e8c9,21,1058,340,718,3,0,3,9,95,130,3,5,3.244929858,7426,287,10,2038,1949,89,45700,43256,2444,812,743,69,99.92229615
d02f0688aece4914a1180be2d659f8ccb821f715,1,78,0,78,1,0,1,1,1,0,1,1,0,0,288,11,8,0,8,606,0,606,4,0,4,99.89795918
fdcbdccae05b5006770f9965b45cab5526c7655d,2,0,8,8,0,0,0,7,96,0,1,1,1,4961,289,12,1424,1424,0,28627,28643,16,464,464,0,100
fe44661dc2614e44953e0d9aaba56e89954ccab5,4,271,0,271,4,0,4,1,1,0,1,1,1.870195122,0,87,2,30,0,30,820,0,820,21,0,21,99.95625334
0795778d3d9f1b3b8b3dd7036fd98df6970a23b3,6,219,42,177,0,0,0,4,30,16,2,2,1.333546486,2298,368,13,611,568,43,19169,18154,1015,326,296,30,100
f214d9f3971bd2f0b5c25574664c57841025dd7b,5,208,5,203,2,0,2,2,66,16,2,3,1.716413812,1538,369,14,377,367,10,11181,9983,1198,254,246,8,96.2496767
f13af4a400bfb678948ed7c37d45ac694f161de2,1,31,8,23,0,0,0,1,2,8,1,1,0,92,88,3,14,14,0,666,502,164,5,5,0,99.99612613
e6ccbb0c0d88be3f36ea97f1f9ec9debcc5fc4e5,7,482,3,479,5,0,5,7,56,57,2,2,2.276481474,2655,89,4,872,824,48,18213,16730,1483,240,204,36,99.95740561
69cf52f68d306838a40ffbadab9b3444be5f7f4a,4,221,10,211,2,0,2,1,27,6,2,2,1.834609939,748,290,11,215,185,30,6298,5360,938,62,43,19,99.98065614
e39a9a09e006697ef6182939c9885071e5e8d476,20,993,299,694,1,0,1,4,31,40,2,2,3.046465576,4515,370,12,1311,1162,149,40812,36875,3937,727,644,83,99.81023933
b32bf1b73002fe2ebead452099af311ab1b93367,1,0,1,1,0,0,0,8,53,42,1,1,0,717,291,12,205,205,0,4943,4943,0,64,64,0,100
82cda8b8d5838fd1a431afda464dc0cb3518eb9f,1,0,3,3,0,0,0,1,3,0,1,1,0,246,292,13,48,48,0,1874,1874,0,24,24,0,100
a291185ad83f3961c5d27b597404461ba00e4030,1,61,0,61,1,0,1,1,1,0,1,1,0,0,371,13,0,0,0,160,0,160,0,0,0,99.98836578
8a6a39dec73e9f380371791d502aaf3a7ea9bc5c,0,0,0,0,0,0,0,0,0,0,0,0,0,0,90,5,0,0,0,0,0,0,0,0,0,100
8c929e6e10fe6c846f0dd8b862b24d5df2c3c887,1,5,0,5,0,0,0,2,7,12,1,1,0,61,372,14,11,9,2,347,317,30,7,6,1,100
ac939f7b5f23e8ef73e37c8baa1b0b23c5c4edce,3,61,0,61,0,0,0,3,19,164,2,2,1.35250743,1149,131,6,251,244,7,8684,8409,275,118,115,3,100
0036dc5bfbaec2a4bc5ededa93301c4353d26838,7,60,30,30,0,0,0,4,62,43,2,4,2.473761008,3928,373,15,991,981,10,32158,31976,182,639,636,3,100
0bd820487556d583d28d61e913703d0b11cda91e,3,8,4,4,0,0,0,1,8,51,1,3,1.584962501,787,374,16,292,291,1,6310,6295,15,104,103,1,100
3c3c8082d31bca141979c0908172580ebe6c355a,0,0,0,0,0,0,0,0,0,0,0,0,0,0,375,17,0,0,0,0,0,0,0,0,0,100
1f347633aa89cf78f0af5d08ea6927e75f8cf826,1,0,2,2,0,0,0,2,4,56,1,1,0,92,91,6,13,13,0,442,451,9,2,2,0,100
e1404bdbbeed9c5fe1976f4647ecd97e6deb8236,0,0,0,0,0,0,0,0,0,0,0,0,0,0,118,2,0,0,0,0,0,0,0,0,0,100
9d69e59a7ce8ee1d43c22592ea94dfa61cd29487,0,0,0,0,0,0,0,0,0,0,0,0,0,0,119,3,0,0,0,0,0,0,0,0,0,100
817696298d8a20044076a0b19dd61531d744c2bd,3,75,5,70,1,0,1,4,22,0,2,2,0.802062655,658,376,18,191,188,3,6222,5847,375,165,164,1,99.93407531
1908a911803951e2a3bb27f203ee2bd077092ff1,0,0,0,0,0,0,0,0,0,0,0,0,0,0,120,4,0,0,0,0,0,0,0,0,0,100
5d6581bf7f75ddf7c77e37a087cf6a63cc757e94,2,17,1,16,0,0,0,4,46,38,2,2,0.918295834,3425,149,4,593,591,2,21744,21628,116,226,225,1,100
e01390051bc617047b7153868289c11ccb6f4cba,22,422,293,129,1,0,1,4,39,5,2,2,2.94404273,7873,377,19,1529,1534,5,71856,71368,488,973,964,9,99.79812097
301fc200d184da687730336c6da1eb6608bf0d44,1,6,8,2,0,0,0,4,6,5,1,1,0,297,150,5,66,65,1,2247,2277,30,26,26,0,100
c880fdeb7f49d70236357c662480bb71349fa7ff,2,2,1,1,0,0,0,4,51,35,2,2,0.918295834,1972,151,6,575,574,1,13478,13463,15,190,190,0,100
c35277c156533287a6e20a0401cfc856f27cf36f,0,0,0,0,0,0,0,0,0,0,0,0,0,0,92,7,0,0,0,0,0,0,0,0,0,100
701221576dc7ff77a99ea8df5c8975ac866f92c0,1,14,0,14,0,0,0,10,50,211,1,1,0,1427,132,6,481,477,4,9086,8971,115,167,167,0,100
d2cc5e03607fc70d84068cc4705e98997e760ebf,0,0,0,0,0,0,0,0,0,0,0,0,0,0,133,7,0,0,0,0,0,0,0,0,0,100
7bcdee7a609acbdf150ba5734f0400fed0905543,4,4,4,0,0,0,0,3,4,496,1,1,2,174,134,8,18,18,0,482,498,16,18,18,0,100
35ef9efaecb177d32d24a064bcbd40ae0578f6d5,1,15,0,15,0,0,0,3,14,65,1,1,0,241,135,9,10,9,1,1015,934,81,5,5,0,100
f246cb19b4e883eca5316578acdfb137470d0eb1,2,7,7,0,0,0,0,3,11,195,1,2,0.591672779,786,136,10,79,79,0,5724,5724,0,44,44,0,100
c39ec8a6deaa00473d24624b56a96535730df340,8,8,8,0,0,0,0,3,12,253,1,3,3,1351,137,11,209,209,0,8500,8524,24,124,124,0,100
f45899eee858a5d7ab93096252ece5f509018095,2,5,5,0,0,0,0,2,4,624,1,1,0.721928095,239,138,12,29,29,0,1444,1437,7,21,21,0,100
e33f83901f65bee3a6cf166f00a8939a010c33ac,16,70,42,28,0,0,0,2,5,331,1,2,3.916794316,2021,139,13,160,146,14,12434,11920,514,84,84,0,100
45f79b59afd5f6becc77ec00be47f30de99316a7,1,1,1,0,0,0,0,4,4,504,1,1,0,165,140,14,11,11,0,1243,1243,0,7,7,0,100
702a9c66162c1a3e48f90a5c225c56ac71c2f9e8,5,38,10,28,0,0,0,4,8,411,1,2,1.84724449,603,141,13,93,85,8,4025,3862,163,45,44,1,100
435f66e27378cbb278fb64022a4e7158df521a5e,1,41,0,41,0,0,0,3,8,330,1,1,0,340,142,14,52,43,9,3241,3074,167,6,5,1,100
a875ef52b1a9262faadd8c43ccf3f102fcced68e,1,34,39,5,0,0,0,4,9,1,1,1,0,369,121,3,52,52,0,3222,3241,19,5,6,1,100
2691db6e0b646eb674c7a60e778b3f1467cf0fd1,2,49,28,21,0,0,0,5,12,166,1,2,0.591672779,682,122,4,89,87,2,5435,5364,71,24,24,0,100
ed40459a2a4f9bac6e449b5697c995d465d854a2,4,32,1,31,0,0,0,13,116,239,1,3,1.796989078,6168,93,6,1968,1961,7,44761,44628,133,410,408,2,100
94a0bc3781da7a432ce7c83a8ba05ecbf3235e20,4,229,1,228,3,0,3,3,3,19,1,1,1.944208194,70,143,13,21,2,19,1011,346,665,19,2,17,99.96891635
c28461ffddd7c60a862bb76d5cd084c1dd5506e7,0,0,0,0,0,0,0,0,0,0,0,0,0,0,378,15,0,0,0,0,0,0,0,0,0,100
a8640cc5d2b3e84f5cb0436045f15db30bfb4b93,23,231,242,11,0,0,0,2,47,415,3,6,4.079333544,9346,379,16,2377,2366,11,58220,57759,461,1463,1460,3,100
a543403d2a283b4c6d30f4b0271308cd810ac0f2,1,1,1,0,0,0,0,4,15,17,1,1,0,249,123,5,10,10,0,1015,1015,0,5,5,0,100
5113654485807a7884796562b9c62d56a2ec7999,10,95,134,39,0,0,0,5,31,119,2,8,2.785484605,5227,124,6,700,709,9,32992,32867,125,274,274,0,100
8e9696522573e9892b4b8aa56d6c311f639847ee,15,151,430,279,0,0,0,2,40,37,2,4,2.591255689,5499,380,15,905,925,20,47078,48340,1262,705,716,11,99.98445998
0d3179cef9e7efb820cafda6a94ca141edcf32f5,2,19,18,1,0,0,0,7,22,0,1,2,0.974024864,488,125,7,72,73,1,3989,3975,14,20,19,1,100
b5fabd88dd4c4f49b33b312fab9eece38418c8b6,4,21,27,6,0,0,0,2,3,443,1,1,1.930406631,503,94,7,66,67,1,2580,2592,12,37,37,0,100
fa49080f8f8e946fc9fc3c64816c859ce2b6bcd6,2,2,14,12,0,0,0,7,23,0,1,2,0.543564443,490,126,8,69,72,3,3928,3989,61,19,20,1,100
dac8af35b4ade56f49747380f1de3487bd164c5b,3,153,3,150,2,0,2,1,97,13,2,2,1.445340738,3722,89,0,1094,1081,13,23354,22826,528,294,286,8,99.98057574
eb5baa42a27e626373134486869b1ab873ac82cb,6,70,20,50,0,0,0,10,55,163,2,3,2.304995503,3017,144,14,889,884,5,19134,19077,57,321,316,5,99.94566272
df860912a7ddda0ea5bed5167b3477ff99c48e81,5,182,5,177,1,0,1,1,41,9,2,3,1.727511082,1198,381,13,153,128,25,12460,11642,818,111,104,7,99.8412637
b573799fc3176ef578951fd8e0e8eced0ee82328,9,26,22,4,0,0,0,3,33,24,2,3,2.871653522,3911,382,14,1088,1087,1,33684,33661,23,504,503,1,100
ba5692da52f0daf51b14ca895ccbc70b334c5874,1,4,4,0,0,0,0,9,40,134,1,1,0,223,99,0,36,36,0,1363,1362,1,14,14,0,100
c534d29cb7b6163e1a7a8054ff7774f48a527a76,1,4,10,6,0,0,0,10,48,5,1,1,0,1173,145,14,350,350,0,8611,8635,24,96,96,0,100
677d34049c0ef5330680a8240f148065a6fda85d,20,279,270,9,0,0,0,4,67,8,1,2,2.717432965,6113,383,15,1628,1628,0,47116,47693,577,958,958,0,97.93739384
38f31390a9cae34e9529eca252bfb0218b84ae79,1,1,1,0,0,0,0,3,5,518,1,1,0,191,384,16,33,33,0,1403,1403,0,14,14,0,100
dc5c7f487af26e5eaafba14db062a1450ea2408c,1,9,11,2,0,0,0,2,4,5,1,1,0,127,385,16,24,24,0,992,961,31,9,9,0,100
0d24829c8c2c1b7380587e67c21c87c83817afd7,1,13,17,4,0,0,0,3,4,116,1,1,0,240,386,17,81,81,0,1464,1485,21,12,12,0,100
32c6ca132ce4daa64f736d2ab50aa5267bc8048a,3,192,0,192,3,0,3,1,1,0,1,1,1.581739328,0,127,9,14,0,14,677,0,677,10,0,10,99.97032012
46734cf443c69afc0221c427a349aa251f9a1969,3,64,68,4,0,0,0,1,2,0,1,1,1.46101656,161,128,10,14,14,0,663,677,14,10,10,0,100
15b5ec20ddf010f4a35bc5e05c3ddd942542b9b0,2,72,17,55,0,0,0,2,2,96,1,1,0.959457916,137,146,15,21,13,8,1037,690,347,12,9,3,100
1e77f6a3e1492e289ce99b071376cdd3e90372cd,2,6,5,1,0,0,0,10,56,2,2,2,0.684038436,788,147,16,176,176,0,4815,4812,3,77,77,0,100
5120b0e629a208ae7dc9f7f049e342ef15c2ea7c,3,13,1,12,0,0,0,3,56,198,1,3,1.378783493,4182,387,17,1323,1320,3,27959,27915,44,582,580,2,100
ec90648e2bdb6c8877e2c9accd8d9a658075f088,1,5,1,4,0,0,0,3,15,198,1,1,0,265,388,18,68,67,1,2117,2081,36,21,21,0,100
81065fea3c5601949690be85b52b01d34fcb3aa0,1,4,0,4,0,0,0,3,9,2643,1,1,0,91,389,19,24,23,1,469,459,10,11,10,1,100
6b96b82d31027452ceb1bfdc1e6a6fa42f7ca7f9,1,10,0,10,0,0,0,4,8,2643,1,1,0,40,390,20,0,0,0,194,188,6,0,0,0,100
1aab5c3c6cfa9876161ff4b7e307012c7ee0b406,1,6,1,5,0,0,0,4,9,2643,1,1,0,113,148,17,19,18,1,844,791,53,6,6,0,100
60e55574c8ae2ee4f915b0197a3e5a4cab72dd1f,1,19,1,18,0,0,0,4,5,519,1,1,0,49,149,18,4,3,1,351,242,109,3,3,0,100
fb34e0a0ec80346278678c39d2549d6752c119fd,0,0,0,0,0,0,0,0,0,0,0,0,0,0,391,21,0,0,0,0,0,0,0,0,0,100
d7b4296c8f53852894c3681a7f77afe98b56bd55,2,11,7,4,0,0,0,2,3,124,1,1,0.503258335,247,392,22,24,24,0,1886,1882,4,17,17,0,100
558446dfe975d67e530e8ec35df976d605d35e0a,1,6,4,2,0,0,0,4,10,1,1,1,0,117,150,19,19,19,0,846,844,2,6,6,0,100
e9b5c53fd00be984157e131b94a7d5efee720a3c,7,54,29,25,0,0,0,3,10,399,1,2,2.351355438,1719,26,0,259,256,3,10278,10133,145,125,124,1,100
b889ccb83462af0a6524c22a0a6e2e065a46d124,1,21,3,18,0,0,0,2,2,88,1,1,0,186,129,11,33,25,8,974,896,78,7,7,0,98.40382399
ee9210be92ff0279aeed80460ead1f2a279c6f6e,4,197,1,196,3,0,3,1,50,2,2,2,1.636748398,1174,130,12,362,352,10,9330,8643,687,106,97,9,99.9699274
416b8d3ccb65f8ecf612513489ed78e5cebe8641,4,119,0,119,1,0,1,1,51,0,2,2,1.186358666,1282,131,13,368,359,9,9680,9059,621,106,104,2,99.98282303
b8dde5761fd5ce9452db8422f3a83dc7cb222463,3,210,0,210,3,0,3,1,1,0,1,1,1.573927122,0,132,14,16,0,16,650,0,650,16,0,16,99.95706496
492a19573c98f9e933c3e5c66d191ef92c371c86,3,348,167,181,2,0,2,4,5,8,1,1,1.375911472,168,133,15,27,18,9,1509,1169,340,16,10,6,99.91825144
bda013675836889b321f4e60c557a716cfe4ad31,0,0,0,0,0,0,0,0,0,0,0,0,0,0,151,20,0,0,0,0,0,0,0,0,0,100
643f4d130f3c5426194ee7775685e85977584f79,1,7,0,7,0,0,0,5,32,13,1,1,0,2552,393,23,325,324,1,15338,15248,90,159,159,0,100
d062b254af87515597cd53a853efb6afc8324eca,1,4,2,2,0,0,0,8,41,83,1,1,0,249,100,1,56,53,3,1560,1530,30,32,32,0,100
c353d0541e8b246dbd1b584d5228603506216880,1,1,1,0,0,0,0,2,2,2,1,1,0,173,152,21,19,19,0,1169,1169,0,10,10,0,100
a9ea5c1817ff24274446213e6969f97eae0e7373,1,3,3,0,0,0,0,2,3,0,1,1,0,173,153,22,19,19,0,1169,1169,0,10,10,0,100
3146afb1bc096750ae2c8a66e2f5346bceaffde8,2,7,1,6,0,0,0,1,10,56,2,2,0.811278124,468,394,24,88,86,2,3834,3775,59,55,54,1,100
eded0dd8facefda2af83567ecdae12f4c09eb53f,1,5,2,3,0,0,0,6,28,83,1,1,0,350,0,0,86,86,0,2497,2448,49,24,24,0,100
8fc1404dadaff7478ac724b540c783ccf2dd5ac8,5,15,14,1,0,0,0,4,13,220,1,2,1.986497245,1077,95,4,153,153,0,7074,7074,0,91,91,0,100
eb5bccdd493119854909f333bf16301488c93897,6,362,0,362,6,0,6,1,1,0,1,1,2.511331866,0,1,1,23,0,23,1112,0,1112,18,0,18,99.96982629
72f2cb8516ee11accbb4cda1ed7c6d8479b79ee2,10,226,7,219,2,0,2,10,57,88,4,5,2.802023777,2799,154,22,729,703,26,20478,19768,710,232,216,16,99.97845849
8c1e1a7ea57a3ebb21757762696ef9592022c71d,10,286,14,272,2,0,2,10,58,6,4,5,2.41271034,2774,155,23,800,771,29,19136,18034,1102,258,240,18,99.98277347
a94bb8ee060371b1c6e60f47eba2eff8ab0e5dc9,3,3,3,0,0,0,0,1,1,0,1,1,1.584962501,157,134,13,16,6,10,650,951,301,16,6,10,99.94832931
0c3c6c3ba4d138aea4287e124539375b2a026549,0,0,0,0,0,0,0,0,0,0,0,0,0,0,135,14,0,0,0,0,0,0,0,0,0,100
1c4a61758ace44c766491f32193ad5d4612a958f,1,1,1,0,0,0,0,9,52,89,1,1,0,590,293,0,131,131,0,3867,3871,4,48,48,0,100
add24283b4e0bf63b3ee0df65490d1e361edc410,1,10,0,10,0,0,0,13,40,23,1,1,0,942,96,4,261,259,2,7012,6945,67,48,47,1,100
cbe18c2f74e096ddf8930632c491d7ae5aceccfa,10,676,0,676,10,0,10,1,1,0,1,1,3.203714497,0,136,15,77,0,77,2101,0,2101,48,0,48,99.73677397
daadd62bd2b1b740e24787e4bf85bf48f4f21fa2,1,10,4,6,0,0,0,1,2,0,1,1,0,49,137,16,3,2,1,352,317,35,2,2,0,99.99135322
7deb8217359235f9de58516dd7e4ab00d6abbf07,0,0,0,0,0,0,0,0,0,0,0,0,0,0,138,17,0,0,0,0,0,0,0,0,0,100
1318f98bc4c146bfdeba13b95c297a4f6015709f,0,0,0,0,0,0,0,0,0,0,0,0,0,0,294,1,0,0,0,0,0,0,0,0,0,100
846d1ef82ac6dbb253a19db1007a684c69e3416f,0,0,0,0,0,0,0,0,0,0,0,0,0,0,295,2,0,0,0,0,0,0,0,0,0,100
ac23a55b680440c84a1101ef95856e3d0aab337c,4,425,0,425,4,0,4,1,1,0,1,1,1.983061614,0,139,18,43,0,43,1808,0,1808,25,0,25,99.07370997
e5f7d97695681a8efb23f0cb67975fe25c5fd1c1,0,0,0,0,0,0,0,0,0,0,0,0,0,0,140,19,0,0,0,0,0,0,0,0,0,100
95a2c8f680e2b09ad9498f0d866f6f1f1afea62d,1,20,0,20,0,0,0,2,3,48,1,1,0,128,97,4,26,24,2,1112,993,119,10,9,1,99.99558265
1c0b9849f185f3a5f14c4a42f4b55379af331219,4,0,8,8,0,0,0,1,3,60,1,1,1.548794941,286,296,3,39,39,0,1518,1598,80,29,29,0,99.96464245
3f43e3dd0e2c17b00e467dd2841b8a9c3bb0c8f1,10,62,11,51,0,0,0,3,117,976,2,3,2.993614798,4916,152,0,1355,1339,16,34768,34470,298,426,420,6,99.92915025
946781881847f4dee118aa286f3dd788781913d9,6,48,10,38,0,0,0,3,118,373,2,3,2.09168838,3879,141,20,1119,1114,5,27774,27678,96,283,278,5,100
cf7f69bbd57fe1f40f9c7341c10788a591278777,20,690,193,497,4,0,4,10,66,23,4,6,3.46400159,7266,156,20,2159,2096,63,52517,50291,2226,605,579,26,99.94238355
5c23058b0ea70d802a55cdb3f94722138d75910b,3,16,9,7,0,0,0,1,50,27,1,2,1.439627536,1791,157,16,471,469,2,14055,13992,63,92,92,0,100
abbda7df8eb2a7108a2276c34bb4d8ad812b8349,1,4,2,2,0,0,0,10,68,29,1,1,0,1331,142,21,349,346,3,8568,8538,30,230,230,0,100
fdd330a116c55a89b1320f1c5e0c7dec242a0ec7,1,2,3,1,0,0,0,9,17,585,1,1,0,690,2,2,209,209,0,4872,4882,10,85,85,0,100
e53f8514f463fcc943bb8152f9f821419a8fa7dd,4,4,4,0,0,0,0,2,5,567,1,3,2,342,153,1,58,58,0,1493,1493,0,33,33,0,100
828e08ee0e921f61df972f5b190b3bbf67c13b42,1,239,0,239,1,0,1,1,1,0,1,1,0,0,143,22,27,0,27,1290,0,1290,4,0,4,99.96901284
19da9769b0b11017a169f84125813ecae51a3458,4,55,6,49,0,0,0,3,16,141,2,4,1.774105917,1479,158,17,441,433,8,10460,10228,232,122,120,2,100
437897789151a863d3db32d8c4692100bcb12a60,5,840,618,222,0,0,0,9,71,210,2,4,0.571954936,4323,3,3,1197,1173,24,30178,29038,1140,493,486,7,99.93372802
f1af41c44c631bd63da734386cdb329faf4ad9e6,4,40,64,24,0,0,0,1,72,145,2,3,1.458224658,1653,297,4,323,326,3,9982,9994,12,269,272,3,99.98234697
01c26a9e21a80fd6339d0c2a406f11397f4e3d20,1,41,5,36,0,0,0,6,33,23,1,1,0,2559,98,5,327,325,2,15514,15338,176,160,159,1,99.96030171
6f1b9627fe928732b637e409c95669fd0cc94746,2,88,31,57,0,0,0,3,38,6,2,2,0.355488678,1181,159,16,256,246,10,9729,9382,347,58,55,3,100
fbb7e1208aaa9c9462a00766e26e5147e4ab44f1,1,13,2,11,0,0,0,9,57,67,1,1,0,1579,99,6,454,452,2,9852,9776,76,116,115,1,100
6485137930cbfa27de554d5a1e6d75c8eff5529e,2,4,2,2,0,0,0,10,69,62,2,2,0.918295834,1550,101,2,355,353,2,10299,10287,12,234,234,0,100
2eeca2a8ac545585a51404c94e59c63559395f05,1,5,3,2,0,0,0,10,63,64,1,1,0,687,144,21,170,167,3,4809,4779,30,86,86,0,100
85a609aa5d3ac8a83048e121526f3519d7c8bdfc,4,224,0,224,4,0,4,1,1,0,1,1,1.943674497,0,145,22,16,0,16,684,0,684,16,0,16,99.9603629
c5954aa4a5bf0bd0279fbbe689f7808d913e9055,1,1,1,0,0,0,0,1,2,0,1,1,0,41,146,23,1,1,0,178,178,0,1,1,0,100
5d3fd3a726aa8f8fb32998c83ed649da068d4ed3,1,19,1,18,0,0,0,4,5,376,1,1,0,296,100,6,20,18,2,2191,2099,92,17,17,0,99.97800167
2a98f2b93d8d6de33cc3df514644adba6b0fafd3,1,13,0,13,0,0,0,3,3,2679,1,1,0,162,101,7,16,15,1,1465,1393,72,7,7,0,100
65ff86ce24da411ddb7d910730d8df97a93eb808,1,1,0,1,0,0,0,2,2,1,1,1,0,44,160,16,5,5,0,136,129,7,5,5,0,100
067a6f0ffb8d51201614adace89568473ad4147c,8,429,67,362,2,0,2,1,39,247,2,3,2.456291705,2290,161,17,547,484,63,19854,17949,1905,148,130,18,99.97800941
d8eadfe600d7f05d99ecd30d3604d18f96d8b114,1,1,1,0,0,0,0,1,2,2,1,1,0,64,147,21,9,9,0,238,244,6,9,9,0,100
7d3497781c1a9660863e9eb10ada9c2ae107360e,1,3,6,3,0,0,0,4,11,0,1,1,0,362,162,18,85,86,1,2851,2863,12,20,20,0,100
fc69f929e924622928c899ce7c65e1de85ce4840,0,0,0,0,0,0,0,0,0,0,0,0,0,0,154,2,0,0,0,0,0,0,0,0,0,100
ef54e75107ffb98f144f86937a292330a11fb823,6,222,12,210,2,0,2,3,40,0,2,2,2.122655381,1966,163,18,446,412,34,16258,15308,950,122,106,16,99.97801908
a6af0f35e20d1161bf1039d545aafbf50eb3117c,1,22,16,6,0,0,0,1,3,5,1,1,0,41,148,21,2,1,1,202,178,24,2,1,1,100
eb8abb81fc295e47521262bf7c297fda3540c4b5,1,1,1,0,0,0,0,1,4,0,1,1,0,45,149,22,2,2,0,202,202,0,2,2,0,100
9c3a7117a83a2e0035cb7d73a14aa42663187a4b,3,75,14,61,2,0,2,1,67,6,1,3,1.508513647,1453,4,4,474,470,4,10942,10671,271,77,76,1,97.41778654
22391c91333a27e49dcbe9789bc7e456d8930161,0,0,0,0,0,0,0,0,0,0,0,0,0,0,102,7,0,0,0,0,0,0,0,0,0,100
cafbd559d2b56a9c756e0a5bf9e7a3e643403c25,20,1411,53,1358,12,0,12,1,6,114,1,2,3.763583432,710,103,8,188,70,118,8304,3577,4727,172,65,107,99.23617041
dc3c2c43ed849779f7edeaabce67f1cb1c60d735,1,1,1,0,0,0,0,1,5,0,1,1,0,45,150,21,2,2,0,202,202,0,2,2,0,100
5f03f77b5c07befba4c4545d1ec91023ef76e3b5,5,19,7,12,0,0,0,1,3,0,1,2,2.145110414,457,104,9,37,37,0,2499,2446,53,31,31,0,100
28573bfcfd38c7f08c15094d54f3769de7f60ea5,5,12,135,123,0,0,0,7,24,9,1,2,0.927778575,537,105,10,49,57,8,2522,3086,564,33,40,7,100
9f29552e858bceac4e69e11547db9118d228461d,9,492,79,413,2,0,2,1,13,154,2,3,2.377614404,2025,164,13,479,403,76,17790,15307,2483,150,126,24,99.97653353
9eeb4b2fbd89570410fcfc165640852353b6c6d7,1,61,0,61,0,0,0,3,12,0,1,1,0,507,165,14,28,27,1,4260,3843,417,17,16,1,100
bb3e1a5185dade67ff4e7e1ab6a3a3a6255bf3c4,2,160,0,160,2,0,2,1,1,0,1,1,0.97779457,0,166,15,25,0,25,557,0,557,15,0,15,99.97654454
363f7f6e3f16bf0693fce192683685894946e252,1,0,8,8,0,0,0,13,41,29,1,1,0,951,27,0,259,261,2,6966,7012,46,47,48,1,100
174f2af0ded2b32e949724b0027263a99d484960,2,158,158,0,0,0,0,2,2,6,1,1,0.962220474,124,298,5,24,24,0,534,534,0,14,14,0,100
562b4942df21464b85b1a040019dde5936c06f0e,11,1257,1257,0,0,0,0,2,4,0,1,1,3.326321376,876,299,6,105,105,0,4077,4077,0,100,100,0,100
450f8352f856cd49bbf53525502db99821654441,8,42,51,9,0,0,0,4,5,451,1,1,2.737497342,1431,28,1,111,111,0,9370,9251,119,75,75,0,99.98593003
9f24d10ecdd5c9286f22e363852e84f116d0f994,15,195,218,23,0,0,0,2,28,613,2,5,2.850173284,3087,395,2,595,595,0,21319,21133,186,254,254,0,99.98124267
9d37d74a105f2a97061e127791555495ccdc055b,0,0,0,0,0,0,0,0,0,0,0,0,0,0,155,3,0,0,0,0,0,0,0,0,0,100
baf800f3b02d6abbd6c3849191511ffdd6b9e0d1,11,131,190,59,0,0,0,9,54,650,5,8,2.460119555,2304,396,2,369,367,2,14948,15114,166,148,148,0,100
7d6ccb108c5fdd31bf1a89441927ce8ff756a840,1,38,49,11,0,0,0,5,19,99,1,1,0,759,397,3,306,306,0,5507,5451,56,31,31,0,100
c8d1003612cd9845c5e6df4f2c27c10d12c02dae,3,139,115,24,0,0,0,8,41,255,1,1,1.507784737,1343,167,15,343,336,7,10426,10284,142,103,101,2,100
c06481b4527a8e6903ebe62df9c040171435fbf5,4,28,19,9,0,0,0,5,119,383,2,2,0.737258645,3678,5,4,1052,1052,0,26026,26016,10,262,261,1,100
529bd3a876723a7af1f09aeb2ddf082708c2c841,4,20,11,9,0,0,0,3,36,56,1,1,1.533107672,1200,398,3,342,339,3,9529,9472,57,135,133,2,100
02471ca7e75ee9360f249f67e255cd18e45c943f,4,58,69,11,0,0,0,2,55,119,2,4,1.259567052,899,151,17,178,180,2,5350,5330,20,67,66,1,99.93429081
a56643889f0837b549268eb3b98d9d6491eeed1b,0,0,0,0,0,0,0,0,0,0,0,0,0,0,152,18,0,0,0,0,0,0,0,0,0,100
794e26d721bd6a34f48b0a3646ece9b7de8cf427,0,0,0,0,0,0,0,0,0,0,0,0,0,0,153,19,0,0,0,0,0,0,0,0,0,100
797de03a1097401bd08b3befa0fe7c5bd506b6ed,0,0,0,0,0,0,0,0,0,0,0,0,0,0,154,15,0,0,0,0,0,0,0,0,0,100
7f833b7b76767e57b52b44c594c4b3b758e9300f,0,0,0,0,0,0,0,0,0,0,0,0,0,0,300,5,0,0,0,0,0,0,0,0,0,100
6119ff76b9b1bed7baa42f554fc73da4ba54176b,0,0,0,0,0,0,0,0,0,0,0,0,0,0,301,5,0,0,0,0,0,0,0,0,0,100
99844b6b1f3d13c07bdb6223d2edc2f47320aad2,3,42,10,32,0,0,0,5,73,81,2,2,1.273650919,2418,399,4,625,622,3,15523,15486,37,362,360,2,100
c2a723816bddb0730c3f7c44e6d15fa1fd4189d1,24,273,262,11,0,0,0,2,51,18,2,4,3.504382546,7635,168,12,1894,1892,2,55562,55458,104,572,568,4,100
30bb14da07e162e0e8f7959f6ab83dfba46ae86f,0,0,0,0,0,0,0,0,0,0,0,0,0,0,155,14,0,0,0,0,0,0,0,0,0,100
fa02d2a5faea007b48a3158808de79c584d03574,92,1746,0,1746,0,0,0,2,10,220,2,9,6.523518629,1714,156,15,99,99,0,13837,13837,0,91,91,0,100
1ff5810e9e98dbcd9ccb9cbfb26e1196be8737a4,6,60,54,6,0,0,0,8,74,9,2,4,1.76929924,4244,400,5,1050,1054,4,28034,28092,58,485,485,0,100
c14838950cd361f54f9ca913c396df570e368b1e,9,652,44,608,5,0,5,1,43,0,2,3,2.783562262,3423,169,13,1000,904,96,27831,25219,2612,320,274,46,99.91074365
4327063d636e1118b2baf9ac4c5fe689420576d7,0,0,0,0,0,0,0,0,0,0,0,0,0,0,156,4,0,0,0,0,0,0,0,0,0,100
400c5921009d3059994ea8bc2ce408729943aaa3,0,0,0,0,0,0,0,0,0,0,0,0,0,0,157,16,0,0,0,0,0,0,0,0,0,100
bcdfee33fef0ec24ec348dbfd99162e32d10a3b2,0,0,0,0,0,0,0,0,0,0,0,0,0,0,106,8,0,0,0,0,0,0,0,0,0,100
4c6ecef1ba10438268154d33c16520588f574fbb,3,14,113,99,0,0,0,2,68,6,1,3,1.53714765,1525,6,4,470,474,4,10671,10942,271,76,77,1,96.35761589
b68c975ebf49b65004c42fcc3bd39dd3f8d6a432,1,1,1,0,0,0,0,3,5,90,1,1,0,90,158,16,13,13,0,444,442,2,2,2,0,100
680320a73310a82637a937be18da25848859101e,0,0,0,0,0,0,0,0,0,0,0,0,0,0,159,17,0,0,0,0,0,0,0,0,0,100
58539dd83369c3a64907bc22c418ba8684e29274,0,0,0,0,0,0,0,0,0,0,0,0,0,0,7,5,0,0,0,0,0,0,0,0,0,100
31c4790c328fa208ed8b9e3c4ed4bb8b168b9c50,0,0,0,0,0,0,0,0,0,0,0,0,0,0,157,4,0,0,0,0,0,0,0,0,0,100
97aca65ddc006b3bd868faadc3893222b0609cd6,2,10,1,9,0,0,0,12,57,7,2,2,0.945660305,696,170,13,153,150,3,4640,4597,43,58,56,2,100
cc5664fe2d6d2cdd08e7b9744d69075541931965,3,90,49,41,0,0,0,11,69,42,2,3,0.904503199,3589,302,5,1161,1157,4,25128,24948,180,287,285,2,100
38a54f39f7ac96ab26c1eda3420362376338ccf8,4,25,32,7,0,0,0,10,58,8,3,4,1.616348566,2320,8,5,590,593,3,15782,15793,11,190,192,2,100
bb67dae45e14faa02b6b4916add3b25f870594d6,0,0,0,0,0,0,0,0,0,0,0,0,0,0,160,16,0,0,0,0,0,0,0,0,0,100
210581b625a50468f70b243f8420b1fb635796c7,1,1,1,0,0,0,0,10,43,0,1,1,0,220,9,5,38,38,0,1369,1369,0,14,14,0,100
b058e703822c814c089cd9e814a702b263e976d0,0,0,0,0,0,0,0,0,0,0,0,0,0,0,161,17,0,0,0,0,0,0,0,0,0,100
18cd43dfcd9a98e8954634a5a7ff3455a7ef4744,0,0,0,0,0,0,0,0,0,0,0,0,0,0,162,18,0,0,0,0,0,0,0,0,0,100
63a3408d7d291fd3c965500c33fabf2189530d65,3,17,2,15,0,0,0,5,120,18,2,2,0.774243303,3642,10,6,1049,1048,1,25993,25913,80,258,258,0,100
5b9c0cb8f893cd2c022b1260a3787cd41c62daca,1,2,0,2,0,0,0,5,8,0,1,1,0,73,11,7,5,5,0,442,427,15,4,4,0,100
020d46ef1231ce51ce231581c2e9c3d52dd7fbb4,4,175,13,162,2,0,2,6,74,41,2,2,1.780928206,4308,158,4,865,844,21,29076,28570,506,302,284,18,99.98017682
39240eb1ecf22f6b47db987bfcdf918bfd0faa78,0,0,0,0,0,0,0,0,0,0,0,0,0,0,163,19,0,0,0,0,0,0,0,0,0,100
c6085cd2961fb178d64a2f739fc25cdc33c9195c,0,0,0,0,0,0,0,0,0,0,0,0,0,0,164,20,0,0,0,0,0,0,0,0,0,100
1b91bd3b58fc2451148d1006f6546843cc2c1201,2,53,6,47,0,0,0,6,75,0,2,2,0.616166193,4324,159,5,858,849,9,28936,28670,266,288,286,2,100
73e9f4d2b6afc4146d16712b532d0c274df000e1,1,0,17,17,0,0,0,6,36,0,1,1,0,2650,160,6,335,338,3,15786,15870,84,163,164,1,100
6ab4b48d5546b4c6b345a0a98b8d3f2ac547438e,2,35,6,29,0,0,0,6,76,0,2,2,0.989245297,4351,161,7,866,855,11,29091,28852,239,288,287,1,100
4994981795bfab854acf479f361a93e0ef80bb43,2,144,144,0,0,0,0,2,2,2,1,1,0.996518478,118,303,5,16,16,0,406,406,0,16,16,0,100
27e2c03fd2025361f84304add76dd307806e5646,0,0,0,0,0,0,0,0,0,0,0,0,0,0,165,18,0,0,0,0,0,0,0,0,0,100
0d9bd741b3606fa6c11b93a5827f9c4f2c175aa2,1,25,34,9,0,0,0,4,15,1832,1,1,0,499,401,6,182,182,0,3293,3242,51,26,26,0,100
a91b3bdb40bad4bd2caed47475f58175987824ad,2,161,0,161,2,0,2,1,1,0,1,1,0.991942496,0,166,18,12,0,12,375,0,375,11,0,11,99.98414711
60491eb4d850c37f98addf72e76ab753c425aa17,1,2,2,0,0,0,0,8,56,20,1,1,0,719,402,7,207,206,1,4967,4958,9,64,64,0,100
0e8cf0dc0b7c443aad3e46b2b19b5beeb0bd2003,10,91,99,8,0,0,0,3,5,564,1,1,2.628450527,2149,29,2,261,258,3,13035,12844,191,173,170,3,99.95245453
47a90dae9834cafdfefce77542f9b627348bd6a5,0,0,0,0,0,0,0,0,0,0,0,0,0,0,30,3,0,0,0,0,0,0,0,0,0,100
3c8b756ce59f3d6bb7ae0ba05cdda04747cb0671,4,476,0,476,4,0,4,1,1,0,1,1,1.878455198,0,403,8,66,0,66,1493,0,1493,32,0,32,99.97227393
bc1139791261b505ab6774ed02169db4a33bc8a7,4,11,14,3,0,0,0,3,4,555,1,2,1.87293504,399,31,3,43,43,0,2059,2045,14,35,35,0,99.98019959
eb41b03ff4263cb004d7c0695f103c7f12203fde,3,150,3,147,1,0,1,11,64,206,3,3,0.510058141,1420,102,0,433,410,23,9963,9210,753,169,163,6,99.97624233
60b8e64ec9e7d10c054faa15ff94885680b98e30,4,4,5,1,0,0,0,1,2,4,1,1,1.891061112,315,404,9,67,66,1,1507,1493,14,32,32,0,100
87e07a9d47a05cb6ee72c80d932a20023a296a15,2,51,0,51,0,0,0,10,70,116,2,2,0.238684511,1568,103,1,376,369,7,10304,10037,267,238,237,1,100
f74e98808838fd02f31b1fb4856821920b1df536,5,217,5,212,2,0,2,7,98,28,2,4,1.294188506,3913,405,10,1135,1117,18,24636,23841,795,319,305,14,99.97229369
05d2a8041782f2531caaeb372ba610be18e5704a,37,112,72,40,0,0,0,4,71,157,3,12,4.919789542,12262,406,8,2412,2409,3,93951,93784,167,1070,1069,1,99.732294
4f5a9dd676ce9742c166b269af5d88d8a0540853,16,124,92,32,0,0,0,3,42,181,2,6,3.134479326,6500,407,9,1144,1143,1,54839,54726,113,844,843,1,99.57224708
8956f17824155cf99d4c766fa7a3d52e6e08febc,0,0,0,0,0,0,0,0,0,0,0,0,0,0,167,16,0,0,0,0,0,0,0,0,0,100
bdd3014b5f6d34c4e222a2fab536fcfd3d5fef5d,0,0,0,0,0,0,0,0,0,0,0,0,0,0,107,1,0,0,0,0,0,0,0,0,0,100
454afa02492627bf7de7f340fb91cca53c203628,2,39,49,10,0,0,0,3,18,1383,1,1,0.730926378,395,408,10,114,113,1,2577,2640,63,46,46,0,100
f1fc076840e84dbb58c6f2c15b6d73210aac9fc2,0,0,0,0,0,0,0,0,0,0,0,0,0,0,168,17,0,0,0,0,0,0,0,0,0,100
52fdddcf380a9b0599039fd5beaa0bacd7e7067b,4,595,0,595,4,0,4,1,1,0,1,2,1.858443606,0,0,0,58,0,58,1863,0,1863,54,0,54,99.960698
cc59e096ef9850ec1638ebcf001d558b9cfaa166,3,1051,1,1050,2,0,2,10,61,1,2,3,0.589244524,640,108,2,186,139,47,10184,4244,5940,72,43,29,99.98428785
bb205a29c91366860d7efa544f344eac41e2f37d,1,6,4,2,0,0,0,1,2,1,1,1,0,158,1,1,8,7,1,1119,757,362,4,3,1,100
6d50e87a03ef41e5cf69b3aeb659284baba29dbb,4,121,4,117,2,0,2,10,55,14,3,3,1.452305883,1625,12,6,445,442,3,11640,11238,402,136,134,2,99.96857693
65d2ea8b1922cae9f68dddbdcd1e8e1212a62ba4,1,16,2,14,0,0,0,9,27,187,1,1,0,673,171,1,136,133,3,4278,4196,82,84,84,0,100
79a4b76fdf0038f2460f6a5c828ab1e04ddf67ae,4,96,12,84,0,0,0,6,38,557,2,2,1.695209964,3760,172,2,746,734,12,24580,24076,504,224,220,4,100
85e631a1938c43aa428cbbd6d7ae8852eba15967,16,524,59,465,3,0,3,1,99,720,2,4,3.23849379,7260,409,8,2037,1978,59,46790,44800,1990,762,736,26,97.38652572
6d964387c8e4732795eeaacc5efa328b5a922661,5,144,59,85,0,0,0,4,27,28,2,2,2.008068338,2551,173,3,491,471,20,22933,22062,871,181,178,3,99.18214583
732e45cabaf70a16c761c0874b2bf84e4b8b4c8e,1,0,2,2,0,0,0,9,28,2,1,1,0,686,104,2,136,136,0,4256,4278,22,84,84,0,100
9d58228dc6e85e63954a1f80c5514ebaab9e25c5,0,0,0,0,0,0,0,0,0,0,0,0,0,0,169,9,0,0,0,0,0,0,0,0,0,100
139b6bb245846432f96f71b48b9308befedcf126,0,0,0,0,0,0,0,0,0,0,0,0,0,0,170,10,0,0,0,0,0,0,0,0,0,100
acab37ec81ea02bf41dfdb431bdf4722a5c4a51e,1,7,0,7,0,0,0,9,58,70,1,1,0,1590,174,4,456,454,2,9907,9852,55,116,116,0,100
a32bb62381a03d9901298e55daf68569f0394942,2,130,10,120,0,0,0,4,57,52,2,2,0.468995594,3667,162,4,844,839,5,28179,27341,838,356,353,3,99.85289931
18f0e74899d1686df968a2eeda8b5ebaf1105122,0,0,0,0,0,0,0,0,0,0,0,0,0,0,32,3,0,0,0,0,0,0,0,0,0,100
c95593d8e255e351127a24efcde2bc33fb0b055a,6,35,38,3,0,0,0,3,5,558,1,1,2.278429824,378,33,4,26,26,0,1963,1880,83,20,19,1,99.97628758
737f17fc266c9d0cc49d2f20a5ffa934afef325a,0,0,0,0,0,0,0,0,0,0,0,0,0,0,171,11,0,0,0,0,0,0,0,0,0,100
58ebc6d9f17f09d274fdb16b188bc81e0d3b34ee,0,0,0,0,0,0,0,0,0,0,0,0,0,0,163,5,0,0,0,0,0,0,0,0,0,100
22054669db9d80652424ae22d04859c00494c7e3,4,343,0,343,4,0,4,1,1,0,1,1,1.931742132,0,175,4,71,0,71,1508,0,1508,33,0,33,99.95733182
cc9644dafe4e06992f29fda7e3c3f0800cce3667,2,55,51,4,0,0,0,9,56,322,1,2,0.915119029,1565,410,9,439,437,2,10919,10930,11,140,139,1,100
6d6645b7edea10eced9b1d15cb9f016ddf01eb8f,23,114,6,108,0,0,0,4,12,2737,1,1,4.501629167,1476,411,10,322,300,22,5148,4813,335,285,263,22,100
afb95a595f13314c687b8edab5e495cfadd874ca,1,5,0,5,0,0,0,4,7,2757,1,1,0,28,412,11,3,2,1,56,41,15,3,2,1,100
59c81b98aa2730084defb28839661bda5aad8bc3,1,9,3,6,0,0,0,5,9,1219,1,1,0,77,413,12,18,17,1,473,455,18,5,5,0,100
1dc5b3bd83e56ca8b46926bf6a224d20f7b51d2f,1,1,1,0,0,0,0,8,65,49,1,1,0,1805,109,2,583,583,0,11997,11997,0,166,166,0,100
2ef5d26a8ead4d86219aeb533f83f54851357ac5,1,10,7,3,0,0,0,11,22,122,1,1,0,565,414,13,109,109,0,3788,3800,12,36,36,0,100
04df2fac8231731830c5b886650b39b46cf9ed69,35,1887,110,1777,18,0,18,9,121,112,4,7,4.47909462,12491,110,3,3584,3424,160,93207,86841,6366,975,841,134,99.79670953
8abd836dcf285c0178e7dfb7a36a4abe24aa24f2,10,254,248,6,0,0,0,9,72,114,3,6,2.533472953,5821,415,14,1701,1716,15,38788,38696,92,459,462,3,99.3204826
c753ce22784c82999290c7819276060f0dc789fe,1,58,0,58,1,0,1,1,1,0,1,1,0,0,172,7,2,0,2,168,0,168,2,0,2,99.97733762
f7568decb957ebcf656c977fcdac4f85914962ce,5,151,13,138,3,0,3,10,73,0,2,3,1.987920529,3054,13,1,936,927,9,20898,20603,295,201,194,7,99.9682813
330b1f657a9bdbd8886eb20adb58001af5b021b4,1,1,1,0,0,0,0,2,3,25,1,1,0,122,105,3,19,19,0,681,683,2,5,5,0,100
e69163bdd53378f1474b2776a49bff681db4ed39,2,111,111,0,0,0,0,11,74,0,1,1,0.97876039,3056,106,4,929,929,0,20638,20638,0,194,194,0,100
721c6ce21193757def7294b3bf725baf0c558057,0,0,0,0,0,0,0,0,0,0,0,0,0,0,173,7,0,0,0,0,0,0,0,0,0,100
7a46717616e9f908df95bcff48dff7e6b29af14a,3,11,12,1,0,0,0,11,75,0,2,3,1.264672679,1531,14,2,478,478,0,10901,10908,7,84,84,0,100
5d793884e63d62b5f88705173083cb0ee0603485,1,6,6,0,0,0,0,11,76,0,1,1,0,1452,15,3,471,471,0,10682,10682,0,77,77,0,100
105d46c6eacbaad594e991b012f046da5d7d38fd,9,220,72,148,0,0,0,4,122,470,2,5,1.948876252,5182,304,0,1308,1289,19,36861,36127,734,362,352,10,99.97283593
ec7f6f5b01f502069454b842c98cb7e9ef868789,11,28,8,20,0,0,0,3,13,534,1,6,3.181485865,1188,111,4,174,173,1,6323,6185,138,132,132,0,100
4f59bec34f4c19e0cede900e1dbc6913dfa519b2,0,0,0,0,0,0,0,0,0,0,0,0,0,0,174,7,0,0,0,0,0,0,0,0,0,100
99816013ba9771ecea42ccc41f9b4d775c696ccc,0,0,0,0,0,0,0,0,0,0,0,0,0,0,175,8,0,0,0,0,0,0,0,0,0,100
13c88d75cf0844d1dfb0bdfc0dc9a297c4d2745d,25,483,342,141,1,0,1,11,100,207,3,7,3.990085095,16939,416,13,4853,4827,26,107350,106755,595,1588,1588,0,97.43251299
b646b8810df12c31de8c23d49a278414cf1afef7,15,409,13,396,2,0,2,3,53,354,2,4,3.070825949,6184,176,5,1810,1749,61,48722,46661,2061,465,438,27,99.96783532
71f9f409c00855e26cb1de51536ff73475ecf4d7,1,1,1,0,0,0,0,2,3,31,1,1,0,86,177,6,12,12,0,345,345,0,12,12,0,100
ad1029fde49253d5e97f880c57665b6ce8dcab44,1,14,3,11,0,0,0,5,16,21,1,1,0,256,112,4,59,57,2,1405,1381,24,41,40,1,100
3ec0fbf66fd6fd433d25e9884e2bd3453e78f1f4,1,28,1,27,0,0,0,3,10,144,1,1,0,108,417,8,33,27,6,668,545,123,19,18,1,100
5016fc69f876b56f961f062b538440af8bdc7497,5,468,85,383,3,0,3,1,41,6,2,3,2.091660867,834,418,9,290,245,45,6907,5008,1899,106,81,25,99.97187513
cb31d309b2cb8a8dc77f261abc39195507b6d967,0,0,0,0,0,0,0,0,0,0,0,0,0,0,176,7,0,0,0,0,0,0,0,0,0,100
530a190ebb90ffd97adc3a961c6d85c896ea9f41,7,786,0,786,5,0,5,1,57,20,2,3,2.469070894,1569,305,1,537,445,92,13115,10512,2603,209,157,52,99.95184204
62cc18cecbc2d87beba982db0c7f04b1b631f32f,1,8,0,8,0,0,0,2,2,1,1,1,0,141,113,4,29,28,1,1141,1065,76,11,11,0,99.99197496
a2abcbbfe38c73a4fa6a473043c1ff0c06c5afd6,0,0,0,0,0,0,0,0,0,0,0,0,0,0,177,8,0,0,0,0,0,0,0,0,0,100
28dafc7affc77ab41b0788f5795834bb5907b8f0,0,0,0,0,0,0,0,0,0,0,0,0,0,0,178,9,0,0,0,0,0,0,0,0,0,100
5e73ca14edc6d37a2ebff56cf0cb30c763fa6774,6,171,148,23,0,0,0,2,76,249,3,4,2.025884844,2696,419,10,595,594,1,16783,16509,274,366,364,2,100
dee384cb3cc143fd46f3a9db54832759a884d949,1,12,29,17,0,0,0,4,15,47,1,1,0,256,420,11,48,48,0,1537,1534,3,18,18,0,100
41f750a8f12f41d950328802ecfaf406348484b5,1,5,13,8,0,0,0,1,3,0,1,1,0,108,421,12,22,24,2,799,846,47,8,10,2,100
c5cc2672190a2ff04d592fae108d6a6ceaec3e67,1,26,22,4,0,0,0,10,73,18,1,1,0,1350,422,13,351,354,3,8783,8749,34,225,225,0,100
a24efc3c55573341ec0cd31e0637946370310e2e,0,0,0,0,0,0,0,0,0,0,0,0,0,0,179,10,0,0,0,0,0,0,0,0,0,100
d0cf5b404e7ee3c2990d58071fb7a4da152969c3,0,0,0,0,0,0,0,0,0,0,0,0,0,0,423,14,0,0,0,0,0,0,0,0,0,100
8c8636fce98d7907c444bc9f7dc2c94321163d68,32,5674,18,5656,24,0,24,11,78,0,3,3,3.775822713,4869,107,3,1958,1402,556,51622,30842,20780,638,407,231,96.85002748
b8e690fb5c282a56960c61b9c6bc09c4939e0bee,1,16,21,5,0,0,0,3,5,145,1,1,0,236,114,5,78,81,3,1424,1464,40,12,12,0,100
1154f23a11eb68666a0f9b3e840c8527c3e9d523,0,0,0,0,0,0,0,0,0,0,0,0,0,0,180,11,0,0,0,0,0,0,0,0,0,100
e1dcbce754528e8f080449e17de06f99e3787c1a,3,8,35,27,0,0,0,2,43,18,1,2,1.35458573,546,181,12,136,139,3,3119,3183,64,46,48,2,100
f25b573aa08af7d0d26d5bb2b40d8e3be15a6874,2,96,3,93,1,0,1,11,74,2,2,2,0.368556778,1353,164,1,356,351,5,9284,8783,501,228,225,3,99.99106744
eabd0c9454bab3170ce7c10208afd687c96b84b1,4,43,4,39,0,0,0,3,71,552,3,3,1.667844887,3745,178,3,775,772,3,29620,29413,207,176,175,1,100
d1feecbc9e3750c2b887f0ae95b509569d28d22e,1,1,12,11,0,0,0,7,30,0,1,1,0,361,179,4,86,86,0,2497,2520,23,24,24,0,100
74b0ac19562af2340db9b75a2b0716ca90783d4b,2,3,0,3,0,0,0,3,16,1148,2,2,0.918295834,340,424,14,72,72,0,1997,1979,18,33,33,0,100
760cf901ed485e7b3d0df316dc248b02c2c4cf24,0,0,0,0,0,0,0,0,0,0,0,0,0,0,425,15,0,0,0,0,0,0,0,0,0,100
90392e37d6389f2002bdf5992e1a1242a442c79b,2,11,5,6,0,0,0,3,23,98,1,1,0.543564443,930,426,16,125,123,2,8231,8169,62,82,82,0,100
073ad1d7976a26e2c6fdf1a6eaeaabab153bbfc6,1,4,4,0,0,0,0,4,13,51,1,1,0,1413,427,13,59,59,0,11896,11896,0,59,59,0,100
f4c2b59df7732892d00acf34593e56e11f7c4b91,1,8,7,1,0,0,0,4,9,0,1,1,0,305,428,14,70,70,0,2335,2314,21,27,27,0,100
e43c6f05a34bdeba6c95619b2494364940850ea3,1,3,3,0,0,0,0,4,14,0,1,1,0,1413,429,15,59,59,0,11896,11896,0,59,59,0,100
b1b1e0fc4092308a30d99dab61b4cda2a38496f9,1,1,1,0,0,0,0,4,10,0,1,1,0,306,430,16,70,70,0,2335,2335,0,27,27,0,100
48a8b22b7b3b06fde0f385dd8817ba22c7257695,1,16,16,0,0,0,0,4,15,0,1,1,0,1413,431,17,59,59,0,11896,11896,0,59,59,0,100
2ff77531c2190355adb1c71f53a87d0873fe1c6e,1,1,1,0,0,0,0,4,11,0,1,1,0,306,432,18,70,70,0,2340,2335,5,27,27,0,100
d59954d4b460c3d95b52a46054d721ba1e596872,1,7,5,2,0,0,0,16,123,35,1,1,0,3522,433,19,1044,1043,1,25278,25270,8,254,254,0,100
ea6499afc01087cfa83879506fdc2ca49ac39ad0,6,195,115,80,0,0,0,1,10,195,2,2,2.277596377,2437,108,3,421,411,10,15416,14519,897,71,69,2,92.15882725
ac531c58759a605d7865db218ff1625454c591b2,3,183,13,170,0,0,0,13,124,120,1,2,1.261880707,4964,115,4,1514,1475,39,36580,35569,1011,361,353,8,100
f0ad193611fdc1e401c897388ddcd9c14ca26227,1,17,2,15,0,0,0,3,3,680,1,1,0,46,116,5,4,2,2,342,252,90,3,2,1,94.30875576
faf2966816c2f6252546b519eb39f4077c1713f2,9,297,129,168,0,0,0,10,75,163,3,6,2.746399238,4406,434,18,1074,1049,25,31046,29705,1341,454,446,8,100
00fcf4cfd3cf28c95c9ba413358a7b680a719302,0,0,0,0,0,0,0,0,0,0,0,0,0,0,182,8,0,0,0,0,0,0,0,0,0,100
3e83d5d15b2095330d21739e1244db9b52a1a9b3,1,5,5,0,0,0,0,11,76,2,1,1,0,1380,109,2,359,359,0,9063,9066,3,225,225,0,100
75f3a174a46540cdcf3509396f7c82febcfd6c2f,1,5,5,0,0,0,0,2,5,9,1,1,0,119,110,3,29,29,0,937,897,40,10,10,0,100
218f57a731b60405ed3d6fc88ca5d38b47652a22,0,0,0,0,0,0,0,0,0,0,0,0,0,0,117,5,0,0,0,0,0,0,0,0,0,100
19eb9f2615a15ae74a13668b88e3fd6136911d3e,2,32,2,30,0,0,0,5,17,281,2,2,0.522559375,323,16,0,77,75,2,2060,1934,126,29,28,1,97.41520283
8f2ed40ac949820ad33faa6520249b672f4be6c8,1,1,3,2,0,0,0,6,13,706,1,1,0,90,111,4,16,16,0,554,570,16,10,10,0,96.31649168
ab18db113b1fcdef7db9e96d8dcd6728cda576d8,2,13,6,7,0,0,0,3,43,359,2,2,0.629249224,1205,118,6,294,294,0,9062,9026,36,63,63,0,100
983b34b68e9b5cf2fb5b78744f6bb2fcb654389c,3,42,8,34,0,0,0,2,77,1184,2,2,0.382542669,1901,180,2,537,536,1,14435,14272,163,133,132,1,99.99364999
4991e6bdc22bdda1ac5d8bee44f9f3e73d94a2d0,8,263,47,216,1,0,1,1,52,546,2,3,2.109673198,2545,112,5,655,633,22,17626,16437,1189,183,173,10,99.98730159
6f11e4d9836fa362d530d00cdd01342594eef1ab,2,33,1,32,0,0,0,11,66,151,2,2,0.989992792,1375,435,12,269,267,2,10442,10260,182,145,144,1,100
70fc46f93eab6364e8062cc857ae27dafbc3449f,2,82,1,81,1,0,1,1,125,12,2,2,0.626177654,3554,436,13,1054,1049,5,25844,25463,381,259,256,3,99.96826001
befbc83945f3220fbb8209670fa66bf7766dcf6d,3,19,0,19,0,0,0,7,101,125,1,1,1.529428332,5059,437,14,1416,1413,3,29565,29506,59,450,448,2,100
965c997c24c50a52a95492ada112d11a4c50fab7,1,2,0,2,0,0,0,6,9,669,1,1,0,1078,438,15,377,376,1,7398,7385,13,99,99,0,100
8c952771dc1852c56b8e2a5e216edc0e5ab9b292,1,5,2,3,0,0,0,7,32,67,1,1,0,1142,439,16,269,268,1,7162,7126,36,62,62,0,100
091109041fe612b507c596a4d903389c33c2c466,1,2,0,2,0,0,0,9,54,61,1,1,0,1726,440,17,460,459,1,14118,14096,22,81,81,0,100
2271a54167f3fa394f0b15f1b660e1cc0bea1144,2,4,2,2,0,0,0,2,5,165,1,2,1,309,306,0,25,25,0,2687,2659,28,12,12,0,100
865dad93aac88d8cf206825c60b1c7f340fe70eb,1,4,0,4,0,0,0,3,38,92,1,1,0,482,441,17,141,140,1,3409,3394,15,60,60,0,100
f6327de653ed080b79c7630c13210bf2389a7079,0,0,0,0,0,0,0,0,0,0,0,0,0,0,307,1,0,0,0,0,0,0,0,0,0,100
6ae4adf687ac9194fa66b4f82ccf07413b0262e3,0,0,0,0,0,0,0,0,0,0,0,0,0,0,442,18,0,0,0,0,0,0,0,0,0,100
6e630e827ea2a257b2277c5589532b3b3b2e7fea,1,28,2,26,0,0,0,1,6,340,1,1,0,658,443,19,175,166,9,4592,4466,126,92,88,4,100
6e37c5f34c72f1f4685288bb5bf14ddf10242e2b,7,179,36,143,0,0,0,3,43,121,1,1,2.158729267,5636,444,20,417,416,1,55308,54784,524,389,388,1,100
0d0daed2cbb92684ec5f8cef09ec1d0e75d42502,5,97,51,46,0,0,0,4,44,90,2,2,1.805359216,2315,445,21,388,387,1,21831,21626,205,296,296,0,100
6cf1ca1f637adc27600a8b1722d0a9b7f65b31a0,0,0,0,0,0,0,0,0,0,0,0,0,0,0,446,22,0,0,0,0,0,0,0,0,0,100
61f9b32a496f538e89074b5edd563bc1f01fb532,3,11,32,21,0,0,0,3,9,2078,1,1,1.421133835,258,447,23,66,68,2,1158,1208,50,33,35,2,98.61839265
a91e85e6db73b4c2c6b2e89eb75b2516d1bb99c6,1,7,11,4,0,0,0,7,14,286,1,1,0,562,448,24,173,174,1,3745,3751,6,63,64,1,100
93ae72d15f2b767c41ffc4458d95d4c64e3cc74d,2,5,36,31,0,0,0,5,14,560,1,2,0.996134484,556,449,25,170,175,5,3220,3399,179,86,88,2,100
05c785704cc706a1ca3745a5b2a3625eafb96c21,3,15,1,14,0,0,0,16,126,649,1,2,0.868392729,4364,450,26,1226,1223,3,31129,31050,79,310,310,0,100
69d2415b575d884968cb2e974173e6af570e093b,2,6,2,4,0,0,0,7,28,143,1,2,0.811278124,1158,451,27,301,298,3,7774,7734,40,109,109,0,100
5143d0cafd3ccd45a973f5945561675d87a5e81c,2,7,3,4,0,0,0,8,20,183,1,1,0.721928095,1306,452,28,376,375,1,9430,9413,17,92,92,0,100
cfea146c2953a8b46abed0f5de50cf42701ccf7b,2,6,2,4,0,0,0,11,67,12,2,2,0.543564443,1395,453,27,270,269,1,10456,10442,14,145,145,0,100
9c275904f3a7a6f7f5740cf641bf7fcccb710186,12,71,52,19,0,0,0,11,127,0,3,6,3.071584213,8235,454,27,2155,2155,0,57925,57946,21,667,662,5,98.61839265
cbde4958f3a5f752fad6a76291ac570da5006d75,2,16,5,11,0,0,0,5,15,0,1,2,0.453716339,797,455,28,254,254,0,5327,5221,106,113,113,0,100
9a7bab2a6a54849fe98de374be278f3c303e68ec,1,7,11,4,0,0,0,7,17,0,1,1,0,562,456,29,173,174,1,3745,3751,6,63,64,1,100
d9d6898558b809c0c630c0db869d4fe8f4ec61b4,2,5,36,31,0,0,0,5,16,0,1,2,0.996134484,556,457,30,170,175,5,3220,3399,179,86,88,2,100
fb82c6ad138638358017b9516f3340bf1a75e4fe,2,8,3,5,0,0,0,11,69,0,2,2,0.845350937,1395,458,31,270,269,1,10462,10442,20,145,145,0,100
c44c17bd77cc9ab79726783f5a5da1419f1b844b,1,62,0,62,0,0,0,2,12,106,1,1,0,293,459,25,52,45,7,3505,2701,804,21,20,1,100
481bb3d6eb14697e425a673b643e6037424c173e,1,28,13,15,0,0,0,3,16,107,1,1,0,195,460,26,59,52,7,2117,1986,131,36,36,0,100
be2ff16fe3ac83e54723daa4452dc71a6c1e2a14,3,62,35,27,0,0,0,1,17,303,1,1,1.10553589,1492,461,27,482,470,12,11747,11444,303,159,158,1,100
d797bc1eda8af75bb266d0523ca569b62ad1b774,2,19,1,18,0,0,0,3,45,12,2,2,0.721928095,1636,462,28,257,255,2,15035,14930,105,151,150,1,100
ee30b010dcbd58258c5d940d121e02f70b8160d9,4,28,7,21,0,0,0,3,78,221,2,4,1.680422032,3874,165,0,1062,1060,2,27739,27590,149,329,328,1,100
27996efb4882423eb1fce9425626d068e4eb501b,1,12,0,12,0,0,0,7,17,285,1,1,0,578,308,2,67,64,3,3900,3817,83,7,7,0,100
f1451e5fd868eacfabaf3500faeae13f05de3e79,2,33,6,27,0,0,0,3,46,53,2,2,0.918295834,2610,463,29,462,460,2,23451,23287,164,355,353,2,100
96c723b3cb5e85f6f68059f62307d488eeedbc27,1,2,1,1,0,0,0,4,13,13,1,1,0,295,464,30,65,64,1,2189,2172,17,24,24,0,100
9f0b7abbeed20dcb4a9fae076e0b9aa50cbf6e64,3,37,16,21,0,0,0,3,47,5,1,1,1.287920252,2891,465,30,249,241,8,26069,25891,178,177,176,1,100
c3a856faa022f43d8fe9b30d954edd46e1401131,7,87,21,66,0,0,0,11,65,251,3,3,2.165015711,4236,181,1,1224,1213,11,27806,27529,277,371,365,6,100
0291158f589290114dc031614f9595e81bc30b10,1,106,0,106,1,0,1,1,1,0,1,1,0,0,466,31,11,0,11,420,0,420,5,0,5,99.97461446
f6a6ee15f23f7bf7d99d33a3c904985b1ef8e98a,4,416,0,416,3,0,3,1,77,21,2,2,1.415596125,743,113,3,221,176,45,7129,5106,2023,64,41,23,96.29674896
0635172cbbb5049ae10808a1aea635b6275c675a,1,33,21,12,0,0,0,3,37,20,1,1,0,1453,467,32,345,345,0,11818,11692,126,262,262,0,100
5d765ea05b1f786c2bc6d48e3231c5d3a5166269,1,86,42,44,0,0,0,1,7,34,1,1,0,680,468,33,181,175,6,4678,4592,86,96,92,4,100
94389184655dd1bf89ee3650bce218d62970107a,1,2,0,2,0,0,0,5,20,170,1,1,0,749,469,34,307,306,1,5516,5507,9,31,31,0,100
d4010d13e18b66922b949e3a02e66c34657394da,1,13,6,7,0,0,0,11,70,24,1,1,0,702,470,35,178,175,3,4930,4886,44,87,87,0,100
3d07bcd372581c08ce74bd80c11db1d55178ec8c,1,10,0,10,0,0,0,16,128,26,1,1,0,3564,471,36,1057,1051,6,25628,25543,85,257,257,0,100
a1221ea36d7bb701ef0777478ea805856516b39a,1,21,0,21,0,0,0,3,48,20,1,1,0,1182,472,37,119,118,1,11995,11829,166,95,94,1,100
cbbe382ecda74174f567e2659a7fd2ccb5419abf,16,444,177,267,0,0,0,1,45,711,3,7,2.712282993,5080,114,1,886,845,41,35594,33271,2323,291,286,5,93.51696339
36a6df375bcb4b4c9b925c4234d02f6d84c6a334,1,3,4,1,0,0,0,3,7,287,1,1,0,230,115,2,29,29,0,1433,1439,6,13,13,0,100
69517ce840b72560e0a33e6e01b91d255f77e1d7,1,5,3,2,0,0,0,1,9,146,1,1,0,120,473,17,25,24,1,670,656,14,22,22,0,100
05226837fdf923830e234fe06e830d34313d3c2b,5,39,3,36,0,0,0,2,3,124,2,4,1.67523885,196,183,0,19,19,0,884,884,0,14,14,0,100
dce2cd8c6f87dfc7135fccfc732d8e2f98c30051,0,0,0,0,0,0,0,0,0,0,0,0,0,0,184,1,0,0,0,0,0,0,0,0,0,100
2c00f18f0c634ed5c16ebdbb90188e24033ef124,4,255,3,252,3,0,3,1,72,23,2,3,1.966009589,3139,17,0,678,656,22,26337,25351,986,143,128,15,99.97167941
110cb20e798f6c6eb2211b973ff23826604daf84,3,100,41,59,0,0,0,1,23,215,2,2,1.137692923,881,34,0,146,151,5,6224,6052,172,62,58,4,99.98786653
eea93c8346dde9ca5b5bbbddfe94b233c32ace47,0,0,0,0,0,0,0,0,0,0,0,0,0,0,116,3,0,0,0,0,0,0,0,0,0,100
bc7da9765803de2193c5dbb26184981952faf5d5,2,4,4,0,0,0,0,12,73,22,2,2,0.811278124,3871,474,11,827,827,0,30673,30637,36,178,178,0,100
583a6366fc9ae66b077a65a72e388358c8142811,1,8,8,0,0,0,0,5,14,246,1,1,0,348,35,1,44,44,0,3138,3152,14,5,5,0,100
ab52f1fa03ec427efc9bcd477d87d6c9437b2882,1,0,3,3,0,0,0,1,10,3,1,1,0,122,475,11,25,25,0,639,670,31,22,22,0,100
1aaa1aa08647c357a406ecee42e6b2439c60fb27,7,66,33,33,0,0,0,3,79,590,4,5,2.690475808,5515,476,12,1296,1293,3,45848,45501,347,664,662,2,99.66806995
2353db803d1f862a2b1a30052cc56346ac59cf06,1,35,20,15,0,0,0,4,6,2886,1,1,0,56,477,13,13,8,5,410,232,178,6,5,1,100
8a0f2da8fd57cd2bd129e56b66a672d724efe13e,2,11,1,10,0,0,0,5,46,82,2,2,0.650022422,1537,182,1,320,319,1,12115,12018,97,104,104,0,100
7cebf2ed256414b5a6da52822fceb1768e61daea,1,36,38,2,0,0,0,3,10,669,1,1,0,366,478,13,99,99,0,1717,1649,68,51,51,0,100
d488b471f5a6f750a9365388cd29aa2130fdbc40,0,0,0,0,0,0,0,0,0,0,0,0,0,0,117,4,0,0,0,0,0,0,0,0,0,100
123e0b61202ec1cfd6632736954bd80d65d3f8b3,2,18,9,9,0,0,0,11,129,76,1,1,0.99107606,3852,183,2,1113,1112,1,27737,27687,50,276,275,1,94.58431188
f697798fd8dac5c9567ecdbd2bd768169cbcc2ef,7,117,4,113,1,0,1,2,39,380,1,4,1.563795269,3137,184,2,427,415,12,18937,18518,419,215,206,9,99.98882682
3f3d586c7301b1f2f926fb40fac194b6229d970e,2,12,14,2,0,0,0,3,11,470,2,2,0.51594693,433,185,3,36,35,1,2514,2467,47,16,16,0,100
8607e0b3b4050a29c93c15bdd23fe676bf76490f,1,5,2,3,0,0,0,9,18,233,1,1,0,689,479,12,210,209,1,4885,4872,13,85,85,0,100
b8313194431891caa284c08b62364cd474a7884a,6,384,0,384,6,0,6,1,1,0,1,1,2.43695897,0,480,13,36,0,36,1299,0,1299,12,0,12,99.92185756
d17c70965d359a3c56f1391392c6a7861abfb1fd,1,25,2,23,0,0,0,14,102,79,1,1,0,3712,18,1,1082,1079,3,22876,22818,58,281,279,2,100
6896c31d601c6c0066b881af07e1d5a6045af274,1,1,2,1,0,0,0,5,11,1225,1,1,0,49,481,13,9,9,0,197,196,1,1,1,0,100
89fe979f492fbe2c2be57b6d899e2f53f736dafa,1,1,1,0,0,0,0,6,28,682,1,1,0,639,482,14,180,180,0,5049,5046,3,29,29,0,100
70518a3685fd93cb67e8591f4f48e2545c005bbd,1,11,6,5,0,0,0,9,59,57,1,1,0,1522,483,15,437,434,3,10661,10626,35,131,130,1,100
c1e0b6bd1c8b3b095f04e737731ccf780db0ac3c,2,46,8,38,0,0,0,9,26,251,1,2,0.999010271,803,19,2,239,231,8,5107,5022,85,77,75,2,100
45bc22baa33b082c97cc35a1252822b8fdb0b6bf,2,29,5,24,0,0,0,14,103,96,1,1,1,4297,185,2,1220,1215,5,26891,26744,147,333,329,4,100
92af878a15349c3463810bec949ecb9725696485,1,6,0,6,0,0,0,1,2,0,1,1,0,81,484,14,6,6,0,559,524,35,4,4,0,100
61dc996dc91fd6b80fc5bc2831ed0c73cc266301,1,0,1,1,0,0,0,2,3,165,1,1,0,160,186,4,8,8,0,1108,1119,11,4,4,0,100
658f01ee388a893ff8e3e2dc1b280b2956f7ddb2,28,4905,0,4905,28,0,28,1,1,0,1,8,3.826064618,0,485,12,667,0,667,17852,0,17852,218,0,218,99.6444642
2578261469a3982a7082566b945c64ca7eab5e0a,7,27,39,12,0,0,0,1,2,0,1,3,2.426887637,811,486,13,167,167,0,4922,4918,4,45,45,0,100
2baa87b0407823c3ea266b78a97adc8cab068fc4,0,0,0,0,0,0,0,0,0,0,0,0,0,0,309,0,0,0,0,0,0,0,0,0,0,100
77c324246587aa62be9213e91bc11697df8be491,2,9,0,9,0,0,0,6,14,166,1,2,0.99107606,387,487,14,115,113,2,2532,2477,55,58,56,2,98.66362079
b1ee063aa43a1e1fbfd837ef82a25a3e7ef937c4,3,30,0,30,0,0,0,3,130,150,2,3,0.674679923,5035,488,15,1253,1250,3,40088,39948,140,364,363,1,100
4515e2f5da657fedb0329c5bc5e48e657e861ebb,1,1,0,1,0,0,0,8,20,149,1,1,0,124,489,16,12,12,0,865,861,4,3,3,0,100
82aece97114ff940964db9bca34b62c9bd5279c7,1,29,0,29,0,0,0,7,13,278,1,1,0,231,310,1,42,40,2,1682,1509,173,16,14,2,99.9940996
e5ba74a9fcefaacdb963405c65910f9272c6829c,1,2,1,1,0,0,0,9,47,28,1,1,0,859,490,17,229,228,1,7157,7147,10,43,43,0,100
43c55d05391c97160cb6e963742b19c62ba1a3b3,1,4,1,3,0,0,0,8,68,149,1,1,0,1730,491,18,563,561,2,11571,11548,23,161,161,0,100
4715cc737b411f1f5e8604251c74f8570f1c645a,12,179,49,130,1,0,1,3,80,921,3,7,2.481093414,5177,492,19,1393,1375,18,35686,35036,650,546,531,15,95.97039045
b119e2b9594eaa6e4ca9f7ceaf85cd43f6eaf6a0,2,58,57,1,0,0,0,6,53,228,1,1,0.581956961,1768,493,20,502,502,0,11526,11405,121,179,179,0,99.98132674
60cae2ff515e80a0eca16e72997f2a86687e82a2,0,0,0,0,0,0,0,0,0,0,0,0,0,0,186,3,0,0,0,0,0,0,0,0,0,100
9dc10ef15e55486cf2977b283623de4ad799f7f3,0,0,0,0,0,0,0,0,0,0,0,0,0,0,187,4,0,0,0,0,0,0,0,0,0,100
6cee09c8c9ff17ce3b997f8116e186a9ca64d4fb,0,0,0,0,0,0,0,0,0,0,0,0,0,0,36,2,0,0,0,0,0,0,0,0,0,100
3067245dac166500fd0cc15c445f222334afba27,3,10,18,8,0,0,0,5,25,108,2,2,1.198117421,471,20,3,69,70,1,3029,3104,75,26,26,0,100
de8d125575ea342d71e11671701e7e25d7353353,13,1108,44,1064,6,0,6,1,3,7,1,4,3.096112652,615,494,20,205,85,120,9097,3702,5395,87,36,51,99.92535921
fd5c79aabca0045a65cf93735df8b3fa0a094423,10,49,18,31,0,0,0,3,72,135,2,5,2.897016155,3708,495,21,935,931,4,24219,24069,150,429,426,3,100
f5c216eb19d280cc2c886e606ea0b337d5cfaff7,2,37,8,29,0,0,0,6,54,10,1,1,0.938932011,1768,496,22,504,502,2,11627,11526,101,181,179,2,100
8dff01769495aa4fd94c83b58f144dfdebdfc581,3,39,7,32,0,0,0,6,55,57,1,2,1.506866502,4497,187,5,816,811,5,30814,30594,220,257,255,2,100
40f017a2e99211101f25fe3d6faafdef38d780a8,4,319,7,312,3,0,3,1,16,45,2,3,1.749186383,409,311,2,170,144,26,4405,3185,1220,34,13,21,99.96737357
8410bc88c6fca3587170b61ad9890c1717e81b1e,4,252,1,251,3,0,3,1,19,240,2,2,1.630869885,426,188,5,119,99,20,4225,3393,832,39,20,19,99.96739485
a05e0073947dd98b7f62c623bb86c6c05ac10308,0,0,0,0,0,0,0,0,0,0,0,0,0,0,25,0,0,0,0,0,0,0,0,0,0,100
9e8b0ded0b5c204f3de3df3abb8f79b44d9f7421,6,468,4,464,5,0,5,1,47,52,2,2,2.394526386,885,166,0,320,268,52,8629,6477,2152,95,66,29,99.94415488
5d9f08e72877b208dad9135afec8b630ce41f81d,6,63,4,59,0,0,0,10,77,479,4,4,2.321448236,3025,189,3,550,541,9,20074,19893,181,360,355,5,100
d189eac9dd6dd756643c3edce6932c56c87fb9a4,2,15,5,10,0,0,0,5,16,479,2,2,0.721928095,1396,190,4,301,299,2,9865,9776,89,166,166,0,100
d8ef5c17921a5e410cfb1fe7bfd1670d1f3b5229,2,21,2,19,0,0,0,4,65,35,1,2,0.558629373,888,21,3,171,168,3,6005,5946,59,58,57,1,100
d491a9cbed9beaf7f838e67e5ecd7aa8d10d58e5,1,3,4,1,0,0,0,1,8,101,1,1,0,655,497,18,272,269,3,5699,5684,15,89,89,0,100
14a02417927de84ff33c127459d3c5375eedf093,2,95,1,94,1,0,1,1,131,16,2,2,0.200622324,3565,498,19,1066,1056,10,25895,25580,315,266,257,9,99.97674743
ac6dab1d076a47319c82aac23a2ef5413fd1ecbe,1,17,0,17,0,0,0,4,7,2945,1,1,0,38,499,20,10,5,5,225,104,121,6,5,1,100
35377aace92dfd5554b0e795e8178f93f1878d3a,2,12,0,12,0,0,0,3,74,438,2,2,0.41381685,3257,22,2,685,683,2,26108,26065,43,138,136,2,100
781654af6044d7c3854d2e9d4ace73999081ba9d,2,7,8,1,0,0,0,5,16,22,2,2,0.996791632,166,23,3,12,12,0,906,859,47,7,7,0,100
91d46a845324e03aeeea27b819dda5386846e013,2,64,35,29,0,0,0,3,4,735,1,1,0.32984607,1318,90,0,106,112,6,8196,8424,228,57,57,0,100
3dee418d36c7aa1c217c3779ec7813ee9f9e87ae,11,418,8,410,2,0,2,3,77,52,3,4,2.373269373,6711,500,15,1662,1596,66,50458,48496,1962,798,762,36,99.64697139
29e919f2ccea6667a47212f1f333fe78a8b43fc0,9,32,58,26,0,0,0,3,56,8,2,4,2.687346373,4489,501,16,1207,1213,6,28917,29000,83,508,506,2,100
df5a403700ac8f070408bf86fdebeedbf209fea8,2,2,1,1,0,0,0,11,78,11,2,2,0.918295834,1482,502,17,361,361,0,9809,9820,11,227,227,0,100
fded22b2e04b8c2482fe257226c15a94bd8f23be,4,25,20,5,0,0,0,3,53,908,2,3,0.966806984,2285,503,18,741,738,3,15426,15348,78,197,197,0,100
775c627b8038f03a86bb1a0bd1cd03e3caf07070,1,3,0,3,0,0,0,1,9,5,1,1,0,658,504,19,273,272,1,5721,5699,22,89,89,0,100
a0e001e40ad600372f16d5708f580fc101fec3c3,10,569,2,567,9,0,9,1,75,0,2,2,3.173847686,3172,167,1,723,663,60,27465,25666,1799,179,128,51,99.90268316
5607a959abde3e078e095c47524487f7e3c69891,1,2,2,0,0,0,0,1,2,2,1,1,0,107,168,2,11,11,0,710,706,4,3,3,0,100
2274f9c21f0619a9ae9d8abbc62f274c002f37bc,1,34,16,18,0,0,0,2,4,2957,1,1,0,82,118,0,15,11,4,511,411,100,3,3,0,100
d33884a90a43d7261e8bbc761295394ce9059df2,0,0,0,0,0,0,0,0,0,0,0,0,0,0,37,0,0,0,0,0,0,0,0,0,0,100
5b7c20eacb99d974a48fcb6bc585ef6fd9f671d5,2,35,24,11,0,0,0,1,7,92,1,1,0.357646706,303,38,1,28,26,2,2282,2189,93,24,22,2,100
e5d2bd435f0c0fe502ed21a7df97672406d225c9,1,2,1,1,0,0,0,11,24,98,1,1,0,605,39,2,120,120,0,4048,4035,13,40,40,0,100
c6459391c8a8668cfc0ecd7ba7de95f7b0f956bd,1,42,2,40,0,0,0,9,14,320,1,1,0,206,40,3,60,56,4,1557,1418,139,14,12,2,99.99074588
02b5554036db444d4f7cb7463c3fe469edb29e87,0,0,0,0,0,0,0,0,0,0,0,0,0,0,188,0,0,0,0,0,0,0,0,0,0,100
f78ddef9c2032a92c9af40e383480033fb8e2a51,0,0,0,0,0,0,0,0,0,0,0,0,0,0,189,1,0,0,0,0,0,0,0,0,0,100
3320287392e035415d7867ac7312d9109d02306a,4,161,2,159,2,0,2,2,53,327,2,2,1.660787342,1276,191,0,375,364,11,9983,9336,647,110,100,10,99.96762407
c4fe0957ee76da70633082fc6210c425c7bfcbe1,0,0,0,0,0,0,0,0,0,0,0,0,0,0,190,2,0,0,0,0,0,0,0,0,0,100
8cf03bdab7873f6b93cba83e2ad84ce9deb2e5e8,0,0,0,0,0,0,0,0,0,0,0,0,0,0,191,3,0,0,0,0,0,0,0,0,0,100
254e9362cd5a730cd5bcc2912c24c971affc0a1c,0,0,0,0,0,0,0,0,0,0,0,0,0,0,192,4,0,0,0,0,0,0,0,0,0,100
5938ca72f084605af63a2540ea6f1d9b0d240924,0,0,0,0,0,0,0,0,0,0,0,0,0,0,193,5,0,0,0,0,0,0,0,0,0,100
bfd07edf3fe65f7ee7b4bc756d694f1bd1759479,0,0,0,0,0,0,0,0,0,0,0,0,0,0,194,6,0,0,0,0,0,0,0,0,0,100
b90c4f01911d3ca0ba34c856117353429588ebd9,0,0,0,0,0,0,0,0,0,0,0,0,0,0,195,7,0,0,0,0,0,0,0,0,0,100
e303892e2a16cc50785f37b951d047e394bf08ac,4,27,2,25,0,0,0,16,132,126,1,2,1.503352977,5616,192,1,1615,1608,7,40227,40111,116,393,390,3,100
6710465b7c66b61222d7c034022a143c93586225,1,4,4,0,0,0,0,8,44,428,1,1,0,514,196,8,147,149,2,3702,3713,11,26,26,0,100
3065f2febb333b4680ccd5649ece87dc2592afa9,1,2,0,2,0,0,0,8,45,0,1,1,0,514,197,9,150,147,3,3721,3702,19,26,26,0,100
5cef9cff179bc021c3a0a075dbb167db0aed3039,1,10,13,3,0,0,0,3,9,233,1,1,0,154,505,0,42,43,1,913,876,37,20,20,0,100
0efea474f226749a971077a592090cd7a4b86648,6,546,385,161,0,0,0,10,78,221,4,6,1.044087033,5421,24,0,1452,1384,68,36842,35694,1148,608,588,20,100
e53378bd2697a023a2be5d4c9191fa80c3411800,1,12,1,11,0,0,0,13,79,12,1,1,0,745,193,2,178,176,2,5188,5119,69,41,41,0,100
55bf86a4c8d4e7bef9aa7b611a9130011fa27c34,65,154,152,2,0,0,0,6,133,755,5,24,5.476675939,38238,198,10,10342,10342,0,267738,267737,1,3427,3427,0,100
1e95ee43a8fb375a4a3050bb157486081e0b6438,0,0,0,0,0,0,0,0,0,0,0,0,0,0,199,11,0,0,0,0,0,0,0,0,0,100
0a8386695305ab65bb153080381a8d178a039dac,4,291,0,291,4,0,4,1,1,0,1,1,1.966773892,0,25,1,29,0,29,945,0,945,29,0,29,99.95378074
6a779fd44ee687aaa092774efa97a56cb2b5cd78,0,0,0,0,0,0,0,0,0,0,0,0,0,0,200,12,0,0,0,0,0,0,0,0,0,100
634d82014b2667101448498f9abed7bfd6bcd7f9,0,0,0,0,0,0,0,0,0,0,0,0,0,0,312,0,0,0,0,0,0,0,0,0,0,100
c21fdc55126e0718c5a9716e8516c55ba7418d1f,0,0,0,0,0,0,0,0,0,0,0,0,0,0,313,1,0,0,0,0,0,0,0,0,0,100
2331d205229f72e7526d03896b5fbdca16ffca2b,3,18,4,14,0,0,0,3,82,208,3,3,0.993897264,2042,194,3,578,577,1,15231,15149,82,167,166,1,100
b8b37205e3900824a762d4f29fcf16f78b41de7d,0,0,0,0,0,0,0,0,0,0,0,0,0,0,201,13,0,0,0,0,0,0,0,0,0,100
4f6e43a7585d53decc9ae0703b33fee8a09be25c,0,0,0,0,0,0,0,0,0,0,0,0,0,0,202,14,0,0,0,0,0,0,0,0,0,100
61cacd5df6a77aa7426dfa03546d9f89fa24a0fb,0,0,0,0,0,0,0,0,0,0,0,0,0,0,203,15,0,0,0,0,0,0,0,0,0,100
dad4ad195225eaa68e6e3bed942822f0ea86d434,3,4,3,1,0,0,0,5,45,192,2,3,1.556656707,1300,169,0,287,287,0,9445,9446,1,68,68,0,100
b5a412fd426ca91d06d2a8a10c45b60070dd2674,12,675,475,200,1,0,1,11,79,560,5,5,2.758449974,7013,506,1,1465,1422,43,46806,45782,1024,658,645,13,98.50654214
db20d8a011cf6efc33b0e3b9c9d04da4ee67674a,15,675,532,143,1,0,1,1,44,622,4,5,3.352815517,2970,507,2,654,634,20,18515,17864,651,235,235,0,98.78282872
342c27dfd58e6c6d954b9335bca4e6f8ee16cb0c,1,1,0,1,0,0,0,6,14,1890,1,1,0,236,508,3,42,42,0,1135,1133,2,13,13,0,100
ab032d8f737fab385234abf1240e501d6d147733,1,16,1,15,0,0,0,1,3,447,1,1,0,168,509,4,43,38,5,1525,1414,111,13,13,0,100
5a8c5de491f363c96532b7ac6522d849c04014e8,2,3,1,2,0,0,0,1,62,142,2,2,1,1681,26,2,493,493,0,11751,11741,10,151,151,0,100
8e0e9cfbd2bd8616d6a30d3100cf609145d2342f,10,1523,0,1523,10,0,10,1,1,0,1,2,2.701260923,0,119,0,214,0,214,5549,0,5549,117,0,117,99.89599819
7b53696e6e5162debf7d48d0f02940f5df15239e,3,52,1,51,0,0,0,3,18,381,2,2,1.507170118,1027,510,5,179,172,7,8182,7865,317,93,88,5,100
fadd48fe5b68577a3a75d86fb7e51746d6662c3b,147,8530,2264,6266,27,0,27,11,134,917,3,13,5.827205311,43907,120,1,12586,11769,817,331121,302637,28484,4114,3538,576,97.09196038
e75d1c9c95348d07f20579f268664e0fd2f737c5,0,0,0,0,0,0,0,0,0,0,0,0,0,0,204,16,0,0,0,0,0,0,0,0,0,100
919be02042d1d458b16c5610276e6eb0a6a0a0ee,1,1,1,0,0,0,0,2,3,2729,1,1,0,78,170,1,14,14,0,320,320,0,12,12,0,100
bbc296ba29c2c6dd5620934446fd71c8561db6e4,1,6,4,2,0,0,0,1,3,0,1,1,0,54,27,3,3,3,0,240,266,26,2,2,0,100
dff9c690bc677bb42ed4317cf9dce92de742110b,34,0,5957,5957,0,0,0,2,4,89,1,9,4.238917087,3649,205,17,0,787,787,0,23251,23251,0,269,269,99.69378299
d31639d7b96d0d2c7a83172d996eb52757406b97,6,246,1,245,4,0,4,5,49,15,2,2,2.347754667,1549,195,4,350,321,29,12972,12160,812,125,104,21,99.95958616
7f66117b5aa372d6ec7179b2a1edd47ed46efbe3,2,10,1,9,0,0,0,11,67,365,2,2,0.439496987,2279,196,5,547,547,0,14347,14314,33,178,178,0,100
36e31ae445e15bc38fdc93bf1d887fb670eac1c5,4,48,2,46,0,0,0,11,79,93,2,3,1.658691872,2598,197,6,528,520,8,17571,17356,215,297,295,2,100
61d8fdaf543401390c008b53d8e9af3102666f62,0,0,0,0,0,0,0,0,0,0,0,0,0,0,206,17,0,0,0,0,0,0,0,0,0,100
7caef96636033372ccb3f989f267ee3493452350,0,0,0,0,0,0,0,0,0,0,0,0,0,0,121,2,0,0,0,0,0,0,0,0,0,100
d62991acc3acf44954744d6a2508884b2d6f02ff,1,2,2,0,0,0,0,1,1,0,1,1,0,100,91,0,11,11,0,554,554,0,6,6,0,99.983841
a91f6d553e59d2c8a0f2c0b7ca4e4cedec33e9f6,1,1,11,10,0,0,0,7,13,283,1,1,0,99,28,4,18,23,5,420,505,85,17,17,0,99.98788466
f877a44a6391005960ab3a1517e6d2f8ab781ac7,1,10,8,2,0,0,0,14,77,20,1,1,0,3177,29,5,664,664,0,25676,25701,25,128,128,0,100
28a6546b14185ea62137b9b0453ce754c5d62bc3,0,0,0,0,0,0,0,0,0,0,0,0,0,0,207,12,0,0,0,0,0,0,0,0,0,100
68eaab6dcca45ab7472dd93b6ff5933b18acb236,0,0,0,0,0,0,0,0,0,0,0,0,0,0,208,13,0,0,0,0,0,0,0,0,0,100
424da6212a4e3e39acbfcaf44ace4577c4392d6e,0,0,0,0,0,0,0,0,0,0,0,0,0,0,511,6,0,0,0,0,0,0,0,0,0,100
1049796100da5f1b082f026c73ae3bb19139dde1,3,9,5,4,0,0,0,11,80,3,2,2,1.148834854,1971,512,7,342,342,0,12384,12375,9,268,268,0,100
3bff9645033db9d990e80187a76b6de08e840aa8,2,2,2,0,0,0,0,7,81,2,1,2,1,2054,513,8,490,490,0,13762,13762,0,282,282,0,100
968634a738b10ff695d59c1ff05fef2ba425681f,1,6,5,1,0,0,0,14,78,2,1,1,0,3179,119,0,664,664,0,25672,25676,4,128,128,0,100
00c44aba43590c4e3f6dab5d71cbae433a13fdb9,1,0,2,2,0,0,0,10,48,0,1,1,0,343,209,14,0,0,0,2349,2358,9,0,0,0,100
245bb82d34f2ca92f96aa77c0784008745d13852,25,94,117,23,0,0,0,1,12,227,2,4,3.834819559,2550,122,3,392,392,0,13378,13478,100,307,307,0,93.34784712
9e736884121e01a153c1931cab19389d746c8779,7,39,6,33,0,0,0,1,135,7,2,4,2.754128307,4574,123,4,1329,1325,4,33133,33027,106,421,417,4,100
4adf1c68a79be63b68975a9b737688653cc059dd,4,53,9,44,0,0,0,2,52,132,1,3,0.858508563,1415,171,2,140,137,3,13510,13182,328,115,113,2,100
f4d0966de5ceb8e2b470c97dc447066dc0ea5de2,8,105,53,52,0,0,0,2,136,2,3,5,1.570221316,4755,124,5,1335,1324,11,34821,34463,358,426,417,9,100
531df90e41e5c80cce3129ef45455e2efe3ef272,1,10,0,10,0,0,0,3,6,911,1,1,0,251,210,14,18,17,1,1984,1914,70,16,16,0,100
2b2ede1e38d86e089cb0b1c8262b6c887e68f95f,1,25,15,10,0,0,0,11,48,3,1,1,0,230,211,15,38,38,0,1459,1460,1,15,15,0,100
9ea3fe08956adcf351ceaa6ca8fd8f7dfd4989e6,1,15,25,10,0,0,0,11,49,0,1,1,0,231,212,16,38,38,0,1460,1459,1,15,15,0,100
acafc94a5e539c4b0bd2a3913006cb32da303f67,1,25,15,10,0,0,0,11,50,0,1,1,0,230,213,17,38,38,0,1459,1460,1,15,15,0,100
5a0b97302ba89edbc08b90954805ad26ce6b1f3a,3,37,17,20,0,0,0,5,10,489,1,3,1.409454476,417,214,18,42,39,3,2606,2486,120,28,28,0,99.97585853
b94d23268f72e09ee305323962b662cbdb3dbac7,3,112,2,110,1,0,1,1,21,462,3,3,0.890164849,868,514,9,346,331,15,6774,6236,538,58,51,7,99.98792999
d23199bf20cdc471a4f589ac23d1f12e3b69ecd6,1,9,5,4,0,0,0,10,54,48,1,1,0,1183,515,10,359,358,1,8762,8726,36,97,97,0,100
3042900de18bd5f37011455050f5ab9078bb4b76,1,0,4,4,0,0,0,3,7,0,1,1,0,263,215,19,27,28,1,1528,1538,10,20,20,0,100
bad0838e0041910c0396b12e81b85635f5c334d1,3,6,4,2,0,0,0,2,137,0,2,2,1.370950594,3744,125,6,1080,1080,0,27100,27086,14,322,322,0,100
b08a0d179bb3fd690da18a2556e9ccc09dfb2c0a,1,14,9,5,0,0,0,13,82,17,1,1,0,767,198,6,182,180,2,5326,5290,36,43,43,0,100
6d253cfe105d6423759860e2ec33ad07409626e4,2,36,0,36,0,0,0,2,2,110,1,2,1,86,216,20,7,7,0,685,685,0,5,5,0,100
184cb41619ef57deb4a2808ee2d1605ae18a084a,5,6,7,1,0,0,0,6,82,230,2,4,2.075869297,1693,92,1,326,326,0,10256,10259,3,268,268,0,100
08cf0152075279240da0c1e17a8a83fcc0444056,0,0,0,0,0,0,0,0,0,0,0,0,0,0,217,21,0,0,0,0,0,0,0,0,0,100
ec8dba1465635ad5fdc8d993c73fa71616face71,2,60,2,58,0,0,0,11,80,18,2,2,0.345117315,2097,516,11,471,457,14,15230,14870,360,288,284,4,100
55d7af6e23c915f7dc418dc196cc132641c26c68,1,2,4,2,0,0,0,13,86,273,1,1,0,2398,30,6,771,769,2,16117,16103,14,224,224,0,100
d299ac431108416d606549ec771ca5b5a26d78a6,1,5,0,5,0,0,0,11,51,3,1,1,0,231,218,22,38,38,0,1490,1459,31,15,15,0,100
c246a7a4b17e6e8c83ebb1660bf3f3b726675c1d,40,5,3191,3186,0,0,0,1,83,425,2,6,4.995932429,4586,314,2,421,721,300,13988,24572,10584,292,487,195,98.14660806
79b14dd05fadfe9d07c02e4cf9ae5fbb4ce816ee,0,0,0,0,0,0,0,0,0,0,0,0,0,0,315,3,0,0,0,0,0,0,0,0,0,100
31757064ca69e04e6169f19f4ea5e6bb22c60bcb,0,0,0,0,0,0,0,0,0,0,0,0,0,0,219,21,0,0,0,0,0,0,0,0,0,100
671417a73a8d3c3548792da6886f207bca99b72d,1,4,12,8,0,0,0,10,23,20,1,1,0,239,126,7,55,56,1,1618,1649,31,19,20,1,100
c15f473949ca72a972dc75f61c5f0b43a9dd1e9f,4,2,54,52,0,0,0,11,84,2,2,3,1.844381594,2556,199,6,510,518,8,16836,17071,235,287,289,2,100
ef89c9d699d3ece9f64542b3cc9c7a2ace1f3d72,0,0,0,0,0,0,0,0,0,0,0,0,0,0,220,22,0,0,0,0,0,0,0,0,0,100
c9b82eec1f696cd42300fefe22184440aa6f70d3,0,0,0,0,0,0,0,0,0,0,0,0,0,0,221,23,0,0,0,0,0,0,0,0,0,100
85c75d84c21cf6dae278e277b2ab3e8b98194859,0,0,0,0,0,0,0,0,0,0,0,0,0,0,222,24,0,0,0,0,0,0,0,0,0,100
e6850b316b2a4e438cea534a5e2c57ab8a814c1f,0,0,0,0,0,0,0,0,0,0,0,0,0,0,223,25,0,0,0,0,0,0,0,0,0,100
9c90ca5506ace031689ce9803a1a1922e1c87693,0,0,0,0,0,0,0,0,0,0,0,0,0,0,224,26,0,0,0,0,0,0,0,0,0,100
83897b4d2882e5aa39d41e338ce7607e9d6cb4b4,0,0,0,0,0,0,0,0,0,0,0,0,0,0,225,26,0,0,0,0,0,0,0,0,0,100
f25dda05b5fe59f2478755f49b4772461c24a6af,0,0,0,0,0,0,0,0,0,0,0,0,0,0,226,26,0,0,0,0,0,0,0,0,0,100
7091a5292781815e9876a03b16f85a644849ee0f,4,356,0,356,4,0,4,1,1,0,1,1,1.468875528,0,227,27,28,0,28,1500,0,1500,20,0,20,99.94738381
a32573481e7759f1c29fd12f9850193b8e611690,5,344,8,336,3,0,3,3,7,161,2,2,2.185005958,491,127,8,129,94,35,4622,3230,1392,48,26,22,99.9883123
b3a931f4b0994d539e2e2dca98fa3a6a6914ee65,0,0,0,0,0,0,0,0,0,0,0,0,0,0,228,26,0,0,0,0,0,0,0,0,0,100
4197457c850cba65612f29bb501f0f97e3e7fcd4,3,25,1,24,0,0,0,4,87,6,3,3,1.105612401,3005,200,5,884,882,2,20481,20293,188,256,254,2,100
54ef07f799bfd130d825eef8a39257ff0f6eac1c,1,7,1,6,0,0,0,4,9,0,1,1,0,244,201,6,88,86,2,1571,1537,34,14,13,1,100
c2ef7871fac32cde39a1c41da8727b1640362b00,0,0,0,0,0,0,0,0,0,0,0,0,0,0,229,26,0,0,0,0,0,0,0,0,0,100
e3560cfd6bf8a4bfe5bad78f17c550a706d6625c,0,0,0,0,0,0,0,0,0,0,0,0,0,0,230,27,0,0,0,0,0,0,0,0,0,100
1000f39d355943c8bfc31322f5a26ffd5a2a1d53,3,117,3,114,1,0,1,6,55,50,2,2,1.206510385,3912,202,7,716,704,12,25642,25135,507,272,263,9,96.49132234
7aad95a75b06f5620fb4d9ac9b50e1a8149d0e19,2,17,44,27,0,0,0,4,10,5,2,2,0.943226155,629,203,8,103,114,11,4224,4371,147,30,32,2,100
97496b0bd6fe8d7471c3b3495ecab01614b8dfd9,2,11,18,7,0,0,0,5,15,113,2,2,0.66319684,556,41,0,83,80,3,4445,4449,4,21,21,0,99.98011039
784e4560db9ed097c77b23d50eee4731d49510b2,3,40,2,38,0,0,0,11,81,365,2,2,0.892942742,2152,517,6,554,546,8,14594,14391,203,315,314,1,100
1a216e9fb71736bbcf2007c0e3a4463332280eeb,7,155,11,144,0,0,0,5,60,331,2,3,2.449670651,4435,204,6,1303,1270,33,32361,31383,978,471,465,6,99.97513551
cbf700e499b2e8e724873cefe2dd1f5f98ae0e32,0,0,0,0,0,0,0,0,0,0,0,0,0,0,231,22,0,0,0,0,0,0,0,0,0,100
a720a9c6f69baa0dd3bed4953fbb772b5a0a4915,2,10,1,9,0,0,0,3,79,40,2,2,0.845350937,3248,316,2,669,668,1,26107,26073,34,133,132,1,100
ec0eeedf35d6250433d1a185ade1a894c44387ad,2,2,1,1,0,0,0,4,61,21,2,2,0.918295834,3637,172,1,913,911,2,29115,29098,17,397,397,0,100
814fef0f7df44e25d5d3c1f1ed04c8b415dc7c41,5,36,3,33,0,0,0,4,62,239,2,3,1.995081221,4818,205,6,1226,1220,6,37811,37721,90,571,567,4,100
69c5eb11ff8545473e4d65102313e1a562f65cf8,0,0,0,0,0,0,0,0,0,0,0,0,0,0,317,1,0,0,0,0,0,0,0,0,0,100
3854f9b5e63dc5d40d6445ad3ee911c8ba5abea5,2,10,2,8,0,0,0,5,50,43,2,2,0.918295834,1611,206,6,327,326,1,12729,12660,69,106,106,0,100
d3b3ee04389520f121eeb1684780e77f3fb75f94,1,1,1,0,0,0,0,11,82,23,1,1,0,1387,232,4,365,365,0,9151,9151,0,225,225,0,100
31265de187e0f6ba913ec895ef9e3374f4ecea47,3,228,4,224,1,0,1,1,22,220,2,3,1.171995359,921,207,7,363,330,33,7906,6766,1140,62,40,22,99.9900547
27abdb414926377f28e4aadff948576353ea3bc3,3,379,0,379,3,0,3,1,1,0,1,1,1.403669709,0,233,5,26,0,26,1362,0,1362,23,0,23,99.88062077
ad3cf2c68210d3ad53f71fdc3a5f9a543d12b748,2,13,5,8,0,0,0,6,63,372,2,2,0.650022422,1700,518,1,501,500,1,11818,11794,24,157,156,1,100
6fa32719b9da7b249d8faaa2f89c1eff8f4a7d42,6,202,110,92,2,0,2,1,85,116,1,2,2.3728777,1544,519,2,345,335,10,9604,9209,395,271,264,7,93.90620764
92f162bd4b12b0700f9784df26cfb21982a44c91,1,38,0,38,0,0,0,10,51,54,1,1,0,329,520,3,0,0,0,2291,2252,39,0,0,0,100
2641d43ed44233b666048977a260aa4a85cde518,2,24,8,16,0,0,0,2,6,198,1,1,0.974489403,310,521,4,47,44,3,2173,2071,102,23,20,3,100
4a987190d99d77dd18878423280489367bd17397,3,77,2,75,0,0,0,11,86,36,2,3,1.289569189,2224,208,8,541,515,26,15379,14750,629,294,291,3,100
f259a4ee1e12b5efe4435665a99f61bced7e8106,1,71,22,49,0,0,0,1,2,3,1,1,0,151,234,5,21,11,10,1240,1005,235,10,8,2,100
dc61fa06805c3da59008411127e0e2cc8a479d97,2,32,0,32,0,0,0,2,2,2,1,1,1,70,235,6,19,19,0,483,483,0,11,11,0,100
19f5b130458db0c5797992446f60f542cc44fccf,0,0,0,0,0,0,0,0,0,0,0,0,0,0,318,2,0,0,0,0,0,0,0,0,0,100
f028f744c2a24fcc93fd13aa07e255655ea552a0,0,0,0,0,0,0,0,0,0,0,0,0,0,0,319,3,0,0,0,0,0,0,0,0,0,100
fb004027ad861c1c0b00c0470bf3248d16f54c15,1,13,29,16,0,0,0,2,3,2,1,1,0,55,522,5,13,15,2,351,386,35,6,7,1,93.8962305
80d6c79b52588dd0c0f7e1fd76f02b67a9b9a945,1,5,3,2,0,0,0,9,58,91,1,1,0,719,120,0,207,207,0,4982,4967,15,64,64,0,100
feff96b4c468cef75140700aa14c71f6dafaf7c8,2,36,28,8,0,0,0,3,69,94,2,2,0.877437311,1945,523,6,598,596,2,13123,13109,14,176,175,1,100
9344d03b50bfe2d3f111ac9bd1c550e9a3d41a61,4,459,0,459,4,0,4,1,1,0,1,2,1.825267497,0,320,4,71,0,71,1757,0,1757,41,0,41,99.95531947
e603bdc5c8e4a2d8c0be197490f2e71a33fdc553,1,3,0,3,0,0,0,11,87,5,1,1,0,1361,425,0,300,299,1,8295,8286,9,249,249,0,100
5f8ad3e811f595cee6497953ce6c7989d3c5e3c8,9,561,561,0,0,0,0,2,3,144,1,1,3.100914376,473,321,5,59,59,0,1768,1768,0,51,51,0,100
a0e95fb993b33ff75d528d5e96c71b4f27f2f505,5,443,443,0,0,0,0,2,2,170,1,1,2.196333055,372,322,6,44,44,0,2028,2028,0,28,28,0,100
c1a24be02bed1d45a892acc4b777c0f834ef4c9b,1,92,92,0,0,0,0,2,2,314,1,1,0,75,323,7,5,5,0,495,495,0,3,3,0,100
307d5e8a9899d538fa0ad3729fdd6dccb8b441f3,0,0,0,0,0,0,0,0,0,0,0,0,0,0,236,5,0,0,0,0,0,0,0,0,0,100
23341c871cc395924aa984976c725af06af84315,1,1,0,1,0,0,0,9,59,86,1,1,0,1698,426,1,506,505,1,10986,10981,5,181,181,0,100
e70d8bf5f2de6b0f4fac0529830a64ce387eee01,1,2,1,1,0,0,0,7,15,87,1,1,0,237,42,1,42,42,0,1135,1135,0,13,13,0,100
8cc89f96dcb353a3cbdd20cbca236b1b65f127c0,0,0,0,0,0,0,0,0,0,0,0,0,0,0,43,1,0,0,0,0,0,0,0,0,0,100
0b1268aa5de08615493f4f6369b70bf06c07eab8,1,2,0,2,0,0,0,1,2,351,1,1,0,26,237,6,2,2,0,185,168,17,2,2,0,100
928993b7e2279d3977c130638efac0a5c3a5e3c1,1,5,6,1,0,0,0,1,1,0,1,1,0,28,238,7,2,2,0,174,185,11,2,2,0,99.98015085
ad106583e804914433e0ff9d3644b6e8894d821c,1,3,1,2,0,0,0,3,14,106,1,1,0,307,524,6,75,75,0,2584,2558,26,24,24,0,94.59938026
d82add658d2dd767680978e038501895005a3eb3,1,2,2,0,0,0,0,10,64,20,1,1,0,1630,525,7,490,490,0,11497,11486,11,149,149,0,100
d037890f7410c1d3f96d87ad876726578b43c61c,3,82,43,39,0,0,0,2,21,553,2,2,1.33114941,563,31,0,154,144,10,3984,3838,146,77,71,6,100
5d6a881a43965f778ed623c7755dd8737b538a88,1,71,18,53,0,0,0,3,3,995,1,1,0,182,32,1,15,7,8,1808,1507,301,10,7,3,99.85604306
3cd8c4c6f0bbc7e37be3c8fc45b84aff44bee4b1,2,19,72,53,0,0,0,3,16,198,2,2,0.152406999,713,33,2,189,197,8,4799,5101,302,33,36,3,99.85604306
bdb1e5d6f2984ec3b7e5e6c84c9595bba25e693b,1,3,6,3,0,0,0,2,4,48,1,1,0,75,526,8,7,8,1,395,415,20,3,3,0,99.99374687
c043302e1e6c90d2859ae5833f455a53a3c62bd8,1,12,7,5,0,0,0,11,83,25,1,1,0,1387,527,9,365,365,0,9127,9151,24,225,225,0,100
8df8d0234e473bdc930be9570e8e27e837dcbaeb,0,0,0,0,0,0,0,0,0,0,0,0,0,0,44,2,0,0,0,0,0,0,0,0,0,100
4fb3371debaf3e20ebe4f63d1f4f89834d634681,0,0,0,0,0,0,0,0,0,0,0,0,0,0,45,3,0,0,0,0,0,0,0,0,0,100
1a4362eb7e01c5ed9c03b5d3125a62b680c4c004,0,0,0,0,0,0,0,0,0,0,0,0,0,0,93,0,0,0,0,0,0,0,0,0,0,100
2c397e9306ee00217289167c0440da09aeac4ed4,0,0,0,0,0,0,0,0,0,0,0,0,0,0,94,1,0,0,0,0,0,0,0,0,0,100
fe2c9295f430082c84a541215cd8c14e1e1f6f14,0,0,0,0,0,0,0,0,0,0,0,0,0,0,95,2,0,0,0,0,0,0,0,0,0,100
7b6c11a6cd8987e33b3f0cd5c77a16798471acf6,1,22,64,42,0,0,0,2,8,693,1,1,0,306,528,10,69,86,17,1643,1958,315,29,29,0,94.67785471
f738b0ba626c3ab8d5a402f80fe4684e6874e8a8,0,0,0,0,0,0,0,0,0,0,0,0,0,0,239,7,0,0,0,0,0,0,0,0,0,100
87b284b52b3d33ca351910bdeca85f30b38181a9,0,0,0,0,0,0,0,0,0,0,0,0,0,0,240,8,0,0,0,0,0,0,0,0,0,100
2f3da18be0fd56cb1cbd10a46bc97af0c8b9bd3d,3,24,12,12,0,0,0,6,22,402,3,3,1.510002757,404,529,11,101,98,3,2699,2563,136,39,38,1,100
a69c39c86976472e3d8e77a7ccb1c7ee607ceaac,0,0,0,0,0,0,0,0,0,0,0,0,0,0,241,9,0,0,0,0,0,0,0,0,0,100
88e32fb2ee1eaea6fa4a5a3bccc51f41d10d3b06,0,0,0,0,0,0,0,0,0,0,0,0,0,0,242,10,0,0,0,0,0,0,0,0,0,100
babda8d2186d065f2c4d5dfb5f2ec627960fe04a,0,0,0,0,0,0,0,0,0,0,0,0,0,0,96,3,0,0,0,0,0,0,0,0,0,100
e512e15ba03eb735f8ddc374969cafe4555c7143,0,0,0,0,0,0,0,0,0,0,0,0,0,0,243,11,0,0,0,0,0,0,0,0,0,100
9ec42334e97fc6e10c766b55dd9a74de192f9b46,1,9,6,3,0,0,0,1,2,9,1,1,0,27,244,12,3,2,1,200,174,26,2,2,0,100
a4c8f28e2cddda6d80a3e15d3e1be54cc2812bba,0,0,0,0,0,0,0,0,0,0,0,0,0,0,46,4,0,0,0,0,0,0,0,0,0,100
8fcc5e7896f147273a537132d18af2a45bde5b92,1,3,6,3,0,0,0,3,6,566,1,1,0,147,121,1,19,19,0,790,810,20,17,17,0,99.91704457
0086e25b8cf904a599529f8475c1cd1bf973e96e,1,4,2,2,0,0,0,2,4,822,1,1,0,317,97,4,35,35,0,2252,2228,24,6,6,0,100
52e2d925446c06995ebd0979eb1cf93160a8cc31,1,125,130,5,0,0,0,14,104,226,1,1,0,3735,122,2,1085,1085,0,23182,22944,238,283,283,0,100
b44715211e61211da14969d1dbdc73bae737bd08,1,17,0,17,0,0,0,11,84,14,1,1,0,1384,98,5,366,365,1,9170,9127,43,226,225,1,100
eb81fddc950687f413fa988b1a92f807fea9db59,1,4,1,3,0,0,0,6,15,115,1,1,0,290,99,6,23,23,0,2051,2064,13,19,19,0,100
127b7bec630ba2e6afa25aed7f56934ea52c186f,0,0,0,0,0,0,0,0,0,0,0,0,0,0,100,7,0,0,0,0,0,0,0,0,0,100
55509846c11d27067dd03232701e9c185b9edcba,0,0,0,0,0,0,0,0,0,0,0,0,0,0,245,12,0,0,0,0,0,0,0,0,0,100
fa4b72d7f50174238a6d97ead9a736b161271609,0,0,0,0,0,0,0,0,0,0,0,0,0,0,123,3,0,0,0,0,0,0,0,0,0,100
cda835d50bd2236de5c17551bcdadc77a7d37b4b,0,0,0,0,0,0,0,0,0,0,0,0,0,0,246,12,0,0,0,0,0,0,0,0,0,100
baa37056999ccc33666e36109cc1d9ed634c4c92,1,3,0,3,0,0,0,11,56,77,1,1,0,1192,101,8,362,362,0,8810,8810,0,97,97,0,100
11c299d895387ddeb9a89d22f50fed7ced69f2c1,0,0,0,0,0,0,0,0,0,0,0,0,0,0,247,13,0,0,0,0,0,0,0,0,0,100
7f319c44739aa96d4c54262c3c87d03ab857f3ec,4,92,0,92,1,0,1,2,34,295,1,2,1.520369482,1319,209,1,303,291,12,8601,8292,309,84,75,9,99.98893438
ff71a1c093fde27bd395854c42afb59cd1a56e9a,1,1,1,0,0,0,0,2,4,0,1,1,0,118,210,2,14,14,0,677,677,0,5,5,0,100
05e0669c0725cb01d125af9cc04032e2bc834990,1,24,0,24,0,0,0,3,12,247,1,1,0,322,173,0,12,9,3,1889,1726,163,9,8,1,100
0c76b25ef57b1079bcccbc5f7ae3dce17a21c5e7,14,592,11,581,7,0,7,1,5,199,1,1,3.032384452,509,128,0,132,69,63,4816,2477,2339,102,53,49,97.12607984
2d7d5599f33d77b856235bce1ea6363a9259bdc2,0,0,0,0,0,0,0,0,0,0,0,0,0,0,248,14,0,0,0,0,0,0,0,0,0,100
fb57d61322d65e42a65cb2661d69fe63eaaa2171,0,0,0,0,0,0,0,0,0,0,0,0,0,0,249,14,0,0,0,0,0,0,0,0,0,100
8ef5a5dda19ed0330b128a2022104e80325f4a21,2,6,0,6,0,0,0,1,2,0,1,1,1,97,129,1,10,10,0,419,391,28,8,8,0,100
428cbc0cae31b1546cd4228930bf4d81b42f1e06,0,0,0,0,0,0,0,0,0,0,0,0,0,0,250,15,0,0,0,0,0,0,0,0,0,100
1462290177b8a53919b6718a7fbf62c8c0371dbd,0,0,0,0,0,0,0,0,0,0,0,0,0,0,251,15,0,0,0,0,0,0,0,0,0,100
c28ffa7be15b25b914eefb897ec1d197ae028c01,0,0,0,0,0,0,0,0,0,0,0,0,0,0,252,16,0,0,0,0,0,0,0,0,0,100
6d53d755f78770a2d801ca1d4cc7de849be6238f,0,0,0,0,0,0,0,0,0,0,0,0,0,0,253,17,0,0,0,0,0,0,0,0,0,100
099d18901e5dd164c189f8b9538c9e80d3923569,0,0,0,0,0,0,0,0,0,0,0,0,0,0,254,18,0,0,0,0,0,0,0,0,0,100
0befad70511584e667396bf1f9d34d8c7de0f436,0,0,0,0,0,0,0,0,0,0,0,0,0,0,255,19,0,0,0,0,0,0,0,0,0,100
c9e2d17fd561f17e996e993c46682200b4b4cda9,0,0,0,0,0,0,0,0,0,0,0,0,0,0,256,20,0,0,0,0,0,0,0,0,0,100
be33af366ccef84a8767ceee03e99b171fc9ccff,2,117,188,71,0,0,0,3,16,927,2,2,0.747394446,378,34,3,49,48,1,1976,2316,340,18,21,3,100
ea49b4cc6abcbf3cb38468a01df4187151fa5498,7,445,1,444,6,0,6,1,9,17,2,3,2.509381927,124,211,2,60,28,32,2232,1018,1214,38,6,32,99.91935484
daae61a6f50a98dddaf649d919d2a46e55567802,1,9,5,4,0,0,0,10,65,26,1,1,0,1630,257,21,491,490,1,11514,11497,17,149,149,0,100
8f32071a8bcb95b68e0c7c93314c0c8d9dbb1bc2,0,0,0,0,0,0,0,0,0,0,0,0,0,0,258,22,0,0,0,0,0,0,0,0,0,100
7b1ee0cbcc329b4cd2d92a3ab942a13b7de35d00,0,0,0,0,0,0,0,0,0,0,0,0,0,0,259,23,0,0,0,0,0,0,0,0,0,100
767f670490e9d73ab8b6ca0c21a3b9d9f4d398af,1,10,9,1,0,0,0,4,11,47,1,1,0,115,35,4,30,29,1,693,689,4,13,13,0,100
9a4fe698c2a83698c301e0fe7635898c8b41a7a0,0,0,0,0,0,0,0,0,0,0,0,0,0,0,260,24,0,0,0,0,0,0,0,0,0,100
06d3e4e65d355589e258f00e3dd995606f1863b0,10,644,0,644,10,0,10,1,1,0,1,1,3.270083745,0,261,25,80,0,80,1916,0,1916,62,0,62,99.87353415
eca02573ba17e8e09bd0cf7120b87becd6f2646f,3,83,7,76,0,0,0,4,22,23,2,2,1.373017485,669,36,5,195,175,20,5028,4577,451,78,71,7,97.21301343
32fe994aeafe6fb785db3703d5305ddaedf22247,0,0,0,0,0,0,0,0,0,0,0,0,0,0,262,26,0,0,0,0,0,0,0,0,0,100
4cb276067a472a4ff08636c208fff523bd38dced,1,5,2,3,0,0,0,5,22,136,1,1,0,116,263,27,12,12,0,746,698,48,10,10,0,99.98349381
d96883f5029fdca609a5871e1641433a01ec72e3,0,0,0,0,0,0,0,0,0,0,0,0,0,0,264,28,0,0,0,0,0,0,0,0,0,100
ad4168b8d44ab037d3c29fe5598c895a73b693d2,11,558,113,445,2,0,2,1,5,158,1,3,2.421172619,874,265,28,235,191,44,7133,4621,2512,101,86,15,95.0472172
4d25d3fa214849ebce96db0fdaf8646070d7e505,1,11,13,2,0,0,0,2,3,8,1,1,0,354,266,29,48,47,1,2500,2513,13,19,18,1,100
42769bd9d801d129fbeda514ea32efbcafbcdab7,0,0,0,0,0,0,0,0,0,0,0,0,0,0,267,29,0,0,0,0,0,0,0,0,0,100
c1a32728724dec004e04aad8d7896e87508e1bf0,1,1,1,0,0,0,0,3,17,134,1,1,0,277,530,6,70,70,0,2177,2169,8,21,21,0,100
11149ec5fba76796f2d3d9a2a8d26d7782d74a99,1,13,13,0,0,0,0,2,14,689,1,1,0,320,531,7,89,89,0,2011,2001,10,36,36,0,100
18a1a04c773dd5c3e2288173f64f58f822cefb50,4,304,24,280,3,0,3,2,4,0,1,2,1.883675461,353,268,29,85,48,37,3695,2500,1195,44,19,25,99.96766594
208f5388ce42e99b77e0cec560ac141680a56ee3,1,37,5,32,0,0,0,6,20,135,1,1,0,270,130,2,58,53,5,1716,1549,167,19,17,2,100
2abde241c030c87fc187adc7dabe2728257d479e,1,117,29,88,0,0,0,2,5,0,1,1,0,400,269,30,72,57,15,3656,3060,596,23,22,1,100
06e6582ab859de863a192f05665d59dfb6256448,1,0,3,3,0,0,0,11,88,51,1,1,0,1363,324,0,300,300,0,8283,8295,12,249,249,0,100
3aea82e40c85ff6d653095a797b00a189681d64f,1,7,0,7,0,0,0,10,32,148,1,1,0,456,270,31,131,129,2,2936,2896,40,44,44,0,100
a515a71fec4d9b083061d3cd0c0e0f9067f2e17a,1,16,10,6,0,0,0,9,70,57,1,1,0,1739,37,5,567,565,2,11629,11605,24,162,162,0,100
8248d81a683ff3a23cccfee3394e5784bdf14760,2,35,1,34,0,0,0,6,42,123,2,2,0.41381685,3158,212,3,465,461,4,19903,19747,156,250,250,0,100
64be0455c3a675b20662303b832d6e6efa25fb97,3,58,6,52,0,0,0,3,88,377,2,3,1.351759324,4391,38,6,1362,1352,10,30451,30228,223,402,400,2,100
6d61c562f5b752f5b1dad2f8d73d21f909ae9c8d,0,0,0,0,0,0,0,0,0,0,0,0,0,0,271,32,0,0,0,0,0,0,0,0,0,100
e9f305f700478876aa71dcda3f9163a74c981c02,0,0,0,0,0,0,0,0,0,0,0,0,0,0,272,33,0,0,0,0,0,0,0,0,0,100
76d184c106b6e4e191549412f0d7513b82b950da,8,142,2,140,1,0,1,3,105,897,2,5,2.306696013,5932,39,7,1739,1720,19,37789,37174,615,499,493,6,99.99076554
e71cd295fcb912db12fa9d51e3a451fc2ffa2859,1,4,2,2,0,0,0,11,85,27,1,1,0,1400,532,4,367,366,1,9182,9170,12,226,226,0,100
0bd96d988008081c0ee99df148cfd0f29a9668d1,0,0,0,0,0,0,0,0,0,0,0,0,0,0,273,34,0,0,0,0,0,0,0,0,0,100
73d4992a2f9898a84a252d258e0ef176b939964b,2,113,18,95,1,0,1,1,106,2,1,1,0.687040806,3758,40,6,1100,1093,7,23644,23368,276,288,284,4,95.76015067
a1ad33d72a0e8f68e514ae2af34258703e9313f8,1,4,1,3,0,0,0,14,107,0,1,1,0,3748,41,7,1090,1089,1,23311,23295,16,284,284,0,100
1950c467f79c218b83fd62af903def3b7983a0a8,1,12,0,12,0,0,0,3,44,216,1,1,0,488,533,3,144,142,2,3471,3442,29,61,60,1,100
a7d613f3bfcbc8ac81ecebbb2eb4ef826fb50045,1,2,1,1,0,0,0,1,10,430,1,1,0,181,534,4,44,43,1,1154,1133,21,35,35,0,100
4dc0267629dc422f7cd7b955b139073a6166a5d7,10,369,6,363,2,0,2,8,108,232,4,4,2.910118802,7249,325,1,2056,2015,41,46046,44625,1421,684,653,31,99.97917274
b074cd80c86dbebfaad5795a1ee81569a3c23b24,2,37,1,36,0,0,0,1,2,0,1,1,0.998000884,116,326,2,16,16,0,733,733,0,14,14,0,100
b0eefe6ea806dd9ca5681ff3783677edf9b1b37c,3,21,17,4,0,0,0,1,109,157,1,2,1.021455466,4094,42,8,1172,1171,1,25741,25696,45,303,303,0,100
bb538f49f9478e4aef3029fda91940c5f849b2ff,1,2,1,1,0,0,0,2,3,0,1,1,0,69,274,29,12,12,0,387,387,0,4,4,0,100
b9a230567ec725cd06f5c0db326572907f42ea52,4,398,14,384,2,0,2,3,27,281,2,3,1.364718292,766,275,30,263,212,51,7195,5251,1944,73,51,22,99.97918141
b01f5718f9ee88246f3f771c7b63306802732ce7,0,0,0,0,0,0,0,0,0,0,0,0,0,0,47,0,0,0,0,0,0,0,0,0,0,100
1c992feeb723b6e1b4464f7bdbf1a1961583124f,1,12,9,3,0,0,0,11,86,11,1,1,0,1402,124,2,368,367,1,9191,9182,9,227,226,1,100
04b5e77c9e65e8c689a3dd3ab25a81bf2d011c17,1,0,1,1,0,0,0,11,75,101,1,1,0,720,125,3,181,181,0,5015,5028,13,87,87,0,100
88f1168b81f10b3a5d8cfe0b0ef1caf62f49f4da,0,0,0,0,0,0,0,0,0,0,0,0,0,0,276,31,0,0,0,0,0,0,0,0,0,100
b59c7577416a0da6e0b450d8f9b8d7c965875488,0,0,0,0,0,0,0,0,0,0,0,0,0,0,277,32,0,0,0,0,0,0,0,0,0,100
d5fb93d98fb9f896dc50178b81defc64c546e56f,0,0,0,0,0,0,0,0,0,0,0,0,0,0,278,33,0,0,0,0,0,0,0,0,0,100
7a8052cd73010994913a7649a7f3db9ad4aadd2c,0,0,0,0,0,0,0,0,0,0,0,0,0,0,279,34,0,0,0,0,0,0,0,0,0,100
4b3d520ee9c59831beb199ff429d5783dffd6ce2,1,1,1,0,0,0,0,8,17,155,1,1,0,1446,280,35,406,406,0,10747,10747,0,117,117,0,100
045eb544de1a22761d7aa35b9da7571be21bc37e,1,1,1,0,0,0,0,6,10,418,1,1,0,82,281,36,18,18,0,473,473,0,5,5,0,100
97cd88adc357a99b97c27d0074a8fec46adee7a5,0,0,0,0,0,0,0,0,0,0,0,0,0,0,282,37,0,0,0,0,0,0,0,0,0,100
14996dfd406d3f59d6d106ca9f89faf753b18eea,1,1,2,1,0,0,0,7,10,349,1,1,0,1080,283,38,375,377,2,7381,7398,17,99,99,0,100
1873fcd3685125c77025e0015ea0dbfbc4fc2818,1,27,0,27,0,0,0,12,28,155,1,1,0,312,284,39,62,57,5,2347,2242,105,20,19,1,100
82694335ddfd450d60b34744a5345bebd99d992e,1,3,1,2,0,0,0,12,29,0,1,1,0,330,285,40,63,62,1,2361,2347,14,20,20,0,100
62092d763ad8d63b7e1b5d45c04d607632986c5b,56,173,172,1,0,0,0,4,138,1233,6,20,5.236526518,32555,327,3,9142,9142,0,227325,228154,829,2831,2831,0,100
c58af533fb565d92f7a514749d05a957b6530fc5,57,0,57,57,0,0,0,4,139,21,6,20,5.832890014,32600,328,4,9147,9147,0,227083,227482,399,2836,2836,0,100
dbe6745966ccd57b016ce50743abe43d918a83b9,1,2,1,1,0,0,0,8,16,70,1,1,0,237,286,41,42,42,0,1137,1135,2,13,13,0,100
ce0886e110de5e2a772dd4d33f5f328aa4bcaba4,4,0,377,377,0,0,0,1,3,659,1,2,1.975148538,276,287,41,0,29,29,0,1453,1453,0,20,20,99.9625203
4190dcc04aa2b7b6d03638ccdf44c4ff36e03293,0,0,0,0,0,0,0,0,0,0,0,0,0,0,288,42,0,0,0,0,0,0,0,0,0,100
4cc1f6478e6dd6d130ab3b2471918e386d0ac864,0,0,0,0,0,0,0,0,0,0,0,0,0,0,289,42,0,0,0,0,0,0,0,0,0,100
4c2f53856e7d886d7fd75baf4ac8887b0a520359,0,0,0,0,0,0,0,0,0,0,0,0,0,0,290,43,0,0,0,0,0,0,0,0,0,100
65b496cd9858d1d65147a4d023d83dbe0d2e541d,0,0,0,0,0,0,0,0,0,0,0,0,0,0,291,44,0,0,0,0,0,0,0,0,0,100
f50f847e97433bc508b5eff7c8e65e036a3ab354,0,0,0,0,0,0,0,0,0,0,0,0,0,0,292,45,0,0,0,0,0,0,0,0,0,100
1446c7148e4a597da6aa84760ab50ddf4f3686de,0,0,0,0,0,0,0,0,0,0,0,0,0,0,293,46,0,0,0,0,0,0,0,0,0,100
9b578759ab89e9cf4a17ea78269b6eb9f58a0d94,0,0,0,0,0,0,0,0,0,0,0,0,0,0,294,47,0,0,0,0,0,0,0,0,0,100
2ed0ca3621d1c030fea44ff0656b54eb4a3f78ee,0,0,0,0,0,0,0,0,0,0,0,0,0,0,295,48,0,0,0,0,0,0,0,0,0,100
33ffb3f8c7fa4790b6f8e29127314ba379e2d94f,0,0,0,0,0,0,0,0,0,0,0,0,0,0,296,49,0,0,0,0,0,0,0,0,0,100
2e9c54f6f67ab38129bfb14b082742c06f439049,0,0,0,0,0,0,0,0,0,0,0,0,0,0,297,50,0,0,0,0,0,0,0,0,0,100
5d7e949803352c5977a3cc1ea1a9abd99bad6bde,0,0,0,0,0,0,0,0,0,0,0,0,0,0,298,51,0,0,0,0,0,0,0,0,0,100
0f62a7de1b9c4fe0085fdf526c1920400e44127f,0,0,0,0,0,0,0,0,0,0,0,0,0,0,299,52,0,0,0,0,0,0,0,0,0,100
17652a870b6f082cbe7980fd50c57670aec397cf,1,1,1,0,0,0,0,13,30,2,1,1,0,332,26,0,63,63,0,2361,2361,0,20,20,0,100
5cb14fe384cf59d2612817ec4c3f1c62e17dd611,2,51,18,33,0,0,0,11,76,32,2,2,0.955758991,791,535,5,192,188,4,5554,5410,144,91,90,1,100
1a12b393df4fc08f6ae8d6c6e9d32cbde2b04e88,0,0,0,0,0,0,0,0,0,0,0,0,0,0,300,53,0,0,0,0,0,0,0,0,0,100
0829f46fb379bf6748637389aaaa1d9b6c286a90,0,0,0,0,0,0,0,0,0,0,0,0,0,0,301,54,0,0,0,0,0,0,0,0,0,100
47453d205e71cb2ba3f6ca74fd2ea9bec5e35245,0,0,0,0,0,0,0,0,0,0,0,0,0,0,302,55,0,0,0,0,0,0,0,0,0,100
2b811429d596b1358921a542a71c1927c7317ecf,0,0,0,0,0,0,0,0,0,0,0,0,0,0,303,56,0,0,0,0,0,0,0,0,0,100
8e4fa80e8022e776ad071f66c6f5ea2984de6333,0,0,0,0,0,0,0,0,0,0,0,0,0,0,304,57,0,0,0,0,0,0,0,0,0,100
e2ba35c93ae5bc017dea8b4164eee74cb33e7b52,0,0,0,0,0,0,0,0,0,0,0,0,0,0,305,58,0,0,0,0,0,0,0,0,0,100
6c8a69cc9a4ed0a63e98312eb772af9349795a0a,0,0,0,0,0,0,0,0,0,0,0,0,0,0,306,59,0,0,0,0,0,0,0,0,0,100
719777606602967a4767dfa549a0df08f3c3bb48,0,0,0,0,0,0,0,0,0,0,0,0,0,0,307,60,0,0,0,0,0,0,0,0,0,100
4ba06b4fd74454b306bbbb8eab8cb3e6eed6a3a7,0,0,0,0,0,0,0,0,0,0,0,0,0,0,308,61,0,0,0,0,0,0,0,0,0,100
ec5d3f555a832417cc72236d5163c2f306232e64,0,0,0,0,0,0,0,0,0,0,0,0,0,0,309,62,0,0,0,0,0,0,0,0,0,100
4092ab72c410bc386a11f5f6d299be3fc57ef5ba,0,0,0,0,0,0,0,0,0,0,0,0,0,0,310,63,0,0,0,0,0,0,0,0,0,100
307b9860f99efa6249fe43cefcbb2f7da5927b98,0,0,0,0,0,0,0,0,0,0,0,0,0,0,311,64,0,0,0,0,0,0,0,0,0,100
470eb431c39f35fbd56c1838280cbc05aa8ad37f,0,0,0,0,0,0,0,0,0,0,0,0,0,0,312,65,0,0,0,0,0,0,0,0,0,100
9a9e0e7f39e1c025001582121b5d75ac51185ce0,0,0,0,0,0,0,0,0,0,0,0,0,0,0,313,66,0,0,0,0,0,0,0,0,0,100
1580b38bee30b04c282e224d2a19d7739cc3e174,0,0,0,0,0,0,0,0,0,0,0,0,0,0,314,67,0,0,0,0,0,0,0,0,0,100
92d7ab6ddd745727f0ac38dcae7652c35bdc2b50,0,0,0,0,0,0,0,0,0,0,0,0,0,0,315,68,0,0,0,0,0,0,0,0,0,100
7a34bebe02cf5670074f4963af2dd3e7c1d0514f,0,0,0,0,0,0,0,0,0,0,0,0,0,0,316,69,0,0,0,0,0,0,0,0,0,100
a70226302e20f3194ce4f2d7666fbda68c260b32,0,0,0,0,0,0,0,0,0,0,0,0,0,0,317,70,0,0,0,0,0,0,0,0,0,100
cfc51799bff6344ab4aff29efff0e09fe75cc849,0,0,0,0,0,0,0,0,0,0,0,0,0,0,318,71,0,0,0,0,0,0,0,0,0,100
1104ca0fd94988a2160eae77037994d956fdf5f4,0,0,0,0,0,0,0,0,0,0,0,0,0,0,319,72,0,0,0,0,0,0,0,0,0,100
a10f53323f6b0012f963ba02fcf8f602869c4acc,0,0,0,0,0,0,0,0,0,0,0,0,0,0,320,73,0,0,0,0,0,0,0,0,0,100
5a014cc6cdfa5475f4869e2cb3b2a2046f6151af,0,0,0,0,0,0,0,0,0,0,0,0,0,0,321,74,0,0,0,0,0,0,0,0,0,100
1623f149725b954b779415274b6a4ed1c5b9d8c3,0,0,0,0,0,0,0,0,0,0,0,0,0,0,322,75,0,0,0,0,0,0,0,0,0,100
e1e697da054a9ff342b720541ee3b414109861c3,0,0,0,0,0,0,0,0,0,0,0,0,0,0,323,76,0,0,0,0,0,0,0,0,0,100
ef6e9d8cf18cb630fd79dbf277b9dacce688fb8b,0,0,0,0,0,0,0,0,0,0,0,0,0,0,324,77,0,0,0,0,0,0,0,0,0,100
4d33d1bcc864e8e08aeca6df8c3e765955feaf8e,0,0,0,0,0,0,0,0,0,0,0,0,0,0,325,78,0,0,0,0,0,0,0,0,0,100
3067690ac6738c4defd9055523139bc1a797ba7b,0,0,0,0,0,0,0,0,0,0,0,0,0,0,326,79,0,0,0,0,0,0,0,0,0,100
50458736d8d3bf2e3af73112cc37761c1e6bb6e4,0,0,0,0,0,0,0,0,0,0,0,0,0,0,327,80,0,0,0,0,0,0,0,0,0,100
3fe201a5425f43b293b42a5bdd28678957582e21,0,0,0,0,0,0,0,0,0,0,0,0,0,0,328,81,0,0,0,0,0,0,0,0,0,100
8599f5290a6a5b9e83c275cdf8b97fce881d7072,0,0,0,0,0,0,0,0,0,0,0,0,0,0,329,82,0,0,0,0,0,0,0,0,0,100
a140e82bcf4f625fc9cb13ce98568217ef0f1042,0,0,0,0,0,0,0,0,0,0,0,0,0,0,330,83,0,0,0,0,0,0,0,0,0,100
8c8cd98a655144d072b6849eb42108435a3ebed8,0,0,0,0,0,0,0,0,0,0,0,0,0,0,331,84,0,0,0,0,0,0,0,0,0,100
695bd9c4bf3b1e71db0da472d351a8d5806d5529,3,127,34,93,0,0,0,5,22,688,2,2,1.178676565,1972,332,84,450,445,5,12139,11919,220,219,215,4,100
f82184314ec6a914ce5ca9c3b8fbfa9cab31e276,1,3,3,0,0,0,0,5,15,0,1,1,0,270,333,85,60,60,0,1622,1622,0,15,15,0,100
137ad1bacc9ae57248e0339dd4252b3efc833fca,2,53,8,45,0,0,0,3,89,33,2,2,0.928839146,1439,43,9,316,309,7,8998,8747,251,255,254,1,100
2798b0dd7304466fea04bff576188ea23ef7e05b,4,198,3,195,2,0,2,4,6,458,2,2,1.826134774,315,213,2,52,33,19,3681,2865,816,34,20,14,99.97917448
f69da242687ffaeec7840c587f6f658e2f3cb283,5,124,10,114,1,0,1,11,82,465,3,3,2.03240509,3220,214,3,974,957,17,21811,21413,398,216,209,7,99.97503121
6234dbddfcb8b17ed3f50221517d5c3823097a5e,1,12,0,12,0,0,0,2,3,587,1,1,0,72,131,1,4,3,1,407,341,66,2,2,0,100
dd210a2831e005f3f51ec85b00ae56699ecde27a,5,257,5,252,4,0,4,1,10,8,2,2,2.103394957,124,329,5,45,28,17,2048,1018,1030,17,6,11,99.84624335
0c65e3c409fe83da4d6c91c6512307c2206047d8,0,0,0,0,0,0,0,0,0,0,0,0,0,0,334,75,0,0,0,0,0,0,0,0,0,100
f0f89c7e0ed53647ae08b425f10e68536d4ba0ab,1,5,2,3,0,0,0,11,77,7,1,1,0,717,536,6,184,182,2,5052,5007,45,87,87,0,100
572d5934274a7f8961e12e3372f5f10f8cdff9d5,1,3,3,0,0,0,0,11,87,13,1,1,0,1404,537,7,368,368,0,9200,9191,9,227,227,0,100
4be5a5a194e541059709c9efcdd07c26990ab673,16,319,154,165,1,0,1,4,140,572,5,7,3.071092,8400,538,8,2343,2315,28,60629,59557,1072,647,637,10,99.9875436
f04031edc128146bb7cfa52e072affb904930a43,6,45,36,9,0,0,0,5,45,138,2,3,2.536676057,2018,539,9,520,513,7,13461,13322,139,159,157,2,100
732ff354b38ef9335d4ccffc40eedc1a909059bd,1,12,0,12,0,0,0,2,6,758,1,1,0,153,540,10,28,26,2,1007,966,41,20,19,1,100
5fec1aaaa6f37977e631aa1382892a2d1de62d36,1,10,9,1,0,0,0,6,13,20,1,1,0,245,541,11,62,62,0,1897,1868,29,9,9,0,100
36b9628948cb746696204447d467105a3a67f0bd,0,0,0,0,0,0,0,0,0,0,0,0,0,0,335,70,0,0,0,0,0,0,0,0,0,100
6503eabef5327eaf3c20965d75ad086c3c4480dd,1,3,2,1,0,0,0,5,16,8,1,1,0,270,174,0,60,60,0,1622,1622,0,15,15,0,100
7c748e62df7235c4030e9b936759b0108ddc5c81,4,159,10,149,2,0,2,1,54,22,1,2,1.841404062,279,336,71,57,44,13,2213,1820,393,25,18,7,99.96264165
e2df6f49e485380d9b462b486242205fec61a052,1,5,1,4,0,0,0,11,30,167,1,1,0,705,175,1,141,140,1,4434,4409,25,87,87,0,100
8f45b5bf0b20c1e371874defd0b9c20b6c0f58fa,1,7,3,4,0,0,0,11,31,0,1,1,0,708,176,2,142,141,1,4453,4434,19,87,87,0,100
d69fb9a65af2ef739981033a7e755f6b6bde7e2f,4,121,3,118,2,0,2,4,7,4,2,2,1.619728995,358,215,3,48,40,8,3694,3283,411,29,22,7,99.97925397
8f236c2aeb8ccdda45cb28505c81fa311c96541e,0,0,0,0,0,0,0,0,0,0,0,0,0,0,48,1,0,0,0,0,0,0,0,0,0,100
f05db496429bd707bca88ba53758c7028913da90,0,0,0,0,0,0,0,0,0,0,0,0,0,0,49,2,0,0,0,0,0,0,0,0,0,100
971c1fb5d42ce68ad69ae62498925d7ff5f99b2a,0,0,0,0,0,0,0,0,0,0,0,0,0,0,337,70,0,0,0,0,0,0,0,0,0,100
b9d83ae33a9a7d0ef5780045d63fe08bcfd67d29,0,0,0,0,0,0,0,0,0,0,0,0,0,0,126,2,0,0,0,0,0,0,0,0,0,100
d1b0d0fd6d376a381a0e7b6fd0f87b5222a86c69,3,79,7,72,0,0,0,7,62,102,2,3,1.431201825,2088,542,10,613,596,17,14183,13834,349,214,210,4,99.98340456
efa6e5428e6354c83825cb038dd1cf9ecfd8364f,3,155,2,153,1,0,1,3,20,309,1,1,1.132307818,822,543,11,133,116,17,7153,6315,838,79,69,10,98.95579116
9c09bc3728e1f57ebb27f7c9995ea2b3b1c64a79,0,0,0,0,0,0,0,0,0,0,0,0,0,0,50,3,0,0,0,0,0,0,0,0,0,100
a5ca9aae2d5160fb463bd7a619e999732d222f31,4,61,23,38,0,0,0,3,55,366,2,3,1.643138607,3932,177,3,523,518,5,33958,33673,285,256,255,1,100
b85c4e30fa0b03bc6c717e0370917662d9d64b5d,10,4116,0,4116,10,0,10,1,1,0,1,1,3.010065868,0,338,67,518,0,518,17475,0,17475,278,0,278,99.91511036
8a1e0307f242cc5b035db140c36ac134008a8aab,0,0,0,0,0,0,0,0,0,0,0,0,0,0,339,68,0,0,0,0,0,0,0,0,0,100
845f9b50187f2a14ceb3826561945edb8742988e,3,17,3,14,0,0,0,11,88,17,3,3,1.156779649,3434,544,12,1004,1004,0,23375,23324,51,416,416,0,100
6d87bbdbb0d3571cf0e28f77273b1aab0cc79a2d,3,35,14,21,0,0,0,11,89,305,3,3,1.584365593,1724,132,1,385,381,4,11816,11639,177,239,238,1,100
f3b00d780109213bcef19166ae5d1894cab84c9f,1,2,0,2,0,0,0,13,84,12,1,1,0,768,545,13,183,181,2,5316,5299,17,43,43,0,100
a99ea6218f5898e37e8a6965f812976bd3362b7e,4,48,32,16,0,0,0,3,28,400,2,4,1.458105549,1049,340,69,269,269,0,7272,7186,86,66,66,0,100
992ba73a7156efe8349639adcec7e714b359b99a,10,37,52,15,0,0,0,7,141,9,3,4,2.046366968,6841,546,14,1807,1809,2,49103,49180,77,481,481,0,100
c618b4692d777a239bbf5e3788175b3f9acf0e02,0,0,0,0,0,0,0,0,0,0,0,0,0,0,330,5,0,0,0,0,0,0,0,0,0,100
8dc74c1e5972eeb1673b9767f0e93f0d8576649a,1,7,1,6,0,0,0,5,18,12,1,1,0,172,547,15,55,54,1,1225,1192,33,12,12,0,100
0f5508e6804db6fb1e8ee3087dd0dc41a48e6a4f,1,8,8,0,0,0,0,3,19,2,1,1,0,295,548,16,78,78,0,2318,2312,6,22,22,0,100
e56be85085acfc32977ddd3dc1bbb63c2f7ebd71,2,3,3,0,0,0,0,1,29,0,2,2,0.650022422,881,341,70,235,235,0,6085,6102,17,46,46,0,100
db7390af622f9ac2efa56dc31f03e57904aeaa9b,0,0,0,0,0,0,0,0,0,0,0,0,0,0,51,4,0,0,0,0,0,0,0,0,0,100
6bc5ff8d3ca092a8e590915f56d47d84576020d1,0,0,0,0,0,0,0,0,0,0,0,0,0,0,52,5,0,0,0,0,0,0,0,0,0,100
4bff5d71e8219ea5f94437d146294130d86fa270,1,27,14,13,0,0,0,1,4,0,1,1,0,232,342,71,39,39,0,1657,1636,21,9,9,0,100
d386fa80679a41fad7b7cf5b6396f465d4d59ec5,0,0,0,0,0,0,0,0,0,0,0,0,0,0,53,6,0,0,0,0,0,0,0,0,0,100
3b15fe9e2d66895dbdb2d722ebcae175b98817c2,0,0,0,0,0,0,0,0,0,0,0,0,0,0,54,7,0,0,0,0,0,0,0,0,0,100
41ce320cc0436552a0d90dd53ba8e875680e5225,2,40,0,40,0,0,0,4,20,4,2,2,0.934068055,585,216,3,108,96,12,5523,5241,282,41,39,2,100
65385662b08df5d7fafc7819514c99a4b6b907a9,1,13,0,13,0,0,0,4,6,4,1,1,0,346,133,2,51,50,1,2478,2412,66,28,28,0,100
04bb0664750212b332720e87b5f273310a8ed1f6,1,13,2,11,0,0,0,3,5,803,1,1,0,212,134,3,42,40,2,1339,1301,38,10,10,0,100
63079316a001a44538183c03e657f7da5324d7c0,1,2,0,2,0,0,0,11,90,3,1,1,0,1408,549,16,371,370,1,9272,9250,22,227,227,0,100
976508eed24aed7dfdbb9b4894cb3bdc6f938e8e,1,192,250,58,0,0,0,2,4,16,1,1,0,339,550,17,38,60,22,2424,3017,593,7,5,2,100
1b20902b507ca7e7209132297266968a92e0d472,12,164,91,73,0,0,0,4,79,72,5,8,2.468934767,3701,551,18,918,898,20,23393,22873,520,392,388,4,100
2ebb6e475a803d4661c6182eb6722451bd63e966,1,12,0,12,0,0,0,7,20,649,1,1,0,363,552,19,114,107,7,2902,2766,136,24,23,1,100
cb895a2b25db52ebe4527a8845cf5a973dd9d54b,1,1,2,1,0,0,0,14,51,4,1,1,0,1030,553,20,266,267,1,7492,7498,6,53,53,0,100
4f11cba18a9009cb6e187df080358c3758c5006b,1,2,0,2,0,0,0,13,33,4,1,1,0,341,554,21,70,68,2,2456,2435,21,21,21,0,100
081baaa8568eb6a3514bcb7fbc87cab21be5be23,1,5,0,5,0,0,0,1,4,1,1,1,0,134,555,22,16,15,1,994,949,45,7,7,0,99.99614525
bd9b59c90f575b71a7167b48fadfb35ffa61449a,5,38,1,37,0,0,0,8,64,165,3,3,1.705472203,1209,331,6,263,257,6,7752,7637,115,127,124,3,100
8c1175054f028ef00d219c054b66fd6634eca020,7,239,13,226,3,0,3,1,142,311,2,4,2.119897677,3890,556,23,1138,1125,13,28865,28159,706,356,345,11,99.97302401
c864f5dfc024d01052d59f0f6f9fd1ab5c0c2710,1,2,4,2,0,0,0,2,2,0,1,1,0,49,135,4,4,4,0,132,146,14,4,4,0,100
15c64cb8f4db54346a10cc5c9183b3343db5c0b5,3,228,24,204,1,0,1,3,23,13,2,2,1.416375396,1260,557,24,274,260,14,10511,9498,1013,131,119,12,99.9845899
13e3c48caea0c7c8125b72f398f6443ce231902f,2,34,2,32,0,0,0,3,22,3,2,2,0.99107606,1222,217,4,209,202,7,9974,9715,259,96,93,3,100
73b7d4748b0e5d914cbe53ade826630a4b7fc650,0,0,0,0,0,0,0,0,0,0,0,0,0,0,558,23,0,0,0,0,0,0,0,0,0,100
9f326c0f8bd5a8007b8f10bc17ee10db438ca615,1,10,4,6,0,0,0,3,23,2,1,1,0,921,559,24,116,116,0,7451,7412,39,71,71,0,100
4f9de8e360c8fcb2dda9100c01b2761a3ec21f5c,1,32,6,26,0,0,0,5,13,9,1,1,0,64,343,68,20,17,3,486,348,138,5,5,0,94.97644501
e6fc6fab0a4f45c81db5ffc8e2c3bcf76e1478ee,1,6,0,6,0,0,0,2,2,3,1,1,0,67,127,3,4,3,1,391,374,17,3,3,0,100
1b9d80003a2ef71cdba8d49f63f8ecf113fd9435,1,6,2,4,0,0,0,2,6,395,1,1,0,119,560,25,36,29,7,1026,937,89,10,10,0,95.91495736
148db96a8cea463537ffa4a530694e45de5820bf,5,61,2,59,0,0,0,12,65,98,1,3,1.609511555,4610,178,4,1394,1381,13,32670,32253,417,563,561,2,100
43c4cff942f56fafcfeda67d7a0a25349066b90c,2,4,6,2,0,0,0,3,91,5,1,1,0.970950594,1533,102,0,404,407,3,10253,10298,45,237,237,0,100
da262a651acda143a47b9eb77ee43bc85aa10699,0,0,0,0,0,0,0,0,0,0,0,0,0,0,179,5,0,0,0,0,0,0,0,0,0,100
c20a4ef30344f65b02a4b64be39cc303a07b0b5c,1,8,6,2,0,0,0,2,4,47,1,1,0,70,44,1,13,12,1,399,387,12,4,4,0,100
773eefc3135294aa18d1122483e8a1d1b82f0c53,1,14,4,10,0,0,0,5,14,8,1,1,0,84,344,64,20,20,0,453,486,33,5,5,0,93.76015236
7c613e69d1b26903589801c66be412014e740627,0,0,0,0,0,0,0,0,0,0,0,0,0,0,345,64,0,0,0,0,0,0,0,0,0,100
28d495e14b0bf223709c6c999132237cbc6b3c05,0,0,0,0,0,0,0,0,0,0,0,0,0,0,346,63,0,0,0,0,0,0,0,0,0,100
72d0c20634f3be0c5e033416435aa0d2bdfa9137,1,1,1,0,0,0,0,7,15,1268,1,1,0,255,45,2,64,64,0,1685,1684,1,19,19,0,100
87ea1de7c25579249ae3c8ac0b9985b39a88515b,1,4,0,4,0,0,0,13,91,41,1,1,0,2402,46,3,773,772,1,16122,16109,13,226,225,1,100
201d680a0db05dacef0c9d8635e9eb6cfe546c59,1,15,6,9,0,0,0,5,7,14,1,1,0,356,128,2,52,51,1,2554,2478,76,28,28,0,100
94a1323dfb8852fb8bfcc7dcde9a029e579b0872,0,0,0,0,0,0,0,0,0,0,0,0,0,0,347,62,0,0,0,0,0,0,0,0,0,100
86546e1e12ef3eea9bb9bf50ead0a575e299aa44,0,0,0,0,0,0,0,0,0,0,0,0,0,0,348,62,0,0,0,0,0,0,0,0,0,100
1c0abb52070ad23a1092603ad97f8a18bc0ffce3,7,64,42,22,1,0,1,1,23,104,3,3,1.875486615,946,47,4,215,189,26,6182,5333,849,83,76,7,99.94268147
148522b8654af8288e9d8c569e887fedaac563dd,0,0,0,0,0,0,0,0,0,0,0,0,0,0,349,63,0,0,0,0,0,0,0,0,0,100
db10ada93e4990c41c7f6704c2d40c3cffbd97a6,0,0,0,0,0,0,0,0,0,0,0,0,0,0,350,63,0,0,0,0,0,0,0,0,0,100
a7c0b3e918f34cf715d70a095db781ab15b9a55e,0,0,0,0,0,0,0,0,0,0,0,0,0,0,351,64,0,0,0,0,0,0,0,0,0,100
73f1a0869ea27f2a7a7ffe9a87b2d97ae91ccf5d,0,0,0,0,0,0,0,0,0,0,0,0,0,0,352,65,0,0,0,0,0,0,0,0,0,100
676a2f74f6d47b501f6e8e16d5d08d5696162d0c,0,0,0,0,0,0,0,0,0,0,0,0,0,0,353,66,0,0,0,0,0,0,0,0,0,100
b5b65a7d4b086db94e544102d82e21a73ca6f1ae,0,0,0,0,0,0,0,0,0,0,0,0,0,0,354,67,0,0,0,0,0,0,0,0,0,100
8bf38a7feee25a6185227ff16f2ef987dd3bb3cb,0,0,0,0,0,0,0,0,0,0,0,0,0,0,355,68,0,0,0,0,0,0,0,0,0,100
3701538ff6e9f44c946a9613130e22e9e843060f,0,0,0,0,0,0,0,0,0,0,0,0,0,0,356,46,0,0,0,0,0,0,0,0,0,100
799f48c54a888d4696c42005000a1327751fa88e,0,0,0,0,0,0,0,0,0,0,0,0,0,0,357,47,0,0,0,0,0,0,0,0,0,100
d9f14ebd32811215b5003a567fca2d4c85ab689f,0,0,0,0,0,0,0,0,0,0,0,0,0,0,358,26,0,0,0,0,0,0,0,0,0,100
5df5db5ee89444abc7e9fe9d517e0941dfcef134,0,0,0,0,0,0,0,0,0,0,0,0,0,0,180,6,0,0,0,0,0,0,0,0,0,100
4efde73b40b2774f209f08659ec63fd1a1770c12,0,0,0,0,0,0,0,0,0,0,0,0,0,0,359,27,0,0,0,0,0,0,0,0,0,100
c4e1b1b339ce41b8b40687efe9e36cc0156c60bd,0,0,0,0,0,0,0,0,0,0,0,0,0,0,360,28,0,0,0,0,0,0,0,0,0,100
53dddbeb8f0468a1f0728cd3e08a7d9d9cd1c701,1,2,1,1,0,0,0,13,86,21,1,1,0,770,218,5,183,183,0,5326,5316,10,43,43,0,100
e6ba2e9ed9dc472f90708806dc55ecfb656bac82,1,4,4,0,0,0,0,3,24,12,1,1,0,925,219,6,116,116,0,7451,7451,0,71,71,0,100
b872b6a6fc188e156c076363a14fb25f8e979a5b,0,0,0,0,0,0,0,0,0,0,0,0,0,0,361,27,0,0,0,0,0,0,0,0,0,100
162b11b542c8a6f3ff8da50f601b3bf010439a3c,0,0,0,0,0,0,0,0,0,0,0,0,0,0,362,28,0,0,0,0,0,0,0,0,0,100
666ec6c6de38ba34062205f7d26913720eba8fa2,7,484,37,447,2,0,2,3,110,480,5,5,1.72548998,7206,332,2,1972,1921,51,46879,44898,1981,762,741,21,99.97395698
e88899d3a1f38886a0de96eed3c870f31d31beb3,33,2278,0,2278,33,0,33,1,1,0,1,2,4.074831364,0,363,28,241,0,241,9323,0,9323,125,0,125,99.60580913
048ffd924d61e9a7b5e90df207900ad325ad2bbb,2,91,9,82,0,0,0,11,93,13,2,2,0.436469817,1532,129,3,389,383,6,10831,10115,716,237,235,2,100
5835eb3b6e9a1b1dd7e848b28ea3c783a3295f8d,2,3,1,2,0,0,0,1,2,0,1,1,1,180,364,29,26,26,0,785,771,14,24,24,0,100
0010c931cf1aca125dfba3e1b581acdce934e1cf,1,10,0,10,0,0,0,11,94,0,1,1,0,1415,130,4,374,372,2,9378,9314,64,228,227,1,100
c0ad7b61a7ad75b66b312e1c518390862d88b4a4,8,328,69,259,0,0,0,11,67,254,3,7,1.574100198,4094,365,28,725,696,29,29424,27954,1470,307,302,5,93.80481847
9a75bfe59d777f068a59e6ebe01168f0a08b32d5,1,2,0,2,0,0,0,1,2,6,1,1,0,75,366,29,12,12,0,284,270,14,12,12,0,100
a9648ec87e0414f0b27cf43fd562d85864c8f48f,1,1,1,0,0,0,0,4,8,212,1,1,0,134,367,30,15,15,0,781,779,2,7,7,0,100
cb0ca8f009a53d1856ec082674b35714c355407f,2,5,1,4,0,0,0,1,9,3,2,2,0.918295834,187,368,31,21,21,0,992,973,19,13,13,0,100
3df86b0e95cf008678785f5dd8671ab1154dad1c,3,4,75,71,0,0,0,1,30,10,2,3,0.574261185,1730,369,32,387,394,7,11804,12178,374,81,83,2,100
371a31a41a78267170b4af8958578d291e074d5d,1,13,4,9,0,0,0,5,16,7,1,1,0,117,370,32,26,26,0,614,614,0,5,5,0,100
137071d9bfc47db884eefa7a48f7dfe38a9a34f7,0,0,0,0,0,0,0,0,0,0,0,0,0,0,371,33,0,0,0,0,0,0,0,0,0,100
b1a2190cf331462d5c6686df87588541f5bb8038,1,2,0,2,0,0,0,11,80,35,1,1,0,722,561,17,187,186,1,5082,5069,13,88,88,0,100
8abf57d913548526a24da7e321de62b45d03ba54,1,1,1,0,0,0,0,11,60,31,1,1,0,1264,562,13,379,379,0,9369,9367,2,100,100,0,100
8579593f885360d74cf4d7d9cdbf7f5af3ebbbc3,16,398,172,226,2,0,2,4,111,218,4,7,3.357649838,10008,333,2,2485,2453,32,64494,63444,1050,834,814,20,99.95802099
0df0c0142ff78f73934a03cdbc4655eeebbc0bc7,1,8,9,1,0,0,0,5,17,5,1,1,0,126,372,29,26,26,0,614,614,0,5,5,0,100
123dd7b51b896fb327c6a8a4b3b8f414b3772c85,1,39,10,29,0,0,0,4,4,922,1,1,0,282,0,0,48,45,3,2149,1956,193,25,25,0,100
709bf862abc3207f3b13be381acebd297abb42a2,3,25,23,2,0,0,0,9,47,88,1,2,0.882039021,1413,563,12,438,435,3,9314,9284,30,130,129,1,100
6f6e94df7614a48410abe9366e375abbce7bf312,4,17,6,11,0,0,0,11,83,406,2,2,1.685117934,4005,564,8,1182,1181,1,26874,26818,56,324,322,2,100
e36547dafcfd58c3de02ffc8f86d686e73b4eec0,3,109,5,104,1,0,1,11,95,146,2,2,0.986870929,1505,565,8,394,384,10,10228,9724,504,246,238,8,98.28474453
670d59ef0f54aa196308d6114dc7a0b2eff28e4f,2,15,1,14,0,0,0,2,13,252,2,2,0.811278124,530,220,2,99,96,3,4767,4659,108,57,56,1,100
b2d71bbe4d829427a1e3ece3fa7e06d29069ef51,0,0,0,0,0,0,0,0,0,0,0,0,0,0,373,24,0,0,0,0,0,0,0,0,0,100
f03f7b4f61cf7470bbd690e458be189466c6b655,1,24,18,6,0,0,0,7,23,59,1,1,0,289,221,3,58,57,1,1710,1682,28,20,19,1,100
b382e52bbdc5f2c2bd655a7b809bc324cdbd8101,0,0,0,0,0,0,0,0,0,0,0,0,0,0,374,23,0,0,0,0,0,0,0,0,0,100
59cdb21326c40529904cc1997db9963fd0cf4b93,7,11,126,115,0,0,0,11,96,7,3,3,1.756934358,5603,48,0,1565,1576,11,36542,37102,560,560,570,10,98.28474453
50202d956b375ee91ca38fe4a0876d7157d20cd7,1,61,12,49,0,0,0,2,2,38,1,1,0,232,375,14,31,29,2,1859,1548,311,11,11,0,100
b2b922e1c80440c404d32454f05b8b871ca28ead,1,12,3,9,0,0,0,5,12,962,1,1,0,177,376,14,27,26,1,1197,1150,47,10,10,0,99.98800672
afa1e44f81246425dfe9caee7fe7f4027f171b6f,1,25,0,25,0,0,0,3,6,61,1,1,0,298,222,2,40,39,1,2565,2431,134,8,7,1,100
4555af14af5256c0c30d39646d69be7b67ec0ca7,1,11,1,10,0,0,0,13,87,44,1,1,0,771,131,2,185,183,2,5348,5326,22,43,43,0,100
684ae10b1d9ab0dc8501c96a50e78ef16fb12cde,1,30,2,28,0,0,0,5,56,67,1,1,0,1271,377,14,128,125,3,12875,12772,103,100,100,0,100
5e62924fcea45d08343a75abef142fdffd605130,1,47,14,33,0,0,0,2,5,60,1,1,0,139,378,15,25,16,9,1285,994,291,8,7,1,99.98800672
e16c8234641532a46bb43daf3b586b4155d4a05d,1,18,0,18,0,0,0,13,34,64,1,1,0,343,379,14,78,70,8,2586,2456,130,22,21,1,99.97602206
c6e4e39fe4ca9990db0bac79f5ee77ffe35071a5,1,1,0,1,0,0,0,13,35,0,1,1,0,359,380,15,78,78,0,2586,2586,0,22,22,0,100
1c76ad58a8ef40533e3185baf221e8d551359996,1,3,2,1,0,0,0,3,3,59,1,1,0,71,381,16,4,4,0,407,391,16,3,3,0,100
db11713e8cbace63e5f56c0030e288a3796a64b8,1,1,1,0,0,0,0,10,39,259,1,1,0,414,566,5,116,116,0,2540,2540,0,50,50,0,100
dbb66f4d943f02bf3f3ffadb8ac6bb1f85f7873d,1,19,2,17,0,0,0,2,6,2,1,1,0,168,382,17,28,25,3,1387,1285,102,8,8,0,100
43988aba97d8a7f3309da10edda2e9e267da1c1d,2,109,7,102,0,0,0,11,85,8,1,1,0.861487213,3107,49,1,960,947,13,21831,20902,929,201,199,2,100
8634acd32799725a1cc4ac52f5463df2e3a35f70,2,111,5,106,1,0,1,2,5,8,1,1,0.531340014,81,50,2,19,10,9,963,346,617,18,10,8,99.97603212
c924de842e3d46c3f7dddac027d6aa4b13c892fd,1,45,17,28,0,0,0,3,4,87,1,1,0,82,383,18,6,4,2,530,407,123,2,2,0,100
92914c0a6dfca79fa055949189e3b74a2f6210f5,1,3,2,1,0,0,0,2,15,114,1,1,0,320,567,6,89,89,0,2012,2011,1,36,36,0,100
20a07726f9aaf4b02955644e7f7a0e5db6939ed6,2,7,7,0,0,0,0,2,7,13,1,2,0.591672779,1461,384,19,131,131,0,9463,9474,11,62,62,0,100
f1027957008e82e5f01fd303020763d17e0b4b9d,1,7,4,3,0,0,0,3,5,0,1,1,0,103,385,20,8,6,2,564,530,34,2,2,0,100
9fd0cadd87492061af2e866367c46918a9dc0249,1,0,3,3,0,0,0,2,8,0,1,1,0,181,386,21,28,28,0,1376,1376,0,8,8,0,100
f8b8ce8eb0796a4083a73742a573bf3bb313548d,1,44,43,1,0,0,0,1,11,384,1,1,0,119,568,7,25,25,0,639,639,0,22,22,0,100
e247f789229bf5bbd9314e2b73ddabd614e4fa03,1,9,1,8,0,0,0,5,7,967,1,1,0,152,387,22,28,28,0,983,1001,18,9,9,0,100
cfe2a0d236db28accf152e9c5289216370ec79ac,1,25,17,8,0,0,0,3,18,428,1,1,0,361,569,8,63,61,2,2443,2406,37,20,20,0,100
aefe784c94888c106f0c1aeb59e11b26f832dee0,5,379,0,379,5,0,5,1,1,0,1,1,2.187754513,0,1,1,30,0,30,1414,0,1414,27,0,27,99.9700545
f95ac63c8b804257c8483258b6691bc8124e83ed,1,1,1,0,0,0,0,3,19,0,1,1,0,366,570,9,63,63,0,2443,2443,0,20,20,0,100
26d306c232fb7944a594aba7f1917b40c576ab51,1,72,15,57,0,0,0,4,7,2,1,1,0,1279,388,23,110,103,7,8435,8087,348,54,54,0,100
aa0ba9078288d45b5daa0e448849b35662f82bc5,0,0,0,0,0,0,0,0,0,0,0,0,0,0,389,24,0,0,0,0,0,0,0,0,0,100
6ccd59c32bb3c3415ed527792a381052cf4b281f,2,37,16,21,0,0,0,1,20,391,1,1,0.509515718,440,571,10,80,77,3,2949,2875,74,28,27,1,100
ce0ffe84f24b591b79cc7fdc9f98fa970b118d6a,1,0,1,1,0,0,0,3,21,0,1,1,0,381,572,11,66,66,0,2513,2528,15,21,21,0,100
b9e87067b7abe800ff7a1bbc4133ddb1b663240b,0,0,0,0,0,0,0,0,0,0,0,0,0,0,390,25,0,0,0,0,0,0,0,0,0,100
53325aed75b92802f4649333e65fa16119402fb3,1,9,4,5,0,0,0,7,24,12,1,1,0,295,223,3,60,58,2,1746,1710,36,20,20,0,100
33e8df53bd3ea521634391064139938a0058364b,1,2,1,1,0,0,0,6,11,97,1,1,0,341,391,24,109,109,0,2332,2329,3,12,12,0,100
689f42f7aa657402ae217c81dadee45b2e86c967,1,8,8,0,0,0,0,14,112,32,1,1,0,3817,224,4,1105,1105,0,23750,23768,18,291,291,0,100
dab906385e2723423d5b9c243457ed2befc034cb,1,0,1,1,0,0,0,6,12,0,1,1,0,341,392,22,109,109,0,2332,2332,0,12,12,0,100
7188baa2c0049187c8a4b71cceff5fcd26616899,1,272,0,272,1,0,1,1,1,0,1,1,0,0,393,23,24,0,24,1401,0,1401,9,0,9,99.98802682
2fbfba07056212ce56e25a21a82eaf4a3204c648,0,0,0,0,0,0,0,0,0,0,0,0,0,0,394,24,0,0,0,0,0,0,0,0,0,100
0ca80f7f79b2f87e4c9f4c59342cbc731a499b6e,0,0,0,0,0,0,0,0,0,0,0,0,0,0,395,25,0,0,0,0,0,0,0,0,0,100
85b89a8701186b7b8587a45efb04298357aeddf1,1,10,165,155,0,0,0,3,22,8,1,1,0,380,573,11,42,66,24,1780,2513,733,13,21,8,100
6eb56facc2479ea03586f25df48e7cd9d56ecc1f,0,0,0,0,0,0,0,0,0,0,0,0,0,0,396,24,0,0,0,0,0,0,0,0,0,100
f90b0bb16fbc181b56c7e256de771bf6f21a0d7b,1,16,28,12,0,0,0,6,13,1129,1,1,0,221,51,3,33,33,0,1483,1501,18,11,11,0,100
8a034d671755a672ce2c77af3830c97c1216b5b7,3,40,4,36,0,0,0,3,7,434,2,2,1.201575179,363,225,5,53,45,8,2552,2290,262,33,31,2,100
1ddfdcef963583c0b085494bdfb74325f9991a8b,1,2,13,11,0,0,0,10,66,144,1,1,0,1631,52,4,489,491,2,11461,11514,53,149,149,0,100
cdc597a26bf5bcfd44213e5d57752db1bd3feccd,0,0,0,0,0,0,0,0,0,0,0,0,0,0,397,24,0,0,0,0,0,0,0,0,0,100
5de5b5136f764f222ba099ebb7f9e2ba22814c43,1,4,1,3,0,0,0,7,16,269,1,1,0,726,136,0,208,207,1,5370,5344,26,42,42,0,100
296752741ea0c158234ba031e5deae06336c83cd,1,21,21,0,0,0,0,3,23,9,1,1,0,276,574,8,42,42,0,1768,1780,12,13,13,0,100
82af197ca61412430929fb5c7eea0b5cccad24ac,0,0,0,0,0,0,0,0,0,0,0,0,0,0,398,25,0,0,0,0,0,0,0,0,0,100
191c7fd329c033dac447bf9f780b0b389f83a5aa,1,18,12,6,0,0,0,2,7,105,1,1,0,160,575,9,28,28,0,1041,1007,34,20,20,0,99.86236611
fb1808b2a34d9e4a7a8705ae99b5a2336482877c,1,4,3,1,0,0,0,2,8,0,1,1,0,162,576,10,28,28,0,1040,1041,1,20,20,0,100
53e63d202fe154126290cdcf79c21265226647f1,4,99,5,94,0,0,0,3,25,234,3,3,1.214188881,1454,577,11,251,233,18,10968,10719,249,144,127,17,100
4502c30b16b58d2342218e2fd24300494b08c5bf,1,83,0,83,1,0,1,1,1,0,1,1,0,0,578,12,9,0,9,393,0,393,4,0,4,99.92826399
5cbc3c4e3f640d4b235845c12fddc761265ffd14,0,0,0,0,0,0,0,0,0,0,0,0,0,0,399,26,0,0,0,0,0,0,0,0,0,100
72b145a562e517cce3d56e97d25280ddb03dee42,1,5,1,4,0,0,0,12,83,35,1,1,0,724,579,13,188,187,1,5101,5082,19,88,88,0,100
ba9dedd4d4854b34f15c47242fad406c4c0939db,0,0,0,0,0,0,0,0,0,0,0,0,0,0,400,22,0,0,0,0,0,0,0,0,0,100
58f33c2119805138f551e2b299ad332ca453e01f,0,0,0,0,0,0,0,0,0,0,0,0,0,0,53,4,0,0,0,0,0,0,0,0,0,100
0cfb656770842c5291bb906dcd5e1703ecd4d1bc,1,29,2,27,0,0,0,2,4,38,1,1,0,84,54,5,10,9,1,775,561,214,9,8,1,100
5e6d42a5bc5bd23d72f555e32060e1dfa3a844bd,1,5,2,3,0,0,0,13,88,42,1,1,0,781,226,3,185,185,0,5381,5348,33,43,43,0,100
2c9790e84f6668d810d2d71c0b568383dc9ebea9,4,544,0,544,3,0,3,1,13,287,1,2,1.199695666,480,401,22,202,126,76,5314,3315,1999,94,19,75,99.95820147
4791781de0d242437e306153c40c11a5231958e2,0,0,0,0,0,0,0,0,0,0,0,0,0,0,402,23,0,0,0,0,0,0,0,0,0,100
f35802f702a37f5d610c968ac3e1270ec669b741,3,0,541,541,0,0,0,1,2,0,1,1,1.156766751,426,403,24,0,75,75,0,1980,1980,0,75,75,99.95820147
fdb539d972405b8ed08e982c64785802f5c2378c,3,541,0,541,3,0,3,1,3,0,1,1,1.156766751,0,404,25,75,0,75,1980,0,1980,75,0,75,99.95820147
4ad9478ffab43c6f5aaa6def4b2074fb009bb2f9,0,0,0,0,0,0,0,0,0,0,0,0,0,0,405,26,0,0,0,0,0,0,0,0,0,100
7425ffca2dddbbe1bcc9b6a7f075e294b8948f2c,7,261,13,248,4,0,4,8,43,302,2,4,2.524383319,898,137,1,253,233,20,6737,6016,721,89,73,16,99.68310912
6bc7930a1477f98192c064ed402ef43587997087,0,0,0,0,0,0,0,0,0,0,0,0,0,0,406,24,0,0,0,0,0,0,0,0,0,100
90355300bbec7ad38404dee8b25e3a4eb017e5aa,3,133,2,131,1,0,1,11,86,34,2,2,0.306755664,3196,138,2,970,960,10,22589,21831,758,209,201,8,94.64121061
aef5474423cb4f981da16c4534cb3117bb46777d,1,6,1,5,0,0,0,16,143,119,1,1,0,3555,227,2,1054,1054,0,26240,26221,19,297,297,0,100
7851202ec6cadd5e38745bcea4dcfb224979a78d,1,46,9,37,0,0,0,8,16,305,1,1,0,262,334,0,46,42,4,1885,1781,104,18,16,2,100
d43fea80d89445b4ff69dfba89ecc355832f1d36,5,22,16,6,0,0,0,2,45,661,2,3,1.593946139,1960,580,6,524,523,1,14647,14633,14,302,302,0,100
4fec004e9d9cb15b6cbc1940d627aa2d84d26d5c,0,0,0,0,0,0,0,0,0,0,0,0,0,0,581,6,0,0,0,0,0,0,0,0,0,100
014ac689b5650db3dcdd93eb4eda9e736489a49c,0,0,0,0,0,0,0,0,0,0,0,0,0,0,335,1,0,0,0,0,0,0,0,0,0,100
94cc84d768871d42450680ab5cbc008bd4db0f40,0,0,0,0,0,0,0,0,0,0,0,0,0,0,407,7,0,0,0,0,0,0,0,0,0,100
3dbb43b85423e27c54389c1bd0d135f8c0157568,0,0,0,0,0,0,0,0,0,0,0,0,0,0,408,8,0,0,0,0,0,0,0,0,0,100
00799c73f0e5382cfe524362d5e3fd7a30e9e67e,4,223,50,173,1,0,1,3,6,357,2,3,1.357609631,564,55,2,137,109,28,4868,3624,1244,47,41,6,97.30172453
2aacb58f6859622a4e4e42acaf41429483f1f19a,0,0,0,0,0,0,0,0,0,0,0,0,0,0,56,3,0,0,0,0,0,0,0,0,0,100
62bed3cf3dd4fcc758034fd814d72efef2ba48a5,1,1,1,0,0,0,0,1,3,0,1,1,0,112,57,4,14,14,0,686,686,0,6,6,0,100
78614963a0396123e0b0594ced458094e97435e8,8,92,56,36,0,0,0,11,67,418,3,4,1.898898321,3001,58,5,835,829,6,20525,20340,185,289,288,1,99.98317985
ee299cc0bd0942ef8da2156c36e342a443bb46a0,2,15,30,15,0,0,0,11,90,158,2,2,0.996791632,1622,59,6,343,344,1,9944,9972,28,265,265,0,100
4e48533de7c409b8111117ebf7cdd6f7e5c76482,0,0,0,0,0,0,0,0,0,0,0,0,0,0,336,2,0,0,0,0,0,0,0,0,0,100
5c497a73539ee11ff753f5f5a0c8704da15c541d,0,0,0,0,0,0,0,0,0,0,0,0,0,0,337,3,0,0,0,0,0,0,0,0,0,100
0b73d9f1a90ae9cfecdbf8d6372dc02a66ef50e7,2,97,97,0,0,0,0,2,2,152,1,1,0.998082508,78,338,4,6,6,0,219,219,0,6,6,0,100
ed2940d54731bd83e864eb0b74e0dadbc8cdab67,6,444,444,0,0,0,0,2,2,198,1,2,2.479062227,325,339,5,32,32,0,1214,1214,0,32,32,0,100
c7addd5f51598dc111e89db16160c912e159c132,14,212,211,1,0,0,0,3,19,912,1,3,2.563438989,2192,582,2,369,362,7,14278,14123,155,169,166,3,99.94540338
7bd2b4ae49b25d040313dd17d2fbce9be74c3378,3,60,13,47,0,0,0,2,12,925,2,2,1.320063802,252,583,3,47,41,6,1358,1053,305,45,41,4,100
4c24a47a8e561133ed5aaae9871c8b8cd50968b6,4,11,47,36,0,0,0,3,17,440,2,4,1.419691185,930,584,4,171,178,7,5941,6148,207,75,77,2,100
990bfb8d9613199156d781204c3bc2cbec805393,1,156,0,156,1,0,1,1,1,0,1,1,0,0,585,5,22,0,22,789,0,789,9,0,9,99.8867117
cb77af09f2a73e30e00f0b12d23169fff1e0f003,1,2,1,1,0,0,0,5,15,728,1,1,0,182,586,6,43,42,1,875,866,9,27,27,0,100
2765b756bc471d7aae762131d3353bc5587db04f,5,91,4,87,2,0,2,1,37,565,2,4,1.722170606,1287,60,5,435,430,5,8971,8740,231,100,98,2,95.78085046
9bc400e7bdbff909666d8e191a8acd7aa1fe76e0,1,9,1,8,0,0,0,1,3,269,1,1,0,189,409,2,23,21,2,1289,1240,49,10,10,0,100
fedcd133d0e32dd53fd2fd33a64cf4a616513c27,0,0,0,0,0,0,0,0,0,0,0,0,0,0,410,3,0,0,0,0,0,0,0,0,0,100
85ba2eada3ffc4eeba3ed8e913ccfee560d6b006,17,98,116,18,0,0,0,2,87,741,3,5,3.149985799,4997,587,7,1382,1382,0,33531,33424,107,384,383,1,99.49153459
5903f31e690d02f9824dff400e9fd2763c41ded8,3,103,2,101,2,0,2,1,113,32,2,2,1.28093899,3817,61,6,1114,1105,9,24129,23750,379,295,291,4,99.9730792
3bb50e3d367beb7fc11bb64228088f9e8e316dba,14,649,99,550,5,0,5,1,19,78,1,4,3.312574249,1939,588,7,384,321,63,15491,13220,2271,173,144,29,99.63968809
bff7d8693a15551c2b2d86fce7dff5e661648395,0,0,0,0,0,0,0,0,0,0,0,0,0,0,589,8,0,0,0,0,0,0,0,0,0,100
ad54566f6cfdf2ea00a7490f9d2e54a6c0f026f5,0,0,0,0,0,0,0,0,0,0,0,0,0,0,590,9,0,0,0,0,0,0,0,0,0,100
f4cddb4c8206a5edffd8d1e3f25ed5ae07720e11,2,6,2,4,0,0,0,1,2,12,1,2,0.543564443,163,591,10,29,29,0,1006,1010,4,10,10,0,100
b0993e01cdd2be8d73e7716770e2faaa3fce81be,0,0,0,0,0,0,0,0,0,0,0,0,0,0,592,10,0,0,0,0,0,0,0,0,0,100
3887eb414e6118c294661aa326886a14444435d1,56,7136,0,7136,56,0,56,1,1,0,1,5,5.341488824,0,593,11,847,0,847,32356,0,32356,351,0,351,99.19449483
30dc29d4dd32124c6b69465ce86679487f6fd280,0,0,0,0,0,0,0,0,0,0,0,0,0,0,594,12,0,0,0,0,0,0,0,0,0,100
f9b7be96359e6501a403192f17cf3ccc1daa52af,0,0,0,0,0,0,0,0,0,0,0,0,0,0,595,13,0,0,0,0,0,0,0,0,0,100
983b02e143518564f034f70fd190bb3ab13e197c,0,0,0,0,0,0,0,0,0,0,0,0,0,0,596,14,0,0,0,0,0,0,0,0,0,100
354d9aee89c28f42e5887c7772cf6630916cce50,0,0,0,0,0,0,0,0,0,0,0,0,0,0,597,15,0,0,0,0,0,0,0,0,0,100
753c7537ac53f5545ea98ce7ba1db81c65fa0e34,1,1,1,0,0,0,0,1,2,0,1,1,0,500,598,16,66,66,0,3295,3295,0,40,40,0,100
51e860d4af4c79da39cfa8114cbb9b1fc5c91391,0,0,0,0,0,0,0,0,0,0,0,0,0,0,411,4,0,0,0,0,0,0,0,0,0,100
646d9f37d10e228be144b554e4ec82b36e7666c7,0,0,0,0,0,0,0,0,0,0,0,0,0,0,412,5,0,0,0,0,0,0,0,0,0,100
cc14c901d1d15b9fb0774abe48795733cd0db7fb,0,0,0,0,0,0,0,0,0,0,0,0,0,0,413,6,0,0,0,0,0,0,0,0,0,100
64e8ea365ac187ad0b73675e3727530674722458,0,0,0,0,0,0,0,0,0,0,0,0,0,0,414,7,0,0,0,0,0,0,0,0,0,100
63e3f262fb82b08d12685dc28cbae13dc2124541,9,13,9,4,0,0,0,2,2,0,1,3,3.118078209,584,415,8,53,53,0,4215,4215,0,25,25,0,100
17848d9d4083c0db00ac46c1b820de43b36e5e5d,6,0,118,118,0,0,0,2,3,0,1,1,2.576165603,82,416,9,0,0,0,0,680,680,0,0,0,99.90990514
2e407aa3ea9f2b5cc094e31092286c46cb2e16e1,3,57,0,57,0,0,0,2,3,0,1,2,1.584962501,171,417,10,44,44,0,1301,1301,0,15,15,0,100
4c0dbdb6fc1d134945d19618880802c7b7cd7b14,0,0,0,0,0,0,0,0,0,0,0,0,0,0,418,11,0,0,0,0,0,0,0,0,0,100
1cef932cc41b07b325c5e71fa66bfef065d4b041,1,8,1,7,0,0,0,1,2,47,1,1,0,117,62,2,13,13,0,965,933,32,6,6,0,100
3d5bfca72c89db87486b2cfb3766606ae65ef925,1,6,1,5,0,0,0,3,7,47,1,1,0,258,63,3,79,77,2,1880,1845,35,12,12,0,100
93d76e21d394d6e5e42000ece095c30974629803,1,0,2,2,0,0,0,3,6,36,1,1,0,125,64,4,19,19,0,695,712,17,17,17,0,100
cea9f61068fbbe02348f011f334fbde64055de7d,0,0,0,0,0,0,0,0,0,0,0,0,0,0,599,16,0,0,0,0,0,0,0,0,0,100
106111ba3e9234e08e2e40fcb8f0483bbc23ecbe,0,0,0,0,0,0,0,0,0,0,0,0,0,0,600,17,0,0,0,0,0,0,0,0,0,100
8af9ff0aafe3818d708bc54432f367eaa85d8b05,1,45,0,45,1,0,1,1,1,0,1,1,0,0,601,18,3,0,3,105,0,105,1,0,1,99.96288244
fc3f2dc536138bd68dfb9eba4c2defbbc02deded,0,0,0,0,0,0,0,0,0,0,0,0,0,0,602,19,0,0,0,0,0,0,0,0,0,100
4cb19dad06a2d4f33840bcebcd76a0f769e599d1,0,0,0,0,0,0,0,0,0,0,0,0,0,0,603,20,0,0,0,0,0,0,0,0,0,100
25f5d15767a57d8c47b5d5d258b52c7ec579319e,1,5,5,0,0,0,0,2,3,14,1,1,0,500,103,0,66,66,0,3295,3295,0,40,40,0,100
b2d771f972c1dabb123be63dcea02e03cf6f63a8,1,18,0,18,0,0,0,2,2,20,1,1,0,58,65,5,17,17,0,409,409,0,9,9,0,100
313b70a403d6a003d85dd0a212be18721f5244e7,0,0,0,0,0,0,0,0,0,0,0,0,0,0,66,6,0,0,0,0,0,0,0,0,0,100
dd92e31eda3cd11ca91aae5beb12eee344076e28,2,22,6,16,0,0,0,1,4,9,1,2,0.222284831,540,604,20,73,72,1,3610,3461,149,43,42,1,100
1c01e8da2a9d37f885b7693b2e758608c04bd10f,2,16,5,11,0,0,0,1,15,343,2,2,0.918295834,222,67,7,39,38,1,1484,1414,70,23,22,1,100
4a1ab585987ee860ba156f22ab24ed570f182128,0,0,0,0,0,0,0,0,0,0,0,0,0,0,68,8,0,0,0,0,0,0,0,0,0,100
92a025c063d1674b84221cf5e9b4fd1723ae5583,0,0,0,0,0,0,0,0,0,0,0,0,0,0,419,10,0,0,0,0,0,0,0,0,0,100
61696dbd7e5cb16d49a8c4170b8c1dd37cd2d6bb,2,4,4,0,0,0,0,2,2,20,1,2,0.811278124,231,104,1,20,20,0,1386,1386,0,13,13,0,100
2f3fe527a14cbbb9054c8d54ee6bd7a8612afe0a,42,300,337,37,1,0,1,1,5,0,1,5,3.718633354,4536,605,19,774,747,27,29221,29048,173,306,302,4,98.50138295
6c8753f804c15f3ed047ae2da870b0e891f39992,0,0,0,0,0,0,0,0,0,0,0,0,0,0,606,20,0,0,0,0,0,0,0,0,0,100
b67f2c033a4884ad18edcbfcb0d59e54af47f94f,0,0,0,0,0,0,0,0,0,0,0,0,0,0,607,21,0,0,0,0,0,0,0,0,0,100
9301f42f4f71d1305997aad38d062ba8203e9c42,0,0,0,0,0,0,0,0,0,0,0,0,0,0,608,22,0,0,0,0,0,0,0,0,0,100
e8b0679ed1b471e3165689a8270559fc03ceb2ee,1,0,9,9,0,0,0,2,4,0,1,1,0,113,609,23,18,18,0,554,627,73,11,11,0,100
e835d87c06ad2db944a77ba63b719c5b23f59bd8,2,66,89,23,0,0,0,2,6,0,1,2,0.813824522,640,610,24,76,84,8,4263,4348,85,46,46,0,99.98565211
183718e3a7b4a755d13a3e01efd4636433fbf213,0,0,0,0,0,0,0,0,0,0,0,0,0,0,611,25,0,0,0,0,0,0,0,0,0,100
af8ebbbdfe5a64917345b053902cf505b4918f57,1,2,2,0,0,0,0,2,7,1,1,1,0,550,105,2,69,69,0,3820,3820,0,43,43,0,100
52402f10833bb93e36072ffa2fbc48c54e9228c9,0,0,0,0,0,0,0,0,0,0,0,0,0,0,612,26,0,0,0,0,0,0,0,0,0,100
18dd7e8542ca5e97f2e9d7b54495018c8864e5b9,2,7,2,5,0,0,0,4,36,274,2,2,0.764204507,603,55,0,97,96,1,4566,4546,20,39,39,0,100
9c629413d877beb911bcb7418c34bb1eda7155d4,0,0,0,0,0,0,0,0,0,0,0,0,0,0,420,11,0,0,0,0,0,0,0,0,0,100
56656348ac425c01fec991c53460cfdbabfd6358,0,0,0,0,0,0,0,0,0,0,0,0,0,0,613,26,0,0,0,0,0,0,0,0,0,100
e0db67ee48a322a4dea61d38d83f5c404f9af3cb,13,26600,0,26600,13,0,13,1,1,0,1,5,1.217523465,0,614,27,4386,0,4386,122792,0,122792,521,0,521,99.85195091
893198dec491ea8cdf251f37d606ede7c657ce6a,2,207,77,130,1,0,1,1,3,6,1,2,0.655444445,137,615,28,25,15,10,1248,964,284,12,7,5,99.99046348
4647e2df8f618da7bf998445d7c464a9b1459ed8,1,0,1,1,0,0,0,1,2,12,1,1,0,76,616,29,17,17,0,413,420,7,6,6,0,100
3c513a022215fb7b201c88a29d12e45f0d11016a,3,4,4,0,0,0,0,1,2,0,1,2,1.5,393,617,30,92,92,0,2018,2016,2,58,58,0,100
0c4ff041cd5795f337eb13bbb453812797ba1812,8,392,98,294,2,0,2,1,8,5,1,4,2.352520053,1303,618,31,233,186,47,10255,8992,1263,117,90,27,99.9666333
6019e8aeab0e3566ec964705b960642f97b16d71,0,0,0,0,0,0,0,0,0,0,0,0,0,0,619,32,0,0,0,0,0,0,0,0,0,100
150374648b2c63a1c94f7a99090e9281d914da77,1,4,0,4,0,0,0,1,2,33,1,1,0,85,620,33,15,15,0,355,355,0,8,8,0,100
157d126fd3fb404a61410d734a0e92f6b458972b,0,0,0,0,0,0,0,0,0,0,0,0,0,0,621,34,0,0,0,0,0,0,0,0,0,100
73ef4961682fc073c9a96302ccfb56f124bb3bf8,0,0,0,0,0,0,0,0,0,0,0,0,0,0,139,0,0,0,0,0,0,0,0,0,0,100
549daababf6e94dc2b8742d73d866b9ae7e5d42a,0,0,0,0,0,0,0,0,0,0,0,0,0,0,622,31,0,0,0,0,0,0,0,0,0,100
5fa827bcce2677449539579d26c3763b40fad22c,0,0,0,0,0,0,0,0,0,0,0,0,0,0,421,10,0,0,0,0,0,0,0,0,0,100
e4162075cfc9d59fbf91f68107dd941d19227922,10,91,37,54,0,0,0,1,5,4,1,5,2.398387478,1400,623,32,242,239,3,8764,8719,45,119,117,2,100
c6fd84d3d03be997be15e2fe85cad9954632b256,0,0,0,0,0,0,0,0,0,0,0,0,0,0,624,33,0,0,0,0,0,0,0,0,0,100
8271556d972cb35405ae1fbe646aabc598bb8d67,0,0,0,0,0,0,0,0,0,0,0,0,0,0,625,34,0,0,0,0,0,0,0,0,0,100
c185bb5f63b05be1156a6d380109d9c483b4647c,0,0,0,0,0,0,0,0,0,0,0,0,0,0,626,35,0,0,0,0,0,0,0,0,0,100
a20f7008baea55dd1f458893411c00c0055caaab,0,0,0,0,0,0,0,0,0,0,0,0,0,0,627,36,0,0,0,0,0,0,0,0,0,100
2789f6252b2b16be7907df3ce601d34432df9e04,1,19,0,19,0,0,0,2,2,7,1,1,0,69,422,11,17,17,0,458,458,0,9,9,0,100
dbd0734d68e99ce69756568afbb7b1dbb0b4e000,0,0,0,0,0,0,0,0,0,0,0,0,0,0,628,36,0,0,0,0,0,0,0,0,0,100
176c4262aa207c11db984bbaa81ecb43a4a6c243,0,0,0,0,0,0,0,0,0,0,0,0,0,0,629,37,0,0,0,0,0,0,0,0,0,100
4399114e70ebc6c54ac17b5b16517cdfaa1898e9,0,0,0,0,0,0,0,0,0,0,0,0,0,0,630,38,0,0,0,0,0,0,0,0,0,100
b0b6df541c196c84c6ebf0afcb167fa4112ac77b,0,0,0,0,0,0,0,0,0,0,0,0,0,0,631,26,0,0,0,0,0,0,0,0,0,100
27d8c3f0c20da2140200d63dee975a5a061e3b28,0,0,0,0,0,0,0,0,0,0,0,0,0,0,632,27,0,0,0,0,0,0,0,0,0,100
35b54a011885d0c7abab3bef23773eb0ea8d3850,0,0,0,0,0,0,0,0,0,0,0,0,0,0,633,28,0,0,0,0,0,0,0,0,0,100
e4679218b173f77ff96fe1241cc3d7343d8a1304,0,0,0,0,0,0,0,0,0,0,0,0,0,0,634,29,0,0,0,0,0,0,0,0,0,100
05b75b3f68e38d5e19418b017238390f7527ecb1,1,3,22,19,0,0,0,2,9,27,1,1,0,557,635,30,74,74,0,3594,3748,154,45,45,0,99.99523446
a89c57d229c2764936439e8820fe1d3428964144,1,1,1,0,0,0,0,1,4,27,1,1,0,67,636,31,9,9,0,399,400,1,4,4,0,100
df01babdcf15ead2e0878f46f885a7baf30c8f73,0,0,0,0,0,0,0,0,0,0,0,0,0,0,637,32,0,0,0,0,0,0,0,0,0,100
632639bb62af9f85b82942c1c4685e66ed6bd9c1,0,0,0,0,0,0,0,0,0,0,0,0,0,0,638,33,0,0,0,0,0,0,0,0,0,100
6bdb269a8bcb4a1df81e18b5b4b1be755ac19f14,12,809,0,809,12,0,12,1,1,0,1,4,3.422160679,0,140,1,87,0,87,2797,0,2797,53,0,53,99.86201646
e919a8fa01d0a4af591509ea1345cdba6ffc435b,0,0,0,0,0,0,0,0,0,0,0,0,0,0,639,26,0,0,0,0,0,0,0,0,0,100
969693edffe5856867c8c5e4d6d9cc758421e119,0,0,0,0,0,0,0,0,0,0,0,0,0,0,640,27,0,0,0,0,0,0,0,0,0,100
4937150c9a2c5f005ef8beb1d4f818c3cffeb5d9,0,0,0,0,0,0,0,0,0,0,0,0,0,0,641,28,0,0,0,0,0,0,0,0,0,100
7b14267281a11e43694114155a44b6f3ae607480,0,0,0,0,0,0,0,0,0,0,0,0,0,0,642,29,0,0,0,0,0,0,0,0,0,100
c3563ec823459744614bae6d94e225cefa8383fa,4,77,72,5,0,0,0,1,10,17,1,2,1.528314541,1132,643,30,141,141,0,7935,7683,252,74,75,1,100
8db65104cf614e142e4d435e6b4b9ed2c720849c,0,0,0,0,0,0,0,0,0,0,0,0,0,0,644,31,0,0,0,0,0,0,0,0,0,100
4647f308c609b6c9f3b8f028e0f59ce6390a7b24,0,0,0,0,0,0,0,0,0,0,0,0,0,0,423,3,0,0,0,0,0,0,0,0,0,100
f0517dd09c089c13018aba395c87058371953592,0,0,0,0,0,0,0,0,0,0,0,0,0,0,424,4,0,0,0,0,0,0,0,0,0,100
e8dbbfd63f4d2d43d1ad90152383f61a8160c80a,2,38,0,38,0,0,0,2,2,2,1,2,1,138,425,5,19,19,0,956,956,0,13,13,0,100
299b54b61b3635c5a5c9653a0d8f8e9967484efc,0,0,0,0,0,0,0,0,0,0,0,0,0,0,426,6,0,0,0,0,0,0,0,0,0,100
a28d7ad275fbc06b26a6294168677d061b40625b,0,0,0,0,0,0,0,0,0,0,0,0,0,0,427,7,0,0,0,0,0,0,0,0,0,100
dc265d929e5285fc76002783de8603af057a199e,0,0,0,0,0,0,0,0,0,0,0,0,0,0,428,8,0,0,0,0,0,0,0,0,0,100
f03598fe592eb44ecace70cd2dfe7bfd79115adb,1,4,0,4,0,0,0,4,8,266,1,1,0,48,645,32,11,10,1,211,196,15,9,8,1,100
97232e67b45a9f8b7b6d48792d255ea0596495ad,5,4,91,87,0,0,0,1,38,80,2,4,1.722170606,1360,69,0,430,435,5,8740,8971,231,98,100,2,96.84748151
fafc33b3cd1cdd5a2060990c30e5f9b26435368f,10,115,16,99,0,0,0,3,144,212,2,3,2.320147835,6772,646,33,2013,1996,17,47440,47057,383,657,647,10,100
79b9583a46d744f7d46e50de383eaaf573c8fa9c,1,0,11,11,0,0,0,4,14,0,1,1,0,49,647,34,7,8,1,139,162,23,7,8,1,100
c68f1de7802d0d8458a8f439a373c93db75751f0,0,0,0,0,0,0,0,0,0,0,0,0,0,0,340,0,0,0,0,0,0,0,0,0,0,100
9d33fe34b8cf330a330c7d70162c23f16fdc436c,2,22,4,18,0,0,0,4,16,780,2,2,0.706274089,712,141,2,118,116,2,4150,4083,67,37,35,2,100
a873065db7f3b9190ff47a88bff1b2cbce3d3e89,18,979,47,932,5,0,5,11,88,483,5,11,2.626790111,10105,648,26,3169,3053,116,77148,72487,4661,838,796,42,93.2879046
d31ec1274b31746e171c5b31a6a038c30991c24e,3,27,5,22,0,0,0,12,67,144,1,2,1.115419141,2996,649,27,952,946,6,21343,21229,114,332,330,2,100
10a056a073bb2ddee279a13feac2ea6d3a7efcbe,0,0,0,0,0,0,0,0,0,0,0,0,0,0,650,28,0,0,0,0,0,0,0,0,0,100
ddda5ee6a03a39c4c56d913bc7096a2eb191aac3,0,0,0,0,0,0,0,0,0,0,0,0,0,0,429,8,0,0,0,0,0,0,0,0,0,100
8de998f90bfdf78c49449c8952abaa2c61e55907,0,0,0,0,0,0,0,0,0,0,0,0,0,0,70,1,0,0,0,0,0,0,0,0,0,100
939f644e775bcf6686d4e8514069799bd1fe2b02,1,2,1,1,0,0,0,1,2,505,1,1,0,166,651,23,42,42,0,800,791,9,25,25,0,100
323ebee840e6274e3023ce20417c13dc738c6d2d,3,215,7,208,1,0,1,1,24,139,2,3,0.679898433,1947,341,1,438,411,27,13007,12084,923,215,207,8,99.98205527
6b38f0cb8eb9362b103b33c1f1b646876f872a92,1,0,75,75,0,0,0,1,2,0,1,1,0,165,342,2,11,24,13,462,864,402,3,6,3,100
59c7001e09e34a7394eb534ec88bc1975b2120d6,1,63,50,13,0,0,0,4,11,7,1,1,0,175,652,21,49,44,5,1106,1053,53,16,13,3,100
ea8dc8b630305acd9e680744c486eff12afb1ba8,7,139,12,127,2,0,2,1,65,468,3,3,2.363057382,999,71,2,218,208,10,6593,6154,439,95,87,8,97.09548448
3905b52a90c1eebe7d95105a0043c684dfb0698b,2,15,10,5,0,0,0,7,21,0,2,2,0.634309555,240,72,3,36,36,0,1525,1469,56,16,16,0,100
493bfe0e1426297ec4dee448bd10232529722c22,19,516,55,461,2,0,2,3,68,916,2,9,3.328516278,6996,181,0,1943,1844,99,54419,51399,3020,751,734,17,93.79643944
d781b913d1341dff8cc9acc809f07d7c27de6890,1,6,4,2,0,0,0,10,58,14,1,1,0,1729,182,1,471,469,2,14584,14553,31,84,84,0,100
15d2f36ab01c7af3124c9b19dcc65d100df191cf,2,5,5,0,0,0,0,1,2,4,1,1,0.721928095,74,73,4,5,5,0,252,252,0,5,5,0,99.98246383
69b8e4a1fdbce7cc062d05811c9ef8a9f799c90b,0,0,0,0,0,0,0,0,0,0,0,0,0,0,430,7,0,0,0,0,0,0,0,0,0,100
2d21d726ab41b3e80b3326c41e9e9bfe9523c8d6,1,3,1,2,0,0,0,4,12,9,1,1,0,182,653,22,49,49,0,1113,1106,7,16,16,0,100
3865aedfaa85d4d0be8f0699ccf169723ce90240,8,31,201,170,0,0,0,11,89,340,4,7,1.062074974,6436,654,23,1915,1955,40,46264,46992,728,482,494,12,100
bc6c92ca6445af3529a5d20dd6736b00ff1b7d67,1,1,1,0,0,0,0,2,2,450,1,1,0,151,431,8,40,40,0,657,657,0,26,26,0,100
72ddd27a00ee5e345a69a081abcf19cdd3d83a96,1,2,2,0,0,0,0,3,7,3471,1,1,0,86,432,9,18,18,0,342,336,6,6,6,0,100
73692a6d3235414427f2792b348a885fb19d0faf,1,7,2,5,0,0,0,8,47,461,1,1,0,516,433,10,150,150,0,3723,3721,2,26,26,0,100
4d5d2fb2bfaa5edeb9cd6170cf2f58d9d5f6d32f,1,1,1,0,0,0,0,8,33,0,1,1,0,356,434,11,86,86,0,2503,2503,0,24,24,0,100
2230521c78eb08ffeed674ee8413079806ab97f3,1,5,2,3,0,0,0,5,15,1313,1,1,0,154,435,12,36,35,1,956,942,14,10,10,0,100
14cfcaa3ccf7b4229f1745b53e0b976e3aab250e,4,29,44,15,0,0,0,11,56,620,3,4,1.697685995,705,74,5,126,126,0,4087,4118,31,59,59,0,100
703bd8db8a82c09051e5c453bd5c849bc532b556,3,11,28,17,0,0,0,3,16,0,2,3,1.312264307,463,75,6,84,86,2,2465,2561,96,43,44,1,100
152e5d2d4fc50e8d8d946efff95c09c513b7fbe4,2,177,177,0,0,0,0,2,2,8,1,1,0.999792766,152,343,3,37,37,0,1038,1038,0,4,4,0,100
efa71484df0c6cbda33b62d9c181e2d31f30ee8b,2,11,3,8,0,0,0,3,6,1348,2,2,0.591672779,275,0,0,52,51,1,1634,1580,54,22,21,1,100
5e2f6c2288f537cb4874b09fc8a456e0980ed04d,1,5,4,1,0,0,0,3,3,1655,1,1,0,111,436,13,24,24,0,616,595,21,6,6,0,100
8a2b1c1f084230704d0abb444434c215b1f1cfb1,18,62,62,0,0,0,0,3,114,840,1,7,3.78842323,14507,437,14,4572,4572,0,96488,96427,61,1413,1413,0,100
7450df02a4d6314c21aaf4c67fa4134f7d6f0a46,2,46,5,41,0,0,0,5,90,51,2,2,0.626751137,1027,228,0,212,204,8,7593,7361,232,64,60,4,100
8084af124c682a8f20360903ef385d65e26938d2,1,1,1,0,0,0,0,5,7,456,1,1,0,149,438,15,32,32,0,1121,1117,4,10,10,0,99.97807498
f82b866318d974d78cd3397d9713d96d7a87c053,1,1,1,0,0,0,0,6,11,456,1,1,0,461,439,16,105,105,0,3823,3821,2,22,22,0,100
cb099098caa9ae1c05f395b16fb2a50982881008,1,1,1,0,0,0,0,8,15,27,1,1,0,620,440,17,215,214,1,4275,4275,0,66,66,0,100
7028247229f380be43d34038f877eeae31a657fe,0,0,0,0,0,0,0,0,0,0,0,0,0,0,344,4,0,0,0,0,0,0,0,0,0,100
13002d2025319075eadf690e5548b3bbc506401c,1,2,2,0,0,0,0,11,26,456,1,1,0,635,441,18,128,127,1,4283,4274,9,44,44,0,100
bc67e474bc20ddb82dee328b07be452c2140cf18,1,1,1,0,0,0,0,3,6,1771,1,1,0,168,442,19,33,32,1,1317,1313,4,18,18,0,100
34a865c5bdc711fda65b9959c40afa93fb163e89,1,7,12,5,0,0,0,13,91,0,1,1,0,813,229,1,191,193,2,5543,5596,53,47,47,0,100
2e827c5eab3154f62e5a82045af1638fafabb7e7,1,5,1,4,0,0,0,7,16,456,1,1,0,223,443,20,49,48,1,1940,1925,15,9,9,0,100
a79a96b86c79d9a7105d6c439a641888572f6284,10,667,341,326,5,0,5,1,2,10,1,1,2.943631387,609,655,20,120,101,19,5190,4339,851,48,41,7,99.92983379
832b5048bd6c22f27b8015036ee2669af4192986,1,4,6,2,0,0,0,10,59,9,1,1,0,1732,183,2,469,471,2,14553,14584,31,84,84,0,100
dbaf9fa67e33844e0b5379a01cc70020fd82f87f,1,0,4,4,0,0,0,2,2,1,1,1,0,135,184,3,40,40,0,862,870,8,11,11,0,100
eac9c66b74a1ef21bf3f430ed84f83965bdc3a4f,3,122,6,116,2,0,2,1,60,0,1,2,1.254111934,1729,185,4,476,469,7,14979,14553,426,91,84,7,92.76338262
3f79c25dfcfae0cd6d3de56e72bd6a3602d671f6,2,117,117,0,0,0,0,1,2,0,1,1,0.909510663,102,186,5,7,7,0,426,426,0,7,7,0,100
cbe90d792b93b3d18905789e68a0b85cd345ad32,0,0,0,0,0,0,0,0,0,0,0,0,0,0,444,15,0,0,0,0,0,0,0,0,0,100
5e8b5afc7252dc4c5a086560000046022a60c47c,1,1,1,0,0,0,0,4,4,1334,1,1,0,159,445,16,32,32,0,1180,1177,3,13,13,0,100
004cbd9644c8b2806bd36256e01481b81300157f,2,2,3,1,0,0,0,11,31,470,1,1,0.970950594,1983,446,17,635,637,2,15247,15255,8,110,110,0,100
702fb78b14618758678d92673e3d2b0ec9034280,3,6,0,6,0,0,0,12,69,577,1,2,1.584962501,3514,447,18,1144,1141,3,24375,24348,27,389,389,0,100
18e329cf4ee70c7f33f0040534431e716a2cbd9f,3,5,5,0,0,0,0,8,22,85,1,2,1.521928095,1555,448,19,556,556,0,9995,9980,15,186,186,0,100
40d808099df7edfff5201648d0fafd70b74e4515,1,1,1,0,0,0,0,16,145,42,1,1,0,3563,449,20,1057,1057,0,26284,26284,0,297,297,0,100
c047527a4f308f9c6dc7f4fa042743c813bb3300,2,9,5,4,0,0,0,16,146,7,1,1,0.371232327,4371,450,21,1250,1248,2,31844,31827,17,344,344,0,100
a7c61414caff614cc33c664357f93394ca8f1744,3,98,10,88,2,0,2,1,82,105,2,2,1.455876472,3179,76,6,666,664,2,25918,25672,246,130,128,2,99.97250481
af772a734b12f9d3b779d14bf48b58e3849abdc1,1,15,11,4,0,0,0,13,93,1,1,1,0,813,451,22,193,193,0,5594,5566,28,47,47,0,100
75bd5fe6a7a6101c5f925ca5f7a05e07ae8c1fe6,1,6,11,5,0,0,0,3,7,473,1,1,0,117,452,23,16,17,1,679,729,50,5,5,0,100
2747862d5fb45276eb89f2854db26fc81da49eaa,1,1,5,4,0,0,0,11,53,317,1,1,0,867,453,24,230,232,2,7212,7244,32,43,43,0,100
d5fc007b7000c1a4fb46a194d1506cb263f6fa65,3,18,9,9,0,0,0,7,22,554,1,2,1.561015011,577,454,25,142,142,0,4600,4495,105,40,40,0,100
e3075014f3c3ba52e08bc921a617bdbc646f870a,2,2,2,0,0,0,0,8,17,769,1,2,1,857,455,26,237,237,0,6143,6141,2,63,63,0,100
ee314e9586abb863f2749cfb80b2d3a28a613c8f,1,3,1,2,0,0,0,16,147,2,1,1,0,3562,456,27,1057,1057,0,26278,26278,0,297,297,0,100
51cf5ee59e8edafd8b5a193636a700c97cd0f634,1,1,1,0,0,0,0,16,148,0,1,1,0,3562,457,28,1057,1057,0,26278,26278,0,297,297,0,100
f5639bb801864fdcee84cb6096689933ea788c82,0,0,0,0,0,0,0,0,0,0,0,0,0,0,142,0,0,0,0,0,0,0,0,0,0,100
a88939693be3f3b732319e5d9599348466c3202b,1,0,4,4,0,0,0,12,97,239,1,1,0,1424,77,6,373,374,1,9338,9378,40,228,228,0,100
e372349aebf983e07dc6509861e885fb294e9e16,5,361,2,359,2,0,2,1,149,6,2,3,1.749840816,4926,143,1,1445,1393,52,37360,35932,1428,401,383,18,99.96152366
8781af1e8861e21fd92ed7b004cb9ac50d14d624,1,1,4,3,0,0,0,11,28,1,1,1,0,750,56,0,162,162,0,5055,5078,23,49,49,0,100
20f2966ea100d6e3998912de07dddeb1f6b4cb75,1,2,2,0,0,0,0,1,4,164,1,1,0,112,78,7,14,14,0,680,686,6,6,6,0,100
b27485bd8bc1452c4a2770723830e8b1ccdf6ed2,1,2,4,2,0,0,0,8,15,298,1,1,0,154,132,0,34,34,0,1035,1059,24,12,12,0,100
2f10cd452065b0c1f6b23553eae61317fa3942f8,6,721,91,630,0,0,0,7,62,626,2,2,2.174551763,4439,57,1,1211,1141,70,32278,28509,3769,679,627,52,100
45c555606de95d37024d2e76b7b9240b0ff81156,0,0,0,0,0,0,0,0,0,0,0,0,0,0,345,2,0,0,0,0,0,0,0,0,0,100
84c7dde7e6640515e451b66d249c0d343670ae09,1,101,0,101,1,0,1,1,1,0,1,1,0,0,656,1,10,0,10,468,0,468,8,0,8,99.96155747
7a1abe052bdb586a9a3c1f1a49fb97cfde5f2ed4,0,0,0,0,0,0,0,0,0,0,0,0,0,0,458,20,0,0,0,0,0,0,0,0,0,100
4d5d3a6aedc9385afcf95ced83ef0b71843b38e3,1,1,0,1,0,0,0,12,98,17,1,1,0,1420,133,1,373,373,0,9349,9338,11,228,228,0,100
d7c6f97a83cd5737eab1d8aaf91d0a429a3e750e,0,0,0,0,0,0,0,0,0,0,0,0,0,0,459,21,0,0,0,0,0,0,0,0,0,100
2400bacd056acb907e4ab9190568ad24a94ffad4,6,444,3,441,4,0,4,1,83,39,3,6,2.293260226,4808,79,2,1216,1157,59,38604,37137,1467,324,277,47,99.9286968
5668a18ec0a54730824d60d3a97a0c3031d4fda6,3,170,4,166,2,0,2,1,6,1178,2,2,1.166702705,45,346,1,20,9,11,890,155,735,18,7,11,99.97259824
020b24e00808e78683e7984f7cd7ba3ee02605fb,1,14,1,13,0,0,0,1,2,165,1,1,0,51,80,3,8,5,3,336,257,79,3,3,0,100
17246f5ff28123fb24069b3f3e6f2c3a5d8be81c,1,1,1,0,0,0,0,12,66,75,1,1,0,551,81,4,130,130,0,3775,3781,6,49,49,0,100
1738c1f33bc0a797b77c5bae2c8e3406f55c6e20,1,12,1,11,0,0,0,3,9,414,1,1,0,266,82,5,72,69,3,1690,1643,47,31,29,2,100
8b13127fd627154275b6e7720c951ec5da378f05,0,0,0,0,0,0,0,0,0,0,0,0,0,0,83,6,0,0,0,0,0,0,0,0,0,100
a1716ad3e2ec745ce070920bd9cc01b498b20d51,0,0,0,0,0,0,0,0,0,0,0,0,0,0,460,2,0,0,0,0,0,0,0,0,0,100
ee83defe59bab7df3967f2772339cdb82f61a2f6,1,19,0,19,0,0,0,3,13,400,1,1,0,345,187,0,14,12,2,2013,1889,124,10,9,1,100
90a54ac7e77b3cf4a190ea3590d8e92a3f61672c,1,5,1,4,0,0,0,3,14,0,1,1,0,362,188,1,16,14,2,2041,2013,28,10,10,0,100
961e957be0797037c474bd60865bc443f5b5fc22,1,27,25,2,0,0,0,1,5,36,1,1,0,112,84,7,9,14,5,530,680,150,5,6,1,100
2fa5556c0daf13cb63b037492e74ad4051aa671c,1,1,1,0,0,0,0,14,84,5,1,1,0,3215,85,8,672,672,0,25876,25876,0,132,132,0,100
fc63143dfe528e9afbf68aca93f1ce2ba864a2ae,2,8,3,5,0,0,0,3,52,173,2,2,0.684038436,1395,189,2,283,282,1,9561,9533,28,63,63,0,100
5ad6624b531aa73a595680e8d53cd1da2b432b7e,4,79,26,53,0,0,0,4,26,178,2,4,1.380611716,1878,190,3,399,393,6,14708,14373,335,165,163,2,100
6210611374f461655d6d2bed02bfdb8841200642,1,50,27,23,0,0,0,4,18,63,1,1,0,329,86,7,91,92,1,2123,2056,67,38,38,0,100
f03b417d416e292e9ba4f99632e10a137583f8ae,3,210,4,206,2,0,2,1,115,27,2,2,1.151376596,3821,347,1,1129,1108,21,24636,23796,840,311,291,20,99.95618359
d5e876372dc1974dcf597820f811139d1f294bb6,1,4,0,4,0,0,0,2,3,2284,1,1,0,159,87,8,34,33,1,1027,1016,11,7,7,0,100
512122c4bafdd3ff036f06e0fd79d67b694bd2e9,1,6,0,6,0,0,0,2,3,101,1,1,0,167,2,0,43,42,1,819,800,19,26,25,1,100
124d3ca7b5716edec7b4f77cf853d008e16ad3cc,5,186,12,174,1,0,1,1,15,884,2,3,1.628385412,702,88,9,173,148,25,4701,3840,861,104,94,10,99.91243912
d899ba81075c96cd6a46b724e49e3bcc72697b25,2,22,2,20,0,0,0,2,19,201,2,2,0.994984828,395,89,10,87,84,3,2609,2503,106,38,35,3,99.96169211
0b80f23e703e09f6d219ca2e1ce5e1051073f9ed,1,14,0,14,0,0,0,12,29,58,1,1,0,747,230,0,162,162,0,5148,5055,93,49,49,0,100
99eef9d0184f8f8f636593caf95f69e3f2ae0e8f,1,2,4,2,0,0,0,6,15,57,1,1,0,452,231,1,49,49,0,2716,2732,16,35,35,0,100
720b8f7e71bbe6b423135cb80f0b69c7f2773294,7,381,0,381,5,0,5,1,74,39,2,3,2.416202387,2320,3,1,819,768,51,17398,16104,1294,232,199,33,96.79529773
c45cba1f29c763cd83e0dd126b19b4869fe06a6c,1,18,0,18,0,0,0,1,2,0,1,1,0,36,4,2,9,9,0,201,201,0,9,9,0,100
84812bb21150b08b9ff4e5064917e92d5e364542,2,15,12,3,0,0,0,6,16,2,1,1,0.999010271,204,90,11,44,44,0,921,921,0,39,39,0,100
aec144cdfaf909826b7d9bc6f5d6e2aa4d93a6a0,1,60,0,60,1,0,1,1,1,0,1,1,0,0,5,3,3,0,3,246,0,246,2,0,2,99.97124922
64181e58adb7b0e78c0fdf89daa81f4050cfb9d6,5,179,3,176,2,0,2,5,28,768,3,4,2.005782651,1056,461,1,263,245,18,7744,7262,482,92,80,12,99.98083924
68208302996c67f39d3db78498ea6b1e51be39d8,4,35,4,31,0,0,0,3,16,623,1,4,1.662086134,874,232,2,90,87,3,5376,5217,159,68,68,0,100
90373cb93fbff9cb8605401f4ff64d15b300e858,1,23,4,19,0,0,0,9,86,93,1,1,0,1737,233,3,534,529,5,13406,13270,136,125,124,1,100
a0b6b2a85d817ae92812fe8594f4c5d351ac8f0e,2,16,4,12,0,0,0,8,35,102,1,2,0.881290899,1312,234,4,378,374,4,11554,11474,80,135,134,1,100
7a7e24366521264df89073dd4ff3b485425f3d0f,0,0,0,0,0,0,0,0,0,0,0,0,0,0,235,5,0,0,0,0,0,0,0,0,0,100
b4782910c56f5001ad142ed2726dda6e5a8d0f4c,1,2,1,1,0,0,0,4,7,839,1,1,0,99,134,0,15,14,1,517,506,11,2,2,0,100
f8c32d45d2cf0e22a9ce747bfc258321796e6a9b,1,2,0,2,0,0,0,3,39,689,1,1,0,1465,236,6,345,345,0,11868,11827,41,262,262,0,100
9225c60a74271459b857eb74a1756d06319e051d,2,96,17,79,1,0,1,1,6,186,2,2,0.997230114,219,91,12,50,42,8,1610,1339,271,14,10,4,100
1916e1bd8697d4d62af0510c8069bbb87962929d,1,1,1,0,0,0,0,2,2,936,1,1,0,59,237,7,5,5,0,283,283,0,3,3,0,100
0a8c27709d5d51f88b796acf66f5c217b64788cd,0,0,0,0,0,0,0,0,0,0,0,0,0,0,462,2,0,0,0,0,0,0,0,0,0,100
c3a7417e2456bc98436dddcc8d048983069f24ac,3,60,31,29,0,0,0,1,22,189,2,2,1.408704209,842,92,13,124,121,3,4821,4743,78,77,73,4,100
9166a7753a1a5091654e46d078164dffe21ac685,2,19,2,17,0,0,0,4,8,341,1,2,0.702466551,452,238,8,52,48,4,4123,4019,104,26,26,0,100
42b0b38815b90afde293c230854b2887d6bd79c8,1,1,1,0,0,0,0,4,7,2078,1,1,0,47,239,9,5,5,0,203,203,0,4,4,0,100
de0e36d39bcfee208fe5bd83f33fa4b46a1768b3,3,188,0,188,2,0,2,1,59,159,2,3,0.896115602,721,463,3,231,207,24,5601,4982,619,87,64,23,97.92972737
982b643868aae81de97a80b75a41c2746d450933,0,0,0,0,0,0,0,0,0,0,0,0,0,0,464,4,0,0,0,0,0,0,0,0,0,100
28f7b7e744e1886413b5a6dfcf5022991764a6bf,0,0,0,0,0,0,0,0,0,0,0,0,0,0,465,5,0,0,0,0,0,0,0,0,0,100
84d5a659b4f065113322c4f8417d0ce16ac0356a,0,0,0,0,0,0,0,0,0,0,0,0,0,0,466,5,0,0,0,0,0,0,0,0,0,100
bfad6bc65fc4307403f4fd947f26d52c627065cb,1,1,1,0,0,0,0,12,30,20,1,1,0,760,240,10,162,162,0,5148,5148,0,49,49,0,100
3b3d01cb6a961c5e017b21df48b669f68040ee24,1,1,1,0,0,0,0,3,3,375,1,1,0,47,241,11,4,4,0,132,132,0,4,4,0,100
ebd30a7cc7a59f78a25aea3161f7cc11bedef084,7,330,61,269,1,0,1,8,67,244,4,5,2.110706696,3087,348,1,781,748,33,22206,20770,1436,314,300,14,99.99013612
e65477c9fa66bb97ec4a09d41d17345f04a59980,0,0,0,0,0,0,0,0,0,0,0,0,0,0,349,2,0,0,0,0,0,0,0,0,0,100
30ccdd8dab561bb535878f397a8f959a0a46565f,0,0,0,0,0,0,0,0,0,0,0,0,0,0,350,3,0,0,0,0,0,0,0,0,0,100
459dddcd5946f45baf0a74bc1dfafd795a6d1494,1,8,1,7,0,0,0,9,60,5,1,1,0,722,467,6,208,207,1,5044,4986,58,64,64,0,100
6d8b5782c9cb1f75bbe6d9c483e4f1b54f8207c7,5,373,4,369,3,0,3,4,27,12,2,2,2.09991737,1284,191,2,254,210,44,11910,10269,1641,123,97,26,99.96549004
4c92537fb5856d029a524c4e7842e1c63751077c,3,275,275,0,0,0,0,2,2,0,1,1,1.552492247,201,351,4,34,34,0,768,768,0,25,25,0,100
44a7674d6ef00a358a9d8d51c7a5fc219518c34c,16,562,42,520,2,0,2,3,87,178,3,7,3.400909305,8223,242,12,2513,2412,101,64097,61157,2940,965,930,35,94.62095463
a4038dadefbec53535ba84713b32e01706f25a77,2,33,9,24,0,0,0,4,28,27,2,2,0.791858353,1509,192,1,283,282,1,11835,11708,127,128,127,1,100
4ff6c05a3e24496d50ccf3da8a870f126d3da13c,4,1437,0,1437,4,0,4,1,1,0,1,3,1.933957596,0,657,0,192,0,192,6470,0,6470,70,0,70,99.95079224
2f880eaacb9481688eee2ac5b596b788f9a78b6e,1,2,0,2,0,0,0,3,4,39,1,1,0,172,352,4,43,43,0,828,819,9,26,26,0,100
892755a822ce2152ba62e47afe623b6e645d3bf7,1,74,0,74,1,0,1,1,1,0,1,1,0,0,658,1,6,0,6,138,0,138,4,0,4,99.99016426
40e05de74205a5a8b5cafdc0d8f1cffc9223dd95,1,5,9,4,0,0,0,10,40,327,1,1,0,414,659,2,116,116,0,2565,2540,25,50,50,0,100
a18edf3f92670bc100eefed84523009052db4cbd,1,0,1,1,0,0,0,10,41,0,1,1,0,416,660,3,116,116,0,2554,2565,11,50,50,0,100
795362f5ce669a43d3aacb16ade19b64059712f5,1,2,1,1,0,0,0,2,2,0,1,1,0,302,468,7,47,47,0,2303,2303,0,12,12,0,100
037f99e480772c8b1920f8fd0bf436bc01a26966,2,0,6,6,0,0,0,2,2,0,1,2,0.650022422,461,353,5,97,97,0,2936,2948,12,41,41,0,100
459aae4b28b43660b20a032c104bc0c0974f4af1,3,277,0,277,3,0,3,1,1,0,1,1,1.579353353,0,661,4,26,0,26,1079,0,1079,16,0,16,99.96559013
b6103d270a2b043a4e0531fa21d186dfc696967d,1,1,1,0,0,0,0,4,4,329,1,1,0,72,354,6,4,4,0,407,407,0,3,3,0,100
d28788fc83d3f86244d0afe0b25dedecc2759ccc,0,0,0,0,0,0,0,0,0,0,0,0,0,0,469,8,0,0,0,0,0,0,0,0,0,100
ac42e2d8eba1a7d5ec8c9773348691220e40b8a2,1,1,1,0,0,0,0,3,9,329,1,1,0,181,243,13,29,28,1,1381,1376,5,8,8,0,100
d27ca8ef8aa6864d08cdec90ea8231dc5383bd01,8,0,1783,1783,0,0,0,2,3,0,1,4,2.661165585,1214,470,9,0,224,224,0,7675,7675,0,90,90,99.90654665
e97e42b3eb5a3297f60e4c9a816d8dff8a8f9359,3,118,1,117,0,0,0,8,47,18,2,2,1.577334967,526,355,7,111,89,22,4056,3316,740,59,52,7,96.38302015
bdb09074a7dd8ab317d28e5f7e11ebe3f668efb9,1,18,0,18,0,0,0,3,7,335,1,1,0,318,244,14,44,40,4,2656,2565,91,8,8,0,100
534892a4ada1c8029f1354c23060d50de459e554,0,0,0,0,0,0,0,0,0,0,0,0,0,0,471,10,0,0,0,0,0,0,0,0,0,100
a7cadff1fa66fcf640e3f7afd934f7b02a630c54,2,5,2,3,0,0,0,2,2,196,1,2,0.985228136,309,472,11,74,74,0,1798,1798,0,31,31,0,100
800899841f5882d5f4782837d040aa89bb41b482,13,0,0,0,0,0,0,1,1,0,1,5,0,797,473,12,71,39,32,3573,6357,2784,54,26,28,99.80743308
279864455834261ae05fca5051818cdfa3d110d3,0,0,0,0,0,0,0,0,0,0,0,0,0,0,474,13,0,0,0,0,0,0,0,0,0,100
899b56b4187626fb5b21895fc9d05253219f130c,0,0,0,0,0,0,0,0,0,0,0,0,0,0,475,14,0,0,0,0,0,0,0,0,0,100
8f06f9a08bfcc2e6644a67dd336e684d97b7843d,0,0,0,0,0,0,0,0,0,0,0,0,0,0,476,14,0,0,0,0,0,0,0,0,0,100
39fb510cb80c1424e993ee845bbdf64c8e83a6e3,0,0,0,0,0,0,0,0,0,0,0,0,0,0,477,15,0,0,0,0,0,0,0,0,0,100
b1eed9c9719af47a9969e208ee8ee3e52161d020,0,0,0,0,0,0,0,0,0,0,0,0,0,0,478,16,0,0,0,0,0,0,0,0,0,100
d14e569301badd0df447a940df1788a4d060c149,0,0,0,0,0,0,0,0,0,0,0,0,0,0,93,2,0,0,0,0,0,0,0,0,0,100
07709672f7d1d24b5e38a660be2575f06079b65f,2,14,12,2,0,0,0,10,69,1278,1,1,0.89049164,1710,94,3,509,509,0,11832,11879,47,157,157,0,100
4dcca875006e4e2c0a91a6d9e961617f34a69898,2,64,8,56,0,0,0,6,32,468,2,2,0.710676854,579,95,4,146,141,5,3763,3444,319,77,75,2,99.81761459
33ac4aa0cb9a2b17fd989145167e6aa0a6c6a1b9,0,0,0,0,0,0,0,0,0,0,0,0,0,0,135,1,0,0,0,0,0,0,0,0,0,100
7d5c4f4dceb04499bdf1e31fb61ef538b8e40ba6,0,0,0,0,0,0,0,0,0,0,0,0,0,0,427,0,0,0,0,0,0,0,0,0,0,100
1b07ef0bc7f53a71b4301f242e6b04963b2a362a,2,15,3,12,0,0,0,2,23,2053,1,2,0.918295834,250,428,1,55,52,3,1552,1463,89,33,33,0,100
bb7c9b2fd8cc0077cdde85e6cf595c2b54d611c0,1,1,1,0,0,0,0,10,33,8,1,1,0,517,96,5,135,135,0,3139,3139,0,71,71,0,100
4c38d185f45282aa0e7bb483e0f2b760f71086c8,0,0,0,0,0,0,0,0,0,0,0,0,0,0,479,17,0,0,0,0,0,0,0,0,0,100
a4db0cb1ca08983e08d400e5e67e29974a47de14,0,0,0,0,0,0,0,0,0,0,0,0,0,0,480,18,0,0,0,0,0,0,0,0,0,100
e65737308ba646ba29eb741983d691ccb6b0f944,3,33,4,29,0,0,0,5,35,727,2,3,1.036967891,1098,97,5,254,251,3,8128,7861,267,76,75,1,100
733adeb47b01342ee337f8a3cd8131ea9dbfb3b1,32,2711,1,2710,28,0,28,1,116,26,3,6,4.710754125,6079,144,0,1803,1541,262,45788,38216,7572,758,589,169,99.73774557
46026f012c892d15e1b4673d37e2c166e7313569,7,65,10,55,0,0,0,10,117,319,1,2,2.52875413,7116,662,5,2116,2105,11,44374,44144,230,685,681,4,100
536e3a284b5252c783aa6c211e8296cccb7ce913,4,217,13,204,2,0,2,1,2,2,2,2,1.520192521,282,145,1,69,53,16,2326,1468,858,47,36,11,99.88122951
40f601f1b834a127e0f2e45441bfec520abed4ce,0,0,0,0,0,0,0,0,0,0,0,0,0,0,136,1,0,0,0,0,0,0,0,0,0,100
d88d28ae0d068eab99b58ed5ae3e4a89cbf0b29b,0,0,0,0,0,0,0,0,0,0,0,0,0,0,146,2,0,0,0,0,0,0,0,0,0,100
5799ca5f5e593f0fb8078f44d34502685cde911f,0,0,0,0,0,0,0,0,0,0,0,0,0,0,147,3,0,0,0,0,0,0,0,0,0,100
1f58c01ea41edc12395c143f9999f360f71ee471,7,60,12,48,0,0,0,1,2,4,1,1,1.916395956,389,148,4,56,50,6,1901,1703,198,32,26,6,99.92399411
4118e6ac44a34bb867baac7ed9c59aff76643a20,2,201,0,201,2,0,2,1,1,0,1,1,0.817138776,0,149,5,10,0,10,1019,0,1019,6,0,6,99.97625267
eef3693be87a586b8580d6765044224fc5d61864,1,0,42,42,0,0,0,1,3,0,1,1,0,111,150,6,12,18,6,451,604,153,6,12,6,100
b8798f1abe8fb84b0450bdbf2b436ceee40f9c86,0,0,0,0,0,0,0,0,0,0,0,0,0,0,151,7,0,0,0,0,0,0,0,0,0,100
bcfadcff1beb2ce2723ab79b817b90c77c6cc6d3,0,0,0,0,0,0,0,0,0,0,0,0,0,0,481,13,0,0,0,0,0,0,0,0,0,100
c9a86d9652993e9a34426b2eb67606aff190dd26,1,47,25,22,0,0,0,4,8,31,1,1,0,333,193,1,51,44,7,2780,2656,124,8,8,0,100
7c0f066234fc2b94de55ab2013eefb9d4a88c9a2,0,0,0,0,0,0,0,0,0,0,0,0,0,0,98,5,0,0,0,0,0,0,0,0,0,100
0f0c6de65206459d532a5aaaeeb1e63cd609a0fb,4,47,22,25,0,0,0,2,26,610,2,2,1.914200277,613,356,3,72,68,4,4092,3960,132,41,39,2,96.75043328
aec11be5f11921f6eb0d70e499b133a6b2edbc5e,0,0,0,0,0,0,0,0,0,0,0,0,0,0,482,13,0,0,0,0,0,0,0,0,0,100
a2d3c9f57a3979993ccb2af901bbb621a5d022c0,0,0,0,0,0,0,0,0,0,0,0,0,0,0,483,14,0,0,0,0,0,0,0,0,0,100
c9f58ec243d0053dc7fb312c5a37810ce01be250,13,334,183,151,0,0,0,3,4,790,1,1,1.978292967,5318,137,2,494,494,0,35822,35592,230,213,213,0,100
8cb9f588ff68d1e6e09294e29c71e4d2e45e4ec1,3,104,0,104,1,0,1,1,33,229,1,2,0.215061259,1348,245,1,235,222,13,9194,8715,479,97,94,3,99.98047352
4fd4c17c769a8eb2b36fc4ca51191d654b03849f,1,1,0,1,0,0,0,1,2,0,1,1,0,80,246,2,12,12,0,459,455,4,3,3,0,100
7b1d5067d6be77ad953a907d7ca12027acc975bd,1,63,138,75,0,0,0,2,4,0,1,1,0,371,138,3,27,27,0,2165,2294,129,27,27,0,100
a6cfb6c8482907e4ae240b2515a814792be3e06e,1,20,6,14,0,0,0,13,94,150,1,1,0,817,357,1,197,193,4,5677,5594,83,47,47,0,100
eeeca1cedbe596c6a3ff5ab050a6d43340590041,0,0,0,0,0,0,0,0,0,0,0,0,0,0,99,6,0,0,0,0,0,0,0,0,0,100
0876c93ff67a568667d1e4494825df50164b3521,2,11,1,10,0,0,0,5,17,98,2,2,0.41381685,466,100,7,92,87,5,3151,3079,72,42,42,0,100
25ccc95d6c8943763d2cb552d282e7b0c6122e15,10,662,142,520,0,0,0,1,20,748,3,5,2.381745084,1044,152,8,272,206,66,8378,5417,2961,130,91,39,99.98535514
754cc62f5c5be54db2b9851118649932ab2b8dac,0,0,0,0,0,0,0,0,0,0,0,0,0,0,101,8,0,0,0,0,0,0,0,0,0,100
7bfc33e46821639c92b9a32c32f891d3e7e995ef,1,25,7,18,0,0,0,2,2,68,1,1,0,39,358,2,5,1,4,230,154,76,4,1,3,95.75340529
a36ace562b0f634530773ee54eab14b73315d6a7,10,291,53,238,0,0,0,3,24,143,3,5,2.801403542,2202,153,9,543,497,46,14835,13841,994,283,259,24,99.88184504
319ba414835f6b2826905739eaaa9958fd583ede,2,133,12,121,1,0,1,1,33,235,2,2,0.66319684,621,102,9,142,129,13,4821,4207,614,58,50,8,99.99093464
7e50c0bf6dae733ea989872e33ab5b1f05919d33,6,490,0,490,6,0,6,1,1,0,1,1,2.510032086,0,359,3,47,0,47,1736,0,1736,47,0,47,99.94111519
3265c84105750842894a433b59b7fce77ff63d00,2,6,2,4,0,0,0,1,2,210,1,1,1,75,154,10,6,6,0,402,346,56,6,6,0,100
9d3305bcc40af92630514e5e773a1548d9ba0143,1,73,2,71,0,0,0,1,3,5,1,1,0,81,247,2,20,12,8,842,459,383,6,3,3,100
268658f782c1c8f934e51a0dff6227c1e2e3c8be,0,0,0,0,0,0,0,0,0,0,0,0,0,0,155,11,0,0,0,0,0,0,0,0,0,100
e449027abece9500d5118e0be3274837dd451606,1,2,1,1,0,0,0,3,15,276,1,1,0,317,360,4,37,37,0,2262,2255,7,15,15,0,100
20507e6d4b2a16475666027c4d1bb332acd1714f,1,0,50,50,0,0,0,2,4,8,1,1,0,351,139,4,27,27,0,2192,2192,0,27,27,0,100
3b8f7948b006a4539538e6e132b29ab9af2b567c,0,0,0,0,0,0,0,0,0,0,0,0,0,0,484,5,0,0,0,0,0,0,0,0,0,100
021e8a498e08f64c1c553a6f8f188269eb45c164,0,0,0,0,0,0,0,0,0,0,0,0,0,0,485,6,0,0,0,0,0,0,0,0,0,100
98563ecfdf3acea9532c7fe9038b6011fd058be3,0,0,0,0,0,0,0,0,0,0,0,0,0,0,486,5,0,0,0,0,0,0,0,0,0,100
b3b274d545c3d12b6a2c870414683895f287afaa,2,69,20,49,0,0,0,1,150,84,1,1,0.356204804,3706,248,3,1086,1078,8,27396,27148,248,305,304,1,99.95020146
f31d31ff9e204b7332868c3752cb7bd13f4f841f,1,6,1,5,0,0,0,3,4,1356,1,1,0,108,103,5,14,13,1,663,633,30,9,9,0,100
0b3f1b2d2a59a1fa991b62b678ec6352a0af2889,4,34,5,29,0,0,0,1,4,633,2,2,0.998486165,1188,156,11,342,336,6,8001,7866,135,135,132,3,100
22620e0a65a6a5bd2207257f5bcebf9306ab6719,0,0,0,0,0,0,0,0,0,0,0,0,0,0,663,1,0,0,0,0,0,0,0,0,0,100
3750cd1f6da5cf46aa793781223daec2eefda26d,1,1,0,1,0,0,0,8,17,1052,1,1,0,1085,194,1,378,378,0,7033,7031,2,89,89,0,100
efd6ee93b53302725216a90c641dab7b498ac772,1,172,37,135,0,0,0,1,5,3,1,1,0,183,249,4,57,27,30,1801,1102,699,12,7,5,100
dbb0a5fe4149bc503e07a6be298cd02c5ba47427,1,3,3,0,0,0,0,1,6,1,1,1,0,264,250,5,57,57,0,1803,1801,2,12,12,0,100
a7bd0831ccb0e2e207b43a69df594a6481268218,1,4,1,3,0,0,0,6,12,655,1,1,0,119,664,1,20,19,1,870,846,24,6,6,0,100
bf9a1edd69289ba62b75562b64bb44dd0991c014,2,17,13,4,0,0,0,11,68,226,2,2,0.987137774,856,104,6,185,184,1,5811,5806,5,60,60,0,100
157c6e689f15ec9fbcf1e86b925dde950f6283ea,1,2,1,1,0,0,0,11,69,0,1,1,0,725,105,7,149,149,0,4995,4995,0,46,46,0,100
5a8030a8026dd6ba77be8988478806e33c565be3,1,1,0,1,0,0,0,3,8,1221,1,1,0,98,106,8,12,12,0,671,667,4,6,6,0,100
63a24dc7bbd3a99be2d750b5e05303f78e48f6ce,2,70,3,67,1,0,1,1,118,22,2,2,0.73275255,3842,107,9,1117,1113,4,24216,23925,291,295,293,2,99.99094613
07d599a02ded21441ccdaec9dd03301238081243,4,215,20,195,0,0,0,4,151,319,2,3,0.897185524,5080,251,6,1462,1412,50,38614,37330,1284,400,388,12,96.14782949
b4715f9669e160652e51fbf5c8d160d412123cc7,0,0,0,0,0,0,0,0,0,0,0,0,0,0,487,6,0,0,0,0,0,0,0,0,0,100
cb4ac9b8916ca0de178b185d7cff08c5edc8a620,1,3,1,2,0,0,0,5,16,600,1,1,0,350,252,7,46,45,1,3172,3155,17,5,5,0,100
560afb7df4c1a62f7f4e8b7a0c975e7376786637,0,0,0,0,0,0,0,0,0,0,0,0,0,0,488,7,0,0,0,0,0,0,0,0,0,100
3a62393e068bb7ddd1237fa96e6a29d30f4efab6,1,23,0,23,0,0,0,1,8,1,1,1,0,402,253,8,107,102,5,3056,2928,128,22,20,2,100
3b20d750e73919118acd035b194cbe9ad64e7fc2,4,94,25,69,0,0,0,3,12,1187,2,2,1.261366172,507,108,10,113,104,9,3511,3142,369,59,56,3,100
729d6751c998df7278ec26a70cf064546c3658e9,1,2,1,1,0,0,0,3,10,69,1,1,0,181,254,9,30,29,1,1398,1381,17,8,8,0,100
9c3364d5c90222da411bd0ea786c5a1eb00e3080,0,0,0,0,0,0,0,0,0,0,0,0,0,0,157,5,0,0,0,0,0,0,0,0,0,100
696786e93e3556d8fb3b08de381990c946610308,0,0,0,0,0,0,0,0,0,0,0,0,0,0,158,6,0,0,0,0,0,0,0,0,0,100
833520766fb60b735687ad60f1564c76d04edf1c,9,369,35,334,2,0,2,4,53,658,2,6,2.082395132,1563,195,2,390,347,43,12730,10626,2104,126,110,16,99.96812749
c000f0bf624e41e7f9681831a2656e02106e96c1,1,1,1,0,0,0,0,3,4,0,1,1,0,61,196,3,8,8,0,218,218,0,8,8,0,100
93c0bbea8feb8449956dd5af2799c4efb70cb8f5,9,225,306,81,5,0,5,1,70,161,2,4,2.591548754,2061,197,4,547,577,30,13090,13517,427,197,207,10,99.92568608
2c188f1113aa28f39c25673317a27324795545b9,3,321,4,317,0,0,0,4,15,168,1,1,1.10664901,1192,58,0,417,340,77,9233,7420,1813,385,308,77,100
f0f3a4c588ff8a7c78e95d12b46ed54e8cfae838,2,2,2,0,0,0,0,1,9,401,1,2,0.811278124,490,255,10,120,120,0,3468,3466,2,28,28,0,100
b3c9553f5902ef8eec6a6891bc80fdc87e908167,1,215,215,0,0,0,0,2,2,8,1,1,0,183,361,4,19,19,0,1480,1480,0,5,5,0,100
acef04f0f637756a63ec4cb532f695cbbffb2974,1,75,75,0,0,0,0,2,2,8,1,1,0,61,362,5,8,8,0,239,239,0,8,8,0,100
99332850e30dbd6f5d419754b9cc3caabb5b850b,5,211,211,0,0,0,0,2,2,5,1,1,2.270472946,180,363,6,10,10,0,533,533,0,7,7,0,100
adfa274b3439b5abecc120330efd9cf59cecc3f8,0,0,0,0,0,0,0,0,0,0,0,0,0,0,256,11,0,0,0,0,0,0,0,0,0,100
319184d64e7b0c3c1a0c2dc2e9969bb3df1b14ee,0,0,0,0,0,0,0,0,0,0,0,0,0,0,257,12,0,0,0,0,0,0,0,0,0,100
e0882d7cc03da7d8dacf445cc0daf8862f248a50,42,5485,0,5485,42,0,42,1,1,0,1,8,5.151940697,0,665,2,558,0,558,23026,0,23026,322,0,322,94.18797033
4f23e96e09a0a256b4ce63fc59526c9ce0a4b52a,0,0,0,0,0,0,0,0,0,0,0,0,0,0,666,3,0,0,0,0,0,0,0,0,0,100
f45f6d57a089ee7487783f36613dd2a385d33106,0,0,0,0,0,0,0,0,0,0,0,0,0,0,667,4,0,0,0,0,0,0,0,0,0,100
f39b149d5109515a201d6a21a46e6ef72328ef04,0,0,0,0,0,0,0,0,0,0,0,0,0,0,668,5,0,0,0,0,0,0,0,0,0,100
44dd974dfce73f0fb0f97c143f9459c982273358,0,0,0,0,0,0,0,0,0,0,0,0,0,0,669,6,0,0,0,0,0,0,0,0,0,100
35b6da3dfe0f860f993df760c3021c4098171392,0,0,0,0,0,0,0,0,0,0,0,0,0,0,364,7,0,0,0,0,0,0,0,0,0,100
581494293acabcfa8fb4617617746331e0153451,0,0,0,0,0,0,0,0,0,0,0,0,0,0,489,5,0,0,0,0,0,0,0,0,0,100
c772a6f26df6bc55a1276483d3558b64d194e1a9,0,0,0,0,0,0,0,0,0,0,0,0,0,0,490,6,0,0,0,0,0,0,0,0,0,100
d618ec5dd4a12d28e52342705ed978c1293f375a,0,0,0,0,0,0,0,0,0,0,0,0,0,0,491,7,0,0,0,0,0,0,0,0,0,100
7126e2d49caba191c0a0c9e862b48f05153ee7c7,0,0,0,0,0,0,0,0,0,0,0,0,0,0,159,7,0,0,0,0,0,0,0,0,0,100
56f3b72b8b88068506a3e04e9e024f2f4872c836,0,0,0,0,0,0,0,0,0,0,0,0,0,0,492,8,0,0,0,0,0,0,0,0,0,100
911140bf8341880c04df24dec74c4ecff97c64eb,0,0,0,0,0,0,0,0,0,0,0,0,0,0,493,9,0,0,0,0,0,0,0,0,0,100
4d6fd5d806a30561f4ce337b09417c54093c7161,3,52,35,17,0,0,0,1,2,3,1,3,0.940144077,298,670,7,40,38,2,2208,2093,115,25,25,0,100
dc42b99108e799ee8c8785795eeb5e50caee1673,0,0,0,0,0,0,0,0,0,0,0,0,0,0,494,10,0,0,0,0,0,0,0,0,0,100
3ba73bc59f0ed0e96d96282fa7a57ccd62a6ff3d,1,13,156,143,0,0,0,6,16,514,1,1,0,497,59,1,92,113,21,2085,3169,1084,60,65,5,100
da688116d56821867cc4fdd44b9370bbbc8a4ff3,1,4,4,0,0,0,0,2,10,11,1,1,0,421,60,2,107,107,0,3060,3060,0,22,22,0,100
52f468bf3b75b0ad0e5243cdc9c1f65a54e43ce7,0,0,0,0,0,0,0,0,0,0,0,0,0,0,671,8,0,0,0,0,0,0,0,0,0,100
96ee7d32e968030484416be6594a637752d6c1a6,2,85,2,83,0,0,0,7,17,341,1,1,0.948980459,982,61,3,289,271,18,5858,5433,425,253,235,18,100
f80e2398fafd28cc4780bb62b8ba34bf326828d6,1,5,2,3,0,0,0,7,14,0,1,1,0,639,495,9,186,186,0,3506,3506,0,182,182,0,100
f56c4ca729f66833db787db1a2bc58d81fe6868a,5,64,30,34,0,0,0,2,20,776,1,3,1.881224288,876,672,9,212,202,10,5846,5665,181,79,78,1,100
7569f437dbee125c690ea52cc817d81356099294,1,205,11,194,0,0,0,5,12,1057,1,1,0,532,62,4,205,157,48,4484,3321,1163,198,150,48,100
238beccbfdc739b27ff484c7023fc564b7d50cfb,7,22,254,232,0,0,0,1,2,28,1,4,1.894759366,871,673,8,116,149,33,4713,5391,678,61,82,21,94.69379083
4628962d2adc6a2c87f1c5cf674be766d2b80c69,2,119,0,119,2,0,2,1,1,0,1,1,0.92909503,0,365,0,9,0,9,418,0,418,5,0,5,99.97372984
f5dbf21ca5003a2e66a5f2f462573771b96e184d,2,82,0,82,1,0,1,1,88,69,2,2,0.736323027,1775,198,0,551,543,8,13944,13536,408,130,127,3,99.96324495
9a0f463d6cbef603eeda7fe09b922befb126b9ed,0,0,0,0,0,0,0,0,0,0,0,0,0,0,496,6,0,0,0,0,0,0,0,0,0,100
9c25bd16339a2421edb24713dae2b2b9e9998f14,5,285,2,283,3,0,3,1,13,887,3,3,1.992095608,384,258,0,107,67,40,3917,2668,1249,59,36,23,99.96327195
00b99e267f6a47f249961ba9aa7281d84235237c,2,36,0,36,0,0,0,2,2,0,1,1,1,113,497,3,29,29,0,685,685,0,17,17,0,100
9ec516a346735ea22fd0ed5a0c71a5375a33833c,1,65,65,0,0,0,0,2,2,4,1,1,0,58,366,1,2,2,0,326,326,0,2,2,0,100
d3ca8f3cc4db0b262bff377fc1259afa7f70e999,0,0,0,0,0,0,0,0,0,0,0,0,0,0,498,3,0,0,0,0,0,0,0,0,0,100
35205c46acdd25acd7370837bb72baab900f5bcd,2,6,9,3,0,0,0,3,14,0,2,2,0.970950594,401,259,1,71,74,3,2751,2806,55,38,38,0,100
208347e88d06ea095c3893c622f215f8b8a6fbcd,1,2,1,1,0,0,0,6,7,546,1,1,0,359,367,2,60,60,0,2269,2263,6,19,19,0,100
8cf2d1d2593e168093dd6c8fb3db9767b8a33d83,0,0,0,0,0,0,0,0,0,0,0,0,0,0,499,3,0,0,0,0,0,0,0,0,0,100
243b44398361546364e73d5ddb80355650de1f9a,0,0,0,0,0,0,0,0,0,0,0,0,0,0,140,0,0,0,0,0,0,0,0,0,0,100
dd36c1d62993d4538882bed6086803ab0582e7eb,0,0,0,0,0,0,0,0,0,0,0,0,0,0,368,3,0,0,0,0,0,0,0,0,0,100
679fee98d6973116414f10005e62288f0f9ed112,0,0,0,0,0,0,0,0,0,0,0,0,0,0,109,0,0,0,0,0,0,0,0,0,0,100
c110e0d28a03f0458620d30d10904204236cef8a,0,0,0,0,0,0,0,0,0,0,0,0,0,0,199,1,0,0,0,0,0,0,0,0,0,100
eaaecc5043364e5e51dc1141adfa58c1a1aefbd8,0,0,0,0,0,0,0,0,0,0,0,0,0,0,500,4,0,0,0,0,0,0,0,0,0,100
0fd180d95af39b4d9d3bca4aa4064b6ae976e464,0,0,0,0,0,0,0,0,0,0,0,0,0,0,501,5,0,0,0,0,0,0,0,0,0,100
b877e90db8fddb50bfb44dcb024f8c92c352d440,1,13,3,10,0,0,0,3,17,185,1,1,0,371,369,4,18,17,1,2175,2065,110,10,10,0,99.98950737
a093e9daa6f01385758993501e155f837ac6b524,1,16,2,14,0,0,0,8,17,426,1,1,0,286,370,5,48,46,2,1946,1885,61,18,18,0,100
c1b941f3d16b8d0fa4e9388c236484d42aea2438,1,0,2,2,0,0,0,8,18,0,1,1,0,294,371,6,48,48,0,1942,1946,4,18,18,0,100
f943cc83b22e82d2d9cc8f11a090ca8fd725efbd,1,3,13,10,0,0,0,3,18,0,1,1,0,381,372,7,17,18,1,2065,2175,110,10,10,0,99.98950737
6f67c88603cd167ed9e911112e41bcafd394e764,1,1,1,0,0,0,0,2,6,1449,1,1,0,127,373,8,8,8,0,786,781,5,7,7,0,100
9b1577b6f189add03718319547540d93d5a9c3d8,0,0,0,0,0,0,0,0,0,0,0,0,0,0,502,6,0,0,0,0,0,0,0,0,0,100
e5f835fbd0bedd1c087ad072a0890ad157f211f0,1,19,12,7,0,0,0,4,11,86,1,1,0,182,374,9,30,30,0,1443,1398,45,8,8,0,100
f4fc93c1282e53476c82525cd36902797c737947,3,22,2,20,0,0,0,11,99,233,1,1,1.428412468,1957,110,1,490,484,6,13002,12837,165,276,276,0,100
782b86628cc030ba703fa21358fc2a22f8aab7bd,0,0,0,0,0,0,0,0,0,0,0,0,0,0,503,7,0,0,0,0,0,0,0,0,0,100
b76ab3884e1bb57e9b066d06ea516455d2de01b2,1,1,1,0,0,0,0,7,15,295,1,1,0,247,504,8,61,61,0,1889,1889,0,9,9,0,100
9b105a2f00e451e190defd033c70271020de034d,3,202,2,200,1,0,1,1,64,105,2,2,1.136411506,1750,160,0,465,447,18,13702,12812,890,136,125,11,99.96329121
cccd4c799d683d9beb78e9ed87c4974ca2b8306c,1,40,25,15,0,0,0,5,8,192,1,1,0,231,505,8,54,45,9,1667,1472,195,10,10,0,100
474c1b60c9363028ab9e23edbdd546115732de1b,5,235,1,234,4,0,4,1,31,249,2,2,2.109965506,1292,375,9,273,253,20,11598,10927,671,78,61,17,99.07398037
d079a88733e4f492fd7a8ebe3841c444dd3561d7,0,0,0,0,0,0,0,0,0,0,0,0,0,0,506,8,0,0,0,0,0,0,0,0,0,100
06537153cac1a7ba9090bdacad594f6b262fd8fa,1,2,2,0,0,0,0,5,11,3773,1,1,0,206,376,9,56,56,0,1330,1328,2,32,32,0,100
9f392edc9d848440d296b44b4511a5dbae07bd5a,0,0,0,0,0,0,0,0,0,0,0,0,0,0,377,10,0,0,0,0,0,0,0,0,0,100
ed85f020fdd883e536db7f4e54b7f7e88e97397d,7,389,11,378,2,0,2,8,48,967,2,4,1.243917953,1676,507,7,446,382,64,12010,10514,1496,190,168,22,99.97555729
cde2a4aaf278bc552f81158a6a573d15b775369c,2,45,2,43,0,0,0,4,25,996,2,2,0.983939395,702,200,1,156,150,6,5326,5143,183,63,63,0,100
6dbe665329e232909668fd20bdedc5739c2f8351,2,1,42,41,0,0,0,3,6,958,1,2,0.693127415,119,111,1,9,11,2,468,585,117,5,7,2,99.97556207
4aa5b4382557ec17d8e34981517a6b76e1877080,1,31,33,2,0,0,0,1,2,2,1,1,0,201,508,6,53,54,1,1238,1246,8,16,16,0,100
fb7a54909d4537315d066d38b40dd9a4ebe3944e,13,145,27,118,1,0,1,1,3,93,1,5,3.250344274,1219,674,0,167,151,16,8719,8141,578,96,88,8,99.92180245
fce1fe09721d464b3dfd8bfdd7cda979df4d8daf,1,18,0,18,0,0,0,2,2,0,1,1,0,20,509,7,4,4,0,213,213,0,1,1,0,100
c7a08227a31ca8983e970d79695605ef2896353f,2,31,1,30,0,0,0,2,4,528,2,2,0.997180399,258,510,8,69,61,8,1584,1453,131,22,21,1,99.99511289
1f64b37ec51ac86c953aceb5288bbe2a2237e2a2,1,4,0,4,0,0,0,1,2,423,1,1,0,33,112,2,1,1,0,89,77,12,1,1,0,100
a4080f46f5aa1b420e4910209fc0eb737624dba8,2,26,2,24,0,0,0,4,23,696,2,2,0.99631652,404,260,0,104,98,6,3321,3160,161,20,18,2,100
c92c435728635a651ee1c9d1b0844f780b0bd667,0,0,0,0,0,0,0,0,0,0,0,0,0,0,511,8,0,0,0,0,0,0,0,0,0,100
d58eaa98ee19f44dfc9eda8cecebdd31951e84dd,0,0,0,0,0,0,0,0,0,0,0,0,0,0,512,9,0,0,0,0,0,0,0,0,0,100
2f996c28834b2f30e8053205be92a3045b6e9ba3,0,0,0,0,0,0,0,0,0,0,0,0,0,0,513,10,0,0,0,0,0,0,0,0,0,100
8f5bc3cd56456c75d9566f67847e70e0f9d8b564,0,0,0,0,0,0,0,0,0,0,0,0,0,0,63,0,0,0,0,0,0,0,0,0,0,100
ccd2dde6dcfa639d5be063ab7953224fa5b1138e,0,0,0,0,0,0,0,0,0,0,0,0,0,0,64,1,0,0,0,0,0,0,0,0,0,100
8fa232c9330e0ea206beecfb070fd21161eecaa7,0,0,0,0,0,0,0,0,0,0,0,0,0,0,141,0,0,0,0,0,0,0,0,0,0,100
5a98879567c0288cd1117aa0b177091fa14706bc,4,83,11,72,0,0,0,7,152,322,2,2,1.600280798,5627,65,2,1575,1564,11,41182,40909,273,483,480,3,100
93357de778be2159b957b8d4c5ed5ec80baf6ada,2,50,3,47,0,0,0,2,2,3228,1,1,0.968700344,109,106,0,14,11,3,642,442,200,11,8,3,100
4230248357a67c994542526c8bc7212973e3b776,0,0,0,0,0,0,0,0,0,0,0,0,0,0,107,1,0,0,0,0,0,0,0,0,0,100
b664ab8b94daacdd77a8a78e3a866a1745803ff8,8,25,4,21,0,0,0,1,5,1080,1,2,2.882663322,611,378,3,92,92,0,3239,3092,147,67,67,0,100
a67852d2c075f869e016dfb4ad685f69cd37bab2,4,6,3,3,0,0,0,2,4,1364,1,1,1.974937501,476,379,4,71,71,0,2337,2309,28,67,67,0,100
54bef663e7d9f8ddec9e5434ca1162b09662bcab,8,588,301,287,2,0,2,2,36,190,2,3,2.564866664,1458,113,2,402,389,13,11119,9593,1526,146,148,2,100
426dce38672b3d6c117e3cba912d83bc1b69ec9a,1,0,3,3,0,0,0,1,2,2,1,1,0,151,114,3,37,38,1,830,845,15,26,26,0,100
b67e3d83ac9e15d019fca58e577d1226ff89a388,1,122,0,122,1,0,1,1,1,0,1,1,0,0,115,4,17,0,17,414,0,414,16,0,16,98.21436811
8f587779d6085e93e59b7026cbeb983ff5381f85,2,5,2,3,0,0,0,2,17,212,1,2,0.985228136,416,380,2,55,54,1,3542,3508,34,8,8,0,100
7c6c7f2d02ee08d765df4144d8fd4c87f8423b6d,2,148,0,148,2,0,2,1,1,0,1,2,0.980947013,0,116,5,10,0,10,763,0,763,7,0,7,99.98252512
643c87437bc9a42a5dbd4c7686b50355b69bcca5,1,0,62,62,0,0,0,1,2,0,1,1,0,50,117,6,0,4,4,0,275,275,0,4,4,99.99126332
854325d119cb5d6695256b94bd5237d857869ca6,1,2,1,1,0,0,0,2,2,1259,1,1,0,60,514,7,12,12,0,333,336,3,5,5,0,100
92b7e93bb736f982fddde7684c20f03dff70d9f2,1,6,3,3,0,0,0,3,6,670,1,1,0,441,515,8,122,122,0,2926,2920,6,35,35,0,100
18dba4182bf203d28862416a604a18e1ca4adeae,6,44,44,0,0,0,0,4,9,1460,1,1,2.114137298,734,516,9,66,79,13,4091,4152,61,49,49,0,100
6f07746a3af6c3be240c23d09e781d6bbe4c829a,2,6,6,0,0,0,0,4,6,1000,1,1,0.41381685,166,517,10,7,6,1,939,950,11,6,5,1,100
b2a38dfadff6b825bae015958d23e72e4f306bb1,1,8,0,8,0,0,0,3,6,1259,1,1,0,73,518,11,5,4,1,404,369,35,5,4,1,100
8ee5186f9fa5592920ffdf92e85ebcef19c8de37,1,2,2,0,0,0,0,2,2,1292,1,1,0,105,519,12,9,10,1,680,689,9,5,6,1,100
a80e26ccfcc7ff658680d1137e19adcfebd699e3,2,0,8,8,0,0,0,2,3,619,1,2,0.954434003,161,520,13,12,13,1,960,969,9,7,8,1,100
fc782f27976d16d4aa596e07e5315260f33d5a61,3,29,19,10,0,0,0,3,6,1291,1,1,1.534337198,476,521,14,43,42,1,2969,2934,35,31,30,1,99.99563128
28f75cc187bc815546764b4239e13127dc891dad,1,3,0,3,0,0,0,3,5,1693,1,1,0,129,522,15,18,18,0,663,647,16,9,9,0,100
4c648a0522d8ced078fd780f11937a27d92ced71,1,30,25,5,0,0,0,3,8,781,1,1,0,260,523,16,28,27,1,1552,1528,24,20,20,0,100
098ac5a11e39613cee64bde7e9eaa73193114268,1,1,1,0,0,0,0,2,2,506,1,1,0,54,381,3,6,6,0,169,169,0,6,6,0,100
11969d128df2ed5ca5e45738a9430b3cf2669838,1,5,11,6,0,0,0,3,6,1259,1,1,0,70,524,17,8,7,1,473,516,43,6,5,1,100
274de206804be8a7887df1214821895ec6fbf9b1,2,5,0,5,0,0,0,3,6,786,1,1,0.721928095,130,525,18,13,13,0,680,650,30,7,7,0,100
5c79f76c697237516e5742d66ce91b5093738b4a,3,48,37,11,0,0,0,3,6,1275,1,2,0.67698917,1520,526,19,82,82,0,10935,10847,88,46,46,0,100
e0a173f17eaf2a0e3a76cd56213a2361bd16da55,2,15,4,11,0,0,0,7,27,162,1,2,0.899743759,279,382,4,55,53,2,1701,1652,49,34,33,1,100
996abba172f20872a8f30ff8737238f438fef629,10,42,14,28,0,0,0,4,6,1440,1,1,2.278611342,1247,527,20,70,66,4,7688,7451,237,54,54,0,100
f4c9c6c45e071e1fa00bcd2a116096aa62d2f392,5,10,0,10,0,0,0,3,7,1196,1,1,2.321928095,244,528,21,24,24,0,998,898,100,24,24,0,95.09097151
353f65783f61b95a295281ac1ec396b82943e5d1,2,4,0,4,0,0,0,4,7,747,1,1,1,77,529,22,6,6,0,263,223,40,4,4,0,99.98735564
9b56a3f5cc5d5ade724422063163d8d7d8500540,1,11,3,8,0,0,0,3,4,1515,1,1,0,86,530,23,12,11,1,606,560,46,9,9,0,100
bbb2f23a856014f649e15d912dce9fbcf129a181,1,2,1,1,0,0,0,3,5,0,1,1,0,96,531,24,12,12,0,606,606,0,9,9,0,100
447f48950dbd15afc7b312a67aa5cc55ba5b898f,1,8,8,0,0,0,0,2,4,362,1,1,0,276,532,25,31,31,0,1857,1863,6,11,11,0,99.99578699
a9c49f705ec9592f827d37e85e80ea59076ae32b,1,1,0,1,0,0,0,3,6,9,1,1,0,271,533,26,50,50,0,2122,2116,6,25,25,0,100
6ebaf34bd95c7e1356ec2e6fc9c0f66a05063ff9,1,3,0,3,0,0,0,2,3,1694,1,1,0,219,383,5,69,69,0,1125,1107,18,36,36,0,100
efec8f38f06ae1a7d8a357a9e2a1c00637f5568e,1,1,1,0,0,0,0,4,5,573,1,1,0,307,384,6,48,48,0,2146,2149,3,25,25,0,100
0a17bc1943cb799ff5b01b81fd292639e6637c34,14,15,14,1,0,0,0,2,6,672,1,1,3.098686167,1002,534,27,134,132,2,4799,4844,45,103,102,1,100
733d90cea6e5605f5981e0560eff7d319ca99c42,1,17,4,13,0,0,0,2,3,147,1,1,0,125,385,7,20,18,2,866,805,61,13,13,0,100
9c87751ae73ffe01fdee64c35effb90cc76000c5,1,9,3,6,0,0,0,4,11,1171,1,1,0,827,535,28,189,189,0,5802,5780,22,81,81,0,100
ea0a44edd3317bbf7d9f4ffbe3845e75bec34fca,15,102,43,59,1,0,1,6,19,122,2,3,2.899049805,1542,386,8,255,256,1,9012,8713,299,149,149,0,99.84815893
1c13b8e59eda1bf8b9ac854bb6d2132736d2baf1,1,6,0,6,0,0,0,7,12,0,1,1,0,174,536,29,44,43,1,935,914,21,16,15,1,100
8a17669161ffc168b4656b259b05911df1194f94,2,34,7,27,0,0,0,5,7,1627,1,1,0.996134484,552,537,30,150,148,2,3617,3491,126,50,49,1,100
ab67cdd17d6808f32494db117c3c0aad1aa4bae0,1,0,1,1,0,0,0,5,8,0,1,1,0,114,538,31,26,26,0,580,584,4,14,14,0,100
a0fad7795b066f404a2ee5d4a814b8b3a7608dc2,2,6,3,3,0,0,0,3,8,1604,1,1,0.918295834,535,539,32,56,56,0,3479,3457,22,40,40,0,100
044164b4adc287139b3c8cf4ff351676cfe0bb95,3,142,128,14,0,0,0,4,17,570,1,1,0.88269296,1625,540,33,93,93,0,12244,12211,33,55,55,0,100
7920a950aa94d9994bef9078f2326aa1fd2a7e5a,1,7,11,4,0,0,0,5,9,0,1,1,0,113,541,34,26,26,0,565,580,15,14,14,0,100
827cc3f400518b44befbf01ed350eb59ae303858,3,58,14,44,0,0,0,2,5,709,1,1,1.15018548,508,542,35,63,61,2,3676,3391,285,33,33,0,99.99155405
81eb5f86cf1b8c6206e774240a32c3f413227b1d,1,21,1,20,0,0,0,2,3,2,1,1,0,61,543,36,17,12,5,448,333,115,6,5,1,100
ad6b24baec837812621951f6c30f7c80cecea971,2,14,13,1,0,0,0,1,16,442,1,2,0.918295834,339,387,9,71,72,1,2399,2399,0,27,26,1,99.91976351
b62b8fc920a056c5f259fa65322433f277ddc106,5,8,16,8,0,0,0,4,11,1072,2,2,1.584962501,879,118,7,135,135,0,4553,4601,48,105,105,0,98.42279428
9618edd2f101fc4b79aa40bb41bcf155081dc649,0,0,0,0,0,0,0,0,0,0,0,0,0,0,544,37,0,0,0,0,0,0,0,0,0,100
739ee54c198fc0a284156f40299e906b2b74db03,3,9,12,3,0,0,0,2,61,1422,2,2,1.04884126,976,545,38,241,240,1,6762,6766,4,90,90,0,99.99125033
b229fbd13eb4fba1135575f0b929801bc86dad30,2,19,12,7,0,0,0,1,4,36,1,1,0.345117315,258,546,39,66,64,2,1548,1479,69,20,20,0,100
a63ba3ed38da753ea792addfbdc28a88217f2055,1,66,45,21,0,0,0,2,3,147,1,1,0,183,388,10,25,19,6,1561,1480,81,11,5,6,100
abf397a513bb445881fdf487032824eb7a9ccc36,0,0,0,0,0,0,0,0,0,0,0,0,0,0,389,11,0,0,0,0,0,0,0,0,0,100
a99e618f5ae5d23ff8bf6f4f8a50a5cb357a4a85,4,49,17,32,0,0,0,3,57,566,1,4,1.551864863,1869,390,12,209,204,5,17076,16923,153,144,144,0,99.99562555
7f332d9cf89bcc6bce644ab92056dff58aa3582f,1,88,81,7,0,0,0,2,4,8,1,1,0,187,547,40,22,21,1,1265,1186,79,13,13,0,99.96062992
2f648350b4b1d02cf6b64756458af5bdae247dbf,1,88,86,2,0,0,0,2,6,8,1,1,0,182,548,41,22,21,1,1187,1173,14,13,13,0,99.96938017
58d1f4966a188ba44232edf5ff5bb27c5d361a3f,2,13,4,9,0,0,0,7,28,9,1,1,0.322756959,213,549,42,50,46,4,1301,1258,43,22,22,0,100
e991772527c144a33d990e78988f7308be6e1b5a,1,1,0,1,0,0,0,4,16,181,1,1,0,318,550,42,37,37,0,2268,2262,6,15,15,0,100
0bcdb27e8fc9d3f011e60a75ee570a04fe3e2a10,1,7,0,7,0,0,0,6,11,762,1,1,0,202,551,43,38,38,0,1309,1290,19,16,16,0,100
b2a62422d36d6dca42322855df9779ded5777802,1,2,1,1,0,0,0,3,8,11,1,1,0,457,552,44,125,124,1,3039,3033,6,36,36,0,100
be183a3a94d5c1add4496473a57f5334dacc54ec,1,1,1,0,0,0,0,8,23,1193,1,1,0,252,553,45,45,45,0,1733,1735,2,11,11,0,100
c9ad4ea728a68fd01ff345d115ba4dbdf2770414,21,90,45,45,0,0,0,3,17,1384,1,1,3.686512192,4143,554,46,408,406,2,27699,27355,344,227,226,1,96.98367036
5588ffe143774e7d549ee839454fb2bade9f9d1b,1,2,0,2,0,0,0,3,6,1527,1,1,0,87,555,47,9,9,0,581,565,16,5,5,0,100
06964726a244ab5f8764538fbe9fac595c553026,9,83,10,73,0,0,0,4,21,965,1,1,2.861602547,3370,556,48,352,333,19,30876,30554,322,264,258,6,100
1edd0d97c1fd83c9cd94d12a80b8195871914ff7,1,1,1,0,0,0,0,3,7,1233,1,1,0,316,557,49,51,51,0,3219,3217,2,35,35,0,100
7b6b4157d02afb80d41b3a1ecd98161cd2fa4515,10,94,0,94,0,0,0,2,7,979,1,1,3.316906982,966,558,50,114,84,30,5653,5227,426,74,64,10,100
6892f7c703b20b1c51628b80daa32657b6ca61e8,8,78,0,78,0,0,0,2,7,800,1,2,2.992993649,774,559,51,89,65,24,4606,4254,352,59,51,8,100
ed00b5cee0b8f6ee74bdfd5aca499dcda238e5c0,2,9,9,0,0,0,0,2,7,707,1,1,0.918295834,451,560,52,61,61,0,3186,3189,3,17,17,0,100
f7b4bcd67d5801434381d2fb5c671997d2f1cff1,1,1,0,1,0,0,0,5,18,1,1,1,0,297,561,52,65,65,0,2200,2200,0,24,24,0,100
dddd2a4cfee0b5848550175178753fb5dcfeda5c,1,11,4,7,0,0,0,3,9,2,1,1,0,458,562,53,125,125,0,3052,3039,13,36,36,0,100
a50e380d99c145fcda5ff6d8671939e9fed175b5,1,2,0,2,0,0,0,7,29,2,1,1,0,137,563,54,29,29,0,814,814,0,16,16,0,100
e807ca86b8d85d8429ea07a30507bf9b07965817,1,18,2,16,0,0,0,4,12,14,1,1,0,833,564,55,190,189,1,5806,5802,4,81,81,0,100
0c239c2dc423dc4eefeee4473a709c0a7039bac1,1,4,1,3,0,0,0,3,6,1314,1,1,0,72,565,55,12,12,0,416,394,22,6,6,0,100
f3e45e5e5419fbdbf5f67ab49b97faf418f25b22,1,17,9,8,0,0,0,3,10,0,1,1,0,461,566,56,127,125,2,3089,3052,37,36,36,0,100
54e64edaa2853a70463e973808105edd61629d46,1,19,8,11,0,0,0,3,11,0,1,1,0,468,567,57,129,127,2,3099,3089,10,37,36,1,100
e175b242f9f68d1d57e2af092117b3169201964c,1,9,0,9,0,0,0,6,9,254,1,1,0,162,568,58,31,31,0,1105,1066,39,9,9,0,100
660fa547d67aaaa53fbc4026128fa0f3da3e2cb9,1,0,7,7,0,0,0,1,4,599,1,1,0,654,569,59,134,136,2,4627,4654,27,32,33,1,100
d32b7da7db340bb5a8367187bf99f0f5dc822cb8,1,8,7,1,0,0,0,2,2,650,1,1,0,92,570,60,7,7,0,593,593,0,4,4,0,99.98361596
0f0f01d36638fe3e4e2f39c6ad2519d8df53157f,2,18,4,14,0,0,0,1,3,1424,1,1,0.994030211,246,571,61,19,19,0,1475,1409,66,18,18,0,100
5a7b1765c7cdcce6bab701bcaaa40b60d37d1efd,2,16,0,16,0,0,0,10,29,216,1,2,0.337290067,1704,572,62,447,443,4,12483,12411,72,114,113,1,100
9f1e9db866a29343d9be32bb54019dd2ce0400bc,5,16,1,15,0,0,0,5,43,1293,1,2,1.849868723,3611,573,63,460,460,0,22462,22372,90,215,215,0,100
4f06ae4591bf5a404f40197ce477a164e89dbab7,4,34,0,34,0,0,0,4,20,850,1,1,1.717803282,1279,574,64,151,151,0,9386,9182,204,103,103,0,100
ebdc67029869b5ba7d99d993256ea6a404aecff8,1,4,11,7,0,0,0,2,3,377,1,1,0,96,575,65,9,11,2,419,462,43,3,3,0,99.99590399
172ec292a718d3c337cfaa3eaad8e33274bdf96e,3,19,1,18,0,0,0,5,13,555,1,2,1.485475297,432,576,66,59,58,1,2801,2713,88,33,32,1,100
ff900d98fe89e34cab5a94cc54a8352cdd014181,4,6,0,6,0,0,0,2,18,1942,1,2,1.918295834,526,577,67,59,59,0,4062,4032,30,14,14,0,100
71ae858f910ffb7331a4153917cb1a29f4178b6b,11,41,11,30,0,0,0,3,9,563,1,7,2.846603609,1415,578,68,122,121,1,10124,9974,150,58,58,0,100
1a3d16a013d1ccd2527447b2b480b9ca4932ce0a,5,27,12,15,0,0,0,3,8,1526,1,2,2.027007182,670,579,69,56,56,0,5360,5265,95,43,43,0,95.73815481
ede1ebe30fb8230f29ce0de0c40fc468c087d02c,0,0,0,0,0,0,0,0,0,0,0,0,0,0,580,69,0,0,0,0,0,0,0,0,0,100
dbbb6bf8150e7c861a2924328da18c7925cb67ec,7,13,10,3,0,0,0,2,6,1007,1,4,2.430563457,1339,581,70,156,157,1,8946,8896,50,93,94,1,100
887a7815a8770e8cbbe0298e431fc4565230b1f7,7,22,4,18,0,0,0,5,30,4,1,3,2.618171815,2112,582,71,504,504,0,13906,13906,0,194,194,0,100
50290a4e1807e4ceb4e5d59f879867aeef9cd021,0,0,0,0,0,0,0,0,0,0,0,0,0,0,391,13,0,0,0,0,0,0,0,0,0,100
b6f237bdc86351322682501cd21f4296a72c593b,0,0,0,0,0,0,0,0,0,0,0,0,0,0,392,14,0,0,0,0,0,0,0,0,0,100
2df8af745705b0fcfea38dd1a4b38604e9d12de0,1,1,0,1,0,0,0,8,20,17,1,1,0,294,393,15,48,48,0,1958,1951,7,18,18,0,100
3040a2d4673f9a45f076008c2350bfd8e8ab90b4,2,4,2,2,0,0,0,3,7,7,1,1,1,382,142,1,44,44,0,2454,2452,2,26,26,0,100
754217f03a761ddad935c81eb107bf7c0dea9824,0,0,0,0,0,0,0,0,0,0,0,0,0,0,583,72,0,0,0,0,0,0,0,0,0,100
c479f35f686017eae236dffff98253e93e014ebf,5,78,27,51,0,0,0,4,19,727,1,4,2.273487923,1101,394,16,71,69,2,7239,6956,283,43,44,1,99.92836676
db1ce09390f129ebdbff01ae031f4795e5c13b47,4,14,7,7,0,0,0,5,31,0,1,1,1.822118925,896,584,73,230,228,2,5452,5413,39,83,83,0,100
8cafaf9f19932c1d66a3367679d633099a321b32,6,41,16,25,0,0,0,2,11,824,1,3,1.818224882,590,585,74,58,58,0,3748,3634,114,48,47,1,99.99601911
c6582b9f2bd4b550df53d89597999c44cab4e4e3,1,0,5,5,0,0,0,2,2,1807,1,1,0,361,586,75,59,60,1,2361,2372,11,23,24,1,100
0e9c5e52dd51d547c7f76308c9e0bd9cacae07b1,1,19,15,4,0,0,0,3,8,1,1,1,0,187,143,2,23,22,1,1241,1188,53,13,13,0,100
2e11a6a90be6345a3b2f5451bd00705b5c461800,2,7,4,3,0,0,0,1,21,729,2,2,0.945660305,342,395,17,50,50,0,2211,2163,48,20,20,0,100
8a5c16e57c251ad9ab8817bab2cc4a40e5d6d8be,0,0,0,0,0,0,0,0,0,0,0,0,0,0,587,76,0,0,0,0,0,0,0,0,0,100
ada720a769273a27ed35c4a321179b0e8803cd9c,0,0,0,0,0,0,0,0,0,0,0,0,0,0,588,77,0,0,0,0,0,0,0,0,0,100
dd903f6244523d352c8c0b0aa4f84e3b42c5b39d,1,1,1,0,0,0,0,2,3,443,1,1,0,137,396,18,37,37,0,1095,1095,0,13,13,0,100
fa8a517fb0d6abbbdedd5925904743aef0e391b8,0,0,0,0,0,0,0,0,0,0,0,0,0,0,589,78,0,0,0,0,0,0,0,0,0,100
eac769a2996cee2be000e6f8ccf774c333f669db,0,0,0,0,0,0,0,0,0,0,0,0,0,0,590,78,0,0,0,0,0,0,0,0,0,100
2414c88960b8c8958e5ed9622d07f164514bab0b,0,0,0,0,0,0,0,0,0,0,0,0,0,0,591,77,0,0,0,0,0,0,0,0,0,100
d99e1dff36ce235658c1ec5e06311509051ab4b4,1,0,6,6,0,0,0,8,22,3,1,1,0,296,397,19,47,48,1,1956,1976,20,17,18,1,100
3707cc8b6d9d39cc81c108062df27ba7fa993976,1,1,1,0,0,0,0,4,5,179,1,1,0,154,144,2,11,11,0,1085,1089,4,7,7,0,100
f9cfbbfe2cc5cdea1b2d9885caf24c2413a7beb5,1,11,0,11,0,0,0,8,23,5,1,1,0,292,398,20,50,47,3,2026,1956,70,18,17,1,100
b0af48eb8feaa4bc2b6424a7d6a36473a7356eb9,0,0,0,0,0,0,0,0,0,0,0,0,0,0,592,78,0,0,0,0,0,0,0,0,0,100
0f5c5291aef2e1bbf836ca638a7d01be1459560b,3,61,201,140,0,0,0,3,20,941,1,1,0.815332651,1477,593,79,146,239,93,8044,9261,1217,52,54,2,100
60e88f82faad894eddf23dc3a71c537e02baf4f1,3,39,1,38,0,0,0,4,58,176,2,3,0.88418372,2470,201,0,291,285,6,22776,22450,326,189,188,1,100
fdf58d63ba0f7bf1c844e4b5da3fb904b90cf546,1,8,2,6,0,0,0,14,55,44,1,1,0,1082,145,3,282,281,1,7847,7810,37,57,57,0,100
2468de045c0837ba2a5d90346a48d32b202bf510,1,20,0,20,0,0,0,2,6,14,1,1,0,86,594,80,27,21,6,642,487,155,6,6,0,100
578704a84884d0eaa0a4894f1600991101983a8c,6,33,13,20,0,0,0,2,7,1138,1,1,1.775904518,769,399,21,113,112,1,4556,4457,99,71,70,1,100
c9f56ed822b82caa17d37b9ed5a878d56d597850,1,1,1,0,0,0,0,3,3,1065,1,1,0,148,400,22,29,29,0,1141,1141,0,11,11,0,100
a13842f7ead3e8ff12fd0316929ad03343b44b2f,2,6,14,8,0,0,0,4,6,27,1,1,0.881290899,338,146,4,40,40,0,2283,2344,61,31,31,0,100
4e3f42e70e068126ea3b768c44176948af491aac,8,264,8,256,2,0,2,1,153,366,2,3,1.944595342,7554,401,23,2274,2249,25,55119,53994,1125,844,823,21,99.98010425
e1a98596895737e6864e21e97d96796887bae6a9,3,6,5,1,0,0,0,2,3,710,1,2,1.494918848,233,147,5,33,33,0,1099,1088,11,30,30,0,100
75bbc90899fb644387e7cba5c5c77e5e5adc8de3,10,96,20,76,0,0,0,5,41,376,2,3,3.07146814,2503,261,0,704,681,23,18650,18198,452,185,179,6,100
005a18a73951940c9ddde5d8623c1ed4dd5fd2b5,2,20,12,8,0,0,0,14,56,1,1,2,0.954434003,1302,402,22,324,320,4,9390,9418,28,76,76,0,100
0a7e318638ef90495dcd6becd3fe1ac3d302630f,1,13,17,4,0,0,0,3,4,1548,1,1,0,281,595,81,29,28,1,2072,2076,4,19,19,0,100
de5e7cefe3626a5dafd50040ed95a92bbf2572f5,1,1,0,1,0,0,0,3,5,0,1,1,0,283,596,82,29,29,0,2076,2072,4,19,19,0,100
53d73cc4fd8a5514766df3eade28821e12016ca9,7,872,506,366,2,0,2,1,2,465,1,1,2.11515819,2099,597,83,400,360,40,13630,12536,1094,164,155,9,99.97613365
7919d9c675197790aecb72cf31bef6e767cfa7e7,1,2,1,1,0,0,0,1,3,0,1,1,0,79,598,84,5,5,0,380,380,0,3,3,0,100
32e0ff48f88c0a798955e21948f7c57df510b91a,2,2,2,0,0,0,0,3,3,48,1,1,1,142,148,6,14,14,0,638,642,4,11,11,0,100
daac0ac0865f41fb7750ae92ecd4ca97d158865b,19,861,195,666,5,0,5,4,75,124,2,7,3.697155455,4590,119,3,1306,1245,61,32917,30096,2821,443,410,33,99.95626938
93e28fc3aceb7e43992fb6d4abe7731d13d1b7ad,0,0,0,0,0,0,0,0,0,0,0,0,0,0,403,23,0,0,0,0,0,0,0,0,0,100
b41714a8593e8c14e180dcc003abf7da30062b20,1,2,6,4,0,0,0,2,4,209,1,1,0,294,120,4,16,17,1,2388,2399,11,10,10,0,100
189e0ed2e3230d26cd7889a59c04736949d1bc32,1,7,4,3,0,0,0,3,5,0,1,1,0,290,404,23,16,16,0,2342,2388,46,10,10,0,100
d54088a365d36b2bdad396d07453cd845549e514,1,68,64,4,0,0,0,8,19,357,1,1,0,729,405,24,208,208,0,5351,5373,22,44,42,2,100
206d17bfcf88de17878895c0786a22efa420ca47,4,4,4,0,0,0,0,4,5,1736,1,1,2,266,149,7,30,30,0,1031,1031,0,30,30,0,100
c8a5f3d91b2d94acc843615ad2695487787b1543,1,30,35,5,0,0,0,3,6,11,1,1,0,287,121,2,16,16,0,2248,2342,94,10,10,0,100
ae1e715248aad98b9327e20f04acdaa541d8e695,3,32,16,16,0,0,0,1,2,12,1,1,1.529951533,270,122,3,29,29,0,1907,1675,232,12,12,0,99.99205435
2ab51d77a6189b69cc19193ba8f9314f2adf9adf,1,2,1,1,0,0,0,1,3,0,1,1,0,53,123,4,7,7,0,324,325,1,5,5,0,100
48f47fc775393cb60f04cf887fcd0fbb00bca428,1,11,15,4,0,0,0,3,3,1745,1,1,0,162,150,8,23,23,0,975,978,3,9,9,0,100
c9bad3efcd992737adbd3df6db91b11794a1228a,1,9,0,9,0,0,0,13,95,225,1,1,0,826,161,0,202,197,5,5725,5677,48,48,47,1,100
f3b0fd45e48e6b482aa06c9ba189f6bf3c7e9807,0,0,0,0,0,0,0,0,0,0,0,0,0,0,599,51,0,0,0,0,0,0,0,0,0,100
8556afe921079e033166311e0d7030ac345433e6,1,1,0,1,0,0,0,3,5,733,1,1,0,118,600,49,14,14,0,683,677,6,5,5,0,100
ee682d82abfc18fa1fa939184812fbb3b8ed9cbe,2,28,12,16,0,0,0,5,30,114,1,1,1,1176,601,50,144,144,0,9671,9575,96,81,81,0,100
8510080d45539355c3629405c1bea720f246bf13,8,9,3,6,0,0,0,3,18,40,1,1,2.918295834,1618,602,50,185,185,0,11458,11420,38,108,108,0,100
53da8cce2ca62089544a5b3ea82610d4d1cf10b3,3,17,7,10,0,0,0,4,7,127,1,2,1.308502445,384,603,49,48,46,2,2976,2920,56,28,28,0,99.96822623
aa9f10cdc82c9e84d767b6f2b7d751500d4c909a,1,1,0,1,0,0,0,2,4,1218,1,1,0,173,604,50,19,19,0,1175,1169,6,10,10,0,100
8813afb4b4bfadec0a26d1a8f81395192792f567,2,12,3,9,0,0,0,3,7,1036,1,2,0.566509507,425,605,51,40,39,1,3510,3471,39,30,30,0,100
226c4731c524e26b55386dee1998b5dde52cb76a,1,2,1,1,0,0,0,2,3,39,1,1,0,90,606,51,6,6,0,605,597,8,6,6,0,100
d62d67fcd9bf3c63a0228f8e11bfcd5cef828ad8,1,1,0,1,0,0,0,4,4,1569,1,1,0,168,607,52,16,16,0,1172,1166,6,5,5,0,100
73cbad1a160c97751dd00ce6a93876c9690b459f,1,7,2,5,0,0,0,5,8,399,1,1,0,199,608,53,30,30,0,1116,1098,18,11,11,0,100
d461ba7f5c4605ee992b06cea2c0e3382da57726,1,3,7,4,0,0,0,2,6,479,1,1,0,82,609,54,4,6,2,445,464,19,4,4,0,100
065f0e25dc2e9547449d95564b06deb011330d48,1,2,1,1,0,0,0,3,6,54,1,1,0,96,610,54,12,12,0,611,606,5,9,9,0,100
1058a69afb1c29786aa1d995329a1866b7e23b01,12,25,1,24,0,0,0,3,6,1499,1,1,3.565448372,1953,611,55,188,188,0,12018,11800,218,112,112,0,93.65622888
5538fd7bb3af11268ca45f9c01ac99823e71522a,1,1,0,1,0,0,0,2,2,2143,1,1,0,54,612,56,6,6,0,245,240,5,3,3,0,100
89fbaf709fdfb4d99f93e4d2618a28882b2ce212,1,11,1,10,0,0,0,3,5,3872,1,1,0,191,613,57,35,34,1,1508,1467,41,11,10,1,100
36d157b0ec10b29b4d0b6ca47e3ea4039231c527,1,0,5,5,0,0,0,3,4,1569,1,1,0,64,614,58,3,4,1,348,357,9,3,4,1,100
0baa453c37bcf61f35c744316dac4dbca7ad6591,1,1,0,1,0,0,0,6,10,105,1,1,0,451,615,59,61,61,0,3495,3489,6,12,12,0,100
89ed13599e99c74a1e281a5227694dd98440c667,1,1,0,1,0,0,0,3,21,24,1,1,0,779,616,60,66,66,0,5046,5042,4,32,32,0,100
582e91b867963a008d2a8f398a8bd1c97a217a4b,4,162,4,158,2,0,2,6,44,14,2,2,1.794020034,3139,617,61,472,455,17,20186,19634,552,204,195,9,99.97398137
57e94f648c5de9af5d6244601eccd1d60edaa9d4,1,5,3,2,0,0,0,6,9,1355,1,1,0,125,618,62,38,35,3,804,774,30,20,20,0,100
ce416a877782ff4d106e681f811be28d25eccc8a,1,4,2,2,0,0,0,12,72,26,1,1,0,2406,619,45,809,803,6,16560,16515,45,307,307,0,100
06c1e74358856150467a15c048155078f5a5c01f,1,1,1,0,0,0,0,4,9,383,1,1,0,210,620,46,62,60,2,1168,1150,18,18,18,0,100
7c377a90434f30c555a60bf2d9f5345d798b8bd2,4,150,14,136,1,0,1,1,26,258,2,2,1.464782637,830,124,5,208,196,12,6131,5437,694,117,113,4,95.92695239
dcf503dd5a48dcc43ab0796209906af356276405,1,5,2,3,0,0,0,6,7,1694,1,1,0,73,621,46,19,16,3,390,360,30,10,10,0,100
3b65de076587b34a430bb5fc4684b637117a8c67,1,6,3,3,0,0,0,5,5,3491,1,1,0,62,622,45,13,10,3,290,258,32,8,8,0,100
6a12a3c121fb4dd70358ecebcea9997ed11d0530,1,1,1,0,0,0,0,13,73,0,1,1,0,2408,125,6,809,809,0,16560,16560,0,307,307,0,100
47d7b1d77820b358221c003442403c5173f8e915,1,1,3,2,0,0,0,3,14,38,1,1,0,478,623,42,131,131,0,3137,3137,0,37,37,0,100
daa090c11b04bda6b41bf7f08356fe4ce4a334b6,1,13,0,13,0,0,0,11,70,210,1,1,0,725,126,7,154,149,5,5088,4995,93,46,46,0,100
9e09567ddc353ee981c33b1baac4651fbb314ecc,1,5,1,4,0,0,0,7,11,856,1,1,0,803,624,42,111,110,1,5084,5057,27,22,22,0,99.99056159
35b5f8fddcee29739e80a433d942ba57bca9b1ba,0,0,0,0,0,0,0,0,0,0,0,0,0,0,127,8,0,0,0,0,0,0,0,0,0,100
3f8bff4331e047a0cd7735129e8ad30adaed692e,18,2439,4,2435,16,0,16,1,71,6,1,2,3.643010807,1040,675,0,625,228,397,18156,7112,11044,192,79,113,90.27557537
c3c97f7cf3477d92d94e792e8aa8bdbb36991df3,5,110,2,108,2,0,2,1,32,418,2,3,1.600451789,2041,262,1,711,701,10,15643,15283,360,171,164,7,99.97252639
61f21099b63004b59d7bac4084866273ecfb10c2,1,17,25,8,0,0,0,14,119,210,1,1,0,3849,128,9,1115,1115,0,23953,23982,29,293,293,0,100
c47965d889b0ff1e3c434d4fef9d1ec2ba210139,1,1,1,0,0,0,0,2,2,0,1,1,0,95,108,0,31,31,0,599,601,2,8,8,0,100
91d1eb914ba2ca99708e16772142a94a308ca351,4,509,0,509,4,0,4,1,1,0,1,1,1.840627626,0,676,1,41,0,41,2563,0,2563,34,0,34,99.96469342
979384e10eb1dda51d8df11690766b4395218571,0,0,0,0,0,0,0,0,0,0,0,0,0,0,625,42,0,0,0,0,0,0,0,0,0,100
3598d38ffc211c84cb2742f9a38d809b8ae43cd2,3,32,8,24,0,0,0,1,2,0,2,2,1.278897903,526,677,2,137,132,5,3389,3297,92,55,52,3,100
06a1b71cbfbf1560e27b1a654b06b856a331b8ce,1,5,2,3,0,0,0,6,15,859,1,1,0,333,626,42,94,91,3,2074,2042,32,64,64,0,100
54234f6102364783f1349338fd606269409ba367,5,22,9,13,0,0,0,5,89,271,3,4,2.022497303,3699,678,3,899,897,2,28354,28249,105,277,277,0,100
9230486ff7d157a39d8c81423d467e4ef4c9e382,1,5,2,3,0,0,0,5,7,3494,1,1,0,87,627,40,19,16,3,418,386,32,13,13,0,100
837d8ccd48453a03dde953c11375e2a0dd566811,1,2,1,1,0,0,0,14,120,2,1,1,0,3841,628,41,1116,1115,1,23966,23953,13,293,293,0,100
8ceee2b1a481f721e0a981454adbd02e5f185101,10,34,571,537,0,0,0,1,9,12,2,4,2.617900348,1149,129,10,110,153,43,4677,7102,2425,73,95,22,99.94506788
81e1f23a13a32c228b95634436860a3a970dad5f,3,3,3,0,0,0,0,9,90,0,2,3,1.584962501,2273,679,4,672,672,0,17195,17195,0,164,164,0,100
bfdfa49810b892f5e0a028b6e6e2bee56a541911,1,2,2,0,0,0,0,1,3,0,1,1,0,170,680,5,38,38,0,890,874,16,21,21,0,100
c325e704eb9829dffc8ec3b5dcf8f5c9aa447831,2,134,1,133,1,0,1,1,10,192,2,2,0.111241049,127,681,6,33,21,12,1754,984,770,13,9,4,99.98822329
d4416c192fc4cdff474548099ffa9d174c931f80,0,0,0,0,0,0,0,0,0,0,0,0,0,0,682,7,0,0,0,0,0,0,0,0,0,100
900304d3c3ee9268691c4b75efa0836853301226,0,0,0,0,0,0,0,0,0,0,0,0,0,0,629,40,0,0,0,0,0,0,0,0,0,100
65b7d7699929da7775496a63608fc76fa472954d,0,0,0,0,0,0,0,0,0,0,0,0,0,0,130,11,0,0,0,0,0,0,0,0,0,100
182c63b13674a22c909360fdece073d6f898265e,0,0,0,0,0,0,0,0,0,0,0,0,0,0,630,38,0,0,0,0,0,0,0,0,0,100
ae8f5ff8c6e1f0417217612dcc83814601daac69,0,0,0,0,0,0,0,0,0,0,0,0,0,0,631,37,0,0,0,0,0,0,0,0,0,100
c4d891525d7fc2535f7f0516cc3c5db1189a46c9,0,0,0,0,0,0,0,0,0,0,0,0,0,0,632,38,0,0,0,0,0,0,0,0,0,100
ab326efe0729737af181b7151766e82be4562c96,2,6,7,1,0,0,0,7,45,892,1,1,0.619382195,2854,151,4,355,355,0,17151,17140,11,173,173,0,100
d99b9ba0341c827e69ed235d7a3f42d31673f15e,2,88,16,72,1,0,1,1,37,41,2,2,0.911751759,591,131,12,175,171,4,4742,4379,363,25,23,2,99.99215009
51dad642538b69f63006114d68f989da3ba0cc03,4,84,52,32,0,0,0,3,84,552,1,2,1.147317173,2642,132,13,799,797,2,18625,18350,275,272,272,0,100
05d19a067236122a9e560c612f92bae7f502955e,0,0,0,0,0,0,0,0,0,0,0,0,0,0,633,38,0,0,0,0,0,0,0,0,0,100
66ce36c0adfe8add0b02a73cc72941002a821bdd,16,48,49,1,0,0,0,3,93,1030,1,6,3.699148989,10348,133,14,3261,3260,1,70483,70450,33,1032,1032,0,100
be92a72ad70d93db5b5d2d9cb89b49a928b36f04,13,43,52,9,0,0,0,3,154,777,1,5,3.14790801,8796,134,15,2626,2626,0,63794,63749,45,780,780,0,100
b24d729deb5e5237475cac06756ad08d2d8e358e,7,20,23,3,0,0,0,4,40,1007,3,5,2.336250794,4426,135,16,1058,1058,0,31424,31433,9,532,532,0,100
f8179d7282a8154926ee89fe8f2b2b8f1b1a848e,1,2,2,0,0,0,0,2,5,0,1,1,0,456,136,17,139,139,0,3356,3364,8,67,67,0,100
aa9573698b5e68c20fa9352b0d439fb3038db6f1,1,2,1,1,0,0,0,7,20,0,1,1,0,358,137,18,113,113,0,2333,2333,0,34,34,0,100
3b3063899b0284e70021037cb1cd93780ba2c3a3,1,3,1,2,0,0,0,1,5,65,1,1,0,218,634,37,60,59,1,1392,1385,7,17,17,0,100
2ca9d9f30f6cae3a43b714a8c87893a1461f894b,1,17,6,11,0,0,0,4,9,62,1,1,0,1330,635,38,114,111,3,8510,8452,58,54,54,0,100
eb2bf2accead888c0e0f4a72af93df4f297b326f,2,12,2,10,0,0,0,10,18,676,1,1,0.371232327,364,636,39,76,75,1,2431,2384,47,22,22,0,100
2f6baf71192c613549c11b9cdc82c82e831d11fd,9,18,85,67,0,0,0,2,91,12,4,6,2.056313126,3986,138,19,1063,1076,13,28220,28520,300,303,308,5,100
36ed1fe1be19c8d858ffc3b4f13bc7f9c09c40dd,16,0,2392,2392,0,0,0,2,5,13,1,1,3.568264139,1765,139,20,0,389,389,0,10850,10850,0,111,111,91.49016011
a70b134576f2d66f4368f7f528eae5d5875cd540,4,0,509,509,0,0,0,2,4,12,1,1,1.840627626,390,140,21,0,41,41,0,2563,2563,0,34,34,95.23111457
c6d23cdb0839111c262385523c9d0e21d0824599,1,5,3,2,0,0,0,5,8,47,1,1,0,316,6,0,50,48,2,2234,2181,53,25,25,0,100
24e547cdcbc85ff3f51e36ee814339f34caa5fd5,3,33,2,31,1,0,1,1,35,119,1,2,0.894552209,1353,406,3,223,223,0,8789,8747,42,94,94,0,99.97638725
3731ab8f2348bf0c5938120fc2e2b3d6b4a2ec07,0,0,0,0,0,0,0,0,0,0,0,0,0,0,141,22,0,0,0,0,0,0,0,0,0,100
c5748ffde16f9e699df8150be508e4149318069f,1,5,6,1,0,0,0,4,12,1741,1,1,0,242,142,23,55,55,0,1599,1590,9,22,22,0,100
2e1e015dee7efe9379d4f2a6ead3b74ce7580f47,0,0,0,0,0,0,0,0,0,0,0,0,0,0,407,3,0,0,0,0,0,0,0,0,0,100
829334021c48c089080e1e7c42fbf890306eef86,1,25,11,14,0,0,0,4,10,5,1,1,0,1336,637,38,114,114,0,8689,8510,179,54,54,0,100
f946f8383bc3ca287f8711a486c057d5aee082e9,1,3,1,2,0,0,0,13,37,500,1,1,0,359,408,4,79,78,1,2615,2586,29,22,22,0,100
531381429d0ff32f1c4d71e402906343a2977625,1,11,15,4,0,0,0,5,14,339,1,1,0,426,143,22,91,92,1,2293,2297,4,52,52,0,100
33c8d872b456b9633ca3c2b3529fddbaf91fc31e,1,7,4,3,0,0,0,4,11,0,1,1,0,1350,638,39,114,114,0,8701,8689,12,54,54,0,100
a09a2b58560ab91c2ef526ec0f10f9adcb321a35,2,212,0,212,2,0,2,1,1,0,1,1,0.999935799,0,409,4,28,0,28,774,0,774,20,0,20,97.32196084
ad98d444e1f43922ac61a25ae57bd7ccddfc6178,4,50,10,40,0,0,0,3,46,393,3,3,1.585997146,1809,263,1,415,410,5,12963,12642,321,190,188,2,100
6d423c5b6b04f683b545d2890f0d74b785f44be5,3,218,0,218,2,0,2,1,24,2,2,2,0.982216394,606,410,4,265,249,16,4493,3659,834,92,82,10,99.97771737
4b19d0fa4ad20b385125b5502f886f64016d5665,7,301,3,298,3,0,3,1,23,505,2,3,1.893247033,970,264,2,237,213,24,8646,7376,1270,85,64,21,91.52253557
5d21297cb67dbb8d0f6a4655e3333aaf97d83119,0,0,0,0,0,0,0,0,0,0,0,0,0,0,66,0,0,0,0,0,0,0,0,0,0,100
0175a1a2e593489d0babd7670828069fca99737c,1,2,2,0,0,0,0,2,2,11,1,1,0,21,67,1,0,0,0,18,18,0,0,0,0,100
3c52abb73d84b4951c1db8e401583975f7d3793b,2,4,0,4,0,0,0,15,58,25,1,2,0.811278124,1719,411,5,481,480,1,12244,12211,33,142,142,0,100
0836fba1588af1a9c4f1544bd123a3333fcd4a6d,2,12,3,9,0,0,0,13,100,76,2,2,0.836640742,1596,265,3,413,411,2,10704,10636,68,241,241,0,99.97959933
324ca8e894293f83d34de671be46feebb7e2dfab,1,2,2,0,0,0,0,1,2,6,1,1,0,81,266,4,11,11,0,376,376,0,11,11,0,100
5040a436e7dc394dececa869321cfae52f30e4ac,1,9,4,5,0,0,0,3,4,359,1,1,0,162,109,1,36,34,2,1072,1027,45,7,7,0,100
c960f725cb6d6ad6211ceec654ea657ccbebface,2,89,8,81,1,0,1,1,39,12,2,2,0.621329097,591,144,16,183,173,10,4755,4384,371,27,23,4,99.99184339
ef9a49e883a5c1fe9cfa60e9e8c583b9d8e76410,1,1,1,0,0,0,0,2,6,39,1,1,0,47,145,16,0,0,0,213,213,0,0,0,0,100
d748e46040ad423ee044304f2312e3dfdb8f0502,1,40,5,35,0,0,0,8,19,904,1,1,0,276,68,2,64,59,5,1875,1752,123,21,19,2,100
98ebca2fe72b02c785715c29decb92808a288f88,3,109,8,101,0,0,0,3,121,67,2,2,0.985477274,5634,146,8,1644,1633,11,35919,35370,549,484,477,7,96.84573472
ea5db0fbb3ba898f5afbb086a748e25b2ad57531,5,92,34,58,0,0,0,12,85,621,2,2,1.64382449,1776,683,0,571,561,10,13081,12813,268,131,129,2,100
dcaa2177c6f89620b373823803adb7c819436e07,1,5,2,3,0,0,0,11,31,317,1,1,0,679,267,4,258,257,1,5120,5107,13,37,37,0,100
559c43468a9ced4845bb0260cee1c1dbd459cf6b,5,496,0,496,5,0,5,1,1,0,1,1,2.197915828,0,684,1,56,0,56,2192,0,2192,38,0,38,99.9154127
24e17363ef3faf489bf187b26f748eb80a19d3a0,5,0,496,496,0,0,0,2,2,0,1,1,2.197915828,398,412,2,0,56,56,0,2192,2192,0,38,38,99.9154127
73cd30152044f4fc56f25eb4b64529983dc9b0a1,4,164,3,161,3,0,3,1,40,6,2,3,1.764007579,591,147,3,189,179,10,4896,4416,480,32,23,9,100
8cfea1bd5f95cb05caebcecec0333ddd29912302,1,1,0,1,0,0,0,8,12,51,1,1,0,1102,148,4,375,375,0,7589,7587,2,99,99,0,100
2009b5c016d09ab8d95da0f9b68ad6eaca99f5bf,1,92,82,10,0,0,0,14,122,11,1,1,0,3849,413,2,1120,1117,3,24053,24015,38,295,294,1,100
7178dd3f002380aee3205d83150c0d9a2d135ae4,1,20,1,19,0,0,0,13,74,78,1,1,0,2408,268,2,813,809,4,16618,16560,58,310,307,3,100
f0ddf938dfd1f2e1cc1c6a80b0910c751e777b5a,1,82,75,7,0,0,0,14,123,6,1,1,0,3858,414,2,1120,1120,0,24083,24053,30,295,295,0,100
406710b477182695bc114c87cfe670060c7c00c7,2,47,54,7,0,0,0,2,12,1004,1,2,0.851645833,423,415,3,137,137,0,2829,2851,22,43,43,0,100
06f8dc4c96e94d4c6835d6722282759dde881acd,4,12,0,12,0,0,0,8,65,556,2,2,1.625814584,3918,149,5,974,974,0,25506,25422,84,462,462,0,100
d12209163ebb77899629394ad563cdbe19c1fff7,5,214,1,213,3,0,3,3,38,197,1,2,2.102060508,1834,269,2,385,359,26,12631,11883,748,146,125,21,99.96884042
9938641b1fd44383e40fea13f9756c7fd40b61bf,0,0,0,0,0,0,0,0,0,0,0,0,0,0,416,4,0,0,0,0,0,0,0,0,0,100
f916b8a89fef65f1d784402d1a21b706ae52d3e6,0,0,0,0,0,0,0,0,0,0,0,0,0,0,417,5,0,0,0,0,0,0,0,0,0,100
a0907bfc3f6f58fe6dfc09557934166a9d51cda5,1,3,3,0,0,0,0,8,25,107,1,1,0,320,418,6,56,56,0,2115,2126,11,20,20,0,100
ae3f3af9db3c5833f4563ed3cb883a350e671d79,0,0,0,0,0,0,0,0,0,0,0,0,0,0,419,7,0,0,0,0,0,0,0,0,0,100
f4b14e18b771ce031316ad2fdd5602b5b52262d5,1,3,1,2,0,0,0,5,10,9,1,1,0,126,152,0,34,34,0,668,641,27,16,16,0,100
2700d1681d9cc5ce0d59fe5e497fe2ab64a932fc,3,17,14,3,0,0,0,9,66,9,2,2,1.417973441,3804,153,1,940,940,0,24968,24865,103,446,446,0,100
685ddfecc66b21af9204992d8d88d64107462112,2,16,8,8,0,0,0,5,20,90,2,2,0.954434003,651,69,0,114,110,4,5136,5069,67,26,26,0,100
f4cbe39a6080ae3d8039a1c561dcee56462b1146,0,0,0,0,0,0,0,0,0,0,0,0,0,0,420,8,0,0,0,0,0,0,0,0,0,100
4a5f766a0cb2cf9a3edf5c1f526b3dcf2746928e,1,40,6,34,0,0,0,7,46,83,1,1,0,2808,270,3,353,350,3,17175,16991,184,171,168,3,100
f56cba97778b781d9fdc3e0c3c1a0057498a331a,1,69,59,10,0,0,0,6,9,2217,1,1,0,394,421,9,99,99,0,2598,2505,93,47,47,0,99.95993055
2ef2640092c857bf1cea1808a3a10923f50d3dde,4,30,3,27,0,0,0,8,155,74,1,2,1.85123476,5527,271,4,1604,1596,8,40325,40197,128,474,471,3,100
9377aa5ce51069d62ffd75ac0d759cc5716ec66c,0,0,0,0,0,0,0,0,0,0,0,0,0,0,422,10,0,0,0,0,0,0,0,0,0,100
3bf5a1a25210fb9568627e5490a31585d60f2d10,0,0,0,0,0,0,0,0,0,0,0,0,0,0,423,11,0,0,0,0,0,0,0,0,0,100
2cc69063aac73db67353bb123150849724a7d920,0,0,0,0,0,0,0,0,0,0,0,0,0,0,424,12,0,0,0,0,0,0,0,0,0,100
502e997b9ca45fd380090e4659e75e9486ccc965,1,1,0,1,0,0,0,5,11,83,1,1,0,135,425,13,15,15,0,788,781,7,7,7,0,100
8c2b69d63f0a99c0c70ff0554e0d4978e79119c7,1,2,2,0,0,0,0,4,17,147,1,1,0,319,426,14,37,37,0,2268,2268,0,15,15,0,100
29f29eadf1136811cc6c188b6b552bf797aec128,0,0,0,0,0,0,0,0,0,0,0,0,0,0,427,15,0,0,0,0,0,0,0,0,0,100
502a5996b7b9a3ad611db0a3e70ff3805acc37e9,0,0,0,0,0,0,0,0,0,0,0,0,0,0,162,0,0,0,0,0,0,0,0,0,0,100
b56fcf328763c661e1651c2ec1f2888efa9c9155,3,281,14,267,1,0,1,13,101,43,3,3,0.862727915,2026,163,1,573,555,18,15050,13858,1192,257,251,6,99.87964696
ccc81f0ab872b8f78106e8ba1f8d95453be7c8da,1,13,15,2,0,0,0,6,28,102,1,1,0,341,685,0,96,95,1,2694,2681,13,25,25,0,100
09dab24fcd5b44519db55fc0ab3d51b6e1446c8d,4,18,1,17,0,0,0,7,35,345,1,2,1.978484594,1394,272,2,328,325,3,9187,9147,40,173,170,3,100
20c1d07a3816342f09f4103bacb730d3d86a43c2,4,19,8,11,0,0,0,6,124,1174,1,1,1.695503838,4017,154,2,1148,1147,1,24780,24738,42,311,310,1,100
315a47945cf5fef9c01dd5c43c85f264dfdf1cad,1,223,223,0,0,0,0,2,2,9,1,1,0,133,428,8,7,7,0,988,988,0,5,5,0,100
bd4a82a07d094a140183904676d3b494a04daf19,23,3534,0,3534,23,0,23,1,1,0,1,1,4.186720602,0,686,1,502,0,502,16225,0,16225,161,0,161,99.72018654
5bcf72d16a61bad8c83a21ff2b7bb7d24a2092e8,0,0,0,0,0,0,0,0,0,0,0,0,0,0,687,2,0,0,0,0,0,0,0,0,0,100
e0d8733623356289b52b872431e2b0aa9d7c1d79,0,0,0,0,0,0,0,0,0,0,0,0,0,0,688,3,0,0,0,0,0,0,0,0,0,100
0a658af10a5b235b375be768532ed1d0ad6b2660,4,417,0,417,4,0,4,1,1,0,1,1,1.976347497,0,689,4,40,0,40,1984,0,1984,26,0,26,99.96021396
dcaf2a41f11156e423dd0fe45f8caf3d64e5c47b,1,17,4,13,0,0,0,8,21,42,1,1,0,303,70,0,69,67,2,2043,1925,118,23,21,2,100
3de119f57a62ecdb6886cde2476232f7f12d4f86,3,139,0,139,1,0,1,11,73,179,2,2,0.859617524,1151,0,0,291,270,21,8060,7642,418,104,96,8,99.98674443
1ac8dd4058304a1e479da43779f40098e4773e96,2,123,0,123,1,0,1,11,58,126,2,2,0.434567358,247,429,7,54,42,12,2168,1594,574,21,15,6,100
5c6fffd259a4a187c433234ccc038e6fc30b2850,0,0,0,0,0,0,0,0,0,0,0,0,0,0,639,0,0,0,0,0,0,0,0,0,0,100
aedc8d9dd08dd35f6a2a8e8bfb9b5dc5ce4c332c,1,17,0,17,0,0,0,13,96,156,1,1,0,833,164,2,207,202,5,5827,5725,102,49,48,1,100
b6024187bad23df193afcfdb1fcdf0e247641642,4,157,11,146,1,0,1,2,2,597,1,2,1.586570674,205,150,0,33,22,11,1790,1006,784,29,19,10,99.94253382
a927273cf98f33d57ccac0de89d84dbefd7c90e6,1,9,5,4,0,0,0,6,18,780,1,1,0,125,151,1,26,26,0,607,614,7,5,5,0,100
caeb66ab25f06be62007e086b38b6d03f1eb5a3c,7,313,8,305,3,0,3,1,85,455,2,5,2.241205164,3918,152,2,912,873,39,31784,30670,1114,181,165,16,96.4007558
aae0ccfc3a51cae02d9515d3a100012987fd297e,0,0,0,0,0,0,0,0,0,0,0,0,0,0,153,3,0,0,0,0,0,0,0,0,0,100
c39cd993fa0927b1efffa286f324959258fa79ae,5,425,1,424,4,0,4,1,94,37,2,2,2.151811063,2403,273,0,860,773,87,18228,16137,2091,269,226,43,99.95672453
933da55ce52a5cc0c5cd01d53244e02a9a59b9a5,4,72,1,71,0,0,0,2,2,0,1,1,1.999597534,325,154,2,81,81,0,2018,2018,0,43,43,0,100
0549627bd29e9fcd8f1e3f3d6f796db05fdbc8d2,1,17,3,14,0,0,0,13,75,131,1,1,0,2423,155,2,819,813,6,16723,16618,105,310,310,0,100
be2b020dcc81877edde8ca817af71fbf1279c691,0,0,0,0,0,0,0,0,0,0,0,0,0,0,156,3,0,0,0,0,0,0,0,0,0,100
7e2bfa3029acdc5b7359b0197a8af8cdc591be84,0,0,0,0,0,0,0,0,0,0,0,0,0,0,157,3,0,0,0,0,0,0,0,0,0,100
06c3ec64586a862f056b8dd951db890dcba2a582,1,11,0,11,0,0,0,11,73,195,1,1,0,1556,158,4,477,475,2,11069,11014,55,143,143,0,100
7b97c4b91f05b928e7ee73a99a76ecf503514947,0,0,0,0,0,0,0,0,0,0,0,0,0,0,430,0,0,0,0,0,0,0,0,0,0,100
04b1abb0393fe8f7186b507650b5bd279576bc9b,8,86,7,79,0,0,0,1,42,392,2,3,2.013809849,2751,159,5,752,739,13,18546,18006,540,291,286,5,99.98558178
c8b5c8350e2d8d7dbee3e338f9ec8f4966c5f68d,1,1,1,0,0,0,0,11,59,86,1,1,0,254,160,6,44,44,0,1673,1669,4,15,15,0,100
d48bbbe6cda8e4296c0f0da4a842f046e6e7d63c,0,0,0,0,0,0,0,0,0,0,0,0,0,0,161,7,0,0,0,0,0,0,0,0,0,100
d916e6feb8c7dfc325e7ac1c8a8b9a00b5c7176c,0,0,0,0,0,0,0,0,0,0,0,0,0,0,431,1,0,0,0,0,0,0,0,0,0,100
0568802abfa03a59230b6d2b24be2a5cdb70e8e7,0,0,0,0,0,0,0,0,0,0,0,0,0,0,432,2,0,0,0,0,0,0,0,0,0,100
28a0c0da8639543ae859bcf53c576cbaa21f2d72,2,175,4,171,1,0,1,1,17,136,2,2,0.154419439,137,690,0,45,31,14,2079,997,1082,25,14,11,99.99038924
01c9608fe69bfb03ef40fcdb9c5a621346a3a003,1,0,32,32,0,0,0,5,32,243,1,1,0,1091,691,1,127,132,5,8723,8994,271,74,75,1,100
6259f9a0bb1ee3cd38bc56223aca8740d6c350f4,16,200,141,59,0,0,0,1,2,112,1,1,3.282130695,2061,692,2,425,421,4,14112,13907,205,137,136,1,97.19093113
40052c12ad45377136fd6b4d73e48604816d7241,5,488,1,487,4,0,4,1,3,1,1,3,1.995125707,116,693,3,63,18,45,3088,756,2332,39,8,31,99.96239541
5d5ac618b9c30c63314ce05cc9c4db6982557f8a,2,69,68,1,0,0,0,5,76,614,1,1,0.70101315,2027,694,4,668,668,0,13419,13526,107,184,184,0,100
212740ea77c48afd1a228a93903a92c4e3d00450,1,2,2,0,0,0,0,11,90,659,1,1,0,1531,695,5,486,486,0,11542,11542,0,80,80,0,100
8695d9f54fbf7821156f82ff1ceea745199aa950,0,0,0,0,0,0,0,0,0,0,0,0,0,0,165,0,0,0,0,0,0,0,0,0,0,100
987513f7ac438d2eaf8f4b6f5aec291a8bea7bb3,1,15,0,15,0,0,0,3,4,309,1,1,0,159,71,0,15,14,1,903,832,71,14,13,1,100
d91475d506d06aa550b4ff15c20bcdc348c58684,1,16,15,1,0,0,0,6,17,254,1,1,0,369,696,6,124,124,0,3012,2948,64,26,26,0,100
cc1dcd9a4c177a28db4d8060748f59bf4e9b670e,3,59,128,69,0,0,0,3,20,1326,2,3,1.442075858,984,162,0,233,235,2,6556,6970,414,59,59,0,100
84e66b1d84fb977831ac0d99de6f70fca74eca66,1,3,5,2,0,0,0,6,18,0,1,1,0,369,697,7,124,124,0,3001,3012,11,26,26,0,100
6dab974ec72d7377ce497a246c5cf01fb382050b,0,0,0,0,0,0,0,0,0,0,0,0,0,0,72,1,0,0,0,0,0,0,0,0,0,100
ee92abbdd0589e099251f63d97fe2e7afe6430d1,0,0,0,0,0,0,0,0,0,0,0,0,0,0,73,2,0,0,0,0,0,0,0,0,0,100
5c92fc502abab9728d4549d7241a7fca41d15f87,1,0,1,1,0,0,0,2,3,727,1,1,0,104,166,1,9,9,0,679,689,10,3,3,0,100
90a95d4ee9e5f5bd31a2b5a6b45903f5963b30eb,0,0,0,0,0,0,0,0,0,0,0,0,0,0,110,0,0,0,0,0,0,0,0,0,0,100
cdfb5c79c50d56c305c8d02e620149440ebc7b80,0,0,0,0,0,0,0,0,0,0,0,0,0,0,74,3,0,0,0,0,0,0,0,0,0,100
85a408aca74aee119f83a294b1144c4b5ae7699c,0,0,0,0,0,0,0,0,0,0,0,0,0,0,433,0,0,0,0,0,0,0,0,0,0,100
d1ec54c6914e92f02817fdeb290a860bc908fc0b,3,79,6,73,0,0,0,6,25,524,3,3,1.292843164,931,167,1,180,165,15,6455,6176,279,51,48,3,100
af080beed34e9920020e0379d9f3706f744ff70b,1,37,8,29,0,0,0,6,23,1451,1,1,0,220,434,1,0,0,0,1664,1664,0,0,0,0,100
c415857292d2f79e33ebcdf11c4652826eae79b2,3,666,0,666,2,0,2,2,2,333,2,3,0.907602112,48,435,2,69,5,64,2488,272,2216,43,3,40,99.97651149
3c8d303c9a6d0df0f05e78a6f669f4a34af9093c,0,0,0,0,0,0,0,0,0,0,0,0,0,0,436,3,0,0,0,0,0,0,0,0,0,100
24f976d6198378c4d9fc5ba3af74b52d778f83d8,1,2,6,4,0,0,0,11,19,297,1,1,0,238,155,0,61,61,0,1623,1650,27,15,15,0,100
b1b503e136464410119034e08b655c299c3b3ca0,5,38,39,1,0,0,0,5,21,2276,2,3,2.037613918,1103,698,0,304,304,0,7078,6977,101,154,154,0,100
8e6a7ae3313edb8ae6c6c37f184ce9b7cd680482,1,4,1,3,0,0,0,13,97,182,1,1,0,844,437,4,207,207,0,5833,5827,6,49,49,0,100
891ccc625c6126e7d2b9a50be5d468927151b74b,3,173,8,165,2,0,2,1,86,55,2,2,1.52601917,3215,438,5,682,672,10,26455,25867,588,140,132,8,99.97652251
61f686a3002312033366aa05ea171113b666395d,1,11,7,4,0,0,0,15,59,300,1,1,0,1109,439,6,289,289,0,7981,7970,11,59,59,0,100
a048ba1faa440d4e2ff084ca346f0d2c021b2a29,1,2,2,0,0,0,0,1,2,309,1,1,0,117,440,7,8,8,0,648,648,0,4,4,0,100
bc5e826b4579a166f388d8f6474ef51859b4fa1b,1,1,3,2,0,0,0,3,24,923,1,1,0,276,441,8,42,42,0,1765,1768,3,13,13,0,100
eaad779a3308a7a363b1411b674b0eebb7bd179c,0,0,0,0,0,0,0,0,0,0,0,0,0,0,111,0,0,0,0,0,0,0,0,0,0,100
cf4a80047e589c90d00de433a3e5d3008565fd07,0,0,0,0,0,0,0,0,0,0,0,0,0,0,112,1,0,0,0,0,0,0,0,0,0,100
0c37fc6e5744a8d84d9d343ac29323844f682b6e,9,206,94,112,0,0,0,12,125,376,4,4,2.397255814,9355,156,1,2447,2427,20,58816,58279,537,874,869,5,99.98122506
54980303924747fdb44cdc7ecc2177b8fa58e5a0,0,0,0,0,0,0,0,0,0,0,0,0,0,0,75,1,0,0,0,0,0,0,0,0,0,100
b44614d94b13f90d879aff00d0c8bd62f368529f,2,9,10,1,0,0,0,2,98,604,2,2,0.629249224,963,442,8,226,226,0,6434,6438,4,68,68,0,100
c54b8ca82374c9b0626a2d28c0610ecb9b77496d,5,292,2,290,4,0,4,1,14,241,2,3,2.10114505,270,443,9,89,68,21,3337,2212,1125,30,14,16,99.95778018
91ef7813d1e1b0c293f04b3e95f2c3f7c1bf8dbb,1,1,113,112,0,0,0,10,27,334,1,1,0,479,444,10,139,156,17,2856,3207,351,38,54,16,100
4aed0be581c236a605445ecc34affcdf28a36ca4,1,7,11,4,0,0,0,13,99,1,1,1,0,845,445,11,207,207,0,5838,5829,9,49,49,0,100
3d5e01bb1e1baf3c13d0ef25e10a5e0f677b93f4,14,0,28,28,0,0,0,2,6,826,1,3,3.807354922,1127,113,2,176,176,0,6078,6078,0,99,99,0,100
3261c1f18502d6d4e05740c8de43570bd08989e2,14,28,0,28,0,0,0,2,7,0,1,3,3.807354922,1099,114,3,176,176,0,6078,6078,0,99,99,0,100
78198b67e733eae27ccf67cf8c151e9d45011f4c,14,0,28,28,0,0,0,2,8,0,1,3,3.807354922,1127,115,4,176,176,0,6078,6078,0,99,99,0,100
e3be88bf7ef8c5a101875d1a1c63ef2832fa8c42,3,17,8,9,0,0,0,3,6,713,1,1,1.163990458,303,157,2,29,28,1,1978,1909,69,27,27,0,100
25b4e8719566d1860e8cb3ea335ec2fcbd45379c,0,0,0,0,0,0,0,0,0,0,0,0,0,0,446,9,0,0,0,0,0,0,0,0,0,100
e0a0050e7bec8032ec0160bdf3c955b1e437737c,6,45,92,47,0,0,0,12,156,422,1,2,1.698714388,6926,76,1,1825,1834,9,49120,49366,246,503,508,5,99.99531089
887f8977ed6deb68f835fbd02cbb3747fd03aad2,5,64,36,28,1,0,1,4,157,512,2,3,2.001884735,4654,163,0,1357,1356,1,33486,33307,179,455,454,1,99.98124619
e6421a4118cfff6ebdd2dccdc31d2a5d4e023d11,1,18,0,18,0,0,0,2,2,0,1,1,0,27,447,6,4,4,0,119,119,0,4,4,0,100
2027274a07e33e9bedbe55cf92be2221c382063e,0,0,0,0,0,0,0,0,0,0,0,0,0,0,448,6,0,0,0,0,0,0,0,0,0,100
1cfbf9d171802e90b469287574b3165461472736,1,2,2,0,0,0,0,4,12,359,1,1,0,1352,449,7,114,114,0,8701,8701,0,54,54,0,100
2e0d69141fc379ce39cad71fabf4e4c5a44d01a2,0,0,0,0,0,0,0,0,0,0,0,0,0,0,77,1,0,0,0,0,0,0,0,0,0,100
1d889e3e506fa3f203a9a8559a018f07e4212ea5,0,0,0,0,0,0,0,0,0,0,0,0,0,0,78,2,0,0,0,0,0,0,0,0,0,100
0022b991ab84c0425663eb6475c6c2c75dcae0f2,1,6,2,4,0,0,0,7,21,24,1,1,0,253,79,3,46,46,0,1627,1611,16,25,25,0,100
2dbbe70692adfb38d05ce040768db02ff65fbc16,5,388,0,388,4,0,4,1,39,64,1,3,2.050060594,1188,450,4,303,278,25,9390,7687,1703,91,67,24,99.95314404
6fdcebd67367fb1dc9d7d50362bfbce35a0b54ac,3,244,5,239,1,0,1,14,126,150,2,2,0.48370028,4284,168,0,1283,1268,15,28412,27360,1052,317,309,8,99.99063407
6309bff2f013f3b187a9aadec1c29e450c8a1596,1,226,226,0,0,0,0,2,2,0,1,1,0,163,451,4,13,13,0,997,997,0,7,7,0,100
c87edf80497062d096d5441effb7a1164e673675,1,6,0,6,0,0,0,5,18,1057,1,1,0,273,452,5,63,61,2,1679,1638,41,15,15,0,100
7d0de515a5d9949e738a1b55fc9d36b644ddb91e,2,10,12,2,0,0,0,10,24,621,1,1,0.684038436,515,453,6,118,118,0,3287,3297,10,34,34,0,100
d3d944ccd28095b9fbaa6368979b5a064fc9e744,1,1,1,0,0,0,0,5,14,1333,1,1,0,558,454,7,153,153,0,2531,2530,1,78,78,0,100
621c52065eaac92fd989ff33e0d8fe72b567096c,1,33,6,27,0,0,0,3,3,709,1,1,0,59,80,3,7,5,2,428,283,145,4,3,1,100
0971bd301c73bcc82215ecf4d9e18a9908ee5d34,2,184,2,182,0,0,0,2,8,1179,2,2,0.149811367,591,169,1,110,93,17,3914,3135,779,31,27,4,100
0b72fb417a761069443586961dc7f7ad61eafeb2,0,0,0,0,0,0,0,0,0,0,0,0,0,0,81,4,0,0,0,0,0,0,0,0,0,100
f6e05d085208568e1ced2881bd564f49065ce653,0,0,0,0,0,0,0,0,0,0,0,0,0,0,82,5,0,0,0,0,0,0,0,0,0,100
2cfb4f62322444507f19bb79477fa5c85a2e78c3,5,49,15,34,0,0,0,2,95,853,3,4,1.706570438,3193,164,0,912,911,1,21790,21525,265,296,295,1,100
7eb317e488993e2f6e0acdd7843abb4833181b2e,3,531,2,529,2,0,2,1,57,279,2,3,1.574401425,1451,165,1,573,483,90,11444,9155,2289,214,169,45,99.97659066
056e9d87208bdbed52c1d7c13209e5dcda5256b9,0,0,0,0,0,0,0,0,0,0,0,0,0,0,166,2,0,0,0,0,0,0,0,0,0,100
8464dc4d1d3a5e009fd93d5a0251ea7967696b17,1,1,1,0,0,0,0,2,2,876,1,1,0,62,116,0,19,19,0,329,329,0,2,2,0,100
9b5fa5152acd4cd77520b36e06bdfb58d8f3cf64,2,63,2,61,1,0,1,11,92,347,2,2,0.751649946,1413,167,3,316,312,4,8863,8658,205,259,256,3,94.51414965
f1c1c7878785f6c066bcba0944ebd8117cc6b701,1,3,1,2,0,0,0,3,25,104,1,1,0,275,699,0,43,42,1,1773,1765,8,13,13,0,100
59c9ec99af799b442c38cbe97efbe2fe9cb258d7,0,0,0,0,0,0,0,0,0,0,0,0,0,0,83,2,0,0,0,0,0,0,0,0,0,100
f10e349f7c356291d32173541c3936e0253243b8,1,11,10,1,0,0,0,11,20,142,1,1,0,234,158,0,61,61,0,1629,1623,6,15,15,0,100
1f139e4013fafe115c294a89d8d1b9596e4846a6,0,0,0,0,0,0,0,0,0,0,0,0,0,0,84,3,0,0,0,0,0,0,0,0,0,100
fd197214a922428f79f9b512e9fc4c144d0724f8,1,1,1,0,0,0,0,11,21,3,1,1,0,235,159,1,62,61,1,1636,1629,7,15,15,0,100
e6b590d73d81f634dc6257caba8f1426c9655c44,10,746,4,742,8,0,8,1,30,115,2,3,2.957244822,1207,170,0,440,390,50,10790,7930,2860,172,135,37,99.77206704
20b66ce0df3c68e9d0e32fcf4c2018fe25566215,0,0,0,0,0,0,0,0,0,0,0,0,0,0,160,2,0,0,0,0,0,0,0,0,0,100
03d4f2f8b6ee948e94c00a51f46b536a2e5c4009,2,26,8,18,0,0,0,1,101,109,2,2,0.936667382,954,161,3,215,211,4,6675,6563,112,55,53,2,100
d470141828c6dab1326a2aedf16490dce8e4c131,0,0,0,0,0,0,0,0,0,0,0,0,0,0,85,2,0,0,0,0,0,0,0,0,0,100
2d232cf4c0f6aaa33dc911610ee098cab0320dbb,3,60,9,51,1,0,1,2,76,702,2,3,1.121215384,2515,168,1,834,831,3,17169,16999,170,324,322,2,99.99108655
985a59afbdfcc7ce59b712f807e5751407483d80,3,284,21,263,1,0,1,1,158,43,1,2,0.95558132,4426,455,0,1287,1274,13,33326,32277,1049,361,355,6,99.97326561
e35178f645722793c9a25ea7b970a084b0dc8356,20,1864,0,1864,20,0,20,1,1,0,1,13,4.023612567,0,456,1,108,0,108,4332,0,4332,72,0,72,94.99187139
8c68768917b64b0f687095f6f29bf1f86165536d,0,0,0,0,0,0,0,0,0,0,0,0,0,0,86,3,0,0,0,0,0,0,0,0,0,100
82c79adab1cfa42e67c0d19760dcf9f623b8afd5,0,0,0,0,0,0,0,0,0,0,0,0,0,0,87,4,0,0,0,0,0,0,0,0,0,100
8544f5da4a76c60f34097b3073d4b7ed4813ff80,1,43,14,29,0,0,0,1,2,11,1,1,0,144,457,2,5,4,1,1010,903,107,5,4,1,100
d20b9a95117482a811c90df92c740b004438ea54,5,33,41,8,0,0,0,1,2,10,1,2,1.653679167,391,458,3,46,46,0,1943,1941,2,20,20,0,100
7afa8754f7385d852f04359512d75c91d48dd5d0,0,0,0,0,0,0,0,0,0,0,0,0,0,0,88,3,0,0,0,0,0,0,0,0,0,100
d5e20c4a115bf69a48adb29e7791f56f82993579,1,4,2,2,0,0,0,9,21,233,1,1,0,723,459,4,209,208,1,5362,5351,11,44,44,0,100
6b93af88a660000ee6ff0a6f911b356b05a69028,0,0,0,0,0,0,0,0,0,0,0,0,0,0,89,4,0,0,0,0,0,0,0,0,0,100
b8e0b0d58b27943a967fe62faa8b38ed5893d7ed,0,0,0,0,0,0,0,0,0,0,0,0,0,0,90,5,0,0,0,0,0,0,0,0,0,100
a582e60afb955951e7eb634286ad7708f55f5b1d,0,0,0,0,0,0,0,0,0,0,0,0,0,0,91,6,0,0,0,0,0,0,0,0,0,100
9223144782ea6369c611645e667a2149b1bd170d,0,0,0,0,0,0,0,0,0,0,0,0,0,0,92,7,0,0,0,0,0,0,0,0,0,100
a997e75ecd5aba713e4334d7142f1efd79c5f036,0,0,0,0,0,0,0,0,0,0,0,0,0,0,93,8,0,0,0,0,0,0,0,0,0,100
c2b3e11a7873aada889b81099794d641328ade34,0,0,0,0,0,0,0,0,0,0,0,0,0,0,94,9,0,0,0,0,0,0,0,0,0,100
77b7ced1d511a8a73a053bf8f3eb171be05fc2cb,0,0,0,0,0,0,0,0,0,0,0,0,0,0,95,9,0,0,0,0,0,0,0,0,0,100
354eb3078e363ab26da64fbea06bd24d5a1af8de,4,234,11,223,3,0,3,1,17,194,2,3,1.888081355,255,169,0,81,64,17,2487,1681,806,33,19,14,99.96796192
045818b05df6886bb4176bb4878007e8f40e92a6,2,2,2,0,0,0,0,1,2,2,1,1,1,113,170,1,12,12,0,453,453,0,12,12,0,100
d1d356c151f8cd6d7f5c047d9c6641ea93c624fe,0,0,0,0,0,0,0,0,0,0,0,0,0,0,96,8,0,0,0,0,0,0,0,0,0,100
9ea0354f1bfdf56f0f6a052406edaefebe5fb3b8,5,498,2,496,3,0,3,3,127,51,2,3,1.558995016,3981,162,0,1189,1148,41,27261,24682,2579,332,306,26,96.50574516
76552a11fd237eef606bca6e22a98215393340ff,5,10,13,3,0,0,0,12,74,1979,4,4,1.627763742,1003,460,1,175,175,0,6590,6586,4,61,61,0,100
bb50bc3caf498016c0b107c28f9831cb40c4c86d,1,1,1,0,0,0,0,11,74,329,1,1,0,1564,700,0,477,477,0,11069,11069,0,143,143,0,100
69fd9dbad901302a1e4ae5d9515068a1fce1bb37,1,10,1,9,0,0,0,12,32,177,1,1,0,752,461,2,160,160,0,5142,5084,58,48,48,0,100
1b8ce008b291714ce06a217d607d9ad8c8e8d279,5,195,12,183,2,0,2,1,128,245,2,3,2.067605729,4740,171,2,1442,1426,16,30577,30002,575,388,374,14,99.97983627
b6ddcab3831b5d78f3781f33f8d9864f88849d3c,1,0,1,1,0,0,0,12,33,2,1,1,0,758,462,2,160,160,0,5138,5142,4,48,48,0,100
d450910b0a1fb73ab73067d20500be53f3c4323c,3,130,2,128,2,0,2,11,76,323,2,2,1.26906372,1664,172,3,485,476,9,10699,10310,389,129,121,8,99.9798444
fb91730361b0c7618fcb56bc786332d1175f82fa,1,17,18,1,0,0,0,1,2,0,1,1,0,55,173,4,6,6,0,228,229,1,3,3,0,100
f9c5a20200c4bc6a859e2d3b23cf0d6806acf289,1,4,3,1,0,0,0,15,103,65,1,1,0,875,174,5,217,216,1,5956,5944,12,52,52,0,100
849a77b5d3c2eb5281e9d5f0ec24b715e68fc507,1,2,1,1,0,0,0,13,38,546,1,1,0,360,463,3,79,79,0,2619,2615,4,22,22,0,100
c00af8d5e8f94f466d198aae565928a3ccc79cd8,1,0,6,6,0,0,0,5,8,612,1,1,0,180,464,4,23,23,0,1151,1166,15,11,11,0,100
6fc7d55a09c87112d2ade2f451c0c11947f9fab0,3,90,29,61,0,0,0,12,77,342,3,3,0.971470514,2293,1,0,671,660,11,13834,13632,202,232,228,4,100
26aa776627e84f62767d689f3f71941a51687602,4,44,6,38,0,0,0,2,92,1061,2,3,1.385826527,2585,465,5,724,716,8,19453,19256,197,200,198,2,100
c159730005aee494d916063b947970eea0179899,3,162,6,156,1,0,1,1,159,192,1,3,0.950471709,4213,466,6,1273,1264,9,31495,30839,656,394,389,5,99.98387942
1148ba809d4756b67703fffb6234605cd287b50d,2,37,8,29,0,0,0,2,93,4,2,2,0.836640742,1947,467,7,571,566,5,14782,14640,142,138,137,1,100
1125b86310b7c08efb2b524633acec52840093e1,2,4,3,1,0,0,0,1,23,2,1,2,0.985228136,721,468,8,202,202,0,4910,4908,2,87,87,0,100
aa88b32b06ec37c1b618d3e4c2d552b852a0b1b5,2,12,4,8,0,0,0,16,160,1,1,2,0.988699408,4224,469,9,1268,1268,0,30957,30949,8,391,391,0,100
862e818e5058f5e898374b1e49fc8e27287b2bc0,4,55,36,19,0,0,0,12,78,145,3,3,1.887635859,3182,175,4,887,884,3,20942,20846,96,247,247,0,100
64bd51ea04c186b80a03cd3fb8ceb6f808ef659d,0,0,0,0,0,0,0,0,0,0,0,0,0,0,2,1,0,0,0,0,0,0,0,0,0,100
258cf99784da43b740a5c843cf21d39dec7aa093,1,0,2,2,0,0,0,4,4,1448,1,1,0,240,176,1,32,32,0,1104,1112,8,9,9,0,100
350ed99379f29b606bf61dedfb4a9bb7f9f397e2,0,0,0,0,0,0,0,0,0,0,0,0,0,0,0,0,0,0,0,0,0,0,0,0,0,100
81c46c503f5efccc4b3724c2c0ea2a19eb93db4a,8,749,0,749,6,0,6,1,129,20,2,2,2.419577732,4579,171,0,1446,1385,61,32612,29418,3194,383,335,48,99.93555663
7b0d1140ac54eb910fa00adf7b2e483a336df41d,1,1,1,0,0,0,0,6,18,87,1,1,0,106,172,1,10,10,0,664,664,0,6,6,0,100
dcf90c68eb5796aba5299aaee498953fa4340fec,1,24,8,16,0,0,0,12,34,83,1,1,0,757,470,0,164,160,4,5219,5138,81,48,48,0,100
50bfa5d2618540b4fd5a033ae4ffe8f1d3160305,1,21,4,17,0,0,0,4,9,2150,1,1,0,146,173,2,24,22,2,995,895,100,19,17,2,99.97583568
b6f39e246dc366cbecdf1d980feca79c05e758a5,1,2,0,2,0,0,0,4,10,0,1,1,0,155,174,3,24,24,0,1015,995,20,19,19,0,100
511fbec8863e8d850a9e039b06bd02aa01286270,1,1,1,0,0,0,0,3,7,1106,1,1,0,352,117,0,31,31,0,2530,2530,0,14,14,0,100
43b545eca415b965f3e7d7a91dedf1890323fa53,0,0,0,0,0,0,0,0,0,0,0,0,0,0,471,1,0,0,0,0,0,0,0,0,0,100
0bcded74e124d14ddd505823ac0ad479b90ac8fb,7,116,38,78,0,0,0,12,91,1132,3,3,2.210630858,6793,472,2,2030,2006,24,47283,46813,470,499,494,5,100
5cceefda8e9fdba8dfc741360839120acbb44487,2,8,9,1,0,0,0,5,24,737,1,1,0.787126586,294,701,0,45,45,0,1917,1896,21,11,11,0,100
14816f465ba3d8cb4fe858f8e8e7b39fa0cb413b,3,21,4,17,0,0,0,2,10,1592,1,1,1.405678055,94,702,1,0,0,0,279,279,0,0,0,0,100
0de12ed49202d2c8aa0f10ad81727d58f61d8d7d,2,43,7,36,0,0,0,2,29,1517,2,2,0.242292189,940,703,2,401,382,19,7308,6916,392,49,49,0,100
8ef3f3db35c2d6464ee28721690ff0b6f5ba55e8,2,27,2,25,0,0,0,12,80,51,2,2,0.79732651,1890,473,2,540,537,3,11383,11338,45,170,168,2,100
b9e61a892316696551ff6b3c9a31cf119c6156ec,2,5,1,4,0,0,0,8,24,818,1,1,0.918295834,434,474,3,80,80,0,2898,2879,19,26,26,0,100
cabf34a6fd21b1e1b9edc6f951c9d57d43fa99db,9,136,21,115,1,0,1,13,103,316,3,4,2.329879364,7497,0,0,2159,2142,17,50837,50275,562,764,758,6,99.99194198
e9dd20c9e9447fdc9986fa59e2f0285a8d66fee7,2,14,8,6,0,0,0,13,104,2,1,1,0.574635698,2238,1,1,586,586,0,15047,15019,28,321,321,0,100
cc3c3eb055c361f9e6bffe5b28d0f560288615fe,5,116,13,103,0,0,0,4,130,1112,2,4,1.774405666,4180,177,0,1183,1173,10,26035,25516,519,334,328,6,96.20925887
be88506438973ba77e1d6d9456fcf5caf20494c7,1,6,5,1,0,0,0,3,12,2114,1,1,0,841,475,4,92,92,0,6760,6762,2,27,27,0,100
0046a656c9c5239209d576ee02dccbba35876570,1,4,1,3,0,0,0,12,69,944,1,1,0,566,704,3,135,133,2,3919,3881,38,49,49,0,100
a7778ff6a9cd83a4142bbbd5f7cce3c3f85c4e95,1,1,1,0,0,0,0,3,13,2,1,1,0,841,476,5,92,92,0,6762,6760,2,27,27,0,100
9be9d836c4ad883292a60c8b0df1366dae56b808,6,81,7,74,0,0,0,14,131,1499,2,2,2.162468309,7970,705,4,2306,2295,11,51647,51303,344,759,757,2,100
9305834478ba40ba3ecda0b03aca213f90d0b923,148,6214,1429,4785,32,0,32,2,163,543,6,46,5.891368027,57039,501,1,15014,14401,613,409922,390118,19804,5196,4898,298,96.8175389
6269231420dee6d9976f4db0a5d85bf4e38b9fb4,0,0,0,0,0,0,0,0,0,0,0,0,0,0,4,3,0,0,0,0,0,0,0,0,0,100
aff65db7e994a3b3eaff9543e3d7d0b04934dfaf,0,0,0,0,0,0,0,0,0,0,0,0,0,0,5,4,0,0,0,0,0,0,0,0,0,100
8d2b795b347bedf8c07eddac84c44fef04f80cac,0,0,0,0,0,0,0,0,0,0,0,0,0,0,6,5,0,0,0,0,0,0,0,0,0,100
e24439984b6af275ecef7d3f5da8b8f92e14bd59,6,86,25,61,0,0,0,3,164,2976,3,5,2.416945372,4466,203,2,1364,1349,15,32898,32480,418,359,357,2,98.8078207
a4d56b5c5b5b0f36fa1334c7d2a6cea615042ed1,0,0,0,0,0,0,0,0,0,0,0,0,0,0,7,6,0,0,0,0,0,0,0,0,0,100
e3fbbfbcede0d4735a882e5208d2a20257c8b2f4,0,0,0,0,0,0,0,0,0,0,0,0,0,0,8,7,0,0,0,0,0,0,0,0,0,100
1a383857ff1c9c3e8de4f61cc1fda4ff6494d534,3,243,6,237,1,0,1,9,36,49,2,3,0.995623557,1254,4,0,307,275,32,9633,8653,980,98,88,10,99.98437622
b2af30891db8bbfd85f1fff67d21efccdba943eb,1,1,1,0,0,0,0,9,26,2,1,1,0,585,5,1,73,73,0,3243,3243,0,61,61,0,100
10a09897a6fd5817eb2c083e2a3cd3727a16ec16,0,0,0,0,0,0,0,0,0,0,0,0,0,0,176,1,0,0,0,0,0,0,0,0,0,100
12e33c9af396fc621e99caa4612c750183e8b9f4,24,547,595,48,0,0,0,3,73,1348,3,4,4.016347835,10359,121,0,2702,2656,46,64492,65116,624,1735,1689,46,98.1949193
bfd6b46773a22251f0143cfa70777b9b5da7a3a4,0,0,0,0,0,0,0,0,0,0,0,0,0,0,122,1,0,0,0,0,0,0,0,0,0,100
4bf8225bfae4fa7f9c97b2e55970ff5e153cbb64,0,0,0,0,0,0,0,0,0,0,0,0,0,0,640,0,0,0,0,0,0,0,0,0,0,100
b20b8103e02ce0c7b08bfb8cf32d97e5aa1df415,1,67,0,67,1,0,1,1,1,0,1,1,0,0,9,6,3,0,3,200,0,200,3,0,3,99.99305556
3631ed562eb960c676455933872e053b2d1f2566,2,2,2,0,0,0,0,2,47,1863,1,1,1,590,732,0,163,160,3,4159,4139,20,69,69,0,100
261917b3a002ab7b506d4afe23f34644cd08fe42,0,0,0,0,0,0,0,0,0,0,0,0,0,0,177,1,0,0,0,0,0,0,0,0,0,100
ba24ed7c0b7a278e2a0a76e89b4454bb33d79569,0,0,0,0,0,0,0,0,0,0,0,0,0,0,10,6,0,0,0,0,0,0,0,0,0,100
fedd2f776257a563448c8a3aaabd8afc2232b608,1,0,2,2,0,0,0,1,2,2,1,1,0,46,11,7,3,3,0,200,200,0,3,3,0,100
e4a94c6cf8271fd302adaf888d5c9c842459796b,7,169,194,25,1,0,1,13,165,636,1,2,1.993393822,7746,733,1,2331,2362,31,54756,55249,493,848,853,5,99.98611352
ffd2a7bfedb5870ad6fe71a5a52306d4500815f5,1,1,2,1,0,0,0,10,29,0,1,1,0,379,734,2,115,116,1,2531,2541,10,37,37,0,100
14d8109f9581045e1efdc347601209baedc2d5b5,1,15,0,15,0,0,0,10,30,8,1,1,0,378,735,3,118,115,3,2591,2531,60,38,37,1,100
9f4fba24dab254fb43d00ac65a3b2896d3ed9e61,3,51,27,24,0,0,0,2,3,785,1,3,0.744194214,246,12,3,31,29,2,1408,1312,96,17,15,2,100
62462f47524e5408956d8ddc1b4d9d0ef6d9d0d6,2,100,0,100,2,0,2,1,1,0,1,1,0.995378439,0,13,4,5,0,5,291,0,291,5,0,5,99.9861169
6bc2b5671d00143dd7039f7c6472f6a449174951,1,8,7,1,0,0,0,1,2,0,1,1,0,47,14,5,3,3,0,220,206,14,3,3,0,100
857abde46c85239d472410f0c005877dd8632d30,1,2,2,0,0,0,0,12,79,155,1,1,0,734,736,4,153,154,1,5061,5070,9,46,46,0,100
fab453596120544955efe71300a120ae394ff40e,4,206,201,5,0,0,0,13,78,1181,1,1,1.009125079,3574,737,5,1078,1076,2,24548,24253,295,468,465,3,100
db415aa984158265b3c0da845bc322d7853d2fb3,4,201,206,5,0,0,0,13,79,0,1,1,1.009125079,3568,738,6,1076,1078,2,24253,24548,295,465,468,3,100
da004e608ef7ea7ca312fb0282957d91c548402e,1,47,34,13,0,0,0,13,80,2,1,1,0,2403,739,7,808,808,0,16518,16503,15,306,304,2,100
6369c744bdbb4c72fca8ec0c276dffcd6be9e752,1,8,3,5,0,0,0,10,46,177,1,1,0,691,641,0,212,212,0,4933,4906,27,51,51,0,100
9cc9b97c97a28d3d9154f78c6a5255414c591d9c,12,151,1,150,0,0,0,3,19,48,3,3,3.477919234,4922,123,0,1463,1433,30,29995,29400,595,1241,1211,30,100
59d0a5262bcd64b577cbdf815e530a3fdc67dac7,1,62,1,61,0,0,0,10,37,66,1,1,0,695,7,0,214,205,9,5941,5586,355,30,29,1,100
afef47f79856793909ee28256f14351eb3409588,1,3,0,3,0,0,0,17,166,36,1,1,0,3615,178,0,1079,1078,1,26718,26693,25,310,310,0,100
ed33f06f4dfd171209a026e9511e3c3c84a289a2,0,0,0,0,0,0,0,0,0,0,0,0,0,0,10,0,0,0,0,0,0,0,0,0,0,100
2d1ff88afb2c21c052044d8ac0b6058efb3d19d2,0,0,0,0,0,0,0,0,0,0,0,0,0,0,11,1,0,0,0,0,0,0,0,0,0,100
6289157f9c92a8bb1790a195e83bc15373841eb3,0,0,0,0,0,0,0,0,0,0,0,0,0,0,15,0,0,0,0,0,0,0,0,0,0,100
2846f873c2eb0c858db1e353278eda390b99d664,8,308,237,71,0,0,0,13,81,527,1,2,1.847318572,5189,740,3,1534,1524,10,36004,35491,513,695,692,3,100
162e98d5b3f3cdc260705efacb7a0c5c305602d0,0,0,0,0,0,0,0,0,0,0,0,0,0,0,179,1,0,0,0,0,0,0,0,0,0,100
3beb74571aeab1e8785a167d4a30db3ae4ce4a57,0,0,0,0,0,0,0,0,0,0,0,0,0,0,16,1,0,0,0,0,0,0,0,0,0,100
0ec5ae0c928d2870c453a3007bb54f0afec7264c,0,0,0,0,0,0,0,0,0,0,0,0,0,0,180,2,0,0,0,0,0,0,0,0,0,100
e267cdd56224e960e05c0842f2c99047e7cd532e,0,0,0,0,0,0,0,0,0,0,0,0,0,0,181,3,0,0,0,0,0,0,0,0,0,100
d354f7cf847d7f346bdc9bd98da690c21277eb0e,2,13,8,5,0,0,0,3,139,1594,2,2,0.985228136,4013,204,0,1144,1143,1,24910,24876,34,307,307,0,100
5bb79b9309aa099ffa2f48a20ad8b506180762ad,0,0,0,0,0,0,0,0,0,0,0,0,0,0,182,4,0,0,0,0,0,0,0,0,0,100
1a50b5fe762e6dda708b46a08ae59fafa6800fbb,20,598,423,175,1,0,1,8,167,1264,4,8,3.46826809,16886,741,1,4989,4965,24,122877,122026,851,1562,1556,6,99.96877169
3c1a2621067e0c8284150bef24b4162e5c950832,3,29,16,13,0,0,0,11,33,216,1,3,1.476056329,1858,742,2,477,475,2,13406,13345,61,137,135,2,100
6430d8eb9235296302d9f53a23aeca8cc63339f0,1,84,17,67,0,0,0,13,83,1,1,1,0,2445,743,3,822,813,9,17305,17048,257,309,306,3,100
c2e11e7f13c3c84f260265161f091fa2831b1de9,1,2,3,1,0,0,0,14,91,142,1,1,0,3266,744,4,676,676,0,26257,26269,12,134,134,0,100
3dee2ca176ee8d85ea89e09f0607036c0cad7b17,1,1,1,0,0,0,0,12,80,66,1,1,0,734,745,5,153,153,0,5064,5061,3,46,46,0,100
024ff20a8c5c5ec8494cb65a175a69687d83259c,2,63,62,1,0,0,0,13,84,2,1,2,0.671247885,2934,746,6,930,932,2,20955,20965,10,330,331,1,100
6bed19c848dd99a870bc1864cc9b350dfe241650,1,15,6,9,0,0,0,7,14,1347,1,1,0,352,747,7,109,107,2,2904,2852,52,28,28,0,100
2c65619be4190b81039de6b87dc8b9ffdef837f7,4,223,3,220,2,0,2,1,36,800,2,3,1.530788939,794,205,1,294,271,23,6814,5895,919,63,44,19,99.97918762
dc95a8a2e640b2b743c975372c5426894b6e0d24,2,1,6,5,0,0,0,1,2,0,1,1,0.985228136,161,206,2,20,20,0,716,747,31,18,18,0,100
736221d10098f808a90ab98b86587b6b7fd473d5,2,212,0,212,2,0,2,1,1,0,1,2,0.859531691,0,748,8,21,0,21,834,0,834,9,0,9,99.98266237
49adef7c61f3bf2c2257a01375b01264bb333088,13,182,130,52,0,0,0,13,91,474,4,7,3.017281618,4243,749,8,1041,1036,5,30130,29847,283,422,421,1,99.98959886
816280b17bbef5519a052565c565b87cd3bbb115,5,124,31,93,0,0,0,2,85,1022,2,4,2.23170785,3765,750,9,1116,1104,12,28468,28073,395,391,386,5,100
ade97ac4d448200bc84b48973f6bd1ace4e338c8,1,3,1,2,0,0,0,1,4,0,1,1,0,64,751,10,14,14,0,318,318,0,7,7,0,100
f31e4ba5072e1c43647042f5dd00ce1ced0e2b03,2,73,23,50,1,0,1,1,5,0,2,2,0.870864469,65,752,11,18,14,4,393,318,75,9,7,2,99.98959922
ccdcf9b3fd6e9427dedd7d226e8b2d3bdac20a19,1,2,2,0,0,0,0,9,21,1346,1,1,0,591,753,12,68,68,0,3924,3922,2,7,7,0,100
e37a58907218feafed529230e05abe34281582db,11,112,116,4,0,0,0,2,32,1538,5,9,2.965710324,3062,754,13,882,882,0,22931,22681,250,211,211,0,100
7def6f8a674e34af58543ead829ad7a5b5f2534e,2,4,4,0,0,0,0,1,6,4,2,2,0.954434003,95,755,14,18,18,0,393,393,0,9,9,0,100
3929e28cda84245afdccd44cb51e13ef213be39a,1,1,1,0,0,0,0,11,61,245,1,1,0,1553,756,15,536,536,0,10083,10082,1,177,177,0,100
fc1ea49c38c5022126e533c98f581e5a945a2a4d,3,19,16,3,0,0,0,3,62,1038,2,3,1.336286231,2816,757,16,944,942,2,18633,18603,30,333,333,0,100
1de07a52ecca70d411c865bac92c08310392294e,1,0,1,1,0,0,0,10,43,177,1,1,0,1465,183,1,346,346,0,9629,9638,9,86,86,0,100
11dc47c80ab3883b2da6eabd38d3af6130239fc7,1,1,1,0,0,0,0,10,44,2,1,1,0,1464,184,2,346,346,0,9634,9629,5,86,86,0,100
ad41647b999b239e7e7add88210ca20b1e0f6bf1,1,1,1,0,0,0,0,10,45,0,1,1,0,1464,185,3,346,346,0,9634,9634,0,86,86,0,100
7b2d6ea89d2a33b0b2269f04e84b782235f20c37,1,17,8,9,0,0,0,1,3,8,1,1,0,115,758,17,18,17,1,741,716,25,8,7,1,100
a666c1d14b6ab27c3635a6f8d995100f88146a89,1,4,0,4,0,0,0,1,7,24,1,1,0,51,759,11,9,8,1,203,187,16,7,6,1,100
52ea95686b7febacae7782817901faa54c120beb,1,1,1,0,0,0,0,11,37,1166,1,1,0,521,6,0,137,137,0,3187,3181,6,72,72,0,100
2988ebaf2a264c9c3d9a918c5bb13abf0708d73e,2,30,8,22,0,0,0,1,3,37,1,2,0.629249224,78,760,12,17,14,3,375,299,76,6,5,1,100
65f9e5926591e280eb8e810c3322f7c3aab777bb,1,0,4,4,0,0,0,1,8,0,1,1,0,54,761,13,8,9,1,187,203,16,6,7,1,100
ba3f74e8be229fc2951b4b69db5d0d9467d36445,1,1,1,0,0,0,0,13,39,52,1,1,0,777,762,14,157,157,0,4931,4929,2,89,89,0,100
5aa9a573c5490878b752ad54a8a6e35f53b0bb65,1,86,0,86,1,0,1,1,1,0,1,1,0,0,763,15,9,0,9,358,0,358,7,0,7,99.99306711
64c8d56e9a8939dbcf419d300b27e8b62d4413d2,1,1,1,0,0,0,0,1,9,0,1,1,0,51,764,16,8,8,0,181,187,6,6,6,0,100
4d0917c55143fb9293f03e88bf54eb6d2854c781,4,647,368,279,1,0,1,1,75,13,2,4,0.805824106,2192,765,17,578,569,9,15388,15059,329,221,209,12,99.98613806
b0536597ae372c8712e9dd56acc538a0e0569f0b,1,1,1,0,0,0,0,15,76,1,1,1,0,1294,766,18,393,393,0,9685,9676,9,122,122,0,100
3a5fce3e33fde632c8b884a5e735007fda09f947,1,2,1,1,0,0,0,15,77,0,1,1,0,1294,767,19,393,393,0,9685,9685,0,122,122,0,100
e8aaaccf9c7912846e95a30107d9a259fb1bba99,0,0,0,0,0,0,0,0,0,0,0,0,0,0,124,0,0,0,0,0,0,0,0,0,0,100
e14af5d7abd79aebb8181d268d4b520ca920b904,11,779,12,767,7,0,7,1,99,40,2,4,3.139476883,5621,176,0,1288,1192,96,44764,41945,2819,489,434,55,99.94805555
e5a7710d6bac0dcce78b3c52311ba74c309e7715,1,1,0,1,0,0,0,13,41,10,1,1,0,777,125,1,157,157,0,4936,4929,7,89,89,0,100
647ab63101243b0b4964f8334828e1acfa0b5019,0,0,0,0,0,0,0,0,0,0,0,0,0,0,768,19,0,0,0,0,0,0,0,0,0,100
91eb9d4792818cf0aa0ffe43c0972bc74cd5739b,2,6,3,3,0,0,0,5,8,202,1,1,0.764204507,280,126,2,52,53,1,1733,1740,7,14,14,0,100
824753b36cbdb20539f28959a7b2d399475d0350,1,120,12,108,0,0,0,5,11,348,1,1,0,711,207,0,214,183,31,5404,4744,660,107,96,11,100
98859e2006bcbbe02723438788886abeb3bf0fd9,1,5,1,4,0,0,0,5,12,0,1,1,0,801,208,1,214,214,0,5404,5404,0,107,107,0,100
0f17510c5cede34e676f6f9587c2690b97bea1a5,0,0,0,0,0,0,0,0,0,0,0,0,0,0,186,3,0,0,0,0,0,0,0,0,0,100
f9cf3b7919546dda9bcf62c140022b8fbca831fc,1,6,1,5,0,0,0,5,7,2265,1,1,0,89,177,1,11,10,1,610,579,31,4,4,0,100
e6d667e6db7f0f42aa4948d9ac3d438e6fca17a2,0,0,0,0,0,0,0,0,0,0,0,0,0,0,127,3,0,0,0,0,0,0,0,0,0,100
2bbbcc9d735a66b64afc1a8bcdba13ab151242db,42,1363,2498,1135,0,0,0,3,168,41,5,14,4.008345118,23134,128,4,6417,6496,79,161904,165551,3647,2201,2248,47,99.92033528
5680616fccef264716732486e0f5ab7f68a1ac8e,1,57,0,57,1,0,1,1,1,0,1,1,0,0,769,10,9,0,9,264,0,264,1,0,1,97.7076076
b1e7cb3a702a31f8141da9da7bef64368cac724b,1,3,1,2,0,0,0,2,2,0,1,1,0,44,187,1,9,9,0,264,264,0,1,1,0,100
bb9fd6f65c3ac2fc5ee4d845afb6f71972966948,0,0,0,0,0,0,0,0,0,0,0,0,0,0,188,2,0,0,0,0,0,0,0,0,0,100
0b55b3bc7c06e00ed1ea1c228c4b5cb5cc247648,0,0,0,0,0,0,0,0,0,0,0,0,0,0,189,3,0,0,0,0,0,0,0,0,0,100
a47e0b7798695f8855e375e398de0098a458dc8d,0,0,0,0,0,0,0,0,0,0,0,0,0,0,190,4,0,0,0,0,0,0,0,0,0,100
777a1f6ba8299d7732dc5fdccde1e16d634c4ddb,0,0,0,0,0,0,0,0,0,0,0,0,0,0,191,5,0,0,0,0,0,0,0,0,0,100
2d42a79c58a4e5e51308601d8b910879476247e6,0,0,0,0,0,0,0,0,0,0,0,0,0,0,192,6,0,0,0,0,0,0,0,0,0,100
4d1e1bc8df87d8ed08835b68d0bc8e53dd8dd75e,0,0,0,0,0,0,0,0,0,0,0,0,0,0,193,7,0,0,0,0,0,0,0,0,0,100
408d8b4463214053557a0722bf9d976feb6e60a2,0,0,0,0,0,0,0,0,0,0,0,0,0,0,194,8,0,0,0,0,0,0,0,0,0,100
cecd73b6ee1060d4d869349e527bb392d2599bf9,1,2,30,28,0,0,0,10,29,203,1,1,0,1931,129,3,418,420,2,11563,11706,143,215,217,2,97.09751337
c55f8469f1c24c88360220e9c5d82389a4b82dff,1,8,5,3,0,0,0,14,113,287,1,1,0,1463,130,4,385,384,1,9716,9704,12,230,230,0,100
6599b7b403fecc75ec7b3fb2bfd0b51bcfa6cdb8,2,13,0,13,0,0,0,1,140,440,2,2,0.779349837,4034,209,2,1150,1148,2,25230,25145,85,309,308,1,100
1f3f320af3633b990f671eee525abe97d1f83b56,1,3,4,1,0,0,0,15,105,226,1,1,0,2420,210,3,783,783,0,16270,16270,0,227,227,0,100
1cb2f10f6ebac68a64c8b46ffce5691c33c8462f,1,2,2,0,0,0,0,15,106,309,1,1,0,890,131,4,221,221,0,6022,6022,0,52,52,0,100
103aa4ffc0ea149de21dbc13596e1ea31d3ff831,9,47,0,47,0,0,0,6,13,1597,1,2,3.165503036,2620,178,1,374,365,9,17398,17290,108,124,115,9,100
fdda697583d18c53e83ddd2d82fda4acbddeb58d,1,6,4,2,0,0,0,17,169,27,1,1,0,3615,132,5,1080,1078,2,26713,26705,8,310,310,0,100
d03434b5576f028adb1781cb0ff659ebd34e105b,9,540,4,536,6,0,6,14,85,384,3,4,2.634334659,4858,179,1,1427,1372,55,33641,31644,1997,571,539,32,99.94248042
c275da64abe546a9af2c28bb6245cb8a95754e96,1,23,1,22,0,0,0,11,21,992,1,1,0,422,12,0,152,147,5,3405,3292,113,14,13,1,100
ce44b7ddcd672809ed8e09db380de061ea757f45,1,115,96,19,0,0,0,6,17,2210,1,1,0,490,180,2,182,182,0,3398,3292,106,26,26,0,100
5f5b20f523e070e3f1464842738bc2450b73d967,0,0,0,0,0,0,0,0,0,0,0,0,0,0,195,8,0,0,0,0,0,0,0,0,0,100
8971fda1aaf23b1057b1fe20fab940411bd432c3,1,1,1,0,0,0,0,16,106,20,1,1,0,2419,7,0,784,783,1,16277,16270,7,227,227,0,100
e07b3ce3cf63fff17b06c6a6289a52ae40d0f62e,1,7,1,6,0,0,0,6,16,2898,1,1,0,163,8,0,22,21,1,915,898,17,10,10,0,100
b98289edbcb2cac2494b066f24a1c1d0d8e85ad0,0,0,0,0,0,0,0,0,0,0,0,0,0,0,196,2,0,0,0,0,0,0,0,0,0,100
ecf492ac461b032caf5486b48d2693ea32e5edc2,1,96,115,19,0,0,0,6,18,35,1,1,0,508,181,3,182,182,0,3292,3398,106,26,26,0,100
e1c4c92888ce7e8559a1e1ea74ec7513226b7e70,6,529,0,529,6,0,6,1,1,0,1,1,2.573694315,0,13,1,96,0,96,2432,0,2432,37,0,37,99.93812975
f94fb7f727fa9f4773ef682ea87ee6bb74af9256,7,368,1,367,6,0,6,1,80,6,2,2,2.499252356,1370,14,1,419,396,23,10817,9808,1009,137,117,20,99.94261752
a7f8af893cd06a925d8f1ef1509e83be6499687b,0,0,0,0,0,0,0,0,0,0,0,0,0,0,197,2,0,0,0,0,0,0,0,0,0,100
cc4f6264ba88810930ee5b8b02df9dfeb9c1ecf9,2,2,2,0,0,0,0,14,97,174,1,1,1,3852,133,0,1133,1131,2,25772,25760,12,260,260,0,100
b68cf1d0fbebcc08561fbdd4d32d4d11ae6f0c73,7,358,7,351,5,0,5,1,19,64,2,3,2.284669889,388,198,3,140,102,38,3210,2190,1020,67,43,24,99.9250474
ca7918e88c50bf2f9e120759c596ace7b70c445c,0,0,0,0,0,0,0,0,0,0,0,0,0,0,199,4,0,0,0,0,0,0,0,0,0,100
f4e1d195bb88e69df1724916162eb435886363e2,1,92,4,88,0,0,0,14,93,108,1,1,0,3396,182,1,736,712,24,27742,27213,529,139,137,2,100
7063dd52967a0c8532624e4e0ae849a0be39b81f,1,0,2,2,0,0,0,5,13,110,1,1,0,801,211,0,213,214,1,5392,5404,12,107,107,0,100
1d71976c8f38a7f56efcb70267a5249337a77981,1,18,5,13,0,0,0,5,14,15,1,1,0,799,212,1,217,213,4,5461,5392,69,108,107,1,100
1925881f5d7a48764db727f30a947623c823df36,2,8,3,5,0,0,0,1,6,469,2,2,0.845350937,191,213,2,22,22,0,1171,1147,24,9,9,0,100
83b432a46f7624a0c1200c602ea65019030183e7,3,173,1,172,2,0,2,1,170,29,2,2,1.114080041,3617,15,0,1094,1080,14,27493,26713,780,320,310,10,99.9779726
3d04bdd463e3e85a02d0c7be1acfd72a1ce17f03,1,1,1,0,0,0,0,16,141,98,1,1,0,3932,214,3,1142,1142,0,24521,24521,0,304,304,0,100
3e1de6c8e3b56457d05250beae5b124c008aba40,18,1023,58,965,3,0,3,7,107,1102,2,7,3.064149571,12351,183,0,3781,3564,217,86355,82240,4115,1701,1618,83,95.7426529
b2cc17c13581839173dae4986ba1005bedf6f454,1,14,10,4,0,0,0,16,108,0,1,1,0,2466,215,4,796,795,1,16568,16554,14,232,231,1,100
f506835fa810c177c8c93a7d0ef24d05570b21fe,6,633,5,628,4,0,4,3,100,473,2,3,2.345876742,1648,200,0,401,336,65,13375,9894,3481,321,275,46,99.942184
284b6e5ceda27eb678399930bc49e028e2e2a39b,1,10,0,10,0,0,0,12,59,153,1,1,0,351,201,1,0,0,0,2427,2413,14,0,0,0,100
42372cf6094fa8e32ad9dd31d1bc79a839f45ba4,5,26,59,33,0,0,0,3,101,80,2,3,1.586114658,2520,202,2,423,429,6,15812,15955,143,342,346,4,100
0354b057c99b41ae6eda2f1bfcdd44850af9b80a,1,24,10,14,0,0,0,18,171,19,1,1,0,3621,134,0,1086,1081,5,26801,26729,72,311,310,1,100
208be279f99344723ac70d44323eaa0d4822850d,4,12,11,1,0,0,0,5,109,1777,1,1,1.924673369,2667,135,1,837,836,1,17393,17386,7,261,261,0,100
90fcd9623d231489b22de9c5d78c2d28ada818a5,1,1,1,0,0,0,0,16,142,13,1,1,0,3932,136,2,1143,1142,1,24527,24521,6,304,304,0,100
b897fe50cc9902e4e11c071d535a54b97a8b4741,1,2,0,2,0,0,0,5,13,437,1,1,0,66,137,3,8,8,0,348,329,19,5,5,0,100
e9ab0d7cec9e81fae5423cb4b4f3a0a209a51dc6,0,0,0,0,0,0,0,0,0,0,0,0,0,0,203,3,0,0,0,0,0,0,0,0,0,100
461471d174c4a99c4dff796e80123e73923d4fd9,1,1,1,0,0,0,0,4,4,2709,1,1,0,429,138,4,53,53,0,3221,3225,4,19,19,0,100
83916ff986b8e020160c67cca47e81a9ade2b2d6,1,5,0,5,0,0,0,16,110,2,1,1,0,2468,139,5,799,797,2,16598,16575,23,232,232,0,100
c5d2d2c217eb54bcc495c67777e439f5d856e2bd,21,120,46,74,0,0,0,11,111,2001,1,2,3.380583746,5551,140,6,1664,1649,15,33145,32809,336,629,626,3,100
6b6c06330a88934c02ae083ded276d189be7d1bd,3,11,1,10,0,0,0,4,143,365,1,3,1.251629167,4537,141,7,1355,1352,3,28447,28390,57,342,341,1,100
90306339595a0d781e22119df11289a68c7a1f85,1,7,6,1,0,0,0,6,12,5,1,1,0,95,216,4,23,22,1,490,482,8,12,12,0,100
31da969bd625c8d02c816d7a474c151d5f130e8f,5,33,30,3,0,0,0,5,82,10,2,3,1.893148083,2678,184,1,732,729,3,18176,18210,34,233,232,1,100
f3dbb5acadf320541d132a588dbc69073b3cf9ef,5,49,10,39,0,0,0,4,144,1120,1,4,2.124997134,6282,142,8,1885,1881,4,40730,40668,62,500,497,3,100
ec836bec3b85d557a8c0bb175eac720a0f6ba868,1,11,6,5,0,0,0,2,3,1232,1,1,0,117,204,4,9,8,1,705,648,57,5,4,1,100
8e445e03a1003390407670f72be58d37dfe27569,1,2,2,0,0,0,0,16,83,3,1,1,0,1391,143,9,408,408,0,9982,9982,0,118,118,0,100
06742412b3b8caae014f9044afdccddd445dd254,2,22,11,11,0,0,0,11,65,302,1,1,0.684038436,1555,205,5,433,430,3,10959,10890,69,98,97,1,100
60e42eddda986127e797ab081a06f4e77a9c24f3,1,1,1,0,0,0,0,4,8,8,1,1,0,119,144,10,29,28,1,594,587,7,12,12,0,100
08b0dd2913af1788046bab1681d2dc342c13f417,1,9,3,6,0,0,0,13,76,368,1,1,0,571,17,0,137,136,1,3954,3936,18,49,49,0,100
3bfaadf1c10169e7ca7fbc23719b044b6a64d1a2,1,6,2,4,0,0,0,5,20,1185,1,1,0,277,206,6,63,63,0,1670,1660,10,15,15,0,100
b7bd2c873dd8bf84fb94ced1528e4c09ebc46249,4,109,4,105,2,0,2,4,10,1395,2,2,1.708879905,355,217,2,80,76,4,2597,2262,335,66,62,4,99.97833622
8ac15ebf931b481cd37c8828ef7c36c2a01448aa,0,0,0,0,0,0,0,0,0,0,0,0,0,0,145,4,0,0,0,0,0,0,0,0,0,100
aac116c904fb66ab33c8e7d72630cd3ad549bb49,1,1,1,0,0,0,0,14,40,518,1,1,0,772,18,0,167,167,0,5239,5239,0,48,48,0,100
df8d3c44169ebc5f4200420e2e202ac5f3ec0720,69,9211,341,8870,65,0,65,1,34,4,3,10,5.447050965,2673,185,0,1939,648,1291,55831,19211,36620,1019,254,765,96.22799346
9b322a9318e431c2cf1272dd355c40e198f64804,0,0,0,0,0,0,0,0,0,0,0,0,0,0,186,1,0,0,0,0,0,0,0,0,0,100
eef9fd4b316a88bc68729b099e23620f77eeb139,1,2,0,2,0,0,0,1,2,2,1,1,0,56,187,2,7,7,0,227,213,14,7,7,0,100
a2c820b66ee9bfa380a2fbe73a032fc040b38a0d,1,5,5,0,0,0,0,3,4,75,1,1,0,121,19,1,9,9,0,705,705,0,5,5,0,100
b15b164b6ceaf5902da9ddf4ee84dcfbbc32d8f1,4,473,0,473,4,0,4,1,1,0,1,1,1.79490948,0,20,2,29,0,29,1661,0,1661,26,0,26,98.74028304
badcf47af8bf85d13fe3019648635d5f274b91ec,1,2,7,5,0,0,0,1,2,0,1,1,0,154,21,3,5,5,0,915,935,20,3,3,0,100
a0f7a2f50fcf156576333367613a50222cec7895,4,201,41,160,1,0,1,1,2,117,1,1,1.614565931,222,16,0,58,37,21,2008,1278,730,25,15,10,99.99208673
432499a3a69acdd985b321fd9ef3101430fa7b54,1,9,13,4,0,0,0,16,112,98,1,1,0,2458,218,0,792,793,1,16484,16493,9,231,232,1,100
8c8e250f402125bcf6a05ef696e33db5417371dd,2,15,4,11,0,0,0,9,47,269,2,2,0.981940787,1570,8,0,555,554,1,11204,11156,48,100,99,1,100
6df8fa909afd1bb66be3bd2daeb1231f751c157a,1,2,0,2,0,0,0,2,2,24,1,1,0,103,207,0,15,15,0,482,468,14,14,14,0,100
0c4b201e8ff8d80015e53cc0ccbdb3ac88798bfa,1,2,0,2,0,0,0,2,3,2159,1,1,0,95,146,0,35,35,0,589,579,10,10,10,0,100
155f2626d08988ed617725ab3b58c8e15912a1ee,0,0,0,0,0,0,0,0,0,0,0,0,0,0,147,1,0,0,0,0,0,0,0,0,0,100
ae9e05b9c7c742f7f5640f5f9fbfa090b9e6b0ba,1,4,3,1,0,0,0,5,15,152,1,1,0,810,219,1,219,217,2,5474,5461,13,108,108,0,100
32d2a850110157fb9e29e38ea1a957d1747e3852,1,3,0,3,0,0,0,10,24,566,1,1,0,447,220,2,116,115,1,2907,2899,8,55,55,0,100
e6a8d377bce1c2b4ecbb349c8be7c836ea78af56,2,22,1,21,0,0,0,11,172,194,2,2,0.932111568,5542,9,0,1507,1504,3,38449,38364,85,527,526,1,100
61b023c7842ba0cdde6305f1be742f773d0f3b84,2,35,8,27,0,0,0,14,98,1829,2,2,0.693127415,1677,22,0,522,517,5,12398,12291,107,102,100,2,100
901c70e1d6a726c769fc08d80422126591b0f9ad,5,270,1,269,4,0,4,1,57,56,2,2,2.093928798,862,208,1,249,230,19,8170,7212,958,61,43,18,99.96440577
f617557bc3dd90b61229900372b492ab9dbba502,6,49,1,48,0,0,0,1,2,60,1,1,2.579470571,2568,188,0,798,786,12,12590,12428,162,337,325,12,100
122f5fe92d8f8f6808238e03dd6928ec362ca34e,1,3,4,1,0,0,0,10,19,1694,1,1,0,547,23,1,182,182,0,3664,3677,13,103,103,0,99.97231998
8a7ce9df2e7c8a790aff1e53f4b462deb4e460d6,4,53,54,1,0,0,0,1,1,0,1,1,1.655747204,348,24,2,29,20,9,1612,3660,2048,28,12,16,98.72152302
2889520be9cdba1d0cc4ef9e5f573d2895f74025,1,3,3,0,0,0,0,9,34,591,1,1,0,137,25,3,29,29,0,814,814,0,16,16,0,100
6be44b2e40c83f46f130a660a0fa149f17be068e,1,4,9,5,0,0,0,9,16,1401,1,1,0,184,26,4,47,47,0,925,978,53,17,17,0,100
ac9466b46067ea5aa9da2fd13470442b8f6aa871,1,59,20,39,0,0,0,1,2,0,1,1,0,132,27,5,7,2,5,1040,785,255,5,2,3,100
fe1a099bcf9d2727fc06a39bb9af1c2d56a70754,1,6,1,5,0,0,0,1,3,0,1,1,0,170,28,6,8,7,1,1053,1040,13,5,5,0,100
908e0f69350a5804d6f54387d86ee4a39906698b,325,22,1008,986,0,0,0,4,40,2589,1,82,7.920424758,38104,29,7,3886,3886,0,224220,232090,7870,2618,2618,0,95.80885723
7cee19d3be610e178020eabdae6c877e6784373c,1,5,3,2,0,0,0,11,81,167,1,1,0,1843,221,1,599,599,0,12229,12218,11,167,167,0,100
8200a351a75b06297445ba8a9909efa8baeb5557,0,0,0,0,0,0,0,0,0,0,0,0,0,0,189,1,0,0,0,0,0,0,0,0,0,100
11cd0d5fd417abc6fff78bc52b124968cebab4f3,2,32,1,31,0,0,0,8,36,175,2,2,0.32984607,1403,10,0,227,223,4,11604,11410,194,100,99,1,100
ebe06fdf352a63c3152874b3efdc4960108cf3b5,4,125,2,123,2,0,2,1,15,1697,2,4,1.413083079,776,11,1,217,212,5,5524,5045,479,111,108,3,99.97833528
5fb9e7172681211588a526257d8c5a1bb5111530,3,125,4,121,2,0,2,1,173,16,2,3,1.294542031,3642,12,2,1097,1088,9,27236,26854,382,319,311,8,99.97834467
e6129051c263992fde38687ada21a4b41336b431,3,201,2,199,2,0,2,1,16,1155,2,3,1.235675446,326,13,3,100,79,21,3246,2490,756,35,17,18,99.97402485
4f479a988746dfc8862ae9db991e811131a3f202,8,327,6,321,4,0,4,1,34,1087,2,3,2.480844906,1712,17,0,506,484,22,12728,11595,1133,230,210,20,99.96106087
dde88d592c553549c51e88a30bd952a87f0c6c7d,1,3,1,2,0,0,0,16,84,189,1,1,0,1391,148,0,409,408,1,10001,9982,19,118,118,0,100
c47085e32f617554f4f5614bb1ee96af1b51820e,1,19,0,19,0,0,0,9,27,522,1,1,0,585,209,0,74,73,1,3291,3243,48,62,61,1,100
c120b18eb9755e7753a3fc8a10f049d4ec458b79,3,19,4,15,0,0,0,3,81,138,2,3,1.402934238,2224,222,1,622,619,3,15620,15489,131,198,197,1,99.90042859
3f03f91eb8aa77afc414a7cdd3dee072cc1b7cab,1,5,1,4,0,0,0,13,78,0,1,1,0,575,223,2,137,137,0,3935,3935,0,49,49,0,100
d1306467c38e36e8e41f583b3de6960a377c6d98,1,1,0,1,0,0,0,12,81,419,1,1,0,734,210,1,153,153,0,5073,5064,9,46,46,0,100
4659638a1d741e95a95d591df1ee7c3209f88ee5,5,308,1,307,4,0,4,1,7,80,2,2,1.992493152,457,18,1,175,140,35,4682,3364,1318,86,67,19,99.9566837
f3e64797b24b92a012ed80c341d9b4385bdc1629,1,2,2,0,0,0,0,3,9,525,1,1,0,294,770,0,82,82,0,1635,1630,5,56,56,0,100
11b8035acef38c689e9fb7b0f023cf131553271a,4,126,3,123,2,0,2,5,59,489,1,1,1.473637118,1377,771,1,158,144,14,13747,13393,354,117,111,6,95.77189287
91c9e234787f68fb8c39e2fb1489e5e3b7004233,1,1,1,0,0,0,0,14,114,378,1,1,0,1465,772,2,385,385,0,9727,9716,11,230,230,0,100
325c7a2f2f4e51d62fab44f08f2367407bd20e8f,1,5,2,3,0,0,0,2,5,912,1,1,0,273,773,3,70,70,0,1707,1680,27,38,38,0,100
318642931b73778ef0da511fb7cc251984946a43,1,2,4,2,0,0,0,2,3,919,1,1,0,58,774,4,12,13,1,288,289,1,5,5,0,100
56bd02449a1d311119fae7c4204fde5f49fd111e,4,413,0,413,4,0,4,1,1,0,1,1,1.923507984,0,775,5,37,0,37,1463,0,1463,30,0,30,99.95680058
1fe219eeaec56e7c8a79fff8c45bfed91d9e6d7e,1,1,0,1,0,0,0,14,115,0,1,1,0,1466,776,6,385,385,0,9742,9727,15,230,230,0,100
cbffb40022241d9862f14ebe25b62551fdc42ec1,1,18,0,18,0,0,0,1,2,1,1,1,0,51,777,7,12,12,0,239,239,0,8,8,0,100
f5d06d73304dabedebfa1d8e7e7d99802e82ffbc,1,4,6,2,0,0,0,2,2,2,1,1,0,109,224,0,10,10,0,706,706,0,9,9,0,100
60c94ad4125fb515340477800029f1e586155745,0,0,0,0,0,0,0,0,0,0,0,0,0,0,225,1,0,0,0,0,0,0,0,0,0,100
dc339a98bc2f7fa3941c6d40e2bd7a8f476e7254,1,1,1,0,0,0,0,13,82,79,1,1,0,1575,778,8,480,480,0,11157,11157,0,144,144,0,100
1de868af0559a91e394fc0b1555eeeffcc64557b,7,688,0,688,7,0,7,1,1,0,1,2,2.66424303,0,226,2,76,0,76,2709,0,2709,53,0,53,99.94692497
1246de0774567c6f0f8d3db115a9138f8bed4363,0,0,0,0,0,0,0,0,0,0,0,0,0,0,227,3,0,0,0,0,0,0,0,0,0,100
b5c83f05f9d1c6a8880302641320adb8b5da63e2,2,4,4,0,0,0,0,1,2,21,1,1,1,89,211,0,13,13,0,290,290,0,5,5,0,99.98674531
d586739ae397ffe2a7dcd68f01a4bcb3c5af35bb,0,0,0,0,0,0,0,0,0,0,0,0,0,0,228,4,0,0,0,0,0,0,0,0,0,100
e4d72a7983a37ac34028b35718947af5d9170e2a,0,0,0,0,0,0,0,0,0,0,0,0,0,0,229,4,0,0,0,0,0,0,0,0,0,100
b04dee5ad2c4277d97b51c1d0ea1ecc03df79f4a,0,0,0,0,0,0,0,0,0,0,0,0,0,0,230,5,0,0,0,0,0,0,0,0,0,100
f30d74802dfec7a0148ca0e98993a2d7495f1085,1,7,5,2,0,0,0,16,113,216,1,1,0,2457,212,1,793,792,1,16492,16484,8,231,231,0,100
5eb13dbde9782affaa41e954e72decef8f3748ca,4,196,0,196,3,0,3,1,8,76,2,2,1.377819851,177,149,0,65,50,15,1859,1166,693,22,13,9,99.97018387
90032dc954223e3fb5600afa8b59a67a665ffb24,0,0,0,0,0,0,0,0,0,0,0,0,0,0,231,6,0,0,0,0,0,0,0,0,0,100
a42c9c280a2834dae7e70b4c3f06e4d7ccd644d0,1,29,0,29,0,0,0,10,38,575,1,1,0,733,232,7,218,214,4,6152,5941,211,30,30,0,100
4b04ef53cfa5769f9a32cd90808f17a5bb06a1f0,4,280,2,278,3,0,3,1,34,78,2,2,1.861411398,436,233,6,185,142,43,3826,2911,915,65,39,26,99.97682042
0506e9f0b5005087032543c3f908e7b2d07af8e4,1,9,4,5,0,0,0,18,174,147,1,1,0,3643,190,0,1089,1088,1,26888,26867,21,311,311,0,100
5afd4e851bb1fe56de5b1b546abecd799d036ad7,4,296,275,21,2,0,2,1,35,878,1,3,0.950229664,2067,234,7,382,366,16,17351,16877,474,162,151,11,99.98675935
654f835222f35902c73fab791b5bccc8e6289e14,2,17,4,13,0,0,0,18,175,391,1,2,0.453716339,3930,213,1,1144,1141,3,28723,28659,64,337,337,0,100
0abd271b3cf28467d61e4e7b07dc541062508256,1,6,6,0,0,0,0,5,15,2782,1,1,0,448,214,1,137,137,0,2798,2792,6,41,41,0,100
a7b90fd9edd7bc43e8c7cc981fc6281aafcf0127,0,0,0,0,0,0,0,0,0,0,0,0,0,0,215,2,0,0,0,0,0,0,0,0,0,100
8c2527215d0662f1345206033bdb8539e27e94cc,1,5,0,5,0,0,0,2,2,1787,1,1,0,115,216,3,30,29,1,706,666,40,11,10,1,100
423d1d18e4066f4be13dc8d60bcf41759b5cfac8,1,3,0,3,0,0,0,2,3,0,1,1,0,119,217,4,30,30,0,727,706,21,11,11,0,100
5c05a69ce6f371616dfb049fc1c996260b10a394,1,12,3,9,0,0,0,9,20,803,1,1,0,262,9,0,60,59,1,1432,1405,27,41,41,0,100
bcda87c67b6e35d3236e04c0bc699da6f6d5022f,3,127,3,124,2,0,2,1,16,188,2,3,1.223495599,309,235,1,90,83,7,2994,2435,559,24,19,5,99.98345412
a55000a4be3385fa71d556a5a53e84a0638b6d8c,4,144,1,143,3,0,3,1,48,68,2,2,1.710347028,1193,236,2,428,424,4,8811,8490,321,86,84,2,95.26076304
2683a0227ad661119c1084aa2372434f40654f10,1,1,1,0,0,0,0,1,2,0,1,1,0,32,237,3,2,2,0,113,113,0,2,2,0,100
3e787f7fe35c262388a4ac10399fd6e76a758de5,1,1,1,0,0,0,0,1,2,9,1,1,0,38,238,3,0,0,0,123,118,5,0,0,0,100
4f930b1c29d0dc2502e640e97ea5c0bce03b8086,4,91,4,87,2,0,2,1,65,414,2,2,1.521063396,1256,218,4,368,360,8,9038,8833,205,98,91,7,99.98514116
1d1b1bbea9dc35bae01b4304fb0b272d6df585d0,0,0,0,0,0,0,0,0,0,0,0,0,0,0,219,5,0,0,0,0,0,0,0,0,0,100
c3169ccf3693eaeca6a925530247a8c4906c8d5f,1,18,4,14,0,0,0,15,107,506,1,1,0,890,220,6,225,221,4,6102,6022,80,53,52,1,100
eb02dc6c519f325e2f614a0a93acf37ac2fb46c1,0,0,0,0,0,0,0,0,0,0,0,0,0,0,221,7,0,0,0,0,0,0,0,0,0,100
a5992927e3e17cfada14dcbdbe8585accb919e84,1,69,43,26,0,0,0,3,3,552,1,1,0,113,30,0,15,16,1,755,642,113,7,7,0,100
9e9b0a7ae3ea25e999bbaa7bf4f16afa0147404b,3,21,10,11,0,0,0,8,15,3129,1,1,1.583476643,341,10,0,76,74,2,2188,2144,44,53,52,1,99.98142852
bc29ef104d0494a08c348a58141760a51f18f534,1,2,1,1,0,0,0,10,33,2022,1,1,0,1279,222,0,473,472,1,10175,10165,10,60,60,0,100
512520f7fb764b406aa3fc3dd298dbf63ec7eb58,2,86,11,75,1,0,1,1,66,42,2,2,0.772398436,731,223,1,220,209,11,5343,5074,269,69,64,5,99.99257168
1952ecd460306fb0539ee6b947d6d07fd84e9bfc,0,0,0,0,0,0,0,0,0,0,0,0,0,0,150,0,0,0,0,0,0,0,0,0,0,100
ef2065122aec54bdee276b4e7f3777c94748826e,2,85,1,84,1,0,1,15,116,113,2,2,0.407076806,1467,11,0,393,385,8,10132,9742,390,236,230,6,99.99257279
e9a6d6681d59750c438ddf384e23b8f28d971085,3,306,0,306,2,0,2,14,93,210,2,2,0.982711212,486,12,1,150,119,31,4878,3180,1698,69,56,13,99.98143679
556d796ed38799a7c99d550ba4d79d26a5933abc,2,50,6,44,0,0,0,2,6,230,1,1,0.966618633,332,779,0,89,82,7,2169,1995,174,47,43,4,99.87763275
ae3441b049f60168e8abec0ef5988c0ba6265df7,2,3,2,1,0,0,0,2,3,1150,1,1,0.721928095,57,780,1,0,0,0,185,185,0,0,0,0,100
0ae1199283814bd7ed3e8bd1f317f3a38b23dfb8,2,58,1,57,0,0,0,1,3,228,1,1,0.693965967,176,781,2,28,22,6,1338,945,393,21,17,4,99.94076049
837638b91b320139aae84df052335c4c8f0f240f,1,2,1,1,0,0,0,12,27,960,1,1,0,236,239,0,55,55,0,1634,1627,7,19,19,0,100
e424097b564273b807f0637056ea244c40a125c3,3,172,6,166,1,0,1,1,34,2672,2,2,1.25424976,666,240,1,154,134,20,5130,4380,750,63,54,9,99.99259917
fd4ca960502967429a242bbdbb51abd778346899,2,8,1,7,0,0,0,4,17,2294,2,2,0.764204507,428,241,2,114,112,2,3121,3075,46,25,24,1,100
fd8e5fe8658a3195a0b3df8db6d064b83fee7274,0,0,0,0,0,0,0,0,0,0,0,0,0,0,782,0,0,0,0,0,0,0,0,0,0,100
1c2ec168ed7a65534db50a8a11c1ba70e797e663,1,5,1,4,0,0,0,4,4,156,1,1,0,126,242,3,15,15,0,792,755,37,7,7,0,100
a06d373573b5e12ba309ef9e6137ee4e759eae5e,4,69,6,63,1,0,1,2,49,130,2,2,1.671031378,1265,224,0,432,428,4,8998,8748,250,86,86,0,99.99260027
9f128e3286913f04597b9263c5d2559361138442,0,0,0,0,0,0,0,0,0,0,0,0,0,0,243,4,0,0,0,0,0,0,0,0,0,100
3a6ffd834f9ee2b94daa2e56514fd5aae9d93a3e,1,1,10,9,0,0,0,1,2,14,1,1,0,92,244,5,7,7,0,466,533,67,6,6,0,100
dab8b620f94c5bd065232bf352eabe3e4adb18ea,3,103,95,8,0,0,0,2,4,2142,1,1,1.062633271,1113,245,6,186,178,8,7253,7097,156,53,50,3,100
4823f1748eeba31bbf81b7fde1c017470f0d3d92,20,533,81,452,7,0,7,12,82,1106,3,3,3.709500222,2651,246,6,639,601,38,19228,17570,1658,229,213,16,99.85592375
94969374f623a82a8d659b763b2c987d2b1c3d79,2,313,0,313,1,0,1,1,79,187,1,2,0.098702311,575,247,7,181,137,44,5124,3935,1189,91,49,42,99.98893642
4ca0cdc92cf98149c720901cec86f628eb8e5e93,1,31,36,5,0,0,0,11,30,798,1,1,0,1011,225,1,285,285,0,7377,7396,19,65,65,0,100
e5f91d12b425a7ab23fedb49101e65a027a6731d,1,0,309,309,0,0,0,1,2,0,1,1,0,222,248,8,0,43,43,0,1156,1156,0,42,42,99.98893642
0988966e5c3a0c5fa3d8574d2fddaf46b0912c42,2,8,3,5,0,0,0,6,18,929,2,2,0.845350937,162,249,4,11,11,0,830,825,5,7,7,0,100
fbe268c71cfbb0de5132fdbe35978157f945abfe,1,2,2,0,0,0,0,2,2,2841,1,1,0,243,250,4,41,41,0,1401,1385,16,33,33,0,100
ef5f605f7f23df32f768c39a071acb50881a2fe7,0,0,0,0,0,0,0,0,0,0,0,0,0,0,251,5,0,0,0,0,0,0,0,0,0,100
4b230ebb534e768a2a3a02fa40483d703d912de4,3,92,10,82,1,0,1,4,46,753,2,2,1.106702148,855,252,3,218,214,4,6907,6483,424,40,38,2,99.99262428
bfa7d2c69629d764beefe61312343372376040d4,1,2,1,1,0,0,0,7,21,485,1,1,0,295,253,4,65,65,0,2187,2174,13,24,24,0,100
2980c1901e31114fcd53d204b0786cf1d6ea3494,3,4,10,6,0,0,0,6,22,29,2,3,1.413799565,458,254,4,76,76,0,2999,3017,18,31,31,0,100
60b97e307fa4b454082dc6a715638d9899133af0,3,61,15,46,0,0,0,6,85,765,2,2,1.183390916,2032,255,3,602,594,8,14119,13899,220,288,282,6,100
cd7851e9d34941787178b35c6f54149863536b8b,1,3,1,2,0,0,0,16,145,654,1,1,0,3934,256,4,1144,1144,0,24557,24540,17,304,304,0,100
c6fa108b3093fed8d60d8b02021aa0b69e8cae55,1,1,1,0,0,0,0,16,114,348,1,1,0,2459,257,5,794,793,1,16500,16492,8,231,231,0,100
0633d68005f7429e19645b963083fbbbd288fa90,0,0,0,0,0,0,0,0,0,0,0,0,0,0,14,0,0,0,0,0,0,0,0,0,0,100
160c71e068cd6976a89534b9acdf1b355801d42a,5,325,1,324,4,0,4,1,47,11,2,3,2.041634228,624,258,3,225,193,32,5792,4706,1086,53,24,29,99.96683006
d6367874aed9bd69a6acbe3fb6cb870eb9f4191e,0,0,0,0,0,0,0,0,0,0,0,0,0,0,259,4,0,0,0,0,0,0,0,0,0,100
404d9491f51589938efe41e7c7252414c5f15b58,0,0,0,0,0,0,0,0,0,0,0,0,0,0,260,5,0,0,0,0,0,0,0,0,0,100
af3df6bd117efa2384f81a79728a1906da766c78,6,21,7,14,0,0,0,4,176,1339,2,2,1.232087222,6254,0,0,1655,1655,0,45023,44942,81,462,462,0,100
0a91a39dd8fe11ce652da7657b15ef18c96d3500,0,0,0,0,0,0,0,0,0,0,0,0,0,0,1,1,0,0,0,0,0,0,0,0,0,100
e0d5b0505f2d0d91e08f6aa6806bbbff80bf59ca,3,18,34,16,0,0,0,15,87,583,3,3,0.550044266,3900,2,2,1103,1108,5,25238,25357,119,315,316,1,100
89b44bbf6c6a3f6554b5ac7338ae841c96e17de7,2,53,3,50,0,0,0,15,84,364,1,2,0.838372938,1791,13,0,545,534,11,12151,11939,212,201,199,2,100
7d897d94ce41035bd8b8d1dca47d6bebd4243e0b,1,0,3,3,0,0,0,15,94,783,1,1,0,3467,15,0,736,736,0,27724,27742,18,139,139,0,100
9fa9ef4fe825bf29c480303c169413ab997e5707,5,123,34,89,0,0,0,13,83,617,2,3,2.291613849,2571,16,1,685,669,16,18105,17553,552,206,202,4,95.68036972
2d5ab5c862737cf13c6a77bee4924dd959e8b941,6,257,1,256,3,0,3,1,177,147,2,2,1.878305026,7207,17,2,2227,2200,27,52513,51643,870,703,680,23,99.97361179
88cc847a1cd2d4fb4f91b88b4de5a91c4b39228e,1,2,4,2,0,0,0,15,88,19,1,1,0,2238,783,0,623,623,0,13670,13670,0,167,167,0,100
f17a08fee4571887c380e92af6fb8dd0b494560d,1,3,2,1,0,0,0,4,22,3371,1,1,0,138,784,1,32,32,0,1018,1006,12,18,18,0,100
56107fc73cd326de6493ce44bd940be04b8b99ac,2,13,13,0,0,0,0,4,28,1424,1,1,0.840358672,799,785,2,203,201,2,5662,5620,42,64,64,0,100
0a8d89da00391980018b6ce1acd80fde98f8ec78,4,100,85,15,0,0,0,11,68,650,2,2,1.182305771,1597,786,2,416,410,6,11205,11046,159,115,110,5,100
dc02973a1988c2b153bc4e63ca3530940b59c545,3,43,21,22,0,0,0,2,27,1502,1,2,1.086613328,534,787,3,165,164,1,4193,4115,78,78,77,1,100
bded0a42b6a490a6cc80bc69a221f7ba7cd1b877,2,68,1,67,1,0,1,1,108,210,2,2,0.517582753,903,18,0,230,225,5,6413,6102,311,55,53,2,99.97738921
56925f515ffb13f6b9d2f242afe5d37fae49508e,1,61,61,0,0,0,0,1,2,2,1,1,0,53,19,1,3,3,0,268,268,0,2,2,0,100
2e9e9e29739a3bde09a1a7acd9d3539c62c0c5f6,1,1,2,1,0,0,0,6,24,20,1,1,0,69,788,2,0,0,0,392,403,11,0,0,0,100
a2b07b18b43003f4c4cdd1872022a57c7e0fe26a,1,3,1,2,0,0,0,11,69,21,1,1,0,745,20,2,214,214,0,5158,5151,7,68,68,0,100
efef270907d3e503de5d883bffd4c797ebd90503,1,0,1,1,0,0,0,3,28,36,1,1,0,210,789,3,86,86,0,1920,1933,13,24,24,0,100
58f24badcc742831bafe728912ba9ffb9867324e,0,0,0,0,0,0,0,0,0,0,0,0,0,0,226,0,0,0,0,0,0,0,0,0,0,100
0ca38be72735a1b9340a519f46f9d969b6c4bf5d,2,30,15,15,0,0,0,4,24,1503,1,1,0.566509507,686,790,2,199,194,5,6108,6040,68,170,168,2,100
114ffd7d1182c919522f2a19cf6c794d78e95cec,0,0,0,0,0,0,0,0,0,0,0,0,0,0,227,1,0,0,0,0,0,0,0,0,0,100
5c3070f571e168416c8c46a31c63fc6a1744ed15,0,0,0,0,0,0,0,0,0,0,0,0,0,0,228,2,0,0,0,0,0,0,0,0,0,100
5b21125f5ee4b57cb8285e874e3c9724bd6e2c4c,1,4,8,4,0,0,0,7,21,2400,1,1,0,237,791,3,54,54,0,1495,1508,13,26,26,0,100
2c3ec958603dc366ce284ebd468856b1e2801d34,6,124,32,92,0,0,0,13,84,1581,3,5,1.554054474,1869,21,0,501,486,15,13326,12999,327,130,128,2,100
01cae73832fd7b86848fe017e990b96ca63e25af,1,20,15,5,0,0,0,11,82,725,1,1,0,1845,792,1,601,599,2,12262,12229,33,167,167,0,100
e63abd92a73968e7687c5928e0789177c8403fee,3,149,3,146,2,0,2,5,5,831,1,1,1.549015066,57,793,2,15,6,9,693,306,387,11,2,9,99.98116264
e12dcddc388e417102a4d0f6db39060a25c232e6,1,5,0,5,0,0,0,15,85,168,1,1,0,1589,3,0,485,484,1,11246,11227,19,144,143,1,100
52fb78cc243c506be08408b7c03958a1af70c6c8,0,0,0,0,0,0,0,0,0,0,0,0,0,0,151,0,0,0,0,0,0,0,0,0,0,100
150755864c02f5aead12c86f14bba717756b0ffd,1,4,0,4,0,0,0,12,28,378,1,1,0,237,229,0,56,55,1,1651,1634,17,20,19,1,100
35421424b5c30f2ffffcbd15e58db44017facaf4,0,0,0,0,0,0,0,0,0,0,0,0,0,0,230,1,0,0,0,0,0,0,0,0,0,100
c8dd4fc32d81f214cf436032b49e36ae4fefe699,0,0,0,0,0,0,0,0,0,0,0,0,0,0,231,2,0,0,0,0,0,0,0,0,0,100
2facc841546b58815bf31a35b02cf597d3844693,1,0,5,5,0,0,0,16,86,281,1,1,0,1425,152,0,413,415,2,10135,10189,54,122,122,0,100
4985e62f9b2cda1e6b9aa7a299aa40abdc2c21c1,0,0,0,0,0,0,0,0,0,0,0,0,0,0,232,2,0,0,0,0,0,0,0,0,0,100
cb309e75a80410eadbefcd2905d576271da27a87,0,0,0,0,0,0,0,0,0,0,0,0,0,0,233,3,0,0,0,0,0,0,0,0,0,100
c0413aad9ead9b1bb6d6983c3c8c168a4ccb6d56,0,0,0,0,0,0,0,0,0,0,0,0,0,0,234,4,0,0,0,0,0,0,0,0,0,100
7f71656cf4935d010138b3f44d5fff23bb3236c1,0,0,0,0,0,0,0,0,0,0,0,0,0,0,153,1,0,0,0,0,0,0,0,0,0,100
862b0f522994a1caf2a6ab75ef09287dd4697d29,0,0,0,0,0,0,0,0,0,0,0,0,0,0,235,5,0,0,0,0,0,0,0,0,0,100
aad999df894242b35ea7240af57421306449d70b,1,7,1,6,0,0,0,13,43,1094,1,1,0,765,154,2,157,155,2,4881,4849,32,87,87,0,100
cbc0301a7229d267adb5f6df0d12be86fd80b28f,0,0,0,0,0,0,0,0,0,0,0,0,0,0,236,6,0,0,0,0,0,0,0,0,0,100
3bdb0b95d8b728447cde2c23d53d673c49e7198b,2,59,9,50,0,0,0,9,39,702,2,2,0.522559375,1354,14,0,304,292,12,9739,9443,296,93,92,1,100
05b41094b86c4f297ee856d90159aeb73d4494bc,0,0,0,0,0,0,0,0,0,0,0,0,0,0,237,7,0,0,0,0,0,0,0,0,0,100
7ce7e556207f545a7bd688d4d8491a3021fa3aac,1,2,2,0,0,0,0,8,12,3393,1,1,0,335,794,0,122,121,1,2395,2390,5,34,34,0,100
4fbf3fc1f0a0431d29765d041e74756f319bc3fe,1,13,4,9,0,0,0,10,34,515,1,1,0,1280,795,1,476,473,3,10263,10175,88,60,60,0,100
fd5cc0436cfdf426304a07cf950609094b46d8f4,4,159,1,158,3,0,3,1,18,279,2,2,1.661694335,381,261,0,97,88,9,3663,3133,530,29,22,7,99.97363962
5632d5ab0abf661ba00e903ef740efc459c6a8fb,5,264,0,264,4,0,4,5,11,671,2,3,2.043710206,227,262,1,99,77,22,2316,1424,892,31,12,19,99.96612849
326fcd7a4c930f6f4da3102e3ed24ed770d74134,3,3,3,0,0,0,0,1,2,0,1,1,1.584962501,170,263,2,18,18,0,673,658,15,17,17,0,100
ecd1246c80d3105ccb39ad3682e180e6d646d61d,1,4,0,4,0,0,0,4,29,237,1,1,0,288,796,2,46,45,1,1935,1902,33,13,13,0,100
80d1fddb751360dd654f70df3918d0fad2c1fc89,1,17,15,2,0,0,0,15,86,125,1,1,0,1592,264,3,486,485,1,11263,11246,17,144,144,0,100
8c23eb3f48f4ad3a313d417aa67dae29a38bdea8,1,3,5,2,0,0,0,16,115,356,1,1,0,2459,265,4,794,794,0,16500,16500,0,231,231,0,100
1e2b753afa311ec49e3679ad103fddd3e4082705,1,21,15,6,0,0,0,10,18,1681,1,1,0,94,266,5,25,23,2,530,496,34,11,11,0,100
e0bb4cd7c7c7f5ac14780480123d22052fb993b1,1,15,21,6,0,0,0,10,19,5,1,1,0,99,267,4,23,25,2,496,530,34,11,11,0,100
9f0f92fc079f76ccfd4a48b99ebc56254980c1e6,7,11,417,406,0,0,0,1,48,366,2,3,2.577832299,1186,268,4,214,250,36,6483,7993,1510,38,69,31,99.95859837
0f4459fcb4fc9cbd25a486201ab0fa9a584b9163,1,9,13,4,0,0,0,4,30,41,1,1,0,292,797,1,45,46,1,1885,1935,50,13,13,0,100
e617abd0869f3e68fba7c7733d601c63b7d8c424,1,14,12,2,0,0,0,3,48,1347,1,1,0,500,798,2,149,148,1,3542,3506,36,63,62,1,100
70a201a55dcc88e380e682685f4855d579405091,1,9,0,9,0,0,0,3,29,212,1,1,0,209,799,3,89,86,3,2031,1920,111,24,24,0,100
47e402ce907adb6ddad899ab391fa94d534ea75d,1,73,32,41,0,0,0,16,116,39,1,1,0,2458,269,5,805,794,11,16616,16500,116,236,231,5,100
1febbf7b16670efca3978e5960ff3638b9a93313,1,15,7,8,0,0,0,16,146,396,1,1,0,3936,270,6,1146,1144,2,24603,24557,46,305,304,1,100
582cfc504aaa7680bc63bc5b88511cd6feb84eee,1,5,3,2,0,0,0,2,7,1086,1,1,0,79,271,7,14,14,0,452,448,4,4,4,0,100
3d5df48bbb99b364b49fb68631862140d5767174,1,16,2,14,0,0,0,16,147,2,1,1,0,3943,272,5,1147,1146,1,24623,24603,20,305,305,0,100
dd439b5ea91ef87713767b6c758926290f30a802,1,0,6,6,0,0,0,16,148,0,1,1,0,3951,273,6,1146,1147,1,24601,24623,22,305,305,0,100
085ea3eb07cf8f6b4758e0bc0f50b3e829b1364e,1,0,1,1,0,0,0,15,95,331,1,1,0,3464,274,7,736,736,0,27717,27724,7,139,139,0,100
e966f0f51c8c00bbaddbae9398e2952643e9af09,1,14,3,11,0,0,0,11,97,1503,1,1,0,1794,800,3,556,554,2,13699,13600,99,129,129,0,100
6adc2f465f179a90253e734221a5cec91ec33b2b,8,295,94,201,0,0,0,2,178,1314,2,3,2.142990949,8676,801,4,2502,2475,27,62395,61468,927,776,760,16,99.93591435
c9fa4b9bda45d0cb50274c8075a780b98b5951d4,2,50,4,46,1,0,1,1,37,647,2,2,0.556421567,696,275,6,266,264,2,5462,5283,179,39,37,2,99.99245226
82027f4a35bdb28c3bc2358f5e1bb220e65e8822,1,2,2,0,0,0,0,15,96,20,1,1,0,3463,155,0,736,736,0,27712,27717,5,139,139,0,100
5c1421cf09d4628064510e6b29c485a749b5f574,2,47,10,37,0,0,0,10,62,1364,1,1,0.962146133,3214,802,5,820,816,4,24322,24241,81,173,171,2,100
7f14c7df6b7c7ef42f0671138b9b5dd062fe99aa,3,33,3,30,0,0,0,5,80,1144,3,3,1.052940761,1198,191,0,291,282,9,8215,8021,194,113,112,1,95.81878889
3d11895269e89cc524b6bd8240326097806ebe93,8,228,27,201,2,0,2,1,149,963,4,7,2.350455433,6152,803,3,1713,1695,18,42267,41442,825,495,485,10,99.93513926
e61acd8571f652faa8f8085f7a1cc0073c680296,0,0,0,0,0,0,0,0,0,0,0,0,0,0,238,0,0,0,0,0,0,0,0,0,0,100
30c3a72a11c43878be3bab01b25e77b1e65e62de,0,0,0,0,0,0,0,0,0,0,0,0,0,0,239,1,0,0,0,0,0,0,0,0,0,100
2e996c9918ec5b18fcf05d0ef5faa1690a0369f9,0,0,0,0,0,0,0,0,0,0,0,0,0,0,156,0,0,0,0,0,0,0,0,0,0,100
e8a2932d4c497a8b8478f10063281b1cadc9f78b,1,1,1,0,0,0,0,11,28,1512,1,1,0,496,240,2,158,158,0,2923,2923,0,67,67,0,100
96751867c9dd063df97478c0ab759372dfd235d2,0,0,0,0,0,0,0,0,0,0,0,0,0,0,157,1,0,0,0,0,0,0,0,0,0,100
8b75df3c9bf992d5b93cb2c5f0e81470860eaa1f,1,6,3,3,0,0,0,17,117,86,1,1,0,2484,4,0,806,805,1,16632,16616,16,236,236,0,100
1a1ab83ff540b5e22e553d3a21e552d493b1414e,2,10,1,9,0,0,0,15,99,708,1,1,0.945660305,3863,804,0,1138,1136,2,25948,25856,92,260,260,0,100
34b223fa6760d4d8a92eac4aad7d790e83b8afc8,1,14,0,14,0,0,0,8,13,174,1,1,0,335,805,1,126,122,4,2507,2395,112,35,34,1,100
fa122cdfaeb398eb38117aa114bcfeb0e4802c16,2,18,3,15,0,0,0,12,58,1895,1,2,0.276195428,1580,806,2,445,438,7,12252,12121,131,148,148,0,100
a90e51691df0dcbe5ac71a300c8ec5d829df1770,7,494,0,494,7,0,7,1,1,0,1,2,2.757665069,0,807,3,44,0,44,1619,0,1619,29,0,29,99.93517636
1869a7b07ef17e5dfa39649c34b89cf7287ba36d,1,6,0,6,0,0,0,17,118,6,1,1,0,2488,808,4,807,806,1,16658,16632,26,237,236,1,100
5ce1ec400e2e3d47b999ebe1347b985bdff34cd2,1,4,3,1,0,0,0,17,150,60,1,1,0,3952,5,1,1148,1148,0,24627,24627,0,307,307,0,100
0d1b15220d3311c9a228613ac97e8a4395c5fc44,11,0,0,0,0,0,0,1,1,0,1,3,0,551,241,3,78,110,32,2164,2937,773,50,110,60,99.83232985
6d313db78837af526fdcf4cf3b2ab515db57a6e2,2,9,5,4,0,0,0,5,12,637,2,2,0.863120569,603,809,0,105,105,0,4165,4185,20,30,30,0,100
c6ee8caa41a31725a4ac80b01c7d7dfb5f1711fd,1,2,1,1,0,0,0,7,15,131,1,1,0,128,192,0,36,35,1,733,711,22,16,16,0,100
937aad666bcf696fdd5e47c281b09e527f721881,3,83,14,69,0,0,0,6,49,1554,2,3,1.120441877,1281,242,0,262,248,14,11358,10891,467,119,116,3,100
ede84e683eb0672a5c71cc760078c6124ce59d4d,3,297,0,297,2,0,2,1,3,854,1,2,0.740345198,233,810,0,105,73,32,3023,1578,1445,29,11,18,99.9809502
0834454bdbf9a72bd78c253f6cebaa5d53d70263,1,6,1,5,0,0,0,4,5,724,1,1,0,128,31,0,16,15,1,833,792,41,8,7,1,100
f30f7bcdb4e4d6c07fd29cc2a70032879cf424f6,0,0,0,0,0,0,0,0,0,0,0,0,0,0,32,1,0,0,0,0,0,0,0,0,0,100
2df7cd6950f68cc4a4df96bd0d10aec0082afc7f,2,5,9,4,0,0,0,6,13,98,2,2,0.863120569,604,243,0,105,105,0,4185,4165,20,30,30,0,100
c8016a49e0ada10a846aabfc6aa3ddc167957ede,2,18,4,14,0,0,0,2,2,160,1,2,0.684038436,139,22,0,21,17,4,769,681,88,9,9,0,100
5e9ecb0bbe6bf6dff60d73388b0a9added2e3544,1,1,0,1,0,0,0,5,31,297,1,1,0,287,244,1,45,45,0,1890,1885,5,13,13,0,100
123e28821e0f7a9850ae1d08b3934502b5030429,4,263,0,263,3,0,3,1,24,541,2,2,1.596219994,316,245,1,95,69,26,3053,2054,999,40,23,17,99.97334247
c7b4e05b1e98796917b2a67ca87f582a292d13c8,1,22,2,20,0,0,0,9,25,0,1,1,0,322,246,2,73,71,2,2179,2094,85,23,23,0,100
e406bda450a1f3b78836153a5a34882c823101b1,2,84,1,83,1,0,1,1,26,905,2,2,0.787126586,316,15,0,95,87,8,2712,2352,360,15,11,4,99.98477293
a30d93f5c8bad43b68efda656460582226ac7ea1,3,28,22,6,0,0,0,15,179,324,1,1,1.26713794,6286,247,0,1959,1958,1,45115,45093,22,641,640,1,100
8eb9ff9ce8d393acafee1ee470ab60cf3073756b,1,1,1,0,0,0,0,3,3,3159,1,1,0,174,248,1,23,23,0,991,989,2,8,8,0,100
8cb451d1dfefe4f4d67332cd055310cf29b0b3a8,2,7,7,0,0,0,0,2,17,4579,1,1,0.591672779,376,502,0,65,64,1,1708,1711,3,30,34,4,100
1b1b60c9a7d63268dc26c1ff5dc601a352cee1c9,24,553,21,532,1,0,1,4,44,1859,3,18,1.279683615,6454,16,1,1098,1010,88,45267,42193,3074,431,406,25,95.34004056
dc2c72f8e141ffeef8c0a2dab392c0f9406a91df,0,0,0,0,0,0,0,0,0,0,0,0,0,0,23,0,0,0,0,0,0,0,0,0,0,100
4cf336fd95eb8e2b2b58bd60e1e1eebf8c781d1b,23,119,52,67,0,0,0,13,97,1906,5,13,3.609806366,14043,276,0,3174,3174,0,107095,107088,7,867,867,0,100
e384913eae23fc70be4e07955faed0ea465ac268,1,4,2,2,0,0,0,19,180,28,1,1,0,3695,24,1,1111,1111,0,27255,27247,8,325,325,0,100
a8af3da0de6981eaea239897ef7f0281ea28b0af,0,0,0,0,0,0,0,0,0,0,0,0,0,0,277,1,0,0,0,0,0,0,0,0,0,100
0929f42f8302a6bb5c6344d4cda4a2e4e0bec930,0,0,0,0,0,0,0,0,0,0,0,0,0,0,278,2,0,0,0,0,0,0,0,0,0,100
503e48e8cde865f5c904170205bfda86d7461af6,1,4,0,4,0,0,0,2,5,2,1,1,0,116,279,3,18,18,0,752,752,0,8,8,0,100
92c4369aa18417e448ac980c0cd5de83a2b4831f,2,2,2,0,0,0,0,6,23,26,2,2,1,772,17,1,87,89,2,4920,4933,13,22,22,0,100
0019221544a0396d9879365a727b8d7da58b0622,0,0,0,0,0,0,0,0,0,0,0,0,0,0,280,4,0,0,0,0,0,0,0,0,0,100
5b3fea7cd446622d8479ca13e09b225161910bea,0,0,0,0,0,0,0,0,0,0,0,0,0,0,281,5,0,0,0,0,0,0,0,0,0,100
ca76712e3875051422c4d121bb5008f81cfd3f61,12,583,10,573,5,0,5,2,38,2749,3,4,2.461622647,557,193,0,174,112,62,4552,2384,2168,141,98,43,99.94007191
f63e7922434a27d7beacce10e6282230f320933b,1,5,1,4,0,0,0,19,181,32,1,1,0,3695,25,2,1111,1111,0,27260,27255,5,325,325,0,100
a0b872f5c2a2e5552f804d171dbdec66dd13de53,2,45,8,37,0,0,0,3,50,3126,2,2,0.859531691,932,18,1,274,271,3,6318,6086,232,98,96,2,99.972057
2ad745381c2c60217657d1115fd9cb0d9f3a54eb,1,5,0,5,0,0,0,2,2,500,1,1,0,40,249,0,4,3,1,247,210,37,2,2,0,100
d4b693e4e87270702857f2f0c0c8fe1d30c9ed4e,0,0,0,0,0,0,0,0,0,0,0,0,0,0,282,0,0,0,0,0,0,0,0,0,0,100
6952aec464f3ce026a70ee2ac6bc87192748b455,1,1,1,0,0,0,0,11,29,344,1,1,0,496,19,1,158,158,0,2923,2923,0,67,67,0,100
9acc4e2b7305f53ce3ab9046745e0e85a2d6fd4a,0,0,0,0,0,0,0,0,0,0,0,0,0,0,20,2,0,0,0,0,0,0,0,0,0,100
0aed173d4f46a542572f0954b926e165558dece1,2,98,0,98,1,0,1,1,29,969,1,2,0.442571065,301,26,0,67,64,3,2305,2096,209,22,21,1,99.96808808
2841d18dda10cd57ffbff878980d15cc869fed2c,1,1,1,0,0,0,0,5,27,425,1,1,0,511,811,0,118,118,0,3513,3513,0,48,48,0,100
1896a2850ca9721c5c00f76cfedceb7441df5651,1,6,5,1,0,0,0,4,26,4200,1,1,0,527,812,1,161,161,0,4948,4946,2,47,47,0,100
4397b003cbbe6a0eb84211df2169c9d3f2c5d2c6,0,0,0,0,0,0,0,0,0,0,0,0,0,0,503,0,0,0,0,0,0,0,0,0,0,100
ea05b25d4612d11aff28d0a6153782432371012a,0,0,0,0,0,0,0,0,0,0,0,0,0,0,504,1,0,0,0,0,0,0,0,0,0,100
ee6f4acc3ff9ac43ea4e98579b478e55767aef24,5,1494,8,1486,1,0,1,1,51,2277,3,3,0.451196557,1666,21,0,505,465,40,19780,9579,10201,208,185,23,99.97607846
7a9815a15f13a9ea818d086fa94842a3fa3b1f95,1,2,1,1,0,0,0,16,110,473,1,1,0,943,27,0,225,224,1,6462,6454,8,54,54,0,100
9f8a682a037f3f92ef6401f82418f3751fe6e4c8,9,253,4,249,1,0,1,9,83,1879,4,6,2.2001533,8520,194,0,2774,2741,33,58981,58008,973,761,748,13,99.98405422
a3fccb40e3f0e3708932f13e99fc52596eac592e,1,4,1,3,0,0,0,10,24,209,1,1,0,594,22,0,72,71,1,3986,3972,14,7,7,0,100
3b94663fe235c7254789519a3c7647a545037b98,2,38,7,31,0,0,0,4,54,3432,2,2,0.970950594,990,28,0,293,292,1,7386,7150,236,72,72,0,100
e719ad01e9504f71d4e3a2787a975a7aa29f39ee,2,43,78,35,0,0,0,5,9,1129,1,1,0.121480478,302,283,0,52,52,0,1737,1924,187,14,15,1,100
c3f73b7f7c504d2220c3ae8ceeafba1c458ffee8,1,6,0,6,0,0,0,2,2,130,1,1,0,113,284,1,17,16,1,648,620,28,4,4,0,100
c8e3d5dcbb664ae8f9c5a87392fc1e6204e55238,5,47,7,40,0,0,0,10,52,179,2,3,2.122270163,1966,23,0,555,548,7,11013,10884,129,254,250,4,100
70ccfae92fc5fb0704bf8c25d4dce93a08dd71e4,5,293,1,292,3,0,3,1,182,51,2,3,1.594541912,4619,24,1,1430,1398,32,35301,34073,1228,415,394,21,99.97210377
35c91eef22c711ca193954104be9ce3ba2065f39,4,186,3,183,3,0,3,1,183,0,2,2,1.879457877,3697,33,0,1127,1111,16,27882,27266,616,337,325,12,99.96813638
dc36e9ae8f2c98222f8a514a52e2b295c8ccafff,5,303,4,299,4,0,4,1,18,340,2,2,2.095087938,1308,25,2,394,369,25,9516,8487,1029,279,260,19,99.96019742
bb743b5f156b08aa750305b9e1a94369f90b1a0f,8,197,8,189,3,0,3,1,35,2238,2,3,2.318658241,1574,29,1,442,425,17,11299,10576,723,222,207,15,99.97215703
83dab92168a533f757bcce390661a09a595b94a2,9,362,5,357,8,0,8,1,10,436,2,2,3.002916837,53,30,2,33,8,25,1330,248,1082,28,6,22,99.91655408
67082453b32d1bc11309f3c45ae1ce1bb2f8e281,4,97,9,88,0,0,0,2,3,2766,1,1,0.503851212,283,34,1,49,32,17,1679,1274,405,16,13,3,100
a76249e143c9d2e73e566540fc3668c8ae8a4302,1,29,8,21,0,0,0,12,32,275,1,1,0,1010,35,2,288,285,3,7441,7379,62,66,65,1,100
1f383374815acfaa6a2878eb3e1e55790383aab1,3,35,16,19,0,0,0,2,38,2440,2,2,1.572969623,796,285,2,277,274,3,5812,5720,92,42,41,1,100
d8395bdc5642ebfb7c44dee46993b54a8146d796,1,0,2,2,0,0,0,12,39,0,1,1,0,695,286,3,265,265,0,5292,5299,7,37,37,0,100
70f1188d19e91f8a6269049d0c4dcadf9c2a9005,0,0,0,0,0,0,0,0,0,0,0,0,0,0,36,3,0,0,0,0,0,0,0,0,0,100
4551bbc69664833548429cd05beeca38d9f80e67,2,105,109,4,0,0,0,12,36,1091,2,2,0.076424293,577,37,4,146,148,2,3523,3585,62,47,48,1,100
fef5615e5326e76820d7bfa79de8fb2d6324acaa,1,1,1,0,0,0,0,3,4,0,1,1,0,111,38,5,15,15,0,584,584,0,3,3,0,100
c428609da75df0ca7bc5dfd7727ef6c4ebc99bb6,6,240,20,220,3,0,3,3,44,1464,2,3,2.135663117,1922,39,6,476,452,24,16007,14900,1107,317,310,7,99.6819212
9da79359463d72a0c68087ae0b3c77e6fe8124cc,1,55,59,4,0,0,0,1,2,0,1,1,0,95,40,7,7,8,1,651,660,9,4,5,1,100
a28818b7d55ab8eed5e2440c03c63eed4419761c,0,0,0,0,0,0,0,0,0,0,0,0,0,0,250,0,0,0,0,0,0,0,0,0,0,100
092e70e0ac381227bcf55974000a48203cecd980,3,54,12,42,0,0,0,6,60,2219,2,3,1.207437973,1556,41,8,179,175,4,15117,14855,262,119,117,2,100
310be135084266fc21515569f297ac714147d8b8,1,3,3,0,0,0,0,3,5,9,1,1,0,111,42,9,15,15,0,584,584,0,3,3,0,100
f4b2428008de297a7f993f48e1a6c98761c078f3,3,111,2,109,1,0,1,1,151,403,2,2,0.388593045,4534,43,10,1296,1286,10,28991,28618,373,366,356,10,99.99203885
08035c10ef469d5dd29fbb7aaec2a7435245eff7,130,2,251,249,0,0,0,2,184,2738,10,51,6.656578616,41724,44,11,9985,9985,0,273314,275556,2242,3834,3834,0,95.91869787
28cad3351c57ff519c4a50107e8b84d0e1e96753,2,11,10,1,0,0,0,18,120,1650,2,2,0.702466551,2663,31,0,847,845,2,17951,17930,21,250,250,0,100
74671312a5b287d67319ebe801a70e7b8f88c1a2,0,0,0,0,0,0,0,0,0,0,0,0,0,0,158,0,0,0,0,0,0,0,0,0,0,100
7c0c4a0a30bf9e4cfad3704c6d0a201e78c2530e,1,33,14,19,0,0,0,10,22,302,1,1,0,1465,287,0,411,408,3,10962,10847,115,122,119,3,100
d4425f579953b6208b95a371618b91f913beef71,1,2,2,0,0,0,0,10,23,1,1,1,0,1472,288,1,411,411,0,10962,10962,0,122,122,0,100
9ce4d50169cdb45788e3ce67c5118c4a86ff7776,4,196,6,190,3,0,3,1,98,113,2,3,1.697238405,3464,289,2,761,736,25,28438,27714,724,149,139,10,99.97116612
d0a311efe0e6a5318f5755db8c3bea460f6a3f00,1,1,1,0,0,0,0,15,99,0,1,1,0,3466,290,3,739,739,0,27767,27767,0,139,139,0,100
bf646350eac65b7ccd9e68031c8e5bc228f5a121,1,4,2,2,0,0,0,5,22,2406,1,1,0,152,291,0,40,40,0,999,986,13,17,17,0,100
4e8732d4ae068a7fc314445567d21c5a87ce9243,2,21,7,14,0,0,0,21,185,446,1,2,0.222284831,3997,26,0,1172,1169,3,29241,29170,71,352,352,0,100
bcf46e516c7aab1b7a1412340c09d01101b96fd3,1,1,1,0,0,0,0,17,111,483,1,1,0,944,27,1,226,225,1,6466,6462,4,54,54,0,100
0527c4570d0bdf444350fb12262b738ee6f61b2e,8,588,8,580,3,0,3,10,100,899,3,4,2.059594265,6775,292,0,1934,1810,124,53430,50890,2540,540,470,70,99.97118274
e21bcdfaa9be7b9d2592f5b5021c29bb8dd32955,1,4,1,3,0,0,0,15,117,1539,1,1,0,1472,293,1,387,387,0,9790,9788,2,230,230,0,100
731649a2c91d5bdfcc572c7e2c43e5ae6c3458dd,1,10,7,3,0,0,0,11,84,467,1,1,0,1857,294,2,603,603,0,12310,12293,17,169,169,0,100
d802d749304300e57447b8108b3a691297e87e6b,2,120,6,114,0,0,0,2,186,1044,2,2,1,3800,32,0,1131,1122,9,28403,27969,434,334,331,3,100
48eaa1aef123843f822c4210f24d3bc8ca332d91,1,1,1,0,0,0,0,9,22,3120,1,1,0,725,295,3,209,209,0,5369,5362,7,44,44,0,100
d5eec88a8a54dc25ca5a67da72beedabe7618820,2,4,3,1,0,0,0,12,48,194,1,1,0.863120569,1160,296,4,344,344,0,7934,7916,18,95,95,0,100
f01f7c47216056a1fbe13272b6aea282618da7ac,7,417,11,406,5,0,5,1,49,1036,2,3,2.577832299,855,297,2,250,214,36,7993,6483,1510,69,38,31,99.95474927
6d8a46e82540d035d4ba53a7760cc7edca2391af,8,108,362,254,0,0,0,3,37,1647,2,6,2.299147717,3318,298,3,615,652,37,23700,25287,1587,298,312,14,99.97943318
51e2b70be5d42530dbb97cae436f28968c7f1182,1,55,10,45,0,0,0,15,90,735,1,1,0,2439,299,0,838,824,14,17019,16767,252,313,310,3,100
fa027f605bffe4daff3aa3d8c18805539fe771ec,0,0,0,0,0,0,0,0,0,0,0,0,0,0,45,0,0,0,0,0,0,0,0,0,0,100
873daf3531ba9384b2500e26a3ac482b77cae38f,5,314,10,304,3,0,3,1,32,1185,2,3,1.75012326,712,33,0,158,137,21,6546,5479,1067,55,37,18,99.97120408
030ba2a41f99771c230aeec856701928a4768de9,2,30,6,24,0,0,0,2,40,1514,2,2,0.309543429,753,34,1,270,269,1,5680,5580,100,41,40,1,100
833031ba61e2d15611f23baa9294035aa95ac9f9,2,38,7,31,0,0,0,6,9,3903,2,2,0.970950594,212,35,2,24,18,6,1383,1210,173,9,7,2,97.32053358
c0b6d882853a8878a03914f9f9be6fe802f1a77c,1,2,2,0,0,0,0,4,7,533,1,1,0,113,159,0,16,16,0,646,646,0,7,7,0,100
b3d7fe8829df05bf836b207ca62856c6e6e8fa82,2,4,6,2,0,0,0,8,38,2018,1,1,0.970950594,1382,160,1,276,277,1,11470,11492,22,67,67,0,100
10089d6126c1022bf545dff62bbbb815696bb442,2,3,2,1,0,0,0,1,1,0,1,1,0.970950594,237,161,2,27,24,3,1879,1538,341,15,8,7,99.81847885
a90ffa27601af506a33feace87693ea5f41bd20f,1,9,0,9,0,0,0,3,3,2102,1,1,0,635,162,3,39,39,0,4472,4408,64,22,22,0,100
8aa54b6989e6a609e8a2426b56e40c6dcd809d93,1,1,1,0,0,0,0,1,2,2,1,1,0,107,163,4,12,12,0,769,769,0,4,4,0,100
b664f187d35a96ad99c9422293cdc65e4def399c,3,8,1,7,0,0,0,2,39,2638,2,2,1.584962501,1574,164,5,313,312,1,12729,12664,65,89,89,0,100
4f23e3fc95bf43ed598bdbd05988faa118ac35f2,1,1,1,0,0,0,0,11,30,776,1,1,0,496,28,0,158,158,0,2923,2923,0,67,67,0,100
3f33d76a34d24dee9cc16e68c1d12441ca5631c8,4,237,17,220,2,0,2,1,187,191,3,3,1.713358526,6239,36,0,1945,1930,15,44782,44142,640,574,565,9,99.98184129
d7dfa322d613e53ebd960541f60c2830d4d27260,1,4,3,1,0,0,0,15,101,254,1,1,0,3466,37,1,740,739,1,27766,27760,6,139,139,0,100
d6c469da60dd60331961284d03c013ebd3897490,0,0,0,0,0,0,0,0,0,0,0,0,0,0,165,0,0,0,0,0,0,0,0,0,0,100
80015bdbf9b953b7ec23afe63b816a7c7a81a8c7,1,1,0,1,0,0,0,1,3,126,1,1,0,107,166,1,12,12,0,778,769,9,4,4,0,100
b95e0d1c6c2e2cc8f6f9d422058dfe232f6091d5,6,476,3,473,5,0,5,5,32,471,2,2,2.031208826,301,300,0,108,76,32,4897,2714,2183,42,13,29,99.95644599
e48cd3e59d82ce352d161109987f283ecc369b66,6,324,271,53,0,0,0,1,39,109,2,2,1.727125981,896,301,1,181,172,9,5795,5394,401,105,101,4,99.98911584
da48a0ad537df1e824471fa80c77062f77030ce4,1,17,8,9,0,0,0,6,51,673,1,1,0,499,167,2,150,149,1,3589,3529,60,64,63,1,100
0a91a631b85b614790404896d190119d062f590f,3,438,70,368,0,0,0,5,85,1317,3,3,0.882853938,2242,302,2,715,695,20,17732,15144,2588,198,187,11,99.98548727
fc4e1e4f58b7a2a0ac0b77c04f33ff93b23d4854,0,0,0,0,0,0,0,0,0,0,0,0,0,0,303,0,0,0,0,0,0,0,0,0,0,100
3eaaa0c4b23e649d9962e46547536c51c3f37254,1,8,1,7,0,0,0,8,20,2565,1,1,0,180,251,0,45,44,1,901,872,29,28,28,0,100
86c478ac0750801355f256e94306d13bce9e0c65,5,298,2,296,4,0,4,10,53,195,2,2,2.106118038,304,304,0,106,74,32,3219,2028,1191,53,33,20,99.96735701
077ad2b4462cd2be819df5485d906632488d73be,12,390,2,388,6,0,6,11,49,1445,4,5,3.047489263,2992,38,0,796,772,24,20742,19576,1166,281,263,18,99.9528866
319bb37fe1725e998531c4e62cf9133dc42b8639,5,363,11,352,4,0,4,1,18,313,2,2,2.280063774,715,29,0,240,207,33,6422,4888,1534,131,105,26,99.96740902
32350302579c5c2fd2198ed56300c57e0c427e92,3,3,3,0,0,0,0,1,2,27,1,1,1.584962501,183,30,1,22,22,0,727,727,0,22,22,0,100
b6eee24112b01ccca340302d19825a524b63ac7d,3,101,2,99,2,0,2,1,4,350,2,2,1.198019053,150,39,0,46,40,6,873,646,227,32,26,6,99.92402041
7b1483052df4a7f7c784cd19d8e0d0365b3b42ac,0,0,0,0,0,0,0,0,0,0,0,0,0,0,31,1,0,0,0,0,0,0,0,0,0,100
a4b909ba64f7ac4a6018740abd948ebd611e3853,0,0,0,0,0,0,0,0,0,0,0,0,0,0,305,0,0,0,0,0,0,0,0,0,0,100
27260ba8eb50b2f415a8e2b79cff56aad1d3acd9,2,23,21,2,0,0,0,2,2,4,1,1,0.439496987,82,306,1,2,6,4,156,227,71,2,6,4,100
078da9d00fa3c27e64f61bcc1232de3ba6421584,1,14,13,1,0,0,0,2,3,0,1,1,0,41,307,2,2,2,0,68,112,44,2,2,0,100
08d94d75d68742fce002f65583844e5bb253b12e,3,138,13,125,2,0,2,1,87,591,2,2,1.38297239,1595,308,3,491,486,5,11588,11263,325,151,144,7,99.98553764
4540f822162023a2bed7d816cd8c0f66d3ab75c7,18,1387,5,1382,8,0,8,15,100,974,4,4,2.914915818,8233,32,0,2663,2515,148,59818,54109,5709,860,772,88,99.9349711
b659ac25783be780938623974195d03efb0137cd,2,58,0,58,1,0,1,1,36,976,2,2,0.423680572,479,40,0,164,160,4,3447,3242,205,43,41,2,99.99277978
7c0e7f2efda611890d8ce348be401a585627350c,0,0,0,0,0,0,0,0,0,0,0,0,0,0,33,0,0,0,0,0,0,0,0,0,0,100
b48106b0720d6ae199da5391aadcf3d4b40c5d13,2,14,7,7,0,0,0,11,66,2651,2,2,0.863120569,430,309,0,91,89,2,2700,2665,35,35,34,1,100
336f654551d70fcf6a38a9db966c2e324c2b8c9e,1,8,7,1,0,0,0,6,45,1323,1,1,0,1491,46,0,358,358,0,12133,12133,0,262,262,0,100
da75d5b27a20cfca26184e8c3525996f5974ec80,0,0,0,0,0,0,0,0,0,0,0,0,0,0,47,1,0,0,0,0,0,0,0,0,0,100
69f3a6e1c92d317ec35ce2740dc0407766eef599,1,19,19,0,0,0,0,15,46,1318,1,1,0,770,48,2,157,157,0,5160,4872,288,87,87,0,100
4ca9dbd7418f4193daceccf00131f0c67dedcfe5,3,240,1,239,2,0,2,1,19,434,2,2,0.911440312,173,41,0,69,38,31,2149,1284,865,23,13,10,99.97834482
c5e4fac8410be1dbd0a97f413c49c513def20036,5,502,31,471,2,0,2,1,188,912,1,2,1.481693087,5112,49,3,1417,1359,58,38478,36652,1826,413,383,30,99.98196053
8c6b968190c4cbe35896e2c817b47d509928d5ff,6,239,227,12,1,0,1,1,189,48,1,2,1.324288273,5284,50,2,1496,1507,11,37697,37770,73,441,447,6,99.99278603
9e54e9e79e340c0f844c8677509dc39492c44927,0,0,0,0,0,0,0,0,0,0,0,0,0,0,51,3,0,0,0,0,0,0,0,0,0,100
244e37b1894af680457b6edadafea4a0a0b6a4c4,2,14,4,10,0,0,0,21,190,0,1,1,0.650022422,3877,52,4,1148,1145,3,28252,28207,45,344,342,2,100
8129fe685bb7788ee5cb192be39d80b0f097f01c,2,275,277,2,0,0,0,2,122,1192,2,2,0.048708313,3515,42,1,837,835,2,26938,26745,193,257,256,1,100
6591d4d464967b47185a77b1fa88a89bd4fdc8e0,6,400,1,399,5,0,5,1,11,908,2,2,2.34913421,150,43,0,84,30,54,2690,1074,1616,32,10,22,99.95673805
09270f6fe482989a3e3942f2d4b9b5e779de71aa,1,7,2,5,0,0,0,8,27,3824,1,1,0,326,44,1,70,69,1,1933,1920,13,22,22,0,100
3b49efddcccf63248f5e2ddfaa7a3241c0c78a72,3,0,3,3,0,0,0,13,51,644,3,3,1.584962501,1331,53,0,369,369,0,9338,9367,29,101,101,0,100
d13ffa5eb3ed13448f442fa7cdc293fe56ad8ae2,2,69,21,48,0,0,0,2,14,2174,2,2,0.994292935,391,54,1,134,128,6,3013,2721,292,38,37,1,100
fcde8fd87e4748c2da77ccd153fc84196657d4a1,0,0,0,0,0,0,0,0,0,0,0,0,0,0,55,0,0,0,0,0,0,0,0,0,0,100
fa44d51b7d93d993c827cec337c527e9377ffacb,0,0,0,0,0,0,0,0,0,0,0,0,0,0,56,1,0,0,0,0,0,0,0,0,0,100
a6f6c987168c80620e2b5180d1b6cdc5b3ea641d,0,0,0,0,0,0,0,0,0,0,0,0,0,0,57,2,0,0,0,0,0,0,0,0,0,100
bdfcda04a26401cec0debf6dfc557ce91fc7b967,2,0,4,4,0,0,0,5,123,533,2,2,0.811278124,2789,58,3,894,894,0,18769,18815,46,250,250,0,99.98918958
cfc598ad5b17b70850c2f1a9a7bf0087fdbabfa2,0,0,0,0,0,0,0,0,0,0,0,0,0,0,59,4,0,0,0,0,0,0,0,0,0,100
9ddafe088f520a71144ab1091e2c91970c158c66,0,0,0,0,0,0,0,0,0,0,0,0,0,0,60,5,0,0,0,0,0,0,0,0,0,100
880d9c3089a6b5d411ed770026bc595b44cf0f90,0,0,0,0,0,0,0,0,0,0,0,0,0,0,61,6,0,0,0,0,0,0,0,0,0,100
f1a7522956e491c2af496b501f0f7d60dcfe0775,0,0,0,0,0,0,0,0,0,0,0,0,0,0,62,7,0,0,0,0,0,0,0,0,0,100
2991f211520319070947efece96b0186923b149d,0,0,0,0,0,0,0,0,0,0,0,0,0,0,63,8,0,0,0,0,0,0,0,0,0,100
f1ad383f4f216f1245aa87251f864abdcaa43656,75,1,187,186,0,0,0,2,191,3696,10,38,5.294683515,26184,64,9,6938,6938,0,176655,176655,0,2296,2296,0,100
85556cb9eadeeac522860eefa8269858d196f94a,262,3,281,278,0,0,0,10,118,4816,6,32,7.95601631,66422,65,10,17519,17519,0,430516,430516,0,6073,6073,0,100
ad6d7fea704123278de1fc318e40dc59898eafeb,1,19,11,8,0,0,0,6,11,0,1,1,0,169,66,11,36,36,0,1155,1091,64,7,7,0,100
a4ae8a61e123cb4a866f865d59b7903664d80c93,1,14,12,2,0,0,0,9,28,83,1,1,0,329,34,0,70,70,0,1939,1933,6,22,22,0,100
f6c5acd9b343e90ac42132077c63110b8224b1ea,1,20,0,20,0,0,0,2,2,483,1,1,0,408,45,0,46,44,2,2812,2663,149,14,14,0,100
9d4c78dfffb9a0dfd73298a9bf3a0dabe10d9153,1,9,0,9,0,0,0,1,2,485,1,1,0,42,46,1,3,2,1,241,169,72,2,2,0,100
7b1c24e1fa855114a28a7c065039798a5a0ef704,6,1069,1,1068,5,0,5,1,93,3,2,2,2.033603678,2479,47,2,976,838,138,21084,17019,4065,444,313,131,99.96037892
950ae7ab766ab8121fd808374929c43a107bd30d,3,3,11,8,0,0,0,3,11,7892,1,1,1.577406283,442,67,12,113,113,0,2452,2479,27,46,46,0,100
fbbfc9d3245089284129dcd719c289a877867169,26,23,71,48,0,0,0,5,153,2733,1,11,4.113953766,18195,68,13,4896,4896,0,125523,125523,0,1381,1381,0,100
bdaf1412986c76bf490cd508ec815a7c61f38791,1,9,32,23,0,0,0,2,3,9,1,1,0,426,48,3,45,46,1,2649,2812,163,15,14,1,100
acb0276bc675b49577a9bb80927ba0e2f6172b39,0,0,0,0,0,0,0,0,0,0,0,0,0,0,69,11,0,0,0,0,0,0,0,0,0,100
232581e52307bfa10fd0523df129864255c20af0,0,0,0,0,0,0,0,0,0,0,0,0,0,0,70,11,0,0,0,0,0,0,0,0,0,100
0221ff996de5b07e89c9081a964ddaf7922c20fc,0,0,0,0,0,0,0,0,0,0,0,0,0,0,71,12,0,0,0,0,0,0,0,0,0,100
0c0c8dd2bfe231681377ee099b151b3cade6f0a4,0,0,0,0,0,0,0,0,0,0,0,0,0,0,72,13,0,0,0,0,0,0,0,0,0,100
52350081377724d5145f059b4da9e5525470ba7a,0,0,0,0,0,0,0,0,0,0,0,0,0,0,73,14,0,0,0,0,0,0,0,0,0,100
419a8afa9a62ccf7b211c2a9f4c75d1409ac38f0,1,15,16,1,0,0,0,9,29,38,1,1,0,331,35,1,70,70,0,1945,1939,6,22,22,0,100
432e6be33306e1fe38ea12943035f9c2bb3d35e8,0,0,0,0,0,0,0,0,0,0,0,0,0,0,74,0,0,0,0,0,0,0,0,0,0,100
7dc47bc953782f9e486a14675a4a7c8762289be2,0,0,0,0,0,0,0,0,0,0,0,0,0,0,75,1,0,0,0,0,0,0,0,0,0,100
d38f10ad7f5559ae9f17ce066bfa9b0d3edef0cf,0,0,0,0,0,0,0,0,0,0,0,0,0,0,76,2,0,0,0,0,0,0,0,0,0,100
bf22072d43a7d3134e0514300b9166882d1f96dd,4,84,39,45,0,0,0,2,35,1757,2,3,0.255658295,1818,77,3,471,458,13,13070,12898,172,121,118,3,100
56ed8e430b155bf807d4a23f5469695f98597daa,0,0,0,0,0,0,0,0,0,0,0,0,0,0,78,4,0,0,0,0,0,0,0,0,0,100
4a23fc27c12c7102253e8f58e821bf385146cdfc,0,0,0,0,0,0,0,0,0,0,0,0,0,0,79,5,0,0,0,0,0,0,0,0,0,100
105ffd3c593918f0c1e826a969cf4ab76c9d8896,2,129,0,129,2,0,2,1,1,0,1,2,0.96323122,0,80,6,10,0,10,318,0,318,10,0,10,99.98560012
b62c0c6ce011e5c15e2bf787211faf59506866f0,0,0,0,0,0,0,0,0,0,0,0,0,0,0,81,0,0,0,0,0,0,0,0,0,0,100
e918d4d0e5287b02b3c64fdb2e4137f2db04826f,1,1,1,0,0,0,0,12,34,84,1,1,0,1058,82,1,301,301,0,7603,7603,0,69,69,0,100
0b26209a2f37eaa63183b56f6dd5d4966fea73bc,6,106,53,53,0,0,0,1,4,4173,4,4,1.934808298,761,83,2,47,47,0,5419,5227,192,30,30,0,99.98560219
87147689b9ef3ce02fa3f4771b75b0d689093304,2,4,2,2,0,0,0,3,4,387,1,1,1,624,84,3,74,74,0,3897,3881,16,24,24,0,100
214146527254dea02cad316a021c0160c91feb45,1,1,7,6,0,0,0,3,5,6610,1,1,0,71,85,4,5,5,0,325,318,7,4,4,0,100
49d8a929627e1ba9bff47a2a8dbd5337375acf24,0,0,0,0,0,0,0,0,0,0,0,0,0,0,86,5,0,0,0,0,0,0,0,0,0,100
b74fe352db407883754939d218d50eb0520a5b07,1,1,1,0,0,0,0,3,3,6789,1,1,0,65,87,6,12,12,0,276,276,0,8,8,0,100
d2cd2810816e151e34218840594aad55854fdc53,0,0,0,0,0,0,0,0,0,0,0,0,0,0,88,7,0,0,0,0,0,0,0,0,0,100
4b3cf478557c503c12a2dbe6a0da1629a159e000,7,1,57,56,0,0,0,3,15,4542,3,7,1.836501376,871,89,8,146,148,2,5091,5129,38,82,84,2,100
a0b12f85055ef62c46e239e51842025e018a7dc4,1,10,1,9,0,0,0,3,5,0,1,1,0,36,90,9,4,2,2,116,81,35,4,2,2,100
3f04e65ed942ce882ff4699d30ab690b9d811a00,0,0,0,0,0,0,0,0,0,0,0,0,0,0,91,10,0,0,0,0,0,0,0,0,0,100
e38098b03fd0a1c14ded54434aeced44b9fb07cd,0,0,0,0,0,0,0,0,0,0,0,0,0,0,92,11,0,0,0,0,0,0,0,0,0,100
692bc96d3c3d9b2d9ba97e44d7ada7c975abf05f,0,0,0,0,0,0,0,0,0,0,0,0,0,0,0,0,0,0,0,0,0,0,0,0,0,100
b88cbdee939d063cbf3b5894c8d8f85ff155a557,10,276,13,263,0,0,0,6,119,2486,3,4,2.690545914,3692,1,1,1043,993,50,28772,27402,1370,599,551,48,100
fac15cf557b5ab7a577d365413a11c3276ee2790,30,2209,30,2179,10,0,10,17,192,864,5,14,3.762165177,20708,2,2,6341,6027,314,152943,143223,9720,2038,1863,175,98.58128149
ea1682c42511894999e7f3c155adf8b4d8785c1c,41,180,2487,2307,1,0,1,2,191,1248,7,19,4.222147771,25647,93,12,6885,7244,359,167642,178155,10513,2216,2438,222,98.5742362
856fefb2c835fd0e46ce7c2a362720ac7f5b714d,1,16,9,7,0,0,0,12,68,228,1,1,0,1708,49,0,510,509,1,11047,11013,34,181,181,0,100
72be5f17209fbe92415a2ebed59d0d25d0a3b785,1,2,0,2,0,0,0,10,26,2203,1,1,0,340,0,0,73,73,0,2193,2179,14,23,23,0,100
a51d3c5c7b02af5ccb5606685d01f1785b3b79c7,2,0,547,547,0,0,0,4,7,1484,1,1,0.788039741,376,94,0,0,70,70,0,1959,1959,0,43,43,99.98560219
f6ba63def5596bfe9ef9e7fb3fe84e230afeb84d,1,12,10,2,0,0,0,14,50,3012,1,1,0,1201,95,1,431,430,1,8554,8549,5,84,84,0,100
82e145860457bc6d2870c03f974582737252636c,5,248,19,229,3,0,3,1,2,752,1,1,2.156585571,86,96,2,25,7,18,1036,294,742,22,7,15,98.66127358
3f040fbe1da7375a3bc1bf95acc52d6f1431918b,2,6,5,1,0,0,0,7,64,276,2,2,0.684038436,1968,97,3,505,505,0,16101,16072,29,97,97,0,100
931c6ed8448b7919378ed4d9564a8c9a15246b5c,1,3,5,2,0,0,0,2,2,6640,1,1,0,38,98,4,3,4,1,70,83,13,3,4,1,100
c4db9b05b8ef13a6053579b50ec7b82b27881674,2,50,4,46,1,0,1,1,2,48,1,1,0.605186577,74,99,5,4,1,3,565,481,84,4,1,3,99.98576462
41c05d1bbe5f3b5c5e103ff7ae63da1fbe1b8448,2,12,2,10,0,0,0,16,93,1891,2,2,0.591672779,2407,100,3,640,639,1,15062,14938,124,174,173,1,99.99644153
104fce25c2d9994b07987ecec93215176337ee38,2,21,2,19,0,0,0,21,192,445,1,2,0.258018669,3992,50,0,1171,1168,3,29199,29161,38,339,339,0,100
2353455a487fb0c1b8f91d5dbbef887c8ac5436d,1,60,34,26,0,0,0,18,69,2690,1,1,0,1129,101,0,294,289,5,8134,8051,83,61,60,1,100
e5fa4e32dfb41fe5c20ec2afe0b3397a4f81f870,3,152,0,152,2,0,2,1,40,461,2,2,1.191636739,534,51,1,151,140,11,3886,3287,599,81,72,9,99.98576816
977ba12bfafc3de8042e93e162985d003cd6a641,5,414,1,413,4,0,4,1,17,1173,2,2,2.080035001,304,0,0,147,84,63,4277,2598,1679,48,16,32,99.96443812
28da3eaccfb62847285dc270318dd2fc873afe6e,1,14,7,7,0,0,0,7,23,583,1,1,0,347,52,0,96,95,1,2179,2165,14,38,38,0,100
e98845758db72b188e9b73029266f45a8215e2de,2,94,3,91,0,0,0,5,20,4511,2,2,0.753715348,521,36,0,127,118,9,3429,2999,430,81,79,2,99.98578233
ffaa46ef9985194421000bc6a3133a2e8252d80d,0,0,0,0,0,0,0,0,0,0,0,0,0,0,37,1,0,0,0,0,0,0,0,0,0,100
1dd5571047bccbd75043e7d8c7048ed88b914e03,3,66,2,64,1,0,1,17,119,468,2,2,0.518787161,1616,1,0,419,408,11,10844,10589,255,247,242,5,99.98578586
19c6b4130d52da65e8facf02377f60170876dac3,1,4,5,1,0,0,0,1,2,0,1,1,0,55,2,1,12,11,1,231,225,6,5,5,0,100
715b9b086fba1d0214a4a820047240857aa27640,2,72,1,71,1,0,1,17,120,0,2,2,0.644694044,1468,3,2,393,387,6,10083,9808,275,234,230,4,99.99289419
3d393f57608f872a47235f3988d9290b8efa276e,0,0,0,0,0,0,0,0,0,0,0,0,0,0,102,0,0,0,0,0,0,0,0,0,0,100
8cc3992fb6fbfee6f70df207e36be79d2b86b648,1,1,0,1,0,0,0,1,3,22,1,1,0,54,4,3,12,12,0,231,231,0,5,5,0,100
03f9d1e9a52de083808fd88300691d6a213c25bd,0,0,0,0,0,0,0,0,0,0,0,0,0,0,5,1,0,0,0,0,0,0,0,0,0,100
9f39c60a0a68f13964cc597e844f5f7826efc83a,11,273,85,188,4,0,4,2,6,1773,1,5,3.134113272,521,103,0,93,69,24,3565,2538,1027,44,23,21,99.96803637
a5788cc859181ad55354083930e2c515a35df95a,3,335,0,335,1,0,1,1,12,953,1,2,0.926254167,290,6,0,104,52,52,2910,1801,1109,47,14,33,99.99289974
285e4688c34aecaf0fea2194dcb0f1be27a4daea,2,2,1,1,0,0,0,21,193,1843,1,2,0.918295834,5047,53,0,1602,1601,1,37805,37794,11,390,390,0,100
88e01d2fba1acd82e70100d001699fcb989d6ea8,1,0,1,1,0,0,0,7,13,47,1,1,0,182,104,0,37,37,0,1173,1191,18,7,7,0,100
0a95d37a28795fbec1b17e4eee124f0c0a0715f0,0,0,0,0,0,0,0,0,0,0,0,0,0,0,105,1,0,0,0,0,0,0,0,0,0,100
d7bcf2670e87532a2ef95354ac44906c2f34e8da,0,0,0,0,0,0,0,0,0,0,0,0,0,0,106,2,0,0,0,0,0,0,0,0,0,100
3396a59061321b5b192ce0a15d2ad637711a781f,0,0,0,0,0,0,0,0,0,0,0,0,0,0,107,3,0,0,0,0,0,0,0,0,0,100
7aed5ecf4806f1e810fe385dd68cf6d7d8b09153,0,0,0,0,0,0,0,0,0,0,0,0,0,0,1,0,0,0,0,0,0,0,0,0,0,100
27f9c5d395476c932d041e38588f59371f56c80e,0,0,0,0,0,0,0,0,0,0,0,0,0,0,108,4,0,0,0,0,0,0,0,0,0,100
c3d950747a191b5a208607055c273701e13bc4f8,0,0,0,0,0,0,0,0,0,0,0,0,0,0,109,5,0,0,0,0,0,0,0,0,0,100
55e8a82558d798c46dc497895423f7180ecc2375,0,0,0,0,0,0,0,0,0,0,0,0,0,0,110,6,0,0,0,0,0,0,0,0,0,100
a8edbf3d23ce9376e3f671685677bbc80ed453f7,0,0,0,0,0,0,0,0,0,0,0,0,0,0,111,7,0,0,0,0,0,0,0,0,0,100
07e28229519cead427ff2cd8b7e05a566c07f7f7,0,0,0,0,0,0,0,0,0,0,0,0,0,0,112,8,0,0,0,0,0,0,0,0,0,100
a453aa9f462cccb99f028426298e885c25b0cee2,3,76,1,75,0,0,0,12,102,2119,1,2,1.54660182,3628,113,0,891,883,8,25361,25128,233,398,395,3,100
bf2ffecbc0dbd53464b91dabaa69bfcb01cef4ce,0,0,0,0,0,0,0,0,0,0,0,0,0,0,114,1,0,0,0,0,0,0,0,0,0,100
e2bbcdc626439855f5a21d1a49f1b813ff86f869,0,0,0,0,0,0,0,0,0,0,0,0,0,0,115,2,0,0,0,0,0,0,0,0,0,100
edd848fc6e66f980afd04939b8345ec1af5b4a72,0,0,0,0,0,0,0,0,0,0,0,0,0,0,116,3,0,0,0,0,0,0,0,0,0,100
e46183191eab1b67cbf52a1c2b857b4e3046b3da,0,0,0,0,0,0,0,0,0,0,0,0,0,0,117,4,0,0,0,0,0,0,0,0,0,100
0d7567fb1cc4d6411c1046d42faa846cb2847dca,0,0,0,0,0,0,0,0,0,0,0,0,0,0,118,5,0,0,0,0,0,0,0,0,0,100
e52f8342be14f732ec700c517a7c237a264eb8f2,0,0,0,0,0,0,0,0,0,0,0,0,0,0,119,6,0,0,0,0,0,0,0,0,0,100
495683085553b0f87270386929e3a652741ac741,0,0,0,0,0,0,0,0,0,0,0,0,0,0,120,7,0,0,0,0,0,0,0,0,0,100
bd9cd89fd1c5f9a2416118c7c2cb81e57db3e3ca,0,0,0,0,0,0,0,0,0,0,0,0,0,0,121,8,0,0,0,0,0,0,0,0,0,100
13d9c55ae407a6e6489cf4b81d24532b5fd7761c,0,0,0,0,0,0,0,0,0,0,0,0,0,0,122,9,0,0,0,0,0,0,0,0,0,100
d2b4edf1877e20f6737120ab21dcb79bcd1c3d73,0,0,0,0,0,0,0,0,0,0,0,0,0,0,123,10,0,0,0,0,0,0,0,0,0,100
3e7ad6057d8264721f035261e5c793aeb931a2f0,0,0,0,0,0,0,0,0,0,0,0,0,0,0,124,11,0,0,0,0,0,0,0,0,0,100
459a2f084162c1879a96c7720f5638774064ec46,0,0,0,0,0,0,0,0,0,0,0,0,0,0,125,12,0,0,0,0,0,0,0,0,0,100
6955ddaea11e7c89199517ac0cceb5edc1eb368d,1,3,1,2,0,0,0,11,57,1080,1,1,0,538,54,0,158,158,0,4005,4004,1,32,32,0,100
0f55f9d133248141d820233218c4515c9a679d28,0,0,0,0,0,0,0,0,0,0,0,0,0,0,126,0,0,0,0,0,0,0,0,0,0,100
bde39c4bc9f2303f4da6963601728454450be10f,1,0,1,1,0,0,0,2,3,4791,1,1,0,94,127,1,8,8,0,506,513,7,4,4,0,100
5899205debfe796c56f10dd69d4f43c203c4399d,0,0,0,0,0,0,0,0,0,0,0,0,0,0,128,2,0,0,0,0,0,0,0,0,0,100
0ac7140b82a35e8066c4b5e4765ba341a82fb410,3,16,8,8,0,0,0,3,36,2140,2,3,0.816689088,944,0,0,196,195,1,6645,6607,38,64,63,1,100
a48b81a26b2a3ba472a6237decb2ae3751c493f4,0,0,0,0,0,0,0,0,0,0,0,0,0,0,1,1,0,0,0,0,0,0,0,0,0,100
5c2bab9cb1da779fcf681a3c7ec8ce0f106db960,0,0,0,0,0,0,0,0,0,0,0,0,0,0,129,3,0,0,0,0,0,0,0,0,0,100
41827d794dc0635a71f846ecb8a213bceca4f961,13,1125,6,1119,10,0,10,1,25,1256,2,3,2.745071563,884,55,0,371,259,112,10223,6092,4131,151,101,50,99.91841947
4afdb070427b8b3f2ac3f18c9629d9509727de20,5,306,0,306,4,0,4,1,7,919,2,2,2.052388379,382,56,0,117,103,14,3590,2513,1077,71,57,14,99.96811337
68fea1a51cb8a553127ce33f38ace2e3aaa70729,2,66,1,65,1,0,1,1,36,1687,2,2,0.48303068,628,57,1,135,132,3,4415,4258,157,52,50,2,99.99291684
41febbaab0830ffdc25110a5c05e414b76ad0abc,0,0,0,0,0,0,0,0,0,0,0,0,0,0,130,0,0,0,0,0,0,0,0,0,0,100
64e9f3868f0875dfef4b83b7c604d25d75691a09,38,2476,34,2442,10,0,10,6,195,1289,6,17,4.079138949,22581,131,1,6911,6547,364,169645,158553,11092,2359,2136,223,99.87624638
fa7f6e9f2eee7918b37913ff454d1c244a6986e8,0,0,0,0,0,0,0,0,0,0,0,0,0,0,132,2,0,0,0,0,0,0,0,0,0,100
9d2963fc0548f0fd638e1654bd03dd8adf6c4961,0,0,0,0,0,0,0,0,0,0,0,0,0,0,133,3,0,0,0,0,0,0,0,0,0,100
98b7a4f9eabe56b517f0274f2ccedd1dfabdbf3d,1,1,2,1,0,0,0,8,13,4660,1,1,0,804,134,4,110,111,1,5061,5064,3,21,22,1,100
cdfd6e274ebe2cbaa3e0d6bf10d35a207a8c63da,2,27,20,7,0,0,0,2,2,1324,1,2,0.25387844,281,135,5,28,27,1,1696,1622,74,19,19,0,100
3d4f6750388dfc3b40cd4a18dec1aaf3f5d15ee4,1,2,1,1,0,0,0,3,4,7949,1,1,0,134,136,6,28,28,0,638,629,9,20,20,0,100
4108566a7060e16a91d46e7c882f1d669ca9ffd9,0,0,0,0,0,0,0,0,0,0,0,0,0,0,137,7,0,0,0,0,0,0,0,0,0,100
91ab1f089ec15af84258b7dec258159e60074a55,0,0,0,0,0,0,0,0,0,0,0,0,0,0,2,0,0,0,0,0,0,0,0,0,0,100
f85e0347d6a4c92d502e1268c1c4a32bcb90458b,0,0,0,0,0,0,0,0,0,0,0,0,0,0,10,0,0,0,0,0,0,0,0,0,0,100
5faf53c036cf406fc804fa8949f4d8a919dfe813,1,19,5,14,0,0,0,6,32,3475,1,1,0,288,11,1,48,45,3,1941,1890,51,14,13,1,100
b2bf5d1149a95819ae26f8de7ef9bd120e0f240f,0,0,0,0,0,0,0,0,0,0,0,0,0,0,3,1,0,0,0,0,0,0,0,0,0,100
13cdb6fd47dd0f2a40260614535738b9e513c28e,9,12,8,4,0,0,0,2,5,7989,1,9,3.121928095,766,138,8,88,88,0,3046,3018,28,88,88,0,100
843398ede455d5ea3183f573c8d8a9801855af1e,1,1,1,0,0,0,0,1,2,29,1,1,0,46,58,1,2,2,0,135,135,0,2,2,0,100
4452e34d58762499a4b0f22536e642908b18c05e,0,0,0,0,0,0,0,0,0,0,0,0,0,0,139,9,0,0,0,0,0,0,0,0,0,100
4ce78c4e7f6611fd580bffdd06c96208c30298e7,1,1,64,63,0,0,0,3,6,1537,1,1,0,126,140,10,17,24,7,633,992,359,3,9,6,100
0859873510374330899a8a8b20ff51094b620821,3,8,179,171,0,0,0,3,45,1550,2,2,1.095795255,1200,141,11,224,243,19,7267,8080,813,67,72,5,99.93991022
305758fc96e8ee05b632e3b7a4341b7dba36f16d,126,148,157,9,0,0,0,2,196,2790,6,30,6.764432704,72570,142,11,20103,20103,0,504992,505105,113,6218,6218,0,100
e647db2ee08624360856174792d53c4dc1c5a777,12,195,26,169,2,0,2,1,72,371,3,10,2.161301034,5101,143,10,1473,1454,19,35962,35130,832,448,442,6,96.41682331
0096a0ebd3999a0fea9432f94366d09d33ba387f,0,0,0,0,0,0,0,0,0,0,0,0,0,0,144,10,0,0,0,0,0,0,0,0,0,100
66ad16fd850de2af3be24e9b6faa6d1f64e84a01,24,234,76,158,2,0,2,4,197,1672,3,13,3.488881517,14643,145,11,4227,4207,20,106491,105522,969,1275,1269,6,99.97809036
58baa13eb24edd4651826f3eb49de6bdfbd3fc54,0,0,0,0,0,0,0,0,0,0,0,0,0,0,146,8,0,0,0,0,0,0,0,0,0,100
685546818753033398ac0ea900fc136a8330e0fc,0,0,0,0,0,0,0,0,0,0,0,0,0,0,147,9,0,0,0,0,0,0,0,0,0,100
da6ea0f708fc5a58b1e38942d9fcf84ee3f5913b,9,53,13,40,0,0,0,1,112,1622,3,8,2.673755429,3547,148,10,871,867,4,26539,26368,171,239,237,2,100
297190a43ab3a003b437da85877be0fc5c3cf60d,23,171,52,119,0,0,0,10,88,1390,5,12,3.419795673,13419,149,11,4153,4135,18,94245,93314,931,1187,1182,5,96.32318401
209adb6fc899622b0a200718341a3869454a4fde,19,85,51,34,0,0,0,10,104,80,5,10,3.321593602,16921,150,12,4727,4717,10,126586,126385,201,1211,1207,4,96.29332109
c4323ac56367020cab9d70c2cd44eb8f0bf1e822,5,18,7,11,0,0,0,16,104,4,3,4,1.483990458,2714,151,13,911,909,2,20616,20527,89,146,145,1,100
10110aadf0cea99315f82bae8c77c7417fe025e5,6,189,20,169,0,0,0,17,125,256,3,5,1.459129877,4608,152,14,1484,1441,43,35047,33497,1550,412,409,3,99.98585523
f979ae1cfefb7390d022a911d9a9ac6c4814af37,18,49,50,1,0,0,0,3,75,0,3,10,4.054086828,7087,153,15,2204,2204,0,47366,47431,65,704,704,0,100
f0286a268e1d3d1b97c361fe2bad743b8064094a,109,829,503,326,0,0,0,2,198,43,6,29,5.537748135,67224,154,16,18498,18443,55,472216,470744,1472,5720,5702,18,97.2590293
9cacf08c7a33302ff2729299f1a84c988db31c80,22,11,26,15,0,0,0,10,156,655,5,11,4.324186136,15726,155,16,4701,4701,0,106099,106284,185,1328,1328,0,99.87753103
02330ad212bb9b739901a68b42a4c440ea7a1b13,5,67,67,0,0,0,0,3,113,4106,4,5,0.4456618,1852,156,17,366,366,0,11472,11535,63,159,159,0,100
8d208ebdbe44e3c04f8aad17bbdc83a6acf40b91,1,4,2,2,0,0,0,7,13,1592,1,1,0,81,157,10,19,18,1,477,466,11,5,5,0,100
5cf5442d199c97fa6a4f57aef545777f3aa37bc0,0,0,0,0,0,0,0,0,0,0,0,0,0,0,158,6,0,0,0,0,0,0,0,0,0,100
19a59684f05c41d79f75714193b5e65bd698f1b7,0,0,0,0,0,0,0,0,0,0,0,0,0,0,159,5,0,0,0,0,0,0,0,0,0,100
e0c03c5fc9bfb988d40b47e5477e30f83307fc2b,1,24,13,11,0,0,0,11,59,83,1,1,0,333,160,0,82,80,2,2304,2261,43,38,38,0,100
88a998eced2d4dc9356795fe62c245aaf1e0c1aa,0,0,0,0,0,0,0,0,0,0,0,0,0,0,161,1,0,0,0,0,0,0,0,0,0,100
fe7659fb0112e0e40e1fef9256297df893430361,0,0,0,0,0,0,0,0,0,0,0,0,0,0,4,0,0,0,0,0,0,0,0,0,0,100
a99daf8f47ed77072d506ede1730b4a16a9c93e6,0,0,0,0,0,0,0,0,0,0,0,0,0,0,5,1,0,0,0,0,0,0,0,0,0,100
be71987b9c7f14af11718351a883582843eaa4ae,1,8,3,5,0,0,0,13,75,101,1,1,0,748,38,0,214,214,0,5180,5160,20,68,68,0,100
6b8d4b9bcdc8b6b4fcbcf6c2adcea2924322fcda,0,0,0,0,0,0,0,0,0,0,0,0,0,0,162,0,0,0,0,0,0,0,0,0,0,100
3d905e17a7015b2342036af8bd378a0102b848f5,0,0,0,0,0,0,0,0,0,0,0,0,0,0,163,1,0,0,0,0,0,0,0,0,0,100
701a4e7d2715b844f3b522400eee2024b1aac049,1,4,0,4,0,0,0,6,52,2635,1,1,0,508,164,2,151,150,1,3600,3589,11,64,64,0,100
4068d5ccb29f65d9a09daebcd232b7c8c1a2ed5a,1,2,4,2,0,0,0,7,13,3309,1,1,0,249,165,3,53,53,0,1641,1640,1,10,10,0,100
bdc1da942339f4df4334270cc1e2bba6b29f14d5,26,83,59,24,0,0,0,6,199,2417,5,11,4.344871962,17288,166,4,4101,4101,0,117932,117587,345,1286,1286,0,100
af8ea38f87a778401ca1c679f7087d3a0d5a52cc,8,771,14,757,3,0,3,1,105,245,3,5,2.452283885,3742,12,0,910,814,96,29151,25090,4061,437,398,39,99.72518458
635dd436cf12d83d40f73fa2b9ac77780e085de8,1,45,18,27,0,0,0,12,45,293,1,1,0,790,6,0,232,229,3,6594,6411,183,30,30,0,100
8567a5e5c20b8e987b3612ef75c6011e51221d83,1,7,3,4,0,0,0,18,71,342,1,1,0,1146,167,0,295,294,1,8182,8159,23,61,61,0,100
49c1478cf3f107d9f7069bf2102d8cf0b6ca2b12,1,10,2,8,0,0,0,19,72,36,1,1,0,1149,0,0,297,295,2,8200,8182,18,61,61,0,100
8f1f9a1af7fe0560750fb09fe501c6b194106ba8,2,53,0,53,0,0,0,9,37,6693,1,1,0.968700344,1163,7,0,148,143,5,9572,9148,424,93,88,5,100
e2a8d2c9661ef9ebe3731a7ca0852c8f8e6f203a,1,6,5,1,0,0,0,13,100,1331,1,1,0,1819,8,0,560,560,0,13822,13806,16,129,129,0,100
ed28ddca1a1ff1026cc068a0a85540eb756f655e,1,5,6,1,0,0,0,13,101,0,1,1,0,1820,9,1,560,560,0,13806,13822,16,129,129,0,100
5c94a7ff67ad38f6fdcaa7a950eeb9622ff960aa,2,21,2,19,0,0,0,2,26,1174,2,2,0.426228657,1123,39,0,245,243,2,7158,7079,79,108,107,1,100
2898b4e342591dc98848663caa74a9bb7fee35b4,1,1,1,0,0,0,0,6,53,789,1,1,0,511,168,0,151,151,0,3603,3600,3,64,64,0,100
778e8e9449210bda0f3fad71081ae3dc954e8a64,1,22,1,21,0,0,0,13,24,899,1,1,0,249,10,0,68,64,4,1868,1729,139,17,16,1,100
b4c13fc0ed80fbfe59df1ce960454c21a0504b56,0,0,0,0,0,0,0,0,0,0,0,0,0,0,11,0,0,0,0,0,0,0,0,0,0,100
14d4b8007cddcbd6197404f7ad435b9b514b2859,1,8,2,6,0,0,0,18,157,1445,1,1,0,3953,12,0,1149,1149,0,24631,24627,4,307,307,0,100
5700102036bd9dabf4508b3186eaa69db485fe7e,1,5,5,0,0,0,0,6,9,2325,1,1,0,185,13,0,34,34,0,1073,1073,0,11,11,0,100
e1bf367e484e23cc3b76ec6c9136475e42659f38,0,0,0,0,0,0,0,0,0,0,0,0,0,0,14,1,0,0,0,0,0,0,0,0,0,100
97d59a9fc877af1e483a985bfacd284ab919e9a2,0,0,0,0,0,0,0,0,0,0,0,0,0,0,169,0,0,0,0,0,0,0,0,0,0,100
7be184d4512062cd342ade08ebdfe3e6698d0937,1,1,2,1,0,0,0,4,7,6547,1,1,0,50,170,0,2,2,0,149,149,0,2,2,0,100
4d577c0fd27d1fb0e37fdb44a7f355c010768a20,0,0,0,0,0,0,0,0,0,0,0,0,0,0,171,1,0,0,0,0,0,0,0,0,0,100
8be86a6903dcf5d6486bf5578486fdd1fd28fc4a,4,145,53,92,0,0,0,16,97,4451,4,4,1.226091003,1366,0,0,334,322,12,8929,8420,509,153,150,3,100
018ba13ad807d295dd37753f425eabf1e4bbdbbf,0,0,0,0,0,0,0,0,0,0,0,0,0,0,172,0,0,0,0,0,0,0,0,0,0,100
93f0193749973c83bcbf2118c34b850e87e1d8a9,0,0,0,0,0,0,0,0,0,0,0,0,0,0,173,1,0,0,0,0,0,0,0,0,0,100
0ea12478214daee47afd038ec528598dcf12e3fe,0,0,0,0,0,0,0,0,0,0,0,0,0,0,174,2,0,0,0,0,0,0,0,0,0,100
627fb6e74caecd8bbf8e35d928bce0117e39d409,0,0,0,0,0,0,0,0,0,0,0,0,0,0,175,3,0,0,0,0,0,0,0,0,0,100
101ee9946aee77894a5111564eaac33a2fb3981c,0,0,0,0,0,0,0,0,0,0,0,0,0,0,176,4,0,0,0,0,0,0,0,0,0,100
ffe3fe4a5051632d15973a0084767612ab22ad17,0,0,0,0,0,0,0,0,0,0,0,0,0,0,177,5,0,0,0,0,0,0,0,0,0,100
74c5980a943f5dda9c13a8ebdd9ad7a78f6ffcaa,0,0,0,0,0,0,0,0,0,0,0,0,0,0,178,0,0,0,0,0,0,0,0,0,0,100
66a0a1499c03ad95019137b63ef6b48e95845e16,0,0,0,0,0,0,0,0,0,0,0,0,0,0,15,0,0,0,0,0,0,0,0,0,0,100
e368468da2fd02b89fd1d900e9faf62df8794a17,0,0,0,0,0,0,0,0,0,0,0,0,0,0,16,1,0,0,0,0,0,0,0,0,0,100
3a0875f39335ceafcf979c89ea207b5654b781f5,0,0,0,0,0,0,0,0,0,0,0,0,0,0,17,2,0,0,0,0,0,0,0,0,0,100
e5f3551a8128f6192176d6f8eee2e909800a7aeb,0,0,0,0,0,0,0,0,0,0,0,0,0,0,18,3,0,0,0,0,0,0,0,0,0,100
0303fb28f85d185e8029353918a96ea100173d7c,3,71,15,56,0,0,0,14,39,3535,1,3,1.208667119,2027,19,4,531,523,8,14539,14368,171,149,144,5,100
4477ace6fde890ffb41fd10c548de2ebbe6f423c,3,78,9,69,1,0,1,1,40,2041,2,2,1.067164889,1679,1,0,601,596,5,13339,13124,215,114,109,5,99.9835506
c79c09ac39b1284d0edadc084dd655c4b66e6818,1,15,23,8,0,0,0,19,115,1923,1,1,0,945,2,0,226,226,0,6496,6487,9,54,54,0,100
ae4b7425274ee82ba40e000bbafcc02a2e1a2eea,1,2,2,0,0,0,0,6,16,275,1,1,0,423,3,1,90,90,0,2319,2319,0,52,52,0,100
18b101228f31adf0d22c6ef1b49df08227c6b157,0,0,0,0,0,0,0,0,0,0,0,0,0,0,13,0,0,0,0,0,0,0,0,0,0,100
8107dfbfa080dafb2dc0fcb06c5096d237334b0f,1,1,1,0,0,0,0,13,32,3680,1,1,0,496,20,0,158,158,0,2923,2923,0,67,67,0,100
6c4c77aa7817b8e98c805ada47c5b11fe7f63172,1,99,69,30,0,0,0,7,19,2189,1,1,0,656,21,0,136,138,2,3977,3830,147,44,46,2,100
9a98d6a2bf8203a1cead34d18f705e380c829cd6,4,258,49,209,2,0,2,1,43,1088,2,2,1.974845342,739,22,1,189,154,35,6168,5305,863,63,47,16,99.92602334
f399f912cf34a1f2a7963472ad19119bdc453071,3,9,9,0,0,0,0,5,47,3691,2,3,1.351644115,1100,23,0,245,245,0,7211,7211,0,69,69,0,100
4709f38ba23244ad1c876ccf16704ccfdb099b73,41,163,253,90,0,0,0,4,158,5667,4,15,4.413028975,19541,0,0,5443,5463,20,123467,123646,179,2014,2018,4,99.98767613
f2fc98031e5191ab6bffec9c028d49c5332bb716,4200,32401,32403,2,0,0,0,2,200,6327,12,319,10.61213018,492901,1,1,86784,86784,0,2864229,2864242,13,42804,42804,0,100
e25438a174d7c338b1392cbbded98270c0be853f,3476,29036,10094,18942,0,0,0,2,201,614,12,296,10.49617314,453948,2,2,82379,82404,25,2763803,2715825,47978,39318,39318,0,95.95047342
02eaa9363ad135eeb670079bee06ec02b87aa2c5,0,0,0,0,0,0,0,0,0,0,0,0,0,0,179,0,0,0,0,0,0,0,0,0,0,100
12ec80cd8cc034fa00fa3509a2d75959ef4b582b,10,125,30,95,0,0,0,3,11,1054,1,5,2.883992798,1757,180,1,233,234,1,12993,12754,239,181,182,1,100
08bb3a5a0e7573622aa6dc25763cb6513095093b,36,256,1186,930,0,0,0,5,18,7,2,10,2.903198687,4063,181,2,413,609,196,21692,26237,4545,242,348,106,99.96402172
3fa4380b478c9d7ae705720c7c70aed89e5e2aab,2,83,65,18,0,0,0,7,13,36,1,1,0.534004273,462,182,3,37,37,0,3125,3083,42,21,21,0,100
1413c369be2b88cdaf4d5631ccc9e6d5d07c7a15,0,0,0,0,0,0,0,0,0,0,0,0,0,0,183,4,0,0,0,0,0,0,0,0,0,100
9a5096308c29e278cd59253922110bdf3464951f,5,20,16,4,0,0,0,5,12,40,2,2,2.023777618,1084,3,0,192,192,0,6293,6308,15,128,128,0,100
b3edd42ee81194c419a395f0f6ea22d48be66105,0,0,0,0,0,0,0,0,0,0,0,0,0,0,4,1,0,0,0,0,0,0,0,0,0,100
73582cc780d3c72af7a227890dde5180028edfd0,6,158,25,133,0,0,0,3,8,54,1,4,1.391015171,1464,184,5,249,233,16,7724,7308,416,229,213,16,100
3bd73ab7d805b5f591fc170d0710dac0e3e38fac,0,0,0,0,0,0,0,0,0,0,0,0,0,0,185,6,0,0,0,0,0,0,0,0,0,100
9d4b2ece3b7de62054d33f7c202392f6f239ed57,0,0,0,0,0,0,0,0,0,0,0,0,0,0,186,7,0,0,0,0,0,0,0,0,0,100
5c38bfaa49a2f9485a690e147f07399047f7d2d2,0,0,0,0,0,0,0,0,0,0,0,0,0,0,187,6,0,0,0,0,0,0,0,0,0,100
7ece63de3c379556f0b1559733dde9b9da64a1f9,0,0,0,0,0,0,0,0,0,0,0,0,0,0,188,7,0,0,0,0,0,0,0,0,0,100
165279436c3a0c1322057a994e4d835136c0963b,0,0,0,0,0,0,0,0,0,0,0,0,0,0,189,5,0,0,0,0,0,0,0,0,0,100
9461ffdfcd870b1aeadf1eab3e8181c983a595b4,5,73,20,53,0,0,0,8,202,85,2,3,1.60611329,6379,190,6,1747,1743,4,47347,47240,107,438,438,0,100
3b4c2e6f427de1f6f1e21a9c5a0cca4e5730167e,4,82,2,80,0,0,0,4,46,63,2,4,1.202296629,933,191,7,221,212,9,6128,5803,325,101,92,9,100
0530b5b72ba00a3014e67c9ee4c3e8bfcddabb76,3,127,29,98,0,0,0,4,203,1,2,3,1.083133857,4250,192,8,1236,1224,12,30771,30205,566,393,386,7,99.99345892
4bb1caa36dc753057790cb735f7e67ff24b4cef6,1,2,2,0,0,0,0,2,2,179,1,1,0,72,193,9,13,13,0,415,415,0,6,6,0,100
f7a4445e681cc7c30ed855283660aae38792215b,0,0,0,0,0,0,0,0,0,0,0,0,0,0,194,10,0,0,0,0,0,0,0,0,0,100
34c99b342a0d3b823b1c777d16b2dbba57350d5e,15,72,53,19,0,0,0,5,9,90,1,2,1.810325385,1300,195,11,175,175,0,5765,5639,126,150,150,0,100
ba7b8493ca8dfe364a52b45939f43ec02c347b96,2,5,3,2,0,0,0,5,7,92,1,1,0.954434003,501,196,12,62,62,0,3326,3255,71,40,40,0,100
eaecedf328038ea646c7b55063f71b40218f3a65,4,12,3,9,0,0,0,4,10,69,1,3,1.932914564,1023,197,13,133,133,0,7216,7132,84,75,75,0,100
c42aff8ffffd54b3b6dc267b1afdf6929c8c321d,0,0,0,0,0,0,0,0,0,0,0,0,0,0,198,14,0,0,0,0,0,0,0,0,0,100
8d41f3da9ccf27f90c372f91afce3630824426c9,1,7,2,5,0,0,0,4,7,110,1,1,0,277,199,12,33,31,2,1890,1859,31,11,11,0,100
7bc09297f88bee8e07851a09a9181b13503b97f4,1,2,5,3,0,0,0,8,23,114,1,1,0,359,200,13,46,47,1,3228,3230,2,5,5,0,100
60ccac0e2201b023fa6194523ab733ea12ee1172,1,22,2,20,0,0,0,3,3,114,1,1,0,264,201,14,33,31,2,1960,1866,94,19,19,0,100
db6f6b642203d60ae1fa7576715e180c6bbe6081,1,4,1,3,0,0,0,17,50,115,1,1,0,770,202,15,165,165,0,5177,5177,0,46,46,0,100
39bde81aa2fe6f5ac8348bf4a6a39669b67dbe7d,1,5,5,0,0,0,0,7,12,115,1,1,0,186,203,16,34,34,0,1081,1081,0,11,11,0,100
7f4997b68a71dbc746e8cc3beebb2dc8854910bf,0,0,0,0,0,0,0,0,0,0,0,0,0,0,204,17,0,0,0,0,0,0,0,0,0,100
d874cbf6d3c2c518accd592929a815fd4162b7bf,7,91,413,322,0,0,0,4,52,141,3,4,1.701794809,2370,5,0,368,424,56,13149,14340,1191,152,166,14,99.97710623
9eb7e2b14521ba8aa40153c4d02f0a40def92b51,0,0,0,0,0,0,0,0,0,0,0,0,0,0,205,10,0,0,0,0,0,0,0,0,0,100
6fe8f101dfe4a3a7f7fc902ae49a16817beaf3cc,0,0,0,0,0,0,0,0,0,0,0,0,0,0,6,0,0,0,0,0,0,0,0,0,0,100
1e76dd4159382ca0b1ddc2434a393c65ce76d520,0,0,0,0,0,0,0,0,0,0,0,0,0,0,7,1,0,0,0,0,0,0,0,0,0,100
6947da342f2346396ac6cf05aba89dce86293407,0,0,0,0,0,0,0,0,0,0,0,0,0,0,8,2,0,0,0,0,0,0,0,0,0,100
5a502cce2482fd1b0fd003d3a2927d08d2924dcb,0,0,0,0,0,0,0,0,0,0,0,0,0,0,24,0,0,0,0,0,0,0,0,0,0,100
73f3957240df78076fd23f3ed476890f186cedf4,0,0,0,0,0,0,0,0,0,0,0,0,0,0,25,1,0,0,0,0,0,0,0,0,0,100
7dde390be999d065b61abe45b03ec97dbc77ba3d,0,0,0,0,0,0,0,0,0,0,0,0,0,0,9,3,0,0,0,0,0,0,0,0,0,100
9cdd90d041b1c699df0b2abb6a81358e395dfd4e,0,0,0,0,0,0,0,0,0,0,0,0,0,0,206,0,0,0,0,0,0,0,0,0,0,100
260042ba5184f1f415f2f0975e3449f13611b84a,24,91,97,6,0,0,0,4,13,240,1,6,4.281852777,5556,207,1,728,728,0,37889,37961,72,404,404,0,100
fe2709aab7298fa8db8a1cbbf21f78499ba06b1e,0,0,0,0,0,0,0,0,0,0,0,0,0,0,208,2,0,0,0,0,0,0,0,0,0,100
fa96d6df02ccb12eb15144e1c001f9783bcdd48e,0,0,0,0,0,0,0,0,0,0,0,0,0,0,209,3,0,0,0,0,0,0,0,0,0,100
d3790f70c7d8a0e7a85c1ad95730605c33c4d818,0,0,0,0,0,0,0,0,0,0,0,0,0,0,210,4,0,0,0,0,0,0,0,0,0,100
6afab6486af7beda11e57696ec607a1c638e318e,6,397,64,333,2,0,2,10,53,160,1,2,1.486707652,1442,211,5,311,254,57,10092,8861,1231,140,125,15,99.97710623
f7c89885e3724761ed450f9e2c4c49a25e26f007,0,0,0,0,0,0,0,0,0,0,0,0,0,0,212,6,0,0,0,0,0,0,0,0,0,100
d25ed12902c1ee4f156e6aba2b715de148be131c,0,0,0,0,0,0,0,0,0,0,0,0,0,0,213,7,0,0,0,0,0,0,0,0,0,100
a53744a744465bd7ef480d7fb79a68ec9e9365d3,0,0,0,0,0,0,0,0,0,0,0,0,0,0,214,8,0,0,0,0,0,0,0,0,0,100
bb6bad070217721424e51edf1b4e5725e3a8e489,3,10,10,0,0,0,0,9,204,256,3,3,1.570950594,6505,215,9,1664,1664,0,41985,41976,9,796,796,0,100
08acaa4f559d53afc413720ab65e429614bc5c52,0,0,0,0,0,0,0,0,0,0,0,0,0,0,216,10,0,0,0,0,0,0,0,0,0,100
c1d9fd3c62ab40a893749ac3338b3ed20ddd6567,3,81,89,8,0,0,0,6,18,297,1,1,0.636788856,781,217,11,178,178,0,5279,5206,73,40,40,0,100
d35ea4bb06d103766c4cd1e738b265d69b8a4f36,0,0,0,0,0,0,0,0,0,0,0,0,0,0,218,12,0,0,0,0,0,0,0,0,0,100
aae0a95f6c8f38e0df18e5f538761ee502d9eb08,1,4,1,3,0,0,0,14,32,297,1,1,0,654,219,13,263,262,1,3885,3880,5,89,89,0,100
40d19ebc6cf56ab60e6adaf22044162bbed5c8a6,1,18,0,18,0,0,0,3,5,311,1,1,0,107,220,14,5,3,2,732,636,96,4,3,1,100
03ebe4fdd0865a6ce7007a6ac9cf4eb189c722e2,1,6,1,5,0,0,0,4,5,314,1,1,0,103,221,15,9,9,0,692,679,13,3,3,0,100
89335fd48cb88a7acb53c9fc1c85942be5a1c3dd,15,226,94,132,1,0,1,4,44,291,2,7,3.020318761,5018,222,7,1410,1395,15,34948,34440,508,527,516,11,99.97056322
61b48040db743ee46cae6940445baeb57a9f3d80,0,0,0,0,0,0,0,0,0,0,0,0,0,0,223,8,0,0,0,0,0,0,0,0,0,100
e57fd518b32d1ebc85fbdb818b1ca818d1abe46a,18,474,161,313,2,0,2,4,205,200,4,9,3.49043677,10222,224,8,3028,2958,70,72213,70597,1616,1008,982,26,99.97709649
dbfb360e85bb29bb11f87e3d5406a4edd4e51bd3,7,154,1,153,0,0,0,1,206,0,2,2,2.531097195,6049,225,8,1603,1577,26,41608,40777,831,649,633,16,100
9e222652dff1d959a2252cf96e5abb48a11dd7fd,21,188,631,443,1,0,1,3,204,102,4,11,3.581468806,12762,14,0,3299,3391,92,90477,92707,2230,1264,1304,40,99.97709649
6d2544f390a53b8e7a8891ca5c025961dda948cc,25,743,225,518,2,0,2,4,207,126,5,12,3.724716887,18384,226,6,4947,4842,105,129198,126588,2610,1870,1821,49,99.97709649
5079209823654d8d99d28f0bb3f3466243e457fd,3,27,4,23,0,0,0,6,63,336,2,2,1.30797636,2192,227,7,341,337,4,19880,19663,217,282,280,2,100
362474e5c93fc0dd73907e16929f55450d9d92e1,2,23,2,21,0,0,0,17,47,298,1,1,0.998845536,778,228,8,173,169,4,5663,5595,68,47,47,0,100
9f0631bbf42aa01542a7d46c3bb610d6c0d3aa3c,0,0,0,0,0,0,0,0,0,0,0,0,0,0,229,9,0,0,0,0,0,0,0,0,0,100
fffc74f0a7f3e387c2cc9826ceabf6a11918468b,2,14,7,7,0,0,0,4,38,178,1,2,0.863120569,935,230,9,232,229,3,6674,6636,38,110,110,0,100
e908a9c293394cfe3651fdd1f046b4b99ce5fee8,2,5,7,2,0,0,0,5,48,178,2,2,0.979868757,1050,231,10,147,147,0,8849,8851,2,78,78,0,100
be62c5a1230e73902ace4d7056a2b6287d10105a,1,26,4,22,0,0,0,20,75,354,1,1,0,1162,232,10,300,297,3,8296,8213,83,62,61,1,100
e82d1ec2fb058809306875c1d3f957caf4b283cf,1,0,6,6,0,0,0,17,52,12,1,1,0,804,233,11,173,173,0,5443,5447,4,54,54,0,100
ad4ed02728a9bbb1624f490bf6eabd59922981a9,2,6,0,6,0,0,0,8,208,186,1,1,1,4129,234,12,1207,1206,1,30074,30059,15,359,359,0,100
0cd523b1f564ec7d1c27de6e017423471f94b4af,0,0,0,0,0,0,0,0,0,0,0,0,0,0,235,13,0,0,0,0,0,0,0,0,0,100
43aa42ccb533212db9acf1a238d24172b18dc513,1,0,2,2,0,0,0,8,20,7,1,1,0,216,236,14,41,42,1,1362,1377,15,17,17,0,100
17ef63bbe4a96ce8b41727a0ace15fdd1ff312a7,2,10,4,6,0,0,0,5,11,366,1,1,1,388,237,15,43,45,2,2474,2468,6,26,26,0,100
25cde67172b9fb9f8e11a0db0cd77a05fe3a31ad,3,115,130,15,0,0,0,6,8,366,1,3,0.393314689,454,238,16,35,42,7,2923,3068,145,27,28,1,100
af39516fc8dd7a7fadeaa4377fcc58ab7bddc5e9,1,50,0,50,0,0,0,8,21,0,1,1,0,214,239,17,49,41,8,1640,1362,278,25,17,8,100
4b88b80dc05bd32893140e197feee1de702168db,1,1,1,0,0,0,0,6,9,0,1,1,0,124,240,18,11,11,0,705,709,4,9,9,0,100
11863ed9327c70420c2a537dafa380d3fee7b548,1,44,7,37,0,0,0,8,22,0,1,1,0,252,241,19,49,49,0,1658,1640,18,25,25,0,100
6e8c4d987fa0f2364d880f8fab4c5d85f790f538,2,67,66,1,0,0,0,3,4,367,1,1,0.112587599,145,242,20,13,13,0,698,694,4,13,13,0,100
e4197b0c422ba33a41dbcdaaa775883af85ecd90,0,0,0,0,0,0,0,0,0,0,0,0,0,0,10,0,0,0,0,0,0,0,0,0,0,100
037a2dc4c0e4d09487455d0f9b3848db2d1caec7,1,2,2,0,0,0,0,12,32,378,1,1,0,344,243,17,73,73,0,2210,2210,0,23,23,0,100
238449e155b9e70915b17a9f8f4cf6ef40e2bf9f,1,17,0,17,0,0,0,3,4,378,1,1,0,200,244,18,24,21,3,2238,2128,110,5,5,0,100
f27a0b91244158e99e9ba0213521b01d5ee89d41,0,0,0,0,0,0,0,0,0,0,0,0,0,0,245,19,0,0,0,0,0,0,0,0,0,100
de316bc01873be9feade647eb0209b0e31f93083,0,0,0,0,0,0,0,0,0,0,0,0,0,0,246,20,0,0,0,0,0,0,0,0,0,100
fa6ce77004739d9601bfde43e06f9446ab601698,1,5,4,1,0,0,0,8,16,106,1,1,0,212,247,21,58,58,0,1347,1342,5,15,15,0,100
b714dbae1876957a56133ff2aebb5d84919af79e,0,0,0,0,0,0,0,0,0,0,0,0,0,0,248,22,0,0,0,0,0,0,0,0,0,100
b484ee1f229fa2732251a1e0682000becaefcca6,1,3,3,0,0,0,0,11,22,402,1,1,0,524,249,14,122,122,0,2907,2906,1,111,111,0,100
0d9645781e243609c59196270d0325f6d75062a8,0,0,0,0,0,0,0,0,0,0,0,0,0,0,250,15,0,0,0,0,0,0,0,0,0,100
80736f6e9d38dfb180c89cec6cb2916341165a5c,4,78,14,64,0,0,0,7,56,401,3,3,0.984839945,1410,251,16,297,297,0,11673,11252,421,148,147,1,100
0e4ec5b392b978c4515b26c60e485f2b610de94f,7,144,56,88,0,0,0,7,80,180,3,3,1.957519827,4139,252,17,1014,995,19,29748,29141,607,504,499,5,99.96727427
c1ae373a0f55d3caa585717d43334b379a9b3bab,2,53,1,52,0,0,0,14,27,402,1,1,0.133039649,396,253,18,87,80,7,2828,2571,257,30,23,7,100
87422c8323f92a584b281917e9342b1bb703b452,0,0,0,0,0,0,0,0,0,0,0,0,0,0,254,19,0,0,0,0,0,0,0,0,0,100
1690076b37e70fb45d302b1af7a6c78256183a3b,2,39,18,21,0,0,0,7,58,0,2,2,0.972966127,851,255,20,224,223,1,5775,5746,29,88,88,0,100
cae509aa72777b96f89b5b86cfd9a07754dd6d0c,0,0,0,0,0,0,0,0,0,0,0,0,0,0,256,13,0,0,0,0,0,0,0,0,0,100
697c4d96ab13e91f69946a73255acbf66b89a929,0,0,0,0,0,0,0,0,0,0,0,0,0,0,11,0,0,0,0,0,0,0,0,0,0,100
44aede26df24d0e0615309c7b31fc59a1479231e,0,0,0,0,0,0,0,0,0,0,0,0,0,0,257,0,0,0,0,0,0,0,0,0,0,100
cb20dd6b95a07fe87bf46a2c33580322d0b11cd0,5,277,31,246,2,0,2,1,71,208,2,3,1.910814484,2995,12,1,843,807,36,25311,23847,1464,235,221,14,99.97708899
75999ad5d93b73d6d363364c99caac2c5e104877,4,206,16,190,3,0,3,1,14,127,1,2,1.762755419,664,13,0,220,207,13,5465,4809,656,39,35,4,99.97382627
8c0b843f6e6e0dd86a31e485928e61f2ba4c8f29,2,11,6,5,0,0,0,15,92,517,2,2,0.322756959,826,14,1,173,171,2,5579,5541,38,51,51,0,100
53b946d9caa0c55522f91ec1899c34a2a3dcd3eb,1,10,6,4,0,0,0,23,209,163,1,1,0,3917,258,0,1165,1165,0,28701,28697,4,342,342,0,100
31c0450562c71b63f7bea8edaf9b6378f724ed70,0,0,0,0,0,0,0,0,0,0,0,0,0,0,259,1,0,0,0,0,0,0,0,0,0,100
acf78d8091f29e6a67ae7214ba56b70b6ce5a317,1,1,1,0,0,0,0,23,210,16,1,1,0,3920,260,2,1165,1165,0,28701,28701,0,342,342,0,100
11cfff3f789803d6a49d68df307e9cb332ba1ed5,0,0,0,0,0,0,0,0,0,0,0,0,0,0,261,3,0,0,0,0,0,0,0,0,0,100
99aa054a29d418e33d8f37b0224c5085a59dca90,0,0,0,0,0,0,0,0,0,0,0,0,0,0,262,4,0,0,0,0,0,0,0,0,0,100
14263ca52d858e9fd29c1e508f2cd0a2ec50e8ca,1,6,4,2,0,0,0,23,211,6,1,1,0,3920,263,5,1165,1165,0,28701,28701,0,342,342,0,100
a5b50a5bd4ca8b0de8ca8032aeaca0b383163bc9,0,0,0,0,0,0,0,0,0,0,0,0,0,0,264,6,0,0,0,0,0,0,0,0,0,100
4e59c4836407382f853306dfd0ffbd14cba6e5c1,8,18,10,8,0,0,0,5,212,303,2,5,2.76588137,6630,265,7,1468,1469,1,48304,48292,12,454,455,1,100
64af85106ae52432c91ff6fa5bf0ed95323d457e,1,8,1,7,0,0,0,4,12,552,1,1,0,149,266,8,13,12,1,930,901,29,9,9,0,100
dc31b800b8831d606c9621be2935282b666ecf64,3,9,7,2,0,0,0,9,12,552,1,2,1.561278124,202,267,9,21,21,0,1014,1002,12,17,17,0,100
a7969c120bfba06b883f319788fc50ca0ef06b69,11,15,15,0,0,0,0,9,213,0,2,7,3.132914564,6840,268,10,1489,1489,0,49318,49318,0,471,471,0,100
d8ddf87a4752921f75e759f735282a70143dd139,0,0,0,0,0,0,0,0,0,0,0,0,0,0,269,11,0,0,0,0,0,0,0,0,0,100
f9b59689d45fdc5615da6779ad097173e729616b,3,39,14,25,0,0,0,4,59,162,2,2,1.183998294,1208,270,10,213,211,2,9977,9942,35,108,106,2,100
afcec21a1d489dff682a3ce7986fac6a1c80e8e0,0,0,0,0,0,0,0,0,0,0,0,0,0,0,271,11,0,0,0,0,0,0,0,0,0,100
9f26ed29bf31b5c8ab68c5257d42e8c88765cf9b,0,0,0,0,0,0,0,0,0,0,0,0,0,0,272,12,0,0,0,0,0,0,0,0,0,100
389a82db97b96bd2bf6b519afdc64e833f5c0478,2,81,37,44,0,0,0,19,96,670,2,2,0.866300675,1717,4,0,514,510,4,12211,11990,221,152,151,1,100
cc26907babf69e493ce34f265a208ed908d1db12,2,37,81,44,0,0,0,18,95,2,2,2,0.866300675,1748,26,0,510,514,4,11990,12211,221,151,152,1,100
cd81d3602436083614afc77bacda4099d3f269c5,2,81,37,44,0,0,0,19,96,670,2,2,0.866300675,1717,5,1,514,510,4,12211,11990,221,152,151,1,100
99a5a102184ffa1402aaa479848cd64ad33374c8,3,1,121,120,0,0,0,4,108,748,2,3,1.172184719,3561,6,0,740,751,11,27763,28146,383,139,146,7,99.9836457
7c54dd855ba283cb6bb0ff87355a00fd60edfbd4,1,4,2,2,0,0,0,19,97,89,1,1,0,1607,7,1,488,488,0,11205,11205,0,145,145,0,100
d381f3f62cf92ed6b76b0e0576c692a1d5e288d8,3,118,1,117,2,0,2,1,109,8,2,3,1.131139538,3468,0,0,752,740,12,28167,27763,404,148,139,9,99.9836457
4cd805eed8570f9a7ff1da7a89b0c631b465f97e,0,0,0,0,0,0,0,0,0,0,0,0,0,0,40,0,0,0,0,0,0,0,0,0,0,100
ef98e1848096448ba7e60f65839d69451dfcc06d,9,219,2,217,2,0,2,8,110,490,5,8,2.183831107,8507,15,0,1868,1838,30,61123,60227,896,668,651,17,99.97712119
b27175be87a3e4e9d88350158ad414e865ceab3b,1,14,7,7,0,0,0,19,99,348,1,1,0,1626,8,0,495,495,0,11316,11308,8,146,146,0,100
0a6b7fb5944129a89f1861f3f7bbb40fac94ef8d,0,0,0,0,0,0,0,0,0,0,0,0,0,0,15,0,0,0,0,0,0,0,0,0,0,100
7ec0015edf61a738fd6a5cc22ed7c69002b74948,0,0,0,0,0,0,0,0,0,0,0,0,0,0,16,0,0,0,0,0,0,0,0,0,0,100
6a3395dc795e3f356f11039caaebdca3bf8c373b,4,545,199,346,3,0,3,1,21,328,2,3,1.775606568,694,27,0,166,137,29,6028,4018,2010,65,45,20,98.79810939
36ddbac0e4dd39494887664f9a96024ad6df798a,0,0,0,0,0,0,0,0,0,0,0,0,0,0,16,0,0,0,0,0,0,0,0,0,0,100
a7c4f4405eacd749659ecd0130cdb4d5e05acd3a,0,0,0,0,0,0,0,0,0,0,0,0,0,0,17,1,0,0,0,0,0,0,0,0,0,100
aad345fc4a690db8b07a428ff6fa82cd02cf4183,0,0,0,0,0,0,0,0,0,0,0,0,0,0,18,2,0,0,0,0,0,0,0,0,0,100
1440702eec4ee0167b16606592198356765f4082,0,0,0,0,0,0,0,0,0,0,0,0,0,0,273,0,0,0,0,0,0,0,0,0,0,100
fd9585839abdb374fb6d2e4b502f30bcf957cffa,0,0,0,0,0,0,0,0,0,0,0,0,0,0,274,1,0,0,0,0,0,0,0,0,0,100
962cbbc624a671dba7075f020a515b2ff0eb89d8,0,0,0,0,0,0,0,0,0,0,0,0,0,0,275,0,0,0,0,0,0,0,0,0,0,100
e4227473b0798a0cf28beed90cec7ae97dfe30ec,0,0,0,0,0,0,0,0,0,0,0,0,0,0,276,1,0,0,0,0,0,0,0,0,0,100
44c4d8dc0203664a1d178b395174e4347fa9faaf,0,0,0,0,0,0,0,0,0,0,0,0,0,0,17,0,0,0,0,0,0,0,0,0,0,100
ae9b2a904bc5611257e2db888d3c61c7235be19f,4,463,0,463,4,0,4,1,1,0,1,3,1.197282994,0,19,0,60,0,60,2491,0,2491,19,0,19,99.96856993
f9b0906c1baa080ea67b3b1b26430a2489013671,1,5,1,4,0,0,0,1,2,16,1,1,0,315,20,1,59,58,1,2271,2242,29,17,17,0,100
d2ba842d61266ab67bc17245c00db37a06da666b,0,0,0,0,0,0,0,0,0,0,0,0,0,0,21,2,0,0,0,0,0,0,0,0,0,100
666ae82f3baabed49b00217f219ba1be9d4ed748,0,0,0,0,0,0,0,0,0,0,0,0,0,0,28,0,0,0,0,0,0,0,0,0,0,100
4c9ac41fd1367396e34151dcc5e9b98674d2665b,0,0,0,0,0,0,0,0,0,0,0,0,0,0,22,3,0,0,0,0,0,0,0,0,0,100
beb125500f10b77cca8d40b88d23252af78fae21,2,362,316,46,1,0,1,1,3,11,1,1,0.997230114,319,23,4,64,59,5,2417,2271,146,21,17,4,99.99301822
26b1f6be289f1eacfb72f2998c360ff6dc692920,1,1,1,0,0,0,0,24,214,1147,1,1,0,3920,0,0,1165,1165,0,28701,28701,0,342,342,0,100
2a579043550b1cc4d1e6348ff65b8bb86c861928,1,2,11,9,0,0,0,24,215,8,1,1,0,3920,18,0,1163,1165,2,28671,28701,30,342,342,0,100
ff2a1e6c1f8655a52fa9db5a8b1e9ffe54f92f81,6,124,84,40,0,0,0,2,72,1479,3,4,1.791394821,2782,277,0,692,686,6,22180,21922,258,200,195,5,100
a975a3d1c63a82a6897b79a5cc9fcc4a3ebbb01f,2,12,12,0,0,0,0,7,13,840,2,2,0.979868757,513,24,0,97,97,0,3344,3344,0,31,31,0,100
bf418eb1b3036f49d9536db66e30ef7ceb83332d,3,60,11,49,0,0,0,5,70,1722,3,3,1.018374614,572,25,1,110,99,11,4068,3682,386,42,41,1,100
d0875670dd470473e305aea00d66984735a8e3dc,4,246,4,242,2,0,2,1,216,351,2,3,1.464462762,4516,26,2,1366,1345,21,33872,32461,1411,453,445,8,99.9685809
560a850bfdee09171a34acd3f79cd676f37279a4,0,0,0,0,0,0,0,0,0,0,0,0,0,0,27,3,0,0,0,0,0,0,0,0,0,100
868a446a3e45fd026280c977de86dd6c4f123113,0,0,0,0,0,0,0,0,0,0,0,0,0,0,28,4,0,0,0,0,0,0,0,0,0,100
e721abfdaa5a89489f7fec11d4cf3a0d2b804556,3,8,9,1,0,0,0,1,27,576,2,3,1.332820405,816,29,5,195,194,1,5133,5127,6,109,109,0,100
db5912b309a3dabc74b7155285f8771dad360446,0,0,0,0,0,0,0,0,0,0,0,0,0,0,30,0,0,0,0,0,0,0,0,0,0,100
55e6829b1d6c534feeb6a3ab6bcb0a4f36f8dfac,1,5,5,0,0,0,0,11,20,1845,1,1,0,370,29,0,136,131,5,2622,2572,50,35,35,0,100
61ec81624d157133ea94a05229932a644b1992f5,0,0,0,0,0,0,0,0,0,0,0,0,0,0,30,1,0,0,0,0,0,0,0,0,0,100
6aa22031e1b4374f8d83a202ea8ed8d74c95a83f,0,0,0,0,0,0,0,0,0,0,0,0,0,0,278,0,0,0,0,0,0,0,0,0,0,100
66d2a72cb2252a59086d76983979b6512c887a3b,0,0,0,0,0,0,0,0,0,0,0,0,0,0,279,1,0,0,0,0,0,0,0,0,0,100
f18f28b63302afeff8d4934719f66962adbf33a4,0,0,0,0,0,0,0,0,0,0,0,0,0,0,280,2,0,0,0,0,0,0,0,0,0,100
c93313767d369d60ed3201c784b257c8592892c6,2,45,0,45,1,0,1,1,54,836,1,2,0.15374218,851,0,0,158,157,1,5433,5331,102,88,87,1,99.99301773
0e32d4981abca26ea97d8e66c643b2bf5162d1e9,0,0,0,0,0,0,0,0,0,0,0,0,0,0,31,0,0,0,0,0,0,0,0,0,0,100
dcc313b6894c4063572173101e1a2b87e548b0b7,2,0,45,45,0,0,0,0,53,71,1,2,0.15374218,886,0,0,157,158,1,5331,5433,102,87,88,1,99.99301773
6ec962f14f9397efb9994ede3a360a52eba03af6,0,0,0,0,0,0,0,0,0,0,0,0,0,0,1,1,0,0,0,0,0,0,0,0,0,100
c97bb58a35241e0925057401dfe1a8f94afedff3,0,0,0,0,0,0,0,0,0,0,0,0,0,0,2,2,0,0,0,0,0,0,0,0,0,100
6ddfe4e0a05bd021131414a97b426539b8eca6e1,0,0,0,0,0,0,0,0,0,0,0,0,0,0,3,3,0,0,0,0,0,0,0,0,0,100
d4882b0acec6ace347517c4f9b352a693bf9a6a6,0,0,0,0,0,0,0,0,0,0,0,0,0,0,4,4,0,0,0,0,0,0,0,0,0,100
29ca489fc61b4ba78f5b41cef6fd7a8b8cb165b9,0,0,0,0,0,0,0,0,0,0,0,0,0,0,5,5,0,0,0,0,0,0,0,0,0,100
5263d8ca27e3e2f72a9641465f5ab397f71a4525,0,0,0,0,0,0,0,0,0,0,0,0,0,0,6,6,0,0,0,0,0,0,0,0,0,100
78225920f9ee7eed53686c95291e36878b595d4d,0,0,0,0,0,0,0,0,0,0,0,0,0,0,7,7,0,0,0,0,0,0,0,0,0,100
80c7d3c9bb624b5a27112e5db318ceb5137f57e0,0,0,0,0,0,0,0,0,0,0,0,0,0,0,8,8,0,0,0,0,0,0,0,0,0,100
c1a6aa5a4eda41e6f711e0253e84795582379d9d,2,45,0,45,1,0,1,1,54,836,1,2,0.15374218,851,32,1,158,157,1,5433,5331,102,88,87,1,99.99301773
e3bb1f16575c53f35969968b259a20d16056747c,9,759,30,729,3,0,3,1,99,906,2,4,1.644114746,5719,10,10,1689,1591,98,41184,37728,3456,641,553,88,95.30203939
bc63cd2e45b386040ea5e402d8ab6abd4d98c833,2,13,2,11,0,0,0,3,11,990,2,2,0.970950594,642,11,11,178,174,4,3963,3907,56,86,84,2,100
589d7755d2711198d7f38fd79d14e61b778a2118,3,7,14,7,0,0,0,6,16,745,2,3,1.556656707,735,281,0,186,190,4,4390,4418,28,88,90,2,100
5d9c88d7cbcc3cdfba0e9fee9d5c6b37bba08030,1,0,2,2,0,0,0,14,71,254,1,1,0,312,282,1,56,56,0,2075,2075,0,18,18,0,100
bf03bdb314d99502046543e2e904235f87f46bb3,2,12,41,29,0,0,0,8,17,1976,1,1,0.657272978,342,283,2,63,67,4,2055,2280,225,12,12,0,100
ab6e0ed4b46f7e3ef59c8ab74b3e9de4fdeff8b9,1,12,14,2,0,0,0,8,16,1977,1,1,0,182,284,3,37,37,0,1134,1175,41,7,7,0,100
94a033d83bcab3e8f00c9927533ae9889c3d11ec,2,20,1,19,0,0,0,10,23,1118,1,1,0.918295834,433,285,4,97,95,2,3033,2947,86,21,20,1,100
5b81bead84f834b283f171d0e29166cda565a8f9,0,0,0,0,0,0,0,0,0,0,0,0,0,0,286,5,0,0,0,0,0,0,0,0,0,100
093a547193e0e2b85c737d409e5808c7dafe271a,0,0,0,0,0,0,0,0,0,0,0,0,0,0,31,0,0,0,0,0,0,0,0,0,0,100
119df603b8223043499b28410ce28a1edae22459,2,21,19,2,0,0,0,1,4,303,1,1,0.384311544,359,33,2,65,64,1,2425,2417,8,21,21,0,100
c13f0b0e136b0c2730c769948937975a92055940,4,46,8,38,0,0,0,15,217,1036,1,2,1.034907629,6049,0,0,1736,1732,4,43315,43245,70,536,533,3,100
f92c85314dc55c780378519c5ca6e20c8deb76e3,1,2,0,2,0,0,0,17,53,1739,1,1,0,803,287,0,173,173,0,5447,5443,4,54,54,0,100
e831faffe4aaf0b68d25aa896d0e4fc515aa6590,0,0,0,0,0,0,0,0,0,0,0,0,0,0,288,1,0,0,0,0,0,0,0,0,0,100
00109319baf9840d4507a7e1d24a2c498a3661fc,0,0,0,0,0,0,0,0,0,0,0,0,0,0,289,2,0,0,0,0,0,0,0,0,0,100
8d76c716b71a58306c32da7522bbefd83d0334d3,0,0,0,0,0,0,0,0,0,0,0,0,0,0,290,3,0,0,0,0,0,0,0,0,0,100
60bfa50c7f9d4a762c78bc45c73c945f9f79415a,0,0,0,0,0,0,0,0,0,0,0,0,0,0,291,4,0,0,0,0,0,0,0,0,0,100
f831ef17c166a7a7c874cd503fb83e0bfbbbde16,0,0,0,0,0,0,0,0,0,0,0,0,0,0,292,5,0,0,0,0,0,0,0,0,0,100
4dd64cc6b340504677885447e2a39f44584a65cd,0,0,0,0,0,0,0,0,0,0,0,0,0,0,293,6,0,0,0,0,0,0,0,0,0,100
4dfabc8b6e01165cdf2756a96a8eee4bdd7b04af,0,0,0,0,0,0,0,0,0,0,0,0,0,0,294,7,0,0,0,0,0,0,0,0,0,100
8f3e1bc21aaf745dff450e7da2c29a99283730d3,2,31,6,25,0,0,0,2,3,251,1,1,0.995252549,586,295,8,99,97,2,3265,3199,66,87,87,0,100
3dfaba893ac06ff35663bfb469bd9337e4047c40,0,0,0,0,0,0,0,0,0,0,0,0,0,0,296,9,0,0,0,0,0,0,0,0,0,100
06ee81dc0b997ca6b9955dffe856fa74c4c3e55d,0,0,0,0,0,0,0,0,0,0,0,0,0,0,297,10,0,0,0,0,0,0,0,0,0,100
8dbdc143219734d3c8ab05f13fa11b791e643458,1,3,0,3,0,0,0,16,43,168,1,1,0,1150,34,0,325,324,1,8164,8152,12,73,73,0,100
a38684b3231e13cef7fa6588194c68f226589d52,1,3,3,0,0,0,0,16,44,0,1,1,0,1153,35,1,325,325,0,8172,8164,8,73,73,0,100
1862e2bad507949caed81cecb9155360b9731220,3,1,32,31,0,0,0,3,17,822,1,2,1.179191089,578,36,2,101,106,5,2748,2923,175,47,48,1,100
325af839651dc5c16ae7781651b4702fead7b1dc,0,0,0,0,0,0,0,0,0,0,0,0,0,0,0,0,0,0,0,0,0,0,0,0,0,100
33fc72ac857dff85f9ff1ef3173638ca504a5d22,100,13443,108,13335,63,0,63,5,162,749,4,16,5.0558565,19672,37,3,6623,5169,1454,158364,119128,39236,2826,1952,874,99.36162871
dd9bce0cc909bd96d706a9438bdc2a58111c481f,5,31,7,24,0,0,0,1,218,1332,1,2,2.229239764,4955,11,0,1367,1362,5,35600,35428,172,418,416,2,100
963ed59ad49c198c750b3ee251989b2793520840,2,1,14,13,0,0,0,1,219,0,1,1,0.970950594,3996,12,1,1174,1177,3,29092,29136,44,345,347,2,100
e95dbc8a0baaeba32a99d650fd2fa2d677ea472c,1,161,0,161,1,0,1,1,1,0,1,1,0,0,13,2,8,0,8,864,0,864,7,0,7,99.9785748
f93ea15745531838caf87022424604044302e95b,8,90,181,91,1,0,1,1,217,318,2,5,1.582771716,5189,0,0,1396,1400,4,36314,36987,673,436,437,1,99.97000857
4c624c0acc9743fe687e3ab4504aa68d03260e7a,6,179,7,172,1,0,1,1,219,1074,1,3,0.873549108,4955,38,4,1372,1362,10,36420,35428,992,423,416,7,99.9785803
b24a6a239cafc968ecaef4ab683495eb3fbe11e0,1,1,1,0,0,0,0,26,220,30,1,1,0,3949,14,3,1173,1173,0,29002,28995,7,344,344,0,100
61f11a7088f5155d01b65f426a4f290a7ee6ea1d,1,32,0,32,0,0,0,4,7,2179,1,1,0,157,15,4,9,8,1,1156,954,202,6,5,1,99.97858214
910a812a1550382d2bafd9a001a66c5e7425ccf5,4,12,44,32,0,0,0,7,219,59,3,4,1.53408762,4657,39,3,1280,1281,1,33360,33569,209,380,381,1,99.97858214
bd015d02e95bd3d7c39f3b0a9bdf2cb448bedc75,2,31,4,27,0,0,0,18,129,2184,1,1,0.775512658,2145,40,2,498,491,7,13450,13298,152,283,282,1,100
049c2ef163d3632f9e91abb91b5ac0d52584d4a9,2,13,2,11,0,0,0,3,11,990,2,2,0.970950594,642,41,3,178,174,4,3963,3907,56,86,84,2,100
758b8667061494392ad3ca30d0737191e31f64fe,2,33,1,32,0,0,0,4,220,1104,1,2,0.322756959,4106,42,4,1182,1181,1,30158,29949,209,350,349,1,99.97858214
4a546f759cee4220495e4206abc3c0503af204fa,2,6,3,3,0,0,0,18,130,0,1,1,0.503258335,2169,43,5,499,498,1,13465,13450,15,283,283,0,100
9fa619f94ecec2510d2ec560bb719eecd8f222c1,5,43,14,29,0,0,0,14,163,750,2,4,1.139944096,6613,44,6,1610,1602,8,39273,39056,217,625,621,4,100
0b68db6ba164943d8470d46fb4de326a19fc9485,1,10,2,8,0,0,0,12,64,2,1,1,0,392,45,7,90,88,2,2570,2527,43,39,38,1,100
574e226ba074dda5927623f5f1b33c009c4d1187,1,1,0,1,0,0,0,18,131,2,1,1,0,1780,46,8,411,411,0,10942,10938,4,245,245,0,100
629ebaefce481863ec0a154b06ef8b5ccf41a620,1,0,2,2,0,0,0,2,5,38,1,1,0,37,47,9,1,1,0,90,97,7,1,1,0,100
4a7d6d72f57472eb77cbbd7bc64cee60f603e389,0,0,0,0,0,0,0,0,0,0,0,0,0,0,298,0,0,0,0,0,0,0,0,0,0,100
548e00f9191b2ae47fb130ed432908c86511f85c,0,0,0,0,0,0,0,0,0,0,0,0,0,0,299,1,0,0,0,0,0,0,0,0,0,100
02e91440e525711f5f0b6cb66fea971d447088df,1,0,3,3,0,0,0,2,6,78,1,1,0,36,17,0,1,1,0,78,90,12,1,1,0,100
6f2692228fbc75656f34c5d1d7cc6dbe2de631ca,2,26,0,26,0,0,0,18,132,58,2,2,0.51594693,1814,48,0,412,412,0,11124,11020,104,246,246,0,100
bb35ca71293e5dd35785d9a6cfea78d5cb6305c2,3,73,26,47,1,0,1,18,131,0,2,3,1.050734287,1840,18,1,413,412,1,11338,11124,214,247,246,1,99.98286571
a998255a1e4944c505bc7a4868c05c74ccfdd4a8,2,112,3,109,0,0,0,1,8,2,1,2,0.072016472,94,19,2,2,2,0,1206,396,810,2,2,0,100
117f75ce0bd4ce3f527ac418e6a737d7a5002cec,1,6,3,3,0,0,0,1,3,0,1,1,0,137,20,3,1,1,0,1126,1120,6,1,1,0,100
aabbc255e7487137908766672f2187ee56b448b8,1,23,0,23,0,0,0,18,132,78,1,1,0,1781,49,1,411,411,0,11034,10942,92,245,245,0,100
440cdb37719d0431e07adcf8dff2f70aab6c292a,4,226,1,225,2,0,2,1,79,616,2,4,1.0625669,1124,50,0,306,278,28,8501,7558,943,110,88,22,99.97858947
0d7816290ea9950a8f1aa02dfe418d877481dc0a,3,294,175,119,2,0,2,1,17,51,1,2,1.344985351,194,51,1,40,35,5,1564,1112,452,16,11,5,99.50390986
61b30777d4e83646325006175f918d9fb2ef45c9,3,138,9,129,1,0,1,6,80,789,1,2,0.612777257,890,300,0,250,232,18,6054,5645,409,104,86,18,99.991741
939f754e373cb723699b7c36166f9fea1e98dcc8,0,0,0,0,0,0,0,0,0,0,0,0,0,0,301,1,0,0,0,0,0,0,0,0,0,100
eef64ccd69c48ba8c7193509f6f621c6315bc74e,2,57,13,44,1,0,1,3,5,1186,1,2,0.985228136,55,302,2,6,5,1,251,208,43,4,3,1,99.98761354
b29976342c912ca5db47ef529cba025b3fe18430,1,1,1,0,0,0,0,3,6,0,1,1,0,60,303,3,6,6,0,248,230,18,4,4,0,100
00bd91cc2c858949486acb4e8063176be9a48842,2,43,19,24,0,0,0,4,64,1956,2,2,0.962900415,1429,304,4,160,162,2,13887,13647,240,115,116,1,100
aeb333fb3a6b7eb611c3ed79ba39c6286445f5b3,0,0,0,0,0,0,0,0,0,0,0,0,0,0,305,0,0,0,0,0,0,0,0,0,0,100
72df0228cab9637e23b4a7a3aa90b7e11b0fd7cf,2,149,23,126,0,0,0,1,36,2550,2,2,0.956550363,855,306,0,370,349,21,7602,6455,1147,37,37,0,100
c7c13d3e8be25512b0e9451f5bbe3706a07c7206,1,1,3,2,0,0,0,16,45,582,1,1,0,1153,307,1,325,325,0,8173,8172,1,73,73,0,100
9c9138603dbd2bb32fd3931e98bba0d015ba01b6,2,88,0,88,0,0,0,10,22,2724,1,1,0.902393283,773,308,2,319,253,66,6064,4983,1081,97,93,4,100
8283ea0fb2d455118c133540ef7f2bea4ae597cd,1,5,0,5,0,0,0,15,30,632,1,1,0,313,309,3,76,76,0,2162,2154,8,24,24,0,100
1a8bcfb6b1bd08d3f0158c023307c3cea2512d98,4,27,3,24,0,0,0,1,19,1963,2,4,1.693344864,615,310,4,140,134,6,4413,4254,159,38,38,0,100
d48f439bc87907703e3bb36073d50dd2f772d236,2,9,11,2,0,0,0,26,221,1436,1,1,0.286396957,4074,311,5,1186,1185,1,29707,29697,10,350,350,0,100
80a16896f1ec27c388dca12df7fadd5a30e49530,1,1,2,1,0,0,0,8,17,2728,1,1,0,248,312,6,19,19,0,1965,1969,4,17,17,0,100
6a47c4c03328689d1133c1a46c1f5d20b56549b9,4,19,22,3,0,0,0,8,222,1364,2,3,1.415037676,4468,313,7,1267,1267,0,32200,32190,10,385,384,1,100
edf7a3985230a6976af02e793dd57fd6eba437f3,0,0,0,0,0,0,0,0,0,0,0,0,0,0,314,8,0,0,0,0,0,0,0,0,0,100
68aa6a3d171cb1165a65d43103b4d49cd1b19be4,0,0,0,0,0,0,0,0,0,0,0,0,0,0,315,9,0,0,0,0,0,0,0,0,0,100
9a96e0cd89ee9bac41a39d89388468a0774a519d,4,7,4,3,0,0,0,4,7,2729,1,1,1.980825936,169,52,0,8,8,0,758,742,16,5,5,0,100
e9f3f9cdfcbb6479e02a477730debb320e5e5dbe,2,28,8,20,0,0,0,5,32,1090,2,2,0.811278124,511,316,10,94,91,3,3846,3716,130,36,34,2,100
f1871782cdac733949816c469e68fc9ad5229fbe,1,9,4,5,0,0,0,3,4,2616,1,1,0,278,317,11,34,33,1,1997,1960,37,19,19,0,99.98348404
93fe0643006b53d23e10931aabcdda4bf3df6ee2,1,1,2,1,0,0,0,8,18,5,1,1,0,247,318,12,19,19,0,1961,1965,4,17,17,0,100
5b46dcc191a0cb104013f59c60a61c572bd756f3,1,2,3,1,0,0,0,4,7,2733,1,1,0,122,319,13,9,9,0,696,707,11,5,5,0,100
20faa3692c701052d510909d09c00abeae9a468a,0,0,0,0,0,0,0,0,0,0,0,0,0,0,320,14,0,0,0,0,0,0,0,0,0,100
c3bbb92557743928d045e1061360f3bfd48b182e,1,26,0,26,0,0,0,17,54,639,1,1,0,804,321,15,176,173,3,5585,5447,138,56,54,2,100
a3bf818402bd5fd5227919f23f24509a4e09f97f,1,0,1,1,0,0,0,17,55,0,1,1,0,819,322,16,176,176,0,5578,5585,7,56,56,0,100
2a3fc7386182ce7e4a6ace5b8f5a926766e53041,1,1,4,3,0,0,0,8,11,585,1,1,0,143,323,17,21,21,0,861,890,29,8,8,0,100
6db4db7f512e67b7ea1e3aeb124a4e0343df79d8,2,132,82,50,0,0,0,1,37,9,2,2,0.207806778,977,324,18,388,370,18,8040,7644,396,50,37,13,100
bd3f8ed57e87cdc015eef01d3c93069c3ec2bb00,1,6,3,3,0,0,0,1,7,0,1,1,0,161,325,19,15,15,0,1305,1305,0,15,15,0,100
8f96a5bd798c8bbdbc03bf5a9551b1da6ef68370,1,1,1,0,0,0,0,1,8,0,1,1,0,164,326,20,15,15,0,1305,1305,0,15,15,0,100
6861dd1d02751ae55ef64dd51f6808d044dc560d,4,50,5,45,1,0,1,26,223,191,1,2,1.505475239,4553,327,21,1336,1335,1,32866,32778,88,423,422,1,99.98761252
f848e99a7b249298643ae98f04ed70e8ac74b81b,0,0,0,0,0,0,0,0,0,0,0,0,0,0,328,22,0,0,0,0,0,0,0,0,0,100
53cc83eb7ee995aa3d645f7b4bdc6492f0e609d1,4,4,31,27,0,0,0,6,56,1276,2,3,1.50671624,2396,329,23,416,420,4,16230,16324,94,179,179,0,100
76225267d90f9abe559dc63a7f5f74a1aa5bcd93,1,5,5,0,0,0,0,10,38,2,1,1,0,858,330,24,373,373,0,6720,6735,15,35,35,0,100
ab8090f5566c68fd3d46600158527de14ce622f2,2,24,1,23,0,0,0,5,12,1096,2,2,0.40217919,597,331,25,102,100,2,4555,4421,134,36,35,1,100
8d3acdc11ef04890718fc8e6d24063daa254ebfe,1,2,1,1,0,0,0,4,12,0,1,1,0,410,332,26,88,86,2,2955,2939,16,25,25,0,100
495fe202a35c276915e52589d14cc3a5cba927c2,1,162,155,7,0,0,0,6,7,2739,1,1,0,171,333,27,18,16,2,1205,1176,29,5,5,0,100
e68083e8d07646278fff970fc811f6bbb962fc9a,37,41,39,2,0,0,0,2,14,2479,3,15,5.153055907,8370,334,28,1058,1058,0,55888,55874,14,572,572,0,100
7f92be5e2bfbee3c2213f8d2609e9f619647d39f,1,1,1,0,0,0,0,8,17,2359,1,1,0,212,335,29,58,58,0,1348,1347,1,15,15,0,100
6d4f951d627c8a890f3d0e91c827b174749000f3,0,0,0,0,0,0,0,0,0,0,0,0,0,0,336,30,0,0,0,0,0,0,0,0,0,100
60cb785a3b528c57f0c55b62d3e67b4d9b2ca1f4,0,0,0,0,0,0,0,0,0,0,0,0,0,0,337,31,0,0,0,0,0,0,0,0,0,100
1c30090c8c611843860ff83be862e22cbcf46cee,2,3,5,2,0,0,0,8,33,2276,2,2,0.811278124,1160,338,32,114,114,0,8280,8272,8,44,44,0,100
515756b8237353b07d8fa617dc9d6f797ffddf6a,1,0,11,11,0,0,0,12,34,0,1,1,0,343,339,33,70,73,3,2151,2206,55,22,23,1,100
7a75ccd80ab1bc5cd156335bbc11bf9e11b68a86,0,0,0,0,0,0,0,0,0,0,0,0,0,0,340,34,0,0,0,0,0,0,0,0,0,100
9458d1720ba3ee6ea192103c89fc3e6ee85ce6e9,7,1,98,97,0,0,0,4,21,2733,3,5,1.978062088,1313,341,35,197,197,0,7568,7569,1,142,142,0,100
b0ba9c3e60305b441956837c8b71479dc6aba825,186,316,353,37,0,0,0,3,224,2238,11,87,7.046465306,74790,342,36,17347,17348,1,500751,501382,631,6107,6107,0,99.97935761
a7708636e3d5440fa071075e94d726b50689a82b,227,809,828,19,0,0,0,6,225,2221,11,84,7.062612545,94139,343,37,21752,21752,0,624140,627549,3409,7946,7946,0,100
d73e2e72f0f2c022aa2e0431a04a1552e7993d17,101,247,421,174,0,0,0,9,166,1496,9,58,6.009842397,47623,344,38,11480,11566,86,319140,320218,1078,3776,3776,0,100
1fb5234574994dd1ec023a04ffbbe042831d22bc,293,4547,4311,236,0,0,0,6,226,1481,9,71,6.691802511,132685,345,39,32610,32608,2,891510,908157,16647,10532,10532,0,100
044c7d27b1e787509d00837443511a9f76cbf6dc,3,20,7,13,0,0,0,6,58,915,2,3,0.725375928,2172,346,40,535,531,4,14226,14173,53,138,137,1,100
f1eee206a9554c50770690c0aed09536e1970e20,0,0,0,0,0,0,0,0,0,0,0,0,0,0,347,41,0,0,0,0,0,0,0,0,0,100
2d3c6e6ee0f5f8f7f73291f33e5580455522070f,1,1,2,1,0,0,0,3,5,2748,1,1,0,109,348,42,16,16,0,641,647,6,4,4,0,100
3647e4e2574fc1ea37bb1b0b2e1c535b9818e23f,2,28,30,2,0,0,0,5,95,2,2,2,0.216396932,1977,349,43,530,530,0,13063,13057,6,170,170,0,100
bb5503b1471b5ce5a2969d12451eced8c0c65b19,2,39,4,35,0,0,0,4,5,1377,1,2,0.693127415,248,350,44,31,30,1,1817,1664,153,17,16,1,100
5fd5de9fb8931548f98888abc2d577a4aea341ad,1,18,5,13,0,0,0,6,8,2749,1,1,0,43,351,45,14,7,7,167,124,43,4,4,0,100
0fc957a02be3c4ad2f862f1424e56717b0887917,4,25,39,14,0,0,0,5,40,689,2,3,1.260692411,1266,352,46,219,222,3,8202,8198,4,119,120,1,95.15902367
a68835381e0975aa1c75cd381e5e37d63b1d0db1,1,26,1,25,0,0,0,26,227,9,1,1,0,3948,353,47,1180,1174,6,28925,28844,81,345,345,0,100
683e78045cba80703154207a96e5935d64a076e1,1,4,0,4,0,0,0,21,79,11,1,1,0,1175,354,48,300,300,0,8254,8250,4,62,62,0,100
c7539a11715954db1b8d55789e386fa7dae0837f,0,0,0,0,0,0,0,0,0,0,0,0,0,0,355,49,0,0,0,0,0,0,0,0,0,100
59a8586855b23cc38cf0c79c4ab050f9f1de7bfd,1,73,13,60,0,0,0,21,80,2,1,1,0,1176,356,50,310,300,10,8547,8254,293,70,62,8,100
c89a94abd8d31eb5571a51764e97d7061ea7ea47,1,1,1,0,0,0,0,3,3,2762,1,1,0,65,357,51,5,5,0,304,304,0,3,3,0,100
d6a19dd56a020d2991129584dcf221262bff28d1,1,6,0,6,0,0,0,4,8,2649,1,1,0,280,358,52,37,33,4,1938,1890,48,11,11,0,100
bb214f93d4027c298a38eb679e97f6e8c2ed12d8,1,7,7,0,0,0,0,4,7,2760,1,1,0,86,359,53,7,7,0,592,592,0,4,4,0,100
2408ff7d9e4d8f16b29d3d393310680e6d93316f,1,2,1,1,0,0,0,3,6,20,1,1,0,73,360,54,3,3,0,488,475,13,3,3,0,100
d6a64bebcd275c1af8e9b9eebeb7ac741321c433,1,40,0,40,0,0,0,21,81,2,1,1,0,1219,361,55,321,310,11,8764,8547,217,71,70,1,100
3b51096dae69634322c8d92cb1f3317f3a25024a,1,5,0,5,0,0,0,6,8,2760,1,1,0,95,362,56,13,12,1,512,487,25,8,8,0,100
760765379264569a1a0cc6d4453f90a67d513a16,1,3,0,3,0,0,0,3,6,18,1,1,0,283,363,57,35,34,1,2022,1996,26,19,19,0,100
d5ac99d402df5129e686deee563106f9e66c11c1,0,0,0,0,0,0,0,0,0,0,0,0,0,0,364,58,0,0,0,0,0,0,0,0,0,100
eb2dbec1273e52d4258ed2b183106ca8d098ed94,2,51,2,49,1,0,1,1,46,20,2,2,0.313812964,922,365,20,246,244,2,8242,8054,188,53,51,2,99.99330163
919154ce690a4ec71810aab7679769071f9438a4,2,0,3,3,0,0,0,1,9,18,2,2,0.918295834,92,366,21,17,17,0,335,363,28,6,6,0,100
5b67ce51801cb646d772dadd03a623312603a0df,1,82,30,52,0,0,0,20,113,43,1,1,0,3478,367,20,741,741,0,27761,27383,378,139,139,0,100
a850031d11aa7fd18e6828c9cce4fa6b2809ffdd,1,30,82,52,0,0,0,21,114,4,1,1,0,3524,32,0,741,741,0,27383,27761,378,139,139,0,100
adf5ad393d6f9ad434ec6c2347098eb5e0994b51,0,0,0,0,0,0,0,0,0,0,0,0,0,0,368,6,0,0,0,0,0,0,0,0,0,100
7d3c89c5159fe78222f41bc528d789b68462f284,1,128,0,128,1,0,1,1,1,0,1,1,0,0,369,4,15,0,15,656,0,656,5,0,5,99.99330252
188ed235dc7c1e9db5b5f009d297fb297b4af1cf,1,22,5,17,0,0,0,1,2,0,1,1,0,106,370,5,17,15,2,775,656,119,5,5,0,100
d8bb07fe86f61a8d62c8701e425383d0cc3ba545,1,25,33,8,0,0,0,10,32,2483,1,1,0,169,371,6,27,27,0,1147,1135,12,7,7,0,100
90ba3b8d5df3ec2843e85d85edf258970dd6900b,3,27,8,19,0,0,0,7,23,81,1,2,1.527747365,1879,372,7,200,197,3,13870,13763,107,84,83,1,94.2576669
8f959cc3a543cc414e03d9f25e5a270396f943aa,1,6,3,3,0,0,0,8,25,81,1,1,0,289,373,8,49,49,0,1724,1648,76,25,25,0,100
b99e2dba29aa41bfe30ede461feb8c6ebd3801a5,1,27,20,7,0,0,0,17,51,2274,1,1,0,404,374,9,92,92,0,3119,2906,213,23,23,0,100
d8b3fd87ff111ab071a95dcc137fc340f7434b07,1,23,0,23,0,0,0,15,33,95,1,1,0,324,375,10,78,78,0,2600,2230,370,25,25,0,100
5dc56fa17b54cb9762f536e9ba42411c62baa9ed,1,28,20,8,0,0,0,4,13,87,1,1,0,411,376,11,88,88,0,3175,2955,220,25,25,0,100
d78bfc47cb505aad70f1d7380df11dfa65440a8e,1,2,37,35,0,0,0,10,54,82,1,1,0,2843,377,10,350,353,3,16717,16960,243,170,171,1,100
8e3b81521fd21243c52fe27ec0d7b3b5dd10462d,0,0,0,0,0,0,0,0,0,0,0,0,0,0,378,11,0,0,0,0,0,0,0,0,0,100
f8667f564d90a3087bded08c8d2ed600501a176e,3,22,10,12,0,0,0,7,36,82,2,3,1.133432101,1385,379,12,289,289,0,9168,9008,160,114,114,0,100
c780084ccdec85c1e98a3cf144f9e0e7bdf117fb,0,0,0,0,0,0,0,0,0,0,0,0,0,0,380,13,0,0,0,0,0,0,0,0,0,100
8e18fdbbbc29f39764f969168dcec58583721f39,3,22,4,18,0,0,0,9,47,967,1,2,1.105612401,2126,381,14,788,780,8,14947,14879,68,172,172,0,100
31d2d862b74bfdcc6088e3c078dfde0098b42423,2,17,16,1,0,0,0,21,82,33,1,1,0.32984607,1401,382,15,348,348,0,9940,9911,29,78,78,0,100
813154a570797b35a0c5d0469817775cd58ae525,1,7,3,4,0,0,0,5,24,80,1,1,0,384,383,16,19,18,1,2195,2169,26,10,10,0,100
cb4e47b82c5ebd308a4ff6f049c353b0dbfbcf2f,3,8,13,5,0,0,0,2,44,479,1,2,1.460721099,957,384,16,177,177,0,6354,6411,57,70,70,0,100
6a7addea165174ada761297d9213b2afcff904bd,1,14,12,2,0,0,0,17,59,85,1,1,0,827,385,17,180,180,0,5666,5628,38,57,57,0,100
f3c65f01ade84a50f6232cd4c279c4bd948ee14b,0,0,0,0,0,0,0,0,0,0,0,0,0,0,21,0,0,0,0,0,0,0,0,0,0,100
477d73a99682f4b029e1f52767e70a6061a04ad3,0,0,0,0,0,0,0,0,0,0,0,0,0,0,386,18,0,0,0,0,0,0,0,0,0,100
25af7c35ee04fd198e95a5e3767530852a432ee6,3,211,160,51,0,0,0,2,20,102,2,2,0.426509307,481,387,19,89,82,7,3127,2835,292,63,58,5,100
49116c7f8e1556b8aec4772409976ccba1172a85,0,0,0,0,0,0,0,0,0,0,0,0,0,0,388,19,0,0,0,0,0,0,0,0,0,100
e3fd21f0a204b5f196732fc594a16bf4baa65ccb,0,0,0,0,0,0,0,0,0,0,0,0,0,0,389,20,0,0,0,0,0,0,0,0,0,100
271e3e50cff8e4799eb9ae60acd249ab4fdbf9af,0,0,0,0,0,0,0,0,0,0,0,0,0,0,390,21,0,0,0,0,0,0,0,0,0,100
361da251a9a42e97c3752b7c4bf8064d574eceb9,0,0,0,0,0,0,0,0,0,0,0,0,0,0,391,22,0,0,0,0,0,0,0,0,0,100
f72f3ca7e07b539c2de3c31e3381e8f9c9216807,2,11,5,6,0,0,0,15,94,1215,2,2,0.337290067,831,392,23,176,173,3,5625,5575,50,51,51,0,100
64d82535788e5dd0bd38f5652524a21fc3a0e2b9,0,0,0,0,0,0,0,0,0,0,0,0,0,0,393,24,0,0,0,0,0,0,0,0,0,100
8f79c8aba8ec647c3bc7d148b76b39b0d53bb45d,0,0,0,0,0,0,0,0,0,0,0,0,0,0,394,25,0,0,0,0,0,0,0,0,0,100
9c95b71fcc88ce7e3b08054c8c30cd80e5a89aa1,0,0,0,0,0,0,0,0,0,0,0,0,0,0,395,26,0,0,0,0,0,0,0,0,0,100
61540f00c4bb51c623f2b33a6d12fded14d61d7a,1,6,3,3,0,0,0,26,228,91,1,1,0,3966,396,27,1180,1180,0,28925,28925,0,345,345,0,100
6eb984a3752c26998d7a2098376bda4221648459,0,0,0,0,0,0,0,0,0,0,0,0,0,0,397,28,0,0,0,0,0,0,0,0,0,100
eec95cd6cb0a30d94b80f0eaf7b2b6838bdaf415,0,0,0,0,0,0,0,0,0,0,0,0,0,0,398,29,0,0,0,0,0,0,0,0,0,100
6546f259b25d211e60a810c62a53010adfc719f7,0,0,0,0,0,0,0,0,0,0,0,0,0,0,399,30,0,0,0,0,0,0,0,0,0,100
bdf3f0a543a02a9ffdd554a8e184b7bbdcf628d0,0,0,0,0,0,0,0,0,0,0,0,0,0,0,400,31,0,0,0,0,0,0,0,0,0,100
6f721f69c93f9c48027837da31a9e2e6f1603647,0,0,0,0,0,0,0,0,0,0,0,0,0,0,401,32,0,0,0,0,0,0,0,0,0,100
ba985ac8c7c1a02b2b999ff33567910bf536cb66,0,0,0,0,0,0,0,0,0,0,0,0,0,0,402,33,0,0,0,0,0,0,0,0,0,100
4894c17c0799ae4c86be6b996ca99799edbfab6a,2,164,15,149,1,0,1,15,75,77,2,2,0.945249467,312,0,0,75,56,19,2716,2064,652,29,18,11,99.99178037
2771cce607663ce19f87cf60f068bcc45eefe24d,1,2,18,16,0,0,0,1,2,2,1,1,0,92,1,1,10,12,2,465,527,62,10,10,0,100
722eb579eaef5e3afedf97aa20be330126ff3ac3,0,0,0,0,0,0,0,0,0,0,0,0,0,0,53,0,0,0,0,0,0,0,0,0,0,100
1742f62032e669b65790e6e9bef28307fc8d2cab,1,188,115,73,0,0,0,14,67,2057,1,1,0,371,403,0,0,0,0,2198,2198,0,0,0,0,100
f8d258594f55cdf06db16f2321a6ae6c6342616e,3,61,70,9,1,0,1,1,3,987,1,3,1.235978568,95,404,1,7,6,1,309,323,14,6,6,0,99.96712419
c6f42826b72940aa771a394d42173b2f7fec0428,3,16,33,17,0,0,0,16,49,555,1,3,1.529786509,2136,405,2,538,543,5,13703,13795,92,140,140,0,100
745795b1d9b8481088c656128ce50f3967495493,0,0,0,0,0,0,0,0,0,0,0,0,0,0,406,3,0,0,0,0,0,0,0,0,0,100
5801f419c0e7df6be74bc96e9366303cf7b1293d,0,0,0,0,0,0,0,0,0,0,0,0,0,0,407,4,0,0,0,0,0,0,0,0,0,100
c5b97348fcfcb77d1a0c00813bc4c18bf85140f7,2,24,9,15,0,0,0,11,29,2962,1,1,0.967294779,452,408,5,91,89,2,2704,2657,47,39,38,1,100
116eda990351130f70ec384c182efecd36b26977,3,119,67,52,0,0,0,12,112,1210,2,2,0.34955485,3459,0,0,1112,1101,11,23821,23503,318,283,281,2,100
d698ccaf00ccffd2a15430363885dafbe5a66ae9,1,15,4,11,0,0,0,16,81,0,1,1,0,1705,1,1,566,564,2,10768,10736,32,186,186,0,100
a0e40795ff786ca74d2f63b9f5956332c0114856,4,58,2,56,1,0,1,1,82,1521,2,3,1.344595135,1972,2,2,606,600,6,12286,12117,169,220,216,4,99.99178172
b2a95194349ea1cae59211247a12560a26b64f0c,6,64,183,119,0,0,0,11,111,2346,3,4,1.27785628,3818,409,0,1135,1154,19,24852,25371,519,311,317,6,99.99178172
30c443dcc32fdc43b75431c9579f8ca415421d17,2,94,1,93,1,0,1,6,15,298,2,2,0.603215407,120,9,0,40,32,8,1375,977,398,14,10,4,95.86910679
0fa0ee9790e1246934b9a553bf55e0a658b0e5c3,0,0,0,0,0,0,0,0,0,0,0,0,0,0,54,0,0,0,0,0,0,0,0,0,0,100
9113461cb98d2c608ad6cf4d703521a1d1780fec,2,93,4,89,1,0,1,1,83,259,2,2,0.595467051,1241,19,0,328,321,7,9089,8793,296,75,71,4,99.99305073
6be0f5b061887bdfee948044d28bae4673204b1e,1,2,0,2,0,0,0,1,2,1908,1,1,0,69,33,0,10,10,0,384,362,22,7,7,0,100
3b6a69e9f0d041b034ce11d934d7321732d069c8,0,0,0,0,0,0,0,0,0,0,0,0,0,0,55,1,0,0,0,0,0,0,0,0,0,100
1fdf245200fc839d25d59a637994c62173429bd2,1,10,4,6,0,0,0,1,6,1032,1,1,0,336,56,2,68,65,3,2355,2331,24,20,20,0,100
08fe2742c1879858f955c74919c3f047c0d74fff,6,186,67,119,1,0,1,12,112,1570,3,4,1.258039568,3718,3,0,1154,1135,19,25371,24852,519,317,311,6,99.9930517
8ff3dff49b4754205315df0d144e2e9da1fe6880,1,9,2,7,0,0,0,16,83,317,1,1,0,1713,4,1,570,568,2,10805,10776,29,186,186,0,100
cb258aee424374a79b9d4fd7728d5ee5eb2cdc17,0,0,0,0,0,0,0,0,0,0,0,0,0,0,57,3,0,0,0,0,0,0,0,0,0,100
4d932bc787ffaa4b8a79b44366b5ec80f58b9dda,0,0,0,0,0,0,0,0,0,0,0,0,0,0,0,0,0,0,0,0,0,0,0,0,0,100
fe423839f134be2d6a13fcbc3e4d91961b869340,1,32,5,27,0,0,0,8,35,3462,1,1,0,300,0,0,53,48,5,2095,1940,155,15,14,1,100
ad5f05112a06dbd0592f4bd158900037e32f2ccd,1,24,13,11,0,0,0,8,36,0,1,1,0,322,1,1,55,53,2,2108,2095,13,15,15,0,100
3e9644d990cb5dd182303bd048622cae5f1f3882,0,0,0,0,0,0,0,0,0,0,0,0,0,0,2,2,0,0,0,0,0,0,0,0,0,100
e7774e32948015cfd8de665e18a091eb2e4564bd,0,0,0,0,0,0,0,0,0,0,0,0,0,0,58,0,0,0,0,0,0,0,0,0,0,100
cc55aec97d5f5050ba0299ed081a56c7b208465d,0,0,0,0,0,0,0,0,0,0,0,0,0,0,59,1,0,0,0,0,0,0,0,0,0,100
720869a4e0470265afb67def2e33b9c7e5801a0a,3,71,59,12,0,0,0,11,103,1677,2,2,1.230244429,3489,20,0,1021,1009,12,21918,21757,161,266,262,4,99.99305218
e15296c4151fdaf3d807ec7ef784a0bfaf15cc5f,10,177,35,142,0,0,0,5,33,2002,2,7,1.57808639,1627,21,1,195,183,12,10621,10333,288,69,67,2,94.85056232
468a4538fa0446dd24da3916f92041163540385e,0,0,0,0,0,0,0,0,0,0,0,0,0,0,22,2,0,0,0,0,0,0,0,0,0,100
000c065dbe8ceb4589fc1f789a37b8d68af6311e,0,0,0,0,0,0,0,0,0,0,0,0,0,0,60,0,0,0,0,0,0,0,0,0,0,100
68b77e1ae7a078fa336d42b0ea6bf1c9b6e65dca,0,0,0,0,0,0,0,0,0,0,0,0,0,0,61,1,0,0,0,0,0,0,0,0,0,100
6d7ee9ba59688db6d2841252a847a2ed63f36786,0,0,0,0,0,0,0,0,0,0,0,0,0,0,2,0,0,0,0,0,0,0,0,0,0,100
e5c29f431807e8083951ff1b9209072326f4c636,0,0,0,0,0,0,0,0,0,0,0,0,0,0,3,1,0,0,0,0,0,0,0,0,0,100
f228d2c259f23fd17a328f719f2908cdc9ff6f52,1,6,0,6,0,0,0,27,229,908,1,1,0,3966,34,0,1182,1180,2,28971,28925,46,345,345,0,100
a605d872e5b4d929d1f4864eba3aa8aebcee35a7,1,1,1,0,0,0,0,11,41,1017,1,1,0,859,35,1,373,373,0,6630,6630,0,35,35,0,100
641dfd947ecde452816c2af7ea26c8673d3a140a,0,0,0,0,0,0,0,0,0,0,0,0,0,0,62,0,0,0,0,0,0,0,0,0,0,100
e5933d6aeed8463b01d1a075d611e336aacddc72,0,0,0,0,0,0,0,0,0,0,0,0,0,0,36,2,0,0,0,0,0,0,0,0,0,100
c3da147fc922dcd56c3a62c951bebac0d870d8cd,0,0,0,0,0,0,0,0,0,0,0,0,0,0,37,3,0,0,0,0,0,0,0,0,0,100
aed0e58f129eecba5beb3e13b265dc23a22ee169,0,0,0,0,0,0,0,0,0,0,0,0,0,0,23,0,0,0,0,0,0,0,0,0,0,100
0be08390d5b2c69573b424a3b9b5ed52bb1551cc,0,0,0,0,0,0,0,0,0,0,0,0,0,0,24,1,0,0,0,0,0,0,0,0,0,100
6aec10a41bf3913b7784b6f83fd252ec7048184a,0,0,0,0,0,0,0,0,0,0,0,0,0,0,0,0,0,0,0,0,0,0,0,0,0,100
e7cd6f65628a3741dad149dd3c0254b684255630,0,0,0,0,0,0,0,0,0,0,0,0,0,0,0,0,0,0,0,0,0,0,0,0,0,100
57f300b1da76b3b98b718414243b05fce996b758,2,35,37,2,0,0,0,2,3,2076,1,2,0.41381685,209,1,0,14,13,1,1452,1424,28,10,10,0,100
05069dfee47724ec263a3bbc1c84c12739f241e4,0,0,0,0,0,0,0,0,0,0,0,0,0,0,2,0,0,0,0,0,0,0,0,0,0,100
d9ceb44526dc60d8be91b39c92d9d606a9c07c54,2590,11493,11304,189,13,0,13,3,168,2553,13,263,10.73550566,262749,410,0,36171,36183,12,1424560,1424600,40,22295,22308,13,96.02550397
3a436b585da4e0f2acf3a2583834c0f12cae0bbb,6,26,26,0,0,0,0,5,8,0,1,2,2.231947046,488,411,1,38,48,10,2583,2791,208,25,35,10,99.95896314
9a87badd3becc9898fb1048936420038bfc210d2,1,14,8,6,0,0,0,2,6,3,1,1,0,136,412,2,8,7,1,1006,909,97,1,1,0,100
6fc05e14d00c23e3684256e5e6e63d1f71c32ecf,11,73,5,68,0,0,0,8,84,4040,2,5,3.27065711,4349,413,3,1284,1260,24,23129,22784,345,509,502,7,100
4ec4598ad1549039022a919d9c2db46722c45641,31,110,41,69,0,0,0,3,49,717,3,16,4.485326138,8565,414,4,1670,1197,473,52193,50796,1397,664,551,113,99.61355631
487159da3bc5404a39e87a883410405e1ef39b02,3,393,13,380,1,0,1,10,50,1672,1,1,1.058307665,1440,415,5,323,282,41,13714,11653,2061,84,68,16,99.98632151
65242c70b7296c581c98df5e5d4471846c879fec,1,270,135,135,0,0,0,10,51,1,1,1,0,1537,416,6,309,293,16,13753,12767,986,74,71,3,100
94a2bf97be80bfc8607472d6b94d8b7ee22250c4,1,108,104,4,0,0,0,10,52,0,1,1,0,1648,417,7,313,309,4,13685,13753,68,77,74,3,100
87458c708bc3971763f9dc79153b9ac8aee66c8c,1,175,126,49,0,0,0,10,53,0,1,1,0,1637,418,8,314,313,1,13987,13685,302,78,77,1,100
12f780eb763d0e7a39faf74d4fdb58af0f7094d7,3,649,179,470,2,0,2,1,54,0,1,2,1.099780604,1667,419,9,378,314,64,16998,13987,3011,90,78,12,99.98632479
8f9547b643421dcd88975e2ac4a283b11cace51b,4,252,806,554,0,0,0,7,55,573,1,3,0.592884925,2811,420,10,421,479,58,19878,23505,3627,185,193,8,99.98290774
ec946b6789184a3be7ffe7d18f59bcac4238e08e,1,152,1,151,0,0,0,10,56,1,1,1,0,1396,421,11,287,277,10,13616,12328,1288,72,71,1,100
7532498e7ac8eda4fa38c5757daf56414b56180e,2,24,10,14,0,0,0,7,57,1,1,2,0.672294817,2269,422,12,394,389,5,19914,19875,39,162,162,0,100
ecff638a02f4bc2f1357857318657325e7d8da1e,1,20,13,7,0,0,0,10,58,0,1,1,0,1530,423,13,292,292,0,13685,13657,28,72,72,0,100
2535a24d55ac9ef70837b151dc50c0682ba225eb,2,22,1,21,0,0,0,7,15,4,1,2,0.886540893,817,424,14,116,112,4,6648,6574,74,97,94,3,100
0ddc38512d690bd18ea37103c6b78f5fa48127a3,1,1,1,0,0,0,0,5,10,5025,1,1,0,69,425,15,9,9,0,372,372,0,5,5,0,100
14239329784a1b1ef2e05144457c13cc296867eb,0,0,0,0,0,0,0,0,0,0,0,0,0,0,426,16,0,0,0,0,0,0,0,0,0,100
a84728ccb17aa86f7b77f00b1316df1a0ef1ee0a,0,0,0,0,0,0,0,0,0,0,0,0,0,0,38,0,0,0,0,0,0,0,0,0,0,100
2ab2746f7793e65968309520bf2ec0fe36a430ff,2,7,107,100,0,0,0,5,18,2542,1,2,0.999777967,280,427,12,33,39,6,1040,1371,331,22,24,2,99.42512717
f19ba018e23ddbf8cdc1eef6d505340b705b257b,2,7,52,45,0,0,0,3,8,2496,1,2,0.999792766,81,428,13,5,6,1,166,264,98,4,4,0,99.98934281
39c838a56f00eea3a234698c2b9a2b3587a2178e,6,202,73,129,2,0,2,4,33,2079,2,5,2.083401147,1322,429,12,263,254,9,11532,11047,485,79,70,9,99.98223927
972f34d85fa9dad3b6991a0a7386d479fbb8e99c,0,0,0,0,0,0,0,0,0,0,0,0,0,0,430,13,0,0,0,0,0,0,0,0,0,100
b238417dabeac935846fe1ce2fef28aafaeef205,2,5,3,2,0,0,0,3,24,1189,2,2,0.811278124,866,431,14,78,78,0,7775,7772,3,39,39,0,100
b51d003ed98aa7663465aad7c9a1b554b006cc7d,9,105,23,82,0,0,0,4,115,1669,3,8,2.137621323,7129,432,5,1633,1624,9,54990,54503,487,404,398,6,99.97869091
31681982de16a3496e0ebb6aa1efa3901ac6e6ef,6,470,176,294,1,0,1,1,116,2990,2,4,2.093408981,4153,433,6,970,912,58,33173,31637,1536,207,195,12,99.99289874
2c3d37e859a125d7521884cee711c03535731964,2,74,43,31,0,0,0,5,117,2,1,1,0.421166015,3802,434,7,823,826,3,29944,29811,133,157,155,2,100
3ea2412003028d37f2a69971a47bb20abf589f8b,4,109,62,47,0,0,0,1,118,0,2,3,1.784984019,4100,435,8,887,884,3,31884,31623,261,175,173,2,100
d13b85b13940726dc1faae89ba1f8807a24b0f49,3,6,24,18,0,0,0,1,119,12,2,2,0.985171747,3933,436,4,828,829,1,30450,30589,139,162,163,1,100
032c6fc7fedb9ae6230a6730cdf7ffb4246119e7,6,112,23,89,1,0,1,8,120,798,3,5,2.049312832,4606,437,5,1034,1028,6,35663,35289,374,216,211,5,99.99290075
f2d27aa15fca7c04f47dfca3770948f3015e17ad,1,52,55,3,0,0,0,21,121,0,1,1,0,3616,438,6,779,779,0,28659,28613,46,144,145,1,100
80272a3bf711c96f45d93ff695ba69bc673545a3,1,27,18,9,0,0,0,21,122,0,1,1,0,3618,439,7,779,779,0,28793,28659,134,144,144,0,100
4c7c81d24958486624ade83a1cc104b34fe51949,1,217,40,177,0,0,0,21,123,14,1,1,0,3623,440,7,790,779,11,29487,28793,694,147,144,3,100
972b5d0e62451b6b79ea82d4e7fd57c93f77835f,1,69,38,31,0,0,0,21,124,0,1,1,0,3749,441,8,792,790,2,29769,29487,282,148,147,1,100
6164d355a69a111943928e6ecf9225505e3132c7,1,21,17,4,0,0,0,21,125,0,1,1,0,3773,442,9,792,792,0,29803,29769,34,148,148,0,100
cd194bb72e75e3ab1a47d486e9cbd129eefc6175,4,825,552,273,0,0,0,4,126,56,2,3,0.06566668,5097,443,8,1112,1091,21,42405,41167,1238,216,211,5,100
03f2d6ae88b537d1bed34b78443e14f8af15af8c,1,49,68,19,0,0,0,21,127,0,1,1,0,3968,444,9,809,813,4,31062,31041,21,152,153,1,100
d8d829b76b550cc8d79824566ce363db2fc23d9f,1,144,36,108,0,0,0,21,128,0,1,1,0,3961,445,9,823,809,14,31654,31062,592,155,152,3,100
3a667fe78adb6bd87ef19cfd9302d72d378c1dd1,3,194,23,171,0,0,0,4,129,1713,3,3,0.237374061,4128,446,10,849,838,11,33104,32041,1063,165,164,1,100
f0fe08baaa4626e9d1cc67c207b0278eb4169566,1,2,0,2,0,0,0,21,130,0,1,1,0,4136,447,11,834,834,0,32739,32717,22,156,156,0,100
810f85ff9f6a8aa3962270cd9929ad1396b67dbe,2,53,346,293,0,0,0,3,131,24,2,2,0.286929041,4179,448,12,795,837,42,31386,32880,1494,151,158,7,99.98580302
50bfc57833dd932e48eb4ebfae4ad8f4bd6bf3cb,1,52,21,31,0,0,0,21,132,2,1,1,0,3935,449,13,799,792,7,31388,31157,231,151,149,2,100
1a287b267f86079aa79348e9d24f93469522d07a,6,175,62,113,2,0,2,5,133,430,2,6,2.28263142,6300,450,14,1470,1461,9,47941,47537,404,357,349,8,99.98225755
a95530b4e6bc00a82077313c7aa876ec1cf12f75,1,34,43,9,0,0,0,21,134,8,1,1,0,3952,451,11,799,799,0,31290,31370,80,151,151,0,100
92bb3b055ae4f882b10a197b012c0a1a3449a4cf,3,314,92,222,0,0,0,3,135,815,2,3,1.077969679,4250,452,12,950,882,68,34482,33381,1101,179,170,9,100
94d18740199e16e0b41dff324770f6b442142155,3,163,66,97,0,0,0,10,136,61,2,3,1.203923183,4415,453,10,964,935,29,35384,34326,1058,182,181,1,100
77d8a8e05b3b22d598c4061c56bdb726e67f8d9c,2,126,141,15,0,0,0,10,137,2,2,2,0.280802198,4079,454,11,821,819,2,33075,32541,534,162,162,0,100
9065ae7201eaba7a2a1e005df9118cca6ea1cf4d,1,32,28,4,0,0,0,21,138,0,1,1,0,3959,455,12,813,813,0,32722,32592,130,154,154,0,100
5d781bd6dce4d7b2db0e7a85b7eb91aeb2a0e023,1,60,46,14,0,0,0,21,139,1,1,1,0,3963,456,13,813,813,0,32787,32722,65,154,154,0,100
ae4964cc457e5a122206182fa8206eeda7ba8437,1,13,10,3,0,0,0,21,140,0,1,1,0,3977,457,12,813,813,0,32850,32787,63,154,154,0,100
a40b718b03005be89c56b1cf361fadfce8ca29ab,2,481,136,345,0,0,0,1,141,11,1,2,0.109857225,4405,458,8,1003,958,45,38594,35693,2901,175,174,1,100
5d63179b480a152b4e56d21c7f059b0c1727fa55,1,174,118,56,0,0,0,21,142,0,1,1,0,4272,459,9,857,856,1,36257,35709,548,155,155,0,100
4b6a38ec1bea4ae3b961f3ecc2186d90a79a5c29,2,95,270,175,0,0,0,1,143,1,1,2,0.152077163,4748,460,10,967,1004,37,37721,39142,1421,175,175,0,100
5e89853664d46ed7505efd37a3eddcc53d110e38,1,35,92,57,0,0,0,21,144,0,1,1,0,4147,461,11,809,818,9,34124,34797,673,154,155,1,100
2b9b024f273d63e479a02cad751c28b8ef974ace,2,286,169,117,0,0,0,1,145,20,1,2,0.269828448,4548,462,9,976,958,18,38096,37048,1048,179,174,5,100
e718fc8b5133ae1bcc3f43442bc9f2644e49359f,3,60,36,24,1,0,1,1,12,955,1,2,1.198940544,654,463,10,188,188,0,4292,4245,47,33,33,0,99.98226133
58db135c5eb430edbc657a47d3c186fb51e0c1e7,2,255,152,103,0,0,0,1,146,23,1,2,0.379618825,4623,464,2,996,976,20,39121,38121,1000,180,179,1,100
d7571386696353fd43e999d2a5a0b3f5631cc285,1,0,31,31,0,0,0,21,147,0,1,1,0,4224,465,3,824,833,9,35607,35760,153,157,158,1,100
7700fdfd45d0f1995d7e4592d5a8c6c713c05faa,1,43,42,1,0,0,0,21,148,2,1,1,0,4198,466,4,825,824,1,35629,35607,22,157,157,0,100
62b14584fbf6781164f5a01f8784cf79a0e493a6,2,329,448,119,0,0,0,1,149,3,1,2,0.074149484,4677,467,5,962,988,26,39054,38990,64,170,179,9,100
4d505987c39858af3431768189c28204c59536d8,1,135,138,3,0,0,0,21,150,0,1,1,0,4123,468,6,797,797,0,35785,35652,133,147,148,1,100
fb20da5063e79bfc91214abdaff1acc718c69405,1,64,161,97,0,0,0,21,151,2,1,1,0,4120,469,7,779,797,18,35377,35785,408,145,147,2,100
0ab02d696593b1507e0fcfdbfd2af50e1ed5e74b,2,24,25,1,0,0,0,3,152,39,2,2,0.73001663,4150,470,8,801,802,1,36077,36016,61,150,151,1,99.9893568
a25ad4fc95bc0d23ba22634a771c330df363017b,3,101,111,10,0,0,0,3,153,1038,1,3,1.000949949,4739,471,9,971,976,5,39478,39407,71,196,196,0,99.97161913
96a64bcebaf921c7f25053040ba9a18e1cac62a9,3,61,140,79,0,0,0,3,154,0,1,3,1.057769859,4732,472,10,960,971,11,38918,39478,560,194,196,2,100
bcb00d890976ac19e7969858aba3ed235ebcfea9,4,10,14,4,0,0,0,8,155,659,2,3,1.492754192,4364,473,10,823,823,0,37450,37450,0,154,154,0,99.98581057
11367cfbeae7e71c22804fc7c1040989388ea5cb,7,77,67,10,0,0,0,8,156,63,2,4,1.907872666,5073,474,10,1024,1024,0,42027,41939,88,191,190,1,99.98580906
37c114c7241db3c9e5842855718941b95c487de3,9,14,25,11,0,0,0,4,157,645,5,8,2.80094445,5882,475,11,1138,1138,0,48456,48522,66,368,368,0,99.96094443
a494966e8b04e1a31f9895947f7b4ac68d4f888b,2,9,9,0,0,0,0,2,27,0,1,2,0.99107606,389,63,0,82,82,0,2587,2587,0,18,18,0,100
86c266df7a2d2840c0f413ef3ea70741ae1bef3a,13,212,331,119,1,0,1,8,158,1461,4,8,2.577243528,7855,476,12,1540,1570,30,60455,60896,441,414,416,2,99.98223927
eabceb69f43f28e2ac2698bc40e1044dd3f80331,6,71,550,479,0,0,0,3,22,975,1,4,2.162464963,1148,477,13,226,274,48,5137,6816,1679,37,79,42,99.94315154
eba1637454cf1cfa25903f8ab6eb5dda14da3750,5,237,16,221,3,0,3,1,159,0,1,3,2.0947807,4491,478,14,951,932,19,39118,38356,762,177,166,11,99.97512349
b5a6424f2b4e867c99335fded8f5f5d2c7209708,2,10,1,9,0,0,0,1,160,70,1,2,0.684038436,3993,479,15,764,762,2,34907,34861,46,145,144,1,100
f26fa179cc831ec570340aac77b961929934235e,1,217,170,47,0,0,0,21,161,0,1,1,0,3961,480,16,760,759,1,34894,34779,115,142,141,1,100
dfaf8da48e9d01af1911cb6effb5362013e03d14,6,30,9,21,0,0,0,1,162,0,1,3,1.964894762,4840,481,17,981,972,9,40009,39904,105,187,185,2,99.95736517
0a81c3de7b8c590bf54b9d4138c51744684d369a,11,209,134,75,0,0,0,8,163,282,4,6,3.008770144,5812,482,18,1166,1151,15,47207,46834,373,258,249,9,99.98223296
b4bc2c4965487298bdf825508e0f416f97f1bc3b,27,0,55,55,0,0,0,4,164,1121,4,19,3.674266071,8160,483,19,1292,1294,2,60246,60616,370,367,368,1,99.98578334
6eeb025cf3e771da8461633813e1926d912d2aab,8,115,433,318,0,0,0,4,165,326,2,5,2.197253662,5166,484,20,988,1041,53,41487,42719,1232,195,213,18,99.98933599
f83cb62c54e7401c8161c7ba513a941963055468,1,3,9,6,0,0,0,9,24,0,1,1,0,183,485,21,26,26,0,1626,1651,25,9,9,0,100
bc63865aac831946f17b4b12a771e09d8226eaad,3,38,28,10,0,0,0,1,166,1,2,2,0.869334232,5514,486,22,1172,1170,2,45637,45431,206,264,264,0,99.99644508
b04c985956815dc3c50d2593c075197a6120ee73,1,4,5,1,0,0,0,9,25,0,1,1,0,180,487,23,26,26,0,1594,1626,32,9,9,0,100
60ccb2605072307ddf123e499c458a34685d8e17,7,580,381,199,0,0,0,4,25,2644,2,5,1.447709546,1689,488,24,204,194,10,15177,13222,1955,109,104,5,98.59266396
9244250865277711aa95f6a9a379c1a3acc4fe4d,4,119,92,27,0,0,0,1,167,6,1,3,1.272482838,5608,489,25,1028,1028,0,48930,48588,342,211,211,0,100
279412c71a2b9ef93d3452db6640cc47b0eb0f7c,2,85,40,45,0,0,0,1,24,0,1,2,0.781481493,807,490,26,197,194,3,6219,6006,213,36,35,1,100
a8cb9d9d3d0ff07032a8d68b2712c2b46daa6d4b,1,28,20,8,0,0,0,5,14,0,1,1,0,266,491,27,16,16,0,2437,2331,106,10,10,0,100
71b0f0b2c63d1f84b88c9598f996fd9258eabec1,1,21,18,3,0,0,0,5,15,0,1,1,0,276,492,28,16,16,0,2466,2437,29,10,10,0,100
f1993f14628580737bfa0f4b46238d2c72ccee43,1,37,73,36,0,0,0,5,16,0,1,1,0,278,493,29,13,16,3,2212,2466,254,9,10,1,100
f009f39150c3d8f30dd601a4048580ded5f0bddd,1,0,50,50,0,0,0,1,4,14,1,1,0,32,494,30,0,1,1,0,97,97,0,1,1,99.99333156
c75e666452b386535c98baee3b481be07b272c8e,1,1,16,15,0,0,0,6,20,2,1,1,0,424,495,31,60,61,1,3557,3638,81,24,25,1,100
e62e7eaa7c656ee5c900395c5d450dc30d642467,1,175,160,15,0,0,0,8,27,2,1,1,0,849,496,32,74,77,3,8376,8089,287,35,36,1,100
1fa918c8611c4f3a774e126d22f90912b0b92d6f,2,305,127,178,0,0,0,1,28,0,1,2,0.042565916,1418,497,33,264,255,9,13652,12264,1388,64,61,3,100
07edae25bf11bd496fcc94bebbc57cd5f6e27f75,1,79,165,86,0,0,0,8,29,0,1,1,0,994,498,34,79,83,4,8978,9764,786,35,38,3,100
8759f6fa7eebb4ed3f5a1cc7d0aa5e8c12197bbc,1,206,134,72,0,0,0,8,30,1,1,1,0,923,499,35,80,79,1,9585,8978,607,35,35,0,100
1f8db2ade4bb46ab42ca1f2602e76545cdaebac2,1,0,25,25,0,0,0,8,31,0,1,1,0,981,500,36,76,80,4,9461,9585,124,33,35,2,100
0ea92f44a4e2044d6c76461a3396f66f741ffc6e,1,28,20,8,0,0,0,8,32,0,1,1,0,966,501,37,76,76,0,9560,9461,99,33,33,0,100
bb11f022d8ad03c1289d0d65d08201969132ca46,2,19,69,50,0,0,0,1,33,0,1,2,0.999627371,1534,502,38,252,257,5,13155,13448,293,57,59,2,100
0729141c31e8aad297b0cdc7cfb651363e84dfd9,2,1,14,13,0,0,0,4,56,3896,2,2,0.566509507,873,503,39,155,157,2,5311,5357,46,87,87,0,100
a1e46a10c68c8176cda82db3d1b60e97ca412b75,0,0,0,0,0,0,0,0,0,0,0,0,0,0,504,38,0,0,0,0,0,0,0,0,0,100
33372a718ef48243f7774af43c4172d8407dfe18,2,19,1,18,0,0,0,4,30,4111,1,2,0.970950594,525,25,0,149,146,3,3900,3804,96,49,47,2,100
815ef2349f5857f1ad017020d6d84f60261839cd,7,192,34,158,1,0,1,4,168,335,2,3,2.300190271,5258,505,0,880,855,25,46643,46080,563,208,188,20,98.59261553
dd30243f6bc8597b0771deb7cadd69f780e5acf9,0,0,0,0,0,0,0,0,0,0,0,0,0,0,39,0,0,0,0,0,0,0,0,0,0,100
65eab774b3d41f978174a8777018e0f1c105d996,0,0,0,0,0,0,0,0,0,0,0,0,0,0,3,0,0,0,0,0,0,0,0,0,0,100
