CommitID,NMF,TotalAddLines,TotalDeleteLines,LC,FileAdd,FileDelete,NAD,NDEV,NUC,AGE,NS,ND,Entropy,LT,EXP,REXP,CommitComplexity,LastCommitComplexity,CFC,CommitTokenCount,LastCommitTokenCount,NCC,CommitMethodNum,LastCommitMethodNum,NMC,a2a
3a0eb19f5734812a4e4a183ad5cf02de119cdb78,2,155,3,152,1,0,1,1,2,0,1,2,0.36450491,111,1,1,38,24,14,1810,868,942,18,14,4,95.89041096
3e7b981ceafde349a8124a2b4beb6701b0236fa9,1,5,8,3,0,0,0,1,2,1,1,1,0,36,2,2,4,6,2,267,273,6,3,3,0,100
6abafa19cea144df49c035839f2ff408aa60662a,1,3,0,3,0,0,0,1,2,1,1,1,0,71,3,3,16,15,1,586,567,19,5,5,0,100
d349f43086617e40515ffc4683993d35e84b421c,4,211,10,201,2,0,2,1,2,0,1,3,1.690161927,525,4,4,123,96,27,5736,4547,1189,87,72,15,98.33948339
4e1e08bd1b0ed25d7c0c393337caf2cb07ce1e33,7,83,21,62,1,0,1,1,2,0,1,3,1.941467763,369,5,5,80,71,9,2930,2698,232,57,48,9,97.35349716
5a00c2dafa559380bdadcc7879dc6d9f454d469d,2,53,1,52,1,0,1,1,2,1,1,2,0.605186577,12,6,6,2,0,2,356,127,229,2,0,2,99.22330097
4444ba02bbbd2379a43fc94260599a7539b3f24d,14,557,60,497,5,0,5,1,2,0,1,4,3.486873033,485,7,7,161,74,87,6486,3726,2760,76,44,32,88.4341637
710270cc63f2e6807b55967cf1a6384b93566f16,3,43,3,40,1,0,1,1,3,2,1,2,0.807670206,370,8,8,66,65,1,3224,3013,211,52,51,1,99.67105263
000540e2f973e11fab6a86d01efe7500b4d4848b,2,20,6,14,0,0,0,1,2,4,1,1,0.779349837,148,9,9,20,17,3,1644,1573,71,10,8,2,100
ba1b2629f365f6ad9bba26a9d9b07ebf08aefc20,16,662,127,535,2,0,2,1,4,0,1,8,3.060716498,1416,10,10,349,270,79,14882,10992,3890,229,178,51,90.43062201
7bb1fde81342f082745969a53618cb4541273c83,4,72,12,60,1,0,1,2,5,2,1,4,1.423461236,614,0,0,128,111,17,5685,5145,540,86,81,5,90.77901431
ba9cdef5f15d3402f259e32786a9cb961f95c171,31,181,785,604,1,0,1,1,3,0,1,12,3.687114388,3066,10,10,478,569,91,19889,24256,4367,303,358,55,89.46395564
4bf4b4342fc775c8ff5877c491e2b4dbf6ce0829,16,662,127,535,2,0,2,1,4,0,1,8,3.060716498,1416,12,12,349,270,79,14882,10992,3890,229,178,51,86.64047151
2b9052a6cf513fa29c292541e0542643cb3566be,17,128,63,65,1,0,1,2,6,0,1,7,3.545374384,1837,1,1,327,324,3,15363,14814,549,213,211,2,88.27586207
b9e2270251791f6040ee64b3597703757f4328c2,1,11,0,11,1,0,1,1,1,0,1,1,0,0,2,2,0,0,0,12,0,12,0,0,0,99.67320261
1c8c93f0ae98695faaf87e1a55ed1ca6ae7fc8db,1,88,7,81,0,0,0,1,2,0,1,1,0,3,3,3,6,0,6,625,12,613,4,0,4,90.93904448
7e43a1de2a14e63e549a3d4a7a1dd288c03c5224,13,46,55,9,0,0,0,1,3,0,1,5,3.075519669,1122,13,13,204,199,5,8770,8707,63,124,123,1,94.65081724
71eb3fc604f08e2266cebc4b9edc33b359f5c544,2,35,2,33,1,0,1,1,2,7,1,2,0.877962001,45,14,14,10,6,4,578,382,196,5,3,2,99.33244326
4851af222f2ed7c065598d2df9cfcb2ca521b783,0,0,0,0,0,0,0,0,0,0,0,0,0,0,15,15,0,0,0,0,0,0,0,0,0,100
2fb492a49c5393268244951577379ddd13846abf,0,0,0,0,0,0,0,0,0,0,0,0,0,0,16,16,0,0,0,0,0,0,0,0,0,100
79f1c295298045cbb14f399cec15616a82ca288d,0,0,0,0,0,0,0,0,0,0,0,0,0,0,17,17,0,0,0,0,0,0,0,0,0,100
9501ce26a401fc2fcf108bb9454f0c036b4462e3,0,0,0,0,0,0,0,0,0,0,0,0,0,0,18,18,0,0,0,0,0,0,0,0,0,100
ab95e96315fcc4b90b344c7551fada0cf924eb19,0,0,0,0,0,0,0,0,0,0,0,0,0,0,19,19,0,0,0,0,0,0,0,0,0,100
48eb72ac6d00ab3a14c7e9e86e8ad7c474e2dbbe,0,0,0,0,0,0,0,0,0,0,0,0,0,0,20,20,0,0,0,0,0,0,0,0,0,100
eff5bf3a33e0954823479b9bf719d2029a0c65cb,0,0,0,0,0,0,0,0,0,0,0,0,0,0,21,21,0,0,0,0,0,0,0,0,0,100
cdbdd7f129c3d1fa2ddf60ba79ab00bc1085c54b,0,0,0,0,0,0,0,0,0,0,0,0,0,0,22,22,0,0,0,0,0,0,0,0,0,100
c18cfa32c583f24f3fecc5fe7bccf71c267d8eea,0,0,0,0,0,0,0,0,0,0,0,0,0,0,23,23,0,0,0,0,0,0,0,0,0,100
bbc8cdbf5fe841d7b92f33ad84bd20a544fd3093,0,0,0,0,0,0,0,0,0,0,0,0,0,0,24,24,0,0,0,0,0,0,0,0,0,100
1158b8296a713e77ae155b517942e10ed4a8f21b,0,0,0,0,0,0,0,0,0,0,0,0,0,0,25,25,0,0,0,0,0,0,0,0,0,100
42b5cd60a38f1b4bcbb19050bf73d6c39af311b8,0,0,0,0,0,0,0,0,0,0,0,0,0,0,26,26,0,0,0,0,0,0,0,0,0,100
793b60abbdd2c778297bef8c1447d5752243cfbf,0,0,0,0,0,0,0,0,0,0,0,0,0,0,27,27,0,0,0,0,0,0,0,0,0,100
b1b45a577aa405cb57dbe737c0df5099edd57286,0,0,0,0,0,0,0,0,0,0,0,0,0,0,28,28,0,0,0,0,0,0,0,0,0,100
2d266a1b073d4b41088b32b10e6247619fde9606,0,0,0,0,0,0,0,0,0,0,0,0,0,0,29,29,0,0,0,0,0,0,0,0,0,100
62c21012d72adc33303d49e2571989188bb88b7f,0,0,0,0,0,0,0,0,0,0,0,0,0,0,30,30,0,0,0,0,0,0,0,0,0,100
9612e983a4f2a997e8724d2f1d7d6a7c1e6f1ab3,0,0,0,0,0,0,0,0,0,0,0,0,0,0,31,31,0,0,0,0,0,0,0,0,0,100
6ac9bf7f9e6dd9a6b2c5290468e2a29ffe80ef7c,2,45,8,37,0,0,0,1,3,14,1,2,0.77170947,329,15,15,69,63,6,2839,2527,312,23,20,3,99.17695473
259393a950324ed6ce40781b1c09bb6dcfef4b27,2,7,44,37,0,0,0,1,2,5,1,2,0.787126586,362,32,32,63,69,6,2527,2839,312,20,23,3,99.17695473
6a596dced1fc0acbcd5d4dd55cd56453e8c75f16,0,0,0,0,0,0,0,0,0,0,0,0,0,0,33,33,0,0,0,0,0,0,0,0,0,100
2bdbee558cf425bed21e411bd3b23076ce712b31,0,0,0,0,0,0,0,0,0,0,0,0,0,0,34,34,0,0,0,0,0,0,0,0,0,100
5cdf7901bc8db47e0596643e3c107242447f9b76,0,0,0,0,0,0,0,0,0,0,0,0,0,0,35,35,0,0,0,0,0,0,0,0,0,100
2e53e54641932f6119eec6d5989f9d8b8b98fe01,0,0,0,0,0,0,0,0,0,0,0,0,0,0,36,36,0,0,0,0,0,0,0,0,0,100
f9099bc944e983cdfba96b28cb5baf43d45d812a,2,45,8,37,0,0,0,1,3,14,1,2,0.77170947,329,38,38,69,63,6,2839,2527,312,23,20,3,99.17695473
6ca8423f8bf344358e3d353b6c2552b108e4ec20,0,0,0,0,0,0,0,0,0,0,0,0,0,0,39,39,0,0,0,0,0,0,0,0,0,100
ef076af3d385b7584b3a24161e7cbea7524a9400,0,0,0,0,0,0,0,0,0,0,0,0,0,0,40,40,0,0,0,0,0,0,0,0,0,100
e245b02d027f4b71acc69513b39a3c4eb96ae338,0,0,0,0,0,0,0,0,0,0,0,0,0,0,41,41,0,0,0,0,0,0,0,0,0,100
8ae7b9897dbe6e754fa3864a0af76033659d6358,13,139,108,31,1,0,1,0,3,7,1,7,3.195724837,1034,14,14,186,180,6,8884,8882,2,81,77,4,98.21673525
75fea5602c4b8eb14a3de6b786172b83419ac843,4,80,10,70,1,0,1,1,3,10,1,4,1.792471289,374,17,17,79,69,10,3417,2909,508,28,23,5,98.7704918
d5a23f7166db372017d67818a0aa63d6c479cd61,7,359,13,346,3,0,3,1,3,11,1,6,1.977044635,160,18,18,58,28,30,3394,1227,2167,40,20,20,98.25503356
96a9baf42208dbd4506c08d83a6faae20d650312,1,8,12,4,0,0,0,1,2,0,1,1,0,123,19,19,8,8,0,1093,1139,46,7,7,0,100
bc7162de7a50e9d65e7ada214f44a5e6c25b05ef,0,0,0,0,0,0,0,0,0,0,0,0,0,0,46,46,0,0,0,0,0,0,0,0,0,100
4cde08e96781d487e432fd1f96598df650574483,0,0,0,0,0,0,0,0,0,0,0,0,0,0,47,47,0,0,0,0,0,0,0,0,0,100
2aef0ac9a9529b82a0e0a64883b969f12cbf116f,0,0,0,0,0,0,0,0,0,0,0,0,0,0,48,48,0,0,0,0,0,0,0,0,0,100
30ab4605dc4c70c12eb6f47b4bdd0177e5306a2c,0,0,0,0,0,0,0,0,0,0,0,0,0,0,49,49,0,0,0,0,0,0,0,0,0,100
34e4907222d07c6230ccfd0b2d38c976855f3060,5,222,9,213,3,0,3,1,2,8,1,2,1.913450564,153,20,20,45,18,27,2628,1400,1228,35,8,27,95.46703297
b56322bfd34513f51d8d5e46dafa5da6fca8d097,4,7,3,4,0,0,0,1,4,12,1,4,1.921928095,337,21,21,45,45,0,2850,2850,0,28,28,0,100
90d2c82ac4adcd45f1f9bd8285db4a3690d83bf3,3,8,8,0,0,0,0,1,5,12,1,3,1.298794941,328,22,22,50,50,0,2626,2607,19,25,25,0,100
0a8c9ed022c9ca5668a598597f1afa99b975d844,10,20,237,217,0,0,0,1,3,2,1,5,2.333385363,727,50,50,88,115,27,5047,6294,1247,48,75,27,95.46703297
67330737f661e9f0c464f3b00e854d6f8f8a6af2,10,237,20,217,3,0,3,1,5,10,1,5,2.333385363,601,54,54,115,88,27,6294,5047,1247,75,48,27,95.46703297
3e0b8a2352300108a6456b9374d0810072576ae4,1,2,1,1,0,0,0,1,2,3,1,1,0,71,23,23,11,11,0,586,582,4,8,8,0,100
7e36875e88bb35857d1f694b9ed8692fffb34d2b,1,1,2,1,0,0,0,1,1,0,1,1,0,71,55,55,11,11,0,582,586,4,8,8,0,100
240f46d000d5ba64b12b091f24cecfb278fb8c6c,1,2,1,1,0,0,0,1,2,3,1,1,0,71,57,57,11,11,0,586,582,4,8,8,0,100
ee1cc1163fe1643e3954b521b980380d05d08af5,0,0,0,0,0,0,0,0,0,0,0,0,0,0,58,58,0,0,0,0,0,0,0,0,0,100
943f9bba3b734204e85989e71edd0fce6436b91e,0,0,0,0,0,0,0,0,0,0,0,0,0,0,59,59,0,0,0,0,0,0,0,0,0,100
571670ef94e5cf53115b7e7bc953d109c6e3e612,0,0,0,0,0,0,0,0,0,0,0,0,0,0,60,60,0,0,0,0,0,0,0,0,0,100
024ac4f7b650b492588e2685e65fab3094877606,0,0,0,0,0,0,0,0,0,0,0,0,0,0,61,61,0,0,0,0,0,0,0,0,0,100
237c9ef50a2bbead3b0c08e1b363e72ec92033e2,6,138,21,117,2,0,2,1,4,10,1,6,2.345930922,286,24,24,65,52,13,2833,2244,589,42,37,5,98.21428571
383cac87d3b4bf9315cce2bce73424119ebfe316,15,377,404,27,1,0,1,1,4,7,1,10,2.513630864,1005,24,24,191,181,10,7650,7733,83,104,89,15,96.84210526
84d654a1b1048d89d76004facfcddeb99c97e54c,6,647,132,515,1,0,1,1,4,8,1,3,1.425571249,530,25,25,183,139,44,6867,3887,2980,110,63,47,83.80782918
e98fa904e5fefb258e41ad097301194d66d4a145,2,76,30,46,0,0,0,1,5,0,1,2,0.77170947,574,26,26,116,104,12,4687,4265,422,85,71,14,100
c581cc5985b738f62964bbfd0bc75048e260f61c,6,138,21,117,2,0,2,1,4,10,1,6,2.345930922,286,28,28,65,52,13,2833,2244,589,42,37,5,81.41135972
aa9a2e1d162d3fb07980b33a9dcef1d9b8312b33,5,91,14,77,0,0,0,1,5,1,1,5,1.801358141,407,29,29,78,72,6,3630,3143,487,49,45,4,97.91955617
d608475a6dda94fc46119101e4228b3e35b272ce,12,400,108,292,6,0,6,1,6,2,1,6,3.255363463,535,30,30,105,90,15,5353,4049,1304,66,58,8,95.77656676
dd5456546941482a4b7c1667ca3f4c0dce29ef75,5,10,10,0,0,0,0,1,2,0,1,3,2.246439345,216,31,31,19,19,0,1660,1660,0,9,9,0,99.45054945
a87d43cc1fdb6050e91c1bb3ebeed90f05f2588c,4,86,22,64,1,0,1,1,4,13,1,3,1.346475824,224,32,32,43,38,5,2324,1975,349,26,23,3,99.7260274
6e605f7254267ff9f1ccd1f9392e8a439b76e2f7,2,20,0,20,0,0,0,1,4,4,1,2,0.881290899,120,33,33,21,20,1,1088,1040,48,16,15,1,100
538c79c4732d75b9b4f23636f537383cab11b7f3,3,5,19,14,0,0,0,1,4,1,1,1,1.040852083,263,34,34,34,34,0,2480,2537,57,17,17,0,100
beeafc99810e076a9a5c0a371ed5d20443d14c39,2,12,18,6,0,0,0,1,3,13,1,2,0.468995594,117,35,35,11,12,1,979,992,13,5,5,0,99.04502046
4e44a41af5f99db188fab6f319b4a8e1ef703aec,0,0,0,0,0,0,0,0,0,0,0,0,0,0,74,74,0,0,0,0,0,0,0,0,0,100
ef6a9a4a53de1c90ea80db3ac161e1f6d9016476,0,0,0,0,0,0,0,0,0,0,0,0,0,0,75,75,0,0,0,0,0,0,0,0,0,100
5a87e8408ae2145c87a9c0e43d07560eaa77d3ff,1,31,12,19,0,0,0,1,2,31,1,1,0,35,36,36,4,3,1,404,321,83,2,2,0,100
3f64484458f7ba8583e02de791925701862cb548,4,13,2,11,0,0,0,1,5,15,1,2,1.723231429,183,37,37,30,29,1,1603,1541,62,24,23,1,99.45429741
efb435838382ff17d6f55894b83e0906a36db087,2,107,41,66,0,0,0,1,6,2,1,2,0.655225738,608,38,38,156,116,40,5325,4687,638,124,85,39,100
0b6d2bccf538aa520861b5442b6b9af0da047a91,0,0,0,0,0,0,0,0,0,0,0,0,0,0,79,79,0,0,0,0,0,0,0,0,0,100
8de1da31ff10e01c572fb5098e7fb50bff44b7c5,0,0,0,0,0,0,0,0,0,0,0,0,0,0,80,80,0,0,0,0,0,0,0,0,0,100
cd458705ee939369471f033040ff2bc8b2440a7e,0,0,0,0,0,0,0,0,0,0,0,0,0,0,81,81,0,0,0,0,0,0,0,0,0,100
6e797a434870b768561695a70a12d8a1832d8d4a,0,0,0,0,0,0,0,0,0,0,0,0,0,0,82,82,0,0,0,0,0,0,0,0,0,100
06da146825ee34039c631c2360f10d833d6c759c,11,136,54,82,0,0,0,1,7,15,1,9,2.867026303,863,39,39,178,159,19,7030,6541,489,87,82,5,98.90859482
82d85f08181b1d28789600fb450ea4ed6c33c03f,0,0,0,0,0,0,0,0,0,0,0,0,0,0,84,84,0,0,0,0,0,0,0,0,0,100
c1e65cf437290e118de238c514eab073a98209fb,0,0,0,0,0,0,0,0,0,0,0,0,0,0,85,85,0,0,0,0,0,0,0,0,0,100
bf02576db48a1e74c7c0bb1860ad2b8e307fdc42,0,0,0,0,0,0,0,0,0,0,0,0,0,0,86,86,0,0,0,0,0,0,0,0,0,100
c7e1e2a00cbc8c363e2f2bf45d44700430b19867,0,0,0,0,0,0,0,0,0,0,0,0,0,0,87,87,0,0,0,0,0,0,0,0,0,100
8139cad737ad330c335f3797bf2718d36c9f940e,0,0,0,0,0,0,0,0,0,0,0,0,0,0,88,88,0,0,0,0,0,0,0,0,0,100
11fd7d5a5600af75c1b348b588a20946ef90147b,7,58,64,6,1,0,1,1,5,5,1,2,2.726690607,504,89,89,66,64,2,4446,4616,170,33,31,2,99.18367347
d90708cde79830a806c969e4694dff95cbbfabe1,0,0,0,0,0,0,0,0,0,0,0,0,0,0,90,90,0,0,0,0,0,0,0,0,0,100
ce1a536eebe6e444e802fb44c39bbc1ba7a278f8,4,133,15,118,1,0,1,1,7,2,1,4,1.466406024,207,91,91,48,36,12,2047,1607,440,30,19,11,99.32249322
07dd67f663b314c786b27f656298b9a271e6352d,6,217,17,200,1,0,1,2,7,22,1,3,2.065627888,843,92,92,189,156,33,8551,7172,1379,140,118,22,93.44262295
bcf65a9c47c4eee74aea5ef328bc1f97fe561379,2,78,1,77,1,0,1,1,2,1,1,2,0.170330576,58,93,93,23,11,12,1117,461,656,9,6,3,99.72451791
48df21e68469c554973d978b9bfd645cb7100e39,0,0,0,0,0,0,0,0,0,0,0,0,0,0,94,94,0,0,0,0,0,0,0,0,0,100
04023d762824ea5d2bec45d1718ad2639fc25476,0,0,0,0,0,0,0,0,0,0,0,0,0,0,95,95,0,0,0,0,0,0,0,0,0,100
e28f376f00c6e3d929f7081ee191ea9468fbf0af,20,331,486,155,2,0,2,1,6,2,2,9,3.73473698,1854,40,35,272,317,45,15060,15954,894,175,206,31,91.29251701
19d42a6fc3452b8de4a0241b84203b1d5c316acf,17,485,96,389,4,0,4,1,7,6,1,8,3.605032903,1535,97,92,313,254,59,15550,13245,2305,204,166,38,92.16216216
a11050daacf55ba22d003076c4b0fcbf7fa9f02b,0,0,0,0,0,0,0,0,0,0,0,0,0,0,98,93,0,0,0,0,0,0,0,0,0,100
102ae017e925f87cdd67de2086f5069240c8109e,0,0,0,0,0,0,0,0,0,0,0,0,0,0,99,94,0,0,0,0,0,0,0,0,0,100
34f904ae566c3c4f1f26244508328c8d1602ddac,0,0,0,0,0,0,0,0,0,0,0,0,0,0,100,95,0,0,0,0,0,0,0,0,0,100
d843b0403370d5fce9898909df03b7dd9105c09b,0,0,0,0,0,0,0,0,0,0,0,0,0,0,100,90,0,0,0,0,0,0,0,0,0,100
1230019c8452fadffd18a110be25f103b2e51fd9,0,0,0,0,0,0,0,0,0,0,0,0,0,0,102,92,0,0,0,0,0,0,0,0,0,100
df3251a0d17b4abaef117b8f20893a53a8173e42,5,159,2,157,1,0,1,1,4,8,1,3,1.612556452,196,103,93,41,25,16,3050,1917,1133,16,11,5,92.15017065
4d21a327a02e2db1f49fb5d11db90d089821ee6f,2,141,0,141,2,0,2,1,1,0,1,2,0.903453555,0,104,94,12,0,12,1074,0,1074,8,0,8,99.41463415
5fc3081166ea2d504fdb48147bb9a920e50e6df7,4,34,8,26,0,0,0,1,3,17,1,3,1.799008666,225,105,95,24,22,2,2374,2142,232,14,14,0,94.78623566
6f1f57939439820272a31d26028f17e91d2e4285,2,15,2,13,0,0,0,1,3,18,1,2,0.522559375,121,106,96,17,13,4,1373,1316,57,12,10,2,94.78623566
479ddeb4fcaa2c329ddec3c233ef1805661bba1f,1,6,4,2,0,0,0,1,4,0,1,1,0,81,107,97,6,6,0,1059,1047,12,3,3,0,100
0562713302346bfa5a32f05f088032cf51d8836e,3,3,18,15,0,0,0,1,5,0,1,2,1.519046164,206,108,98,14,17,3,1972,2048,76,7,7,0,100
922261865045fc4eba71e6e6ae3ce62f9be4a790,3,35,11,24,0,0,0,1,6,0,1,2,1.301574289,193,109,99,20,14,6,2066,1972,94,7,7,0,100
e221c0395f4f171747cfeb05931ec5889bf17b90,0,0,0,0,0,0,0,0,0,0,0,0,0,0,110,100,0,0,0,0,0,0,0,0,0,100
9162a9a2490c9c95c03e3cb28994ea0298aaf104,2,4,3,1,0,0,0,1,7,19,1,2,0.985228136,203,111,101,28,28,0,1899,1883,16,22,22,0,100
b018c1a62ed89127599b26552f5697fbf1bcb727,3,22,11,11,0,0,0,1,8,17,1,3,1.572623664,346,112,102,70,67,3,2747,2698,49,45,44,1,100
90d9a82ffa4fb21ea85bead214b695a465817c02,0,0,0,0,0,0,0,0,0,0,0,0,0,0,113,100,0,0,0,0,0,0,0,0,0,100
e84fe8e31852e48af3f7c530a6ab4fd53f90ac22,15,218,125,93,1,0,1,1,8,15,1,7,3.081910522,1741,114,101,351,341,10,15769,15453,316,231,218,13,94.15137615
8e9ed9635d5728137b5bfd4381a50b5c1918ff45,0,0,0,0,0,0,0,0,0,0,0,0,0,0,115,102,0,0,0,0,0,0,0,0,0,100
cb03e2362f2d525d65b2407f4d8673d6377183ee,8,149,1,148,2,0,2,1,9,7,1,5,2.04249886,965,115,101,201,184,17,9213,8503,710,151,138,13,94.80519481
f3764a2196212c2b40dd565fc50e63366a85ba2e,0,0,0,0,0,0,0,0,0,0,0,0,0,0,117,103,0,0,0,0,0,0,0,0,0,100
fc9aa1fe21f4f98e9f117e3e59ad363a803750a8,9,181,27,154,1,0,1,1,9,20,1,5,2.350841088,498,118,88,112,92,20,4782,3933,849,79,62,17,92.65033408
f486ab37c33134b205e37f2581de77ff869cd025,0,0,0,0,0,0,0,0,0,0,0,0,0,0,119,89,0,0,0,0,0,0,0,0,0,100
19b5e479c77ff8dde8df37b828f7294e2b1dc815,2,3,2,1,0,0,0,2,10,4,1,2,0.970950594,726,120,89,135,135,0,6447,6417,30,98,98,0,100
d029abe7a15c135e315f1ed47171d3921fad3adf,0,0,0,0,0,0,0,0,0,0,0,0,0,0,121,90,0,0,0,0,0,0,0,0,0,100
6ee1bf006d624da92f7a99d85f90026f26e4a44e,7,41,16,25,0,0,0,1,9,30,1,5,2.261594782,615,122,87,112,106,6,5168,5040,128,61,58,3,100
48420164942158d99efcc6b81e9eb72981dbeae9,0,0,0,0,0,0,0,0,0,0,0,0,0,0,123,79,0,0,0,0,0,0,0,0,0,100
b785818c2d5ae341067c289a99dfe855813b4459,0,0,0,0,0,0,0,0,0,0,0,0,0,0,124,76,0,0,0,0,0,0,0,0,0,100
4a858f885a93a3925147a22aee5dab8ecd6e6370,0,0,0,0,0,0,0,0,0,0,0,0,0,0,125,75,0,0,0,0,0,0,0,0,0,100
ed7d768d1f97f905359a11d42ef428b0f3a198d4,8,107,88,19,1,0,1,1,4,59,1,3,2.174488314,385,126,32,67,63,4,3115,2977,138,32,31,1,95.58823529
d7a794944de7bdf42dc1c427384d80f23a55f116,1,2,1,1,0,0,0,1,5,57,1,1,0,293,127,14,63,63,0,2176,2162,14,16,16,0,100
5736b434be39641a4f64d1fee51fbbc2f67bb27b,1,5,3,2,0,0,0,1,6,0,1,1,0,294,128,15,63,63,0,2201,2176,25,16,16,0,100
ffba8a9bf445e42bf1b1318a85e1ddb82907095a,0,0,0,0,0,0,0,0,0,0,0,0,0,0,129,11,0,0,0,0,0,0,0,0,0,100
f7f8261aafbc511b251643c2534fd15f89ac48df,0,0,0,0,0,0,0,0,0,0,0,0,0,0,130,12,0,0,0,0,0,0,0,0,0,100
7aa3ea41dee97df83a68eb643dd257f5aa9b99a7,0,0,0,0,0,0,0,0,0,0,0,0,0,0,131,13,0,0,0,0,0,0,0,0,0,100
27feaced65c49a19b49d3ef49f6601457fce955e,0,0,0,0,0,0,0,0,0,0,0,0,0,0,131,5,0,0,0,0,0,0,0,0,0,100
9c16403403c263d85f3f6949447763a4312370d1,0,0,0,0,0,0,0,0,0,0,0,0,0,0,132,0,0,0,0,0,0,0,0,0,0,100
b72ed48b4436f3f69a81193c141cf4da164ad279,0,0,0,0,0,0,0,0,0,0,0,0,0,0,131,0,0,0,0,0,0,0,0,0,0,100
08254632c4f93c62135244edae95847bb584ac94,7,52,0,52,0,0,0,2,11,208,1,5,2.452980942,1336,0,0,248,240,8,12232,11934,298,185,177,8,100
d9b3a6e278805d4a8a68ea32a6b24c7ed0c52348,2,822,0,822,2,0,2,1,1,0,1,2,0.923085333,0,1,1,82,0,82,6441,0,6441,52,0,52,99.51219512
69000067e8ac24eb09e575a351d95a39b74a573a,0,0,0,0,0,0,0,0,0,0,0,0,0,0,132,0,0,0,0,0,0,0,0,0,0,100
ab7d3df338ba38bb4a33c4384592be34fd239b1c,0,0,0,0,0,0,0,0,0,0,0,0,0,0,134,1,0,0,0,0,0,0,0,0,0,100
6ba84a6311b16dd89c14c29ccaf4e69c38d05b69,2,10,0,10,0,0,0,3,12,18,1,2,1,749,133,1,141,139,2,6704,6616,88,104,102,2,100
08bd226464bfaf169dd6243e4440f39d1bafa2dc,2,51,0,51,0,0,0,1,4,236,1,2,0.897427193,127,134,2,28,18,10,1618,1161,457,9,6,3,99.87864078
bb6107d741c27333ae546f5ea209c6032d177a9d,0,0,0,0,0,0,0,0,0,0,0,0,0,0,137,4,0,0,0,0,0,0,0,0,0,100
0a9cdfb2c5061ec0797ed2fc4feaf4a9c0c7fcc5,3,96,23,73,0,0,0,1,10,233,1,2,1.061403196,204,138,5,39,28,11,2386,1978,408,23,14,9,99.75728155
39a2cc4bbbb7123c049d19ad5d86f299ff8675e4,4,13,4,9,0,0,0,1,7,224,1,3,1.64571137,285,139,6,50,49,1,2248,2150,98,36,36,0,99.03614458
ad6a11059fdb33cb1835bd0773630531e4a9d74f,3,10,2,8,0,0,0,2,4,177,1,3,1.28067213,311,140,7,42,41,1,2814,2770,44,38,37,1,99.76076555
436f1c722a0f998dd9f5daa63317c8b1bfb302ff,35,442,296,146,2,0,2,2,13,186,1,13,4.361287312,2720,141,8,478,458,20,22460,22062,398,339,324,15,95.36340852
2dd920845faa3b1297ec5275cd4d21972cea7988,4,27,8,19,0,0,0,1,6,133,1,1,1.694552209,141,142,9,28,25,3,1125,1025,100,15,14,1,99.47299078
07938975169595a476efd984ac017ff6dd492010,50,322,1512,1190,1,0,1,1,10,4,1,17,4.06752321,4488,133,0,600,738,138,29258,37590,8332,413,504,91,94.53621347
c0cf2f46d522e92f602216480ca4d77331259005,50,1512,322,1190,4,0,4,2,13,168,1,17,4.06752321,3547,146,11,738,600,138,37590,29258,8332,504,413,91,94.53621347
21c6af447c652d678e1f82d1df4b25579ed7bf4b,50,322,1512,1190,1,0,1,1,10,4,1,17,4.06752321,4488,134,1,600,738,138,29258,37590,8332,413,504,91,94.53621347
84b07e3eeb7d6a832fab17fffd0c9479f3845f1e,0,0,0,0,0,0,0,0,0,0,0,0,0,0,135,2,0,0,0,0,0,0,0,0,0,100
22e6f810f7f7ecb227d174af9b4f142b45bec96c,50,1512,322,1190,4,0,4,2,13,168,1,17,4.06752321,3547,149,9,738,600,138,37590,29258,8332,504,413,91,94.53621347
f774840827f91d729ba5e5685659e6f77a64c667,2,261,2,259,1,0,1,1,8,18,1,1,0.26752362,69,150,10,44,14,30,1505,539,966,24,9,15,99.47437582
0da35cf79fdea418a6cf2adf56648f4b78471a2f,6,1109,25,1084,1,0,1,1,9,141,1,3,0.2730595,469,151,11,252,85,167,7913,3125,4788,93,54,39,99.73890339
812a7d0c8d9eeb0fff6f3df5cb3c7f7d75c226e8,5,38,14,24,0,0,0,2,13,135,1,5,1.93765445,859,152,12,156,150,6,7745,7600,145,100,99,1,100
db09f3ede7d07287ccd6a704754805114f3d47f6,10,38,23,15,0,0,0,1,7,244,1,3,2.89482684,570,153,12,106,102,4,4338,4269,69,80,79,1,99.8687664
b4c0bded7f0196a8ac3d6b90c59f3781ea3c6181,1,8,3,5,0,0,0,1,10,3,1,1,0,77,154,13,18,16,2,614,597,17,10,9,1,100
8f8b29194dbd91f3b52564afe2cb1e14b4e20f79,4,1,14,13,0,0,0,1,7,170,1,4,1.908612699,313,155,14,58,58,0,2204,2296,92,33,33,0,99.60369881
f5c26e93cad8f73f91267db1973aa156263c5619,0,0,0,0,0,0,0,0,0,0,0,0,0,0,156,15,0,0,0,0,0,0,0,0,0,100
151123f255305a476bb00278a500cd2f5132d18b,0,0,0,0,0,0,0,0,0,0,0,0,0,0,157,16,0,0,0,0,0,0,0,0,0,100
521b2315dc4db18ecadcd75050215c7297815d0d,1,1,1,0,0,0,0,1,12,4,1,1,0,109,158,16,11,11,0,1169,1167,2,8,8,0,100
3711cea61bded4c90b235a01163ae5f855089917,1,7,9,2,0,0,0,1,4,296,1,1,0,39,159,17,6,7,1,258,247,11,4,5,1,100
f3888266c7faf05cef7943262a9d83d96f1a4ac0,0,0,0,0,0,0,0,0,0,0,0,0,0,0,160,18,0,0,0,0,0,0,0,0,0,100
f65f642e1b0b935e7a5d023fb21a1543266679d3,0,0,0,0,0,0,0,0,0,0,0,0,0,0,161,18,0,0,0,0,0,0,0,0,0,100
74ce6e6d7aadc2de08007eebaf76e899b591ab96,5,51,15,36,0,0,0,1,14,133,1,2,1.529179654,630,162,18,104,98,6,5995,5709,286,72,69,3,99.73544974
9117c74c2fba1434877a63721b9b09c792cd447d,0,0,0,0,0,0,0,0,0,0,0,0,0,0,163,19,0,0,0,0,0,0,0,0,0,100
0475400eea34066e308f61bb7cf0d9cad8971086,7,701,9,692,6,0,6,1,3,11,1,2,2.50257943,74,164,16,100,12,88,4456,708,3748,77,5,72,96.01873536
299343a43ba86c0297903c4349f6c72c1a641c0b,2,234,0,234,2,0,2,1,1,0,1,2,0.998682213,0,2,0,22,0,22,1510,0,1510,12,0,12,99.47862357
9a1929649bc92ee2e504533ddced9e32d1c3a449,2,0,234,234,0,0,0,0,0,0,1,2,0.998682213,152,165,5,0,22,22,0,1510,1510,0,12,12,99.47862357
c8f6fafb7454dc8c259cf0fcf521d536507b388c,9,175,206,31,0,0,0,1,14,113,1,3,2.546564902,803,166,6,146,139,7,6644,6542,102,93,96,3,96.75550406
b3a82c399afb25a0f393379f0cb12b96e50ba8b3,8,178,22,156,1,0,1,1,15,1,1,4,1.011045378,716,167,7,137,115,22,7209,6273,936,91,78,13,98.95697523
18c11b5ee42eac271039f9cc5aae8e316415c8d5,1,0,144,144,0,0,0,1,3,0,1,1,0,111,168,8,0,21,21,0,818,818,0,12,12,98.95697523
5016a52b56c9ac6adb02259fe8f7b96f8f42f763,0,0,0,0,0,0,0,0,0,0,0,0,0,0,169,8,0,0,0,0,0,0,0,0,0,100
bad74688b5b4ee23d3eeee238aeb85f950dc03ea,0,0,0,0,0,0,0,0,0,0,0,0,0,0,170,9,0,0,0,0,0,0,0,0,0,100
ccbd5cf6beee2c4edf2028c15411f46f6a2f88ed,4,124,3,121,0,0,0,1,7,100,1,4,0.948451342,859,171,8,214,196,18,7831,6659,1172,147,136,11,100
21e19f1b88da49f22bb300f1e4389389a26db10a,6,237,124,113,2,0,2,1,6,8,1,4,1.916676796,963,171,8,218,214,4,8169,7831,338,148,147,1,99.35649936
4bd5bbefa1f1895b340f6266992871e7747d9c5c,4,124,3,121,0,0,0,1,7,100,1,4,0.948451342,859,173,10,214,196,18,7831,6659,1172,147,136,11,100
817cfd099e3ca8e9f4d5af4f51ddf656805c8c82,3,39,10,29,0,0,0,1,7,58,1,3,1.112248039,369,174,11,64,61,3,3484,3209,275,37,34,3,100
cf01463cabecedeeb35c40f32a35a5a3c25704ff,0,0,0,0,0,0,0,0,0,0,0,0,0,0,175,12,0,0,0,0,0,0,0,0,0,100
50419fb5d569f43e07df5c5bed8204211b1ca7d3,0,0,0,0,0,0,0,0,0,0,0,0,0,0,176,12,0,0,0,0,0,0,0,0,0,100
d56291d333cb5fe24f8f7630d223b83cdd8032f8,1,1,1,0,0,0,0,3,15,45,1,1,0,360,177,13,69,69,0,3258,3273,15,49,49,0,100
ba0a6103a3fc7351ec616c2a4c1114cf5fbb7dd0,0,0,0,0,0,0,0,0,0,0,0,0,0,0,178,14,0,0,0,0,0,0,0,0,0,100
555d8f33cc4f2ce8a44a2c5bb9e925e3a76094d7,0,0,0,0,0,0,0,0,0,0,0,0,0,0,179,15,0,0,0,0,0,0,0,0,0,100
7ecccbde22c41d8ea98baebfa51e91a0e6ddc9fa,0,0,0,0,0,0,0,0,0,0,0,0,0,0,180,16,0,0,0,0,0,0,0,0,0,100
707bbc03a349ed0a56e8a3720fd6617e83ccbb3a,1,13,0,13,0,0,0,1,3,25,1,1,0,141,181,17,31,28,3,1366,1222,144,20,17,3,100
a91b266cde34673c18d2ecca29e59f83bad4f84f,0,0,0,0,0,0,0,0,0,0,0,0,0,0,182,18,0,0,0,0,0,0,0,0,0,100
f5aaac5236e8cec8810bfd623cc83e62ea25ee26,25,727,400,327,13,0,13,1,11,71,1,6,4.420672773,765,183,12,157,150,7,7226,6114,1112,115,103,12,90.58823529
9680d1d0c040ef1ba9358f5902b8cd4bc2a0b791,4,83,1,82,1,0,1,1,4,98,1,2,1.850460973,151,184,13,37,30,7,1704,1283,421,34,27,7,92.91666667
ecd916c63e2c7cbfb9ae0241c771ea4530e00a78,17,311,129,182,2,0,2,1,12,153,1,9,3.420608057,1330,185,14,259,235,24,12498,11647,851,160,137,23,97.37783075
9ae7ea2b7d9409027b0c33b5f4af25b0141a8627,4,66,6,60,0,0,0,1,9,0,1,4,1.987061868,473,186,15,96,84,12,4322,3992,330,60,54,6,100
be0aabc994c189ebcdd9a2a708b59d889ac4fbed,3,18,0,18,0,0,0,1,10,0,1,3,1.584962501,318,187,16,63,61,2,2486,2401,85,49,47,2,100
a01b8e5317f2b1e3d6a3f6cb44b70850c733a90a,1,17,8,9,0,0,0,1,2,382,1,1,0,54,188,17,13,10,3,454,405,49,12,10,2,99.88179669
4b32d73ea0f749377b697a14448b61fe5ea03753,1,17,8,9,0,0,0,1,16,53,1,1,0,122,189,8,16,14,2,1294,1263,31,13,11,2,100
fbd10a97358d05a8d530ed2b2ffe62bba9a18ad2,1,3,3,0,0,0,0,1,3,370,1,1,0,203,190,9,46,46,0,1476,1486,10,20,20,0,100
9c2888c8d505408cce3c7622a6f4a94a4ac56601,1,5,6,1,0,0,0,1,4,389,1,1,0,43,191,10,4,4,0,398,408,10,2,2,0,100
48c5f1edcf6fe4090eaa05e4b4211abd6bb805f3,0,0,0,0,0,0,0,0,0,0,0,0,0,0,192,11,0,0,0,0,0,0,0,0,0,100
9fd37e4c0d95e13adcade836cf347711a77ad61a,2,124,1,123,1,0,1,1,7,174,1,2,0.343122907,296,0,0,72,63,9,3017,2201,816,23,16,7,99.76415094
c6f05f365d951458a97289fc4b394a335985f39a,2,1,124,123,0,0,0,0,6,0,1,2,0.343122907,382,0,0,63,72,9,2201,3017,816,16,23,7,99.76415094
488c339002a6805f704a84bd5bc700ff1809116c,0,0,0,0,0,0,0,0,0,0,0,0,0,0,193,12,0,0,0,0,0,0,0,0,0,100
a904a91b681796d18cba9685caec768189d1f7b1,2,124,1,123,1,0,1,1,7,174,1,2,0.343122907,296,194,13,72,63,9,3017,2201,816,23,16,7,99.76415094
0b6c7e5fa8e725cc95b0219f32a4a004d6697795,2,17,4,13,0,0,0,1,6,222,1,1,0.998363673,77,195,14,15,12,3,607,554,53,6,6,0,100
8488622148eec7d62f5b1df46bf599965809d7a5,5,141,19,122,2,0,2,1,5,105,1,3,1.670852612,178,1,1,38,28,10,2084,1350,734,28,15,13,99.29824561
e320453783fe0730b83e714e399d3be9e4fb88cd,0,0,0,0,0,0,0,0,0,0,0,0,0,0,195,12,0,0,0,0,0,0,0,0,0,100
9f45503f7f63af8d8d31a53195e0ed06bbc277b0,2,17,4,13,0,0,0,1,6,222,1,1,0.998363673,77,197,14,15,12,3,607,554,53,6,6,0,100
4300bc2b3eb9ffb6f43d2b08b6c1f1ee4ad640a2,3,123,3,120,0,0,0,1,8,226,1,3,1.06499666,751,198,11,198,172,26,6650,5896,754,156,136,20,100
e1450c080ff7a31aebb330128067f5229207ef59,10,661,197,464,5,0,5,1,6,88,1,5,3.138616979,257,2,2,77,37,40,4738,2006,2732,56,26,30,97.20357942
05929e5a9697371a01a6dfe5fb8cde9b5e227ae0,11,197,661,464,0,0,0,0,10,39,1,6,3.164397631,789,199,10,72,112,40,3935,6659,2724,39,69,30,97.20357942
8eff603b8a4fb470448b38caf16f964d282f986c,4,26,18,8,0,0,0,1,17,64,1,3,1.194625154,390,200,11,74,70,4,3223,3127,96,51,49,2,99.65116279
20a6856ca59c7dbdc84fc9fcbbd33d01f2692048,0,0,0,0,0,0,0,0,0,0,0,0,0,0,201,12,0,0,0,0,0,0,0,0,0,100
279d6d9c89503b50dce3fde790783760b25e1144,2,28,1,27,0,0,0,1,5,274,1,2,0.893571102,85,202,13,36,27,9,873,587,286,15,12,3,100
860a1dbdde4520f41914fb18edb4b9f350decdce,10,661,197,464,5,0,5,1,6,88,1,5,3.138616979,257,3,3,77,37,40,4738,2006,2732,56,26,30,92.40654206
38ccb69201ce8ae2f5a58f046bdcd94ea3d5f65a,10,195,659,464,0,0,0,0,5,39,1,5,3.136202019,595,1,1,37,77,40,2006,4738,2732,26,56,30,92.40654206
89ef2569b7521739d6a9f2adcf88b7468e5a36e6,0,0,0,0,0,0,0,0,0,0,0,0,0,0,203,14,0,0,0,0,0,0,0,0,0,100
3a157dc36f53304759ebd93ede976faa83e4004a,10,661,197,464,5,0,5,1,6,88,1,5,3.138616979,257,204,14,77,37,40,4738,2006,2732,56,26,30,92.40654206
e3521447b8342000dca0602d5864c314a87cf074,0,0,0,0,0,0,0,0,0,0,0,0,0,0,2,2,0,0,0,0,0,0,0,0,0,100
c124c35b5afc7620dcae7a26e1d413a690dd6b9c,0,0,0,0,0,0,0,0,0,0,0,0,0,0,205,15,0,0,0,0,0,0,0,0,0,100
7d3bfdacd998a4cb06d4014151a9aeb8f120e509,0,0,0,0,0,0,0,0,0,0,0,0,0,0,206,16,0,0,0,0,0,0,0,0,0,100
32d86be385db69f6debcb1483589080856d06314,0,0,0,0,0,0,0,0,0,0,0,0,0,0,207,17,0,0,0,0,0,0,0,0,0,100
5bccf64c4cdc8341f55e33dfffc95de82225a7be,0,0,0,0,0,0,0,0,0,0,0,0,0,0,208,18,0,0,0,0,0,0,0,0,0,100
8724acc5ce159523c165f0facfff99bd1287bd1c,2,212,3,209,1,0,1,1,16,46,1,1,0.133532716,360,209,16,116,69,47,4836,3258,1578,55,49,6,88.94668401
f6b1dc3e80963d0672e7118fe5c07ec8be2fa07b,0,0,0,0,0,0,0,0,0,0,0,0,0,0,210,17,0,0,0,0,0,0,0,0,0,100
37baf55539318d8bec54e3640260a31e9d93bb77,8,122,12,110,2,0,2,2,17,37,1,2,2.081643189,843,211,18,168,154,14,8144,7663,481,91,83,8,98.43304843
9f2f7fee28d94ae60d29fcbc355f00b3d0bc3c0c,2,2,2,0,0,0,0,3,18,4,2,2,1,574,212,19,127,127,0,5209,5211,2,60,60,0,87.89407314
8fa4c3817e54788758d7fc0199ef13c1f7adff1a,1,112,1,111,0,0,0,1,4,35,1,1,0,102,213,15,38,21,17,1398,719,679,28,15,13,100
b3b3b6750037e1d1fa31180d2092bec1ed6e49ea,1,8,2,6,0,0,0,3,14,202,1,1,0,423,214,16,81,79,2,3668,3626,42,58,58,0,100
87995d10b47d5af35cc35eb80bd6069d31fd0c3d,9,102,51,51,2,0,2,1,19,13,2,2,2.684373847,728,215,12,154,150,4,6627,6472,155,77,75,2,98.50917431
c006a751ad8c0ee81574093bc6d31c028842287e,11,346,24,322,1,0,1,1,20,29,2,3,2.546532796,915,216,12,232,175,57,10006,8004,2002,115,89,26,99.19261822
4eee058f08df4b71f84c480bca6496dfe332605c,3,126,7,119,2,0,2,1,3,162,1,3,1.563961916,44,217,8,25,12,13,736,278,458,17,12,5,99.42062572
0cbb87cad71d8369f852d489a5092e4f9d4c23dd,2,19,0,19,0,0,0,2,2,0,1,2,0.74248757,36,0,0,7,4,3,429,303,126,7,4,3,100
1283a8b13344f30f2ff6815697cfd0560bbff06a,0,0,0,0,0,0,0,0,0,0,0,0,0,0,218,9,0,0,0,0,0,0,0,0,0,100
25424de56af0a689b6dff04e1ea52bbd011d6f93,0,0,0,0,0,0,0,0,0,0,0,0,0,0,219,4,0,0,0,0,0,0,0,0,0,100
b786ea5b90a7651a032a6c59979071d173bd60d1,0,0,0,0,0,0,0,0,0,0,0,0,0,0,220,5,0,0,0,0,0,0,0,0,0,100
8337f1b77fbc9c912c3c9b58742e0d75f0739cd3,1,1,1,0,0,0,0,1,6,211,1,1,0,85,221,6,16,16,0,705,705,0,12,12,0,100
df78bcb01018fefd3ecdca12837c37113ad6fc8c,1,2,2,0,0,0,0,1,7,0,1,1,0,85,222,7,16,16,0,705,705,0,12,12,0,100
a3d2da2a752fa0689056a1d09cd857d5ca4d1e2c,0,0,0,0,0,0,0,0,0,0,0,0,0,0,223,4,0,0,0,0,0,0,0,0,0,100
1e1be09af1beeac8c8b720899939ce955dcff065,1,8,0,8,0,0,0,2,3,507,1,1,0,25,0,0,6,5,1,201,165,36,6,5,1,100
0190ab5bf93cd708cb7f577d913abfd6c8d3846f,12,42,44,2,0,0,0,2,21,260,1,8,2.92663914,1711,224,5,284,282,2,14826,14790,36,205,203,2,98.85057471
415d3867bd1b7084251f679167dcebc3af1b0bc0,1,7,0,7,0,0,0,2,5,1,1,1,0,31,225,6,7,6,1,244,208,36,7,6,1,100
34f75bad69d11388fad5bd0de3e989c435b73a32,4,90,0,90,0,0,0,3,22,0,1,3,1.77402689,893,226,7,186,167,19,8214,7854,360,138,123,15,100
0ce01c8e6d684729001adaf6535b8775cff3dff0,6,50,42,8,0,0,0,2,8,123,1,4,0.979514797,357,227,8,37,37,0,2964,2877,87,21,21,0,100
cc7d533367f9acbb0827dee5acf3e725f82a2bb1,5,95,2,93,0,0,0,4,23,5,1,3,1.94506492,1004,1,1,213,193,20,8810,8458,352,161,145,16,100
8fca382c81ca6790c69ce06cdc1f4d9b83953366,0,0,0,0,0,0,0,0,0,0,0,0,0,0,228,9,0,0,0,0,0,0,0,0,0,100
f68f9450e6f9004e97b2f1f51809a2e88cd6aa4a,0,0,0,0,0,0,0,0,0,0,0,0,0,0,2,2,0,0,0,0,0,0,0,0,0,100
a081ffaba4da0f9ab0c95539a17a3896a1c56da7,0,0,0,0,0,0,0,0,0,0,0,0,0,0,229,5,0,0,0,0,0,0,0,0,0,100
e7ddb49de3ef3e509dae35f1ee5716c56444f65c,22,55,133,78,0,0,0,1,18,234,1,10,2.759353869,3317,230,6,624,636,12,24638,24927,289,294,300,6,99.31113662
e3953fd4447222113ab734c83c10fd6ceb6b5bfd,18,759,164,595,10,0,10,1,6,78,1,7,3.626228557,688,3,2,175,100,75,8437,6417,2020,91,63,28,89.12415784
ceac5b54b6ede89f2fafd53c4cf1f8e3d244e473,0,0,0,0,0,0,0,0,0,0,0,0,0,0,231,4,0,0,0,0,0,0,0,0,0,100
7e86e30a9888e470c1a5e74a546b613e6c53b70d,0,0,0,0,0,0,0,0,0,0,0,0,0,0,4,3,0,0,0,0,0,0,0,0,0,100
66af78d5b894962ce86ff2d4723025a16a24a4f8,0,0,0,0,0,0,0,0,0,0,0,0,0,0,232,5,0,0,0,0,0,0,0,0,0,100
7e5e2ae8a03e22871fa07393bc5a06fc69b1116e,3,153,5,148,1,0,1,1,6,21,1,2,0.734328441,165,0,0,34,25,9,2161,1382,779,23,17,6,99.83471074
54cc7fc47780c7903e1b5a9caed6df43318b60a0,0,0,0,0,0,0,0,0,0,0,0,0,0,0,233,4,0,0,0,0,0,0,0,0,0,100
5c1aa65d0e72ce576e533b750872600c6e87936e,5,11,4,7,0,0,0,1,7,10,1,5,1.906890596,464,5,3,66,66,0,4589,4508,81,46,46,0,92.48395967
5e00775022ff7843cb2ab972a90a5dc91cdabbed,0,0,0,0,0,0,0,0,0,0,0,0,0,0,234,5,0,0,0,0,0,0,0,0,0,100
a0f029bb6759e583ce506ad933cfbd3cd2b4166e,9,28,20,8,0,0,0,2,7,124,1,8,2.748881452,747,1,1,103,100,3,6797,6778,19,78,75,3,92.48395967
dea7dd20db3329ee597995629fb5fa07ee4ff68f,5,11,4,7,0,0,0,1,7,8,1,5,1.906890596,464,2,2,66,66,0,4589,4508,81,46,46,0,92.48395967
1233b7534fbdf34c667f571ae2c216279d7970ad,0,0,0,0,0,0,0,0,0,0,0,0,0,0,235,6,0,0,0,0,0,0,0,0,0,100
f0f58159639f99e265cd79270f7c564cff896cde,0,0,0,0,0,0,0,0,0,0,0,0,0,0,3,3,0,0,0,0,0,0,0,0,0,100
0e369bb2391a96a2a2eb311d040fde22dba25af6,1,2,3,1,0,0,0,2,4,549,1,1,0,48,6,4,8,8,0,347,360,13,5,5,0,99.89690722
a13e0d27ea6719ef847606b62b32670445274cbd,0,0,0,0,0,0,0,0,0,0,0,0,0,0,236,7,0,0,0,0,0,0,0,0,0,100
7e18be932e6402762ae9899a0593a4ddf0d1ebb3,0,0,0,0,0,0,0,0,0,0,0,0,0,0,4,4,0,0,0,0,0,0,0,0,0,100
3d67e86e81f385a759690f9b7a13993ba6011548,27,319,883,564,2,0,2,1,11,66,1,13,4.036180467,1487,231,2,219,270,51,10146,12148,2002,152,167,15,92.24973089
734708cf77302a8e40265765448088b5d16bb611,20,880,116,764,10,0,10,2,7,53,1,7,3.741949384,679,238,9,187,100,87,9165,6198,2967,105,68,37,92.75053305
0e96f62ea94ea951bbbcb738e50830dd985af5cf,1,3,1,2,0,0,0,1,3,217,1,1,0,61,239,10,15,13,2,466,454,12,12,12,0,100
d9c59932e8cb617b1588844af57474b38d18fbe3,1,29,23,6,0,0,0,1,2,0,1,1,0,96,240,11,24,23,1,687,664,23,7,7,0,100
63d4a19e7ffe5b1d0d9037f72784db370a88e020,1,10,2,8,0,0,0,1,3,0,1,1,0,101,241,12,25,24,1,716,687,29,7,7,0,100
9bc337f0ed5d8cd264cf40df34096e8c3ee0c148,0,0,0,0,0,0,0,0,0,0,0,0,0,0,5,5,0,0,0,0,0,0,0,0,0,100
8b32a80df1b80118e2081f979774d4cdbd899cf4,5,209,0,209,2,0,2,1,8,50,1,5,1.326605726,177,6,6,43,33,10,2555,1502,1053,37,28,9,93.35976214
d5103aec79882d0f8a78152dceb92a3ea34f66c0,0,0,0,0,0,0,0,0,0,0,0,0,0,0,242,13,0,0,0,0,0,0,0,0,0,100
028b7fa4b4612c06c1a40f1904f4de0eb193d679,4,106,0,106,1,0,1,1,9,0,1,4,0.81246542,190,7,7,43,35,8,2231,1590,641,37,30,7,99.80620155
db5054f6f8835e499a512353e69881c067e68fc2,0,0,0,0,0,0,0,0,0,0,0,0,0,0,243,14,0,0,0,0,0,0,0,0,0,100
c69a354f760f7318dc020c9825d79814ca5aa5b4,3,161,2,159,1,0,1,1,12,76,1,3,0.56455575,338,8,8,83,70,13,3648,2513,1135,52,44,8,97.76699029
5c523231f6e5d664197f14b8977f5fb1620162a1,0,0,0,0,0,0,0,0,0,0,0,0,0,0,244,15,0,0,0,0,0,0,0,0,0,100
ff457adcf0aa4027727276366792fa5025a1cc4e,16,587,163,424,4,0,4,1,24,218,1,9,3.144098684,1127,245,15,243,186,57,11899,9342,2557,173,136,37,94.6481665
586cdc9a4a0e0982c50466f9d6d005fb3f4a163f,1,7,1,6,0,0,0,1,2,0,1,1,0,79,246,16,4,4,0,849,761,88,4,4,0,100
36a9204c99982b4b55fbce0b302eb3360c3a9cb2,11,39,5,34,0,0,0,1,13,226,1,4,3.341985758,377,247,16,72,65,7,3158,3051,107,53,46,7,96.32571996
4c0fd19b2ef2566cc3fb84a78befbcb9bc673a53,1,4,0,4,0,0,0,1,7,355,1,1,0,69,248,17,7,7,0,575,549,26,2,2,0,100
50bcd989bc5cf407dfcd810c89da25c768d98f12,3,16,5,11,0,0,0,1,18,170,1,3,1.441166544,374,249,18,67,64,3,3184,3122,62,41,39,2,100
c30606ccf157b31bc8fab35fcd30168c8f02221a,7,64,72,8,0,0,0,1,17,203,1,5,1.954879432,865,4,0,185,184,1,6532,6471,61,92,94,2,99.21722114
95a75f20af2643b33e856f949e4d321b08a1cc35,1,25,27,2,0,0,0,2,2,10,1,1,0,114,5,1,11,11,0,1045,1017,28,8,8,0,100
b6a1c4c578cf882a7907a4c1b4cbcec58eacfc93,0,0,0,0,0,0,0,0,0,0,0,0,0,0,249,18,0,0,0,0,0,0,0,0,0,100
663d9e991dcb1adee7fc628045d30dbdac59c20e,3,16,5,11,0,0,0,1,18,170,1,3,1.441166544,374,251,20,67,64,3,3184,3122,62,41,39,2,100
88a76ace52207f492d474daf65987fd8422cbd57,0,0,0,0,0,0,0,0,0,0,0,0,0,0,252,21,0,0,0,0,0,0,0,0,0,100
b79545590ab02d9ef20b3ae529426130c5d72c96,1,11,11,0,0,0,0,1,12,55,1,1,0,190,253,20,35,35,0,1893,1893,0,13,13,0,100
2eb6d58cfc0ce35b11ad2fa36062f1fdec6ff5f1,0,0,0,0,0,0,0,0,0,0,0,0,0,0,254,21,0,0,0,0,0,0,0,0,0,100
1c72edfc1c9ef1e080d51109f66fb550fd2d4344,2,21,7,14,0,0,0,1,9,9,1,2,0.67694187,164,255,22,36,34,2,1249,1212,37,30,28,2,99.60861057
1d622798cc1ee873db9633dc1681de36b88bac96,121,287,264,23,0,0,0,1,19,118,2,29,6.593807847,9515,7,1,1527,2160,633,81576,115531,33955,1042,1345,303,78.1120332
77bb2df6d923782c3c3e45a6929b5ea9cb4d2106,123,490,402,88,0,0,0,2,24,94,2,30,5.262605058,9743,9,5,1609,2216,607,83919,117501,33582,1098,1382,284,78.1120332
7d1ea2c03030de2bf2de3283f83d8ebfb3278082,0,0,0,0,0,0,0,0,0,0,0,0,0,0,256,20,0,0,0,0,0,0,0,0,0,100
136bb5ddffc169d2d3bdcf191ee16c7b48523c47,0,0,0,0,0,0,0,0,0,0,0,0,0,0,257,20,0,0,0,0,0,0,0,0,0,100
d243a1aa51c815851d7caace4de5dce89d17bc17,121,287,264,23,0,0,0,1,19,118,2,29,6.593807847,9515,258,21,1527,2160,633,81576,115531,33955,1042,1345,303,78.1120332
400b63706b2382bba72b064f55ae80ed22f9ba22,0,0,0,0,0,0,0,0,0,0,0,0,0,0,259,22,0,0,0,0,0,0,0,0,0,100
4b6a08f511c1ce6a3075881072c3eb491b93591c,122,421,287,134,1,0,1,2,24,94,2,30,5.894974304,9539,10,5,1541,2160,619,82109,115905,33796,1056,1345,289,77.95031056
6bf055f106586feab0df077c6e7b9e25e3548da4,123,542,579,37,1,0,1,1,19,117,2,30,4.912676337,9628,6,2,1539,2174,635,82182,116334,34152,1053,1359,306,77.7892562
0bde57f964ce2f6839de823767ca826df8c3b9fa,4,217,285,68,0,0,0,2,12,151,1,4,1.468963977,288,6,2,43,52,9,1710,2160,450,31,40,9,99.77973568
0b25d1e6ec10b14efa1ecbe562f97d1ce8fcabd5,2,255,158,97,1,0,1,1,13,7,1,2,0.756346971,168,8,4,46,34,12,1838,1232,606,37,26,11,99.77973568
7061fa75d318f93dd66506ee51ea1643a444bdba,126,636,606,30,1,0,1,2,24,94,2,30,5.059596387,9741,11,4,1559,2191,632,82940,117414,34474,1064,1365,301,77.7892562
a4da745ecd66b30ea0a107a84720feecdc2fbb33,121,287,264,23,0,0,0,1,19,116,2,29,6.593807847,9515,12,5,1527,2160,633,81584,115539,33955,1042,1345,303,78.09917355
9397edad2dce5b055a2eb539b933aa16759e2a55,6,64,214,150,0,0,0,2,7,224,1,4,1.761217992,362,260,17,45,58,13,1819,2550,731,26,39,13,99.77973568
6fce6c0781d6ffacc65f743ad86355ff99ebd03d,2,255,158,97,1,0,1,1,13,7,1,2,0.756346971,168,261,18,46,34,12,1838,1232,606,37,26,11,99.77973568
8edd450a797dbc386108a2d0e6ecaea3ca67c4c4,8,372,319,53,1,0,1,2,12,104,1,5,2.132911105,496,13,6,92,91,1,3782,3657,125,65,63,2,99.56043956
bface9631d45dcac4d617c5300340397baf0bdf2,4,319,191,128,1,0,1,3,13,3,1,4,1.496782705,216,14,7,56,41,15,2334,1571,763,42,29,13,99.78070175
6d89646be88da34e276bed45480bb05fe79608c0,6,7,188,181,0,0,0,2,7,224,1,4,1.065138103,383,9,5,45,61,16,1819,2707,888,26,41,15,99.78070175
5a6f3ac990eb1d85beed5766a01e5686d7c80c72,7,181,9,172,1,0,1,3,10,2,1,6,1.314724161,339,15,6,70,51,19,3488,2537,951,49,32,17,99.78070175
6d48734f94546faff0f9e99dc84edb4c9ac0a3bc,9,131,190,59,1,0,1,3,7,134,1,7,1.929406676,499,10,6,71,76,5,3261,3768,507,51,55,4,99.3442623
bd0532084679776d80be533f5ecb6d5662d4377a,1,62,0,62,1,0,1,1,1,0,1,1,0,0,11,7,3,0,3,426,0,426,3,0,3,88.53255588
2b420a03ed5481b78513b58202bfd440dfd240e2,10,190,193,3,1,0,1,3,10,34,1,7,2.255862478,498,262,15,76,74,2,3768,3687,81,55,54,1,87.93774319
670748477cc4fc9d8bc4dd23242fed74a9a30924,4,185,30,155,2,0,2,1,7,5,1,4,1.576712205,116,12,8,33,18,15,1582,785,797,26,11,15,88.15533981
8c3200ceac94c3ab7234a2cd4dafa5eb93d3e917,1,2,1,1,0,0,0,2,2,2,1,1,0,101,13,9,16,16,0,832,827,5,16,16,0,100
e4b7c16046bef4fcd9b9c3760438fcfd00bf2efe,0,0,0,0,0,0,0,0,0,0,0,0,0,0,263,16,0,0,0,0,0,0,0,0,0,100
73283a074e92bc0e726e171a9dc297bc62275e9d,2,72,1,71,1,0,1,1,5,12,1,2,0.181166402,50,16,7,15,8,7,756,361,395,15,8,7,96.46425826
54151584ce107562a82d520746f61a3e3772e428,0,0,0,0,0,0,0,0,0,0,0,0,0,0,264,17,0,0,0,0,0,0,0,0,0,100
b85b122421ea1b9c8d654bf1cbacc3ad13ae6201,6,117,11,106,1,0,1,2,15,68,1,5,1.939873739,534,265,12,110,98,12,4922,4432,490,62,54,8,99.72583962
fa0ae1c6564fc467f2139acac705dd695d2f4c62,20,271,541,270,1,0,1,1,14,204,1,13,3.388973778,1349,0,0,191,222,31,8757,10550,1793,112,149,37,85.94276094
f7d7a10be8326e3e5d1ea01090d4d0b7f3b2fb81,18,536,31,505,5,0,5,3,15,23,1,11,3.163283257,961,266,13,216,163,53,10248,7610,2638,147,100,47,86.24161074
497f0a723cfc6e894d851f739ec912c7a0828dbb,6,192,153,39,0,0,0,3,14,74,1,4,0.766937892,988,267,13,171,167,4,9170,8911,259,103,99,4,100
224102ac4813fc0e124114026438a2e3884f858b,2,60,0,60,0,0,0,2,2,38,1,2,0.609840305,576,268,12,111,104,7,5509,5071,438,85,80,5,100
47be22c97f783f587f20762534dfe0657540159c,4,266,60,206,2,0,2,1,1,0,1,4,1.376402472,628,0,0,125,111,14,6850,5509,1341,87,85,2,90
e84a52c5c4d2b98f3ff76082b6dd66bd43ba1a17,1,1,6,5,0,0,0,1,2,0,1,1,0,38,1,1,6,7,1,451,472,21,1,1,0,100
b6be8dd8928dd6ccc1007f4216227621760d645d,2,60,0,60,0,0,0,2,2,38,1,2,0.609840305,576,269,12,111,104,7,5509,5071,438,85,80,5,100
8e50dacc11bb191277ee534eea0ae7709c33d6ee,2,119,109,10,0,0,0,2,3,0,1,2,0.679693101,159,270,13,20,20,0,1800,1758,42,7,7,0,90.18726592
1384c9a48b156336e92acda7dfbd491f8dba65dc,3,74,6,68,1,0,1,1,5,64,1,2,0.878265497,260,271,11,60,53,7,2217,1923,294,30,27,3,99.52925353
b9d344137315ecd6363ada690ba72e814a0254d7,0,0,0,0,0,0,0,0,0,0,0,0,0,0,272,12,0,0,0,0,0,0,0,0,0,100
fd8ce2d6bc02de694aa7ab066bb51b0b28f4989c,3,11,3,8,0,0,0,2,4,44,1,3,1.448815636,157,273,13,28,26,2,1198,1164,34,16,16,0,100
44712ecff2ea905ec2653e5ce91a7413f711758a,0,0,0,0,0,0,0,0,0,0,0,0,0,0,274,14,0,0,0,0,0,0,0,0,0,100
7006d07f1d275608260c04741cac4c351a696635,4,32,8,24,0,0,0,2,3,46,1,3,1.678785613,944,275,15,171,167,4,8022,7812,210,124,122,2,100
c722a6d3593272fe4fe53b4f53fad9387c63a325,0,0,0,0,0,0,0,0,0,0,0,0,0,0,276,16,0,0,0,0,0,0,0,0,0,100
aac0cf661e60f45b22a2bd9818feb97e5d6198c7,0,0,0,0,0,0,0,0,0,0,0,0,0,0,277,17,0,0,0,0,0,0,0,0,0,100
3d6defbb8e85a0b419e4bbadce95a540b46561c7,0,0,0,0,0,0,0,0,0,0,0,0,0,0,8,0,0,0,0,0,0,0,0,0,0,100
2030b6c809c4d4f7cbb547ab14383d546a50ae2a,0,0,0,0,0,0,0,0,0,0,0,0,0,0,278,14,0,0,0,0,0,0,0,0,0,100
f2b1db828abbebc16e74ad681b5fd7682d8311f6,7,68,9,59,1,0,1,1,16,140,1,5,2.467597372,902,14,0,184,178,6,7490,7169,321,78,72,6,89.38471941
b68ff9cf87bb513c7f52e513981ad3864670bc34,0,0,0,0,0,0,0,0,0,0,0,0,0,0,279,14,0,0,0,0,0,0,0,0,0,100
22609e36655ad1b04a5580f5be032a2ac5f23d6f,0,0,0,0,0,0,0,0,0,0,0,0,0,0,9,1,0,0,0,0,0,0,0,0,0,100
6e8433b0f6b92f53e477cec3fd3c8938cd559774,0,0,0,0,0,0,0,0,0,0,0,0,0,0,280,15,0,0,0,0,0,0,0,0,0,100
1bbb99ee2526c37393313ef5e29c3bdd7dd29a1e,0,0,0,0,0,0,0,0,0,0,0,0,0,0,2,2,0,0,0,0,0,0,0,0,0,100
90f27f344ff075c8384b8ef6c3f8f2fed36750d9,6,117,2,115,2,0,2,1,17,37,1,6,1.871559673,420,3,3,98,82,16,4090,3289,801,63,54,9,99.65940054
0997a1b4f20480411460da2e9918187e02b5b8ab,2,2,2,0,0,0,0,4,10,0,1,2,1,106,4,4,17,17,0,950,950,0,16,16,0,100
8c32538d4eccde0c52773c8d8c75b84386487c73,0,0,0,0,0,0,0,0,0,0,0,0,0,0,281,14,0,0,0,0,0,0,0,0,0,100
1e1aea7cd7b140e729a22f1a9f58011f4ee12efb,7,86,5,81,0,0,0,3,4,49,1,5,2.674015689,377,282,15,40,40,0,3198,3233,35,31,31,0,100
48490b514eef729473f303b8316d0b54cf8cf847,0,0,0,0,0,0,0,0,0,0,0,0,0,0,10,2,0,0,0,0,0,0,0,0,0,100
eb3de88510c6c568bab6bb7ad2360ff6fd3dbf6b,0,0,0,0,0,0,0,0,0,0,0,0,0,0,283,16,0,0,0,0,0,0,0,0,0,100
4b7324908055cc6e041199014b81081c3347d030,2,11,17,6,0,0,0,2,3,63,1,1,0.67694187,594,284,13,127,129,2,4868,4904,36,93,93,0,100
2d25d5dfd8f4b78681162c2dfaf4a7342c7678e1,44,1323,1180,143,0,0,0,1,15,231,1,9,1.862404626,5341,285,14,1092,1081,11,42277,41313,964,640,643,3,100
6ca9be42e5b2bd7b8e9a1bd12991e6d8b1e5c308,0,0,0,0,0,0,0,0,0,0,0,0,0,0,15,1,0,0,0,0,0,0,0,0,0,100
f1210d8833317b572e4e5aa5c13bd745585fe89c,47,265,280,15,0,0,0,3,20,112,1,21,4.314910797,5441,16,2,987,948,39,45705,45612,93,620,620,0,100
e578d29d2de98ece2f6cf0cce2f878b011791753,34,177,344,167,0,0,0,2,16,4,1,9,3.272717092,3779,286,11,742,742,0,30219,31241,1022,493,493,0,100
e74fc23e182418572fcf44c66bfd5065c7a56dc1,1,17,1,16,0,0,0,5,19,1,1,1,0,219,287,9,48,47,1,1750,1650,100,22,22,0,100
4b45e134fc28d3d2a83bb1db7c00487f724d54dc,2,52,1,51,1,0,1,1,9,17,1,2,0.313812964,162,288,10,37,33,4,1705,1422,283,23,22,1,99.86431479
25f3280443f082f69971d838d6d841890c493a48,1,48,1,47,0,0,0,2,4,116,1,1,0,119,289,6,11,8,3,1486,1093,393,8,7,1,100
1d020be259b6b23b1a5ebd0613637f50bf291dc2,1,12,2,10,0,0,0,2,9,23,1,1,0,82,1,0,24,24,0,481,481,0,16,16,0,100
76c5015687a2e97d55bd95e0715fe900adc78084,1,12,14,2,0,0,0,4,6,101,1,1,0,87,2,1,6,6,0,729,736,7,6,6,0,100
fe53b71fe3ecf049eaa5fc3cfc99c8fa0cdd5169,8,932,687,245,1,0,1,2,7,51,1,4,1.902480117,924,17,2,179,151,28,8681,7639,1042,132,113,19,94.88130564
2232d0a7a987812f00e55711b10a3b8fcb3f7e3f,1,4,0,4,0,0,0,5,11,58,1,1,0,23,18,3,0,0,0,272,272,0,0,0,0,100
a69bda8f50b6ed227cf28a3a59da0c0c2d379dcc,2,11,2,9,0,0,0,3,7,24,1,2,0.89049164,668,290,4,114,112,2,5718,5639,79,86,86,0,95.03703704
7397d98a59f64df3bf7fbda57e1ddcfdf37b9487,23,744,26,718,7,0,7,3,17,50,1,8,3.975617698,2251,19,3,467,401,66,22893,18644,4249,327,280,47,95.7794418
5eec5ad92c8847a70b7e7ce4557e0bc475c7a0f1,2,4,7,3,0,0,0,3,10,38,1,2,0.845350937,262,291,5,49,49,0,2253,2244,9,38,38,0,100
9367826ee5516439852006c333702bd383241335,2,2,3,1,0,0,0,3,6,6,1,2,0.970950594,141,292,3,19,19,0,1203,1215,12,18,18,0,100
6d701c13fde22a342508c11f0de351a689ea5752,2,159,64,95,1,0,1,1,20,23,1,2,0.840110102,232,20,3,55,48,7,2269,1750,519,28,22,6,99.86320109
8b64b84f880abeabf09c6958306de20b6202d758,1,4,4,0,0,0,0,2,5,8,1,1,0,117,21,4,28,28,0,808,808,0,16,16,0,100
b13bd4f416dcff62fd006a8104df252a406262d0,2,224,0,224,2,0,2,1,1,0,1,2,0.994241797,0,22,5,16,0,16,1450,0,1450,11,0,11,98.21428571
f70a6df8b2fe48efa14b432fddf731c3e8d94d86,5,43,23,20,0,0,0,1,8,96,1,4,1.424578561,204,23,6,33,28,5,2099,1929,170,21,20,1,100
0607de6ec79569469737d47674bd49b55342999e,1,2,0,2,0,0,0,3,7,8,1,1,0,178,24,7,21,21,0,1720,1708,12,21,21,0,100
0473d8e8685d2b18c22fbb882f2ee35fa2983743,1,0,2,2,0,0,0,3,8,0,1,1,0,180,25,8,21,21,0,1708,1720,12,21,21,0,100
3a3111546e788f4139fa291f018fe71bd3420d91,11,62,24,38,0,0,0,2,6,100,1,3,3.297652045,441,26,9,103,98,5,4363,4105,258,40,35,5,92.99410029
9cf194578fbe4d5c17fd3f43bf1e2340d47fa140,0,0,0,0,0,0,0,0,0,0,0,0,0,0,293,4,0,0,0,0,0,0,0,0,0,100
5accc9ac142740937e3114fb33b9a18d3beb1f43,463,25816,24871,945,230,0,230,1,21,19,1,82,8.390280198,17352,294,5,3123,4893,1770,140696,235391,94695,1904,2966,1062,22.31543624
540345ca226d37cfe7a8e2a8989e3ab4e21cde4a,5,80,68,12,1,0,1,1,3,29,1,2,2.268867875,381,295,6,103,30,73,3246,961,2285,29,18,11,98.69918699
dcbe3784229875eefb04f3aff71563ecd2f7c412,0,0,0,0,0,0,0,0,0,0,0,0,0,0,296,7,0,0,0,0,0,0,0,0,0,100
2ff7247c081e69fe0fe2f04b7848876d25f802d2,3,66,57,9,0,0,0,1,1,0,1,1,1.583817732,196,297,8,18,12,6,1805,1194,611,9,6,3,95.06382979
584c7f6e472bfed15510cffe03fed80c2737d3c2,0,0,0,0,0,0,0,0,0,0,0,0,0,0,0,0,0,0,0,0,0,0,0,0,0,100
6bcd67df4d19ba3ba577a2f66ae9bc904b3a989f,0,0,0,0,0,0,0,0,0,0,0,0,0,0,1,1,0,0,0,0,0,0,0,0,0,100
a3f8e4a6b53fe9117476de104cc38f5f5266430e,0,0,0,0,0,0,0,0,0,0,0,0,0,0,27,10,0,0,0,0,0,0,0,0,0,100
1ed57904e095620aaee95fc9cb96773446f473e8,2,42,5,37,0,0,0,2,2,6,1,2,0.746736607,258,2,2,56,52,4,2318,2142,176,18,17,1,100
ab0a99dc190e12c789ca32148dd03ef315427d38,0,0,0,0,0,0,0,0,0,0,0,0,0,0,3,3,0,0,0,0,0,0,0,0,0,100
6c4b836db6bebd4fae172fcbfbbafdb3c977ee65,0,0,0,0,0,0,0,0,0,0,0,0,0,0,4,4,0,0,0,0,0,0,0,0,0,100
38c45bd94f5303c1f197b591fcc9e0f25087a867,2,5,42,37,0,0,0,1,1,0,1,2,0.746736607,278,2,2,52,56,4,2142,2318,176,17,18,1,100
b14a7d62cb66a537438254237b16cf3f48fac1ac,2,42,5,37,0,0,0,2,2,6,1,2,0.746736607,258,6,6,56,52,4,2318,2142,176,18,17,1,100
91b4ac274c2c9b65769205ef4ae56240fbac085e,1,4,3,1,0,0,0,2,2,9,1,1,0,159,7,7,11,11,0,1497,1486,11,8,8,0,100
83acb813d5293be67ff693bc3e63a19abedffea5,233,5,5,0,0,0,0,1,1,0,1,42,0,17368,8,8,3127,2330,797,140883,124655,16228,1905,1398,507,22.39057239
1a12116480042d2c72d540dbefbe189fe6a9aca8,0,0,0,0,0,0,0,0,0,0,0,0,0,0,9,9,0,0,0,0,0,0,0,0,0,100
5d841a4a5c3c7da91876ceb8143037877ce75e19,0,0,0,0,0,0,0,0,0,0,0,0,0,0,10,10,0,0,0,0,0,0,0,0,0,100
15e24a2475013f773110fe803286f026dc1595c2,0,0,0,0,0,0,0,0,0,0,0,0,0,0,0,0,0,0,0,0,0,0,0,0,0,100
204aeb1ddf3b44cdc00237a8b0be9e7e07888d40,0,0,0,0,0,0,0,0,0,0,0,0,0,0,1,1,0,0,0,0,0,0,0,0,0,100
f699409f388ea20a551e007796e9addf631d1a29,13,1243,989,254,1,0,1,2,2,0,1,6,2.811198811,1616,28,11,293,253,40,15743,13682,2061,230,199,31,96.75755343
42c9e4e53946ad1f4e0a73f0882d3ef03479c655,32,109,107,2,0,0,0,1,1,0,1,7,4.553937142,2836,11,11,341,256,85,25760,7040,18720,220,64,156,90.06711409
59194a6ff0a86d85994816339b1ffa04c407cf77,0,0,0,0,0,0,0,0,0,0,0,0,0,0,12,12,0,0,0,0,0,0,0,0,0,100
36a5ae37a414ebc3e09cb5c36a9c5be31aa1d07a,0,0,0,0,0,0,0,0,0,0,0,0,0,0,13,13,0,0,0,0,0,0,0,0,0,100
076837116508d48d291dcbe37e5c28ee0ad1513c,225,4730,4951,221,0,0,0,2,3,0,2,48,6.936826289,17272,29,11,3092,3092,0,141180,141235,55,1891,1891,0,100
31b77af61a104a25c0b87da852a9665b045d70d6,0,0,0,0,0,0,0,0,0,0,0,0,0,0,2,2,0,0,0,0,0,0,0,0,0,100
c0aaabdf8c8db009c1066c76d70dab96b59134a6,0,0,0,0,0,0,0,0,0,0,0,0,0,0,0,0,0,0,0,0,0,0,0,0,0,100
4097823bdc36adeb70b32ea39cbfb0230b08bf8a,9,188,183,5,0,0,0,2,3,6,1,7,1.07597415,874,14,14,206,202,4,6592,7308,716,96,92,4,99.07955293
af54c920e59bdca7fbe8f7790e263e5c323ada87,16,289,22,267,5,0,5,1,3,12,1,4,3.046687307,462,30,3,114,103,11,5790,4363,1427,51,40,11,93.3411215
dd9456b924a1af8aed50039ef71b1afcf10cbd07,3,31,15,16,0,0,0,3,3,21,1,3,0.997626792,298,3,3,57,56,1,2411,2317,94,30,29,1,99.84326019
b645a55ddb63f0bda67dd50607d13529cf7f7e97,2,0,61,61,0,0,0,3,3,20,1,2,0.777152994,319,4,4,44,54,10,2311,2685,374,33,41,8,100
6f549ed3ed0267b0872b5d3256a6f313a1a412c8,11,244,93,151,2,0,2,1,3,27,1,4,3.018186086,994,5,3,127,111,16,9680,9025,655,86,70,16,99.74079834
627bb42d6a23d3923c0d432478f170315a7df026,27,219,109,110,0,0,0,4,4,15,1,7,4.394214719,2690,1,1,352,351,1,26313,24663,1650,233,233,0,99.84504132
be357f264265de5ccac2edca9c304aa80d5b9f8e,1,21,0,21,0,0,0,3,4,0,1,1,0,78,31,2,10,8,2,870,811,59,9,7,2,100
e540459ee2f4c3b7f29989c16cb9aa19278fd3fb,6,27,24,3,0,0,0,2,4,10,1,4,2.138692053,445,6,4,56,56,0,4046,4065,19,37,37,0,99.69104016
5b9d3ce1f48377ebc9de0369750a0706b53c1304,2,36,1,35,1,0,1,1,4,3,2,2,0.571354974,60,15,1,15,13,2,516,452,64,15,13,2,99.74345818
ac6f6894f5393ab7a080d754a4b91041ecb06fc1,1,1,6,5,0,0,0,1,2,0,1,1,0,11,16,2,0,1,1,41,61,20,0,1,1,100
b4ef5ff9358c3979d6a229d0a8ed4ba28517e25b,0,0,0,0,0,0,0,0,0,0,0,0,0,0,17,3,0,0,0,0,0,0,0,0,0,100
9c42c0b35c0976b6c72a59c37788ad5032601595,33,241,173,68,2,0,2,1,5,0,2,9,4.63358167,2859,7,5,336,349,13,27181,27533,352,236,251,15,98.77112135
47a9d1c456663021903d77116c65d5723fe8ede6,5,12,56,44,0,0,0,2,6,0,3,5,1.63809201,504,8,6,49,51,2,5222,5387,165,44,46,2,99.59016393
9d3bf41605b07d888ca07a29f3dd35c1fc96bb36,1,14,7,7,0,0,0,4,7,0,1,1,0,124,18,4,14,14,0,1276,1234,42,11,11,0,100
493686cbad567d42239021651889b9e05d653249,3,53,1,52,0,0,0,2,2,0,1,2,1.580585678,140,19,5,25,25,0,1155,1155,0,23,23,0,100
99c866c17be708c8dd6bfd3522f2df481d501592,0,0,0,0,0,0,0,0,0,0,0,0,0,0,20,6,0,0,0,0,0,0,0,0,0,100
b7b79c17ec42ba4bbc4b7ab56e517269851fbc6e,0,0,0,0,0,0,0,0,0,0,0,0,0,0,21,7,0,0,0,0,0,0,0,0,0,100
c18f2d63ad3f92a35ce1c5f75a7d0e0cbd60bc59,1,1,1,0,0,0,0,2,3,5,1,1,0,72,22,8,17,17,0,502,508,6,15,15,0,100
0e663d4063323a9743649848c06b0ea92cdeec5d,2,34,0,34,0,0,0,2,2,31,1,2,1,73,9,6,20,20,0,400,400,0,13,13,0,100
fbc741f102c1103fca3bcb3756eb096d5d4bcd67,0,0,0,0,0,0,0,0,0,0,0,0,0,0,10,7,0,0,0,0,0,0,0,0,0,100
a7b98a9e0ffc50d6bd2ae643607a33d1f3de72d3,2,71,0,71,0,0,0,2,3,56,1,2,0.908618598,781,23,8,186,177,9,6637,6211,426,148,141,7,100
daa16452c467147c0b523ecce75da5100d4f4830,1,8,6,2,0,0,0,1,1,0,1,1,0,8,24,9,0,0,0,35,61,26,0,0,0,99.64194373
fd1fc3ad69334c25dfaee044785385ba95981f91,0,0,0,0,0,0,0,0,0,0,0,0,0,0,5,0,0,0,0,0,0,0,0,0,0,100
a92a523fb72a3d3180d43115762442e4ccf881f3,0,0,0,0,0,0,0,0,0,0,0,0,0,0,6,1,0,0,0,0,0,0,0,0,0,100
dfd28922d6c5740db3d5170d94db546d22077ba4,7,4,4,0,0,0,0,1,1,0,2,2,2,572,11,6,121,63,58,5048,1939,3109,38,35,3,98.57142857
7971c86d6132fa3c406d3db790d7170fb924b70c,0,0,0,0,0,0,0,0,0,0,0,0,0,0,25,10,0,0,0,0,0,0,0,0,0,100
c12ef81090bbc142ed865592bb1a497699376c24,1,20,1,19,0,0,0,3,3,73,1,1,0,40,0,0,5,3,2,573,392,181,1,1,0,100
547d56fa8588a693899d4e308312766761aaa80e,0,0,0,0,0,0,0,0,0,0,0,0,0,0,26,11,0,0,0,0,0,0,0,0,0,100
153617a4444e439b6fe9dc06d3d4c5a3859307da,12,421,50,371,6,0,6,2,4,37,1,4,3.410196181,937,32,0,205,181,24,9078,7648,1430,149,132,17,94.03567447
f2107350bfffae2aced07447838a536423a159af,1,17,0,17,0,0,0,2,2,0,1,1,0,21,27,12,1,1,0,196,196,0,1,1,0,100
05ff678fcb5ecf3fb37dbcfa38c08daa4ef6494d,0,0,0,0,0,0,0,0,0,0,0,0,0,0,28,13,0,0,0,0,0,0,0,0,0,100
5588544c7bd27cc4b35d915e947ee4c09847a070,1,3,4,1,0,0,0,1,2,1,1,1,0,18,33,1,3,3,0,132,138,6,2,2,0,100
03dd4b52b164b3540fbaba38c198c0160a479734,2,8,2,6,0,0,0,2,5,43,1,2,0.721928095,721,34,2,126,124,2,6548,6499,49,95,94,1,100
0666b0f89e9eb5f78bbcf561e823b1d343aa434f,2,31,9,22,0,0,0,2,6,4,1,2,0.998195879,726,35,3,128,126,2,6696,6548,148,97,95,2,99.93857494
38d7b3a6b301a09d06c90d2e449c9197fae9b481,4,113,0,113,2,0,2,2,5,4,1,4,1.649034562,290,36,4,65,59,6,2732,2215,517,48,44,4,90.12345679
629f57342bb8fb41b1484de7869c90509fdbfb9d,3,10,9,1,0,0,0,2,6,59,1,3,1.189731917,421,29,8,54,54,0,4040,4025,15,30,30,0,100
1af6210727ea5052f01930fdc9f1965ef0f90d53,0,0,0,0,0,0,0,0,0,0,0,0,0,0,30,9,0,0,0,0,0,0,0,0,0,100
d78e890a6efa8786b39128b762becdea474ec55f,1,23,1,22,0,0,0,3,7,0,1,1,0,154,31,10,13,11,2,1591,1479,112,8,8,0,100
7ab0da94eb696f6a92c9fb9bd5060a6ad624d1dd,0,0,0,0,0,0,0,0,0,0,0,0,0,0,12,3,0,0,0,0,0,0,0,0,0,100
a8691d0bd193a5c514e8318d4aa927eee643e531,10,155,29,126,4,0,4,3,3,27,2,4,2.70614118,465,13,3,74,71,3,4446,3000,1446,61,56,5,96.7764541
6a66e17944be7db94515ddaba53854b9497714be,0,0,0,0,0,0,0,0,0,0,0,0,0,0,32,9,0,0,0,0,0,0,0,0,0,100
92c06fc6c3dc852e24a9bce3c368250d5b4af43b,1,11,1,10,0,0,0,2,2,81,1,1,0,176,37,5,48,46,2,1222,1153,69,23,22,1,100
33f53e629291bb651265ff8bca607b9e47f27606,0,0,0,0,0,0,0,0,0,0,0,0,0,0,33,10,0,0,0,0,0,0,0,0,0,100
04438473c7bd8681331aa180acf7e3c2c2d3faef,10,36,21,15,0,0,0,2,5,84,1,9,2.454291659,945,34,11,205,202,3,7702,7656,46,101,100,1,100
e487447b026cbab779ddcf2c26f05f71558164be,0,0,0,0,0,0,0,0,0,0,0,0,0,0,14,4,0,0,0,0,0,0,0,0,0,100
2932e9e4a053414e961b77e419a8b1d07ee2daa2,17,316,159,157,2,0,2,2,7,36,1,6,3.382991819,2203,38,6,396,389,7,19674,18794,880,299,287,12,91.75911252
fd6fae494218f2a8061cb7c2d39d7ef65cf544be,0,0,0,0,0,0,0,0,0,0,0,0,0,0,15,5,0,0,0,0,0,0,0,0,0,100
60d6ca5dea7227aeca3989426dcb7d97d6bbc664,0,0,0,0,0,0,0,0,0,0,0,0,0,0,2,0,0,0,0,0,0,0,0,0,0,100
012e924e6a2900065a7f9fefd2265136d65af2ee,1,250,0,250,1,0,1,1,1,0,1,1,0,0,35,10,14,0,14,1497,0,1497,7,0,7,100
457a067b688ab129dc3adc01f5aacc2fa7114dbc,2,57,4,53,0,0,0,2,4,52,1,2,0.514091279,830,36,11,194,186,8,6938,6637,301,150,148,2,100
11819871bb7206f9802c0e67f1fbd6d9b42988f0,2,0,521,521,0,0,0,2,3,114,1,1,0.999997343,322,37,11,0,82,82,0,2613,2613,0,56,56,90.75425791
b8891e5479f129ce2321c64679ae6621a3992a38,14,129,70,59,0,0,0,2,8,48,1,7,3.436312595,1763,38,12,266,248,18,16273,15953,320,195,192,3,100
6531106621730d8e527ecbf78245a023a05b8e34,1,6,7,1,0,0,0,4,5,72,1,1,0,84,39,13,6,6,0,760,783,23,6,6,0,100
b05f1836cb4ee4c9bf34b202d57a536f251f82bc,4,44,19,25,0,0,0,2,9,28,2,3,1.18229148,947,40,14,169,157,12,9355,9133,222,110,109,1,100
89e58b3e254d1ebb7885cc57574981a61b16e091,7,66,37,29,0,0,0,2,10,36,1,3,2.280584271,1067,41,15,209,205,4,9157,9085,72,138,137,1,100
dfe70ca96f120659b89f6ad961fcbf4340deb942,1,3,3,0,0,0,0,2,5,0,1,1,0,73,39,7,11,11,0,617,620,3,7,7,0,100
5d9b69869c39e9200829378280f871a35d6dd910,3,184,29,155,1,0,1,2,11,24,1,2,1.475377564,644,40,8,146,137,9,6370,5461,909,88,83,5,98.88724036
9d8b679ec0bbd007e65c33f2018b2c9630cfc700,0,0,0,0,0,0,0,0,0,0,0,0,0,0,16,4,0,0,0,0,0,0,0,0,0,100
e72f9fde7bf183bc2762073ce9e7321662b912f2,0,0,0,0,0,0,0,0,0,0,0,0,0,0,298,0,0,0,0,0,0,0,0,0,0,100
e4e8f994866922b5bc3ea92b52a80a502f083bd1,5,138,120,18,0,0,0,2,6,15,1,4,1.988066656,458,41,9,42,49,7,4339,3967,372,36,37,1,99.70414201
ca2b9c06a5d9d430cfb987dc66fcfa34301cc026,1,6,0,6,0,0,0,3,3,126,1,1,0,387,3,1,59,59,0,4070,4056,14,30,30,0,100
58383d3d0e8346c17366beaea4c4543eec0b9c19,5,75,9,66,1,0,1,3,5,84,1,4,1.348977219,270,299,1,33,27,6,2369,2085,284,13,9,4,99.77876106
267707c471088789d44baea1f9e2cffc25824255,0,0,0,0,0,0,0,0,0,0,0,0,0,0,300,2,0,0,0,0,0,0,0,0,0,100
8a0763f0e1f31017ca346d5c1185cbe5299f1ad2,0,0,0,0,0,0,0,0,0,0,0,0,0,0,301,3,0,0,0,0,0,0,0,0,0,100
5df1ccd08d63800b88810ecae923b123d4a249ef,1,0,4,4,0,0,0,3,3,70,1,1,0,184,302,3,48,48,0,1222,1222,0,23,23,0,100
32c33eb6cbc102947373fe9ddac79066c3abed03,5,196,6,190,2,0,2,1,4,94,1,5,1.616147652,159,303,4,45,30,15,2257,1157,1100,31,20,11,99.48377581
867314ef6dd255fa33d38fa2763499dccead256b,2,8,19,11,0,0,0,1,7,25,1,1,0.825626526,178,304,5,11,13,2,1606,1646,40,8,10,2,100
67142f6b4fb8c258297ad2230090ea9d5c4f12c5,1,1,6,5,0,0,0,1,3,2,1,1,0,71,305,6,4,5,1,615,644,29,3,3,0,100
2a44d18e8c4c201bc827067245eccabf89e7d34b,18,810,34,776,9,0,9,1,8,73,1,7,3.679468197,1061,1,0,239,189,50,12790,9647,3143,170,130,40,94.40124417
cad1b053b390878b8b2e48e5a565077fe9356efc,2,0,38,38,0,0,0,2,2,4,1,2,1,48,306,4,4,7,3,190,269,79,3,6,3,95.58263519
739a4703a00dca526c7d7880649fa6329c246856,8,611,252,359,4,0,4,1,6,83,1,2,2.26687029,582,307,5,179,147,32,6329,4739,1590,84,54,30,96.05654762
7e8d63a20d4eb04cff82ff700a06e801074dc372,1,13,2,11,0,0,0,5,6,140,1,1,0,72,308,6,9,8,1,757,697,60,8,7,1,99.60906959
c38a32bdf600b56088345326f0ecc30b51d73778,2,60,2,58,1,0,1,4,4,2,1,2,0.508611331,187,309,7,40,38,2,1749,1455,294,30,29,1,99.53161593
d49c07a3042f5ad6fadb76b11eee64cbe13d4fc0,0,0,0,0,0,0,0,0,0,0,0,0,0,0,310,8,0,0,0,0,0,0,0,0,0,100
8cea3d02e06a7038662fd57f4dd7f440d4066276,5,113,0,113,1,0,1,3,5,3,1,5,1.473702694,559,2,1,117,109,8,5690,5109,581,78,70,8,99.22360248
1acc34a6e6f857bbf665593a779c9edcfdde8871,3,8,8,0,0,0,0,2,2,4,1,1,1.5,165,311,9,16,16,0,1351,1351,0,16,16,0,100
11ecaacf41bf34f13441d4f9e3ac0fd9cc66cdee,0,0,0,0,0,0,0,0,0,0,0,0,0,0,17,0,0,0,0,0,0,0,0,0,0,100
8b58faa5516a6d6db5833c8ba9289ca60cbc59c6,1,20,11,9,0,0,0,3,3,191,1,1,0,82,0,0,24,24,0,481,481,0,16,16,0,100
7cc16e32231c8d4f5fea0ba29e2a014799a1c771,0,0,0,0,0,0,0,0,0,0,0,0,0,0,312,10,0,0,0,0,0,0,0,0,0,100
28e51b6a4505ff406c0d9472303c28cd2e2d6aaa,5,161,20,141,1,0,1,1,4,12,1,2,1.743143459,418,313,11,112,90,22,4126,3274,852,41,36,5,99.84544049
568e91cb6002a5e8d782e8ca9401f1515cb20ee6,7,104,161,57,1,0,1,4,4,51,1,3,2.370092006,666,313,11,126,142,16,4884,5250,366,63,63,0,99.53703704
a65feb569fb2465d1dd0544bead8532556173bc0,5,161,20,141,1,0,1,1,4,12,1,2,1.743143459,418,315,13,112,90,22,4126,3274,852,41,36,5,99.8459168
17ec1558455f2ba7ab099da5f028b4b6b01adda0,3,33,18,15,0,0,0,1,2,129,1,1,1.584962501,191,18,1,21,18,3,1941,1794,147,9,9,0,99.23076923
22a33dd56e1486a7734d10a462a398cbe8a27feb,2,4,9,5,0,0,0,4,5,92,1,1,0.961236605,127,42,0,21,21,0,1111,1204,93,11,11,0,100
883c565a31c914dd004c649fa46df1e47fb85bba,15,75,6,69,0,0,0,2,9,150,1,6,3.378595993,944,43,1,189,180,9,8392,8163,229,103,96,7,96.94029851
a4cf3edf0bdebb8969bf25b304fca7b13a198623,2,56,53,3,0,0,0,2,3,204,1,2,0.977969744,136,44,2,12,20,8,1826,1789,37,8,7,1,97.08955224
a66b5edb0f3d77068cff7f67ab063e150a6980a0,2,24,18,6,0,0,0,2,3,6,1,2,1,146,45,3,25,25,0,1182,1182,0,12,12,0,100
4e0ead87d77be4991bc776b3938f27ed26bbf5e3,24,104,192,88,0,0,0,2,8,8,2,10,3.819106942,1592,3,2,264,268,4,14132,14452,320,135,143,8,99
cfccf494dba2b0870c96ede4d40934231291cf33,24,192,104,88,0,0,0,2,9,127,2,10,3.819106942,1544,316,12,268,264,4,14452,14132,320,143,135,8,99
65696ea3b39b905051e711771d86138919f5c502,3,9,15,6,0,0,0,1,3,9,1,1,1.584962501,200,19,2,21,21,0,1884,1941,57,9,9,0,100
cb94abfcd9776f84849a82472cc0c831a889cc6d,0,0,0,0,0,0,0,0,0,0,0,0,0,0,4,2,0,0,0,0,0,0,0,0,0,100
1c58b6fb24bb178571510be681ca8a588a2aa022,0,0,0,0,0,0,0,0,0,0,0,0,0,0,0,0,0,0,0,0,0,0,0,0,0,100
1897ae82fdb94e9c6bd4314dee0c6dfa165ae5e0,3,37,18,19,0,0,0,3,5,165,2,3,1.48788087,214,11,0,41,41,0,1716,1615,101,19,19,0,100
37a7fac13d25a8078c1d39b9c378263f486c7d6e,0,0,0,0,0,0,0,0,0,0,0,0,0,0,20,3,0,0,0,0,0,0,0,0,0,100
0083239b2fb92bf1238edd0f7c9529d5fe77813a,0,0,0,0,0,0,0,0,0,0,0,0,0,0,21,3,0,0,0,0,0,0,0,0,0,100
a79ce8a7674589b3c91e625f2a3f242f528edb8f,5,268,0,268,5,0,5,1,1,0,1,2,2.263474123,0,22,4,9,0,9,820,0,820,6,0,6,99.23664122
910b1450de30db0748ff06cfc9626ea4ea367416,2,25,2,23,0,0,0,3,5,136,1,1,0.503258335,278,317,5,62,59,3,2110,2002,108,34,33,1,99.09021986
9b648b0863ea61c75bc9e412bbff429635fec3de,1,0,1,1,0,0,0,4,6,0,1,1,0,169,318,6,34,34,0,1282,1291,9,26,26,0,100
319c911bfe9e333c5b8eb7e1ffe6ff37712fc5d2,2,2,24,22,0,0,0,2,4,94,1,1,0.391243564,291,4,0,59,62,3,2002,2101,99,33,34,1,99.09021986
e7b5feb341757e8aed7b3a3539419b353a202c4b,0,0,0,0,0,0,0,0,0,0,0,0,0,0,23,5,0,0,0,0,0,0,0,0,0,100
167c9c2818400103f1f0860bbf0d7f2e31a46c2b,1,177,0,177,1,0,1,1,1,0,1,1,0,0,0,0,13,0,13,1055,0,1055,2,0,2,98.86449659
18a2462e84d6621bcf5f6173b4d2a0b66e3889d8,0,0,0,0,0,0,0,0,0,0,0,0,0,0,317,3,0,0,0,0,0,0,0,0,0,100
618e58c25a050bd5151b2f9525b74aa4de9b739c,0,0,0,0,0,0,0,0,0,0,0,0,0,0,24,6,0,0,0,0,0,0,0,0,0,100
a078541f983371582aaaea1925b569b943bb90e7,2,24,2,22,0,0,0,3,6,118,1,1,0.391243564,278,320,4,62,59,3,2101,2002,99,34,33,1,98.56278366
ef10e80bcf6b069c1e7fb89afda6855e0c92f2a0,2,2,2,0,0,0,0,2,6,200,1,2,1,312,46,1,67,67,0,2350,2354,4,37,37,0,100
ed7481d9c88fc9968efa24a18d9b63ce25f0f9d0,1,41,17,24,0,0,0,4,7,0,1,1,0,249,47,1,52,52,0,1886,1886,0,25,25,0,100
1c95647be1abc0bc2927ea1aceec9dfdcf61667d,2,50,21,29,0,0,0,3,6,174,1,2,0.18512476,777,321,4,194,190,4,5505,5415,90,146,143,3,100
b0165faaea013a0d6124308154039c33c7b85002,3,50,6,44,0,0,0,2,6,126,1,2,1.411650205,308,48,2,60,57,3,2755,2474,281,46,43,3,96.91629956
8b3cc0015164e33bb0edd5f88c6b7c767a4529ae,5,157,6,151,1,0,1,1,7,126,1,5,1.642467392,300,49,3,75,68,7,3312,2405,907,42,36,6,99.64412811
eda3c776b34ba58eabd11674cac668ab4a40bfcc,1,5,4,1,0,0,0,2,2,144,1,1,0,144,25,5,14,14,0,1505,1497,8,7,7,0,100
7fef772cf379a640697b175ad2a485439cc19f3a,38,376,303,73,0,0,0,3,10,97,1,12,4.400920641,2154,322,5,360,351,9,18629,17914,715,230,223,7,99.92897727
255800fb35701657c66057a30c288f320f5e2dac,0,0,0,0,0,0,0,0,0,0,0,0,0,0,5,1,0,0,0,0,0,0,0,0,0,100
3eb2d3f3bcf0d2952a8e9a13df8df2500d1e529b,21,377,34,343,4,0,4,1,6,135,1,11,3.61451639,750,50,4,165,143,22,7083,5702,1381,111,90,21,94.60526316
ad90b151d9114cebe5382f678170e4a5bee1c119,5,287,0,287,5,0,5,1,1,0,1,3,2.103617564,0,5,1,17,0,17,1328,0,1328,13,0,13,99.02794654
c3ba38e24f8aab79726e3f81605bec29ed957f84,0,0,0,0,0,0,0,0,0,0,0,0,0,0,6,1,0,0,0,0,0,0,0,0,0,100
43c4e83a2412d55408a73db98e025ef4cf495aca,13,233,6,227,10,0,10,1,3,17,4,13,3.547002204,3,26,5,0,0,0,127,29,98,0,0,0,98.80952381
2576896c91a0400af07e5fe32c1edd7adea29b48,3,267,0,267,3,0,3,1,1,0,1,2,1.337273981,0,6,1,19,0,19,1220,0,1220,19,0,19,99.64830012
14132b093cd5201b0f323d7fb9c7a9ab4a58a679,0,0,0,0,0,0,0,0,0,0,0,0,0,0,7,2,0,0,0,0,0,0,0,0,0,100
1cee024c65938606d0d5794fbc4d10a1135f0f65,18,212,163,49,1,0,1,3,12,132,2,13,3.313999737,2117,7,2,366,380,14,18421,17771,650,255,271,16,99.12587413
82a978299d1f51db74789e97dc267f3275b29619,1,2,2,0,0,0,0,3,3,0,1,1,0,52,27,2,1,1,0,477,477,0,1,1,0,100
298fbaa0a8b8ac9be861ca2a9bbc56ee8596228b,0,0,0,0,0,0,0,0,0,0,0,0,0,0,28,3,0,0,0,0,0,0,0,0,0,100
521cea2573b680c849f70e13e615e715dd2cdad0,2,175,23,152,1,0,1,1,2,27,2,2,0.638161945,116,323,1,30,13,17,2370,1055,1315,19,2,17,99.82578397
db0ce8e8985c3d0d686898aa4182bdf1c004d7b5,2,91,75,16,1,0,1,1,2,0,1,2,0.96580288,122,324,2,11,17,6,1359,1474,115,11,17,6,96.37681159
8c725ac7915294bd4e2133655e57ce66a5c06c0b,2,10,9,1,0,0,0,1,3,0,2,2,0.998000884,182,325,3,22,23,1,1776,1791,15,11,12,1,99.74811083
0eb69c43b525502e6cff3ec79fe68b31e36b37d3,10,51,58,7,2,0,2,1,13,52,1,5,2.260516677,1517,29,3,298,246,52,12872,11016,1856,191,170,21,97.45608722
69105d07b5c5b36d132a3f00e9ac191067db808d,5,104,9,95,1,0,1,5,14,116,1,3,1.046304883,779,326,3,138,135,3,7541,6962,579,90,88,2,99.88344988
2af9cbae45ac44fd0b8b325efe9382973bfe50f1,3,105,8,97,1,0,1,2,5,80,1,2,1.071099448,310,51,0,86,77,9,3013,2489,524,24,21,3,99.70980847
a8847de5851b2886852a6e8c6afb6f173ae4f921,2,12,0,12,0,0,0,3,5,64,1,2,0.811278124,48,327,4,7,5,2,467,387,80,5,4,1,100
a547e90dce7f51295c95cc1b05d428670f621b43,6,416,4,412,2,0,2,1,8,122,1,3,1.585564726,663,52,1,195,150,45,7437,5471,1966,68,43,25,98.22552948
e3b9f520b14b5ed322cc223762dfa4ac741b1cd8,1,7,1,6,0,0,0,4,6,290,1,1,0,71,30,2,12,12,0,715,682,33,3,3,0,100
37a71a3c05f390a6318fba1c6b64f9c601f9f6f8,2,2,2,0,0,0,0,2,4,122,1,1,1,154,328,5,16,16,0,1467,1467,0,7,7,0,100
b6e65d9a2b04409d0cf82cb12e7e418161c507c7,0,0,0,0,0,0,0,0,0,0,0,0,0,0,31,3,0,0,0,0,0,0,0,0,0,100
e0d2cf2ba5a56a3788de13a76aa1eb90f054dc76,2,9,0,9,0,0,0,3,6,155,1,2,0.503258335,875,32,3,199,198,1,7113,7028,85,154,153,1,100
3c03a2d95a059bab516744330abb57fb5ed1d493,0,0,0,0,0,0,0,0,0,0,0,0,0,0,33,4,0,0,0,0,0,0,0,0,0,100
073e4ee0cecb258875fde22b25753970e6f864d3,0,0,0,0,0,0,0,0,0,0,0,0,0,0,34,5,0,0,0,0,0,0,0,0,0,100
e9df0bc7d5f9cf6fd1c4260c859438b585f95e54,1,3,1,2,0,0,0,3,9,91,1,1,0,210,53,2,35,35,0,1683,1665,18,31,31,0,100
50b4fd3957612364b4eecb53a149d930edc592fc,0,0,0,0,0,0,0,0,0,0,0,0,0,0,35,5,0,0,0,0,0,0,0,0,0,100
9c5749efbc3c3eec50217a15a00ca8ee9c30b75a,0,0,0,0,0,0,0,0,0,0,0,0,0,0,36,6,0,0,0,0,0,0,0,0,0,100
26021d7bbf3cb8f68be4e100b2429c4a8f4b5cca,0,0,0,0,0,0,0,0,0,0,0,0,0,0,37,7,0,0,0,0,0,0,0,0,0,100
edc33d8857ed0b574c8f5248e95b12d8e746d929,0,0,0,0,0,0,0,0,0,0,0,0,0,0,38,8,0,0,0,0,0,0,0,0,0,100
d20c32958d2934803b294d56d0256c88232753b0,0,0,0,0,0,0,0,0,0,0,0,0,0,0,39,9,0,0,0,0,0,0,0,0,0,100
11ba4134e7b02676b597e6db15e3fa8897dce901,0,0,0,0,0,0,0,0,0,0,0,0,0,0,40,10,0,0,0,0,0,0,0,0,0,100
f6f965c4d9963eacb5584a85b667ed7148bccabb,8,226,103,123,2,0,2,1,7,210,1,6,2.435627946,468,41,11,76,67,9,4413,3845,568,68,59,9,98.99609593
228657740cf10d7b5f99137bc43b3a93286e10b8,17,1805,23,1782,5,0,5,1,7,110,3,12,2.134438372,1768,42,12,533,336,197,22526,14960,7566,375,221,154,97.95383001
78a3eb7d9b176f1ae1506c3eada6b1205ccb7cdf,0,0,0,0,0,0,0,0,0,0,0,0,0,0,43,10,0,0,0,0,0,0,0,0,0,100
0ba630bb10765c2e74283b6c23560f55f9ca4e74,9,96,44,52,1,0,1,2,10,190,1,4,2.140929746,669,329,0,99,90,9,5904,5658,246,71,67,4,99.64912281
711eaedff7db459ae3f7c0ebc8230f752635bedb,0,0,0,0,0,0,0,0,0,0,0,0,0,0,44,3,0,0,0,0,0,0,0,0,0,100
a71871d36de81d5af3f6d1bd604792e7a4313f5e,4,192,4,188,2,0,2,1,2,16,1,4,1.656253069,818,330,1,206,188,18,7446,6585,861,159,145,14,99.75037444
affa10f28407408149b346d4a764be2e4a957b36,3,25,4,21,0,0,0,2,3,0,1,3,1.334599426,906,331,2,207,205,2,7388,7279,109,160,158,2,100
a9a65eae1fd3f8f350587d7499a7ceaee3be0a24,4,22,9,13,0,0,0,2,4,0,1,4,1.349407895,930,45,4,209,208,1,7615,7555,60,162,161,1,100
72caac7d8b31a7ef717e673724c2f9cd590224bf,0,0,0,0,0,0,0,0,0,0,0,0,0,0,46,3,0,0,0,0,0,0,0,0,0,100
1e06362b9b8ff43d977d166fc4916e41cbeb3ae3,3,92,2,90,1,0,1,1,6,100,1,2,0.296431632,119,0,0,34,33,1,1551,911,640,13,10,3,99.80099502
f69aa5d2a4d46b04d53566e56e3c64eb7affeb40,4,212,21,191,2,0,2,1,4,121,1,3,1.406598238,178,332,3,56,40,16,2611,1304,1307,37,24,13,99.70252851
f26a7c73102aee8dd9a398b12a2dca546bdc1362,32,41,42,1,0,0,0,3,8,275,1,13,4.679197413,3310,47,3,637,637,0,23985,24025,40,330,330,0,100
63050d0d49afc9d53bc3948270c49acbf337f3d9,20,532,150,382,6,0,6,3,8,167,1,7,3.472546735,690,333,4,110,81,29,7534,5869,1665,86,54,32,96.64602683
374bf3de658f8e519da0fc7306f31793e4c075b2,2,37,1,36,0,0,0,3,3,269,1,2,0.398459274,252,334,5,29,26,3,2516,2212,304,17,15,2,100
a988ce2d261f4a3938e7bb71416724d5c6fdc711,3,425,9,416,0,0,0,4,5,169,1,1,1.43059778,135,335,6,44,30,14,2119,1427,692,44,30,14,99.94606257
8ce493aebbb0f5e724e62cb880ac1dd977356f75,5,63,37,26,1,0,1,1,5,119,1,4,1.388353064,132,336,7,26,26,0,1366,1323,43,26,26,0,99.73060345
06ef56e6017d296242ec05ca9b8ed36b9661ab84,3,97,14,83,0,0,0,4,6,6,1,1,1.571501687,193,337,7,44,44,0,2211,2128,83,44,44,0,100
77e6919326e5060b7af9b31aee593c1b05bcc805,0,0,0,0,0,0,0,0,0,0,0,0,0,0,48,2,0,0,0,0,0,0,0,0,0,100
bf5cea2fe24150fc3f8b2ad3c65de7ee732a4631,1,5,5,0,0,0,0,1,2,19,1,1,0,42,338,6,4,4,0,334,334,0,4,4,0,100
092ef5d017470828cf6b1866885b7586762e114a,11,89,33,56,0,0,0,1,7,162,2,7,2.524079073,714,339,7,111,106,5,6937,6410,527,69,67,2,98.95233106
4a3aa0dfd9dbdfd2532b03776d87b99f71fae5a5,1,3,19,16,0,0,0,3,4,362,1,1,0,38,340,8,5,7,2,209,263,54,2,2,0,100
ac317a185401cb0ef1afe7096b51ac29106eb1e2,9,1431,0,1431,9,0,9,1,1,0,1,2,2.76509283,0,341,9,161,0,161,6026,0,6026,130,0,130,91.60220994
29de385be69738de3acd3369216c4839620689c7,19,30,15,15,0,0,0,3,9,208,2,12,3.800614956,1588,342,8,310,310,0,12010,12064,54,164,164,0,97.30679157
dd3ae01ae88707dc5490a2e8294fb6c31ef11e25,8,47,57,10,0,0,0,3,7,263,1,5,2.900089805,940,343,9,146,150,4,8676,8683,7,120,122,2,99.42987457
bd5f32c5b89467f294423e566dbbc886e937d668,2,2,2,0,0,0,0,3,6,117,1,2,1,168,344,10,33,33,0,1256,1256,0,21,21,0,100
1ee3a70dc11a54c4625eded0b290ab517c7d0838,1,1,1,0,0,0,0,1,2,16,1,1,0,53,345,8,9,9,0,281,283,2,7,7,0,100
80654bbb319fe9c07e2b290f400ce49a9c07cec9,1,7,2,5,0,0,0,1,3,24,1,1,0,43,346,9,7,7,0,407,399,8,7,7,0,100
5919af7bc274e0ff2c5c32ea2cc9e1d18542b3c5,1,1,1,0,0,0,0,2,4,6,1,1,0,166,347,10,34,34,0,1252,1254,2,26,26,0,99.59490741
c440ca5e227d4e99196bf13a7f0ebe4fbe7a10d7,0,0,0,0,0,0,0,0,0,0,0,0,0,0,49,1,0,0,0,0,0,0,0,0,0,100
08fa84e592d605a2b3d1465c031db3a64c76faf6,1,1,1,0,0,0,0,1,2,253,1,1,0,22,54,0,3,3,0,162,162,0,3,3,0,100
2bf55617739645d1747d13a4aca4daa06a560931,1,3,1,2,0,0,0,5,8,167,1,1,0,202,55,1,37,37,0,2153,2130,23,14,14,0,100
2bc04f98c1b874f4039ff405b5fd50098bd67447,13,347,93,254,1,0,1,3,9,196,1,9,2.922161802,1198,348,0,268,233,35,11933,10236,1697,154,133,21,96.98759598
522a691c967606963b8bfc13d3f92bc1e071ddef,25,447,603,156,2,0,2,1,8,130,2,10,2.791239176,1493,349,1,234,274,40,12499,12716,217,140,163,23,97.93753683
018d16984f127a4a14ae3ab2d0af0ac839dfb439,2,56,15,41,1,0,1,5,10,34,2,2,0.743898745,258,350,2,56,54,2,1976,1939,37,29,26,3,99.88331389
e8b9d4b2aa651503aa03a5a75f13aa6e6f9347f7,1,43,0,43,0,0,0,3,4,191,1,1,0,86,56,2,31,21,10,770,553,217,20,14,6,100
438e36a3801a7d71d08c5422cea5fb6ae7bb0682,4,262,3,259,3,0,3,1,5,0,1,2,1.950000314,123,57,3,65,31,34,1842,770,1072,40,20,20,99.65156794
5fe2f68b79aa5cd21756619cdc76764b7d502aa5,1,0,17,17,0,0,0,3,3,560,1,1,0,34,351,3,1,4,3,204,323,119,1,2,1,100
75ba3546810fc27b4a6248559fefffd6c3eddb44,1,4,1,3,0,0,0,1,3,116,1,1,0,42,352,4,4,4,0,363,334,29,4,4,0,100
b3d02387191613c8269ebbf44ad0a87f7ab551a6,2,2,2,0,0,0,0,3,10,44,1,2,0.811278124,212,353,4,29,29,0,2140,2136,4,18,18,0,100
f1640ceb2e5e56593dd17ce4cc110c284785ca61,4,17,12,5,0,0,0,5,11,249,1,3,1.368551705,648,354,5,101,99,2,5508,5479,29,47,46,1,99.5373048
6a36ce61d1bbf39f173e3b40c50e154373a02696,1,1,3,2,0,0,0,2,2,282,1,1,0,63,58,2,15,15,0,455,464,9,12,12,0,100
5cf8142aead9f4e168417afd3e29b6c899152edf,1,7,0,7,0,0,0,3,4,280,1,1,0,82,355,4,13,12,1,641,613,28,13,12,1,100
9a1c42760b5c01a5d1dbdf6ee6bdc4f9fb8ca086,2,40,3,37,0,0,0,3,12,82,1,2,0.910348062,305,356,5,73,64,9,2585,2297,288,37,35,2,100
035b1b91d60c1ed5029135d73706ffd54b184a8c,3,79,8,71,0,0,0,4,4,236,1,1,1.434145338,133,357,6,26,21,5,1594,1231,363,21,16,5,100
d743ce7c8aa9107c3c73bac51bdb5ec3c761f094,2,102,1,101,1,0,1,5,13,5,1,2,0.138157229,259,358,7,62,55,7,2491,1910,581,32,27,5,99.53917051
03f3ce8008da6546193678e1a60f032dda028483,8,79,1,78,0,0,0,2,8,282,1,6,2.699664198,347,59,1,57,48,9,2960,2562,398,39,34,5,100
b681953c56c4178b4d4d8f1d13c6d96953268ad8,1,2,4,2,0,0,0,1,1,0,1,1,0,62,359,8,6,6,0,570,577,7,5,5,0,99.77037887
0bec4e4e6f8bbd7a36c25129ebf2d5686e12616f,2,23,7,16,0,0,0,5,8,66,1,2,0.836640742,369,360,9,79,73,6,3287,3145,142,52,51,1,100
70c4edd0b6f73009e62882a5a654d135b446afc9,0,0,0,0,0,0,0,0,0,0,0,0,0,0,0,0,0,0,0,0,0,0,0,0,0,100
41f01c037007fb54091a69464d81c3269b269710,7,193,33,160,1,0,1,3,14,126,1,6,1.816559218,741,361,8,163,146,17,6801,5877,924,98,89,9,99.59490741
6536f4c909a1b8d952f1c4398195177659d1423d,1,3,5,2,0,0,0,3,5,75,1,1,0,52,362,9,9,10,1,523,542,19,2,2,0,100
3e9d6ed64315ebf0a4d6f8081ca3c9102c027a70,13,160,33,127,0,0,0,4,15,245,1,9,2.923863781,2071,363,10,428,401,27,18488,17834,654,307,286,21,100
3f9d29b337af71f5b28960a3b8299500e96bd1d6,1,4,0,4,0,0,0,3,3,623,1,1,0,39,364,9,11,10,1,249,231,18,7,6,1,100
170ba8eea530b965782fcbfefd1c5f3f236d1897,5,151,6,145,1,0,1,3,10,98,1,3,0.935452922,650,60,1,169,155,14,5929,5081,848,73,63,10,100
6f33d586fc5b8584d84785d8b8521327276af712,2,18,0,18,0,0,0,5,7,232,1,2,0.503258335,128,1,1,26,23,3,1143,1005,138,9,8,1,99.65034965
849ad5fe48a411a4d925556f32ba5d8a366511d4,15,350,11,339,1,0,1,1,15,184,2,9,3.245150223,1425,365,8,307,271,36,13225,11593,1632,196,179,17,98.76832845
e052b88d0dbbeab9a4d263e71ae6f249c759c8a4,0,0,0,0,0,0,0,0,0,0,0,0,0,0,366,9,0,0,0,0,0,0,0,0,0,100
82e911b4ec36f68229d24945e828427697349d9e,0,0,0,0,0,0,0,0,0,0,0,0,0,0,367,10,0,0,0,0,0,0,0,0,0,100
aa05a4618fa897d20001b88e1630f12bd821eed8,1,6,0,6,0,0,0,2,5,102,1,1,0,234,368,9,18,18,0,2344,2303,41,11,11,0,100
6cc8d8ec8865aad977b99f69a405582e19d9af91,1,1,1,0,0,0,0,1,2,399,1,1,0,1,50,0,0,0,0,7,7,0,0,0,0,100
855b0ddcb738611abfd9bed445403f18b63d2453,3,273,177,96,1,0,1,4,8,251,1,2,0.891221293,655,369,4,107,84,23,7105,7174,69,66,54,12,91.74364896
c0564f181fdd7eb1d4e6f6a82a4fa7bdcc9a0680,1,1,1,0,0,0,0,5,9,147,1,1,0,204,61,0,37,37,0,2154,2153,1,14,14,0,100
236d97dbb249b3c4b98ec893893e2d2c591d0ae0,8,303,64,239,2,0,2,3,16,182,1,7,2.425524919,1010,370,1,253,235,18,9124,8041,1083,93,84,9,99.66235228
6ddbf57ff2fd51394357a2af0820782047119a2b,1,1,1,0,0,0,0,4,4,400,1,1,0,52,371,2,1,1,0,477,477,0,1,1,0,100
453bff6fefe58334a66e02c04da909320df4b4d8,1,4,1,3,0,0,0,1,2,17,1,1,0,51,372,3,5,5,0,529,519,10,5,5,0,100
d36b69ab8d07daaca3ffdad6082b26acd6d1e49b,6,199,138,61,0,0,0,3,17,6,1,6,1.79097525,866,373,4,187,180,7,6696,6467,229,94,87,7,100
65a1d26f2ca38b0a48ad22dfb9d37acbd369ea20,2,24,9,15,0,0,0,3,5,67,1,2,0.32984607,82,374,5,18,15,3,702,635,67,15,12,3,100
9b0b9eb633e11872072db32ea63cb09a20a39148,1,6,7,1,0,0,0,5,7,89,1,1,0,466,375,6,100,99,1,4053,4068,15,70,70,0,100
913d767184b250c1c8f1b37d1a7e478cddcea172,6,33,0,33,0,0,0,5,12,72,1,3,2.57167226,747,376,7,144,140,4,6528,6374,154,110,106,4,100
65822ab7bd34c5ce228d19e48dc1dd5610ae39b1,4,127,116,11,2,0,2,1,6,119,1,3,1.842043457,338,377,7,68,79,11,2309,2310,1,35,35,0,99.72020145
1138d38559d0a2efd5fbed3d47ccc4529378de2a,0,0,0,0,0,0,0,0,0,0,0,0,0,0,62,0,0,0,0,0,0,0,0,0,0,100
96f5e9f8cbaf387c93204db2e9d15430154124cb,3,356,39,317,1,0,1,3,5,126,1,2,1.348312387,58,378,8,43,10,33,2572,550,2022,23,8,15,99.88851728
0b8677579dc7fed083a1d46eb448b9c75f78763a,2,55,0,55,1,0,1,1,5,135,1,2,0.959316032,166,379,3,38,34,4,1529,1252,277,30,26,4,99.88876529
5d30af0c03a565894aa1cd7226ab13f90437548a,2,13,8,5,0,0,0,2,6,34,1,1,0.702466551,215,63,1,38,38,0,2201,2128,73,21,21,0,100
e20cbf089ddf5c7992c7d5f76f050bea8d9eaecc,19,854,402,452,5,0,5,1,12,216,2,13,2.833803505,1661,380,3,358,314,44,15726,13337,2389,212,186,26,97.62162162
bd72e849f37956c8c050764dda88e18cbc20b37a,1,2,0,2,0,0,0,2,3,1,1,1,0,127,64,2,28,28,0,1176,1154,22,11,11,0,100
b34c2f22fb9543de1c4ac8158282be1776b77ce9,9,279,320,41,1,0,1,1,10,83,1,5,2.369608955,1108,2,0,245,254,9,8543,8663,120,84,86,2,99.42287513
241b86d2f21c0cc2e569eeb5e8f35ce0f87e95d3,2,140,1,139,1,0,1,4,9,36,1,2,0.25387844,218,17,0,52,38,14,2558,1792,766,34,25,9,99.89550679
4683a8d4993ae13565de50273fec88edd759d9bf,1,3,6,3,0,0,0,4,10,0,1,1,0,221,18,1,39,39,0,1795,1823,28,26,26,0,100
154c8fbd3c345e06fdb392a0a5b83f1fba5c7b4f,5,156,219,63,1,0,1,1,4,299,2,3,1.84347379,235,51,0,30,34,4,1701,1948,247,27,29,2,99.47616553
64497fa4f40827d740d341d5513bafff6ed20a9d,2,67,3,64,0,0,0,2,8,496,1,2,0.913460145,152,65,2,25,18,7,2149,1623,526,13,9,4,100
3e513cfabf7d37321c868ea8007aa3c9d202e644,1,11,3,8,0,0,0,3,5,197,1,1,0,60,66,3,12,11,1,616,565,51,10,9,1,100
222dd76ac2be2cdc786feeb9e75f86713ff8c559,4,195,136,59,1,0,1,1,9,95,1,4,1.686637576,259,381,0,45,46,1,2267,2219,48,26,21,5,99.73725696
cbc7c2fb30ad0486e7ec60656c079c81e41eda2c,6,200,2,198,3,0,3,1,8,194,1,6,1.813708954,869,67,2,218,206,12,7102,6361,741,159,151,8,99.58224543
890e0086a12df5006a23cfdd86f3703f929cb147,326,0,0,0,0,0,0,1,1,0,1,54,0,22786,382,1,3988,3260,728,191735,174410,17325,2534,1956,578,27.4041134
77327bef83384a91fac39c415bbc1416bd424b62,0,0,0,0,0,0,0,0,0,0,0,0,0,0,52,0,0,0,0,0,0,0,0,0,0,100
7c536c395d6e2d402858b5992a89dfd3168c8114,1,2,1,1,0,0,0,1,2,3,1,1,0,38,383,1,8,8,0,268,257,11,7,7,0,100
f1e877d4f1627a8289d42072202556a42e56e97c,1,10,4,6,0,0,0,1,2,5,1,1,0,74,384,2,8,7,1,852,723,129,7,7,0,100
48cf308c82ad2e3adb95083a0d10c90e70503fd5,6,98,133,35,0,0,0,1,2,15,1,4,2.21436804,329,385,3,54,57,3,2186,2356,170,30,31,1,97.71126761
5578d5e8be97ff5d5b86815e005d9df387965f60,6,678,0,678,6,0,6,1,1,0,1,2,2.417979294,0,386,4,41,0,41,4407,0,4407,30,0,30,96.75070028
a8828d19089512cf16fec1a4279f2b9db3638fe8,1,5,1,4,0,0,0,1,2,0,1,1,0,98,387,5,14,13,1,935,918,17,9,9,0,100
d0af4d7b94c804ec9217dd3bddd2106e6948790d,0,0,0,0,0,0,0,0,0,0,0,0,0,0,388,6,0,0,0,0,0,0,0,0,0,100
6b1d72aaafa3d35df1a1adb701774884e9c7d1f0,0,0,0,0,0,0,0,0,0,0,0,0,0,0,389,7,0,0,0,0,0,0,0,0,0,100
669519f4208164b61a0c03f265c7e39a4eff9a15,0,0,0,0,0,0,0,0,0,0,0,0,0,0,53,1,0,0,0,0,0,0,0,0,0,100
7bb1dcf86c7e4f2b304fc559d7acd24979ccb056,5,223,188,35,3,0,3,1,2,14,1,2,1.816858951,319,390,8,65,65,0,2983,2880,103,31,31,0,99.40184883
0251bc604b67a1d433f25e432271a67239fdafd1,2,24,18,6,0,0,0,1,2,0,1,1,1,53,391,9,8,8,0,484,484,0,6,6,0,100
56b9050992d1cab027adb207e24701cd6de946bd,1,12,9,3,0,0,0,1,2,353,1,1,0,87,392,10,14,14,0,682,682,0,6,6,0,100
6b3f2894eee7697d6d82e8ee354d9d996fab3c50,3,184,5,179,2,0,2,1,3,5,1,1,1.004009243,102,393,11,25,14,11,1729,935,794,16,9,7,99.72958356
d864f2fd4634f62b2e5684169becd9f599c6d5e3,7,125,29,96,2,0,2,2,2,30,1,4,2.496872504,867,3,0,200,198,2,6811,6485,326,91,89,2,99.73089343
2276ee050d2a22ef74c75d462fa7ddf22a38a67b,2,36,2,34,0,0,0,2,2,46,1,2,0.297472249,327,19,0,53,50,3,3048,2827,221,34,33,1,99.45205479
d75704836d466bcaed0355782ad2bc559ffa2519,1,118,0,118,1,0,1,1,1,0,1,1,0,0,20,1,5,0,5,679,0,679,5,0,5,99.01693064
70da18c541b951d3ae6ca3ffe9e0b3ab13519c1f,1,17,14,3,0,0,0,1,2,1,1,1,0,70,21,2,6,5,1,680,679,1,6,5,1,100
fc2d5782a04d748ab06c3f94b6d04ed105b8b92f,0,0,0,0,0,0,0,0,0,0,0,0,0,0,394,9,0,0,0,0,0,0,0,0,0,100
b24dc58044f655e456400d91fd10513954b7f654,12,263,30,233,0,0,0,1,2,72,1,6,3.026647254,896,395,5,150,130,20,9259,8085,1174,120,100,20,100
125f1b4e143fbe16b18965e73a7a618effb68215,4,98,28,70,0,0,0,1,2,84,1,2,1.586260267,259,396,2,60,49,11,2493,2101,392,38,31,7,100
ceaa6a5e0ab4c1d2b23e55c0d9a7cc0b63a41000,1,41,21,20,0,0,0,1,2,98,1,1,0,68,397,3,11,9,2,788,799,11,7,6,1,99.83982915
1d844b3f1f107cc645319080ff3e9e73f0dd72e2,3,84,7,77,1,0,1,1,2,86,1,2,1.04008691,215,398,1,45,38,7,2555,2255,300,21,15,6,99.83991462
630163014ccf91edd0dac79780607f73295a46a4,20,686,110,576,10,0,10,1,2,21,1,4,3.771496154,708,68,0,165,175,10,9303,10872,1569,95,99,4,95.53792762
a6df0ccac245fc74b2c8fb81253527100e7e4a80,4,229,2,227,2,0,2,1,2,35,1,2,1.123767054,113,69,1,36,22,14,2845,1267,1578,19,8,11,99.76883957
b8ae33ddb7eae55626e718f5f2902565a2104e8c,3,34,30,4,0,0,0,2,3,111,1,3,1.550955255,441,399,1,81,81,0,3437,3390,47,48,48,0,100
2550809ec8235850265b2a8d20251d6fab927812,4,457,1,456,3,0,3,1,3,1,1,2,1.001981926,77,70,2,50,10,40,3014,845,2169,34,7,27,98.30028329
e03103759a17903015eb4f61c9e56b608191c2c6,1,2,1,1,0,0,0,2,2,150,1,1,0,289,4,0,73,73,0,2505,2492,13,6,6,0,100
45cef2dc5978e487e7927149e47a0a937f6f514b,1,1,1,0,0,0,0,1,3,142,1,1,0,180,400,2,34,34,0,1280,1280,0,16,16,0,100
4236ec7b7f51c473a66c145111920af1a1117c8e,1,5,5,0,0,0,0,3,6,369,1,1,0,238,5,1,18,18,0,2334,2344,10,11,11,0,100
a97e8e1019334263b8f8b5aeaa9135345e466d2a,1,1,1,0,0,0,0,1,4,6,1,1,0,180,401,3,34,34,0,1280,1280,0,16,16,0,100
6878945645bd15036bd15c1e4b5a17ab6691fc11,2,21,1,20,0,0,0,1,2,170,1,2,0.574635698,117,402,4,16,14,2,1065,913,152,8,7,1,100
c51bcd63afffc6e5a9c8a171503bc487440b2d85,3,248,82,166,1,0,1,3,4,66,1,2,1.457392694,280,71,3,65,47,18,3594,2326,1268,35,28,7,99.7582205
38a97e54cef99749731a4b88d59b3100cc3b87e9,11,186,48,138,0,0,0,1,3,179,1,6,2.983340834,462,403,3,94,66,28,5021,4139,882,71,54,17,96.28482972
2461099628d83b8f4693c562e7f961eeab941c22,2,46,1,45,1,0,1,1,2,99,1,2,0.550984443,47,404,4,9,7,2,551,325,226,6,5,1,99.83700081
1082111c741916f62208cf783a0e69850fe60018,22,270,15,255,1,0,1,3,8,201,3,11,3.547761758,2016,405,5,431,390,41,16856,15405,1451,269,251,18,96.26966292
dea3fd93eb54c68b7083fdbdb3f798aafb4d9e9a,2,8,7,1,0,0,0,2,6,90,1,2,0.996791632,355,0,0,47,47,0,2845,2854,9,22,22,0,100
4983a0ca85d814e29cf60d3588dc2a38ce3b5aa0,5,41,47,6,0,0,0,1,2,181,1,2,2.235672884,383,406,5,59,60,1,3267,3379,112,35,35,0,99.84977466
21cf6d37f74d0813667c9e129c959cdd1556f0d1,1,10,6,4,0,0,0,1,4,12,1,1,0,60,407,6,14,13,1,466,449,17,6,6,0,100
045557973d3eae470205279f059ad8404cd95806,1,1,1,0,0,0,0,1,5,0,1,1,0,64,408,5,14,14,0,466,466,0,6,6,0,100
37a73f1039ddb205874acb58177772cef86e6485,1,7,1,6,0,0,0,1,3,27,1,1,0,35,409,6,12,10,2,285,255,30,3,3,0,100
8d18862738defb48c4064dc72cc1a2128a4d35c4,7,79,18,61,0,0,0,2,6,410,3,5,2.169450281,474,3,0,81,73,8,4218,4023,195,56,50,6,100
146f1e5055114170957f50487a985737c036ea51,2,8,0,8,0,0,0,1,2,94,1,2,0.543564443,122,72,0,15,14,1,1623,1571,52,12,11,1,99.84977466
a3dd33f453c0db6f9e6a45bde04e9a458546a292,2,125,24,101,1,0,1,2,3,49,1,2,0.829368151,290,410,4,73,73,0,3223,2505,718,8,6,2,99.9
643e4106374c95b2f17c63da3800dbdde991e341,1,45,13,32,0,0,0,1,2,255,1,1,0,72,411,2,12,9,3,1073,883,190,11,9,2,100
181b476fe25c9ba5efac7d65edcbfc8b27ae1077,4,381,54,327,0,0,0,1,3,229,1,3,1.508041423,292,412,3,110,86,24,5453,2609,2844,52,35,17,99.95014955
a708e80685b12edffd11e1c4bf8197e09e336c2e,1,9,1,8,0,0,0,2,3,116,1,1,0,55,413,4,7,7,0,832,831,1,3,3,0,100
b54ce84e7b1cbc08cfe1431c7033622d13a7a7d3,1,5,0,5,0,0,0,4,7,109,1,1,0,238,0,0,18,18,0,2356,2334,22,11,11,0,100
36bde4162ba624c5f9bdb85434c66fa889713060,10,96,33,63,0,0,0,1,7,191,1,7,2.637841523,1155,414,4,256,237,19,9999,9468,531,93,90,3,98.79923151
3eb5f0a8a7b0918e79232a301ad3db8af0756e9b,6,1141,0,1141,6,0,6,1,1,0,1,3,2.430687143,0,415,5,137,0,137,8287,0,8287,76,0,76,99.35483871
ebacb54c65be596392fbeb890856b64d6f2949b9,3,32,2,30,0,0,0,2,3,208,1,1,1.418353348,121,1,1,23,16,7,1349,1107,242,18,12,6,100
146f5080b5ff90657d3d4853d69179b4fd18ce0a,11,66,8,58,0,0,0,3,9,66,3,6,3.360075952,1055,416,6,224,217,7,8298,7978,320,116,109,7,99.90808824
cf18df6f896b4b3c684d1aaa8e4fa3cbbcbf3402,0,0,0,0,0,0,0,0,0,0,0,0,0,0,417,7,0,0,0,0,0,0,0,0,0,100
6323f481c18a1d3b7436d91e7b4c939255bcce53,0,0,0,0,0,0,0,0,0,0,0,0,0,0,418,8,0,0,0,0,0,0,0,0,0,100
d4a06967e9a05f4f81649b56b94fdb092def2d00,1,0,2,2,0,0,0,3,6,29,1,1,0,103,6,0,15,15,0,791,807,16,11,11,0,100
92ea0592f10f5cfaa6a45372a92eac4b6d2e8623,5,590,0,590,4,0,4,2,2,212,1,2,1.868727093,7,7,1,42,1,41,3886,42,3844,27,1,26,99.4947175
98458852a7c6d774de7716eef855467c0df22c87,2,84,1,83,1,0,1,2,5,22,1,2,0.487369571,297,419,2,84,79,5,3180,2573,607,8,6,2,99.90859232
fd957a9202ab2c72b835d64d9d1b08c3b5d71c85,3,117,19,98,1,0,1,1,3,183,1,2,1.05434726,265,420,3,42,30,12,2641,2155,486,27,18,9,99.77200182
3f98411364cec32a0a8c6681dfaabd43caa4dd60,1,36,0,36,0,0,0,1,2,28,1,1,0,205,8,2,19,15,4,1995,1816,179,11,10,1,100
3a377e0294765cdc464a87a280732e319140933a,3,0,1231,1231,0,0,0,1,3,268,1,1,0.799419545,996,421,2,6,204,198,335,6100,5765,5,59,54,99.7717937
028fa14b7edc631d1250acb65a11fa2b770e7241,3,23,4,19,0,0,0,1,3,329,1,2,1.218336824,323,422,3,69,66,3,2645,2547,98,45,42,3,100
bf1a094f8810cdde5e4231cd3efb99cd30d8e22e,0,0,0,0,0,0,0,0,0,0,0,0,0,0,0,0,0,0,0,0,0,0,0,0,0,100
c10996a4d995d72a0ae7dab78a2da4aca6a56af3,3,17,2,15,0,0,0,3,4,232,1,3,1.359992492,275,2,0,49,46,3,2217,2106,111,29,27,2,100
891e28d0e0e9cd8da00bed28b33d4e448697b171,2,71,16,55,0,0,0,1,3,40,1,2,0.157906374,354,9,1,39,35,4,3496,3119,377,24,20,4,100
1eae50c1a0aad49c6af4c43c8ba7b1eeb0101d9b,0,0,0,0,0,0,0,0,0,0,0,0,0,0,10,2,0,0,0,0,0,0,0,0,0,100
6b994e3bb484235b9d8e62cdf13cf924c993d3fc,4,167,51,116,0,0,0,1,4,28,1,2,1.854309905,513,11,3,58,47,11,5307,4355,952,34,29,5,99.95425435
8d47b3b5097a82c7d0aac62d4ed6859b89cf85cf,15,42,19,23,0,0,0,2,5,298,2,8,2.855653967,609,423,2,106,102,4,5246,5093,153,84,81,3,100
d91390d6cdf60bd82972bc1765d17f7758719562,1,2,2,0,0,0,0,2,4,13,1,1,0,144,424,2,19,19,0,1268,1276,8,10,10,0,100
71e67830076e328c81ec84ba745f0b8466752909,5,835,1,834,3,0,3,2,5,233,1,2,1.934097348,158,12,3,124,21,103,6935,1394,5541,61,12,49,99.58922866
ae748c8eacf45137575a4974eafeb517349fdf4c,1,3,3,0,0,0,0,1,2,0,1,1,0,46,13,4,8,8,0,426,422,4,6,6,0,100
b7781ca0858b6eee0ff7c7c2ccbe0c49f247db5d,11,280,73,207,3,0,3,1,5,251,2,7,2.831604782,512,425,2,110,84,26,5254,4120,1134,66,58,8,99.27927928
92888ff4260d1417baba66323e2dd2779f0105e4,2,161,0,161,2,0,2,1,1,0,1,2,0.947914861,0,426,3,7,0,7,718,0,718,5,0,5,99.77767897
9a63b294c84a8869df06e1008fa94ae5a7832254,3,36,27,9,0,0,0,2,2,0,2,3,1.584962501,83,3,1,7,7,0,713,713,0,7,7,0,100
35136cb4eaf45b6e4c69932d4a1dca04a68ce5c6,5,185,4,181,1,0,1,2,8,59,1,2,1.677193625,580,427,3,76,54,22,6443,5482,961,52,38,14,99.86702128
fee4d1654f791cf314b83141cef9fe99703b6477,5,68,19,49,0,0,0,2,6,249,1,2,1.912405398,590,14,2,144,139,5,5376,5037,339,34,31,3,99.60369881
ac17f4f72d2b26433ef79fec6463a7b122440ccc,3,14,5,9,0,0,0,1,4,38,1,1,0.953013885,79,428,3,16,14,2,832,770,62,5,5,0,100
acdf396b516e9a9c8348eb041be6adc1cd0de278,2,34,6,28,0,0,0,2,4,187,1,1,0.998195879,120,429,4,21,17,4,1650,1522,128,13,10,3,100
995f4d9854c3008884171719e419bb9b618740cf,3,126,5,121,2,0,2,1,2,146,1,2,1.227114501,134,430,3,33,24,9,1396,882,514,23,17,6,99.82517483
013f2e19a7d666caca352cb3874e407e682a2436,5,205,30,175,0,0,0,2,6,49,1,2,2.031524481,864,15,1,151,128,23,9032,7693,1339,71,60,11,100
14f0c16b5bcf6496bedcf184d22c10462ababe7e,5,46,7,39,0,0,0,1,4,273,1,4,1.920151369,248,431,4,47,43,4,2052,1812,240,34,32,2,100
16d4d35f73d42b97c779ba6fa8dd6be425f6faaa,2,23,3,20,0,0,0,1,2,452,1,2,0.840358672,781,432,5,159,157,2,6872,6674,198,107,106,1,100
af3df548a3d8c70cf5b4849f5e73e8a7fbe67f3c,3,28,2,26,0,0,0,3,5,221,1,3,1.110552251,428,433,5,99,92,7,3168,3056,112,48,47,1,100
ecf5dd01c21e3427cbd2de1f1bc8ca7996ba7c9e,2,21,14,7,0,0,0,2,5,242,1,1,0.512709142,343,434,4,76,74,2,2973,2940,33,28,27,1,100
7a8af286529aeacb07bd7bc6daf313d5e3f31b49,4,140,39,101,0,0,0,3,6,327,1,4,1.557636015,515,435,2,113,90,23,4670,4115,555,63,47,16,100
9b5e10808a1203fe873f38a9a9224d261e95b530,7,124,22,102,1,0,1,1,4,221,1,4,1.91561613,604,436,3,142,134,8,5290,4761,529,99,95,4,99.82570806
d2a979ca6a3cb95e2394f2ba901ca1874ffc49fa,14,172,104,68,0,0,0,2,10,199,3,8,3.031222793,1235,437,4,232,226,6,9628,9290,338,143,137,6,99.9129678
910b6afbe1deb2d99a42a9665269551c8e77a0c8,1,0,1,1,0,0,0,2,3,49,1,1,0,582,73,0,123,123,0,5090,5109,19,75,75,0,100
f47e778b78e7d667556cfa0f9ff0c3a936e91e3e,8,843,0,843,8,0,8,1,1,0,1,3,2.817229824,0,4,0,64,0,64,4981,0,4981,48,0,48,97.01086957
68cf3bd3c71bf01ed59078fc6f1a39f0d04a6f60,0,0,0,0,0,0,0,0,0,0,0,0,0,0,54,0,0,0,0,0,0,0,0,0,0,100
e0dbebf1546973f9994e0d42438e94ecd2088d00,56,313,329,16,0,0,0,3,9,442,6,30,4.578702472,5128,438,3,782,785,3,44276,44399,123,529,530,1,100
9f53a5122200244ee0340a9e85ce1478d6628dbb,2,107,3,104,1,0,1,1,3,199,1,2,0.703369339,14,439,4,9,2,7,739,133,606,7,2,5,99.85849057
9c42bab14faae4883ceccae23cfe9872d33213a4,1,20,12,8,0,0,0,2,7,106,1,1,0,303,440,5,84,81,3,2692,2629,63,6,6,0,100
ff56d0539f50b402cc23fe34059e1e44309b5677,3,100,18,82,0,0,0,1,4,203,1,3,1.1894104,446,441,6,94,86,8,4270,3651,619,59,55,4,99.71949509
655df3c45d3d49bf3787d485d94af4d68d3ccc86,42,1182,154,1028,15,0,15,1,9,150,2,14,4.766504447,1958,442,4,446,348,98,20598,16442,4156,340,267,73,92.94729027
09624fe3c79fe8bdd94b1449b394911e9d931e12,3,33,58,25,0,0,0,2,3,99,1,2,0.646193189,354,443,5,36,40,4,3121,3308,187,24,25,1,95.59089266
cde5f34e78804dd874521a4399a7110f2016b3b8,11,171,1754,1583,0,0,0,1,3,394,1,4,2.013712881,1289,444,5,77,287,210,2304,10109,7805,50,215,165,97.22099691
54efa1d6c87078bb8277c12701989a60659b1da7,0,0,0,0,0,0,0,0,0,0,0,0,0,0,4,0,0,0,0,0,0,0,0,0,0,100
dcf5d32b38806bbf89b74887cbc3da8ca5b1ef82,1,1,2,1,0,0,0,2,4,94,1,1,0,198,445,6,47,47,0,1398,1408,10,21,21,0,100
a3b56322d0185a34be0887b6571793ebcf056d52,1,9,4,5,0,0,0,2,3,484,1,1,0,93,74,0,16,15,1,661,649,12,13,12,1,100
cb92723af09cee63735cbf6b5dac5e86dd480e9c,1,12,2,10,0,0,0,3,3,300,1,1,0,71,75,1,10,10,0,662,631,31,5,5,0,100
9a689d1ed2e89417af597aad8f52354dc42d797b,6,219,6,213,1,0,1,2,7,188,1,5,1.632903432,516,446,4,120,98,22,5833,4409,1424,77,62,15,97.23369116
a7002c1178ae9e8dd522d029c96d80ba7d616df8,3,183,2,181,2,0,2,1,7,26,1,2,1.010695621,313,447,5,86,66,20,3504,2585,919,50,38,12,95.7591179
875709c4876ab259f5882b217624316e2ba3a42a,2,24,18,6,0,0,0,1,2,8,1,2,1,127,448,6,20,20,0,919,919,0,12,12,0,100
063d1446be271c7616352dda60f34225615392ab,0,0,0,0,0,0,0,0,0,0,0,0,0,0,449,7,0,0,0,0,0,0,0,0,0,100
e5a919ea88a7bead9d041ffe78cc50daecc5f98c,0,0,0,0,0,0,0,0,0,0,0,0,0,0,450,8,0,0,0,0,0,0,0,0,0,100
a787428ef599e1b6b14602618d39a76aa835811e,0,0,0,0,0,0,0,0,0,0,0,0,0,0,451,9,0,0,0,0,0,0,0,0,0,100
79e6c896bbe0dd5fb57b5358d3f0600657804bb9,1,8,0,8,0,0,0,4,6,89,1,1,0,73,5,0,19,17,2,544,516,28,17,15,2,100
2aa692e5299ee9d775218d4754ae73f3d58beed1,0,0,0,0,0,0,0,0,0,0,0,0,0,0,452,0,0,0,0,0,0,0,0,0,0,100
a724ddce5686270782cad031b071f74084ccb534,3,10,12,2,0,0,0,1,4,463,1,1,0.993897264,297,453,1,51,52,1,2543,2555,12,28,28,0,100
1381165fb8f6a51b18b78d6bd955a4aa15bfb824,13,279,68,211,2,0,2,2,8,288,1,3,2.582632628,1546,0,0,324,294,30,13836,13022,814,199,182,17,99.76280835
12dea675bf50ee767a86870dfcda744818ecb332,8,260,55,205,1,0,1,2,8,131,1,5,1.951738232,1149,454,2,305,272,33,10455,8916,1539,128,120,8,99.20486436
fb172fd84e35b4a81c4d344961259acd05f936e8,3,27,1,26,0,0,0,1,5,424,1,3,1.151565379,295,455,3,72,68,4,2095,1989,106,49,48,1,100
b9e9672d9ced2a48db95028b48407b5b2d2a830b,4,183,90,93,0,0,0,5,9,256,1,4,1.512083809,635,0,0,98,96,2,6252,5569,683,62,57,5,99.95378928
2a8b6c1498f0a0eff3f595652f1745098beca8d5,2,19,3,16,0,0,0,5,10,0,1,2,0.902393283,510,456,4,82,80,2,4638,4430,208,51,50,1,100
c51ef57aeecb78901e7489728367c2921f4c08d7,10,256,227,29,0,0,0,1,5,574,1,5,2.774560943,1384,457,5,286,291,5,12310,11904,406,156,159,3,99.95378928
e3b0d13f3d6ba01e5ff41f4b3e7c4f794f11d3ec,1,4,1,3,0,0,0,2,6,103,1,1,0,91,16,0,18,18,0,762,738,24,9,9,0,100
23bad11d6a2f89f1d069ada121f3cf6d08e7f614,3,28,12,16,0,0,0,3,11,234,1,3,1.121906486,627,6,0,135,132,3,5031,4995,36,70,68,2,100
96e3945383d15a5d70b7a6bed2f02fcd0d79e58e,19,345,303,42,1,0,1,2,10,87,2,14,3.381306642,2806,16,0,600,594,6,23282,23263,19,280,276,4,99.67756794
10bf70489b6ad132acc09085bc05d17cfefe5e73,14,288,240,48,0,0,0,2,11,466,2,9,3.086312094,2102,18,2,439,441,2,18103,17637,466,235,236,1,99.95408632
22965cf87e2793ca79048ac48adf7b41dda23ea2,2,3,3,0,0,0,0,2,5,284,1,2,0.918295834,331,0,0,39,39,0,3611,3609,2,27,27,0,100
b46c2b8b4decdf6825f91f68a296e7671b13a76b,4,239,15,224,0,0,0,2,3,178,1,2,1.181488316,230,458,0,60,33,27,3679,1973,1706,42,25,17,98.59282796
11e9b53e27ac92bc255c5484866013aee48d5e93,5,305,18,287,3,0,3,1,10,51,1,4,1.98793977,298,459,1,79,53,26,4044,2280,1764,34,22,12,98.23449525
a691b835b71c3ffaeade03bf02f5e4c0d7961557,56,1801,1068,733,13,0,13,2,12,145,2,20,4.767805201,5365,460,2,1119,1002,117,46489,41174,5315,638,551,87,96.68607255
6e6234138252f9bfa9f08758ea1443fe3f648322,46,4007,0,4007,46,0,46,1,1,0,1,6,5.161607515,0,461,3,379,0,379,25601,0,25601,210,0,210,93.23816679
8932f2a2022d05ad913bf0d0fcebed27e945ea31,0,0,0,0,0,0,0,0,0,0,0,0,0,0,462,4,0,0,0,0,0,0,0,0,0,100
e5a360512c61d368358130b4a37ef7fa19f6a4ab,1,5,1,4,0,0,0,1,2,0,1,1,0,170,463,5,29,29,0,1403,1373,30,6,6,0,100
677c269142d16aae8205cee52770aca47f638487,1,16,12,4,0,0,0,1,2,1,1,1,0,81,464,6,15,14,1,736,687,49,7,6,1,99.9671916
a959ee6c7fc400d1f455b0742641c54de1dec0bf,25,576,371,205,3,0,3,1,11,317,3,9,3.647969647,2500,465,7,400,360,40,22404,21375,1029,252,217,35,99.6068152
1f7e79cf5c7d62ec3fd8f44f2316e5eae9f6bf19,0,0,0,0,0,0,0,0,0,0,0,0,0,0,466,8,0,0,0,0,0,0,0,0,0,100
bc69671a3fd87d003b9b1fc25482aba6749f6108,0,0,0,0,0,0,0,0,0,0,0,0,0,0,467,9,0,0,0,0,0,0,0,0,0,100
9cde3d9005ede9281950a7556d3558101466b3ab,4,96,26,70,0,0,0,3,5,403,1,2,1.711619018,917,468,10,188,177,11,8357,7799,558,120,113,7,99.70491803
316ccb6bfb8579ee6c269be80ed78e18e83a6402,2,31,2,29,0,0,0,2,5,374,1,2,0.532835063,175,469,11,24,23,1,1658,1345,313,17,16,1,99.96714849
58eb227d78e6b1a32a334f83913df275ea1c7811,6,170,12,158,1,0,1,2,6,60,1,2,1.067271314,1045,1,0,220,212,8,9348,8434,914,134,128,6,99.93434012
5d666fe97b2273d17accaa9ec1adcb8cbee41885,14,489,16,473,7,0,7,1,13,73,2,10,3.333657865,1045,470,2,272,229,43,11231,8593,2638,117,81,36,90.94604582
633438c1cfc7f01957dac46546502db05a24bc74,1,1,1,0,0,0,0,3,4,35,1,1,0,92,7,0,18,18,0,819,824,5,11,11,0,100
b4cad9454bac13761091298c0f2a2e470c40ab2d,1,1,0,1,0,0,0,2,3,239,1,1,0,73,2,1,6,6,0,710,703,7,4,4,0,100
64c20ad9c2361786c225d874561511ec62dd408d,1,159,0,159,1,0,1,1,1,0,1,1,0,0,0,0,5,0,5,985,0,985,4,0,4,99.91546915
52da56301fac9cdc0baac0ee9b8fd421a5147baa,9,459,28,431,3,0,3,1,7,289,1,5,2.63742263,1539,471,1,383,309,74,15621,13566,2055,250,210,40,99.62105263
cf388fe8bd620eaa0a41c891bebf1fb2edcc5adb,1,9,8,1,0,0,0,1,2,798,1,1,0,28,472,1,4,4,0,162,170,8,3,3,0,99.83200336
3d01b9aa823b2fb5085a1404be06c0d47b8de942,4,13,45,32,0,0,0,1,3,626,1,2,1.335759915,92,473,2,11,14,3,643,640,3,11,14,3,99.83179142
c52a8e850a2aa98aaa50eec6afe8ffa8b054f042,0,0,0,0,0,0,0,0,0,0,0,0,0,0,76,0,0,0,0,0,0,0,0,0,0,100
809a6d70128ffac05b77a854350cc8621777363f,1,2,2,0,0,0,0,2,3,295,1,1,0,94,77,1,10,10,0,1045,1045,0,10,10,0,100
349e896124422b8b76ef591400f8f50aaffe6731,2,79,2,77,1,0,1,1,3,149,1,2,0.959937718,186,474,2,40,37,3,1616,1414,202,31,29,2,99.87384357
99fbc8ee82ad7b4818730287a586373c05e6f471,2,46,7,39,0,0,0,1,3,374,1,2,0.941423108,269,475,3,36,33,3,2787,2466,321,24,22,2,100
0cbccccac919989b9db9d870cef6a3e3c5d1cf4b,1,6,2,4,0,0,0,2,5,131,1,1,0,250,476,4,51,51,0,2042,2018,24,34,34,0,100
4406ded0264bfd552738bea4483603fdb2c184a0,3,146,3,143,0,0,0,1,2,837,1,2,1.363955666,258,477,5,57,42,15,3564,2853,711,49,41,8,98.8299206
234b51aa25de7f543a17c5b79b7d9fa1ae89e225,0,0,0,0,0,0,0,0,0,0,0,0,0,0,478,6,0,0,0,0,0,0,0,0,0,100
ffd8375a22ab42cfc28372516a367e6b7839a5d9,2,21,5,16,0,0,0,1,7,215,1,2,0.619382195,190,479,6,45,41,4,1800,1623,177,21,20,1,100
715128b93044eb7e3c375e2d680be9da4ee3a2c1,1,160,3,157,0,0,0,1,3,22,1,1,0,143,480,6,43,31,12,2098,1516,582,36,24,12,100
752fed58ee1d9b8b09ae959536af06b1114edf7f,6,21,4,17,0,0,0,2,7,296,1,5,2.45868857,228,8,0,39,39,0,2293,2153,140,29,29,0,99.91704687
a9165502bf0b7e43a84c6fd684f87b6499b162db,0,0,0,0,0,0,0,0,0,0,0,0,0,0,9,1,0,0,0,0,0,0,0,0,0,100
c938f5e1869509c1eba1bb508dbbe79bc510f88a,2,59,22,37,0,0,0,3,7,140,1,2,0.424405145,322,78,0,41,37,4,3944,3552,392,30,27,3,100
fce2b23b81e9a1bbe306955f3a9a8af8e3627e3f,0,0,0,0,0,0,0,0,0,0,0,0,0,0,19,0,0,0,0,0,0,0,0,0,0,100
1a160b653509eaa4ce0e9c42ed5919a5ac545b98,6,236,154,82,0,0,0,1,4,330,1,5,2.008941849,1137,481,1,254,236,18,10085,9677,408,136,127,9,100
ac3863e8019c33adae931d5d02e38e563e0b9c94,2,98,5,93,1,0,1,6,14,70,1,2,0.573459321,332,482,2,76,71,5,3350,2763,587,44,42,2,99.91728701
bf58906b1e365cb7c14c6c046ac550e87cde340b,2,120,15,105,1,0,1,1,5,26,1,2,0.938932011,64,79,1,22,13,9,1257,719,538,10,3,7,99.91742362
9df5807397196178ca8328fe5ebb5d98606df062,1,6,6,0,0,0,0,1,4,370,1,1,0,23,483,3,4,4,0,189,189,0,2,2,0,100
296abb86c99a76f74828fbee52c0b2321c28f9de,1,1,2,1,0,0,0,2,4,452,1,1,0,97,80,2,18,18,0,688,703,15,8,8,0,100
799b1232f1aa6179759506722709f26a858adedf,2,256,40,216,0,0,0,2,5,356,1,2,0.894107184,242,81,3,59,37,22,4159,2451,1708,41,25,16,100
6a4f9977c452635766801ef620f3ee28bfafd070,1,1,1,0,0,0,0,2,4,355,1,1,0,206,484,3,30,30,0,1739,1738,1,20,20,0,100
8a61e3a62a58d461cd002c2145814ea56fdcbd29,4,74,5,69,0,0,0,1,9,288,2,4,1.356031539,766,485,4,173,164,9,5764,5487,277,80,71,9,100
1b8b153154e226687b33336bd700f468c62dd4d7,15,320,71,249,2,0,2,2,8,282,1,6,3.290525108,2773,82,3,549,527,22,25397,23860,1537,382,363,19,99.67064636
0da8e3c3e5b24ad70c1ab1a64ec6dd21d7fdea11,3,115,1,114,1,0,1,3,10,81,1,3,0.34117437,342,20,1,83,71,12,3099,2446,653,37,34,3,98.03996925
d68895f32fbc22001c0577ed6a91aa5a0fd37ef0,1,2,2,0,0,0,0,1,3,400,1,1,0,34,486,5,6,6,0,187,187,0,4,4,0,100
cfee30e988b826d4c89a78622bf327e13555129f,0,0,0,0,0,0,0,0,0,0,0,0,0,0,487,6,0,0,0,0,0,0,0,0,0,100
18028aab3dfe18385bbf1d4d0f72ee97f68fbc97,5,412,41,371,1,0,1,1,9,108,1,3,1.389163139,1073,10,0,261,222,39,10068,8582,1486,160,133,27,99.92784993
e03cd2b9ca5d779310be529f0f0023380f0f6cc2,3,776,5,771,1,0,1,2,6,53,1,2,0.579243876,850,21,0,275,160,115,12390,8130,4260,179,102,77,99.85595967
eac45b00a90e1c248a4dedeade44a82b25347fec,0,0,0,0,0,0,0,0,0,0,0,0,0,0,488,0,0,0,0,0,0,0,0,0,0,100
e04f4c7d93410f05872066c8b50f608d3d30ff1b,0,0,0,0,0,0,0,0,0,0,0,0,0,0,0,0,0,0,0,0,0,0,0,0,0,100
d39923de37baedd3b3d3d83995b0882acdfeec75,0,0,0,0,0,0,0,0,0,0,0,0,0,0,11,0,0,0,0,0,0,0,0,0,0,100
c53bc7857cecec70e1c9c573a501250adb751f3d,0,0,0,0,0,0,0,0,0,0,0,0,0,0,22,0,0,0,0,0,0,0,0,0,0,100
d4917a217f7db21b9489299e39cd7f28428be9af,2,66,19,47,1,0,1,2,2,444,1,2,0.955511123,28,23,1,4,5,1,420,243,177,4,4,0,99.85627021
ada7e3a6470447dc0b90884a3d59da50b52c5315,2,35,2,33,0,0,0,2,3,328,1,2,0.909022156,131,83,0,19,17,2,1508,1233,275,9,8,1,100
b877dbdfdab7e365cbab8b5218f5051b5e780a37,0,0,0,0,0,0,0,0,0,0,0,0,0,0,1,1,0,0,0,0,0,0,0,0,0,100
3f86cf9e655bdae5af2617f46f5f256d394abcf0,2,71,6,65,0,0,0,2,6,126,1,2,0.624274101,391,84,1,62,59,3,4693,4159,534,43,41,2,100
a6430bbb18d617a32a3c8230ec9f51f4030cceb8,2,231,28,203,1,0,1,1,4,71,1,2,0.962236825,165,24,2,68,50,18,2552,1185,1367,26,18,8,99.89239598
69896816bd41f0eede0483c3f7dc61d20dc38e86,0,0,0,0,0,0,0,0,0,0,0,0,0,0,85,2,0,0,0,0,0,0,0,0,0,100
d0fefe729fc64967cdc2e27fcf973bd97697096b,3,12,2,10,0,0,0,2,8,282,1,3,0.946372936,427,0,0,90,89,1,3219,3126,93,51,50,1,100
b559e0e5840ae7f17a831270ed9c9e711cf8bae7,2,8,1,7,0,0,0,2,5,472,1,2,0.764204507,272,12,0,54,54,0,2051,2051,0,41,41,0,100
9355e74ec221bd6e2835ac591e7e30f1654799b5,5,123,0,123,1,0,1,1,6,311,2,5,1.676710717,753,489,0,152,143,9,7368,6633,735,97,90,7,99.78517723
1e142de03d82c7126f3b103fbd4e6a866631b0f4,3,38,2,36,0,0,0,1,2,390,1,2,1.53949107,142,490,1,18,15,3,1995,1554,441,10,9,1,99.71336439
7d908c7c8f456d5b6acb49162dabf2a6f7a4c7ff,11,42,28,14,0,0,0,2,9,523,3,8,2.581134748,1832,0,0,335,332,3,15749,15715,34,188,187,1,100
26f6bb2d392d79d96d9129231657c2b17edd394a,5,11,8,3,0,0,0,2,4,642,1,2,2.102933434,544,86,0,96,96,0,5493,5461,32,67,67,0,100
f81b5c253fb6380e5cd68d320a9a74f0b2a2c5d0,3,38,3,35,0,0,0,2,10,470,1,2,1.21018798,933,87,1,194,191,3,7877,7685,192,118,115,3,100
58ab2fa674381520cf0e7b0bf65e2206b6b6a692,0,0,0,0,0,0,0,0,0,0,0,0,0,0,88,2,0,0,0,0,0,0,0,0,0,100
2c9e8306caddf7ed687c62802dc63fbd46110a90,7,279,146,133,2,0,2,1,3,204,2,4,2.19960129,664,491,1,124,112,12,6197,5648,549,61,43,18,99.74910394
c88ce47187b0a06ceba1e12ddee3077bf3f16b36,6,17,14,3,0,0,0,3,10,437,1,2,2.166377459,1326,492,2,171,170,1,11615,11605,10,86,85,1,100
1d4448e64e79724f5973022da3da94655a38c04c,3,15,5,10,0,0,0,1,7,27,2,2,1.156779649,669,493,3,137,133,4,5427,5334,93,68,68,0,100
a32bd8fc9d5b65bcbaf02caba0ee8156c03ede65,0,0,0,0,0,0,0,0,0,0,0,0,0,0,494,3,0,0,0,0,0,0,0,0,0,100
1b1e523e5b8be2e094e98609aad97278dca6fdd9,2,115,5,110,1,0,1,3,12,193,1,2,0.650022422,325,0,0,96,87,9,3570,2818,752,9,6,3,99.92846924
a4d1f84613e78ca023e52763025988772b7f3913,0,0,0,0,0,0,0,0,0,0,0,0,0,0,495,4,0,0,0,0,0,0,0,0,0,100
d186658cb7d925979f0f4f745ed33f75eeb0b3ef,2,47,6,41,0,0,0,3,5,604,1,2,0.968700344,406,89,0,72,70,2,4313,4013,300,35,33,2,100
25c22e58d7cadd29208bab8b5000c2429b115723,2,75,1,74,1,0,1,3,11,119,1,2,0.175565026,198,496,5,46,38,8,1766,1383,383,18,16,2,84.68858131
f2cf619ca35307f39b86fc348aba8ff633ee0c5c,2,5,2,3,0,0,0,1,5,35,1,1,0.863120569,409,497,5,81,81,0,3238,3212,26,32,32,0,100
128c110e4ac2bd2d75777bb12f981aaccdf2a797,1,2,2,0,0,0,0,1,2,464,1,1,0,142,498,5,16,16,0,1916,1916,0,13,13,0,100
997f76476416b19c58061de34921b64b53559591,0,0,0,0,0,0,0,0,0,0,0,0,0,0,499,6,0,0,0,0,0,0,0,0,0,100
00bc96991d9f8e0723af320930892fd1ce91da1a,0,0,0,0,0,0,0,0,0,0,0,0,0,0,500,5,0,0,0,0,0,0,0,0,0,100
bbeb7537a581939c6c22dfdcffe8625b9336589a,0,0,0,0,0,0,0,0,0,0,0,0,0,0,501,6,0,0,0,0,0,0,0,0,0,100
b90427f3efbbb6c5b7bdde57aa2ca6d464ff0f18,0,0,0,0,0,0,0,0,0,0,0,0,0,0,502,7,0,0,0,0,0,0,0,0,0,100
657cdd6b37a6d2beefb2c43f8d5407c8c4cb13cd,1,1,1,0,0,0,0,4,7,73,1,1,0,86,0,0,11,11,0,521,520,1,11,11,0,100
ce79a7a1be6cc4670d4fcf58184028a0663ef139,10,1588,0,1588,10,0,10,1,1,0,1,3,3.084624789,0,0,0,128,0,128,6032,0,6032,53,0,53,98.80823402
077343a5d7f777c8a6e26aee9ae64833f4a0ae47,5,79,36,43,0,0,0,3,11,479,1,2,2.101377199,465,13,0,51,48,3,4048,3695,353,36,36,0,100
a62a24b6f80666d92cac2b6dfa5c088e51f26ef6,1,2,2,0,0,0,0,2,2,1978,1,1,0,237,503,5,69,69,0,2140,2140,0,14,14,0,100
dc03c913318d2853eed3751886fe45bdfdf7dfa4,2,12,10,2,0,0,0,1,6,640,1,1,0.994030211,244,504,6,49,49,0,1638,1620,18,24,24,0,100
9ddd029f48c74061980c7f15187c474d288095ee,0,0,0,0,0,0,0,0,0,0,0,0,0,0,505,7,0,0,0,0,0,0,0,0,0,100
567d25dd7d56e4e9f0a1fb3c4ac04fd198c22275,6,33,18,15,0,0,0,2,8,509,1,4,2.291560114,736,506,8,152,151,1,5818,5700,118,75,74,1,100
c135bba631c106f93aa2cb4f973bbff4262aba0d,2,15,15,0,0,0,0,1,4,359,1,1,0.970950594,268,507,7,62,62,0,3026,3008,18,55,55,0,100
fcb861edce7a5b2a76e2a21300b054932174bc47,1,1,18,17,0,0,0,2,8,513,1,1,0,110,508,8,16,20,4,830,926,96,10,11,1,100
583ea6dabc457ec69f316b52548b1dc92f99dda1,14,114,71,43,0,0,0,2,11,503,2,5,3.210248677,2033,509,9,424,416,8,16891,16515,376,214,213,1,98.61849097
35d404c9b46bf7fb102dab9a4a1b96a5b1f89926,0,0,0,0,0,0,0,0,0,0,0,0,0,0,510,10,0,0,0,0,0,0,0,0,0,100
f2dee62dbcd6a64580498b68604a54b345d9bb40,0,0,0,0,0,0,0,0,0,0,0,0,0,0,511,11,0,0,0,0,0,0,0,0,0,100
fcb1aa4158f90001c114daa90d68ce99fd8870e4,1,19,1,18,0,0,0,2,9,0,1,1,0,94,512,12,20,16,4,945,830,115,11,10,1,100
bea44469e5d3cd3925a26986d85fb146f43874b8,0,0,0,0,0,0,0,0,0,0,0,0,0,0,513,13,0,0,0,0,0,0,0,0,0,100
b4486cc9c1bdf1d53aebf62c2b28e9ea153d83e1,1,3,0,3,0,0,0,4,8,12,1,1,0,146,514,11,27,26,1,988,977,11,19,19,0,100
a8ce5385ee674b6b14cdf095628be494d8d52229,2,2,16,14,0,0,0,2,5,20,1,1,0.503258335,136,515,12,31,34,3,943,1051,108,12,12,0,100
772f7f2b21c9c817f481fd7e2a4f030378cadb3d,4,75,109,34,0,0,0,2,12,218,1,2,0.910827942,996,90,0,196,199,3,8073,8196,123,117,120,3,100
96ef2d679c9a7bf6c2cb80190e0646f94f558482,2,16,2,14,0,0,0,3,8,235,1,2,0.309543429,878,0,0,182,179,3,7627,7525,102,111,109,2,100
9898ee92fc36fed739201fa0b2593175519b2ab4,2,34,6,28,0,0,0,6,15,491,1,2,0.286396957,440,91,1,78,78,0,4005,3799,206,50,49,1,85.81328985
2ef8c1678369fd84705a24ac99d35be7a744fada,3,19,13,6,0,0,0,3,6,186,2,2,1.014097656,424,516,3,113,112,1,3749,3681,68,33,33,0,100
fd0bce36b918621ff45149e877848b14da3b8fed,4,141,17,124,1,0,1,3,13,332,1,2,1.343791369,545,517,3,147,134,13,5634,4769,865,23,19,4,99.93355482
ac4a525ad65e44c564290beb4642f588e3b96e23,0,0,0,0,0,0,0,0,0,0,0,0,0,0,518,3,0,0,0,0,0,0,0,0,0,100
189febe62496e3e44386c3d095949a3041a6bae0,3,100,3,97,0,0,0,2,7,740,1,3,1.182025682,143,519,4,28,18,10,1957,1232,725,14,12,2,99.60146131
a8a8a9b86168e4e38a4cee2e542c4aa3f8df870c,3,5,6,1,0,0,0,3,6,524,1,3,1.095795255,949,520,5,217,217,0,7176,7172,4,148,148,0,100
c70f2cc39669db35be05556d09e8e7d08534705c,1,11,1,10,0,0,0,5,12,78,1,1,0,150,0,0,23,21,2,1311,1246,65,18,16,2,100
ac816fd44bfa083bee4a324fbcee7998f9bb8044,1,1,1,0,0,0,0,5,13,0,1,1,0,157,521,5,23,23,0,1311,1311,0,18,18,0,100
8027f706ae47b613c6f0e96e0ee9f7ef21d1d6ed,4,63,15,48,1,0,1,1,8,233,1,4,1.537542688,372,92,1,84,82,2,3819,3596,223,64,60,4,99.93359894
ace392bde724273b1d300f7b01c4648e9e1b9060,2,66,47,19,0,0,0,1,2,108,1,2,0.979509158,190,1,0,27,22,5,1792,1593,199,11,8,3,100
e1bfa47e8c77c96bd62334cc3e4cae36c29085da,5,185,9,176,2,0,2,1,5,420,1,5,2.047603727,229,522,1,60,46,14,2810,1821,989,36,27,9,99.36960849
ebe3061260ee02752536384ff1f7d9cf72d09831,2,106,17,89,1,0,1,1,2,309,1,2,0.986176332,63,523,2,17,8,9,1110,644,466,8,4,4,99.933687
8434dcaab5504e69c42b914551634b2a9ac838b2,2,28,10,18,0,0,0,1,5,173,1,1,0.74248757,230,524,3,45,40,5,1913,1765,148,24,22,2,100
92025c7e33d69414a427fc62daa88137b2f902d5,11,624,39,585,5,0,5,1,13,116,1,5,2.678251211,1459,93,1,324,283,41,15964,12811,3153,233,196,37,99.50576606
afcfb66e871e817929ab066ed1c47fd150443482,0,0,0,0,0,0,0,0,0,0,0,0,0,0,525,4,0,0,0,0,0,0,0,0,0,100
63a2e29b82d112d1fff6804378db2457052819b4,4,99,7,92,0,0,0,2,14,228,1,2,1.676161975,1351,94,1,266,259,7,11573,11267,306,164,159,5,99.9672346
dac78384a0a7c493244b56ea5deae332f05b26cc,1,45,0,45,1,0,1,1,1,0,1,1,0,0,526,4,4,0,4,236,0,236,3,0,3,99.8690671
5201256c20365de678d197de623a1034b3ae3f2e,9,197,88,109,0,0,0,1,3,138,1,3,2.921675841,804,2,0,133,127,6,6375,5859,516,55,54,1,100
59263aaf26436ea3ab5ffe8976465c03d0522863,3,17,12,5,0,0,0,2,7,380,1,1,1.572704142,316,95,2,72,72,0,3486,3495,9,65,65,0,100
ded504eb133fa0814e2d90ff2a662e72a67e04bb,2,42,10,32,0,0,0,1,3,1087,1,2,0.811278124,151,527,5,24,22,2,1252,1157,95,19,18,1,100
0e7e0d0b079c2ff51dbcd483402802917ac79f8f,0,0,0,0,0,0,0,0,0,0,0,0,0,0,528,6,0,0,0,0,0,0,0,0,0,100
3f13ee65c9debcf6bd7366607f58beae6c73ffe2,0,0,0,0,0,0,0,0,0,0,0,0,0,0,529,7,0,0,0,0,0,0,0,0,0,100
71d59b6910747d98eecbde5492c04db1226a8062,2,40,3,37,0,0,0,4,15,461,1,2,0.271389588,802,530,3,180,173,7,7081,6782,299,106,102,4,100
cacb383778242c9cfb1590d0d3e0a446a80951e4,0,0,0,0,0,0,0,0,0,0,0,0,0,0,531,1,0,0,0,0,0,0,0,0,0,100
31d80f5d565f1f58bc813d841a8efe10301b8cbd,0,0,0,0,0,0,0,0,0,0,0,0,0,0,532,2,0,0,0,0,0,0,0,0,0,100
21965a6e2b3729afc8fc92ab041656e5a7c46f35,30,980,93,887,3,0,3,1,16,386,2,14,3.939010278,3678,533,3,829,732,97,34235,29807,4428,427,382,45,99.1
5d43171a140ddfe84aee602be473b1226e784770,2,57,19,38,0,0,0,2,6,710,1,2,0.868040399,284,96,0,52,48,4,2687,2468,219,27,24,3,100
6fc84b125a6dff2dc0c9cadeacb913919670e98c,0,0,0,0,0,0,0,0,0,0,0,0,0,0,97,1,0,0,0,0,0,0,0,0,0,100
2e135095190c2d24c1ecf1036200cf2189493193,0,0,0,0,0,0,0,0,0,0,0,0,0,0,1,0,0,0,0,0,0,0,0,0,0,100
f17d7f7b017ae30ab8c7a164e174cc5280daab3d,2,61,2,59,1,0,1,2,4,47,1,2,0.764204507,108,534,4,19,16,3,1205,864,341,17,15,2,99.93206522
f0f75f3c731fca2c629e881532ac6d66ece97f65,1,1,1,0,0,0,0,2,6,554,1,1,0,51,535,5,11,11,0,537,537,0,2,2,0,100
f8cc90a751b7779ee67fab66160af311b9282c4a,4,105,29,76,1,0,1,1,4,749,1,3,1.69296733,253,536,6,51,45,6,2952,2368,584,37,34,3,99.93215739
f5d3858aa57c71ef38835031218163a3d4121381,2,15,1,14,0,0,0,1,9,432,1,2,0.69621226,300,537,7,59,57,2,2549,2428,121,39,38,1,100
dee0fcf51bfaa96c3dde773bbc8745fcc1ecb6f5,1,28,2,26,0,0,0,1,6,161,1,1,0,130,538,8,48,38,10,1195,1003,192,12,10,2,100
363c8243b90e5df0394e8edb547f268b2408f250,21,2415,0,2415,21,0,21,1,1,0,1,6,4.171640539,0,539,9,256,0,256,13797,0,13797,145,0,145,92.40641711
4aaa5d6c51e1f2f26a1e620a953533dead1acfd9,2,42,10,32,0,0,0,4,16,415,1,2,0.391243564,860,540,10,197,189,8,7375,7256,119,117,117,0,100
f54d3d638022a341fa5ba1eeb6689036d9478e53,2,2,2,0,0,0,0,2,7,130,1,1,1,163,541,7,30,30,0,1300,1300,0,15,15,0,100
c182309f082757c10e6c817890a8b0f819f3ef89,1,3,0,3,0,0,0,3,7,181,1,1,0,233,542,8,41,41,0,2451,2420,31,17,17,0,100
7f54a0e22cebca659cb8164e52b5eb4713125041,5,56,20,36,0,0,0,1,6,639,2,4,1.813147304,530,543,7,99,95,4,4309,4065,244,45,42,3,99.96240602
2d20e7772beee8f588431c6767b411895be94f6c,6,145,10,135,1,0,1,1,7,287,1,4,1.288072997,471,544,8,105,87,18,4763,3921,842,42,30,12,99.92486852
4354658703c50f9506b30e6f0768b4a473817807,34,679,111,568,13,0,13,1,8,305,1,5,4.45795308,1227,545,9,231,196,35,13072,11146,1926,109,88,21,92.42575909
e8b19e68eb850244f5613b5fc83efa8d9947f215,0,0,0,0,0,0,0,0,0,0,0,0,0,0,546,10,0,0,0,0,0,0,0,0,0,100
a8ffc4643b1b10d7371ed80ab60562d1bad606b1,0,0,0,0,0,0,0,0,0,0,0,0,0,0,547,11,0,0,0,0,0,0,0,0,0,100
ef939b77827ea8fdf3687e4e11f992451ad585e6,2,5,6,1,0,0,0,3,5,747,1,2,0.845350937,149,55,0,20,20,0,1367,1346,21,10,10,0,100
0a6c8decb6682aa3a37f639b9db9bb3e1f30d41b,0,0,0,0,0,0,0,0,0,0,0,0,0,0,548,7,0,0,0,0,0,0,0,0,0,100
f12eab83e18caed24a168c5753902c50e2b4c1a5,3,48,3,45,1,0,1,1,4,277,1,3,0.630594179,65,549,6,13,10,3,910,671,239,6,4,2,99.93997599
3740f3b1b955d1258cc5f1105f1fe97b8109002c,1,5,3,2,0,0,0,1,2,861,1,1,0,56,550,0,13,13,0,356,339,17,9,9,0,100
f6ed0ca3ae532df2a701d65b986eadc27c0b1a2d,1,2,1,1,0,0,0,2,5,668,1,1,0,208,551,1,40,40,0,1574,1574,0,31,31,0,100
1e2ea6eb8eefc9fa97311ee8131152543a03f561,0,0,0,0,0,0,0,0,0,0,0,0,0,0,552,2,0,0,0,0,0,0,0,0,0,100
8f525cc623b607f91811c95caa6f52a55553108e,0,0,0,0,0,0,0,0,0,0,0,0,0,0,553,3,0,0,0,0,0,0,0,0,0,100
24c1c176c9cad115b8cb517f33d2cdaf83ddaecc,1,20,0,20,0,0,0,2,8,513,1,1,0,317,554,0,27,26,1,2942,2831,111,17,17,0,100
0157d03bf75bed3e05446c66feb672dc37222a65,0,0,0,0,0,0,0,0,0,0,0,0,0,0,555,1,0,0,0,0,0,0,0,0,0,100
82cecc0cea64cb3cd47d6bc0c9562e49509b34ca,43,185,203,18,0,0,0,2,17,569,6,27,5.279181341,7187,14,0,1357,1355,2,58037,58577,540,642,642,0,100
25332614830ca61df05d2f68074f4462b8bdf1d4,5,79,15,64,0,0,0,4,16,164,1,5,1.282990798,1097,556,2,232,227,5,9420,8910,510,70,68,2,99.94008388
2c7821fd353dd1618af112d27cbc3a936142d61c,2,179,25,154,0,0,0,2,4,1008,1,2,0.902882612,308,557,0,42,39,3,3908,2835,1073,32,29,3,100
d4f23c42c6d215a07ecfea74b1b6cddbc1537eeb,3,262,57,205,1,0,1,1,10,429,1,3,0.709263337,363,558,0,101,65,36,4512,3085,1427,46,26,20,99.94019139
36c100e7b6ed23cbf0a25bd84b6d68ee88652b01,1,212,0,212,1,0,1,1,1,0,1,1,0,0,15,0,11,0,11,1249,0,1249,11,0,11,98.93001735
3088d827506c28ecb2b845a55fd14c4a0bda324b,0,0,0,0,0,0,0,0,0,0,0,0,0,0,2,0,0,0,0,0,0,0,0,0,0,100
6543ded556dbbd4e8e25e59730f7f5fa8e2c3c26,17,1257,283,974,6,0,6,3,18,212,2,9,3.276885903,2071,22,0,542,426,116,21785,16853,4932,211,152,59,94.96229261
e3141009a4eb818f3826bbd55b81365cb518c0a8,1,2,2,0,0,0,0,1,2,0,1,1,0,109,23,1,25,25,0,799,799,0,12,12,0,100
48e4e79412b83013bea3e8a7723d4a7917f6ce49,9,163,21,142,2,0,2,1,3,577,1,4,2.162164787,267,559,0,51,43,8,2866,2082,784,31,23,8,99.54188482
3477ea431015a81ad2cee825ca9410f6da441dee,10,913,0,913,9,0,9,1,3,180,1,2,3.022684469,92,3,1,68,12,56,6717,1137,5580,51,11,40,99.18699187
85c2642ca6a759a5d53fc725594ec336edeb0f49,3,28,5,23,0,0,0,5,10,816,1,1,1.233515936,982,560,1,223,216,7,8145,8019,126,120,118,2,99.96772111
7f00d785aa7a6f854a596f8eb4a898738c8d5977,1,1,1,0,0,0,0,2,5,189,1,1,0,140,561,2,29,29,0,1239,1242,3,21,21,0,100
ab7e5e4c3b1956d5ae6efe8706110e003179d6b6,1,7,4,3,0,0,0,4,16,42,1,1,0,219,562,3,46,45,1,1619,1598,21,17,17,0,100
006cd72a383d91ba15ec0d6b596872a062567d48,32,977,69,908,5,0,5,1,19,571,2,14,4.157006272,2912,563,3,581,490,91,29621,23940,5681,383,325,58,98.1569749
cbb1b7e757a7302b6b656ceaf1170033435df23c,0,0,0,0,0,0,0,0,0,0,0,0,0,0,564,3,0,0,0,0,0,0,0,0,0,100
4f2b1f25fe21aca7c2df4747e754862d113173be,2,42,18,24,0,0,0,2,5,434,1,2,0.2108423,165,565,3,29,24,5,1381,1244,137,22,19,3,100
7157c0a1f481ffa6e817065abce3159ef24ec067,0,0,0,0,0,0,0,0,0,0,0,0,0,0,566,4,0,0,0,0,0,0,0,0,0,100
ebb1b2e32a901caaa2858e9d12536ce1095c1696,5,57,16,41,0,0,0,1,20,361,1,4,2.142799924,1187,567,5,250,248,2,10188,9797,391,157,153,4,100
e84751081ec6d8f995b6a41f0c4488f0ff86daf1,0,0,0,0,0,0,0,0,0,0,0,0,0,0,568,6,0,0,0,0,0,0,0,0,0,100
5dccb5330e947b80a22c813d2e0d519c8e470f03,0,0,0,0,0,0,0,0,0,0,0,0,0,0,24,0,0,0,0,0,0,0,0,0,0,100
958d011a4c4c704bd2e12dfbb8f7216342c7fb1f,3,264,0,264,3,0,3,1,1,0,1,2,0.839938613,0,25,1,29,0,29,1671,0,1671,17,0,17,99.75023416
4e1cc9ede6fe794c0b0ab798c2a389177446e095,0,0,0,0,0,0,0,0,0,0,0,0,0,0,569,7,0,0,0,0,0,0,0,0,0,100
050b4a9e18f25cf9615dc07be21c5389624f58c9,1,7,0,7,0,0,0,1,2,86,1,1,0,49,4,0,10,9,1,512,467,45,9,8,1,100
5e6e335363d86630a14067b37bd8efc6e5bc1607,3,138,5,133,1,0,1,1,2,14,1,2,0.755173629,154,26,2,34,25,9,1804,1162,642,20,13,7,99.9377335
dbd56e638456437451e8bc12bb0dfe55aef0f254,1,1,2,1,0,0,0,1,5,50,1,1,0,211,570,5,44,44,0,1434,1456,22,22,22,0,100
fcf901cbb437faf65cae6d1fb4c3513084fe4186,3,308,44,264,1,0,1,3,12,105,1,3,0.667493774,365,5,0,109,66,43,4915,3101,1814,49,27,22,99.93781095
cd4b3887bd8d52c89151c7dba0cffa6e1615c364,0,0,0,0,0,0,0,0,0,0,0,0,0,0,27,1,0,0,0,0,0,0,0,0,0,100
d7443e3927aaec99563d8a48fe1341c5d5b8f85a,4,33,11,22,0,0,0,1,5,809,1,4,1.519999942,1036,571,1,226,223,3,7194,7066,128,172,171,1,100
04e02516a975d02014078bfb418fae83c2c8b919,1,1,1,0,0,0,0,3,7,90,1,1,0,288,572,2,64,64,0,2178,2182,4,45,45,0,100
8c35a13996eba01671ce7c7c6f369b180bdd408b,1,10,15,5,0,0,0,3,7,54,1,1,0,314,573,2,61,61,0,2734,2767,33,29,29,0,100
3ab0b078c47f23b3ba893fdfb05fd723f663d02b,2,109,24,85,0,0,0,1,4,1077,1,2,0.783346567,869,574,0,221,201,20,7387,6996,391,166,154,12,100
b34cf6dfbd4875fed7762fea10e94ddda52c5ae3,0,0,0,0,0,0,0,0,0,0,0,0,0,0,575,0,0,0,0,0,0,0,0,0,0,100
ba7a3477cd74777717c19cc0a85916a2a2208e8b,0,0,0,0,0,0,0,0,0,0,0,0,0,0,576,1,0,0,0,0,0,0,0,0,0,100
a3761da72503ee209b487d831178d234281ac332,1,4,0,4,0,0,0,2,2,1282,1,1,0,39,577,2,3,3,0,203,177,26,3,3,0,100
cc62ef73edaba3905d10d501374486146be44f70,0,0,0,0,0,0,0,0,0,0,0,0,0,0,578,3,0,0,0,0,0,0,0,0,0,100
87318ca7eec9f35ad9c2e386531344b5e1f8a45b,1,6,1,5,0,0,0,2,9,303,1,1,0,146,16,0,30,28,2,1266,1222,44,16,15,1,100
504a6194edb5e066e248e78f83e4519bb6e82c58,2,23,1,22,0,0,0,3,6,1556,2,2,0.41381685,313,0,0,35,33,2,3207,3028,179,22,21,1,100
c9be5e87d680594432d0aa971cf874fe8ab2b2f8,0,0,0,0,0,0,0,0,0,0,0,0,0,0,98,0,0,0,0,0,0,0,0,0,0,100
9f4193163d739cf1da4049f5793455d41e32b888,4,252,1,251,3,0,3,3,10,145,1,2,1.658532208,139,579,2,47,30,17,2500,1054,1446,28,18,10,99.81389578
6e3560651ed3a0bd47cab2ad0ec1c808e599e050,4,17,24,7,0,0,0,3,11,655,2,3,1.930007492,603,580,3,108,112,4,5021,4998,23,40,40,0,100
7c2a02ee6dd4183340366e37dc2eb293a3eb5217,0,0,0,0,0,0,0,0,0,0,0,0,0,0,581,4,0,0,0,0,0,0,0,0,0,100
61f98eea9458a97fe24c851b67dd0f746d189ab4,0,0,0,0,0,0,0,0,0,0,0,0,0,0,582,5,0,0,0,0,0,0,0,0,0,100
d0bb205eaf236bf1d81b9070a2db3428cb90a161,31,121,92,29,0,0,0,4,12,1058,6,21,4.485607542,4791,1,0,812,805,7,40390,40241,149,476,473,3,100
e90cf2782d89e61f5c4f2a19a7879a1da357facc,0,0,0,0,0,0,0,0,0,0,0,0,0,0,2,1,0,0,0,0,0,0,0,0,0,100
85b985a725e181444867efb3b9d5cf7ac8f0ef52,14,14,1018,1004,0,0,0,1,9,1298,2,7,3.330117487,1296,583,4,119,186,67,5223,11030,5807,56,100,44,99.00466563
9bb526fd1f67c06641c24e29a3e2b1078877e9f2,3,16,1,15,0,0,0,1,3,1575,1,1,1.565653112,122,584,5,25,22,3,918,848,70,25,22,3,100
6c8c5ffd0447da82e63cf0b74ed2026c77a0c554,3,24,3,21,0,0,0,5,13,743,3,3,1.248654521,596,3,2,94,94,0,5292,5151,141,51,51,0,100
5bd258d1c0244fdb2c8a6d83b766fde08bb33354,7,122,90,32,0,0,0,4,12,883,1,2,2.074386933,1288,585,2,186,185,1,10834,10455,379,90,88,2,100
aaaec816c0cc75855a8b8f7f0e2367d682b67ac1,1,0,18,18,0,0,0,5,14,5,1,1,0,196,4,3,13,13,0,1810,1929,119,10,10,0,100
cddba97c5e1b08e9e5f1bded5c16abcbec31d670,0,0,0,0,0,0,0,0,0,0,0,0,0,0,99,0,0,0,0,0,0,0,0,0,0,100
06688d55ee306a52d243b10de017ebeec913577a,7,131,9,122,3,0,3,3,6,718,1,6,2.134485646,323,100,1,62,57,5,2575,2247,328,44,41,3,99.75054568
626853abb7f996107941875653b8292f462ba3b9,2,71,4,67,0,0,0,2,3,1944,1,2,0.918295834,110,0,0,45,36,9,1327,882,445,19,15,4,100
484545a583603f9b69ef87c7b1c981d0267b1275,1,1,3,2,0,0,0,4,18,650,1,1,0,787,586,3,168,168,0,6792,6798,6,98,98,0,100
d4da529985593ecf84c057938baf706a144e9024,1,3,7,4,0,0,0,2,3,502,1,1,0,109,587,0,25,25,0,799,799,0,12,12,0,100
d176778cf803374506cb7743069a05e28e07e2cf,0,0,0,0,0,0,0,0,0,0,0,0,0,0,588,1,0,0,0,0,0,0,0,0,0,100
b06c5cc27b97d92d5c0b689cf58af90166155717,2,36,3,33,0,0,0,5,15,421,1,2,0.779349837,340,17,0,41,36,5,3280,3074,206,32,28,4,100
1f5323bd18115f24f02234788f9d6073c64a916f,1,1,0,1,0,0,0,5,13,745,1,1,0,121,0,0,21,21,0,966,959,7,10,10,0,100
7f85ee5816a19eca0e87ce503ea0b03ea294433c,5,94,25,69,0,0,0,4,13,1253,1,5,2.142971442,706,589,2,148,139,9,5950,5488,462,69,62,7,99.8443822
2bd612eb9c115f857f5776f58fbd336028a438b3,3,35,5,30,0,0,0,2,10,904,1,2,0.991760148,398,590,3,74,73,1,3057,2836,221,44,43,1,100
8d9c54037243b10acccacf21de791ff725180e31,5,236,145,91,1,0,1,4,18,335,1,2,1.375495385,617,101,0,138,133,5,5291,5146,145,32,27,5,99.8755832
a727606eaeaea2d78a161685d9d29217864e6846,2,26,16,10,0,0,0,4,11,341,1,2,0.702466551,897,102,1,185,185,0,7725,7660,65,112,112,0,100
16209bed6f2290352807bf7d1796a5188d974702,0,0,0,0,0,0,0,0,0,0,0,0,0,0,591,2,0,0,0,0,0,0,0,0,0,100
a670b91697bcb89faff252dd4204d8273b6dbf2d,2,61,7,54,0,0,0,3,6,811,1,2,0.984343203,153,592,3,23,18,5,2022,1476,546,11,9,2,100
b6accf4e33d8311225cf03f29c674dc25bec451e,2,36,11,25,0,0,0,1,3,2185,1,2,0.419921097,78,593,4,18,14,4,835,722,113,11,7,4,100
b2e6d169b3492d9a04c8a76ca771f586bbaa760d,2,39,16,23,0,0,0,5,13,172,1,2,0.994030211,757,103,2,116,111,5,6847,6680,167,52,49,3,100
de1553e73c646f3747c71a5b345d15c33a32f230,2,15,6,9,0,0,0,5,14,86,1,1,0.791858353,593,104,3,113,113,0,4966,4876,90,45,45,0,100
9146d10dae2452e699ac9506f5bbe754902dfc32,3,5,9,4,0,0,0,2,19,82,1,2,1.378783493,999,594,3,198,198,0,8394,8414,20,120,120,0,100
95e92fc898329b5b762e0a76be1b3396d61430b4,3,40,12,28,0,0,0,1,20,1169,1,2,1.548580607,945,595,4,194,190,4,8300,8105,195,118,118,0,100
29d1ce4cddcddc86cda36bd464c26df4bdff3ae4,3,245,3,242,1,0,1,4,13,456,2,3,0.180105408,479,596,5,103,94,9,5593,3849,1744,41,34,7,97.00740741
2f5b33ead752deb4796989f56f9aebf6e3330286,2,7,16,9,0,0,0,1,8,618,1,1,0.666578358,243,597,6,46,49,3,1578,1619,41,24,24,0,100
3a1d474b0514f02a5ce46f6db1fbe2e8abcb03be,2,80,0,80,1,0,1,1,4,275,1,2,0.230709956,68,598,7,20,13,7,950,480,470,16,13,3,99.9434069
8bae517ea1e1cb919ecc067eb6b877a4f58916f5,10,93,21,72,0,0,0,3,16,761,1,2,2.952628951,971,18,0,148,136,12,8194,7694,500,91,82,9,100
20a83b8953e88709a1060ac3171e01c07415a41a,0,0,0,0,0,0,0,0,0,0,0,0,0,0,599,7,0,0,0,0,0,0,0,0,0,100
2befc029950ec521479a7920e157848f8745db2e,0,0,0,0,0,0,0,0,0,0,0,0,0,0,600,8,0,0,0,0,0,0,0,0,0,100
54de732479e7e55e86fbe8048b35d93323bf3b13,2,38,186,148,0,0,0,2,6,325,1,2,0.073603483,928,105,0,184,222,38,6937,7395,458,144,166,22,100
366da2ee0996c573ecb3a3094a29d697ec539db3,3,427,9,418,1,0,1,1,5,530,1,3,0.268336591,163,601,0,51,19,32,4752,1618,3134,26,7,19,99.88697372
60b28b12b26348a2e17ae5f8023e8f4256cd03fc,15,641,32,609,5,0,5,1,11,671,1,5,3.354000085,1390,602,1,304,240,64,15654,12012,3642,242,182,60,99.63369963
19c0c2d8d78ebb490334bf019965e74b44ff49c4,1,1,1,0,0,0,0,4,14,112,1,1,0,386,19,0,76,76,0,3131,3125,6,23,23,0,100
e884bf238bdb9443d091690e8db19f5c2ed4c6df,0,0,0,0,0,0,0,0,0,0,0,0,0,0,603,1,0,0,0,0,0,0,0,0,0,100
f629b8e6bc1bf9f0fc3f5f6e3c5d28a01c593855,4,164,2,162,0,0,0,2,7,370,1,4,1.900488697,1142,604,0,265,244,21,11020,9719,1301,203,186,17,100
abaa203b6d6ac141e9e11410a62e2655d140e04b,2,8,2,6,0,0,0,4,8,1121,2,2,1,244,106,0,44,42,2,1783,1759,24,20,20,0,100
f8c98a6c69dcd1e971f2b35b94a2bb99a4233b4e,2,133,78,55,1,0,1,1,4,670,1,2,0.98228293,137,0,0,16,19,3,1447,1056,391,10,6,4,99.94378865
57235348d6628d28c3a869f23aca15888aa377be,2,18,4,14,0,0,0,1,8,1307,2,2,0.945660305,267,605,1,44,43,1,2887,2733,154,20,19,1,100
b4da23b26539aeea4ca9cd88e8799739ef7b6da4,5,322,5,317,3,0,3,1,7,105,1,3,1.739295802,193,6,0,57,36,21,3723,1629,2094,33,19,14,95.52969994
387068d4e68b4b22116af8392418353effd1bb5b,1,53,1,52,0,0,0,3,12,157,1,1,0,346,7,1,81,72,9,3342,3099,243,57,55,2,100
5d9432fbc709fc60592ada0f545f03bed770682c,0,0,0,0,0,0,0,0,0,0,0,0,0,0,20,0,0,0,0,0,0,0,0,0,0,100
463a131b445e34456c020c95ae66edf7b9f345e7,1,40,20,20,0,0,0,4,10,446,1,1,0,361,606,1,83,78,5,2949,2884,65,40,38,2,100
188360048a7f2d3cedf5fc915b48d7671f1d8d46,0,0,0,0,0,0,0,0,0,0,0,0,0,0,8,2,0,0,0,0,0,0,0,0,0,100
85f24c5c8c95964516b691477d949a948149e7a2,1,1,1,0,0,0,0,3,4,2358,1,1,0,25,0,0,4,4,0,223,223,0,2,2,0,100
ccad69448c020172cfa3ecc442c089e83b0e31de,1,15,1,14,0,0,0,4,4,331,1,1,0,29,107,0,9,6,3,375,259,116,8,6,2,100
86ecd82d9a8510ebb9254a24cfba594efcce4ad2,0,0,0,0,0,0,0,0,0,0,0,0,0,0,607,0,0,0,0,0,0,0,0,0,0,100
46b33437ad19fea88446ceb18ed34e4f3f88a7eb,3,129,6,123,1,0,1,1,13,1082,1,3,1.093169547,259,0,0,56,50,6,2571,1809,762,25,22,3,99.9327957
775de6cd8c35f128b5426e0383550218140674d1,3,50,13,37,1,0,1,2,13,1012,1,2,1.022649663,500,9,0,110,108,2,4298,4230,68,68,66,2,99.69798658
f8920d355e17cc30a6cff3325d9ac1c3786003bb,3,27,1,26,0,0,0,2,7,1162,1,3,1.572245179,236,5,0,43,41,2,2316,2147,169,38,36,2,99.89936263
7d7af4ef43b122cc03cee721b9106d174d71d435,39,1420,638,782,13,0,13,1,14,116,2,8,4.539024546,1982,6,0,402,340,62,20752,17547,3205,315,268,47,87.11592179
e59cb17a4ddaee203c97f574be29cfc98ade246a,1,21,0,21,0,0,0,1,2,23,1,1,0,84,7,1,28,22,6,1159,984,175,23,20,3,100
1e62245947db91ffbb6e6f4ec83940c2b104b245,1,10,1,9,0,0,0,3,3,127,1,1,0,111,0,0,27,27,0,923,888,35,9,9,0,100
55d73bf17e41ef100121b95c82d0dbd23d8d5b8d,2,14,7,7,0,0,0,4,7,1910,2,2,0.453716339,144,608,0,31,30,1,963,916,47,24,24,0,100
6463da4218568d3d3fd82a33930f8b7cc57c1288,1,2,2,0,0,0,0,3,5,360,1,1,0,110,609,1,12,12,0,924,925,1,6,6,0,100
b5b7f48ebf5a88b69084dcc08be76b8819fc00a7,3,30,0,30,0,0,0,3,21,1332,1,3,1.198892337,1094,10,0,209,205,4,10038,9813,225,128,127,1,100
8e2c4fbcbf2e0d64948f83dc1afdea8c26a1b446,0,0,0,0,0,0,0,0,0,0,0,0,0,0,21,0,0,0,0,0,0,0,0,0,0,100
894446d66490cee49318808e3dbade3109af9de9,0,0,0,0,0,0,0,0,0,0,0,0,0,0,22,1,0,0,0,0,0,0,0,0,0,100
2292c7491f14a634716126dc161184607eb6b704,3,271,12,259,0,0,0,6,15,1439,2,3,1.157132702,887,0,0,161,131,30,9342,7813,1529,69,60,9,100
20fc3ab79d5c20a887518928c953c98e5e10082d,4,194,3,191,1,0,1,1,15,719,1,3,0.244950773,471,610,0,103,88,15,5308,4006,1302,38,27,11,99.89082969
fa04e3c7b31f2416efb2022757c1866f63e8b5f3,1,24,0,24,0,0,0,2,2,3014,1,1,0,92,0,0,19,16,3,1114,1030,84,13,11,2,100
0d31415e4a0d86e1d2e1648ad9da8dca49f5e985,4,174,17,157,2,0,2,4,7,611,1,3,1.659726275,239,0,0,48,37,11,2396,1936,460,36,27,9,94.75273688
1252e7f9181053132d35d13b0137f997786c79ff,9,20,20,0,0,0,0,1,6,1718,2,6,2.98418372,1126,611,0,120,120,0,10158,10076,82,84,84,0,100
65f39198ebc9ba5f1557afd4e350227919c80229,2,20,4,16,0,0,0,1,3,229,1,1,1,196,8,0,57,57,0,2532,2432,100,49,49,0,100
02828f8f08d7e6b427f3f03a9118bdd7ac6c3342,2,54,1,53,0,0,0,5,10,1480,1,2,0.305400571,366,0,0,67,62,5,3881,3456,425,37,32,5,100
2a72ef1f792654b8091bdb789e4cdb07d537a1fc,1,23,1,22,0,0,0,6,11,24,1,1,0,289,0,0,60,57,3,2733,2625,108,32,29,3,100
973c70d093c6c7daab1330136259eb0520fc8969,0,0,0,0,0,0,0,0,0,0,0,0,0,0,612,0,0,0,0,0,0,0,0,0,0,100
49a64ab16734d08023e881078b07aaa54bd6bad9,0,0,0,0,0,0,0,0,0,0,0,0,0,0,613,1,0,0,0,0,0,0,0,0,0,100
49e4575595e4667a7d2aeef7d4e0aaeace0f59c3,3,83,8,75,1,0,1,1,15,1216,1,3,0.869738905,378,108,0,76,73,3,3362,3021,341,49,47,2,99.80376766
c09c4ee2de992b50c15d2cb91a3e6e22c88fb0b1,2,24,3,21,0,0,0,4,13,659,1,2,0.975119065,546,109,1,52,52,0,5089,4869,220,23,23,0,100
321cfef6e85325ab7a4d9548686a96972f6f31fd,20,3808,0,3808,20,0,20,1,1,0,1,5,4.079375531,0,23,0,352,0,352,20745,0,20745,177,0,177,88.05635607
360d72a4f887505e020fdb8f99c3ccb1800693f6,1,0,1,1,0,0,0,1,2,0,1,1,0,301,24,1,37,37,0,3195,3229,34,19,19,0,100
fb218002e1c9d2a2139d93bbd83bc69110199ac8,3,271,20,251,0,0,0,1,2,129,1,3,0.810206431,376,25,0,97,69,28,5052,3032,2020,30,20,10,100
983019aab946a0505569f34ef925640244845f6d,3,55,4,51,1,0,1,1,12,744,1,2,1.316798712,211,0,0,33,30,3,1761,1604,157,26,22,4,99.8919211
8ca28db25b44c4f86e103b2d485f4ada6c850568,1,28,10,18,0,0,0,2,2,698,1,1,0,37,1,1,4,1,3,492,341,151,1,1,0,100
b0491f20ac9f671020fcbc3f3118cd4eda013c57,1,7,8,1,0,0,0,6,16,504,1,1,0,510,614,0,99,99,0,4401,4377,24,40,40,0,100
157ae25b48ba5fb46001df7bb05c753a188ade8d,10,1565,0,1565,10,0,10,1,1,0,1,3,2.821341515,0,26,0,164,0,164,8730,0,8730,96,0,96,99.38420348
597eadd6570226f518aa0f97ee61c9d4dbc133e9,10,170,1,169,0,0,0,1,2,0,1,3,3.321709446,1030,27,1,164,164,0,8719,8730,11,96,96,0,100
0b19717d105b58e58c1947eda6b673a387e330d0,2,25,10,15,0,0,0,5,12,1245,1,1,0.999411065,946,28,2,215,212,3,7761,7708,53,112,112,0,100
3fff74e2e18b22d5cdc302f52e19ef10028a0c31,4,70,4,66,0,0,0,2,10,2221,1,4,1.621240331,425,615,0,84,69,15,4230,3721,509,40,36,4,100
f1d074c2a7dcaf44b03dab5b84e9d323f586fdac,5,105,4,101,1,0,1,1,9,2112,2,4,1.287659953,383,616,1,72,65,7,3993,3520,473,39,37,2,96.51428571
5d237b36609484d49c30fa92fdf9613b6eee9d91,21,48,48,0,0,0,0,3,14,2514,3,5,3.985902344,2107,11,0,249,249,0,18555,18555,0,136,136,0,100
e8d2a69b6df297f02dfe45053d0a72f6f32cd524,1,6,0,6,0,0,0,1,2,323,1,1,0,169,29,0,36,35,1,1514,1469,45,7,7,0,96.27613864
5944f81b2aa15c59484d24864570d21e13bfca3b,1,4,1,3,0,0,0,3,6,821,1,1,0,34,1,0,0,0,0,494,494,0,0,0,0,100
ef8d60f2b51e552a0d2296d2b4711008cd0b58ee,3,122,4,118,0,0,0,1,3,253,1,3,1.37169612,555,30,0,107,96,11,5927,5199,728,33,28,5,100
e929e04442f2b00acb6437574280208bc2d26998,1,11,0,11,0,0,0,1,4,609,1,1,0,101,9,0,30,28,2,1294,1209,85,25,23,2,95.79594976
fbda02f46961c17b3f444424b166fbf65262711c,6,189,30,159,0,0,0,2,4,387,1,4,1.837696851,999,0,0,156,144,12,9686,9100,586,85,76,9,100
c14acfab04a18d7b57af040c9399ec0cca61eed6,1,1,1,0,0,0,0,2,8,2613,1,1,0,199,617,0,45,45,0,2265,2265,0,38,38,0,100
901d0644dcaec5309670b7a2eeff228cea2c7767,2,25,22,3,0,0,0,4,4,2397,1,2,0.342463772,173,0,0,40,39,1,1328,1332,4,16,16,0,99.87669544
6cb3cb01933705ccd4bcc57eaeb1b3ca6dc2c4f9,2,49,0,49,0,0,0,2,3,210,1,2,0.642064289,245,31,0,30,27,3,2503,2201,302,25,22,3,100
6280983179e9c690af69c2bf0e296b054122d724,3,4,53,49,0,0,0,2,5,378,1,3,1.137106993,452,0,0,62,65,3,3490,3784,294,32,35,3,100
2e47294047403b4822f1ac75affbf592cdf15b34,2,49,0,49,0,0,0,2,3,210,1,2,0.642064289,245,32,1,30,27,3,2503,2201,302,25,22,3,100
049fb499b7f2e45385f45d954138e56eecb83064,5,104,18,86,0,0,0,2,6,2384,1,2,2.139737739,574,33,0,103,95,8,4978,4308,670,35,32,3,100
d9a7099b8661d696578e7ea81db69501a1bafe2c,0,0,0,0,0,0,0,0,0,0,0,0,0,0,618,0,0,0,0,0,0,0,0,0,0,100
427c54acdb7a8adbe83b0ced04ee5275e80fdad4,0,0,0,0,0,0,0,0,0,0,0,0,0,0,619,1,0,0,0,0,0,0,0,0,0,100
a743e4e470667b509199987eb4926f53bc6a03f8,1,1,1,0,0,0,0,1,3,647,1,1,0,182,34,1,37,37,0,1372,1367,5,9,9,0,100
cde71cfe361e28579dff920cee1a905ab707fdef,1,1,1,0,0,0,0,4,10,1764,1,1,0,226,110,0,52,52,0,1575,1575,0,26,26,0,100
e3ba6fcd036eb13ebb32285baecb15daec9129a6,0,0,0,0,0,0,0,0,0,0,0,0,0,0,12,0,0,0,0,0,0,0,0,0,0,100
e520d9f6e55bdcd16e5ad9715f46ddce4ce96f76,3,29,9,20,0,0,0,7,19,1392,1,2,0.943421044,607,13,0,135,132,3,5191,5084,107,27,26,1,100
e176b6166218fabc247eef25cbbc549271f8bd2d,4,344,3,341,2,0,2,1,14,855,1,4,1.911421397,624,0,0,159,130,29,6900,4993,1907,75,58,17,98.08036857
ca8ff16b6172be6cf2be1c185c41593ce4897c53,2,4,5,1,0,0,0,1,15,8,1,2,0.99107606,399,1,1,63,63,0,3247,3251,4,28,28,0,100
d5e40e3393b4fb1e2f3c60d158191ec3e81302f8,1,30,10,20,0,0,0,2,3,3822,1,1,0,67,0,0,14,12,2,710,615,95,12,10,2,100
afc171fb7ad06a8c0a12fb00811874a99bf8d310,1,4,1,3,0,0,0,4,8,694,1,1,0,190,14,0,42,42,0,1618,1591,27,13,13,0,100
ce9aaa3a532a56ea52a698fcc259c2c3d5a21a6c,2,88,2,86,1,0,1,2,4,2,1,2,0.938932011,73,1,1,18,14,4,1210,710,500,16,12,4,99.94680851
047d8fd36773608a3d2cf6445881173e7d26377c,11,47,27,20,1,0,1,2,4,2620,1,2,2.862634611,390,15,1,55,53,2,3443,3402,41,32,30,2,99.94686504
d65ba78e6da4a72a0d836aa2b5b2dd32cc72eed9,4,358,17,341,2,0,2,1,17,483,1,2,1.755999555,608,111,0,130,104,26,6944,5271,1673,59,42,17,99.86740918
28ab19975b1939d754e32e3a09f23134e351223b,0,0,0,0,0,0,0,0,0,0,0,0,0,0,620,0,0,0,0,0,0,0,0,0,0,100
f473478141144dea5ce422309aec37e8212a9f1e,15,2326,1,2325,12,0,12,1,4,236,1,4,3.402430963,584,0,0,295,79,216,18320,5368,12952,171,56,115,98.60176075
ae0221f34cd03ee988d20c986932af762493f2cb,1,13,2,11,0,0,0,1,2,4941,1,1,0,31,621,0,5,3,2,289,233,56,5,3,2,100
2469348f66b2e5ff45ed938753b35ddab83e6db4,1,21,16,5,0,0,0,2,2,3641,1,1,0,178,1,0,39,38,1,1275,1263,12,22,21,1,100
5609b014378d3460a55ce25522f0c00659872807,17,2362,0,2362,17,0,17,1,1,0,1,3,3.735513241,0,2,1,171,0,171,12031,0,12031,108,0,108,95.39083558
8e5c2ad37c6e2f0fbc428bddf69da3644d535456,4,41,14,27,0,0,0,2,4,1197,1,4,1.904400405,662,622,0,124,123,1,5584,5354,230,49,48,1,100
614364aa9e005ac350481869cb18e3e44b0d1c3a,1,7,7,0,0,0,0,4,8,4018,1,1,0,86,623,0,11,11,0,528,521,7,11,11,0,100
41b201a9e546f7860e09cb30f1b7cecd4507d267,2,64,46,18,0,0,0,2,5,132,1,2,0.13110653,358,1,0,77,70,7,2930,2887,43,18,17,1,100
8121bdf5a8a292b796fb3dc07f14e96a8f06d5a7,2,61,3,58,0,0,0,2,7,3801,1,2,0.625262405,153,1,0,35,29,6,1562,1127,435,14,12,2,100
6c0ae41318a89a4aed9d343f79849fbadc329e56,4,84,2,82,2,0,2,1,15,1434,1,2,1.271389588,192,2,0,35,33,2,1825,1533,292,20,18,2,99.8273878
23a2da07d3a80b3650568dde8973acc941f4f25d,2,19,3,16,0,0,0,5,17,2939,1,2,0.439496987,236,2,0,49,47,2,1798,1716,82,19,18,1,100
4df441907bc22ec54d9eb58bd637f8da70eaf9a9,1,1,1,0,0,0,0,2,2,267,1,1,0,249,3,1,14,14,0,2565,2563,2,9,9,0,100
5ef1c4ed2a09c2a4672450518be71db029f91433,2,95,4,91,0,0,0,2,9,2783,1,2,0.884963636,224,4,0,56,49,7,3108,2485,623,45,42,3,99.42889777
ffca004e9efe22b3e4e35e0273f5977db4d60761,1,6,2,4,0,0,0,5,12,1217,1,1,0,409,624,0,92,91,1,3203,3183,20,42,42,0,100
1b2c058c4c2b084d895cf6ae86f68ac935282f2c,16,305,286,19,0,0,0,1,18,2697,3,4,3.193335186,3104,625,0,375,377,2,27120,26814,306,205,206,1,99.97162316
51d9443f5be3d67588e4c3a974f71ea02158d39e,0,0,0,0,0,0,0,0,0,0,0,0,0,0,0,0,0,0,0,0,0,0,0,0,0,100
07458f78282e1b55aee90960818f5fcb35dae5c0,3,149,7,142,0,0,0,4,14,1648,2,3,1.143351605,374,0,0,81,65,16,3711,2728,983,33,30,3,100
571b90c03e3010e7bb9badf4e6e441ab2164be56,6,28,10,18,0,0,0,5,21,3680,1,5,2.323531576,1347,1,0,283,276,7,10534,10459,75,138,138,0,100
f326a635d823db7abfb50fc3ccf8616c19be993a,15,413,18,395,1,0,1,2,18,3509,3,10,2.689153388,1376,2,0,294,255,39,12480,10566,1914,173,152,21,99.9432785
f4c1ccd889a226daf083f7a0e7c07ba1615bbcb8,5,53,1,52,0,0,0,2,17,1102,3,4,2.15446407,961,3,1,177,169,8,7645,7478,167,102,94,8,100
88026ce0d603cc4bc771193653ede09e40205563,0,0,0,0,0,0,0,0,0,0,0,0,0,0,35,0,0,0,0,0,0,0,0,0,0,100
21cb425610676c0ec05627d21f8dc01d51904589,6,416,9,407,2,0,2,2,4,686,1,2,2.026405806,600,2,1,128,102,26,7798,5198,2600,76,53,23,99.80209217
9b8849cfd89f1e7f187b99914163509060692aa5,0,0,0,0,0,0,0,0,0,0,0,0,0,0,36,1,0,0,0,0,0,0,0,0,0,100
31e822c9cc7edceadd1cb8d711034cc528ef92e5,1,120,15,105,0,0,0,7,19,816,1,1,0,535,3,0,107,100,7,4983,4673,310,48,41,7,100
a6dfa38aa28161a07d65b20390aad9b10a01dbdd,1,80,10,70,0,0,0,7,20,0,1,1,0,579,4,1,107,107,0,4983,4983,0,48,48,0,100
869aac60c9d3b5bef10b4e907ec3840be2d8c20e,4,161,4,157,0,0,0,2,18,1197,2,4,1.173422973,598,5,2,115,102,13,5867,4484,1383,55,44,11,99.88719684
7c49b8b9f8f85782370e158fc681904c5c34647e,1,2,1,1,0,0,0,3,6,213,1,1,0,143,6,3,30,30,0,1108,1097,11,18,18,0,100
e53004b316973f98702cc5082487f896b304cc72,3,482,0,482,3,0,3,1,1,0,1,2,1.540026209,0,0,0,42,0,42,3579,0,3579,19,0,19,99.80292793
8711b2fec4bb3a2b56e39ebaccc316dfa0a0d4eb,2,49,7,42,0,0,0,2,5,3226,1,2,0.491237342,81,4,0,20,17,3,838,579,259,10,8,2,100
ef0c7e882921c2c99fcd0feb9a50d8438c327822,5,298,33,265,1,0,1,1,19,254,1,4,1.427007084,852,5,1,181,158,23,7830,6356,1474,89,78,11,99.85959
587e2c9eaaec8ae9a26e6b1b5c99be7f4d521951,0,0,0,0,0,0,0,0,0,0,0,0,0,0,7,0,0,0,0,0,0,0,0,0,0,100
f57c8fc0fc110e9effb95a622aa54c3817c81869,5,319,94,225,1,0,1,4,20,206,2,5,1.330792281,657,8,1,161,106,55,6306,4980,1326,58,45,13,99.83169705
8a1c8b451fff5b516296ad9a8f3624087cff7924,3,42,7,35,0,0,0,7,21,1293,1,2,0.489538633,1177,9,0,170,163,7,10295,10078,217,82,78,4,100
67e28902e839bfd0e0d86fd8961280fb1995c537,0,0,0,0,0,0,0,0,0,0,0,0,0,0,626,0,0,0,0,0,0,0,0,0,0,100
b58363bef9916be59ad0130c5c0abf210a4addfb,3,7,2,5,0,0,0,1,8,4981,1,3,1.435520504,226,627,0,36,35,1,1963,1950,13,17,17,0,100
78f1b672bc5afb3120f54f0af53e683bd66459bd,0,0,0,0,0,0,0,0,0,0,0,0,0,0,628,0,0,0,0,0,0,0,0,0,0,100
2b15eb0057e417ce36b41df91f3b5aebb0d89d83,0,0,0,0,0,0,0,0,0,0,0,0,0,0,629,1,0,0,0,0,0,0,0,0,0,100
fda17d0051641e6068e0edfab60da060db980ada,0,0,0,0,0,0,0,0,0,0,0,0,0,0,630,2,0,0,0,0,0,0,0,0,0,100
d94800c556368829870a9bac64618dfe65d5699d,5,6,6,0,0,0,0,3,7,2857,2,5,2.251629167,873,631,0,145,145,0,7851,7855,4,58,58,0,100
7c677940061534f17ecaf3ef5efcd56ee07984e9,3,20,29,9,0,0,0,3,6,4202,1,2,1.202385347,469,632,1,41,39,2,4174,4132,42,35,34,1,100
65afa91dbaff02fb3900c4a065820a4411bd8ef7,1,1,1,0,0,0,0,2,3,2109,1,1,0,142,633,2,18,18,0,1329,1327,2,13,13,0,100
cd32244ec96a0f1ca21ebc765c4a45d0dee6e5cf,1,1,0,1,0,0,0,2,3,2109,1,1,0,185,634,3,36,36,0,1384,1370,14,19,19,0,100
f49fa8eafeeb5614e0469ececadb727f858f18fc,1,1,3,2,0,0,0,2,2,2246,1,1,0,303,635,4,37,37,0,3170,3202,32,19,19,0,100
362853da42b73d7eae5307269be60ca8ae814a02,2,1,6,5,0,0,0,2,4,1514,1,2,0.863120569,421,636,5,48,48,0,4368,4435,67,30,30,0,100
37be4b4f468b2126fbb4e31df7ec4cd86884cbf9,13,48,32,16,0,0,0,2,6,1436,3,10,2.903615279,2192,112,0,323,325,2,20127,20073,54,172,173,1,100
73d333e979f584dac9536b5023cfe5a5280eb9e2,0,0,0,0,0,0,0,0,0,0,0,0,0,0,631,0,0,0,0,0,0,0,0,0,0,100
fe22a6ca6248bb44e7be9b3c8d219ecb11804656,13,32,48,16,0,0,0,2,7,2487,3,10,2.903615279,2194,637,0,325,323,2,20073,20127,54,173,172,1,100
df2ea94467cdc647024feb05836fc45f474b5a95,1,4,3,1,0,0,0,2,2,7754,1,1,0,77,639,2,13,13,0,484,475,9,10,10,0,100
1da1f9c03db4d6b5924ee775d16f31119793d5ca,22,109,3447,3338,0,0,0,2,7,2672,1,9,3.854724509,3684,1,0,209,530,321,13757,34428,20671,126,280,154,96.6395664
807e0c809f2f206d2ce209b970d3c071c4d05183,2,40,7,33,0,0,0,2,3,1931,1,2,0.903453555,197,10,0,27,20,7,1476,1250,226,20,15,5,100
c57b55bd3c8eaa3dae124af0eda771144abe90a5,1,16,1,15,0,0,0,3,8,913,1,1,0,265,6,0,50,49,1,1997,1956,41,23,23,0,100
a5c5a7ed7fad7314d80be61fa7d251f0739332c5,1,2,2,0,0,0,0,3,9,0,1,1,0,275,7,1,50,50,0,1997,1997,0,23,23,0,100
a2a879661b5148a1cdd2b4af615130d0e8c61444,0,0,0,0,0,0,0,0,0,0,0,0,0,0,640,0,0,0,0,0,0,0,0,0,0,100
ee751f6ca77ea335bab0327ddb8e77f4724ed0b9,1,36,1,35,0,0,0,4,4,5847,1,1,0,81,11,0,20,14,6,816,575,241,9,8,1,100
f75cce92de29cf419ecf75b89fc9b37eb2fe2806,0,0,0,0,0,0,0,0,0,0,0,0,0,0,641,0,0,0,0,0,0,0,0,0,0,100
