CommitID,NMF,TotalAddLines,TotalDeleteLines,LC,FileAdd,FileDelete,NAD,NDEV,NUC,AGE,NS,ND,Entropy,LT,EXP,REXP,CommitComplexity,LastCommitComplexity,CFC,CommitTokenCount,LastCommitTokenCount,NCC,CommitMethodNum,LastCommitMethodNum,NMC,a2a
a53c9a5d06767276ace353a6e54ff324a14f20ae,1,52,1,51,0,0,0,1,2,1,1,1,0,5,18,17,2,1,1,504,20,484,1,1,0,94
f258bb831a1dd6e7e7807b0a224d17f66ee3d1c2,1,0,2,2,0,0,0,1,3,0,1,1,0,47,19,18,2,2,0,504,504,0,1,1,0,100
6f83187af00d739ae10ca13f3b1603c34c7039f9,0,0,0,0,0,0,0,0,0,0,0,0,0,0,20,19,0,0,0,0,0,0,0,0,0,100
96dabd0ff78accd58098b6f351b091598fdc910a,0,0,0,0,0,0,0,0,0,0,0,0,0,0,21,20,0,0,0,0,0,0,0,0,0,100
77977138dd8dc7e7a1bd7cb00142c2f35a426ad9,0,0,0,0,0,0,0,0,0,0,0,0,0,0,22,21,0,0,0,0,0,0,0,0,0,100
0eaa1bc72fd494e8c5f14769edd59f34f69091c2,0,0,0,0,0,0,0,0,0,0,0,0,0,0,23,22,0,0,0,0,0,0,0,0,0,100
dec70940e91a8308c0c842d67275e1e9c8ce382b,3,216,178,38,0,0,0,1,2,9,1,1,1.46948613,852,24,20,108,118,10,6536,6043,493,26,25,1,100
e100d1f500c433b133fb9fa3f60ffb2f67c96ae2,1,100,4,96,0,0,0,1,3,4,1,1,0,366,25,21,56,46,10,3513,2750,763,10,10,0,100
4b220333134afc0b2b3447f697b925c848caf1b8,1,287,2,285,0,0,0,1,3,4,1,1,0,246,26,22,61,30,31,3866,1764,2102,10,8,2,100
683b7ecb730313dd6f02adbe6665239349af416b,1,0,178,178,0,0,0,1,4,0,1,1,0,504,27,23,41,61,20,2775,3866,1091,9,10,1,100
4370752868ca724d50ba1a0a06cdc003980e9d3d,1,206,12,194,0,0,0,1,3,4,1,1,0,273,28,24,52,32,20,3674,2022,1652,10,8,2,100
4d8f04f673b0773539f955f241d0ef098561c51e,1,1,1,0,0,0,0,1,4,0,1,1,0,434,29,25,52,52,0,3674,3674,0,10,10,0,100
08ed6d1b2f96b0b0a1b9b7dbaaed0fec3c791d88,0,0,0,0,0,0,0,0,0,0,0,0,0,0,30,26,0,0,0,0,0,0,0,0,0,100
720d80247f3185dc67ca2fb930a5dbfc5d1a0619,1,37,7,30,0,0,0,1,5,12,1,1,0,434,31,27,54,52,2,3825,3674,151,11,10,1,100
4be0f52be9b242b6340ec6705c3e05a4c9e5197d,1,111,0,111,1,0,1,1,1,0,1,1,0,0,32,28,11,0,11,929,0,929,7,0,7,96.15384615
51a62783645be0fd7d092d20c52c470cfb590b36,0,0,0,0,0,0,0,0,0,0,0,0,0,0,33,29,0,0,0,0,0,0,0,0,0,100
6bcf568b75490f75d719d264f24049fcb091767e,1,12,16,4,0,0,0,1,4,13,1,1,0,444,34,30,56,56,0,3508,3513,5,10,10,0,100
ceea1c2226ddbb4f062236242b800db7cd26cc99,1,11,7,4,0,0,0,1,5,12,1,1,0,340,35,31,41,41,0,2792,2775,17,9,9,0,96.2962963
f90bc3447b09805a66398d39701eb3a1d29a3420,1,15,8,7,0,0,0,1,6,0,1,1,0,458,36,32,54,54,0,3832,3825,7,11,11,0,96.2962963
74949488b67d6b64dec8ca50ef942a89e0bf9e31,0,0,0,0,0,0,0,0,0,0,0,0,0,0,37,33,0,0,0,0,0,0,0,0,0,100
094f2a4f6333f5de82fe7efe55d97609153e6367,0,0,0,0,0,0,0,0,0,0,0,0,0,0,38,34,0,0,0,0,0,0,0,0,0,100
87654a6897d57bb5521363fc122791dd27fdff6c,0,0,0,0,0,0,0,0,0,0,0,0,0,0,39,35,0,0,0,0,0,0,0,0,0,100
29b9e2e0510154261f400bc25d53f4f946fba5b9,0,0,0,0,0,0,0,0,0,0,0,0,0,0,40,36,0,0,0,0,0,0,0,0,0,100
15dd494e677e4885db603c58b1033cfd0a7f9d63,0,0,0,0,0,0,0,0,0,0,0,0,0,0,41,37,0,0,0,0,0,0,0,0,0,100
2e7c83e75c7b799ccb14dfd521f64b02e0933382,1,342,7,335,0,0,0,1,7,3,1,1,0,465,42,38,90,54,36,6353,3832,2521,13,11,2,100
a963345a56bc8ed57b91db39bf63607647d8cd30,1,155,2,153,0,0,0,1,6,3,1,1,0,343,43,39,56,41,15,3797,2792,1005,10,9,1,100
383aa33953ae4f68f830d3e80893493ef70d2a08,0,0,0,0,0,0,0,0,0,0,0,0,0,0,44,20,0,0,0,0,0,0,0,0,0,100
f04169b6264ceb756c130f8a79282acae5cf78a5,1,0,111,111,0,0,0,1,2,17,1,1,0,98,45,21,0,11,11,0,929,929,0,7,7,94.23076923
1a2e602a52f8dec388b20f9b8cc9698dcdf29b96,1,57,0,57,1,0,1,1,1,0,1,1,0,0,46,22,9,0,9,331,0,331,9,0,9,96.15384615
cf363e216f4d2187b51e779437d8001fcd906fba,1,74,30,44,0,0,0,1,5,17,1,1,0,446,47,23,58,56,2,4062,3508,554,10,10,0,100
b1788b3c9af81e3d063de4950b13727b30e35bde,1,64,22,42,0,0,0,1,7,14,1,1,0,473,48,24,58,56,2,4343,3797,546,10,10,0,96.2962963
58e7c34bf3ea6caffa70029856765afb9129bd05,1,126,34,92,0,0,0,1,8,14,1,1,0,744,49,25,96,90,6,7401,6353,1048,13,13,0,94.44444444
15b89162206b29accd286724c63f65a94fd5685a,0,0,0,0,0,0,0,0,0,0,0,0,0,0,50,26,0,0,0,0,0,0,0,0,0,100
759f5c22ba15087097fe6bd774a0b5048ba22676,0,0,0,0,0,0,0,0,0,0,0,0,0,0,51,27,0,0,0,0,0,0,0,0,0,100
778ec09bf0ff9e35b53ebe196e1d62fa10ae1d55,0,0,0,0,0,0,0,0,0,0,0,0,0,0,52,28,0,0,0,0,0,0,0,0,0,100
6c1a29b82adf34dfc232662fd31e86adf005bae1,0,0,0,0,0,0,0,0,0,0,0,0,0,0,53,29,0,0,0,0,0,0,0,0,0,100
33d25d594c4bc9496a19d0d8a3fef23045478016,0,0,0,0,0,0,0,0,0,0,0,0,0,0,54,24,0,0,0,0,0,0,0,0,0,100
90c545d475a19fd36669693b15aacdf65d047ea3,0,0,0,0,0,0,0,0,0,0,0,0,0,0,55,25,0,0,0,0,0,0,0,0,0,100
1317efaa34b5a961029e7fbaee5cc402bbaa8995,1,9,8,1,0,0,0,1,2,55,1,1,0,41,56,26,7,9,2,328,318,10,2,2,0,100
177a3d2a0aea749864ddabc6b96d6e7c65b08d7c,1,8,22,14,0,0,0,1,2,55,1,1,0,54,57,27,8,15,7,331,418,87,2,2,0,100
27494df67cd919adb8cf4a6c45a5464e4bced352,1,7,20,13,0,0,0,1,2,55,1,1,0,53,58,28,8,15,7,350,456,106,2,2,0,100
4855cbfb41bccb428819f1eb85c05397e34732f8,1,162,0,162,0,0,0,1,6,24,1,1,0,485,59,18,75,58,17,5348,4062,1286,12,10,2,100
8b939d81c448ff39ac015b7461369b3550d2e6b8,1,67,1,66,0,0,0,1,2,24,1,1,0,48,60,19,15,9,6,951,331,620,12,9,3,100
1d400ba4c819157d20477dfb346dc676e73123e7,0,0,0,0,0,0,0,0,0,0,0,0,0,0,61,20,0,0,0,0,0,0,0,0,0,100
a69299f6b980758605c4f1705f13df21f5acafb2,3,0,0,0,3,0,3,1,1,0,1,1,0,0,62,21,0,0,0,0,0,0,0,0,0,94.73684211
f8da125512700a5adf0219c8389fb36742eefd67,3,438,0,438,3,0,3,1,2,0,1,1,1.440387122,0,63,21,16,0,16,3197,0,3197,3,0,3,93.5483871
2ccd3efa0600a5955c105c31ab28a56afbff7dd3,4,184,144,40,2,0,2,1,7,0,2,2,1.701247951,739,64,20,91,83,8,6254,6324,70,30,13,17,92.95774648
0ba749b45a6c2b7d1cb7ff1f60a438436dd7b925,0,0,0,0,0,0,0,0,0,0,0,0,0,0,65,21,0,0,0,0,0,0,0,0,0,100
3c585d9dd9695bbafb8aaca2940fb5f248a3686c,0,0,0,0,0,0,0,0,0,0,0,0,0,0,66,22,0,0,0,0,0,0,0,0,0,100
d98348739828769a04a02c4cf87694ce9899d294,0,0,0,0,0,0,0,0,0,0,0,0,0,0,67,23,0,0,0,0,0,0,0,0,0,100
0d75728fdf38ca6d584831b9b6828994e3b3bc62,12,571,17,554,1,0,1,1,9,25,2,2,3.110043421,2378,68,24,348,300,48,21997,19591,2406,79,70,9,92.40506329
fbe547335cf1cbb005e6db82237a0afb3a6c7ed6,0,0,0,0,0,0,0,0,0,0,0,0,0,0,1,0,0,0,0,0,0,0,0,0,0,100
d445c835bf06184e88d8d953f167125fcedcf874,0,0,0,0,0,0,0,0,0,0,0,0,0,0,2,1,0,0,0,0,0,0,0,0,0,100
67758e0515ff495b6661ad8e63973fa717f9b037,0,0,0,0,0,0,0,0,0,0,0,0,0,0,3,2,0,0,0,0,0,0,0,0,0,100
bbcc4f0a40e7d39414d8b5bbd151e878ca012598,0,0,0,0,0,0,0,0,0,0,0,0,0,0,4,3,0,0,0,0,0,0,0,0,0,100
5bf34e736efbecaf1634025d41468b261b7898b5,0,0,0,0,0,0,0,0,0,0,0,0,0,0,5,4,0,0,0,0,0,0,0,0,0,100
e68f96c47df15de24a1bfbb481a430d5ea1c7444,0,0,0,0,0,0,0,0,0,0,0,0,0,0,6,5,0,0,0,0,0,0,0,0,0,100
e90f469fe69e6a84abf33645d53cf453f7c4601d,0,0,0,0,0,0,0,0,0,0,0,0,0,0,69,10,0,0,0,0,0,0,0,0,0,100
25bb618e8dbbe5884085d634e90bf7d638644799,0,0,0,0,0,0,0,0,0,0,0,0,0,0,70,11,0,0,0,0,0,0,0,0,0,100
fec0d8ac766432a8b157d6cb5159cf8e0bbf1a58,0,0,0,0,0,0,0,0,0,0,0,0,0,0,71,12,0,0,0,0,0,0,0,0,0,100
798840f830c0ad629f07a01cc8da3ea1c7062eca,1,69,0,69,1,0,1,1,1,0,1,1,0,0,72,13,2,0,2,598,0,598,1,0,1,100
8652cef27775dd29dad65fa54c8578a5bee131fb,1,0,152,152,0,0,0,1,4,29,1,1,0,132,73,14,0,10,10,0,1104,1104,0,3,3,96.1038961
9680a12451ead4c7dba9068853458da90638cd67,1,0,231,231,0,0,0,1,3,30,1,1,0,170,74,15,0,5,5,0,1723,1723,0,1,1,100
1cf7c9d4ea375dc2f75537541a42e8836941c2c6,2,75,73,2,1,0,1,1,3,15,1,1,0.999868267,55,75,16,3,3,0,625,498,127,1,1,0,98.64864865
f6db1df94d271e4a8fe1d26a254809aa1d63fffd,0,0,0,0,0,0,0,0,0,0,0,0,0,0,76,17,0,0,0,0,0,0,0,0,0,100
893ef82b597b16fd74ef9530d6d5ea28cf642136,18,1320,1674,354,3,0,3,1,9,3,3,3,2.548238052,3083,77,16,362,337,25,22014,22743,729,112,180,68,18.66666667
93ecdf71624da887777211774b071039103a8c29,1,18,19,1,0,0,0,1,2,9,1,1,0,54,78,17,1,2,1,615,598,17,1,1,0,88.37209302
f085e1fdb50665bd012f5a132f295ec394731e83,1,5,13,8,0,0,0,1,2,9,1,1,0,59,79,18,2,3,1,609,625,16,1,1,0,100
6b6b2cfce527b24a2394e4732a48f293aced525f,0,0,0,0,0,0,0,0,0,0,0,0,0,0,80,19,0,0,0,0,0,0,0,0,0,100
5a7692b11be6b78ad23a623cd686206763eab558,0,0,0,0,0,0,0,0,0,0,0,0,0,0,81,12,0,0,0,0,0,0,0,0,0,100
049a35de373b74f64547f3b5538b54ce259ba394,0,0,0,0,0,0,0,0,0,0,0,0,0,0,82,13,0,0,0,0,0,0,0,0,0,100
0b98c77a6ce51482868a91c30021036186f6144c,1,0,0,0,1,0,1,1,1,0,1,1,0,0,83,14,16,16,0,1134,1134,0,8,8,0,93.2038835
c34519e3b4ac5033b1eb035780b4fd17dcad3016,1,0,0,0,1,0,1,1,1,0,1,1,0,0,84,15,16,16,0,1008,1008,0,8,8,0,96.46017699
8bc83337b4b4b7b0f1ed5f57e6d6e992d3080b23,1,169,0,169,1,0,1,1,1,0,1,1,0,0,85,16,16,0,16,1024,0,1024,8,0,8,98.33333333
d33b638a93fc556cfa0e855fc6abfa3872a5122c,1,401,95,306,0,0,0,1,2,26,1,1,0,511,86,17,92,56,36,6691,4650,2041,17,15,2,100
ad81aa756847121c6948b3d771c8c9256138c6ed,1,194,81,113,0,0,0,1,2,26,1,1,0,438,87,18,68,52,16,4764,4013,751,15,14,1,100
50178854d6b53a2fa5e1fb75ba38b26057882c87,0,0,0,0,0,0,0,0,0,0,0,0,0,0,88,19,0,0,0,0,0,0,0,0,0,100
04a8fd6d9468c4f4f6ff4431084c5646d494ad74,0,0,0,0,0,0,0,0,0,0,0,0,0,0,89,20,0,0,0,0,0,0,0,0,0,100
6127bb1e6ca9f8c1c478b5d11d03e66330ca2daa,0,0,0,0,0,0,0,0,0,0,0,0,0,0,90,21,0,0,0,0,0,0,0,0,0,100
298ae421064851aeebe70bd8249ec6302c80a813,0,0,0,0,0,0,0,0,0,0,0,0,0,0,91,22,0,0,0,0,0,0,0,0,0,100
e45157b69459a6207100dd5757267becbc94207b,4,630,0,630,4,0,4,1,1,0,1,1,1.849356459,0,92,11,21,0,21,4610,0,4610,8,0,8,83.76068376
73d9024d147e28f11110630aaabf0872f672eaa2,2,0,135,135,0,0,0,1,3,48,1,1,0.99996042,113,93,12,0,3,3,0,1224,1224,0,2,2,96.22641509
4f286a356c4a184d9ff12617737c89152afa8f6b,10,3937,0,3937,10,0,10,1,1,0,1,1,2.865674146,0,0,0,290,0,290,27804,0,27804,118,0,118,97.14285714
57a9675d2b29a8c487e0af11c4ef4a7e2adfaa62,0,0,0,0,0,0,0,0,0,0,0,0,0,0,1,1,0,0,0,0,0,0,0,0,0,100
d99c884dfe24b05160cc66b5810d9664557af3b2,10,0,0,0,0,0,0,1,1,0,1,1,0,3276,94,13,290,20,270,27804,4890,22914,118,10,108,82.53968254
8fbc36b8914e6d2f4f9cac64f824af61e5e701b6,0,0,0,0,0,0,0,0,0,0,0,0,0,0,7,0,0,0,0,0,0,0,0,0,0,100
5873a68119786f79404975ad038583215bce93a5,0,0,0,0,0,0,0,0,0,0,0,0,0,0,8,1,0,0,0,0,0,0,0,0,0,100
8f188b457e104847121c4dfc2cfa814463a965a3,1,41,21,20,0,0,0,1,2,77,1,1,0,786,95,3,95,91,4,7342,7231,111,17,14,3,100
ac7c76cb6523366be8c18ed4bbb9e1a1de71d3f8,1,0,1,1,0,0,0,1,3,51,1,1,0,527,96,4,68,68,0,4759,4764,5,15,15,0,100
eb5e31ed89cae4ebcafaa7712659aa19e6a02e6f,1,1,1,0,0,0,0,1,2,29,1,1,0,80,97,5,1,1,0,618,615,3,1,1,0,100
17027004574527b56afec617abd745d59ec5a248,1,1,0,1,0,0,0,1,2,29,1,1,0,158,98,6,10,10,0,1312,1309,3,3,3,0,100
ad8f475f3bd49277d78c76fb9eb367dbae50c692,1,1,0,1,0,0,0,1,2,29,1,1,0,217,99,7,8,8,0,2079,2076,3,3,3,0,100
86d3470845ee35aa0c48858987a4a4e3a7b8ba5c,1,1,0,1,0,0,0,1,2,29,1,1,0,76,100,8,2,2,0,613,610,3,1,1,0,100
a59f8a2525895459c5269700c557c2d41fa70392,0,0,0,0,0,0,0,0,0,0,0,0,0,0,101,0,0,0,0,0,0,0,0,0,0,100
4fa3de30101053e655c51ac248224ef1f5ab386c,0,0,0,0,0,0,0,0,0,0,0,0,0,0,102,1,0,0,0,0,0,0,0,0,0,100
242674639667fb6b9f43585025a0b474a5b70d23,1,51,0,51,1,0,1,1,1,0,1,1,0,0,2,0,1,0,1,424,0,424,1,0,1,98.63013699
914964baadbb92ad85866e716205bd22107fd7a6,1,122,79,43,0,0,0,2,3,177,1,1,0,742,3,1,99,92,7,7054,6691,363,18,17,1,100
0675050f204425218166c248ab8c1001ffb43a18,1,61,0,61,1,0,1,1,1,0,1,1,0,0,4,2,1,0,1,490,0,490,1,0,1,98.66666667
421802f8c191ab7d650ce7754c1267203ebd7783,0,0,0,0,0,0,0,0,0,0,0,0,0,0,103,0,0,0,0,0,0,0,0,0,0,100
fed5dfec4ea8b9f4be1f89a04c07e25b087f7b4e,0,0,0,0,0,0,0,0,0,0,0,0,0,0,104,0,0,0,0,0,0,0,0,0,0,100
cfea8a21e6f6adbd00c44e659eb15bfa954bb8e8,0,0,0,0,0,0,0,0,0,0,0,0,0,0,105,1,0,0,0,0,0,0,0,0,0,100
c8522bf6fa4113e7d0abb8e7d2fc2a4af46d4859,6,2,1,1,0,0,0,1,1,0,1,2,0,2373,0,0,299,90,209,21127,5682,15445,78,72,6,82.78145695
d0ccc5bafe222e9b9dab6efc54cf75ed8b753d46,1,0,0,0,0,0,0,1,1,0,1,1,0,202,1,1,42,42,0,1129,1129,0,14,14,0,97.33333333
8d91b2fdc9983040154f64396dcb8d8027df2cf1,4,110,29,81,3,0,3,1,2,0,1,2,1.81753813,202,2,2,48,42,6,1687,1129,558,18,14,4,94.9044586
355a3cc0504147e159072044de3b01d864709d98,0,0,0,0,0,0,0,0,0,0,0,0,0,0,5,0,0,0,0,0,0,0,0,0,0,100
8025284d60f3e973487abf7b04e80e6a9e7801c1,15,328,194,134,13,0,13,2,3,0,1,2,3.296850157,240,6,1,44,44,0,2019,1533,486,16,16,0,85.34031414
fc775da0c798bb63014130a4ef2ed7c9243eca72,16,34,41,7,1,0,1,2,4,0,1,2,3.194069627,285,7,2,42,45,3,1891,2065,174,16,17,1,98.16513761
0aa56ea1bef4d6a5a6cf56fc69116a182cccc783,23,735,11,724,0,0,0,2,4,0,1,4,3.611753177,2690,8,3,347,347,0,23255,23254,1,96,96,0,100
2f2e72c29523d1305635ee66242ac97179047dfb,2,3,3,0,0,0,0,2,5,0,1,2,0.918295834,59,9,4,5,5,0,442,442,0,3,3,0,98.16513761
aae6fcfa239b51b56d5c31da1670b4b23a9bfdbf,1,33,5,28,0,0,0,1,2,0,1,1,0,16,10,5,10,3,7,190,70,120,2,1,1,98.63013699
3b15bb4f816516842718293964478bf3f06661ba,1,30,3,27,0,0,0,2,3,17,1,1,0,41,3,3,21,10,11,399,190,209,2,2,0,98.63013699
c68d23d538fb919cd03e61552c61eb1f06ddec29,1,10,8,2,0,0,0,2,3,18,1,1,0,96,4,4,11,11,0,716,629,87,7,7,0,97.26027397
6ecc266e40cf29d6fd6a091764fe0abc4155cf1d,16,963,937,26,0,0,0,2,4,4,1,5,0.640823404,3317,5,5,420,398,22,27257,25856,1401,120,102,18,71.75925926
4b090042788947b3ef463e1d02b05f208513a313,12,12,12,0,0,0,0,1,3,1,1,5,3.584962501,1069,6,6,143,152,9,6670,7332,662,60,64,4,81.53153153
ddacc61f3ac584f12a0c47afa8951cba7137062e,8,150,119,31,5,0,5,2,4,0,1,3,2.463150199,861,7,7,130,130,0,8150,8021,129,30,30,0,90.47619048
f84bd0ca8f0f9196f1522745107dbfe0bcf15e87,2,7,6,1,0,0,0,2,4,0,1,1,0.995727452,1340,8,8,163,163,0,12315,12279,36,32,32,0,96.42857143
1214870fad759e918a9ad60bc08d8db085f2f0e4,3,3,13,10,0,0,0,1,1,0,1,1,1.061278124,451,9,9,48,48,0,3087,3042,45,24,24,0,94.82758621
67240b3c18dadd92a442e18f7d9721cabbbba464,4,82,27,55,3,0,3,2,5,0,1,2,1.314447955,712,10,10,101,99,2,7341,7119,222,20,18,2,96.23430962
a77f7cc33cf645fae1c5b51a73d404833672183a,2,32,28,4,0,0,0,2,5,1,1,2,0.970950594,559,11,11,72,72,0,5182,5140,42,19,19,0,99.59349593
cdde0f389839a533d20338933d98d5f25416a2c2,1,1,0,1,0,0,0,1,3,0,1,1,0,41,12,12,6,6,0,396,396,0,6,6,0,100
7ac71c61fe5df026941ac8733b68149d58d45260,1,5,0,5,1,0,1,1,1,0,1,1,0,0,13,13,0,0,0,14,0,14,0,0,0,99.19354839
0809915f42a2044ee25fe7ac228bc1b2852fa0a8,1,3,0,3,0,0,0,1,4,6,1,1,0,41,14,14,6,6,0,407,396,11,6,6,0,100
ae22a0a206b8c8aa701f99a89d5ba243c6694287,27,1100,1245,145,1,0,1,1,2,0,3,7,1.920707111,3415,11,6,441,505,64,27519,33014,5495,131,172,41,66.80851064
8d7dd838a8f8146fa6acc492e1fdc52d94da5794,27,1267,1122,145,9,0,9,2,5,12,2,8,1.902794847,3429,15,15,454,492,38,28481,31961,3480,133,170,37,66.80851064
269ab56a663c954910cb59803655aed5457c8d2c,26,1511,6862,5351,3,0,3,2,6,207,3,6,3.969068812,6033,16,0,187,581,394,15430,54269,38839,48,184,136,73.45132743
4fdd051edbdd5f6547abcf7080484938e3700342,0,0,0,0,0,0,0,0,0,0,0,0,0,0,17,1,0,0,0,0,0,0,0,0,0,100
e739c9aba2529babe10208dad3242b2590751513,3,43,1,42,0,0,0,1,2,0,1,1,1.536749209,158,18,2,4,4,0,1550,1550,0,3,3,0,100
811344eee9f5587a73f449aed13070e804e064b1,1,0,5,5,0,0,0,1,2,66,1,1,0,3,19,3,0,0,0,0,14,14,0,0,0,97.98994975
07c89803fd6b7173ca50a651c4dfe6e97524709e,0,0,0,0,0,0,0,0,0,0,0,0,0,0,106,0,0,0,0,0,0,0,0,0,0,100
35875308952af145eb7326fef88c9fb8155b2679,1,93,0,93,1,0,1,1,1,0,1,1,0,0,107,1,2,0,2,535,0,535,1,0,1,97.98994975
e811e2da4c3d0c36536bcb0adca0ba5feebe3987,1,273,0,273,1,0,1,1,1,0,1,1,0,0,108,2,8,0,8,2001,0,2001,3,0,3,99.01960784
bd6008de63326f6cb7fdc6c8ecc92f14306a36f5,1,174,0,174,1,0,1,1,1,0,1,1,0,0,109,3,10,0,10,1318,0,1318,3,0,3,99.03846154
09b0a843f9155b45629ab0b1e7beebc9db55b061,1,2,2,0,0,0,0,2,3,1,1,1,0,58,110,4,1,1,0,456,456,0,1,1,0,100
ec615d4d3d4540bb225fab604e64652982da683c,1,5,5,0,0,0,0,2,3,1,1,1,0,78,111,5,2,2,0,572,572,0,1,1,0,100
d29865ad8f10c4bb82f1685f1617a0e6e7d0c96b,1,3,3,0,0,0,0,2,3,1,1,1,0,64,112,6,1,1,0,522,522,0,1,1,0,100
d6c6d822f07e021b977a81063823c0d0fe892de9,0,0,0,0,0,0,0,0,0,0,0,0,0,0,113,7,0,0,0,0,0,0,0,0,0,100
68a6cd44a68cd9be0fadd2ba9e399cdf9089f8ab,0,0,0,0,0,0,0,0,0,0,0,0,0,0,114,8,0,0,0,0,0,0,0,0,0,100
8525fd41c52c1c467c32130525db7f5fa6b1106a,0,0,0,0,0,0,0,0,0,0,0,0,0,0,115,9,0,0,0,0,0,0,0,0,0,100
630d0249896ef4fc40015f8eae8948bb5a64a530,0,0,0,0,0,0,0,0,0,0,0,0,0,0,116,10,0,0,0,0,0,0,0,0,0,100
caad556c1d04e6a9e5d26e864eceee3dff8db336,1,0,93,93,0,0,0,1,2,39,1,1,0,77,117,11,0,2,2,0,535,535,0,1,1,99.03846154
196ccdf298cea9d6a01f60c095165286d0da7855,1,0,273,273,0,0,0,1,2,39,1,1,0,218,118,12,0,8,8,0,2001,2001,0,3,3,99.01960784
1f51fb8ff99e648a24ec8a412a9dcecbd0e0eb53,1,0,174,174,0,0,0,1,2,39,1,1,0,160,119,13,0,10,10,0,1318,1318,0,3,3,97.98994975
4c9a058170240a549123fc6a7cbe4f159a448b43,0,0,0,0,0,0,0,0,0,0,0,0,0,0,20,0,0,0,0,0,0,0,0,0,0,100
7317aa48d3915ab87ed0a3c43f470f3964f594a9,10,1157,181,976,8,0,8,1,7,42,1,6,2.934908704,321,21,1,118,38,80,8270,2851,5419,46,19,27,84.07079646
81cfc4e5094a7a82f702a312233eb19f9ea971b1,20,1094,660,434,5,0,5,1,8,94,1,9,3.204123192,2062,22,2,294,241,53,22163,18571,3592,93,65,28,87.35177866
2924243a37e565886266b88fab0ff2cd0098fc96,0,0,0,0,0,0,0,0,0,0,0,0,0,0,23,3,0,0,0,0,0,0,0,0,0,100
7b92720d509675f302a33fb3411c88b49e0a0f0d,4,8,8,0,0,0,0,1,3,0,1,3,1.905639062,362,23,3,37,37,0,2823,2809,14,19,19,0,100
f1136e6a5ac7b5f812e416c91d1551f12f52e240,0,0,0,0,0,0,0,0,0,0,0,0,0,0,25,5,0,0,0,0,0,0,0,0,0,100
f6f17cd562d9214eee47bffeffa19859b918349a,1,26,79,53,0,0,0,1,4,0,1,1,0,132,26,6,8,14,6,717,1041,324,5,5,0,100
a7df53f7633287be043060c87067473abf9fe812,0,0,0,0,0,0,0,0,0,0,0,0,0,0,27,7,0,0,0,0,0,0,0,0,0,100
abab6ca5a9727b3b97062a86c350e81723c0cec3,0,0,0,0,0,0,0,0,0,0,0,0,0,0,28,8,0,0,0,0,0,0,0,0,0,100
07a68c17a8e628a06ab22492b4cbd0466562aeaa,0,0,0,0,0,0,0,0,0,0,0,0,0,0,29,9,0,0,0,0,0,0,0,0,0,100
6240125c31b62346c7430db3d4a8fa6d583eaa78,0,0,0,0,0,0,0,0,0,0,0,0,0,0,30,10,0,0,0,0,0,0,0,0,0,100
27a93a4dbdf3b9f5c29665114610e153af4f7b86,2,0,1313,1313,0,0,0,1,5,2,1,2,0.407417322,925,31,11,0,117,117,0,9105,9105,0,9,9,92.21311475
c0efd187cbe6ce3f4f525198320f21c7e99440df,20,419,1164,745,0,0,0,1,9,168,1,6,3.560293922,1860,32,11,159,236,77,11416,14991,3575,56,98,42,86.5470852
2ef688768a0d5a7390cb48e8365787a749ded5fa,0,0,0,0,0,0,0,0,0,0,0,0,0,0,33,12,0,0,0,0,0,0,0,0,0,100
0ead02b8ccd065a8355e1b91ae36bbdc1a15e019,7,685,361,324,1,0,1,1,9,32,1,4,1.32703671,782,34,13,137,88,49,8984,6646,2338,48,39,9,84.81675393
c87910e30d440a45a6514d4e85424d82636bee94,1,0,2,2,0,0,0,2,7,0,1,1,0,377,35,14,52,52,0,3625,3647,22,14,14,0,95.97701149
7ceb6c3f618d3fc65367bed5a48eb9d614e3a33a,0,0,0,0,0,0,0,0,0,0,0,0,0,0,12,0,0,0,0,0,0,0,0,0,0,100
ac21391cc9a3308ca3574c502e43c86f69d8c321,15,369,210,159,3,0,3,1,10,60,1,7,3.398661318,1706,36,15,228,233,5,15818,15507,311,76,71,5,89.50276243
3ca15bb52557a136faf8e2de3f3854af388aa5ee,0,0,0,0,0,0,0,0,0,0,0,0,0,0,37,16,0,0,0,0,0,0,0,0,0,100
d74df010b912b37e4f39b0528dc6ba3db5c38a65,2,12,5,7,0,0,0,1,5,8,1,2,0.522559375,141,38,17,25,25,0,1310,1086,224,19,19,0,100
84e85117affb4bf95da310588ab920bf5450db59,1,0,210,210,0,0,0,2,4,300,1,1,0,110,39,18,0,15,15,0,953,953,0,12,12,98.92473118
03d5333bb5a9d056b01f6d17fbf78b97bf7acb4f,0,0,0,0,0,0,0,0,0,0,0,0,0,0,13,1,0,0,0,0,0,0,0,0,0,100
f36cf76c4bd8ee1ab46c63a3458312e4b907407d,0,0,0,0,0,0,0,0,0,0,0,0,0,0,9,0,0,0,0,0,0,0,0,0,0,100
ccc69f40ab625c9f4f672cf26f24635e8bba21b7,0,0,0,0,0,0,0,0,0,0,0,0,0,0,10,1,0,0,0,0,0,0,0,0,0,100
7eb1997e5960fadfe5ccabba96dbc9d45fb1e2c6,0,0,0,0,0,0,0,0,0,0,0,0,0,0,14,2,0,0,0,0,0,0,0,0,0,100
e01a446d5d9b6b042347717234034ccccf532d9d,0,0,0,0,0,0,0,0,0,0,0,0,0,0,120,0,0,0,0,0,0,0,0,0,0,100
ed2f35d3d901950ad998309b51496ff8fb1bc64e,0,0,0,0,0,0,0,0,0,0,0,0,0,0,11,0,0,0,0,0,0,0,0,0,0,100
674e7c9bba5a4df3a7e0545befbb94adc69089ef,0,0,0,0,0,0,0,0,0,0,0,0,0,0,0,0,0,0,0,0,0,0,0,0,0,100
0f783746d1c9e6274571cf3709b88e81d6cf10d9,0,0,0,0,0,0,0,0,0,0,0,0,0,0,121,0,0,0,0,0,0,0,0,0,0,100
3c840e136fbfdb772b75a0875eae1a34d8d83b41,0,0,0,0,0,0,0,0,0,0,0,0,0,0,12,0,0,0,0,0,0,0,0,0,0,100
3f8b71391fd783f0734f5f719e560e84960a19b1,0,0,0,0,0,0,0,0,0,0,0,0,0,0,13,1,0,0,0,0,0,0,0,0,0,100
6ca71f838321c0e83cb95168feee3097fe0b84c0,513,90531,2098,88433,471,0,471,2,11,43,1,71,8.503768453,2887,122,0,9541,438,9103,290941,28812,262129,4440,185,4255,17.47126437
71c1c0fb2191cf7782c45b7249ec6e5f07ef150a,0,0,0,0,0,0,0,0,0,0,0,0,0,0,123,1,0,0,0,0,0,0,0,0,0,100
51f136cc59dc35932bf915c31a68971fcb3f134e,1,4,104,100,0,0,0,1,2,0,1,1,0,288,124,2,22,34,12,1653,2335,682,8,11,3,100
91bdebc19f4d76d8e258065f7d628b397014987f,0,0,0,0,0,0,0,0,0,0,0,0,0,0,125,3,0,0,0,0,0,0,0,0,0,100
acbbe3007b26a1f44377b418a5e06c83aab939f5,0,0,0,0,0,0,0,0,0,0,0,0,0,0,126,4,0,0,0,0,0,0,0,0,0,100
b324a0d3c06ed5d2c9dd52e01bfe30ef2942d36b,0,0,0,0,0,0,0,0,0,0,0,0,0,0,127,5,0,0,0,0,0,0,0,0,0,100
a2f171aa16e07574b9b588c76d86814c9dadcd3e,0,0,0,0,0,0,0,0,0,0,0,0,0,0,128,6,0,0,0,0,0,0,0,0,0,100
ba51de58f97c5f9dc22855ee76c6df9ca63d5c5b,0,0,0,0,0,0,0,0,0,0,0,0,0,0,129,0,0,0,0,0,0,0,0,0,0,100
7fe9c81b2808072a0aef04a926d871f35adf36bd,0,0,0,0,0,0,0,0,0,0,0,0,0,0,130,1,0,0,0,0,0,0,0,0,0,100
323cc27f09c6c201e5e9099a6de72f5451969cad,77,1183,1337,154,1,0,1,2,12,76,1,14,4.604533019,5948,131,2,673,703,30,44946,48021,3075,286,291,5,96.94214876
88d3ab56b7770da1e82ff4ea67218256fcd781dd,0,0,0,0,0,0,0,0,0,0,0,0,0,0,132,3,0,0,0,0,0,0,0,0,0,100
2158d7676492738286b6691390fec8a448544468,0,0,0,0,0,0,0,0,0,0,0,0,0,0,133,4,0,0,0,0,0,0,0,0,0,100
952b70c93130e8dd278309fc0ee68bf97d23ea99,0,0,0,0,0,0,0,0,0,0,0,0,0,0,134,5,0,0,0,0,0,0,0,0,0,100
07d2a533ef24ffd8913bdfac163838da39f6f3d0,0,0,0,0,0,0,0,0,0,0,0,0,0,0,135,6,0,0,0,0,0,0,0,0,0,100
5d49516e3be03c823da11f79e7476cfe125985a5,0,0,0,0,0,0,0,0,0,0,0,0,0,0,136,7,0,0,0,0,0,0,0,0,0,100
0ecad6e2f85cf5bc289d4a850224071621f67947,0,0,0,0,0,0,0,0,0,0,0,0,0,0,137,8,0,0,0,0,0,0,0,0,0,100
86ec79a88338d7353e2834d920f2d336a88354a6,0,0,0,0,0,0,0,0,0,0,0,0,0,0,138,9,0,0,0,0,0,0,0,0,0,100
46e174814a82eba36ba79e27b4c02e0259266c61,0,0,0,0,0,0,0,0,0,0,0,0,0,0,139,10,0,0,0,0,0,0,0,0,0,100
e4fed4c7a9c191108042485f8d4e3a0d6efd7246,0,0,0,0,0,0,0,0,0,0,0,0,0,0,140,11,0,0,0,0,0,0,0,0,0,100
0e7b05b10a3d3e0a94d9929ca231b8bf3e404bcf,0,0,0,0,0,0,0,0,0,0,0,0,0,0,141,12,0,0,0,0,0,0,0,0,0,100
6664901c51bec1e48c358b31ce0b5af52b283e2e,0,0,0,0,0,0,0,0,0,0,0,0,0,0,142,13,0,0,0,0,0,0,0,0,0,100
9045517a858434586b298fa5bc6c68744c2384d3,0,0,0,0,0,0,0,0,0,0,0,0,0,0,143,14,0,0,0,0,0,0,0,0,0,100
aa0e0933fab9ea02188500024ba5927406a48180,0,0,0,0,0,0,0,0,0,0,0,0,0,0,144,13,0,0,0,0,0,0,0,0,0,100
6411d55cb1b4bc9cd3bb1d2801f78ed7f4e8abd5,0,0,0,0,0,0,0,0,0,0,0,0,0,0,145,14,0,0,0,0,0,0,0,0,0,100
fe2bf78ee396242a2925978c8592019b9392757a,0,0,0,0,0,0,0,0,0,0,0,0,0,0,146,15,0,0,0,0,0,0,0,0,0,100
9747c85b2f1dd0a927554bf509156dfa78220153,447,465,84631,84166,2,0,2,1,13,0,1,62,8.345707935,52336,147,3,238,9054,8816,21516,262421,240905,112,4245,4133,28.32244009
1f066ad2e5c1478d43bf3ff47b1839aa622d964e,0,0,0,0,0,0,0,0,0,0,0,0,0,0,148,4,0,0,0,0,0,0,0,0,0,100
5da8403e6024651284290a20889cccadf7ed2a7d,0,0,0,0,0,0,0,0,0,0,0,0,0,0,149,5,0,0,0,0,0,0,0,0,0,100
c6fb3beb11be30a2ee49d9ad92a500824e0b9d91,0,0,0,0,0,0,0,0,0,0,0,0,0,0,150,5,0,0,0,0,0,0,0,0,0,100
6eea3255b888a657c111626637b5f5b3b73c35b9,0,0,0,0,0,0,0,0,0,0,0,0,0,0,151,6,0,0,0,0,0,0,0,0,0,100
8c947f784f7395c465a24300ba23fb24bd0f2007,0,0,0,0,0,0,0,0,0,0,0,0,0,0,152,7,0,0,0,0,0,0,0,0,0,100
9a544f58049e37005811e2fa2fb3fac8aa3e7802,0,0,0,0,0,0,0,0,0,0,0,0,0,0,153,6,0,0,0,0,0,0,0,0,0,100
92accba2666b5a730f4590540ad117db9d8e253e,0,0,0,0,0,0,0,0,0,0,0,0,0,0,154,7,0,0,0,0,0,0,0,0,0,100
0a8e246e4c22edccb9f4f78490e740ed725809de,0,0,0,0,0,0,0,0,0,0,0,0,0,0,155,8,0,0,0,0,0,0,0,0,0,100
fc6eabd4bed624b79dc45e7755aa1cb591eb0c02,3,34,0,34,3,0,3,1,1,0,1,1,1.429753806,0,0,0,2,0,2,103,0,103,2,0,2,97.6945245
3fa7a704c389d7ace962ab5f44641e2e8819a539,0,0,0,0,0,0,0,0,0,0,0,0,0,0,1,1,0,0,0,0,0,0,0,0,0,100
03950e3dc0f298bdafe0ed6746b07e4368fa9948,15,319,389,70,0,0,0,3,9,182,1,5,3.717830783,1794,2,2,201,201,0,14676,14727,51,91,91,0,96.90140845
64ea403ad14c2b9bc4ae26b0a641b0c837fc75db,52,287,401,114,0,0,0,2,14,191,1,10,4.65818173,3316,3,3,417,417,0,28279,29006,727,179,179,0,94.61756374
847921ac5cec71bc1853854b3fb2ad1a581d75b7,20,76,49,27,0,0,0,3,10,0,1,5,4.237102789,2127,156,0,252,243,9,18027,18042,15,102,99,3,100
8861822b553589946e98688aa45ba964895c0ff0,0,0,0,0,0,0,0,0,0,0,0,0,0,0,157,1,0,0,0,0,0,0,0,0,0,100
f0ca01d96a836f91d05ff7c6f88530fa2a893158,80,2415,570,1845,0,0,0,3,15,20,1,15,5.914089837,5382,158,2,694,694,0,45616,45589,27,304,304,0,100
67cb4e0cd9dc430f9468cb787830b7094fc24f57,0,0,0,0,0,0,0,0,0,0,0,0,0,0,159,3,0,0,0,0,0,0,0,0,0,100
338746ff158dc44a81adcdfc1eec9bd6af4ecff8,1,0,0,0,0,0,0,1,1,0,1,1,0,6,160,4,1,1,0,25,25,0,1,1,0,98.85714286
50062eac96ff40ffd229610324c1bf4059a60017,1,0,0,0,0,0,0,2,6,0,1,1,0,6,161,5,1,1,0,25,25,0,1,1,0,98.85714286
f0100da49494bc5721d6d669f176d83c29445450,90,3486,4402,916,10,0,10,3,16,0,1,15,5.360996506,5472,162,6,663,694,31,44342,45831,1489,231,306,75,76.80722892
de58eade675466a784f6cb7947b272cdabcb9c72,0,0,0,0,0,0,0,0,0,0,0,0,0,0,163,7,0,0,0,0,0,0,0,0,0,100
c46fbb5c9e27e53f23c7619dbb3d65365c7fe6c6,81,2505,1378,1127,11,0,11,3,17,0,1,15,5.395211155,5292,163,7,756,663,93,50590,44342,6248,260,231,29,75.46583851
a74846d9c1015766a0fd966706961d8f0a9b0018,1,0,1,1,0,0,0,2,9,0,1,1,0,213,164,8,25,25,0,2373,2381,8,6,6,0,100
33d835ecd3b6db2338031bd7f15d633f5ce2d051,0,0,0,0,0,0,0,0,0,0,0,0,0,0,165,9,0,0,0,0,0,0,0,0,0,100
85bd7fe1e210e59842181f387b41d57074ad4305,0,0,0,0,0,0,0,0,0,0,0,0,0,0,166,10,0,0,0,0,0,0,0,0,0,100
8d134899a464d1bcb220ad0f6474a5a72311294c,0,0,0,0,0,0,0,0,0,0,0,0,0,0,167,11,0,0,0,0,0,0,0,0,0,100
99ae47b08155d322c306a451259296caf67d1da8,0,0,0,0,0,0,0,0,0,0,0,0,0,0,169,13,0,0,0,0,0,0,0,0,0,100
54d84c9c9e578117081e49cf5a1faf7503308743,0,0,0,0,0,0,0,0,0,0,0,0,0,0,168,12,0,0,0,0,0,0,0,0,0,100
7ca462e356e4b7048e2f80849a105b7fae530332,0,0,0,0,0,0,0,0,0,0,0,0,0,0,171,15,0,0,0,0,0,0,0,0,0,100
1e4dc8be57f5564988809c93006eedb3745aea27,0,0,0,0,0,0,0,0,0,0,0,0,0,0,0,0,0,0,0,0,0,0,0,0,0,100
dd5f865f50cd9c7596ea822da9ceb7dca121f391,91,4171,157,4014,26,0,26,3,18,0,1,22,4.809400545,5978,169,0,1022,756,266,70066,50582,19484,363,260,103,83.08080808
2adce0c1c13af172f9be6c3cd0cda1431c74d0b8,0,0,0,0,0,0,0,0,0,0,0,0,0,0,173,1,0,0,0,0,0,0,0,0,0,100
ddc4f70c711af135a86ad14d84ef53b5c82bc503,0,0,0,0,0,0,0,0,0,0,0,0,0,0,174,2,0,0,0,0,0,0,0,0,0,100
9445b0f9ad88c81d147e4d9a9de67121cb47326d,0,0,0,0,0,0,0,0,0,0,0,0,0,0,175,3,0,0,0,0,0,0,0,0,0,100
8d731e1d51169ce18d38685033c93db7aa17d7a9,1,11,11,0,0,0,0,1,2,0,1,1,0,70,176,4,10,10,0,600,587,13,4,4,0,99.13232104
ce84dc70e358327def9600851557b822968812f0,0,0,0,0,0,0,0,0,0,0,0,0,0,0,177,5,0,0,0,0,0,0,0,0,0,100
c912d522f7f6fc629cbd8388b45a75558d8bd9d4,0,0,0,0,0,0,0,0,0,0,0,0,0,0,178,6,0,0,0,0,0,0,0,0,0,100
c9c3301b6fe8a4858951d98482789ae2b55a062d,0,0,0,0,0,0,0,0,0,0,0,0,0,0,179,7,0,0,0,0,0,0,0,0,0,100
ec6a2a23c55e3fcd51ab71fec9edbfd4fb70e294,0,0,0,0,0,0,0,0,0,0,0,0,0,0,180,8,0,0,0,0,0,0,0,0,0,100
44b7d693cc0113539aab5667769171a53f28a93c,0,0,0,0,0,0,0,0,0,0,0,0,0,0,0,0,0,0,0,0,0,0,0,0,0,100
2e13329a2ba2031da721d3844fb68a42b096dc75,0,0,0,0,0,0,0,0,0,0,0,0,0,0,0,0,0,0,0,0,0,0,0,0,0,100
b086dfbdd3b8569eb52d56cdc420cfb7b0670044,0,0,0,0,0,0,0,0,0,0,0,0,0,0,180,8,0,0,0,0,0,0,0,0,0,100
a9fe0d475101e743189bc4d305792f0cc726d495,0,0,0,0,0,0,0,0,0,0,0,0,0,0,181,9,0,0,0,0,0,0,0,0,0,100
5deae3d59243a61140cc216f39356c12c2914179,0,0,0,0,0,0,0,0,0,0,0,0,0,0,183,11,0,0,0,0,0,0,0,0,0,100
ad8d7881211b7e8fbfaa0b9e42634fdbc11f42e9,0,0,0,0,0,0,0,0,0,0,0,0,0,0,184,12,0,0,0,0,0,0,0,0,0,100
5117a951554801866da3b4c3763916fd46188b7d,0,0,0,0,0,0,0,0,0,0,0,0,0,0,185,13,0,0,0,0,0,0,0,0,0,100
199b558d23afec6d1d7607b0d7587146b2bb13e6,0,0,0,0,0,0,0,0,0,0,0,0,0,0,186,14,0,0,0,0,0,0,0,0,0,100
0d7f87c2b5c070687d8b7d9669546ce990a6d051,20,187,72,115,1,0,1,2,13,76,1,9,3.926151161,1752,187,0,171,153,18,15477,14517,960,74,70,4,97.17391304
80f355ae6117aa1d47a8bdf3c765c78bad63462b,15,150,60,90,0,0,0,2,11,5,1,8,3.442683299,1328,188,1,109,114,5,11706,12198,492,66,71,5,94.34782609
3c956b1a314bbe6bf54f13e11f5009eb81eb258a,0,0,0,0,0,0,0,0,0,0,0,0,0,0,189,2,0,0,0,0,0,0,0,0,0,100
474f460a0007b9fa9a448f2d80427959d1172068,0,0,0,0,0,0,0,0,0,0,0,0,0,0,190,3,0,0,0,0,0,0,0,0,0,100
b53433ec9bf1c8afb5c38a0d3e163b581e60fa19,0,0,0,0,0,0,0,0,0,0,0,0,0,0,191,4,0,0,0,0,0,0,0,0,0,100
f647480c6780e4aa5faf97219c2a3ed556277096,0,0,0,0,0,0,0,0,0,0,0,0,0,0,192,5,0,0,0,0,0,0,0,0,0,100
32d145973c4aa5b85ad40e5df507ae8eb4b563f5,0,0,0,0,0,0,0,0,0,0,0,0,0,0,192,5,0,0,0,0,0,0,0,0,0,100
5315c8ff077429018a416284e0cf969f8521a921,0,0,0,0,0,0,0,0,0,0,0,0,0,0,194,7,0,0,0,0,0,0,0,0,0,100
b360ee96db11fa04bc053f457c0133cc9eb6d950,1,4,4,0,0,0,0,1,3,108,1,1,0,82,193,6,10,10,0,787,787,0,9,9,0,100
8a07f09be6b4230e97ff0f4abb3d99df837943be,0,0,0,0,0,0,0,0,0,0,0,0,0,0,196,9,0,0,0,0,0,0,0,0,0,100
bb30d00783bb7264a6e8237bdbeebd513db7cd88,11,650,111,539,1,0,1,1,19,82,1,4,2.606655222,1665,194,2,225,194,31,18425,16778,1647,106,75,31,98.7012987
2aaef7534372d56d52b3ba944919ecd377dad344,2,18,10,8,0,0,0,1,3,64,1,2,0.491237342,237,195,3,25,24,1,2364,2335,29,7,7,0,100
e1a63fd3de594f8b619b3bfca586268043e65bb4,0,0,0,0,0,0,0,0,0,0,0,0,0,0,199,6,0,0,0,0,0,0,0,0,0,100
7493a7596335ff849eacc0771dc7d7c52b70f24a,0,0,0,0,0,0,0,0,0,0,0,0,0,0,196,4,0,0,0,0,0,0,0,0,0,100
9019595845dac946dc8492ff676bcef8a5ed46aa,0,0,0,0,0,0,0,0,0,0,0,0,0,0,201,8,0,0,0,0,0,0,0,0,0,100
8906358ca63fb9bdb8c9c5cbfbbee3789ee56fed,0,0,0,0,0,0,0,0,0,0,0,0,0,0,197,5,0,0,0,0,0,0,0,0,0,100
646e61c7bd3557c2adc5e54659db286b56dc088f,0,0,0,0,0,0,0,0,0,0,0,0,0,0,203,10,0,0,0,0,0,0,0,0,0,100
e5503ef96e58627f9df975575209c253d89661ee,0,0,0,0,0,0,0,0,0,0,0,0,0,0,198,0,0,0,0,0,0,0,0,0,0,100
920ee29cb8df80cef283a8bbf8a56f2e7a5e668c,0,0,0,0,0,0,0,0,0,0,0,0,0,0,205,1,0,0,0,0,0,0,0,0,0,100
2232076dad8da758da5382fb8b5e72492caa6b61,60,2557,2784,227,3,0,3,1,20,132,1,17,4.461140098,6426,199,1,812,794,18,53552,53870,318,299,273,26,89.92974239
1a7f8235e34c17ec1690a3912e479924435da228,0,0,0,0,0,0,0,0,0,0,0,0,0,0,207,3,0,0,0,0,0,0,0,0,0,100
9344ddcf33246fd5858c1132c79c90448d5bb2d6,2,50,3,47,0,0,0,3,13,0,1,2,0.386018901,772,200,2,95,89,6,7108,6783,325,27,25,2,100
f6f38d3104ae4eb92c2f823c5bccffa208cb7133,0,0,0,0,0,0,0,0,0,0,0,0,0,0,209,5,0,0,0,0,0,0,0,0,0,100
d148d270457cf726879ca74d1079a4a3525fe1b6,0,0,0,0,0,0,0,0,0,0,0,0,0,0,201,3,0,0,0,0,0,0,0,0,0,100
387a88a51cfe48c27807c432a05389fc67d36ce3,0,0,0,0,0,0,0,0,0,0,0,0,0,0,211,7,0,0,0,0,0,0,0,0,0,100
07a8b20792929a87e8f2a73c105a5f1917b69134,0,0,0,0,0,0,0,0,0,0,0,0,0,0,202,4,0,0,0,0,0,0,0,0,0,100
e6ca4d67883b98c31c3fd57089fc0513d8d2121e,0,0,0,0,0,0,0,0,0,0,0,0,0,0,213,9,0,0,0,0,0,0,0,0,0,100
f5aabdb05d1ef08b17b9774af654199c2ac9933a,29,1835,962,873,10,0,10,1,4,32,2,10,3.47930044,1881,203,0,273,196,77,20482,26670,6188,110,142,32,78.3042394
427f6f26b7881ebc97d3966fb9e087b66c1c9c3e,70,0,168,168,0,0,0,1,2,20,2,16,2.313509579,6947,204,1,891,206,685,56227,19610,36617,336,200,136,36.69250646
14fc841cdf911809f08bc6bbc53ae66041c5c5c0,0,0,0,0,0,0,0,0,0,0,0,0,0,0,205,2,0,0,0,0,0,0,0,0,0,100
ef9e5c354966ea57c5dd36005e33d76056a98a8e,0,0,0,0,0,0,0,0,0,0,0,0,0,0,206,3,0,0,0,0,0,0,0,0,0,100
c1489a34869b89168aa51f1cdfc60c5df4e4ae0b,0,0,0,0,0,0,0,0,0,0,0,0,0,0,207,4,0,0,0,0,0,0,0,0,0,100
ac4dc7fe049e85bd432886f1f7c8f57ca1345af3,0,0,0,0,0,0,0,0,0,0,0,0,0,0,208,5,0,0,0,0,0,0,0,0,0,100
08ac35d9822e20880608f80cefe0a589d54d6db5,0,0,0,0,0,0,0,0,0,0,0,0,0,0,220,6,0,0,0,0,0,0,0,0,0,100
1b6ffbb68745f30e1ddde2d766f1b20073e4b5b4,0,0,0,0,0,0,0,0,0,0,0,0,0,0,209,6,0,0,0,0,0,0,0,0,0,100
25523dc6688e0b9303b24da644f667c3c871969d,0,0,0,0,0,0,0,0,0,0,0,0,0,0,222,8,0,0,0,0,0,0,0,0,0,100
b77b57f9ffe34c8f99c3243c539b6d120d5d863b,2,5,3,2,0,0,0,1,2,2,1,2,0.543564443,375,210,7,24,24,0,3535,3526,9,14,14,0,100
097de21627c9233c363edc6259fda5bd1e8068f7,1,1,1,0,0,0,0,1,2,4,1,1,0,37,211,8,3,3,0,280,289,9,3,3,0,100
253df9dcba50e01b759fe752cbd77ee1c95dd54f,0,0,0,0,0,0,0,0,0,0,0,0,0,0,225,11,0,0,0,0,0,0,0,0,0,100
6db77882c19ea9686e2ca2e0e2bfb1009e3192ca,3,425,0,425,3,0,3,1,1,0,1,3,1.545448924,0,212,9,22,0,22,2157,0,2157,12,0,12,98.10298103
e311f2d14a8a1b1339ef6ad29fa0741062ad1113,2,36,12,24,0,0,0,1,2,0,1,2,0.543564443,186,213,10,16,16,0,1492,1492,0,8,8,0,100
06ecaa671a3b0ae829104f5702a73e014a95e817,15,573,238,335,3,0,3,1,3,0,1,6,3.300576681,1994,214,11,234,211,23,18441,17492,949,90,78,12,93.1372549
ac607309962ecf02c77adb83283b9832f14c2d74,0,0,0,0,0,0,0,0,0,0,0,0,0,0,229,15,0,0,0,0,0,0,0,0,0,100
5d6c53231da431d579231fdba4f4f6b7b5364937,2,123,183,60,0,0,0,1,2,13,1,2,0.120364434,293,215,12,24,34,10,2073,2558,485,13,14,1,100
90aa25de5d1275905b3fe177eb8d0bf352b1b7df,13,337,593,256,2,0,2,1,4,3,1,5,2.904277837,1642,216,13,161,175,14,12390,13169,779,53,60,7,94.05940594
a43bdb7cfaa2ef57cf3316881c03016b5c36ddb8,8,348,27,321,1,0,1,1,5,6,2,8,1.779159366,860,217,14,99,78,21,8947,7107,1840,43,38,5,97.60638298
7f0d2b7ec42aeac9ed33c4f68bf69ef107aecc68,0,0,0,0,0,0,0,0,0,0,0,0,0,0,233,19,0,0,0,0,0,0,0,0,0,100
42231451bfc010313e0bdd815b7fe08ddb2d741a,0,0,0,0,0,0,0,0,0,0,0,0,0,0,218,15,0,0,0,0,0,0,0,0,0,100
ba0d7bcb06ba23c5bc8219284225f2c89e50a69f,0,0,0,0,0,0,0,0,0,0,0,0,0,0,235,21,0,0,0,0,0,0,0,0,0,100
5568955794925c8faf2b4f74eb58349733611c04,42,1313,91,1222,2,0,2,1,4,40,1,15,3.739612654,5001,219,0,722,624,98,47588,42053,5535,302,256,46,96.61458333
7ea1d88800cd58d11005c17b47799ea7020c4d02,0,0,0,0,0,0,0,0,0,0,0,0,0,0,220,1,0,0,0,0,0,0,0,0,0,100
ad1602fe1710f8136cafe6d3dee2dcf64dbeafe0,0,0,0,0,0,0,0,0,0,0,0,0,0,0,221,2,0,0,0,0,0,0,0,0,0,100
ddca0a61366e93bd2465ecfd561fd565e1f2506b,0,0,0,0,0,0,0,0,0,0,0,0,0,0,239,3,0,0,0,0,0,0,0,0,0,100
802cd6a6ebba0d9db989d74dfd6b17f39cdf24ee,0,0,0,0,0,0,0,0,0,0,0,0,0,0,222,3,0,0,0,0,0,0,0,0,0,100
32e8ddb04236a4ea7f5283fb66b6480d29d58b8a,0,0,0,0,0,0,0,0,0,0,0,0,0,0,241,5,0,0,0,0,0,0,0,0,0,100
bb7c0c53a971ef17798252f7e674ea458c008848,8,83,140,57,0,0,0,1,3,62,1,2,2.905841943,1241,223,4,157,161,4,9055,9414,359,52,51,1,100
ab6ba20efa914d39b186d528a7d208d0c067e417,0,0,0,0,0,0,0,0,0,0,0,0,0,0,243,7,0,0,0,0,0,0,0,0,0,100
ee6c8f15b12536b27e42f6d68cadd5eb705a16be,10,132,14,118,0,0,0,1,4,39,1,3,3.022480798,2055,224,5,267,261,6,20070,19596,474,147,141,6,96.62337662
475ad85747a2750f5657ae4c9d63df2c58cc9ed1,0,0,0,0,0,0,0,0,0,0,0,0,0,0,245,9,0,0,0,0,0,0,0,0,0,100
f97c74b2397228c81f2992736762eafdc8ea906c,0,0,0,0,0,0,0,0,0,0,0,0,0,0,225,6,0,0,0,0,0,0,0,0,0,100
27100dd7add27fdfd9a996edcc8c55378d638e56,0,0,0,0,0,0,0,0,0,0,0,0,0,0,247,11,0,0,0,0,0,0,0,0,0,100
ec75e7c74be92adf267fe7e6f1945d14c3904da0,15,465,178,287,1,0,1,1,5,113,1,5,2.515806508,1996,226,3,261,228,33,18499,16964,1535,98,85,13,99.23664122
f84c690f6b103b881796acbd7d0c3aa036522469,5,130,16,114,0,0,0,1,6,0,1,3,1.80988994,1290,227,4,182,179,3,10858,10492,366,52,50,2,100
d7d9f818090cdb8cb4b4f2a01378ddc89d789cae,13,1012,821,191,0,0,0,1,7,20,1,5,0.79594097,2180,228,5,276,256,20,18829,18321,508,100,97,3,100
5022b2c609aa6eade7c0ce4618485c7b6f40add0,29,1771,1403,368,12,0,12,1,5,0,2,8,2.959445282,2674,0,0,366,309,57,24199,21540,2659,157,114,43,93.33333333
8e4b7f70f7a97c7f9f706093e3a7eec93094cccd,1,23,0,23,1,0,1,1,1,0,1,1,0,0,1,1,2,0,2,73,0,73,2,0,2,99.54751131
84e54305c8f5f3690dc66d7b5cd4e847e083d3e6,0,0,0,0,0,0,0,0,0,0,0,0,0,0,2,2,0,0,0,0,0,0,0,0,0,100
0b96eb61ce903aa3165365fd62fe250090e30ea9,1,48,4,44,0,0,0,1,2,0,1,1,0,13,3,3,3,2,1,447,73,374,3,2,1,99.3258427
e5a633e8b70f9b07e0fb14fe210424af1f6e712e,1,69,57,12,0,0,0,1,2,4,1,1,0,199,4,4,38,38,0,1701,1543,158,12,11,1,100
de5e88d89131ac953752f3e4443e1b56fbbfccc7,1,108,1,107,0,0,0,1,3,4,1,1,0,49,5,5,15,3,12,1510,447,1063,7,3,4,100
cc3a4cf293b127cc41c98a15a85307b584ccebfe,0,0,0,0,0,0,0,0,0,0,0,0,0,0,6,6,0,0,0,0,0,0,0,0,0,100
fd45a2285c07a963c33f89a1f896f42dc1fd1507,1,50,5,45,0,0,0,1,3,7,1,1,0,212,7,7,48,38,10,1916,1701,215,13,12,1,100
07f4e720378fef2b480653ef95cb125f4c249109,2,74,3,71,0,0,0,1,4,12,1,2,0.934646644,255,8,8,33,30,3,2512,2279,233,14,13,1,100
ff403855763f434d89b65276c38d777c7fd82f6e,0,0,0,0,0,0,0,0,0,0,0,0,0,0,9,9,0,0,0,0,0,0,0,0,0,100
8047c2d7939ad537cef133c1953779298f45551d,4,158,29,129,3,0,3,1,2,4,1,1,1.964208678,42,10,10,15,1,14,750,325,425,14,1,13,98.23399558
a703b4c5c552dc97ab72b89e70c82d155605b50f,10,454,264,190,7,0,7,1,4,2,1,3,2.762317867,341,11,11,73,60,13,3794,2724,1070,33,23,10,96.21052632
7f674bb0d7b062ff3867100628a74707fa9340db,2,13,1,12,0,0,0,1,2,9,1,2,0.591672779,69,12,12,13,11,2,522,471,51,13,11,2,99.79591837
62eca610af04f9dd28c613176456623f2db2a88a,10,117,129,12,2,0,2,1,5,2,1,3,2.87761606,352,13,13,56,66,10,2830,3146,316,35,45,10,97.9757085
dcdd700f7a872f8780527e53f7f8deec2a16f5f3,18,19,53,34,0,0,0,1,4,2,1,4,3.607737545,705,14,14,108,63,45,5218,4222,996,66,37,29,93.9516129
554405929b06392cf2ce12b08c8e0142b5857e1e,12,116,102,14,1,0,1,1,5,0,1,4,2.592037251,697,15,15,118,115,3,6072,5997,75,53,52,1,98.38709677
bd4d504f170b8c866a843b55a5260a4a58b0283b,95,594,322,272,1,0,1,1,6,75,1,20,4.690592037,8867,226,0,1192,1198,6,73534,74280,746,496,502,6,88.58800774
05ed061f09b35896d0f5fa0aff9397b3aa9cb6f8,4,17,23,6,0,0,0,2,5,0,1,2,1.780011676,264,16,12,47,47,0,2034,2092,58,23,24,1,99.81343284
f0eb64931371ca117381020e4a5b397e69d4ab00,10,90,7,83,0,0,0,2,6,0,1,2,3.115003623,418,17,13,74,75,1,3073,3125,52,28,28,0,100
46d542e69d0f21f4b27d59375f6d8b97b4b0e9cb,17,1402,810,592,1,0,1,1,7,43,1,6,1.597193945,2257,230,1,309,253,56,21540,19131,2409,114,96,18,99.44751381
78c7ad006e558077e16811a16c8b8e8ed56701b3,50,4769,2506,2263,12,0,12,1,7,1,2,19,4.330563626,6722,231,2,1132,862,270,69859,56491,13368,415,312,103,90.71803853
dbf9249e0c7ec957c0f7ae942c4c0b4b91ed4b1e,2,17,4,13,0,0,0,1,5,1,1,2,0.702466551,359,232,3,37,36,1,3264,3176,88,17,16,1,99.49324324
e814d5a031163604b4424066cb5cb43d1e6ab84f,2,8,8,0,0,0,0,1,6,0,2,2,0.543564443,323,233,4,28,28,0,2815,2815,0,16,16,0,100
593b89b7155644b26f42e973d51508e1484a967f,5,89,158,69,0,0,0,1,7,0,1,2,2.315280425,371,234,5,30,26,4,2792,2672,120,9,9,0,100
647476ce313663fbf1a9ba013ebc6b7cb3c6686e,6,30,266,236,0,0,0,1,8,64,1,3,1.134538413,944,235,6,45,59,14,7930,9011,1081,33,38,5,99.32088285
176747fd8fc87a2254e8ba83f03ebfdf85b82c26,0,0,0,0,0,0,0,0,0,0,0,0,0,0,258,7,0,0,0,0,0,0,0,0,0,100
7a1f4c926680a48050de1fe94daed4f3acdde8fe,28,182,57,125,0,0,0,1,9,73,2,8,3.981145308,3021,236,7,359,359,0,24252,24252,0,141,141,0,100
a1ca5eea59fbd33e3a6d88c399cf0edd3bd9ca08,0,0,0,0,0,0,0,0,0,0,0,0,0,0,237,8,0,0,0,0,0,0,0,0,0,100
0d1f931389dd44e13f7eba4abc2e7f02cbee3bc7,0,0,0,0,0,0,0,0,0,0,0,0,0,0,238,9,0,0,0,0,0,0,0,0,0,100
20fd43b2e4a08ad5a3a1acca44a5e22fb72052ff,0,0,0,0,0,0,0,0,0,0,0,0,0,0,262,11,0,0,0,0,0,0,0,0,0,100
366699703c19835ed3db45578578a353331daf5c,80,3827,6438,2611,4,0,4,1,7,30,2,24,4.733451447,10015,18,2,1013,1328,315,71269,86463,15194,421,530,109,88.41354724
53b516a3c1e3a1e412fb773f511a09a0a0c6af3d,1,20,11,9,0,0,0,2,6,26,1,1,0,73,19,3,23,19,4,739,655,84,6,6,0,98.87850467
4d66ec4bf539b7ad301680b67b5f302690e3a116,1,11,20,9,0,0,0,2,7,0,1,1,0,81,227,1,19,23,4,655,739,84,6,6,0,98.87850467
90a97cbfa58b2b46eae667bf44c6fd62c4cfa4af,3,1,78,77,0,0,0,2,8,0,1,2,1.067590714,186,228,2,18,33,15,928,1250,322,10,23,13,98.50746269
3c8887f5bbce99b8a977efa23b8b36ce54cee622,78,6436,3748,2688,13,0,13,1,9,20,2,23,4.702160934,8356,241,12,1323,993,330,86147,70631,15516,525,403,122,89.66131907
0b929e35ce241d6fcde35bc44957809fdfd2f8cd,3,85,1,84,1,0,1,2,9,14,1,2,0.94193097,177,20,4,36,23,13,1507,1215,292,23,12,11,99.65986395
bc65b5bf0cec43de985a24aa38941e9751b2ac30,1,10,5,5,0,0,0,2,8,8,1,1,0,73,21,5,22,19,3,733,655,78,6,6,0,99.15110357
595b350dbfd91f52415e838a45ab71bdaa66020e,1,7,0,7,0,0,0,3,4,26,1,1,0,140,15,0,20,18,2,976,952,24,9,7,2,100
e6ff2dee61db1aada3a09e04613067c6c4dcc924,1,31,0,31,0,0,0,2,3,59,1,1,0,208,16,1,23,22,1,2298,2067,231,9,8,1,99.49066214
947e6ed830ee045396f0f0baab9ec5c0993aeea0,0,0,0,0,0,0,0,0,0,0,0,0,0,0,242,3,0,0,0,0,0,0,0,0,0,100
5ad429a8e7f0a8abe4d9ef5005a3f813ef1bd1df,5,6,133,127,0,0,0,1,6,0,1,4,1.95715953,543,263,0,64,83,19,3937,4562,625,26,40,14,98.80952381
1138faacd5650fcb04437ea166d08f7036de92f9,5,133,6,127,1,0,1,2,9,19,1,4,1.95715953,458,268,5,83,64,19,4562,3937,625,40,26,14,98.80952381
0a0e38f57cbf95f572d531feb9f93d9ff1feb718,1,26,2,24,0,0,0,3,5,89,1,1,0,83,0,0,13,11,2,739,629,110,6,5,1,100
b08c44bbe2e87a9012b5a34492e2775230e54979,0,0,0,0,0,0,0,0,0,0,0,0,0,0,1,1,0,0,0,0,0,0,0,0,0,100
6c989e8336e921d09828915b4bc1b4e09901b35a,0,0,0,0,0,0,0,0,0,0,0,0,0,0,2,2,0,0,0,0,0,0,0,0,0,100
168ea0d10e7ea84abe067dea8f0d3aaafb8c252c,1,1,1,0,0,0,0,3,6,0,1,1,0,92,3,3,13,13,0,734,739,5,6,6,0,100
2871743f0a97edc47737c02205c68b0fba7cf9c3,0,0,0,0,0,0,0,0,0,0,0,0,0,0,269,3,0,0,0,0,0,0,0,0,0,100
a15091c7488125e3558c5344e93561e44b27db15,1,3,2,1,0,0,0,3,7,0,1,1,0,92,4,4,14,13,1,761,734,27,6,6,0,100
b81f173c5e31d5e3452d4edc8e066952cd286975,0,0,0,0,0,0,0,0,0,0,0,0,0,0,270,4,0,0,0,0,0,0,0,0,0,100
dcf1fbcdd3601c2c74b803d24745cabd8e2298a2,34,2268,614,1654,3,0,3,2,10,56,2,11,3.436302709,4190,271,5,629,521,108,41513,34806,6707,241,188,53,94.81605351
ec8ec97dd8c1ae10d02e283977946918a39c77e8,0,0,0,0,0,0,0,0,0,0,0,0,0,0,272,6,0,0,0,0,0,0,0,0,0,100
0281d840b24558401c0efa58860b5125f0d8f8de,0,0,0,0,0,0,0,0,0,0,0,0,0,0,273,7,0,0,0,0,0,0,0,0,0,100
5406e2d9a1e3ebc92c2ed9a67a218155007521f6,34,623,2272,1649,0,0,0,2,10,15,2,11,3.448749347,5063,5,5,521,629,108,34853,41513,6660,188,241,53,94.81605351
44ec302d8765e72148545ccfcdabc9c485f3daff,1,0,1,1,0,0,0,3,11,0,1,1,0,50,6,6,7,7,0,373,388,15,5,5,0,100
30806a083dfcf301a6cdc041f15c28d1239499ba,34,2268,614,1654,3,0,3,2,13,53,2,11,3.436302709,4193,274,8,629,521,108,41545,34838,6707,241,188,53,94.81605351
d7157acf35bed02baf38349c28aa4b993e9a0ce7,0,0,0,0,0,0,0,0,0,0,0,0,0,0,275,8,0,0,0,0,0,0,0,0,0,100
ee2dfe33501c020167d9647b31c26f064bfa6afd,0,0,0,0,0,0,0,0,0,0,0,0,0,0,276,9,0,0,0,0,0,0,0,0,0,100
96fd5cdf091b574803446d74db2764fb4dfd2014,35,627,2275,1648,0,0,0,2,11,16,2,12,3.470381087,5145,7,7,544,651,107,35600,42278,6678,194,247,53,94.81605351
7df1bbebda2ac89f34b6b16205bc06e21352b6db,35,2274,626,1648,3,0,3,2,13,53,2,12,3.469409165,4276,277,8,651,544,107,42278,35600,6678,247,194,53,94.81605351
511d0ce1b200624a42bb187c1055d11424f8cb95,0,0,0,0,0,0,0,0,0,0,0,0,0,0,278,9,0,0,0,0,0,0,0,0,0,100
b99846fce0ad08d6aab6b8f44fc4cd16a8457f9a,0,0,0,0,0,0,0,0,0,0,0,0,0,0,279,10,0,0,0,0,0,0,0,0,0,100
15522118c7a44e315a309cd93147ddc9d2dd1d70,0,0,0,0,0,0,0,0,0,0,0,0,0,0,280,11,0,0,0,0,0,0,0,0,0,100
96baa98e21c090d6689d2def88695ec035d5b866,36,643,2275,1632,0,0,0,2,11,19,2,12,3.500424215,5162,8,8,548,653,105,35889,42422,6533,197,249,52,94.81605351
d1078424544b0bc8e25c81d5b423b018ccb6950d,1,9,0,9,0,0,0,4,5,50,1,1,0,146,9,9,20,20,0,976,976,0,9,9,0,100
18ce570579c3101473710b0a8771b543df03eb10,4,43,31,12,0,0,0,3,10,62,1,2,1.59581219,281,10,10,54,54,0,2372,2273,99,24,24,0,100
e8188b1a3af9726fca9a1eb425d2713e594e8394,39,2301,690,1611,3,0,3,2,13,53,2,12,3.617607584,4510,14,0,684,579,105,43933,37499,6434,267,215,52,94.81605351
569fd8f1b2d3850866018465d214f6f0b5b8a7f5,40,696,2367,1671,0,0,0,2,11,19,2,12,3.664133169,5380,11,11,572,688,116,37450,44067,6617,208,271,63,94.45378151
4b7573774086ace85a8750e7b381bfce97dd48f4,5,335,16,319,3,0,3,3,12,6,1,3,2.035796566,195,12,12,65,27,38,2943,1349,1594,48,14,34,95.62289562
02c2c5a2f71ed301205d926fe8042b5fdecab363,1,95,67,28,0,0,0,1,2,0,1,1,0,89,13,13,24,24,0,624,624,0,23,23,0,100
c62bef3ffa5fcc78b4e712ff1016b1ef542f249b,43,2381,1057,1324,4,0,4,2,13,41,2,13,3.944346495,4699,281,12,688,610,78,44067,39044,5023,271,242,29,96.36363636
8058cc7dcd652843e5dcd555c61730189c261519,43,1063,2383,1320,3,0,3,2,12,15,2,13,3.947979087,5380,14,14,609,688,79,39038,44067,5029,242,271,29,96.36363636
e93b3cedc28e7d0d4641e5cba756c5aabf4cbfc3,3,65,62,3,0,0,0,3,9,27,1,3,0.609171389,334,15,8,46,46,0,2476,2460,16,24,24,0,100
8825f7010e1898e05da18f1f99670fcb4f734c88,1,75,91,16,0,0,0,4,9,0,1,1,0,165,16,9,21,23,2,1166,1136,30,9,11,2,100
f7c5dba844f466847ba29d7464a5ada040d14d9e,3,15,23,8,1,0,1,3,8,54,1,2,1.377963039,62,17,0,10,11,1,372,453,81,8,9,1,98.16666667
7c8330b2e3d95fcb156c11d7605ae807f6e108ff,1,1,3,2,0,0,0,4,10,54,1,1,0,169,18,1,21,21,0,1147,1166,19,9,9,0,98.67109635
61955fb38d1c082da93f00f6c5a58b708d157c3a,3,594,4,590,1,0,1,1,4,52,1,2,1.105896959,235,22,0,70,23,47,5865,2314,3551,31,9,22,98.53658537
41c8509e03ac432659a28fb994bda499b77afae0,45,2406,1653,753,4,0,4,0,13,32,2,13,4.149775735,5104,0,0,688,653,35,44067,42535,1532,271,261,10,95.11400651
00bc1787dc23abb41826a5ba7b144bcdb0798662,21,340,641,301,0,0,0,2,8,193,1,7,3.776255689,2565,1,1,350,357,7,19232,20991,1759,198,195,3,100
7a5d893bc2f2573e41c1ec5162c607b9698a5219,65,2310,2745,435,5,0,5,1,12,25,2,19,4.780574442,7274,19,2,968,993,25,60221,59942,279,438,451,13,95.11400651
952d1d61a9271b08749d00b9d17ea4eb74cead8f,40,4031,613,3418,11,0,11,1,10,52,2,11,4.15315244,4201,280,0,779,508,271,50888,35631,15257,299,172,127,93.73177843
cc2721c5e02f9c30ea191688f5ec21f102ff994c,1,23,6,17,0,0,0,2,2,2,1,1,0,229,281,1,25,22,3,2320,2268,52,9,9,0,100
b76451bac5b9cfa8e71f7084eff7855531e71fc3,8,0,1856,1856,0,0,0,1,2,0,1,1,2.99599342,1276,282,2,0,166,166,0,8650,8650,0,74,74,96.0755814
92e350ea9421dda9cd8721dcf0aed41b76ab5b3f,0,0,0,0,0,0,0,0,0,0,0,0,0,0,285,3,0,0,0,0,0,0,0,0,0,100
ca836977d301229c4647bdcbff190cb91fe02aaf,0,0,0,0,0,0,0,0,0,0,0,0,0,0,286,4,0,0,0,0,0,0,0,0,0,100
56bd922ae5cd6ff8535389a1b28ce93457b01f27,21,340,641,301,0,0,0,2,8,193,1,7,3.776255689,2565,287,5,350,357,7,19232,20991,1759,198,195,3,100
59e0436071e05303948bde7c669a1feae86aaf6b,7,96,822,726,0,0,0,2,6,197,1,4,0.90772759,946,2,2,98,154,56,4010,7823,3813,25,42,17,99.36204147
7f24e8b278f696b8e295f1e5135884fdbcd9dd99,0,0,0,0,0,0,0,0,0,0,0,0,0,0,288,6,0,0,0,0,0,0,0,0,0,100
fa9ce4b78197eb91000c089ad1df84bdeff2b4a0,0,0,0,0,0,0,0,0,0,0,0,0,0,0,289,7,0,0,0,0,0,0,0,0,0,100
b12e0aef1a2ae6d2a9771003ed8c426828b35cc6,3,58,32,26,0,0,0,1,9,154,1,3,1.403852238,423,290,8,51,48,3,3230,3131,99,26,24,2,100
7fb9778a4fb0e9abb22f1b2615b40b3a281298bc,0,0,0,0,0,0,0,0,0,0,0,0,0,0,291,9,0,0,0,0,0,0,0,0,0,100
645cade177b27790b814078374beab5057c74d30,11,570,392,178,4,0,4,1,9,58,1,6,2.96757706,841,3,3,156,137,19,8413,7265,1148,73,47,26,97.78830964
699765f870a11ed8edcafa37055e4ea0c0f47584,1,39,7,32,0,0,0,2,8,0,1,1,0,237,4,4,44,44,0,2405,2405,0,20,20,0,100
16c5b031b44e7f9de1bd10477575acaf1dc46608,5,359,673,314,1,0,1,2,6,135,1,1,2.246932275,638,5,5,65,81,16,3443,5587,2144,57,37,20,98.64661654
7a8ab91d729357ed83e8c6c6fa0cc0a687982b95,3,58,32,26,0,0,0,1,11,154,1,3,1.403852238,422,292,10,51,48,3,3219,3120,99,26,24,2,100
d373bf82fb833ca6fbe18932db7a834d286da8ba,0,0,0,0,0,0,0,0,0,0,0,0,0,0,293,11,0,0,0,0,0,0,0,0,0,100
b227d494d01cfd8ebb4a30bcf258165e4207084d,2,29,11,18,0,0,0,2,2,252,1,2,0.992774454,78,6,4,18,21,3,554,484,70,10,9,1,100
b877b7ae9d9bbc597fc27475c9d4099e2db1ce66,7,42,70,28,0,0,0,1,9,19,1,4,2.65300206,515,6,4,99,96,3,4271,4365,94,39,40,1,100
d455b33c0d17e2d414db116b346f54b0c749cb54,11,334,451,117,0,0,0,2,8,119,1,5,2.270913704,1149,6,3,193,203,10,8419,9318,899,74,71,3,100
c3407a4403fd462fef7c394c984fdf720a77f8fc,9,488,352,136,0,0,0,2,12,34,1,6,2.354643686,1032,6,2,179,166,13,8830,7827,1003,69,70,1,100
a6e56334fee3010ed613539f388ed799d218ab0f,12,151,430,279,0,0,0,1,11,80,1,6,3.128721819,1172,7,2,138,175,37,8403,9954,1551,63,73,10,98.5380117
e8d8ac0bcf3b01274b3d3eb2d9d19eb4bf4ad49b,11,393,105,288,3,0,3,1,8,107,1,6,2.906718993,651,294,0,139,108,31,7209,5668,1541,55,46,9,98.5380117
0e13e77bd8aa20fcdd60e5ed61368b12d1fa3d06,5,31,41,10,0,0,0,2,9,25,1,2,2.112683683,428,295,1,78,78,0,3787,3811,24,30,30,0,100
9b5e719c3405ba23c064d3f818542a65f7da1a65,3,67,58,9,0,0,0,2,12,37,1,3,1.448832367,436,296,2,54,51,3,3299,3219,80,28,26,2,100
e398e375b5364bbf7723faef94fe48481f0a0717,5,63,323,260,0,0,0,2,10,86,1,4,2.197163295,542,297,3,53,87,34,3810,5257,1447,27,35,8,98.5380117
f82a7b3371dcdb4d26d755784a1c2e5795efe8a8,5,47,184,137,0,0,0,2,13,68,1,2,2.282217875,488,10,4,48,56,8,2927,3443,516,25,27,2,98.78787879
6417e9a03f991483421f5d41bb584de8887bf846,4,268,170,98,2,0,2,1,7,92,1,1,1.965888565,322,11,5,41,38,3,3218,2414,804,27,21,6,99.23076923
4ac319c6a7689b774fc675fdfa44560c60479c1f,0,0,0,0,0,0,0,0,0,0,0,0,0,0,298,4,0,0,0,0,0,0,0,0,0,100
2098461a08361f3aa5383fb1dfde601951dd6c0d,6,293,420,127,0,0,0,2,5,185,1,3,1.800055307,729,299,5,111,121,10,4603,5526,923,44,41,3,100
b62e29d97b64eae920701c647d2480536ef95d89,5,88,208,120,0,0,0,2,14,180,1,2,1.602686039,712,13,7,82,103,21,4556,5448,892,41,40,1,100
2ea3e8f2fd9b59c1b4917c7eb9aa812477826f9d,0,0,0,0,0,0,0,0,0,0,0,0,0,0,300,6,0,0,0,0,0,0,0,0,0,100
e09e0b878e6e1d6489f681649b729bdb5dbe8ce9,25,965,471,494,6,0,6,1,15,42,1,9,4.262877038,2021,14,8,396,307,89,17974,15052,2922,221,166,55,95.26717557
669d586f8b6a3b128fc48f268489d2f537dae88c,28,743,1074,331,1,0,1,0,14,87,1,11,4.323523857,2948,14,6,421,488,67,20371,22445,2074,216,266,50,95.26717557
50aed927c63d53ea98ca0b094dfdd0aad0423b65,0,0,0,0,0,0,0,0,0,0,0,0,0,0,301,7,0,0,0,0,0,0,0,0,0,100
f0a80dfc904d2dc9244e98bee074c4f624035dfd,2,131,24,107,1,0,1,1,15,3,1,2,0.97799981,411,15,7,59,48,11,3729,2980,749,33,25,8,99.6969697
d8fde4f65bb96a7a2b92697a43af5c0b561dafaa,0,0,0,0,0,0,0,0,0,0,0,0,0,0,302,8,0,0,0,0,0,0,0,0,0,100
92891a00bc230fdd74cdf6c8b74bcfd2a575ba3f,25,965,471,494,6,0,6,1,17,42,1,9,4.262877038,2056,303,9,404,315,89,18155,15233,2922,226,171,55,95.31013616
a79ae1110b56a787d1b9d104c5dc3ee88db47253,1,19,5,14,0,0,0,2,18,14,1,1,0,447,17,6,59,56,3,3203,3145,58,32,31,1,100
419a7b9d2c24f1bac07720a28c06fce7b27c2c32,2,5,63,58,0,0,0,2,17,50,1,2,0.936667382,491,17,6,56,65,9,3145,3402,257,31,36,5,99.69512195
395b79e71b503366bb25bba5af67500b492f426f,2,63,5,58,1,0,1,2,18,113,1,2,0.936667382,447,304,10,65,56,9,3402,3145,257,36,31,5,99.69512195
ef7c9b179ad6e33286b16b984f9a031cbc9bed64,1,0,44,44,0,0,0,2,3,101,1,1,0,32,305,11,0,6,6,0,199,199,0,4,4,99.69512195
a457b34ddc028b63f1a39ea24a7f13ad8996ed3d,6,388,1722,1334,1,0,1,1,17,96,1,6,0.951028604,1774,17,6,103,262,159,7152,17163,10011,62,80,18,98.92473118
ec6f1b30944e14b4215f7a9e2fddce4978e5462e,2,19,49,30,0,0,0,2,18,57,1,2,0.936667382,479,306,12,59,62,3,3203,3344,141,32,35,3,99.69040248
789cd5a79f5c07ab8118bee306b38498296abbbc,5,1713,350,1363,2,0,2,1,7,71,1,5,0.81367799,546,19,8,227,65,162,15751,5591,10160,60,39,21,99.22958398
9d97ce9a99c627fa3d31eb04f1b6e701d22dd4f3,4,339,1703,1364,0,0,0,1,4,93,1,4,0.739223017,1315,307,13,41,203,162,3808,13960,10152,27,48,21,99.22958398
8aa27308b97688e1e512257888a106cd57582e8e,17,323,159,164,0,0,0,2,12,50,1,10,1.688769167,1755,308,14,245,246,1,15699,15761,62,141,142,1,100
46d3ae9bc91081fdf366c2d2f69738a7c9533cfd,1,12,12,0,0,0,0,2,5,0,1,1,0,132,309,15,23,23,0,917,917,0,6,6,0,100
132b827f712d44584bdadbc60cbb6b210cafdd60,0,0,0,0,0,0,0,0,0,0,0,0,0,0,310,16,0,0,0,0,0,0,0,0,0,100
5e5f95864e1c026e46e920b0edc95a6e7450b1e9,25,164,791,627,1,0,1,2,8,132,1,9,3.11935936,2703,311,17,301,359,58,19392,21827,2435,177,186,9,97.6635514
d5ad818539f694c575ab8baa153f902cd23a2b47,0,0,0,0,0,0,0,0,0,0,0,0,0,0,312,18,0,0,0,0,0,0,0,0,0,100
14ad2a4912c2036c0b32c9178e8b0fc0c9910f59,30,0,0,0,0,0,0,1,1,0,1,7,0,3679,313,19,437,270,167,30161,59160,28999,179,270,91,81.87311178
8cccd607e11d631eb29c3d211a3c13b7a0e0d4f2,5,187,212,25,2,0,2,2,19,2,1,3,1.784487301,615,314,20,64,67,3,4622,4781,159,41,40,1,97.25036179
d4c0ca86a5b2960bbb9c4d9c175f2afa633620b4,0,0,0,0,0,0,0,0,0,0,0,0,0,0,315,21,0,0,0,0,0,0,0,0,0,100
c95d7e7da686ef0f809055d61554eaa802737fa0,0,0,0,0,0,0,0,0,0,0,0,0,0,0,316,22,0,0,0,0,0,0,0,0,0,100
44a46f25f178d8c2be6a707827a0833c760092f6,27,861,669,192,6,0,6,2,13,124,1,9,4.166959631,2027,21,7,350,308,42,18877,17029,1848,170,141,29,92.41982507
bcae36159b31848df7c82a8bb4165ed02ef42ade,0,0,0,0,0,0,0,0,0,0,0,0,0,0,317,16,0,0,0,0,0,0,0,0,0,100
957aa12cfc3007ae8655d906fc450b5e5a035998,3,14,4,10,0,0,0,1,8,119,1,2,1.541982284,306,22,7,33,33,0,2693,2572,121,16,16,0,95.44159544
e0496ef5b2c9b921be27f642f606a4423a0da00b,0,0,0,0,0,0,0,0,0,0,0,0,0,0,318,17,0,0,0,0,0,0,0,0,0,100
878f7e05f7f8cfb3ca85e277a35b593c8275c394,0,0,0,0,0,0,0,0,0,0,0,0,0,0,319,17,0,0,0,0,0,0,0,0,0,100
c0a1dba48a01af30caddb1a05cb8669d3078e701,0,0,0,0,0,0,0,0,0,0,0,0,0,0,320,16,0,0,0,0,0,0,0,0,0,100
3cbffdaef44755b1a7c54b484f48170292d8f059,2,44,1,43,1,0,1,1,4,34,1,2,0.503258335,28,23,3,7,5,2,437,209,228,4,3,1,99.45429741
27d55f672ad590a7bbb0f2ecaaee096b79830c7c,6,99,51,48,0,0,0,0,14,81,1,5,2.321545806,442,23,0,78,73,5,4039,3823,216,40,37,3,99.45429741
50e83cb7e84bc7879d6ff63129bc44fbcad9265e,2,12,20,8,0,0,0,4,7,4,1,2,0.997180399,277,24,1,40,40,0,2409,2425,16,20,21,1,100
6d5469ed13e05ffb06734caf759e1d5181b67712,6,52,92,40,1,0,1,1,13,88,1,5,2.138670498,467,321,4,73,78,5,3823,4023,200,37,39,2,99.45429741
20229c4b50b8252f6fd942aadce9b88f390fd521,6,94,54,40,0,0,0,0,15,11,1,5,2.162566809,442,25,2,78,73,5,4026,3823,203,39,37,2,99.45429741
f85f05e48ba028f387cdb6324e75ac2eea364d1a,2,44,1,43,1,0,1,1,4,34,1,2,0.503258335,28,322,5,7,5,2,437,209,228,4,3,1,99.45429741
c1c8e4f7267ed966869e17419a15ff13c594c1fe,16,226,251,25,3,0,3,0,13,61,1,9,3.421691458,1286,23,0,210,205,5,10637,10569,68,125,126,1,98.37398374
013d90a4ea82650bcbb0c4b7cd9fe83cb8eec423,22,492,747,255,2,0,2,1,15,78,1,11,3.806902542,1901,24,0,265,303,38,13173,15356,2183,150,140,10,98.37398374
30edf05a7e7ba58d3ccb66f7807ef5016c5c0e93,16,899,254,645,2,0,2,2,20,117,1,6,3.085578435,1552,24,0,313,219,94,16625,12562,4063,162,143,19,98.92037787
bdc6a34334d1b78982893fd54716654fcbf7783e,16,228,492,264,3,0,3,2,19,32,1,7,3.009848851,1836,323,2,229,276,47,13821,15042,1221,146,171,25,97.85522788
e5def8984449892c0cb14bf33015f94ae9d77e59,6,240,520,280,0,0,0,2,7,262,1,2,2.483271655,598,324,3,60,93,33,2604,4719,2115,24,15,9,100
e646c2eee45ce65b818605b0d177536ea03b903a,10,378,13,365,2,0,2,2,20,65,1,4,1.533807485,1205,325,3,220,159,61,11978,10030,1948,147,119,28,98.93475366
bdd9f9fee8e526418b27dcdf8cc43320e654118a,2,36,3,33,0,0,0,2,14,12,1,2,0.961236605,364,27,3,55,55,0,3361,3122,239,22,22,0,100
1aab76e9109e80a8b9f2e14618f1c8ed633d26f2,0,0,0,0,0,0,0,0,0,0,0,0,0,0,326,3,0,0,0,0,0,0,0,0,0,100
3292919873ec2ada5bf178fbfbbb0e68b319b261,0,0,0,0,0,0,0,0,0,0,0,0,0,0,15,0,0,0,0,0,0,0,0,0,0,100
d627617fdd7ec93e6cb87e9d0cdcf51c30ba3e78,0,0,0,0,0,0,0,0,0,0,0,0,0,0,327,4,0,0,0,0,0,0,0,0,0,100
034ce86b2a4799124286e5ddbfd9817ca13c0927,0,0,0,0,0,0,0,0,0,0,0,0,0,0,328,5,0,0,0,0,0,0,0,0,0,100
292a134661a0f041dff40d01dc102d19369216d3,1,1,1,0,0,0,0,2,4,43,1,1,0,77,329,6,13,13,0,636,637,1,7,7,0,100
4f477ad4701a57aa08f641ea3f1e2ff2d3a98883,1,4,4,0,0,0,0,2,5,0,1,1,0,77,330,7,13,13,0,636,636,0,7,7,0,100
ea72f9bcba03a3a6e3721d6a342d075f81c0194b,9,176,66,110,1,0,1,2,8,96,1,4,2.944235053,535,331,8,101,94,7,4511,4143,368,49,43,6,99.73614776
4ea17ccc907f67be7e5787b9bdf16a6c510f13b4,1,1,1,0,0,0,0,2,3,0,1,1,0,29,332,9,1,1,0,272,272,0,1,1,0,100
df8eb0a543f28729b464b9e439d011ad68eea284,0,0,0,0,0,0,0,0,0,0,0,0,0,0,333,10,0,0,0,0,0,0,0,0,0,100
146673508e4c8b85959031c371f5428da5dc4c9d,4,86,12,74,0,0,0,1,6,124,1,2,1.474010158,110,333,10,24,16,8,1244,859,385,10,8,2,100
2c9f030fa20ae71b5f6c8e26650e05bfe60bf79e,0,0,0,0,0,0,0,0,0,0,0,0,0,0,335,12,0,0,0,0,0,0,0,0,0,100
6a1afeefa9924aed0a9cf80623aa0cec8791ae4e,1,38,0,38,0,0,0,2,15,34,1,1,0,218,334,11,36,28,8,2610,2144,466,24,16,8,100
af387187593efa37aa2296486e8b712aa4eab5ee,0,0,0,0,0,0,0,0,0,0,0,0,0,0,337,14,0,0,0,0,0,0,0,0,0,100
84cb2a5d063853501f21360553eceb0b84a6072e,1,147,0,147,1,0,1,1,1,0,1,1,0,0,335,12,8,0,8,1124,0,1124,8,0,8,94.68223087
31537ffb743813aaddb50db868b792fd387c1d6e,0,0,0,0,0,0,0,0,0,0,0,0,0,0,339,16,0,0,0,0,0,0,0,0,0,100
8f4c467e594594d64c2234f85155cdb1a6286204,0,0,0,0,0,0,0,0,0,0,0,0,0,0,336,13,0,0,0,0,0,0,0,0,0,100
bf9ab33191e119187a7c85b84cdfcfd985643cb3,0,0,0,0,0,0,0,0,0,0,0,0,0,0,341,18,0,0,0,0,0,0,0,0,0,100
458c6c31aab0599cf03c22207bf36c5a767d0e9c,1,5,10,5,0,0,0,1,2,0,1,1,0,129,337,14,8,8,0,1084,1124,40,8,8,0,100
0b0c343789ce6584ef8554666efbda7070dfa8dd,0,0,0,0,0,0,0,0,0,0,0,0,0,0,343,20,0,0,0,0,0,0,0,0,0,100
56bab6a71b332d848ab7dbe9805fb039a469a211,0,0,0,0,0,0,0,0,0,0,0,0,0,0,338,15,0,0,0,0,0,0,0,0,0,100
cd369e244cfe9f1d7836f7fd94280a1a7b89e5c4,0,0,0,0,0,0,0,0,0,0,0,0,0,0,345,22,0,0,0,0,0,0,0,0,0,100
d03bc935269901990d10c8289c19ad196a043361,2,85,18,67,0,0,0,1,16,4,2,2,0.933633772,372,339,13,46,44,2,4230,3694,536,34,32,2,95.24438573
4a81de5fa96fe1d97c7d6552536cc888984e8d5e,1,0,4,4,0,0,0,2,17,0,1,1,0,248,340,14,36,36,0,2574,2574,0,24,24,0,100
303784da79174b338236d88e8ecb198a5f09d3ae,0,0,0,0,0,0,0,0,0,0,0,0,0,0,341,15,0,0,0,0,0,0,0,0,0,100
978cee399a192f1ba04cc15c74e448d78dd5a7b2,0,0,0,0,0,0,0,0,0,0,0,0,0,0,349,23,0,0,0,0,0,0,0,0,0,100
459099edf747b8dec14d163d6b3dbc149c364ab9,15,284,42,242,3,0,3,1,18,70,2,8,2.578033344,1220,342,7,197,172,25,10794,10019,775,133,113,20,97.42895805
c01f128d40fb85801757022f788a3c3151740834,0,0,0,0,0,0,0,0,0,0,0,0,0,0,351,13,0,0,0,0,0,0,0,0,0,100
4cc442b3556659ada93710daeb856a69775bc239,1,14,16,2,0,0,0,1,2,0,1,1,0,171,343,8,10,10,0,1624,1641,17,10,10,0,100
1aca8de4bca940b0951b5656eae124144ba1d51d,0,0,0,0,0,0,0,0,0,0,0,0,0,0,353,15,0,0,0,0,0,0,0,0,0,100
4cb2abcb6ed9cf53cb124aed01c97d9f8cd1c052,0,0,0,0,0,0,0,0,0,0,0,0,0,0,344,9,0,0,0,0,0,0,0,0,0,100
ca37b7c8221578a1b502b07607c63f8a1844b6a8,0,0,0,0,0,0,0,0,0,0,0,0,0,0,355,17,0,0,0,0,0,0,0,0,0,100
6efe889b3e09345b2096b92a3746cc144e69f556,31,247,247,0,0,0,0,1,4,6,2,8,4.282256895,3960,345,10,495,328,167,31933,60932,28999,201,292,91,83.42541436
aa9d1a53893799b21b41f416c6d3d343e1318481,0,0,0,0,0,0,0,0,0,0,0,0,0,0,357,19,0,0,0,0,0,0,0,0,0,100
d4e0a6942148c3944beb84d76866dbdaeeab2093,0,0,0,0,0,0,0,0,0,0,0,0,0,0,346,11,0,0,0,0,0,0,0,0,0,100
fdc40b0bb87be820bf671b26514b770b852c63da,0,0,0,0,0,0,0,0,0,0,0,0,0,0,359,21,0,0,0,0,0,0,0,0,0,100
74bdfd7d8f8886423a3e9a8c50e0df54a321200c,0,0,0,0,0,0,0,0,0,0,0,0,0,0,360,14,0,0,0,0,0,0,0,0,0,100
e999455959e54f4d90a6e0f86ddd5ac94f98ce05,1,1,1,0,0,0,0,3,8,165,1,1,0,56,347,5,9,9,0,453,453,0,2,2,0,100
0cf86e25e4f63d1ddd677b5f9b199423815c3b8c,0,0,0,0,0,0,0,0,0,0,0,0,0,0,348,6,0,0,0,0,0,0,0,0,0,100
ee3028f2c39a1d486144083cdddc8406a5d749d2,0,0,0,0,0,0,0,0,0,0,0,0,0,0,349,7,0,0,0,0,0,0,0,0,0,100
518a74670ce2bfd454d7a0e0ad81f384d722d6de,0,0,0,0,0,0,0,0,0,0,0,0,0,0,364,14,0,0,0,0,0,0,0,0,0,100
08c0fb4aa565e03f60ff77d3686ac56a4f934a85,1,1,1,0,0,0,0,1,3,8,1,1,0,169,350,8,10,10,0,1625,1624,1,10,10,0,100
2f8c05b4c106535cb5dc3dc38792907d6523beb8,0,0,0,0,0,0,0,0,0,0,0,0,0,0,366,16,0,0,0,0,0,0,0,0,0,100
2332b5810d5829b5496d01744c14296f8d6d6423,0,0,0,0,0,0,0,0,0,0,0,0,0,0,367,17,0,0,0,0,0,0,0,0,0,100
d292d3b12545e7044fd21aa244f173c87596fa86,0,0,0,0,0,0,0,0,0,0,0,0,0,0,0,0,0,0,0,0,0,0,0,0,0,100
e3e5bed2a0644c80137b585f2d23026868d2c57f,0,0,0,0,0,0,0,0,0,0,0,0,0,0,368,18,0,0,0,0,0,0,0,0,0,100
2f54cda2569e71967283425626660c922ffce61f,0,0,0,0,0,0,0,0,0,0,0,0,0,0,369,9,0,0,0,0,0,0,0,0,0,100
7e2ab57198a36f85b1e52fc1e843496570914234,1,17,10,7,0,0,0,2,2,233,1,1,0,124,26,0,28,26,2,991,950,41,9,9,0,100
1d59195f216145876a61db1932ff2b2cdb8172df,2,239,0,239,2,0,2,1,1,0,1,2,0.867039835,0,27,1,32,0,32,1477,0,1477,12,0,12,99.29278642
77a61aae80a28bd5ff64d14417dfab1323aa6bd5,2,199,67,132,0,0,0,1,2,0,1,2,0.763448826,188,28,2,54,32,22,2387,1477,910,17,12,5,100
d04db5e334a72cea488016fbff30bd37020221f6,1,133,48,85,0,0,0,1,3,3,1,1,0,74,29,3,18,6,12,1285,660,625,10,4,6,100
dcf7a29f145309d4b3f2fbbd8305900d6b49db5c,3,10,473,463,0,0,0,0,1,0,1,2,1.237037279,496,370,1,26,94,68,950,4003,3053,9,32,23,99.29278642
de414e7191ff80b28182ee6573b20c39e295719f,3,474,11,463,2,0,2,1,3,5,1,2,1.248892029,124,30,4,94,26,68,4003,950,3053,32,9,23,99.29278642
ec8f5739ba60b32cba90fa39b447fe7521e030ba,1,8,0,8,0,0,0,1,3,11,1,1,0,224,31,5,48,48,0,1727,1727,0,13,13,0,100
28751f1589c48d199d0e03aab30c0456724ab575,1,2,2,0,0,0,0,1,4,8,1,1,0,141,32,6,18,18,0,1289,1285,4,10,10,0,100
aa6d158b0ccf369b384e3feff6e72f78142084b6,1,6,9,3,0,0,0,3,5,86,1,1,0,33,33,7,1,1,0,285,316,31,1,1,0,99.57865169
ce8625c23c08743931bb2edb91674157f8a86ff5,0,0,0,0,0,0,0,0,0,0,0,0,0,0,34,8,0,0,0,0,0,0,0,0,0,100
77038be7ffb063947e06a4f10cfbfc46e08ddc6b,0,0,0,0,0,0,0,0,0,0,0,0,0,0,370,0,0,0,0,0,0,0,0,0,0,100
e12fa95a23e73c905841312721cddf144b252e4f,0,0,0,0,0,0,0,0,0,0,0,0,0,0,372,2,0,0,0,0,0,0,0,0,0,100
bc1f880543123bc4fb6e2fb443a44ba109f288b8,10,350,391,41,4,0,4,1,2,48,1,4,3.038164722,679,373,3,52,42,10,5866,6439,573,48,40,8,98.88888889
877e6d2f81b319c52744aad12562c13d05bbf6c4,0,0,0,0,0,0,0,0,0,0,0,0,0,0,374,4,0,0,0,0,0,0,0,0,0,100
d2c379e57f807a6328d903ed9a8034048d8d4fd7,0,0,0,0,0,0,0,0,0,0,0,0,0,0,375,5,0,0,0,0,0,0,0,0,0,100
b1dfe2a6c23fe46af119972572a3aed39e6d6b6b,0,0,0,0,0,0,0,0,0,0,0,0,0,0,376,6,0,0,0,0,0,0,0,0,0,100
0248f63d0060b40d69efdb1e240f74ca92ba9a57,2,19,0,19,0,0,0,1,3,44,1,2,0.981940787,114,377,1,20,18,2,561,493,68,18,16,2,100
c40a4c2c89c69b8428906f71a700a09934a80294,0,0,0,0,0,0,0,0,0,0,0,0,0,0,0,0,0,0,0,0,0,0,0,0,0,100
8384a2a9f7c4e1ec128ee6b9971f164cf9e89028,0,0,0,0,0,0,0,0,0,0,0,0,0,0,378,1,0,0,0,0,0,0,0,0,0,100
90602796a5855f4aa8f34eb4db29d4a9046f59b6,0,0,0,0,0,0,0,0,0,0,0,0,0,0,379,0,0,0,0,0,0,0,0,0,0,100
72a4ac20a6d29aecf6d19c9273b48796629d84fb,0,0,0,0,0,0,0,0,0,0,0,0,0,0,380,1,0,0,0,0,0,0,0,0,0,100
dd55fea5ee260fd09bb9b945e8b8a0514044a193,0,0,0,0,0,0,0,0,0,0,0,0,0,0,381,2,0,0,0,0,0,0,0,0,0,100
e0da0c4934a8dca339434a4e472fec3513e3fe5c,1,3,2,1,0,0,0,3,10,565,1,1,0,110,381,2,19,17,2,949,928,21,7,7,0,100
3c6a3a17052cb994c15c7c480de01e0c5542b5b1,0,0,0,0,0,0,0,0,0,0,0,0,0,0,383,4,0,0,0,0,0,0,0,0,0,100
74c04e5a7de2604cc1462bdfce7ea58f8e2e90fa,0,0,0,0,0,0,0,0,0,0,0,0,0,0,382,0,0,0,0,0,0,0,0,0,0,100
004a2d9d54e27693fa65820996166a61842f85fd,0,0,0,0,0,0,0,0,0,0,0,0,0,0,385,1,0,0,0,0,0,0,0,0,0,100
35e57adeb239de84d900be7739ec284fbff2109c,0,0,0,0,0,0,0,0,0,0,0,0,0,0,386,2,0,0,0,0,0,0,0,0,0,100
34db06a139fb4813f37ccf5c8d3017cb7239dcc5,0,0,0,0,0,0,0,0,0,0,0,0,0,0,383,1,0,0,0,0,0,0,0,0,0,100
7b1213e0685c7b4649c752b74ee5adedfc2ad3d4,0,0,0,0,0,0,0,0,0,0,0,0,0,0,388,4,0,0,0,0,0,0,0,0,0,100
16f43cd6a9b95164bc0f650044be35bf35dd666d,0,0,0,0,0,0,0,0,0,0,0,0,0,0,384,2,0,0,0,0,0,0,0,0,0,100
8ca94c91d993496404e5e6551d06212e8c2433d0,0,0,0,0,0,0,0,0,0,0,0,0,0,0,390,6,0,0,0,0,0,0,0,0,0,100
0e13ad45389ffc6c3efc5bc00ad10ba1e271c900,0,0,0,0,0,0,0,0,0,0,0,0,0,0,391,7,0,0,0,0,0,0,0,0,0,100
7f57ffe02d0506cb86d32b60555495775516c481,0,0,0,0,0,0,0,0,0,0,0,0,0,0,392,8,0,0,0,0,0,0,0,0,0,100
08bb90a8eda4495d05466f5c30b0920cb04a4708,0,0,0,0,0,0,0,0,0,0,0,0,0,0,393,9,0,0,0,0,0,0,0,0,0,100
ab66a3dd7f4b39405c4637619300d4cd1d2043fd,0,0,0,0,0,0,0,0,0,0,0,0,0,0,394,10,0,0,0,0,0,0,0,0,0,100
7587dd5df45854c587bd036e54a6e3efa36cc588,0,0,0,0,0,0,0,0,0,0,0,0,0,0,385,0,0,0,0,0,0,0,0,0,0,100
23d334066197d1a465d3a22029bd01a9f6d67497,0,0,0,0,0,0,0,0,0,0,0,0,0,0,396,3,0,0,0,0,0,0,0,0,0,100
a178bd3ad0a2f0e117e5e71d54d38f2efe58e938,0,0,0,0,0,0,0,0,0,0,0,0,0,0,397,4,0,0,0,0,0,0,0,0,0,100
24e68142235ef45f121e0b62e869fcf181b9b338,0,0,0,0,0,0,0,0,0,0,0,0,0,0,398,5,0,0,0,0,0,0,0,0,0,100
c1a836ff58a0ebf411b74c806993ff78eb2b7d80,160,15369,9907,5462,0,0,0,1,21,344,3,36,6.769092486,14169,399,6,2027,2027,0,115902,115497,405,1074,1074,0,99.32249322
80898a15693364bf81a21907ca0e765e44dbedff,160,9849,15311,5462,0,0,0,1,22,0,3,36,6.775380756,19800,400,7,2027,2027,0,115497,115902,405,1074,1074,0,99.32249322
757c925aa6a0f8d25de2163f8de89a206bfc79c2,160,11610,9188,2422,0,0,0,1,23,0,3,36,6.516508149,14169,401,8,2027,2027,0,115902,115497,405,1074,1074,0,99.32249322
bc2feba380fe2426c736ae522ff441803e2e8f98,160,3759,719,3040,0,0,0,1,24,0,3,36,7.311030025,15800,402,9,2027,2027,0,115902,115902,0,1074,1074,0,100
fcd3fd87d519603656fbf1755f40be388915a7af,3,53,0,53,0,0,0,2,11,3,2,3,1.300060183,422,0,0,44,39,5,3051,2686,365,27,24,3,100
3111e351cb31406fbadac61c4a7dea6e437d1479,0,0,0,0,0,0,0,0,0,0,0,0,0,0,403,10,0,0,0,0,0,0,0,0,0,100
e6371442de591d413f5ad372ca098d8b04bf7cc6,0,0,0,0,0,0,0,0,0,0,0,0,0,0,404,11,0,0,0,0,0,0,0,0,0,100
8ed8845014a5441c84189bcf8c8e8ee0c8932ec3,0,0,0,0,0,0,0,0,0,0,0,0,0,0,405,12,0,0,0,0,0,0,0,0,0,100
40793385fd5489d911260efb1f7652a485f4dd8a,0,0,0,0,0,0,0,0,0,0,0,0,0,0,406,13,0,0,0,0,0,0,0,0,0,100
ef5b733fbb694a7f88e69c2636e504b61512a752,0,0,0,0,0,0,0,0,0,0,0,0,0,0,407,14,0,0,0,0,0,0,0,0,0,100
6730e1b19692c3f6ca9b86dd844fd233d88a3074,0,0,0,0,0,0,0,0,0,0,0,0,0,0,408,15,0,0,0,0,0,0,0,0,0,100
941e4925279e95daceb9c49a92fb0ad7c24b74b9,0,0,0,0,0,0,0,0,0,0,0,0,0,0,409,16,0,0,0,0,0,0,0,0,0,100
77af9ba7a1809f3073e3395fc335d42a5887309d,0,0,0,0,0,0,0,0,0,0,0,0,0,0,410,17,0,0,0,0,0,0,0,0,0,100
c73a7f338707dbf6541f9652afd96d15cf70de9c,0,0,0,0,0,0,0,0,0,0,0,0,0,0,411,16,0,0,0,0,0,0,0,0,0,100
3cc5bb3fb90aa9459679c9502e11cc99f853b329,0,0,0,0,0,0,0,0,0,0,0,0,0,0,412,17,0,0,0,0,0,0,0,0,0,100
b6fc737ed6912b10d430bcbee0003e2bdd8044bc,0,0,0,0,0,0,0,0,0,0,0,0,0,0,413,18,0,0,0,0,0,0,0,0,0,100
e5ca208b28bb61b8e62fa33053f546393673dae8,0,0,0,0,0,0,0,0,0,0,0,0,0,0,16,0,0,0,0,0,0,0,0,0,0,100
3b1d1f17e20aa7fe49d57dc23201fb80f2bdcbf4,0,0,0,0,0,0,0,0,0,0,0,0,0,0,17,1,0,0,0,0,0,0,0,0,0,100
000e8de91b2ec9f5ff7190e08a18c62c0722e32e,0,0,0,0,0,0,0,0,0,0,0,0,0,0,18,2,0,0,0,0,0,0,0,0,0,100
a02b49228c1df5f8dd4d99ae8c831771be3d431d,0,0,0,0,0,0,0,0,0,0,0,0,0,0,19,3,0,0,0,0,0,0,0,0,0,100
3cb739f683b75951c3df277e308eb0f13f7eeffa,0,0,0,0,0,0,0,0,0,0,0,0,0,0,414,19,0,0,0,0,0,0,0,0,0,100
f80cd8cabfbaa9241b3da7082f940808668a115c,0,0,0,0,0,0,0,0,0,0,0,0,0,0,415,1,0,0,0,0,0,0,0,0,0,100
d6371758fd06085ac9bc4e540094a8c3972ff492,0,0,0,0,0,0,0,0,0,0,0,0,0,0,416,2,0,0,0,0,0,0,0,0,0,100
fadccf2579e4bbe905b2c28d5d1162fdd72aa99c,0,0,0,0,0,0,0,0,0,0,0,0,0,0,417,3,0,0,0,0,0,0,0,0,0,100
24b503c7e0a5fe028c5f61a1f08664f1b464721e,0,0,0,0,0,0,0,0,0,0,0,0,0,0,418,4,0,0,0,0,0,0,0,0,0,100
c370c9eec818959b8d6d26c2d412b49baf58246f,0,0,0,0,0,0,0,0,0,0,0,0,0,0,419,5,0,0,0,0,0,0,0,0,0,100
f1cc7a4981760ac6dc58099856ad53289253840e,8,75,51,24,0,0,0,2,13,64,1,2,2.648201318,1449,420,6,190,182,8,10550,10208,342,169,161,8,100
9df59f340e057672cb99c3bfe807c8ad0d291488,11,240,93,147,0,0,0,2,14,42,1,4,2.857713852,1818,421,7,235,213,22,12898,12259,639,136,134,2,100
9db5ed559553a9603d23210048edfc2765dda7a4,11,93,240,147,0,0,0,2,15,0,1,4,2.857713852,1945,422,8,213,235,22,12259,12898,639,134,136,2,100
2bfa28ee955f42e3e8fe84de704835d0f5d0bac0,11,240,93,147,0,0,0,2,16,0,1,4,2.857713852,1818,423,9,235,213,22,12898,12259,639,136,134,2,100
407f8e078527708cee5b13a523ca990be19ce704,4,6,6,0,0,0,0,2,16,18,1,3,1.79248125,505,424,10,57,57,0,2846,2848,2,30,30,0,100
5ff0bfb018276a4e8fc11fb78b30b032ac279eec,2,5,5,0,0,0,0,1,9,72,1,1,0.970950594,269,425,11,21,21,0,1649,1661,12,9,9,0,100
87384442da19fc33ca25434bb35ffeda0b6115b7,0,0,0,0,0,0,0,0,0,0,0,0,0,0,426,12,0,0,0,0,0,0,0,0,0,100
468e4f9803d77d36966829bcc68f7c4ba64df09b,0,0,0,0,0,0,0,0,0,0,0,0,0,0,427,13,0,0,0,0,0,0,0,0,0,100
29ca7bbf467fb0784febc7f9cdc0cf8a76849318,0,0,0,0,0,0,0,0,0,0,0,0,0,0,428,14,0,0,0,0,0,0,0,0,0,100
7e8099ea153d82df8110ef7f8f8336006be415f0,0,0,0,0,0,0,0,0,0,0,0,0,0,0,429,15,0,0,0,0,0,0,0,0,0,100
acea34668d33ad13b2a67fa279f2b0831f10657e,0,0,0,0,0,0,0,0,0,0,0,0,0,0,430,16,0,0,0,0,0,0,0,0,0,100
5b727a8a7f19d1611f0d760f1608860bedc27281,0,0,0,0,0,0,0,0,0,0,0,0,0,0,431,17,0,0,0,0,0,0,0,0,0,100
b8ae5b8a9b9588c4a62eda5523bd34d5cde04209,1,1,0,1,0,0,0,4,14,1,1,1,0,252,432,18,26,26,0,1924,1918,6,11,11,0,100
f957e9b5a9c58a7f1960a39ee8da580ba1ea7c95,4,58,19,39,0,0,0,5,17,80,1,3,1.307538262,573,0,0,80,73,7,3598,3337,261,36,34,2,99.05149051
47f414b9fc1876400100c3a1a4db383bb9756f1d,12,96,156,60,0,0,0,2,17,48,1,4,2.89846111,1462,433,18,145,155,10,7766,7929,163,66,67,1,100
f62cb07cd1e30596c3c8ab9569f98f44e085e807,0,0,0,0,0,0,0,0,0,0,0,0,0,0,434,19,0,0,0,0,0,0,0,0,0,100
7cae474ddee099fb1ee13180dc0a2109256370a3,0,0,0,0,0,0,0,0,0,0,0,0,0,0,435,20,0,0,0,0,0,0,0,0,0,100
4e2982c59670dd4c49bf412d8ba637ad1f6df8ba,0,0,0,0,0,0,0,0,0,0,0,0,0,0,0,0,0,0,0,0,0,0,0,0,0,100
b2b6f1d7f0015d5c9d663a7b28d5e1bb1043c413,0,0,0,0,0,0,0,0,0,0,0,0,0,0,0,0,0,0,0,0,0,0,0,0,0,100
f0334dd9d0e1bc8fc5a9bcf96b762df0d1d8cae1,21,732,413,319,4,0,4,2,25,277,2,10,3.776237101,3271,436,0,402,369,33,23351,22400,951,254,244,10,97.72423025
10aba3567801b17d40874fcd04c10d236fcd0721,0,0,0,0,0,0,0,0,0,0,0,0,0,0,1,0,0,0,0,0,0,0,0,0,0,100
c79054e44b748cee95fe62ea2eda83ab16df33ad,2,2,29,27,0,0,0,1,8,464,1,2,0.99323382,952,437,0,126,126,0,5992,6069,77,29,29,0,100
dd29db8ecdb91771574040e5f64cab8c1b72735f,0,0,0,0,0,0,0,0,0,0,0,0,0,0,438,1,0,0,0,0,0,0,0,0,0,100
de05c0eed36237fd828c24375376403c86457022,0,0,0,0,0,0,0,0,0,0,0,0,0,0,439,2,0,0,0,0,0,0,0,0,0,100
6d00a7681f86989ad33954b17dad3a2aa265eafd,2,17,7,10,0,0,0,1,17,70,1,2,0.979868757,371,440,3,60,56,4,2105,1996,109,17,17,0,100
3c56334e672ea9691d5fb7943c5e09e09bd5b565,2,27,2,25,0,0,0,5,18,253,1,2,0.66319684,429,0,0,56,52,4,3253,3128,125,20,19,1,100
756dd8df3dbc0056f3291dcd13ebd5ff00c67829,0,0,0,0,0,0,0,0,0,0,0,0,0,0,441,0,0,0,0,0,0,0,0,0,0,100
351f666f9a58c3c53ebc229338cdad4229bd6932,0,0,0,0,0,0,0,0,0,0,0,0,0,0,442,1,0,0,0,0,0,0,0,0,0,100
5c32fafa5a1480cb997afc234f1d59188f6f1055,0,0,0,0,0,0,0,0,0,0,0,0,0,0,443,0,0,0,0,0,0,0,0,0,0,100
4e92d2c1a6a50e9ba057ecc1d7ff426a0f944159,0,0,0,0,0,0,0,0,0,0,0,0,0,0,444,1,0,0,0,0,0,0,0,0,0,100
34607225b82a5b490420138aff50739b02bbb8a6,0,0,0,0,0,0,0,0,0,0,0,0,0,0,445,2,0,0,0,0,0,0,0,0,0,100
ddfa98510a91c8e6c508a89e089975780177f8ce,0,0,0,0,0,0,0,0,0,0,0,0,0,0,0,0,0,0,0,0,0,0,0,0,0,100
f226be72008fa3ce58817a1a31144936f2ae01de,0,0,0,0,0,0,0,0,0,0,0,0,0,0,0,0,0,0,0,0,0,0,0,0,0,100
bf55e403bb188d2d3c1f2cd453d1fae595514b81,0,0,0,0,0,0,0,0,0,0,0,0,0,0,0,0,0,0,0,0,0,0,0,0,0,100
746ddb426ba8397c80b9ee5133021e72eb9435a1,3,67,12,55,0,0,0,2,18,291,1,2,1.580591108,398,0,0,67,61,6,2558,2265,293,21,18,3,100
32a6ab26bd7720f254747c12fa8d48050ae2c850,0,0,0,0,0,0,0,0,0,0,0,0,0,0,1,0,0,0,0,0,0,0,0,0,0,100
e4a92d335d754291eb673f3312f17167799582a0,0,0,0,0,0,0,0,0,0,0,0,0,0,0,1,0,0,0,0,0,0,0,0,0,0,100
c108d3df0d703da8f0fbf3a5f1f94512ef534076,0,0,0,0,0,0,0,0,0,0,0,0,0,0,2,1,0,0,0,0,0,0,0,0,0,100
84a5ad80aba2074ac4a7efcf52bef7496af519e7,11,306,107,199,5,0,5,1,19,147,1,3,2.523659563,1062,1,0,197,181,16,8862,7731,1131,133,115,18,95.92356688
52422d23c4e0555af11d178109c556b308584b9a,14,235,86,149,2,0,2,2,20,31,1,4,3.020798948,1457,446,0,224,225,1,10523,10385,138,146,147,1,96.36591479
622a763b0b20cce47c1aa9df4571585e15fcca35,0,0,0,0,0,0,0,0,0,0,0,0,0,0,0,0,0,0,0,0,0,0,0,0,0,100
a3087756c32f3c8e567798db13c29b26eb557fbf,0,0,0,0,0,0,0,0,0,0,0,0,0,0,0,0,0,0,0,0,0,0,0,0,0,100
c88e332fda16cf9bd69fb9d6b90c9a1b44ed6a79,0,0,0,0,0,0,0,0,0,0,0,0,0,0,0,0,0,0,0,0,0,0,0,0,0,100
e7fc36984d5a0df0176089b1aea2ac3158d01396,0,0,0,0,0,0,0,0,0,0,0,0,0,0,447,1,0,0,0,0,0,0,0,0,0,100
dbd5f887509924440d4b6f27dea2633a46634a57,0,0,0,0,0,0,0,0,0,0,0,0,0,0,0,0,0,0,0,0,0,0,0,0,0,100
9a1d4473924494e28988aea2df2af60d20578cfc,0,0,0,0,0,0,0,0,0,0,0,0,0,0,0,0,0,0,0,0,0,0,0,0,0,100
21c227762a81673760a563180af78703633c5239,0,0,0,0,0,0,0,0,0,0,0,0,0,0,1,1,0,0,0,0,0,0,0,0,0,100
44d90632f0c486014d9947ca7cc15da6539701ae,20,1199,514,685,6,0,6,1,10,668,2,8,2.983029359,2658,448,0,342,290,52,18783,17001,1782,116,113,3,98.13895782
92e9205185d7f36f357c263f1c5845716df33e54,0,0,0,0,0,0,0,0,0,0,0,0,0,0,449,1,0,0,0,0,0,0,0,0,0,100
15cb77652a8457c16a2a74ec61a59639be7dfdc1,0,0,0,0,0,0,0,0,0,0,0,0,0,0,450,2,0,0,0,0,0,0,0,0,0,100
19f11e8ce6a36ca5d6c7ebced08539bd5c7e5e20,0,0,0,0,0,0,0,0,0,0,0,0,0,0,451,3,0,0,0,0,0,0,0,0,0,100
b1d2734da1ab9d9f971b61ccb6c0f30a49e85d6b,0,0,0,0,0,0,0,0,0,0,0,0,0,0,452,4,0,0,0,0,0,0,0,0,0,100
c05aec1c4a403202dcfc30dcd55109ce857a191b,1,1,1,0,0,0,0,4,21,168,1,1,0,325,453,5,60,60,0,1952,1948,4,16,16,0,100
5b1512abe7e3353627009a0e0375a465bb0f982b,0,0,0,0,0,0,0,0,0,0,0,0,0,0,454,6,0,0,0,0,0,0,0,0,0,100
08a43854bf721cabd5433da9added3ebdc9a9155,0,0,0,0,0,0,0,0,0,0,0,0,0,0,455,7,0,0,0,0,0,0,0,0,0,100
aa9ec969d6c6eacfee6306c7bd4e4985a0d460c7,128,1322,2375,1053,0,0,0,1,26,805,2,28,6.995771446,14187,456,8,1666,1666,0,79212,79212,0,792,792,0,100
85d9258f9c1e8e0e86a9e4085c416b457640e617,0,0,0,0,0,0,0,0,0,0,0,0,0,0,457,9,0,0,0,0,0,0,0,0,0,100
fcc01330393fbe83de0895eb879b6313de505bac,0,0,0,0,0,0,0,0,0,0,0,0,0,0,458,10,0,0,0,0,0,0,0,0,0,100
1b7bf7b0103ac44a45b07a14f8b226503d4c07e3,0,0,0,0,0,0,0,0,0,0,0,0,0,0,459,11,0,0,0,0,0,0,0,0,0,100
33a944b9fa9ebce195b88c78b5b8d82fc0520438,0,0,0,0,0,0,0,0,0,0,0,0,0,0,460,12,0,0,0,0,0,0,0,0,0,100
769b0a5e4fcc5697137eca948a6c049e83863b19,0,0,0,0,0,0,0,0,0,0,0,0,0,0,2,0,0,0,0,0,0,0,0,0,0,100
45b00ba5ece4524576d2c6f11f9218780c7f4816,0,0,0,0,0,0,0,0,0,0,0,0,0,0,0,0,0,0,0,0,0,0,0,0,0,100
6c3057bd98df2d42b75b99528e1132d3fb9390f7,0,0,0,0,0,0,0,0,0,0,0,0,0,0,461,0,0,0,0,0,0,0,0,0,0,100
6875884c092bf1813b51577933a773fd7e522eeb,0,0,0,0,0,0,0,0,0,0,0,0,0,0,0,0,0,0,0,0,0,0,0,0,0,100
bfb45e89a35f72c5e57ab292d3330d221d2b29eb,0,0,0,0,0,0,0,0,0,0,0,0,0,0,462,0,0,0,0,0,0,0,0,0,0,100
a2e393c223af91771d3aada2636b71dfc19d5c0d,2,33,12,21,0,0,0,3,23,419,1,2,0.938932011,396,1,0,67,64,3,2476,2354,122,21,20,1,100
cb709c5e8a5299f67b96d58cde3e3201d644d6ea,0,0,0,0,0,0,0,0,0,0,0,0,0,0,0,0,0,0,0,0,0,0,0,0,0,100
3431f0315a52fc1baf833dd72c20ecae97696b6c,0,0,0,0,0,0,0,0,0,0,0,0,0,0,20,0,0,0,0,0,0,0,0,0,0,100
431c035f214d6b8f84e085099067e78b720a463f,0,0,0,0,0,0,0,0,0,0,0,0,0,0,0,0,0,0,0,0,0,0,0,0,0,100
79bb381208a83cbd26166e68fb8de7b199c073fe,0,0,0,0,0,0,0,0,0,0,0,0,0,0,463,0,0,0,0,0,0,0,0,0,0,100
b18cbf44e51a2e250f8da9ed5dfe5b7447d16e38,0,0,0,0,0,0,0,0,0,0,0,0,0,0,464,1,0,0,0,0,0,0,0,0,0,100
3ddaa1142696dac1675a61e199aad70dae6aba46,0,0,0,0,0,0,0,0,0,0,0,0,0,0,0,0,0,0,0,0,0,0,0,0,0,100
56eb14cd9e9219daec790b3ead8ff65d26314868,0,0,0,0,0,0,0,0,0,0,0,0,0,0,0,0,0,0,0,0,0,0,0,0,0,100
4f4e609e985155a00acee89ee166bac3d002a641,0,0,0,0,0,0,0,0,0,0,0,0,0,0,465,0,0,0,0,0,0,0,0,0,0,100
0da31b672f2900febda94b457759c7839304c894,0,0,0,0,0,0,0,0,0,0,0,0,0,0,466,1,0,0,0,0,0,0,0,0,0,100
b68086af7cc0594ba8fcd0e13be1d79a363c2513,0,0,0,0,0,0,0,0,0,0,0,0,0,0,0,0,0,0,0,0,0,0,0,0,0,100
15edbca254232c446697cc103cd8c422c93cba2d,0,0,0,0,0,0,0,0,0,0,0,0,0,0,1,1,0,0,0,0,0,0,0,0,0,100
21fb3c3c495aeade9015693915f32310a08d9d63,0,0,0,0,0,0,0,0,0,0,0,0,0,0,1,1,0,0,0,0,0,0,0,0,0,100
a3d94bb9322bd535b6bce09812fb8dacebe060cd,0,0,0,0,0,0,0,0,0,0,0,0,0,0,467,2,0,0,0,0,0,0,0,0,0,100
c98248046888e6ca01ee316acdac644706c3ea29,0,0,0,0,0,0,0,0,0,0,0,0,0,0,468,3,0,0,0,0,0,0,0,0,0,100
b29d4cb2bb918340847f6e0c0f7385c7dbf77ce9,1,11,22,11,0,0,0,2,10,1345,1,1,0,230,469,4,12,12,0,1760,1870,110,12,12,0,100
792d5963322d69a4ecd8e358baaed5c0887633af,0,0,0,0,0,0,0,0,0,0,0,0,0,0,2,0,0,0,0,0,0,0,0,0,0,100
0f680398407f8515c2a33f9ce0f03b8283690f0b,0,0,0,0,0,0,0,0,0,0,0,0,0,0,470,3,0,0,0,0,0,0,0,0,0,100
48518c8926c0740c094ad1378e51e92564855aa4,2,131,0,131,1,0,1,1,27,393,1,2,0.858757913,419,3,0,53,42,11,3176,2488,688,30,24,6,98.29268293
83f2bcc6a34f6a12b3951839aa7274d08a445283,2,83,2,81,0,0,0,2,28,6,1,2,0.987885353,504,2,0,61,53,8,3660,3176,484,33,30,3,100
a948afb43d5b6bedf15dd75a9bc6a072828c647f,0,0,0,0,0,0,0,0,0,0,0,0,0,0,4,0,0,0,0,0,0,0,0,0,0,100
a4e301e1cb82466b9cd12a2fc04310ec49548016,0,0,0,0,0,0,0,0,0,0,0,0,0,0,0,0,0,0,0,0,0,0,0,0,0,100
776e5585ef793b2402d4eef37e5553dc347c2547,0,0,0,0,0,0,0,0,0,0,0,0,0,0,2,0,0,0,0,0,0,0,0,0,0,100
f001c4e02922227fa9f9899f73b645ec51c97ee6,0,0,0,0,0,0,0,0,0,0,0,0,0,0,471,0,0,0,0,0,0,0,0,0,0,100
d090817d7404e9fcf9cc229e34421b14fc7b4de2,0,0,0,0,0,0,0,0,0,0,0,0,0,0,3,1,0,0,0,0,0,0,0,0,0,100
56aa6003b8f3c194e37799af88d1f15fa86d26e3,0,0,0,0,0,0,0,0,0,0,0,0,0,0,0,0,0,0,0,0,0,0,0,0,0,100
9469731396483489aec3d33f4d5c6a87365d614d,0,0,0,0,0,0,0,0,0,0,0,0,0,0,0,0,0,0,0,0,0,0,0,0,0,100
b41bad3a537c4717fde1aa1d392df281f8360685,2,22,1,21,0,0,0,4,24,706,1,2,0.886540893,411,5,0,69,67,2,2556,2476,80,22,21,1,100
bc84951a233ca0a2c3b420978932f1b844f9311d,0,0,0,0,0,0,0,0,0,0,0,0,0,0,472,0,0,0,0,0,0,0,0,0,0,100
2e56edd4dd2f6c629a71814fe52de7ded9d93f8f,0,0,0,0,0,0,0,0,0,0,0,0,0,0,473,1,0,0,0,0,0,0,0,0,0,100
618da90413f7d86c59def92ba765fbd6d9d49761,0,0,0,0,0,0,0,0,0,0,0,0,0,0,474,2,0,0,0,0,0,0,0,0,0,100
ccc63656b6d84e8842cb3ec03f711feb242964c4,0,0,0,0,0,0,0,0,0,0,0,0,0,0,3,0,0,0,0,0,0,0,0,0,0,100
ffb557ea791922923421f84c7fd120cf98d9581b,0,0,0,0,0,0,0,0,0,0,0,0,0,0,475,0,0,0,0,0,0,0,0,0,0,100
f06e4d381cb29c03efd7c0650182b4a663b8fe02,0,0,0,0,0,0,0,0,0,0,0,0,0,0,21,0,0,0,0,0,0,0,0,0,0,100
81a04d241a084e2a7021c0218ee7ea3d8e8ed3a3,0,0,0,0,0,0,0,0,0,0,0,0,0,0,22,1,0,0,0,0,0,0,0,0,0,100
856577e1518d34175c755c327e481a996b0a7cb0,0,0,0,0,0,0,0,0,0,0,0,0,0,0,6,0,0,0,0,0,0,0,0,0,0,100
f723a5c84a3f45bcc35e9eedda5210dc2e73fb81,0,0,0,0,0,0,0,0,0,0,0,0,0,0,476,1,0,0,0,0,0,0,0,0,0,100
00178b5052901d15e0588fba9ed7facf38bec380,2,60,7,53,0,0,0,6,17,1599,1,2,0.839530498,359,4,0,42,36,6,2918,2590,328,18,17,1,100
17a5d828a746eebd758ac15181495cea78986fae,0,0,0,0,0,0,0,0,0,0,0,0,0,0,4,0,0,0,0,0,0,0,0,0,0,100
8726b48e815295adb3bbc1c741c0b680bda5b928,0,0,0,0,0,0,0,0,0,0,0,0,0,0,5,0,0,0,0,0,0,0,0,0,0,100
fe11547738b7d614ff0d7bdb889283a8e1f7fece,2,19,4,15,0,0,0,7,29,378,1,2,0.426228657,791,1,0,84,83,1,5267,5242,25,42,41,1,100
f102eaa8a1af5a419030784ece9c8e4177d7a7a5,0,0,0,0,0,0,0,0,0,0,0,0,0,0,6,1,0,0,0,0,0,0,0,0,0,100
b5e7742ce20c20c1992b0ebadef46c8a148b3a02,0,0,0,0,0,0,0,0,0,0,0,0,0,0,0,0,0,0,0,0,0,0,0,0,0,100
c3a5f4fe7f605e52ae1b928b6e85a7bf09dd9cc6,0,0,0,0,0,0,0,0,0,0,0,0,0,0,1,1,0,0,0,0,0,0,0,0,0,100
c30ca346b446c572684ae51f611111e8c86e3f20,0,0,0,0,0,0,0,0,0,0,0,0,0,0,477,0,0,0,0,0,0,0,0,0,0,100
8cc219f0bffe44b83a992c07c3895afab4aab1c4,0,0,0,0,0,0,0,0,0,0,0,0,0,0,478,1,0,0,0,0,0,0,0,0,0,100
0b4ec1a66cb14251421e0d8a0ba543d2a8112f2a,0,0,0,0,0,0,0,0,0,0,0,0,0,0,5,0,0,0,0,0,0,0,0,0,0,100
3418c14cfe78dbd2f5c1a461738bc38e2064cdf8,0,0,0,0,0,0,0,0,0,0,0,0,0,0,0,0,0,0,0,0,0,0,0,0,0,100
b4781ed313546b78a00d8af4c84a689bb1d755cd,0,0,0,0,0,0,0,0,0,0,0,0,0,0,7,0,0,0,0,0,0,0,0,0,0,100
67f4c46f255d0cc841b2d2c5729ae423df967a18,0,0,0,0,0,0,0,0,0,0,0,0,0,0,479,2,0,0,0,0,0,0,0,0,0,100
55873afa9329a9b28149795d9539dfb9a20c8966,0,0,0,0,0,0,0,0,0,0,0,0,0,0,480,3,0,0,0,0,0,0,0,0,0,100
06aa269489339930fd32eca57931d2710f3293fc,0,0,0,0,0,0,0,0,0,0,0,0,0,0,481,4,0,0,0,0,0,0,0,0,0,100
d5c6cb2412dc303880505d9c41dafe718ace1aac,0,0,0,0,0,0,0,0,0,0,0,0,0,0,482,5,0,0,0,0,0,0,0,0,0,100
4baed9184d9178e123c3290cf30999f115c3bb53,1,80,256,176,0,0,0,1,9,1544,1,1,0,800,483,6,87,110,23,4073,5655,1582,16,16,0,100
c4e3419b323aa3ba03dc2027dae7abbc7487b4e2,0,0,0,0,0,0,0,0,0,0,0,0,0,0,484,7,0,0,0,0,0,0,0,0,0,100
bf45063e1306c1397134628118517cd4f7739d53,0,0,0,0,0,0,0,0,0,0,0,0,0,0,485,8,0,0,0,0,0,0,0,0,0,100
bb5ccbc11d1251c93430f35d3d966342288831fb,0,0,0,0,0,0,0,0,0,0,0,0,0,0,1,1,0,0,0,0,0,0,0,0,0,100
bf3cd3063123140a0cdf131797b10ff9ebddf700,0,0,0,0,0,0,0,0,0,0,0,0,0,0,2,2,0,0,0,0,0,0,0,0,0,100
dd06e69b3d684fc63c6db35d0cd1018a1bae2172,2,12,0,12,0,0,0,2,8,1556,1,1,0.650022422,266,3,3,9,9,0,1677,2177,500,9,9,0,100
e9a539c1a461d99a9b3b5ce0f8a2b4dcba865b9c,0,0,0,0,0,0,0,0,0,0,0,0,0,0,4,4,0,0,0,0,0,0,0,0,0,100
34ceb2bffc2992bf49bdd238be225d5506bb4ca4,0,0,0,0,0,0,0,0,0,0,0,0,0,0,5,5,0,0,0,0,0,0,0,0,0,100
03d180ea340f8e0d8a9a7c421df7cc2be6f84208,0,0,0,0,0,0,0,0,0,0,0,0,0,0,6,0,0,0,0,0,0,0,0,0,0,100
d72d7bae560ee39682e166a9d1de7ff0f9e956f8,0,0,0,0,0,0,0,0,0,0,0,0,0,0,486,0,0,0,0,0,0,0,0,0,0,100
973e25487096747ef5f120856e7d5840aa1eb642,0,0,0,0,0,0,0,0,0,0,0,0,0,0,487,1,0,0,0,0,0,0,0,0,0,100
b8bcc163f29be468b0b0e9b7cf5633aacb0a61db,0,0,0,0,0,0,0,0,0,0,0,0,0,0,488,2,0,0,0,0,0,0,0,0,0,100
c66590db9874ccc9b353bbeafbdbe3409b32f16c,0,0,0,0,0,0,0,0,0,0,0,0,0,0,489,3,0,0,0,0,0,0,0,0,0,100
65aea91a998a6fdad7c00cff4b67f0f148358c04,177,29912,0,29912,177,0,177,1,1,0,1,39,7.031841051,0,490,4,2181,0,2181,121329,0,121329,1135,0,1135,62.56895193
a60d51829e82bfdd2bef06e05a96d02df7056946,0,0,0,0,0,0,0,0,0,0,0,0,0,0,491,5,0,0,0,0,0,0,0,0,0,100
03c0e5a50e98e750e82683dc3c0bb2761d44d33c,0,0,0,0,0,0,0,0,0,0,0,0,0,0,492,6,0,0,0,0,0,0,0,0,0,100
e59616a7838d1d4980526a1f7f2d7982efeb4f96,0,0,0,0,0,0,0,0,0,0,0,0,0,0,493,7,0,0,0,0,0,0,0,0,0,100
5b20b11152430173077305f9e42a1a3e22ea15e4,0,0,0,0,0,0,0,0,0,0,0,0,0,0,494,8,0,0,0,0,0,0,0,0,0,100
c573ca2334ace7fa8182cb7a2396e94ea4fe4d56,0,0,0,0,0,0,0,0,0,0,0,0,0,0,495,9,0,0,0,0,0,0,0,0,0,100
4fb59c1d1b2ce758eb1bde28b19382bc3e986ba9,0,0,0,0,0,0,0,0,0,0,0,0,0,0,496,10,0,0,0,0,0,0,0,0,0,100
7cdf0ee5939ab4a196e076e58569a0e8ba8c1cbd,0,0,0,0,0,0,0,0,0,0,0,0,0,0,497,11,0,0,0,0,0,0,0,0,0,100
a44efa564c8fcd3d300058d9ce7588a958e3ba46,0,0,0,0,0,0,0,0,0,0,0,0,0,0,498,12,0,0,0,0,0,0,0,0,0,100
37e6657796cf3995b3f5e4fa2d7a080397a3a51e,0,0,0,0,0,0,0,0,0,0,0,0,0,0,499,11,0,0,0,0,0,0,0,0,0,100
615904bdb7f5a60174662491e14da9b4b7232491,107,424,437,13,0,0,0,1,30,1930,3,29,6.127859384,14798,500,0,1720,1718,2,94496,94579,83,864,862,2,100
1c73568fabad5e64dab0ac2249f1a3f147ddb129,0,0,0,0,0,0,0,0,0,0,0,0,0,0,501,1,0,0,0,0,0,0,0,0,0,100
9e01f6f44d55caad1f554fce03920a1d9ff7d7c0,0,0,0,0,0,0,0,0,0,0,0,0,0,0,502,0,0,0,0,0,0,0,0,0,0,100
2be66ea34d888a0dc4958477d50d642498154771,0,0,0,0,0,0,0,0,0,0,0,0,0,0,503,1,0,0,0,0,0,0,0,0,0,100
2e60fc07b0eae78ccae3876d970e677fc9319c40,354,29823,29899,76,177,0,177,2,31,350,3,78,8.039308591,19706,504,2,2177,2609,432,121598,229166,107568,1137,1563,426,51.93434936
ffb96829172c7d58d1646481b46497f1d388e44a,0,0,0,0,0,0,0,0,0,0,0,0,0,0,505,0,0,0,0,0,0,0,0,0,0,100
16a1bb94fb4c71c58b79314ea5f559699ffb8382,0,0,0,0,0,0,0,0,0,0,0,0,0,0,506,1,0,0,0,0,0,0,0,0,0,100
4800676929d3d07db2f7e6421a643ffd562f90a3,31,691,752,61,4,0,4,1,2,54,2,15,4.228717883,5203,507,2,607,587,20,35920,35687,233,342,334,8,98.13845259
b22b37077eb07fdd273a4dc4b01171d03aa46664,0,0,0,0,0,0,0,0,0,0,0,0,0,0,508,3,0,0,0,0,0,0,0,0,0,100
4ab128526c9c1726a9d0fa99f59ac57bfd6652f9,0,0,0,0,0,0,0,0,0,0,0,0,0,0,509,4,0,0,0,0,0,0,0,0,0,100
d58333ce412019238ad9f82968bed4b653f40de8,0,0,0,0,0,0,0,0,0,0,0,0,0,0,510,5,0,0,0,0,0,0,0,0,0,100
1e7d1baf0fe4ef090bd471330520bf299c7e208c,0,0,0,0,0,0,0,0,0,0,0,0,0,0,511,6,0,0,0,0,0,0,0,0,0,100
220aed405f34062dd3a6014e440089ff49910fe4,0,0,0,0,0,0,0,0,0,0,0,0,0,0,512,7,0,0,0,0,0,0,0,0,0,100
a614cfbb322d18dee01a4043426073bec4727047,0,0,0,0,0,0,0,0,0,0,0,0,0,0,513,8,0,0,0,0,0,0,0,0,0,100
f94e5c5a593de16ee698fea3f505f2ca6e5fb36d,0,0,0,0,0,0,0,0,0,0,0,0,0,0,7,0,0,0,0,0,0,0,0,0,0,100
aff3af360c827b7d17039b14aa3c1bb6566ada0e,0,0,0,0,0,0,0,0,0,0,0,0,0,0,514,3,0,0,0,0,0,0,0,0,0,100
1cf775dc94ef549f4913c0297b848d55e70ad4d9,32,3038,26,3012,19,0,19,1,3,21,1,10,3.852473243,1446,515,4,519,172,347,18798,9035,9763,253,80,173,94.56398641
6d0dcf995021c6327c71e943dfe384de4557a278,2,36,0,36,0,0,0,1,3,46,1,2,0.764204507,476,516,5,59,57,2,3133,2957,176,34,32,2,96.34877384
6e144cc159e2e32e07c8811ca6015419e225cb3d,0,0,0,0,0,0,0,0,0,0,0,0,0,0,8,1,0,0,0,0,0,0,0,0,0,100
1a6035d7a62c717f454bf3e2fbb5facd75375a7d,1,63,0,63,1,0,1,1,1,0,1,1,0,0,517,3,4,0,4,378,0,378,3,0,3,99.8940678
cfb781722f4c375f501db0f0fa01ef44bc57a8dc,32,26,3038,3012,0,0,0,1,4,0,1,12,3.852473243,3143,518,4,167,524,357,8916,18917,10001,78,255,177,93.52715304
74e862fa06046b1d4be147754a4a713bc1d00e9d,0,0,0,0,0,0,0,0,0,0,0,0,0,0,519,5,0,0,0,0,0,0,0,0,0,100
530ebe930dd6f890066ce1033877808fb31c387e,0,0,0,0,0,0,0,0,0,0,0,0,0,0,520,6,0,0,0,0,0,0,0,0,0,100
9b4a2f51ae9bbcfc7625f25765436a955ac3c8c2,0,0,0,0,0,0,0,0,0,0,0,0,0,0,521,7,0,0,0,0,0,0,0,0,0,100
a6a651e83df0e6da810f98d67c29bd1e17e4f6b6,0,0,0,0,0,0,0,0,0,0,0,0,0,0,522,8,0,0,0,0,0,0,0,0,0,100
a5e6c8c0d79e214b6e0800a6f7c272fd89272341,0,0,0,0,0,0,0,0,0,0,0,0,0,0,523,9,0,0,0,0,0,0,0,0,0,100
a4faea735a954ea2c2bdbf8b5d3270aca2bca799,0,0,0,0,0,0,0,0,0,0,0,0,0,0,524,10,0,0,0,0,0,0,0,0,0,100
ad0a075d7ece7103587771ae91cf714dd748320f,0,0,0,0,0,0,0,0,0,0,0,0,0,0,525,11,0,0,0,0,0,0,0,0,0,100
174e2e17b4dba6d7ed343a198106e2b487d926df,0,0,0,0,0,0,0,0,0,0,0,0,0,0,526,12,0,0,0,0,0,0,0,0,0,100
9d7ec9a755919952efd7a49122d204327e5a03f1,0,0,0,0,0,0,0,0,0,0,0,0,0,0,527,13,0,0,0,0,0,0,0,0,0,100
e4aece9186db4f310fce2d115c7f33f487d2b4ad,0,0,0,0,0,0,0,0,0,0,0,0,0,0,528,14,0,0,0,0,0,0,0,0,0,100
1056b7c2f7e543c60b5841fd904249476df6d200,0,0,0,0,0,0,0,0,0,0,0,0,0,0,529,15,0,0,0,0,0,0,0,0,0,100
c6ff56df24621bf0bd4a7e21f25ec407685154d9,0,0,0,0,0,0,0,0,0,0,0,0,0,0,530,16,0,0,0,0,0,0,0,0,0,100
e3e74998df1883bd3fa3b34d0c61eb06dcd22770,0,0,0,0,0,0,0,0,0,0,0,0,0,0,531,17,0,0,0,0,0,0,0,0,0,100
987d180a9cb228bbfce0a038835e80d8b482c813,0,0,0,0,0,0,0,0,0,0,0,0,0,0,532,18,0,0,0,0,0,0,0,0,0,100
69a1c12a635088b06920152a89f3a01144f91f01,0,0,0,0,0,0,0,0,0,0,0,0,0,0,533,19,0,0,0,0,0,0,0,0,0,100
feaf338b27a66f28cd2b9062748bf567cdcbc86e,0,0,0,0,0,0,0,0,0,0,0,0,0,0,534,20,0,0,0,0,0,0,0,0,0,100
097c7b330ae508ef42e5ffd2abecb4f89b29a02d,0,0,0,0,0,0,0,0,0,0,0,0,0,0,535,21,0,0,0,0,0,0,0,0,0,100
887c43a488c995e2f4a9d827c432c81612e28d0d,0,0,0,0,0,0,0,0,0,0,0,0,0,0,536,22,0,0,0,0,0,0,0,0,0,100
bfb962ba1ea25dff3853db6af389832137e28c94,177,0,29912,29912,0,0,0,1,2,177,1,39,7.031841051,19721,537,23,0,2181,2181,0,121329,121329,0,1135,1135,65.49707602
3dabc4dc6becbb73089f6fa859d0486f1e24298f,0,0,0,0,0,0,0,0,0,0,0,0,0,0,538,24,0,0,0,0,0,0,0,0,0,100
317302bb49b55fbfc63179272ab35c3363736d24,0,0,0,0,0,0,0,0,0,0,0,0,0,0,539,25,0,0,0,0,0,0,0,0,0,100
ba5dbb8473d1e62475b14c274b841df5a2189043,0,0,0,0,0,0,0,0,0,0,0,0,0,0,540,26,0,0,0,0,0,0,0,0,0,100
746b08b6624a9a491d4b75efda7061f6c7f68292,0,0,0,0,0,0,0,0,0,0,0,0,0,0,541,25,0,0,0,0,0,0,0,0,0,100
fcecc60896d1187a87a58a58b8f4d72dd79f8838,0,0,0,0,0,0,0,0,0,0,0,0,0,0,542,26,0,0,0,0,0,0,0,0,0,100
205d79bf4e564eb51e5df81af42548f88e24c5ac,0,0,0,0,0,0,0,0,0,0,0,0,0,0,543,26,0,0,0,0,0,0,0,0,0,100
12b9cfe992444a499fd5194bda1b2177f4bcabe5,0,0,0,0,0,0,0,0,0,0,0,0,0,0,544,27,0,0,0,0,0,0,0,0,0,100
da4d9083a96bf9022a0f43eb884fb8a85a026b92,0,0,0,0,0,0,0,0,0,0,0,0,0,0,545,28,0,0,0,0,0,0,0,0,0,100
2b3d181cc82bf771df77de0fcfb8c046a91ae97c,0,0,0,0,0,0,0,0,0,0,0,0,0,0,546,29,0,0,0,0,0,0,0,0,0,100
a7d419f59cce4805b0dc20c979a46ea87c168535,0,0,0,0,0,0,0,0,0,0,0,0,0,0,547,30,0,0,0,0,0,0,0,0,0,100
61e909b3bbb0e39772cb69c9add18fcdf6d1942b,0,0,0,0,0,0,0,0,0,0,0,0,0,0,548,31,0,0,0,0,0,0,0,0,0,100
e4d3e31658cfcb8b7b2bb895d8eacb646c0c7baa,0,0,0,0,0,0,0,0,0,0,0,0,0,0,549,32,0,0,0,0,0,0,0,0,0,100
61839143c7bb08817ba9f5321c046dec62760a79,0,0,0,0,0,0,0,0,0,0,0,0,0,0,550,33,0,0,0,0,0,0,0,0,0,100
4161e8491021e65b5a613a0e134e405ec018014a,0,0,0,0,0,0,0,0,0,0,0,0,0,0,551,34,0,0,0,0,0,0,0,0,0,100
0f577971e85c06056eae094d5751493286ef6284,0,0,0,0,0,0,0,0,0,0,0,0,0,0,552,35,0,0,0,0,0,0,0,0,0,100
faa943129333bc4c59062ce89a247dbe760229a6,0,0,0,0,0,0,0,0,0,0,0,0,0,0,553,36,0,0,0,0,0,0,0,0,0,100
1d9848eae74170092ad8b705c980c09d44f52e6a,0,0,0,0,0,0,0,0,0,0,0,0,0,0,554,37,0,0,0,0,0,0,0,0,0,100
9642a0002c6c339c305c732d9a8714ec7c340d6d,0,0,0,0,0,0,0,0,0,0,0,0,0,0,555,38,0,0,0,0,0,0,0,0,0,100
547bef4da93804b5a3b2afe3ad48006c0fcacc67,0,0,0,0,0,0,0,0,0,0,0,0,0,0,556,39,0,0,0,0,0,0,0,0,0,100
2a6c1f4660ea5571097679450f0438241801ac34,0,0,0,0,0,0,0,0,0,0,0,0,0,0,557,40,0,0,0,0,0,0,0,0,0,100
29f897bbcaf65aa5b5b28ea4e93c6b7e783d83a6,0,0,0,0,0,0,0,0,0,0,0,0,0,0,558,41,0,0,0,0,0,0,0,0,0,100
55a47f90c3794cf094d0250d9899d30fae063b6f,0,0,0,0,0,0,0,0,0,0,0,0,0,0,559,42,0,0,0,0,0,0,0,0,0,100
f71c37c36d4b85e9ac95335e957612d2c95cf0f4,0,0,0,0,0,0,0,0,0,0,0,0,0,0,560,43,0,0,0,0,0,0,0,0,0,100
cc3efb282412f368cb4fe6e66e64d66545cc5ffd,0,0,0,0,0,0,0,0,0,0,0,0,0,0,561,18,0,0,0,0,0,0,0,0,0,100
8249b2ba540be138cb52cdea453d5e465ac09a28,3,15,11,4,0,0,0,1,3,191,3,3,0.892995357,599,562,19,48,48,0,4737,4792,55,30,30,0,100
f1d20b5c79590fdb7acff9541ab9c1c9e37087f9,0,0,0,0,0,0,0,0,0,0,0,0,0,0,563,20,0,0,0,0,0,0,0,0,0,100
cee466c09aea4b825ebdb142c4c4810f99d53a8a,0,0,0,0,0,0,0,0,0,0,0,0,0,0,564,3,0,0,0,0,0,0,0,0,0,100
8235924ac80939cbf2ce562b0209b71833ed9429,0,0,0,0,0,0,0,0,0,0,0,0,0,0,565,1,0,0,0,0,0,0,0,0,0,100
074bdb397149683821b6753e46ce49c5a975ce00,0,0,0,0,0,0,0,0,0,0,0,0,0,0,566,2,0,0,0,0,0,0,0,0,0,100
be90b00690904a414f95f0037dd21476f9d00b3a,0,0,0,0,0,0,0,0,0,0,0,0,0,0,567,3,0,0,0,0,0,0,0,0,0,100
c095513bd23a49c06690b2d9c46b72a02885fe2e,0,0,0,0,0,0,0,0,0,0,0,0,0,0,568,4,0,0,0,0,0,0,0,0,0,100
0541080cc17fef11fd10073d28d5744a577e654c,0,0,0,0,0,0,0,0,0,0,0,0,0,0,569,5,0,0,0,0,0,0,0,0,0,100
5d6f33947bb131e438664d91d4fba5857e3e828d,0,0,0,0,0,0,0,0,0,0,0,0,0,0,8,0,0,0,0,0,0,0,0,0,0,100
74cf6c5b6d9a24c256a79f965b18e19c45c81d16,0,0,0,0,0,0,0,0,0,0,0,0,0,0,0,0,0,0,0,0,0,0,0,0,0,100
ad767488ea2e6695ea9cf587e124811ceeeaaaac,0,0,0,0,0,0,0,0,0,0,0,0,0,0,1,1,0,0,0,0,0,0,0,0,0,100
71ce8230b3cda68e5c5813121c115e873dbade04,0,0,0,0,0,0,0,0,0,0,0,0,0,0,570,5,0,0,0,0,0,0,0,0,0,100
74c1ef8665cfbd5586f67a1ea1c01fb0a6cd830b,0,0,0,0,0,0,0,0,0,0,0,0,0,0,571,6,0,0,0,0,0,0,0,0,0,100
41d66f6cc95b57ec4d512163fe2d50264d863e72,0,0,0,0,0,0,0,0,0,0,0,0,0,0,572,7,0,0,0,0,0,0,0,0,0,100
bd4e6299528a56d4fbedd2c3459cbc8246aa87f6,0,0,0,0,0,0,0,0,0,0,0,0,0,0,573,3,0,0,0,0,0,0,0,0,0,100
588c6cdbaf0bf3fd5fff6caf1cc063304bd1867d,0,0,0,0,0,0,0,0,0,0,0,0,0,0,2,0,0,0,0,0,0,0,0,0,0,100
efd9915832d99d81b68d577fafb4f0a661a1c8dc,5,7,10,3,0,0,0,2,3,270,1,2,1.938679017,904,0,0,106,106,0,5428,5430,2,82,82,0,100
34fef45c638693ca3099f5907d6214c07b656edc,0,0,0,0,0,0,0,0,0,0,0,0,0,0,0,0,0,0,0,0,0,0,0,0,0,100
f74d057364e81ffb3d40c044330b8d598880be2a,0,0,0,0,0,0,0,0,0,0,0,0,0,0,0,0,0,0,0,0,0,0,0,0,0,100
be30079150c59aefa18ba12a603ac5e51a1f6b4a,0,0,0,0,0,0,0,0,0,0,0,0,0,0,574,0,0,0,0,0,0,0,0,0,0,100
3df790acc03b0b0da30f9df734357f27858c9ed7,0,0,0,0,0,0,0,0,0,0,0,0,0,0,575,1,0,0,0,0,0,0,0,0,0,100
e0fa15d7d8337a3a14d6296a0ddc320ad9bd7152,0,0,0,0,0,0,0,0,0,0,0,0,0,0,576,2,0,0,0,0,0,0,0,0,0,100
55e1ac2872ed3199dddb578b2b972b185e2c6e57,1,2,1,1,0,0,0,1,3,172,1,1,0,190,577,3,12,12,0,1678,1653,25,12,12,0,100
b39312cadac7f51a43caf47c2c16063e4049ea54,1,1,2,1,0,0,0,1,4,0,1,1,0,191,578,4,12,12,0,1653,1678,25,12,12,0,100
ae502a848688319f893c8c6ec1ecb3b270850870,0,0,0,0,0,0,0,0,0,0,0,0,0,0,579,5,0,0,0,0,0,0,0,0,0,100
a8c42896a8fc2f15b56fe817121c965adf0dc2f5,0,0,0,0,0,0,0,0,0,0,0,0,0,0,580,6,0,0,0,0,0,0,0,0,0,100
369b51a68a7983b0c6fa79c313a29bdc1ff6be11,0,0,0,0,0,0,0,0,0,0,0,0,0,0,1,0,0,0,0,0,0,0,0,0,0,100
6169c5c9396daad1b568f109753250f57c206d7f,0,0,0,0,0,0,0,0,0,0,0,0,0,0,581,5,0,0,0,0,0,0,0,0,0,100
f6b1c5e24bdb67d2c8d701a9b2af1fb5658fdc4d,0,0,0,0,0,0,0,0,0,0,0,0,0,0,582,0,0,0,0,0,0,0,0,0,0,100
e0904c54deb1e25c96db21dd1b416d0bf62f9413,0,0,0,0,0,0,0,0,0,0,0,0,0,0,583,0,0,0,0,0,0,0,0,0,0,100
0bfafc1272b76353b6c1e6d86ddafdfb1c951baa,0,0,0,0,0,0,0,0,0,0,0,0,0,0,584,1,0,0,0,0,0,0,0,0,0,100
c4d275b2fdd82d3fd65ac4179cd121be14eff801,0,0,0,0,0,0,0,0,0,0,0,0,0,0,585,2,0,0,0,0,0,0,0,0,0,100
8b158e69c979c7d9b531bcc0796a6add54c78660,0,0,0,0,0,0,0,0,0,0,0,0,0,0,586,3,0,0,0,0,0,0,0,0,0,100
36b7796262e2fb965da278c0a7443394ba6fde25,0,0,0,0,0,0,0,0,0,0,0,0,0,0,587,4,0,0,0,0,0,0,0,0,0,100
a8efbc8d7de8fff3eb876c7dc08dc59cdf950a9a,2,2,123,121,0,0,0,1,4,475,1,2,0.204324671,552,588,5,48,71,23,2748,3716,968,28,38,10,96.42470206
faadf6967b679ed3a7972bdce83c6e349713b340,0,0,0,0,0,0,0,0,0,0,0,0,0,0,589,6,0,0,0,0,0,0,0,0,0,100
4573274a0617bc130647121f9c82f9bd43457450,0,0,0,0,0,0,0,0,0,0,0,0,0,0,0,0,0,0,0,0,0,0,0,0,0,100
e8561bd634b02d1a4aab816d2dcd97ad33e81817,0,0,0,0,0,0,0,0,0,0,0,0,0,0,590,7,0,0,0,0,0,0,0,0,0,100
2501e0c4b9836bd1c5bd17d5953e1eb9b4756492,0,0,0,0,0,0,0,0,0,0,0,0,0,0,591,8,0,0,0,0,0,0,0,0,0,100
0e2847dc3eadf2a6fd6f5b5e36d47e39a98f39dd,0,0,0,0,0,0,0,0,0,0,0,0,0,0,592,9,0,0,0,0,0,0,0,0,0,100
19250b71e8d7d10304696da378468cb1358e930f,0,0,0,0,0,0,0,0,0,0,0,0,0,0,593,10,0,0,0,0,0,0,0,0,0,100
d827579c16ffd7a1b8c196038baeb0a4bf11989f,0,0,0,0,0,0,0,0,0,0,0,0,0,0,594,11,0,0,0,0,0,0,0,0,0,100
3b9454edd447345292c02568ef790edb441d2a65,0,0,0,0,0,0,0,0,0,0,0,0,0,0,595,12,0,0,0,0,0,0,0,0,0,100
b5aac3c9527a74d66896a7bef848a39ecb0a3ea3,0,0,0,0,0,0,0,0,0,0,0,0,0,0,596,13,0,0,0,0,0,0,0,0,0,100
bef93d2a5f987768584bd58507daecb82fce358c,0,0,0,0,0,0,0,0,0,0,0,0,0,0,1,1,0,0,0,0,0,0,0,0,0,100
acacc39de182441da1e1390b02e3246b153bcc6d,0,0,0,0,0,0,0,0,0,0,0,0,0,0,597,14,0,0,0,0,0,0,0,0,0,100
a8e977a3c02dc254ee8073aa6b0e2069f8c3a639,0,0,0,0,0,0,0,0,0,0,0,0,0,0,598,15,0,0,0,0,0,0,0,0,0,100
567e421015cc0bfbf18be9446fae3013686853f5,0,0,0,0,0,0,0,0,0,0,0,0,0,0,599,16,0,0,0,0,0,0,0,0,0,100
477f4e725c160b3cad3ce8a1cac62238fb808f87,0,0,0,0,0,0,0,0,0,0,0,0,0,0,600,17,0,0,0,0,0,0,0,0,0,100
55311f82b9a7c3ba6d215710c576134d1817edb6,0,0,0,0,0,0,0,0,0,0,0,0,0,0,9,0,0,0,0,0,0,0,0,0,0,100
8a7fac11f38e8a35ac0ecb281219625cd1e13817,0,0,0,0,0,0,0,0,0,0,0,0,0,0,601,18,0,0,0,0,0,0,0,0,0,100
a48490685f3dc6072fc23684c57b67435206872c,2,162,1,161,1,0,1,1,2,308,1,2,0.095491238,43,0,0,10,3,7,921,119,802,5,2,3,99.76851852
5910b520343dd33fc2d212a35525f41a9cfd3d9a,2,30,161,131,0,0,0,1,2,308,1,2,0.627249062,204,602,5,11,16,5,1048,1550,502,5,7,2,99.76851852
6dce17183bec095227222025acd00d2c59b33991,0,0,0,0,0,0,0,0,0,0,0,0,0,0,603,6,0,0,0,0,0,0,0,0,0,100
d8c2aae0678b7262660bda68eb0a2048b849e438,0,0,0,0,0,0,0,0,0,0,0,0,0,0,0,0,0,0,0,0,0,0,0,0,0,100
8fd688f4c26374bf2f4811d1dc4c333d9acd3b4d,0,0,0,0,0,0,0,0,0,0,0,0,0,0,0,0,0,0,0,0,0,0,0,0,0,100
c363cd894759b0ecb1e82dec653f23a682f692d6,0,0,0,0,0,0,0,0,0,0,0,0,0,0,1,0,0,0,0,0,0,0,0,0,0,100
81e92f125114bf194b0a25b84426e8e00fd74102,0,0,0,0,0,0,0,0,0,0,0,0,0,0,604,0,0,0,0,0,0,0,0,0,0,100
e6513bedd41f8f71d75dcdf9f7db9efaef880518,2,27,2,25,0,0,0,2,3,712,1,2,0.929363626,204,1,0,22,18,4,1347,1207,140,8,7,1,100
ce31e3be07d69404542a119cffaeb140d2812acd,0,0,0,0,0,0,0,0,0,0,0,0,0,0,2,0,0,0,0,0,0,0,0,0,0,100
057c375f00791ea307f71557af0afefc15403f6f,0,0,0,0,0,0,0,0,0,0,0,0,0,0,2,0,0,0,0,0,0,0,0,0,0,100
59bc7098baeb7791b745865c249e03eee16a71f9,0,0,0,0,0,0,0,0,0,0,0,0,0,0,0,0,0,0,0,0,0,0,0,0,0,100
eea460f332d78516ec61cd4b67e817f19b10bc53,1,4,2,2,0,0,0,1,2,906,1,1,0,98,605,0,6,6,0,617,610,7,4,4,0,100
a0ed49da0b62ce591d858e5dccd5cebb69a8e695,19,743,243,500,10,0,10,2,5,280,2,12,3.889760813,1133,9,0,165,124,41,9446,7011,2435,94,72,22,96.36363636
429270a4d503561eae8359abaecd08e230c4ff53,0,0,0,0,0,0,0,0,0,0,0,0,0,0,0,0,0,0,0,0,0,0,0,0,0,100
d92fe8fd17a62e86d134f4321d365f82e0c0e31c,1,5,0,5,0,0,0,2,2,935,1,1,0,60,0,0,8,6,2,375,343,32,2,2,0,100
7d950669d985e77b098a5a90a5c4f77d4f163ee7,19,243,743,500,1,0,1,2,6,19,2,12,3.889760813,1511,606,0,139,150,11,7593,8948,1355,74,92,18,96.36363636
8d9079970941ad050b3beab934b31340186793c2,0,0,0,0,0,0,0,0,0,0,0,0,0,0,607,1,0,0,0,0,0,0,0,0,0,100
4761ac02b3a1b8f6752ecfb0b3dfde5f9e8f9af8,2,32,3,29,0,0,0,3,4,778,1,2,0.591672779,358,1,1,46,43,3,2819,2658,161,26,25,1,99.65237543
4c9bed6782735b8227bc7d45f29181c3ddf33c4f,4,47,6,41,0,0,0,2,5,723,1,4,1.161948015,726,0,0,81,80,1,4395,4037,358,53,52,1,100
f544bbdcc5023df1bc9b7c6b1f01253076e1edfe,0,0,0,0,0,0,0,0,0,0,0,0,0,0,0,0,0,0,0,0,0,0,0,0,0,100
6e3646fa974daf36a57699d685e193850661c62d,0,0,0,0,0,0,0,0,0,0,0,0,0,0,608,2,0,0,0,0,0,0,0,0,0,100
9f7f0dc67064d8dee9a43d8d2b0569bf20726595,0,0,0,0,0,0,0,0,0,0,0,0,0,0,609,3,0,0,0,0,0,0,0,0,0,100
73d6bbe514a663741f4321996aeeed1afd53dc23,0,0,0,0,0,0,0,0,0,0,0,0,0,0,610,4,0,0,0,0,0,0,0,0,0,100
66ef15503ec5b53d06caf6cb6d2ddfbf692d1c4c,0,0,0,0,0,0,0,0,0,0,0,0,0,0,611,5,0,0,0,0,0,0,0,0,0,100
c60c37318ef82445e3ed557eb6d64a6d0961effa,0,0,0,0,0,0,0,0,0,0,0,0,0,0,612,6,0,0,0,0,0,0,0,0,0,100
9c7ee0c6bdbc5bdb43eef4b8e45c65f1258dcaae,0,0,0,0,0,0,0,0,0,0,0,0,0,0,613,5,0,0,0,0,0,0,0,0,0,100
671a109c31cd249e5c4dbd093a2789ced6ce8f0f,0,0,0,0,0,0,0,0,0,0,0,0,0,0,614,6,0,0,0,0,0,0,0,0,0,100
ba3007cde81709ea69e930799130f26430039e8a,0,0,0,0,0,0,0,0,0,0,0,0,0,0,615,7,0,0,0,0,0,0,0,0,0,100
6bd69fc43b5a9fc5a721838e918bfe0093f1a7ce,0,0,0,0,0,0,0,0,0,0,0,0,0,0,616,8,0,0,0,0,0,0,0,0,0,100
7133eb9e51171240b1035f664e542514e65f7348,0,0,0,0,0,0,0,0,0,0,0,0,0,0,617,9,0,0,0,0,0,0,0,0,0,100
409ad0cfe50a1031b012e239af92f96bb15c819d,0,0,0,0,0,0,0,0,0,0,0,0,0,0,618,10,0,0,0,0,0,0,0,0,0,100
3758fcfb4d532a53b960adcf94818b9cc2d89ccd,0,0,0,0,0,0,0,0,0,0,0,0,0,0,3,0,0,0,0,0,0,0,0,0,0,100
cb2c7d1e5226a40ae1d78e6013d0def3bd169750,0,0,0,0,0,0,0,0,0,0,0,0,0,0,619,11,0,0,0,0,0,0,0,0,0,100
8948bdba44b4b322609372c8f6baacae133e1e8f,0,0,0,0,0,0,0,0,0,0,0,0,0,0,620,12,0,0,0,0,0,0,0,0,0,100
c11212ff1d308f8063e0f95f377ea8d1ae8a6fd2,0,0,0,0,0,0,0,0,0,0,0,0,0,0,10,0,0,0,0,0,0,0,0,0,0,100
9fa36d71fc87c7a992402a7a8a89839de94be75f,0,0,0,0,0,0,0,0,0,0,0,0,0,0,11,1,0,0,0,0,0,0,0,0,0,100
df2a1c2b8d5a11979839825a659651e7244957c9,0,0,0,0,0,0,0,0,0,0,0,0,0,0,621,8,0,0,0,0,0,0,0,0,0,100
6fafc93217b14745d11819f44e5a166480746baa,0,0,0,0,0,0,0,0,0,0,0,0,0,0,2,0,0,0,0,0,0,0,0,0,0,100
b12ceaabe63b20cfb41910fc35660fc69eedebd6,0,0,0,0,0,0,0,0,0,0,0,0,0,0,0,0,0,0,0,0,0,0,0,0,0,100
5055078d18c687f92fcc67b7377203c501823b8a,0,0,0,0,0,0,0,0,0,0,0,0,0,0,3,0,0,0,0,0,0,0,0,0,0,100
609261b9a0efb7bf1c19c2168975f726adf3a054,0,0,0,0,0,0,0,0,0,0,0,0,0,0,1,0,0,0,0,0,0,0,0,0,0,100
536f4980a8590542fb2b19928d6890ac8612c2dd,0,0,0,0,0,0,0,0,0,0,0,0,0,0,4,0,0,0,0,0,0,0,0,0,0,100
b38394197dede5700d5b5f959d905ed39929681e,0,0,0,0,0,0,0,0,0,0,0,0,0,0,4,1,0,0,0,0,0,0,0,0,0,100
df67799ea5d3372ab267ebe670dba08d800e6b54,0,0,0,0,0,0,0,0,0,0,0,0,0,0,2,1,0,0,0,0,0,0,0,0,0,100
ced494b9d4a6799e0d223c14df5ac8293ea76b7a,0,0,0,0,0,0,0,0,0,0,0,0,0,0,622,0,0,0,0,0,0,0,0,0,0,100
85e225ed756fc057dfe75f0c6732489a36d19d6a,0,0,0,0,0,0,0,0,0,0,0,0,0,0,623,1,0,0,0,0,0,0,0,0,0,100
0462d0934c9a58ae4ed23f75769c5f9319c14e04,0,0,0,0,0,0,0,0,0,0,0,0,0,0,624,2,0,0,0,0,0,0,0,0,0,100
f9ba2235d39dda41fba10aeceb733201b80d690e,0,0,0,0,0,0,0,0,0,0,0,0,0,0,625,3,0,0,0,0,0,0,0,0,0,100
b5806cb8ed2ca23965c3de76917c52ecb71efff4,0,0,0,0,0,0,0,0,0,0,0,0,0,0,626,4,0,0,0,0,0,0,0,0,0,100
b1baf9e28542eb0f7776f483aa6f94cf474d02ac,0,0,0,0,0,0,0,0,0,0,0,0,0,0,627,5,0,0,0,0,0,0,0,0,0,100
182d97ab413b2c18a7d88927698222c3a791d0e9,0,0,0,0,0,0,0,0,0,0,0,0,0,0,628,6,0,0,0,0,0,0,0,0,0,100
ea5160aa275370316ff41030507f2931feebd0f9,0,0,0,0,0,0,0,0,0,0,0,0,0,0,12,0,0,0,0,0,0,0,0,0,0,100
53234ea5fbcbeb462d0c0fb70a64d61f9aacc897,0,0,0,0,0,0,0,0,0,0,0,0,0,0,629,7,0,0,0,0,0,0,0,0,0,100
41d531fabd9932ac4e6a494c06ccc08ba0623e29,0,0,0,0,0,0,0,0,0,0,0,0,0,0,630,4,0,0,0,0,0,0,0,0,0,100
66c5556142d1566b789c3c691db2b9bdc99e3430,0,0,0,0,0,0,0,0,0,0,0,0,0,0,1,0,0,0,0,0,0,0,0,0,0,100
2e7bbc198a2d50071203293b31fa46c9dd0b7a9c,0,0,0,0,0,0,0,0,0,0,0,0,0,0,0,0,0,0,0,0,0,0,0,0,0,100
cabe590b3e196e1d2393d7fc15a4bcc8108ddf49,0,0,0,0,0,0,0,0,0,0,0,0,0,0,3,0,0,0,0,0,0,0,0,0,0,100
890a8d9921abb06427f353965b359c6649da6184,2,18,2,16,0,0,0,2,4,1078,1,2,0.468995594,391,0,0,45,42,3,3006,2941,65,18,18,0,100
22406a6071ec316c7131bcaa782b013f27b5b331,0,0,0,0,0,0,0,0,0,0,0,0,0,0,631,1,0,0,0,0,0,0,0,0,0,100
f90cfe826e2842edb4e4730a0c99cfa896e69ab2,14,827,578,249,3,0,3,2,7,693,1,6,3.083559032,2054,632,0,342,287,55,12557,11187,1370,138,116,22,97.36842105
6ec547baf267111127dd4fa9c5d78e6c37b40884,0,0,0,0,0,0,0,0,0,0,0,0,0,0,633,1,0,0,0,0,0,0,0,0,0,100
7225629b3721615c3c8818753ae1eb148a431695,0,0,0,0,0,0,0,0,0,0,0,0,0,0,0,0,0,0,0,0,0,0,0,0,0,100
c2895c4b32b7279fa9470022a942089f15c54f71,0,0,0,0,0,0,0,0,0,0,0,0,0,0,4,0,0,0,0,0,0,0,0,0,0,100
3da0c1920f047d0ca981f695de79f75fc5aa6f76,0,0,0,0,0,0,0,0,0,0,0,0,0,0,0,0,0,0,0,0,0,0,0,0,0,100
47ecb00e73fe4a446478427aa7b661c2cd16a575,0,0,0,0,0,0,0,0,0,0,0,0,0,0,0,0,0,0,0,0,0,0,0,0,0,100
7c1497f0bdcc85974815b09d6df275174854d154,12,833,39,794,10,0,10,1,3,145,2,5,3.295293885,151,634,0,88,22,66,5601,764,4837,65,9,56,96.91629956
3843382c5a38be9ba4e79120bc6f7270a5f0ae0a,0,0,0,0,0,0,0,0,0,0,0,0,0,0,1,0,0,0,0,0,0,0,0,0,0,100
298887363abfb108f6fea863be232e035029304d,0,0,0,0,0,0,0,0,0,0,0,0,0,0,5,0,0,0,0,0,0,0,0,0,0,100
e1eab692a1edf41bba5988f56f88b60b0c9cdb3d,0,0,0,0,0,0,0,0,0,0,0,0,0,0,1,0,0,0,0,0,0,0,0,0,0,100
dd174a4c2ccfda7ad6a73456857e57657904b2ba,0,0,0,0,0,0,0,0,0,0,0,0,0,0,635,1,0,0,0,0,0,0,0,0,0,100
7fce6ee1945e85190979763f0841631bf2e41e89,0,0,0,0,0,0,0,0,0,0,0,0,0,0,636,1,0,0,0,0,0,0,0,0,0,100
6675e70385824456bc73ff69a27a5a06fdfc6392,0,0,0,0,0,0,0,0,0,0,0,0,0,0,2,0,0,0,0,0,0,0,0,0,0,100
754836e2da847ab5a187546fafe8f5e46980a7dd,0,0,0,0,0,0,0,0,0,0,0,0,0,0,3,1,0,0,0,0,0,0,0,0,0,100
5c7222a5e755b51844db975186984551764d25c7,3,30,0,30,0,0,0,2,2,78,1,3,1.156676652,113,13,0,14,11,3,1110,902,208,12,10,2,100
84a69fc21d849b2692f0c05786633e56c51fb7f9,0,0,0,0,0,0,0,0,0,0,0,0,0,0,3,0,0,0,0,0,0,0,0,0,0,100
358ae3548032078205cf0d00d950cbd76977f33e,6,83,23,60,1,0,1,1,3,52,1,2,1.853269059,403,637,1,60,58,2,4295,3600,695,47,45,2,99.46409432
b69ebbffa0d92a2043bd5f4a2ba05aa2a2ba95e7,5,0,0,0,0,0,0,1,1,0,1,1,0,348,638,1,43,145,102,3054,8015,4961,34,100,66,100
d8f05bca55d916b6ecb1dc16e2df230405e90f40,0,0,0,0,0,0,0,0,0,0,0,0,0,0,639,2,0,0,0,0,0,0,0,0,0,100
213a8390366d6e325cbb03e7b107f47b1a7fbd3d,0,0,0,0,0,0,0,0,0,0,0,0,0,0,640,3,0,0,0,0,0,0,0,0,0,100
6ea2b7f72388beb65d2107557feb6dbcc0fad60f,0,0,0,0,0,0,0,0,0,0,0,0,0,0,0,0,0,0,0,0,0,0,0,0,0,100
dcec5fd323d7d02101e31289b9ab15c1c01d5211,0,0,0,0,0,0,0,0,0,0,0,0,0,0,0,0,0,0,0,0,0,0,0,0,0,100
55f87b8236b32cdd27c25dfb8d543e0e347be352,0,0,0,0,0,0,0,0,0,0,0,0,0,0,641,4,0,0,0,0,0,0,0,0,0,100
07e4987f0ac9aad6a0bbf77098e6539b8872ce02,0,0,0,0,0,0,0,0,0,0,0,0,0,0,4,0,0,0,0,0,0,0,0,0,0,100
6578dea5f58a1969b4aa149a62cb8daba2e8a1ef,4,62,3,59,0,0,0,2,3,48,1,3,1.459969937,320,10,0,49,45,4,3500,3041,459,37,34,3,100
3613a756d6e9a50fd2cb7cb0484e654249440598,0,0,0,0,0,0,0,0,0,0,0,0,0,0,642,1,0,0,0,0,0,0,0,0,0,100
1dbc30eef4251248573eed4b65ad59f8bf1af2b6,0,0,0,0,0,0,0,0,0,0,0,0,0,0,0,0,0,0,0,0,0,0,0,0,0,100
4838d7e491f405401969b98afc19ad5a51701dae,0,0,0,0,0,0,0,0,0,0,0,0,0,0,0,0,0,0,0,0,0,0,0,0,0,100
71c14946be4b33b1ce17e0b338c357d7dd89e7d6,0,0,0,0,0,0,0,0,0,0,0,0,0,0,1,1,0,0,0,0,0,0,0,0,0,100
6afe7785ae4fbbb2e18c272b0375458a10f2a61d,0,0,0,0,0,0,0,0,0,0,0,0,0,0,1,0,0,0,0,0,0,0,0,0,0,100
46fc348e41db58a51eeb70c1c7e87c0f95abb1fa,0,0,0,0,0,0,0,0,0,0,0,0,0,0,4,0,0,0,0,0,0,0,0,0,0,100
4be749a776b3a4744ff2bc80c1dff5e61526b257,0,0,0,0,0,0,0,0,0,0,0,0,0,0,0,0,0,0,0,0,0,0,0,0,0,100
02eefc1ce480c3f7722a39ab3aa5887b252c046d,0,0,0,0,0,0,0,0,0,0,0,0,0,0,0,0,0,0,0,0,0,0,0,0,0,100
5ef6ab3fe48e907a177da3af03092560d160f540,3,18,1,17,0,0,0,2,4,99,1,3,1.471354487,140,0,0,16,14,2,1389,1235,154,14,12,2,100
c59ab622ada2e133e3b075c830106c9cf5dcfb3b,4,26,0,26,0,0,0,3,5,360,2,4,1.75004993,203,0,0,31,27,4,1953,1770,183,23,20,3,100
a2b039c3a60385a269d9d70395ef5e6e0117d8d9,0,0,0,0,0,0,0,0,0,0,0,0,0,0,643,0,0,0,0,0,0,0,0,0,0,100
c34e7002bb78f752f0b692915b7d003a315a0647,0,0,0,0,0,0,0,0,0,0,0,0,0,0,644,1,0,0,0,0,0,0,0,0,0,100
4c2868a12fb3d02b60a9ae14b529a111f8d37239,0,0,0,0,0,0,0,0,0,0,0,0,0,0,645,2,0,0,0,0,0,0,0,0,0,100
8d39bf41845704d858df5ebeb5b1e32ef5a6613c,0,0,0,0,0,0,0,0,0,0,0,0,0,0,646,3,0,0,0,0,0,0,0,0,0,100
b03958d738b2a2fbcfe720a115787e2485f12ef4,3,35,1,34,0,0,0,2,6,92,1,3,1.188721876,104,0,0,16,12,4,1120,924,196,16,12,4,100
ce2710675108c59e3318679b0d0a2378fe51e9ce,4,35,2,33,0,0,0,4,7,16,2,4,1.809087486,228,0,0,36,31,5,2188,1961,227,26,23,3,100
ec852a9d22fa7694f58b03a5172583a8ae168fc6,0,0,0,0,0,0,0,0,0,0,0,0,0,0,0,0,0,0,0,0,0,0,0,0,0,100
37f495c6465abd3e2cccfc2c8d62b546b026bf83,0,0,0,0,0,0,0,0,0,0,0,0,0,0,1,0,0,0,0,0,0,0,0,0,0,100
cfbb8522b5f353320930253d9cd51fc20f85b610,0,0,0,0,0,0,0,0,0,0,0,0,0,0,647,4,0,0,0,0,0,0,0,0,0,100
92406035781a2fb0f8b6dddfd4714e96e3fb41ee,0,0,0,0,0,0,0,0,0,0,0,0,0,0,648,5,0,0,0,0,0,0,0,0,0,100
edb234e3edc712fc1a65ddc7cca8cc909eb61540,0,0,0,0,0,0,0,0,0,0,0,0,0,0,649,6,0,0,0,0,0,0,0,0,0,100
4fe38d5f8a61867c7db59c59ead637a2085eb66f,0,0,0,0,0,0,0,0,0,0,0,0,0,0,2,1,0,0,0,0,0,0,0,0,0,100
5874e1b2f616123de8dd433c9798ddbe3f009f41,4,52,7,45,0,0,0,5,8,4,2,4,1.744116981,257,0,0,43,36,7,2569,2188,381,29,26,3,100
c8d674020462249b9451b3f880a3c517ba974f55,4,22,4,18,0,0,0,6,9,0,2,4,1.699366016,297,0,0,45,43,2,2702,2569,133,31,29,2,100
d71b5604b0e6e9f91be6ec342e4cfe13bdd548ed,3,50,1,49,0,0,0,7,10,0,1,3,1.293669252,227,0,0,30,24,6,2505,2087,418,26,22,4,100
4e22dac89cd3035ef0379df8b2455f570865d320,3,49,1,48,0,0,0,8,11,0,1,3,1.259721832,270,0,0,38,30,8,2899,2505,394,30,26,4,100
2e5c6ef6e3cb64468a2986760b722aeea6ee03fd,4,99,7,92,0,0,0,9,12,0,2,4,1.646317216,399,0,0,72,59,13,4195,3514,681,46,39,7,100
52159191baef38ddca3c4198857e4a671c175454,0,0,0,0,0,0,0,0,0,0,0,0,0,0,0,0,0,0,0,0,0,0,0,0,0,100
16e6a254cd9e6c5c0802da57e7c78d7e6501737d,4,85,2,83,0,0,0,10,13,4,2,4,0.99446634,472,0,0,90,72,18,4846,4195,651,51,46,5,100
21cfa42e34e769e2dcc326d98bbcfd964f540d74,3,55,0,55,0,0,0,2,14,81,1,3,0.991882522,188,11,0,22,18,4,2157,1754,403,20,16,4,100
74f6d7eaa470a22ff73237048c7c2071bfa73014,2,25,0,25,0,0,0,3,15,48,1,2,0.242292189,111,5,0,16,13,3,1121,994,127,16,13,3,100
eaa94f0b885416b9f06a8142611ffe74330ad7de,0,0,0,0,0,0,0,0,0,0,0,0,0,0,650,0,0,0,0,0,0,0,0,0,0,100
ec6c74bde2f3cdab06ee08026c0ff58b99f9d3a1,0,0,0,0,0,0,0,0,0,0,0,0,0,0,651,1,0,0,0,0,0,0,0,0,0,100
5ff4ab04d9a2dac2d9f1e95e96cf3db5a5568e19,0,0,0,0,0,0,0,0,0,0,0,0,0,0,652,2,0,0,0,0,0,0,0,0,0,100
381c11d690ff9c80769beebdbbf878f6c6c2bfff,0,0,0,0,0,0,0,0,0,0,0,0,0,0,653,3,0,0,0,0,0,0,0,0,0,100
dae17a7a50b956899eb1366dbd0eb3ff75f5647a,0,0,0,0,0,0,0,0,0,0,0,0,0,0,1,0,0,0,0,0,0,0,0,0,0,100
56d73fd7bc9998390028b6d10b97a839ea21f819,0,0,0,0,0,0,0,0,0,0,0,0,0,0,654,2,0,0,0,0,0,0,0,0,0,100
9e6d9aca9e37ef5af8b80543bcb138a7bdd42b3f,2,40,1,39,0,0,0,3,5,118,1,2,0.801469893,193,0,0,22,20,2,2309,1880,429,20,18,2,100
44ae2e71845210bfae2b42ba25108dc742d00cdc,0,0,0,0,0,0,0,0,0,0,0,0,0,0,0,0,0,0,0,0,0,0,0,0,0,100
18e713b694aceed70c86b1edca93cbff94cab383,4,174,20,154,0,0,0,2,16,102,1,3,1.663038113,460,12,0,71,55,16,5650,4431,1219,58,43,15,100
308b8cfcfa5e08491d0c9ab6fc9df6a863744dfa,0,0,0,0,0,0,0,0,0,0,0,0,0,0,5,0,0,0,0,0,0,0,0,0,0,100
2d0c51f8c3d233029d1b9d6bd0401fa8bdca6469,0,0,0,0,0,0,0,0,0,0,0,0,0,0,6,0,0,0,0,0,0,0,0,0,0,100
c56f5d44e9ba303397757f5564e4869fbc506940,0,0,0,0,0,0,0,0,0,0,0,0,0,0,0,0,0,0,0,0,0,0,0,0,0,100
43b250fd6871e5eeba3a5668c277f9a50f4941f4,0,0,0,0,0,0,0,0,0,0,0,0,0,0,0,0,0,0,0,0,0,0,0,0,0,100
6881149f71ca6d5f14b3c2518ad21071104cf6e0,0,0,0,0,0,0,0,0,0,0,0,0,0,0,5,0,0,0,0,0,0,0,0,0,0,100
75e8b557ad4288d1ca802dd200dbe11276dfb32d,0,0,0,0,0,0,0,0,0,0,0,0,0,0,0,0,0,0,0,0,0,0,0,0,0,100
27b1e38f43e80dd29634013c7237f3da732a1d12,0,0,0,0,0,0,0,0,0,0,0,0,0,0,1,1,0,0,0,0,0,0,0,0,0,100
68f9f3a5dd036a1d048137c55dbc1cab67e682f8,0,0,0,0,0,0,0,0,0,0,0,0,0,0,2,2,0,0,0,0,0,0,0,0,0,100
6a8f26a9bd19f98e281c45e9c2babd32947b2848,0,0,0,0,0,0,0,0,0,0,0,0,0,0,3,3,0,0,0,0,0,0,0,0,0,100
71c83119da945df5c8e8d732796486d0d49e8c15,0,0,0,0,0,0,0,0,0,0,0,0,0,0,4,4,0,0,0,0,0,0,0,0,0,100
610025db76775838939216a023fd1840903f8453,0,0,0,0,0,0,0,0,0,0,0,0,0,0,5,5,0,0,0,0,0,0,0,0,0,100
6863cfe062cece50669383c698093d0d01504986,0,0,0,0,0,0,0,0,0,0,0,0,0,0,655,0,0,0,0,0,0,0,0,0,0,100
15085a597106581c5157eb274ee6bbaf16d1ee5e,0,0,0,0,0,0,0,0,0,0,0,0,0,0,656,1,0,0,0,0,0,0,0,0,0,100
727ffaad84c1239d730adc69464401ba9039ae08,0,0,0,0,0,0,0,0,0,0,0,0,0,0,657,2,0,0,0,0,0,0,0,0,0,100
f28ce2954cba032ecf703df9bc695804dc1efd38,0,0,0,0,0,0,0,0,0,0,0,0,0,0,6,0,0,0,0,0,0,0,0,0,0,100
a6e31f2ac58a4eb485f687d915573f969f8182f4,0,0,0,0,0,0,0,0,0,0,0,0,0,0,658,0,0,0,0,0,0,0,0,0,0,100
2ae9c1c0f316968b5bc59dc7b15aaaabf6518561,0,0,0,0,0,0,0,0,0,0,0,0,0,0,6,0,0,0,0,0,0,0,0,0,0,100
b8ae982b625ea072ebb9babd4acd457ae12078ec,0,0,0,0,0,0,0,0,0,0,0,0,0,0,659,1,0,0,0,0,0,0,0,0,0,100
e20da3a8de29421aebf88e6f4a2daaf76bd7b889,0,0,0,0,0,0,0,0,0,0,0,0,0,0,660,2,0,0,0,0,0,0,0,0,0,100
54b27cb5bab3168390e403260c6c702e21b338e0,0,0,0,0,0,0,0,0,0,0,0,0,0,0,0,0,0,0,0,0,0,0,0,0,0,100
c11889b97c5c74e205b1a03f148f6eee6d3a9c0e,0,0,0,0,0,0,0,0,0,0,0,0,0,0,1,1,0,0,0,0,0,0,0,0,0,100
3c8c1d6587c9429b3ff214950de423aa106f6e38,0,0,0,0,0,0,0,0,0,0,0,0,0,0,2,2,0,0,0,0,0,0,0,0,0,100
74c6d8510a0d3e2e2ba33c3b9630a954a2ddd8f8,0,0,0,0,0,0,0,0,0,0,0,0,0,0,3,3,0,0,0,0,0,0,0,0,0,100
4b9e2c960d336dd4ddfb80162e34b6d7ad2f8408,0,0,0,0,0,0,0,0,0,0,0,0,0,0,4,4,0,0,0,0,0,0,0,0,0,100
ef8052bae131b1f45fc10a5098b2707454139e67,0,0,0,0,0,0,0,0,0,0,0,0,0,0,5,5,0,0,0,0,0,0,0,0,0,100
effcd052c5aac528a9da0959d49e8872faaaab63,0,0,0,0,0,0,0,0,0,0,0,0,0,0,6,6,0,0,0,0,0,0,0,0,0,100
4623e5d6a9138e68875075957c445d78f74490d4,0,0,0,0,0,0,0,0,0,0,0,0,0,0,7,7,0,0,0,0,0,0,0,0,0,100
67538d22cdfcf7f89d530f4507b9ae0a04674b57,0,0,0,0,0,0,0,0,0,0,0,0,0,0,8,8,0,0,0,0,0,0,0,0,0,100
efb79600064f21a6f45c6c3fcc5576b20d4e876d,0,0,0,0,0,0,0,0,0,0,0,0,0,0,9,9,0,0,0,0,0,0,0,0,0,100
bcb1803c24dc9decfb113a31db8fc14433be025b,0,0,0,0,0,0,0,0,0,0,0,0,0,0,661,3,0,0,0,0,0,0,0,0,0,100
f81ddcbda5e146ba3f193a521a9567c30f45f4bf,0,0,0,0,0,0,0,0,0,0,0,0,0,0,662,4,0,0,0,0,0,0,0,0,0,100
f2e61b85dc95235bffd5aa49a8db35ad0735f1a7,15,363,78,285,4,0,4,12,17,753,3,10,2.558760435,2508,7,0,355,290,65,19590,17139,2451,188,151,37,97.96137339
bf8e5db3ad6675187105b41a6ab2b1d59d7e9c02,0,0,0,0,0,0,0,0,0,0,0,0,0,0,0,0,0,0,0,0,0,0,0,0,0,100
400a9e45aceed4479520369e80c9d6746a22a591,4,26,26,0,0,0,0,3,11,340,1,1,1.536791896,415,7,1,36,36,0,3914,3922,8,36,36,0,100
6ade4b0cb16288ddd98ff2914fe37080ea98d5ca,1,1,0,1,0,0,0,11,12,0,1,1,0,152,8,2,18,18,0,1526,1524,2,18,18,0,100
da7bbbc7cae10916def12c12ea8d279ae0864694,0,0,0,0,0,0,0,0,0,0,0,0,0,0,1,0,0,0,0,0,0,0,0,0,0,100
36af55aedbb7aa3e65c1f98d1ecfae0615253897,0,0,0,0,0,0,0,0,0,0,0,0,0,0,9,3,0,0,0,0,0,0,0,0,0,100
e317adacf1c1a3a6f2922db0403437fa200c875f,2,10,1,9,0,0,0,11,14,0,1,2,0.845350937,294,10,4,36,35,1,3153,3061,92,36,35,1,100
4b7df8e0d18786dde6d5c57b6a1deacf7caac36f,0,0,0,0,0,0,0,0,0,0,0,0,0,0,663,4,0,0,0,0,0,0,0,0,0,100
59e8797d4c262b9ed29aeeaba26581fc5d6ea3ab,2,4,6,2,0,0,0,11,15,0,1,2,0.721928095,302,11,5,36,36,0,3133,3153,20,36,36,0,100
a0ba099bd103fe775eb8351dc117fe1c46a88989,2,25,0,25,0,0,0,3,4,92,1,1,0.855450811,251,12,6,42,39,3,2554,2363,191,30,27,3,100
67d1a41c28814d6cbc4f0e4665ba5463b55eb8ff,4,27,2,25,0,0,0,11,18,0,2,4,1.73442676,444,13,7,65,61,4,4384,4190,194,59,56,3,100
47f79204f3b289082fbc1a0b3fab35660f73ff24,1,5,1,4,0,0,0,2,2,2,1,1,0,173,14,7,47,44,3,1359,1310,49,15,14,1,100
26aba91ead4f06558880be7dda745cf3c05581e8,5,68,0,68,0,0,0,11,19,0,2,5,1.941728396,643,15,8,122,112,10,6325,5743,582,82,74,8,100
cd191f570af55971c465a497148d7c84b6121db5,4,53,1,52,0,0,0,11,20,0,2,4,1.846393983,516,16,9,80,72,8,5285,4861,424,72,66,6,100
82ed264786d80b1e26faffcb31f4b348c2759bab,0,0,0,0,0,0,0,0,0,0,0,0,0,0,17,10,0,0,0,0,0,0,0,0,0,100
a93e902b355bdc8f3d3d0409960e23219a3a3ea8,0,0,0,0,0,0,0,0,0,0,0,0,0,0,18,11,0,0,0,0,0,0,0,0,0,100
4aecd0e4e6e3d6c76c3f3c6d88b1fa16123a3940,13,126,10,116,0,0,0,11,21,464,3,12,2.518916892,2070,19,12,296,272,24,16836,15829,1007,184,170,14,98.83103082
f665e454725f1545ac96a1fc705de63b45553310,0,0,0,0,0,0,0,0,0,0,0,0,0,0,664,1,0,0,0,0,0,0,0,0,0,100
547ff40466b79fc9f54f771afa78306f85fefefd,0,0,0,0,0,0,0,0,0,0,0,0,0,0,0,0,0,0,0,0,0,0,0,0,0,100
d7b1382df343e5455d25470eac37c205995d0d2a,8,355,38,317,3,0,3,3,22,8,1,3,2.292512221,765,665,2,112,85,27,9346,7233,2113,95,73,22,99.06152242
5c7ac9a64774c44a3071588b06101106bbefe395,6,129,0,129,0,0,0,11,23,38,2,4,2.277532103,977,20,13,148,137,11,10384,9538,846,128,118,10,100
7623e7b9599e8da9394af8425d82e647429b1ae9,4,92,16,76,0,0,0,11,24,0,2,4,1.688596463,723,21,14,123,110,13,7322,6686,636,104,92,12,98.96694215
59a1ab44173e76783bfd131a254bf716a7df90bd,0,0,0,0,0,0,0,0,0,0,0,0,0,0,0,0,0,0,0,0,0,0,0,0,0,100
26d65d4e7f5add374c8089dfdf974d7cb830ee01,0,0,0,0,0,0,0,0,0,0,0,0,0,0,666,3,0,0,0,0,0,0,0,0,0,100
24a9bb8f9523e776eff92fe7ab202c396bc83583,0,0,0,0,0,0,0,0,0,0,0,0,0,0,667,3,0,0,0,0,0,0,0,0,0,100
a917aec6e72cda4abf55530cd793d835f4fb1185,0,0,0,0,0,0,0,0,0,0,0,0,0,0,668,4,0,0,0,0,0,0,0,0,0,100
ec6844572336bd2860a1d54db068ed0ddadeb430,4,69,0,69,0,0,0,11,25,32,2,4,1.77125896,789,22,2,135,123,12,7841,7322,519,113,104,9,100
58bc459d435fda9846420f3d778718c4f8df0d93,0,0,0,0,0,0,0,0,0,0,0,0,0,0,23,3,0,0,0,0,0,0,0,0,0,100
0083d2c3a9c3443013c9de0dca1e6e368196294f,4,51,0,51,0,0,0,11,26,0,2,4,1.76091812,849,24,4,144,135,9,8267,7841,426,119,113,6,100
18abae4817b34438c1d1096bf01f0cd99d389170,0,0,0,0,0,0,0,0,0,0,0,0,0,0,25,5,0,0,0,0,0,0,0,0,0,100
e8077154e27dc191dcedb953b5ec978de3bdd8e5,4,23,2,21,0,0,0,11,27,0,2,4,1.939470571,894,26,6,147,144,3,8446,8267,179,122,119,3,100
abd142dc930990c0deeb4c50b06895bf55e01fcf,4,20,0,20,0,0,0,11,28,0,2,4,1.739353872,912,27,7,150,147,3,8617,8446,171,125,122,3,100
c4e37bae0199d4b7fa22e60c68561715b517a8d1,5,58,43,15,0,0,0,3,6,1613,1,3,1.498306437,581,669,3,71,73,2,3796,3686,110,32,29,3,99.69104016
dad4e5ee0754f3b694eca830e7335560f85f2e03,4,63,0,63,0,0,0,11,29,4,2,4,1.760835283,929,28,6,160,150,10,9087,8617,470,134,125,9,100
75a769526019a879ae288cc60d4d1748f81fba3b,0,0,0,0,0,0,0,0,0,0,0,0,0,0,29,7,0,0,0,0,0,0,0,0,0,100
2e99867ea2660bf8eda49dc5e14aecfdbc217799,0,0,0,0,0,0,0,0,0,0,0,0,0,0,670,3,0,0,0,0,0,0,0,0,0,100
72479374805bd02a582b5e4f31a3d72ca9084a72,0,0,0,0,0,0,0,0,0,0,0,0,0,0,671,2,0,0,0,0,0,0,0,0,0,100
54942047b91a4f60f6d6e3128b73f4c9a7342982,0,0,0,0,0,0,0,0,0,0,0,0,0,0,6,0,0,0,0,0,0,0,0,0,0,100
65080422b6256a0f12cc74347ac2ed531d26a4f6,4,23,1,22,0,0,0,11,30,24,2,4,1.903107168,983,30,8,163,160,3,9267,9087,180,137,134,3,100
9a1f54593fa60cdfb49bb1de77a5e17b332a6a02,0,0,0,0,0,0,0,0,0,0,0,0,0,0,31,4,0,0,0,0,0,0,0,0,0,100
82c923d6d579818fa4257100e59b370458567889,4,110,1,109,0,0,0,11,31,8,2,4,1.720949256,1002,32,4,185,163,22,10147,9267,880,149,137,12,100
30b727aa9f57a3a05edecd9ab4c239b02ef9999c,0,0,0,0,0,0,0,0,0,0,0,0,0,0,672,2,0,0,0,0,0,0,0,0,0,100
ff54bd3f1a8911fd81cc0372999a403c7c62fb47,0,0,0,0,0,0,0,0,0,0,0,0,0,0,1,0,0,0,0,0,0,0,0,0,0,100
3c082ffd281ca31b62b78ef3e9010f46800adb06,4,27,1,26,0,0,0,11,32,48,2,4,1.867411697,1093,1,0,190,185,5,10350,10147,203,152,149,3,100
a352a7b6019ecb815ad83478cc0e755bd6e5a26f,0,0,0,0,0,0,0,0,0,0,0,0,0,0,673,1,0,0,0,0,0,0,0,0,0,100
206936a04fe9fdb153bab71ad330e062711421ab,4,37,3,34,0,0,0,11,33,4,2,4,1.693787875,1116,33,0,198,190,8,10686,10350,336,156,152,4,100
ff2a4dd0e801d3338472279910aa8505c27bd1df,3,150,0,150,0,0,0,4,34,206,1,3,0.815727214,207,1,0,36,21,15,2666,1721,945,36,21,15,100
eb774081da9673bc3777d38fe5bafa37105ec560,3,65,2,63,0,0,0,12,31,0,2,3,1.377145533,1070,7,0,202,196,6,10644,10141,503,157,154,3,100
b2ee308efecbf04acec54f396b9fa3d1da3876fc,18,1209,167,1042,6,0,6,4,7,946,2,5,3.385733051,1165,2,1,273,144,129,13582,7966,5616,144,75,69,97.965412
a8449b0b9d34a8adf77dea94b6b5909e1779bb90,0,0,0,0,0,0,0,0,0,0,0,0,0,0,674,1,0,0,0,0,0,0,0,0,0,100
8d7e3fbedad3b643e409714c055b654f742cd812,0,0,0,0,0,0,0,0,0,0,0,0,0,0,7,0,0,0,0,0,0,0,0,0,0,100
bba5444729555b93df59a36f44e71ef99a2f1d1f,0,0,0,0,0,0,0,0,0,0,0,0,0,0,0,0,0,0,0,0,0,0,0,0,0,100
3533b9f38618c4916991ec741ef66f0b64a2462c,2,11,0,11,0,0,0,3,18,126,1,2,0.945660305,499,8,1,148,145,3,3834,3778,56,68,66,2,100
0a6f26a0e0eace87243dd919738af5f182557b8a,0,0,0,0,0,0,0,0,0,0,0,0,0,0,0,0,0,0,0,0,0,0,0,0,0,100
cfaed6ae07a5412f2b98ddf81b46b89f9d96e8c4,1,107,6,101,0,0,0,6,19,7,1,1,0,315,3,1,116,96,20,2995,2332,663,61,51,10,100
20283d63599323909c23cf0f06079258eb8003ba,0,0,0,0,0,0,0,0,0,0,0,0,0,0,1,1,0,0,0,0,0,0,0,0,0,100
0004580325e3c268ebdaab318e33aff823f4a2fd,1,40,0,40,0,0,0,2,2,52,1,1,0,105,0,0,29,20,9,695,484,211,20,11,9,100
dcba933f9343094969bf95fae8844599ca41e3fd,0,0,0,0,0,0,0,0,0,0,0,0,0,0,4,1,0,0,0,0,0,0,0,0,0,100
c455a8358f7a72156f5fae54725d3f68ce01274b,0,0,0,0,0,0,0,0,0,0,0,0,0,0,675,0,0,0,0,0,0,0,0,0,0,100
77a9bb5b207afdfecc3104a2b493e65756a706ae,0,0,0,0,0,0,0,0,0,0,0,0,0,0,676,1,0,0,0,0,0,0,0,0,0,100
3c7e5be68c267946501ded6da9d18421db947968,0,0,0,0,0,0,0,0,0,0,0,0,0,0,677,2,0,0,0,0,0,0,0,0,0,100
2e9c58b015159e491f4d7ed0a5c8825ca13dc3f2,0,0,0,0,0,0,0,0,0,0,0,0,0,0,0,0,0,0,0,0,0,0,0,0,0,100
871acef424f14aaea074aac3a6f71a7c63600459,0,0,0,0,0,0,0,0,0,0,0,0,0,0,678,3,0,0,0,0,0,0,0,0,0,100
4b989de84d9ec9ee202cd8c10fb5f37bae83ba2d,0,0,0,0,0,0,0,0,0,0,0,0,0,0,1,1,0,0,0,0,0,0,0,0,0,100
da9ab224b1a57746ea6e2381606762eb25174f9c,0,0,0,0,0,0,0,0,0,0,0,0,0,0,2,2,0,0,0,0,0,0,0,0,0,100
1a0c8e237344c8e2ef95b1eb3104881021d37105,0,0,0,0,0,0,0,0,0,0,0,0,0,0,1,1,0,0,0,0,0,0,0,0,0,100
5c88ab4997de9d09c14b06234d72e384728cd9e0,2,13,0,13,0,0,0,3,20,60,1,2,0.89049164,598,9,0,172,168,4,4587,4497,90,80,78,2,100
b2c25dcd9331103193622d04a09a6271e9ce642e,0,0,0,0,0,0,0,0,0,0,0,0,0,0,679,4,0,0,0,0,0,0,0,0,0,100
b055bf2b90e75b6b76268bd5fb19b97cfe0f6a8a,0,0,0,0,0,0,0,0,0,0,0,0,0,0,680,5,0,0,0,0,0,0,0,0,0,100
a2946638e91c9a95c2d5841bbf0f4d799a8ac5a6,0,0,0,0,0,0,0,0,0,0,0,0,0,0,681,6,0,0,0,0,0,0,0,0,0,100
b13412e96ac20de87cb7803fa664acaf0930d1c0,0,0,0,0,0,0,0,0,0,0,0,0,0,0,682,7,0,0,0,0,0,0,0,0,0,100
01d314b3b0f93a67f3b2094dec5bf959166d2eb2,3,46,2,44,2,0,2,5,8,84,2,3,1.308502445,147,10,1,26,23,3,1809,1497,312,23,21,2,99.29859719
fc8740ab4d1c2d22dce0858ae6fb1d8324b2ed60,2,26,0,26,0,0,0,2,2,0,1,2,1,34,683,8,3,3,0,297,297,0,2,2,0,100
057b87b9d8ed593468953dc95814db07068b0d74,0,0,0,0,0,0,0,0,0,0,0,0,0,0,3,3,0,0,0,0,0,0,0,0,0,100
dc36f554c844eeb896113b3362008d917d4a0a0a,0,0,0,0,0,0,0,0,0,0,0,0,0,0,4,4,0,0,0,0,0,0,0,0,0,100
8f7242ef06d52a5542942d36aac9dcd0b40ff738,0,0,0,0,0,0,0,0,0,0,0,0,0,0,684,9,0,0,0,0,0,0,0,0,0,100
d9e7a7afe8fd873829cc1da4ea7596ef76fbf50a,0,0,0,0,0,0,0,0,0,0,0,0,0,0,0,0,0,0,0,0,0,0,0,0,0,100
ab4d8266fe9b48b451b13c40d0a44747936db311,4,71,1,70,0,0,0,13,35,102,2,4,1.668432007,1297,0,0,240,226,14,12551,11911,640,179,171,8,100
8489b2d604f8b5039707d805386292e0a3b9c245,0,0,0,0,0,0,0,0,0,0,0,0,0,0,2,1,0,0,0,0,0,0,0,0,0,100
fd8100896029f4338a2c8d3f885ba3a7cf0328a6,0,0,0,0,0,0,0,0,0,0,0,0,0,0,685,0,0,0,0,0,0,0,0,0,0,100
611b321d2e9b5047f63e5661e0dcc465b7df3f7c,0,0,0,0,0,0,0,0,0,0,0,0,0,0,686,1,0,0,0,0,0,0,0,0,0,100
d5fe2b46d45215f1703cbb43a181d040fd43c28e,2,67,63,4,1,0,1,1,5,656,1,2,0.871683617,135,11,0,17,20,3,794,666,128,15,18,3,99.80079681
7b9396d6bb3d083bec1fccfdb98d2007fcfe9df9,4,41,0,41,0,0,0,14,36,32,2,4,1.618198507,1360,0,0,248,240,8,12910,12551,359,183,179,4,100
5c0f92701b45d49dbab78a5366776e30b0fef834,6,143,1,142,0,0,0,4,37,142,2,5,2.329001226,761,0,0,103,84,19,8647,7376,1271,82,68,14,100
460f09700f44295f5687fda03bdb00ec7aeb4a4e,0,0,0,0,0,0,0,0,0,0,0,0,0,0,687,2,0,0,0,0,0,0,0,0,0,100
a9281884851c3e5859f69e153c662101a1fca466,1,6,3,3,0,0,0,1,2,2285,1,1,0,352,688,3,42,42,0,1972,1990,18,20,20,0,100
9fff785091bbbc6a405acec0bf719ab5876e854f,0,0,0,0,0,0,0,0,0,0,0,0,0,0,689,4,0,0,0,0,0,0,0,0,0,100
7dbefc411fa644132c8d37a33c29f771f3ccb0cf,2,8,8,0,0,0,0,1,23,178,2,2,1,478,690,5,132,132,0,3532,3524,8,67,67,0,100
cd3ef7a4add68930f6dd139f8e3b290f5cfe2c0d,1,9,9,0,0,0,0,9,24,0,1,1,0,445,691,6,129,130,1,3340,3344,4,65,65,0,100
0bdf78145f214e25dc6c6647621481eab2ac5692,4,403,1,402,3,0,3,1,2,572,1,3,1.522147414,156,692,7,55,15,40,2867,1336,1531,22,5,17,99.40711462
6dd09113187f687d9dbe30de7a7ea96a09046685,0,0,0,0,0,0,0,0,0,0,0,0,0,0,693,8,0,0,0,0,0,0,0,0,0,100
713d99e00b62489bf62bc855bd0df32a7d0d73b9,1,18,0,18,0,0,0,2,2,27,1,1,0,30,694,9,4,4,0,238,238,0,4,4,0,100
95502ef0cb7d4ee798d3f67a7307b835c904214a,0,0,0,0,0,0,0,0,0,0,0,0,0,0,695,10,0,0,0,0,0,0,0,0,0,100
da1d4a50691860ad7b97683eaed6072e5f4fdb30,0,0,0,0,0,0,0,0,0,0,0,0,0,0,696,11,0,0,0,0,0,0,0,0,0,100
058d21a229d21af90ffbd79d410ddf23c756d38f,0,0,0,0,0,0,0,0,0,0,0,0,0,0,0,0,0,0,0,0,0,0,0,0,0,100
8c319fa2de0d05dcb276e45550b86b7538cde501,0,0,0,0,0,0,0,0,0,0,0,0,0,0,697,12,0,0,0,0,0,0,0,0,0,100
68c8527c9aba3850ed202b09d2acfcd37feef3e3,0,0,0,0,0,0,0,0,0,0,0,0,0,0,7,0,0,0,0,0,0,0,0,0,0,100
ee1042bf121f0fc831299f4ac675c23b1c4df118,2,28,0,28,0,0,0,2,6,16,1,2,0.811278124,155,12,1,21,17,4,933,794,139,18,15,3,100
137bd050de185b1174dc936d8ce89467cce1946a,0,0,0,0,0,0,0,0,0,0,0,0,0,0,5,0,0,0,0,0,0,0,0,0,0,100
35044f719e69e6c2e14e0e488d1898de114c3f7b,0,0,0,0,0,0,0,0,0,0,0,0,0,0,13,2,0,0,0,0,0,0,0,0,0,100
79e2039bebdff6894dbc0d75ecf8922bca85c242,0,0,0,0,0,0,0,0,0,0,0,0,0,0,698,11,0,0,0,0,0,0,0,0,0,100
f6cd274f91fa4b870c1e346c521aa8bde04b472d,4,39,0,39,0,0,0,15,38,42,2,4,1.679375518,1402,1,1,251,247,4,13325,12924,401,187,183,4,100
1957b9694685cdae62a37a1fe54023d915a8a5bf,0,0,0,0,0,0,0,0,0,0,0,0,0,0,699,12,0,0,0,0,0,0,0,0,0,100
5c0b334e1731e18346c84f383fa0b6fda93684f2,0,0,0,0,0,0,0,0,0,0,0,0,0,0,700,13,0,0,0,0,0,0,0,0,0,100
4e220a9c06c5bdd3fb5d490830e60ab4c18cc27f,0,0,0,0,0,0,0,0,0,0,0,0,0,0,701,3,0,0,0,0,0,0,0,0,0,100
c4e649adeb7f85fe24316ff135d7e9b3c44b1f3b,15,2385,34,2351,14,0,14,4,6,26,2,3,3.472588706,173,6,0,268,28,240,17017,1101,15916,138,9,129,97.04480458
8ddd353a68aea026e04f9edf7807f9822c2d8384,0,0,0,0,0,0,0,0,0,0,0,0,0,0,7,1,0,0,0,0,0,0,0,0,0,100
0f5235f76be101140bbae81e9beb4a53d75cc3fe,1,71,52,19,0,0,0,1,2,6,1,1,0,275,8,2,47,46,1,2048,1960,88,22,21,1,100
91af71136d8bc96684ade11615f67ade08b8be64,0,0,0,0,0,0,0,0,0,0,0,0,0,0,8,0,0,0,0,0,0,0,0,0,0,100
d2d5336dc0e4349b5828617a8f389d10d2b13e5c,1,0,3,3,0,0,0,5,7,80,1,1,0,304,9,1,46,46,0,3132,3164,32,32,32,0,100
6c6e8ce40094afbf737982f8f48f9758b127261d,7,672,5,667,2,0,2,16,39,45,2,6,1.657656113,1636,2,0,395,306,89,19324,14897,4427,245,205,40,99.26199262
4d23fb4649b6f05fd13c9880bb04a2fbc4f1c4e9,7,267,158,109,1,0,1,1,8,1231,2,5,2.086328359,1161,702,1,207,198,9,8106,7814,292,81,82,1,99.63235294
112596a315577dc12d40e70fcda9b03ad38bd574,0,0,0,0,0,0,0,0,0,0,0,0,0,0,9,3,0,0,0,0,0,0,0,0,0,100
35d6c43e83e035686a22f50eea7c2ef3b9cfbd72,0,0,0,0,0,0,0,0,0,0,0,0,0,0,3,1,0,0,0,0,0,0,0,0,0,100
78cad1b5b6b13b9f87f117f1c70fe8b41b5634bb,0,0,0,0,0,0,0,0,0,0,0,0,0,0,4,2,0,0,0,0,0,0,0,0,0,100
43e1d793a746389d1dfe068467cb7f4a525ac54d,14,204,233,29,2,0,2,5,8,324,3,7,2.881831093,2085,14,0,354,360,6,13716,13833,117,154,152,2,93.91080617
9229439f0111a86bee7e9c78a81af9419140b2c0,0,0,0,0,0,0,0,0,0,0,0,0,0,0,15,1,0,0,0,0,0,0,0,0,0,100
5d297413896f4751d0368cc66f94c999788285f2,0,0,0,0,0,0,0,0,0,0,0,0,0,0,703,0,0,0,0,0,0,0,0,0,0,100
596132e52afbb274e7657d09cd51bbfe036833d2,0,0,0,0,0,0,0,0,0,0,0,0,0,0,704,1,0,0,0,0,0,0,0,0,0,100
8f95a2d7e3d6ebf33262bc1d20d4505197f9bedf,0,0,0,0,0,0,0,0,0,0,0,0,0,0,705,2,0,0,0,0,0,0,0,0,0,100
cfa1762ded2b8b77cd1cc84f0bec934112e5e6cf,0,0,0,0,0,0,0,0,0,0,0,0,0,0,706,3,0,0,0,0,0,0,0,0,0,100
ee98f555ff0f8c0cd7f30dd02ac0418ee7f17523,2,53,0,53,0,0,0,3,4,148,1,2,0.941423108,78,16,2,15,11,4,941,720,221,10,6,4,100
2999d8353d5cdcb7498526209bab0febf1a2d1d4,0,0,0,0,0,0,0,0,0,0,0,0,0,0,10,0,0,0,0,0,0,0,0,0,0,100
8f805fb8a398e114add86f63980918cca2286f9f,1,23,0,23,1,0,1,1,1,0,1,1,0,0,1,0,0,0,0,11,0,11,0,0,0,99.83948636
1de8831cfa15bbb7a57b99d9809eca6976da15c8,0,0,0,0,0,0,0,0,0,0,0,0,0,0,0,0,0,0,0,0,0,0,0,0,0,100
500e0460c3b08a2daca19649138d24b34b7c7e14,0,0,0,0,0,0,0,0,0,0,0,0,0,0,1,1,0,0,0,0,0,0,0,0,0,100
ceb1724bb3b3deafbe3dcfa4509530ecfd2cb6c3,0,0,0,0,0,0,0,0,0,0,0,0,0,0,2,2,0,0,0,0,0,0,0,0,0,100
de2d2d84d9c1339fc91d6e94edc48b2f03116cdf,0,0,0,0,0,0,0,0,0,0,0,0,0,0,3,3,0,0,0,0,0,0,0,0,0,100
41e42c560cec06d308cfc6d262c1abf75fa4a5fa,2,5,5,0,0,0,0,6,8,109,2,2,0.970950594,498,4,4,98,98,0,4702,4702,0,48,48,0,100
a02629b5096f8a29c9016aff0bf2d18ceae34e96,7,9,9,0,0,0,0,2,9,1949,1,7,2.641604168,1072,5,5,114,114,0,6309,6309,0,72,72,0,100
b0b74295a1899c94fdadf2497ea671111fc4f235,0,0,0,0,0,0,0,0,0,0,0,0,0,0,6,6,0,0,0,0,0,0,0,0,0,100
37766cfe325f8b98c91b789511f49f9e04b541aa,1,1,1,0,0,0,0,2,2,2336,1,1,0,39,7,7,4,4,0,378,378,0,3,3,0,100
ff561824abf04b7515902e201d76e36c04d7abaa,5,82,37,45,0,0,0,1,2,135,1,2,2.069270266,920,11,1,105,105,0,6783,6534,249,51,48,3,100
147a377ab7dafe4e45b151d8efed9203fea97a88,1,9,0,9,0,0,0,17,36,117,1,1,0,488,12,2,65,64,1,4898,4840,58,65,64,1,100
5a91619aa85af33e7c9176470b6382aa29163b6c,0,0,0,0,0,0,0,0,0,0,0,0,0,0,0,0,0,0,0,0,0,0,0,0,0,100
abe41fab92c12d9c0693fd70312abd5723adad24,0,0,0,0,0,0,0,0,0,0,0,0,0,0,13,3,0,0,0,0,0,0,0,0,0,100
9b99d24a65b1e4467275fb1d632ef5fee1fefce9,0,0,0,0,0,0,0,0,0,0,0,0,0,0,14,4,0,0,0,0,0,0,0,0,0,100
b3ce9012d6a87b89d68227d9c56e42e65e45f651,0,0,0,0,0,0,0,0,0,0,0,0,0,0,1,1,0,0,0,0,0,0,0,0,0,100
edc61144ad9c1f4afaaee0616e3937d4b54521b3,1,0,33,33,0,0,0,3,4,551,1,1,0,234,17,0,22,25,3,1775,2044,269,9,10,1,100
ef8a0d05676ecc4ec2747db5cf005928be4dead1,10,543,29,514,3,0,3,7,40,64,2,6,2.735031215,2201,1,0,453,399,54,25517,21184,4333,298,265,33,93.88794567
fcf57c0c55b22e4f26288af124dccf8a59b82475,7,430,0,430,7,0,7,1,1,0,1,2,2.733017876,0,18,1,32,0,32,2590,0,2590,21,0,21,98.48888889
e6f8dc5f7b31af5b76f19b347ab8388b7b2dd53c,0,0,0,0,0,0,0,0,0,0,0,0,0,0,8,1,0,0,0,0,0,0,0,0,0,100
b1886b05449efb47cb01656e79d8f153c9060cb1,0,0,0,0,0,0,0,0,0,0,0,0,0,0,707,0,0,0,0,0,0,0,0,0,0,100
48d516ab84f3276ea15d4d3aa5faffd500fdd065,0,0,0,0,0,0,0,0,0,0,0,0,0,0,19,2,0,0,0,0,0,0,0,0,0,100
b74c0d8d7fb16a5c25ee5ef3255bf396fecb7418,0,0,0,0,0,0,0,0,0,0,0,0,0,0,9,1,0,0,0,0,0,0,0,0,0,100
a89bb43207ec60d6e4a630b6f0f825aa043367ee,0,0,0,0,0,0,0,0,0,0,0,0,0,0,10,2,0,0,0,0,0,0,0,0,0,100
a67b8df0ab18d91840c441f267184cae48430652,0,0,0,0,0,0,0,0,0,0,0,0,0,0,2,2,0,0,0,0,0,0,0,0,0,100
2d8709d312ea25c7196028b83d950d0ac4c0b354,0,0,0,0,0,0,0,0,0,0,0,0,0,0,3,2,0,0,0,0,0,0,0,0,0,100
697306edab3e215c6d932ecbac6113609c95032a,0,0,0,0,0,0,0,0,0,0,0,0,0,0,4,2,0,0,0,0,0,0,0,0,0,100
097efb66875f60fc75df30ca5a3d63a7b0dd5db7,0,0,0,0,0,0,0,0,0,0,0,0,0,0,5,3,0,0,0,0,0,0,0,0,0,100
c8891c69de234fcb0a02dbf01cbabfc73938f5ab,0,0,0,0,0,0,0,0,0,0,0,0,0,0,6,4,0,0,0,0,0,0,0,0,0,100
89916d880f6f38b918898f87c08ab6d8917f507d,0,0,0,0,0,0,0,0,0,0,0,0,0,0,5,0,0,0,0,0,0,0,0,0,0,100
84e67f6f1d75b5774b501165f0f8f0cb62fa4564,1,5,5,0,0,0,0,6,8,133,1,1,0,150,6,1,31,31,0,1587,1587,0,26,26,0,100
c3da9d9fd531412ca523692ec08a652536524161,0,0,0,0,0,0,0,0,0,0,0,0,0,0,708,1,0,0,0,0,0,0,0,0,0,100
e292a9eb6df54710abdeb2d920b08b5c7bfb7b03,0,0,0,0,0,0,0,0,0,0,0,0,0,0,7,2,0,0,0,0,0,0,0,0,0,100
fb1881e3907214e5a8c012f18bfba9f3663489a7,0,0,0,0,0,0,0,0,0,0,0,0,0,0,8,3,0,0,0,0,0,0,0,0,0,100
2664cd792040ee7f56e28d34665ae2b7dc74b4eb,0,0,0,0,0,0,0,0,0,0,0,0,0,0,15,0,0,0,0,0,0,0,0,0,0,100
ddde1f06014a660b09e97dae709a6be1e1fba943,0,0,0,0,0,0,0,0,0,0,0,0,0,0,16,1,0,0,0,0,0,0,0,0,0,100
7b107f91bf3bd2dba155d8c84234a90f9034da53,0,0,0,0,0,0,0,0,0,0,0,0,0,0,17,2,0,0,0,0,0,0,0,0,0,100
51217435a76225c2ce8b5c8aba08df6b4baef228,0,0,0,0,0,0,0,0,0,0,0,0,0,0,18,3,0,0,0,0,0,0,0,0,0,100
a0628e16441cb5318dff94e5ccd7ca427730c62f,2,59,0,59,1,0,1,4,7,135,1,2,0.616166193,125,19,4,20,16,4,760,649,111,15,13,2,99.82517483
a7a258163301edfd45e3af2177c752115a5b4889,0,0,0,0,0,0,0,0,0,0,0,0,0,0,7,4,0,0,0,0,0,0,0,0,0,100
7dfa2c3f566beade3cd524ab64327fcde836e6e8,2,22,10,12,0,0,0,18,38,66,2,2,0.988699408,989,9,4,203,200,3,8754,8676,78,134,134,0,100
4106230ffff7873d370e0acd6d20f0802487a53e,1,18,0,18,0,0,0,2,2,69,1,1,0,78,709,1,19,19,0,755,755,0,10,10,0,100
5583319385ca6f95c4041615f570a09a8495d836,0,0,0,0,0,0,0,0,0,0,0,0,0,0,710,2,0,0,0,0,0,0,0,0,0,100
36fec86179b25b09fcdec01020e0e037976966f8,0,0,0,0,0,0,0,0,0,0,0,0,0,0,711,3,0,0,0,0,0,0,0,0,0,100
422e7e09fceb049e0a0ddff1fb50d7e121d48bc0,0,0,0,0,0,0,0,0,0,0,0,0,0,0,712,4,0,0,0,0,0,0,0,0,0,100
0bcfa656205153933385b66b4b27c61bbaff7fad,0,0,0,0,0,0,0,0,0,0,0,0,0,0,0,0,0,0,0,0,0,0,0,0,0,100
ec3c659620bed5479b19ad13a4ceb97db7c83099,2,197,0,197,2,0,2,1,1,0,1,1,0.97440248,0,713,5,10,0,10,1473,0,1473,6,0,6,99.56559513
42a33fc6fa469ef0c893a1534315fd462488ce5e,0,0,0,0,0,0,0,0,0,0,0,0,0,0,8,1,0,0,0,0,0,0,0,0,0,100
57bd2bf12a7d1e55fc3790a16ff4c49ac5e2c500,0,0,0,0,0,0,0,0,0,0,0,0,0,0,0,0,0,0,0,0,0,0,0,0,0,100
6e4091afe836735dbc6203e630ba33939402a603,0,0,0,0,0,0,0,0,0,0,0,0,0,0,714,6,0,0,0,0,0,0,0,0,0,100
aac7a06d9df78d8cbdf35463fb7b652c0aaac395,0,0,0,0,0,0,0,0,0,0,0,0,0,0,715,6,0,0,0,0,0,0,0,0,0,100
16e9ed9785403b5d0a3e7f233a82a5b87cf08ec4,0,0,0,0,0,0,0,0,0,0,0,0,0,0,20,5,0,0,0,0,0,0,0,0,0,100
099fd97d0bdd487f3edc1c0c0e12762f1818d008,0,0,0,0,0,0,0,0,0,0,0,0,0,0,20,0,0,0,0,0,0,0,0,0,0,100
12cabb7d6ad8bb01b4f2eb6e1c13733bb6148ed4,0,0,0,0,0,0,0,0,0,0,0,0,0,0,21,6,0,0,0,0,0,0,0,0,0,100
0579e9a5b3039066eade44f404ef286a067416b0,0,0,0,0,0,0,0,0,0,0,0,0,0,0,21,1,0,0,0,0,0,0,0,0,0,100
a61577388fe552def9d8453f41b8a007c1dddb5a,0,0,0,0,0,0,0,0,0,0,0,0,0,0,22,2,0,0,0,0,0,0,0,0,0,100
b987b423a32e9105b7e50e087a28e5d85edd7573,3,33,5,28,0,0,0,1,2,108,1,2,1.359220043,158,23,3,25,21,4,1907,1702,205,15,13,2,100
86b90fc41a342088d20429ebcd61a95b2f757903,0,0,0,0,0,0,0,0,0,0,0,0,0,0,11,0,0,0,0,0,0,0,0,0,0,100
7c78ec42add610ad5905aa003a4d2e8b3e64fce9,0,0,0,0,0,0,0,0,0,0,0,0,0,0,0,0,0,0,0,0,0,0,0,0,0,100
1fb08855effc5c82c11a73d9d4a1ddaf5111e172,0,0,0,0,0,0,0,0,0,0,0,0,0,0,716,0,0,0,0,0,0,0,0,0,0,100
ed45311f1401b1dc18bb900b4132a3203fed0326,2,31,0,31,0,0,0,1,3,40,1,2,0.999249248,147,24,1,26,23,3,1743,1476,267,15,13,2,100
e9e418095237b9ce2c0baa6add9e017df84e0854,14,798,1,797,13,0,13,6,10,12,1,3,3.500156063,285,2,0,205,85,120,6216,2171,4045,59,26,33,97.05387205
1b73ccfd8a177709ef4f188b31ef8f3c03c073b0,36,73,49,24,0,0,0,2,10,2070,4,13,4.635804562,4443,3,1,503,615,112,31894,35033,3139,308,331,23,98.60541427
7044c0c1dec4df41e7a8c4b0a8ebbf73087bc84e,4,302,5,297,2,0,2,1,29,26,1,2,1.951660578,538,4,2,214,151,63,5978,4173,1805,111,75,36,93.99075501
7ccc33f6daa6d9044e114e8134c2c209af2706f8,3,72,5,67,0,0,0,1,30,72,1,3,0.910016513,900,5,3,272,256,16,7346,6890,456,112,108,4,100
f0ecaf7fb7d02a8de60f97b9d9623d6e694f787a,0,0,0,0,0,0,0,0,0,0,0,0,0,0,12,0,0,0,0,0,0,0,0,0,0,100
56239fdf0ff38666ff686edd0fba8e07fd042080,2,0,0,0,0,0,0,1,1,0,1,2,0,209,22,0,12,0,12,1664,22,1642,12,0,12,99.42028986
643d0f02bf2df83b85fc54052bd0d0adcdb9f335,11,102,207,105,0,0,0,6,11,239,3,9,1.676387131,1292,717,0,153,175,22,9264,12614,3350,94,119,25,95.33483822
bf8ac8b6147ae0c5ec76c26fb77d7f5481fedfc2,0,0,0,0,0,0,0,0,0,0,0,0,0,0,5,0,0,0,0,0,0,0,0,0,0,100
aad8a8a916e657fc75cccd26c5b376b20a5dd1e6,0,0,0,0,0,0,0,0,0,0,0,0,0,0,718,1,0,0,0,0,0,0,0,0,0,100
f97169e34041456a3556dea99951b308d12d1813,0,0,0,0,0,0,0,0,0,0,0,0,0,0,719,2,0,0,0,0,0,0,0,0,0,100
43f8624ec1ea15e652171832485fd640e19fc737,1,96,0,96,1,0,1,1,1,0,1,1,0,0,720,3,10,0,10,515,0,515,2,0,2,99.84350548
95391214c4b4bb2cf36c08d669d6488776201c68,0,0,0,0,0,0,0,0,0,0,0,0,0,0,6,1,0,0,0,0,0,0,0,0,0,100
13a62911fb1a67c7ebd9b83254b5e5256c4b3399,0,0,0,0,0,0,0,0,0,0,0,0,0,0,721,4,0,0,0,0,0,0,0,0,0,100
6c51355a560e997371f06067d692980a720fc760,0,0,0,0,0,0,0,0,0,0,0,0,0,0,25,0,0,0,0,0,0,0,0,0,0,100
abc51e3db675db643418c2e03f1be3f63d2a1b37,6,294,9,285,0,0,0,8,41,216,2,5,1.933015057,2264,0,0,432,383,49,24630,22384,2246,289,267,22,100
40e387cfa6729d043ca0804fbb86fc3ec9e76af2,0,0,0,0,0,0,0,0,0,0,0,0,0,0,0,0,0,0,0,0,0,0,0,0,0,100
23f1b80e85cfe02b9f0fc9c9c1460d335936866f,6,397,0,397,2,0,2,19,42,4,2,5,2.244194223,1438,722,5,207,172,35,18685,15547,3138,183,164,19,99.53307393
cd74c0dfac7ddaf05c9f38c84e55021bcfb4eb1f,0,0,0,0,0,0,0,0,0,0,0,0,0,0,9,0,0,0,0,0,0,0,0,0,0,100
880b7cd94855e0d9ebab5fcb15780a4161410db0,0,0,0,0,0,0,0,0,0,0,0,0,0,0,0,0,0,0,0,0,0,0,0,0,0,100
b7b779cf89eaada4837fb15682e9b5a32d03e087,0,0,0,0,0,0,0,0,0,0,0,0,0,0,23,0,0,0,0,0,0,0,0,0,0,100
c35a1d57626c2298003a226a2cd2338835f9648a,0,0,0,0,0,0,0,0,0,0,0,0,0,0,24,1,0,0,0,0,0,0,0,0,0,100
bce57e39be346370b013a7d2a88c91c81a667e1b,0,0,0,0,0,0,0,0,0,0,0,0,0,0,0,0,0,0,0,0,0,0,0,0,0,100
df3bfd68b910bcd7c0c7ebef87229f7887f653f6,3,9,9,0,0,0,0,19,41,27,2,3,0.986426729,1070,723,1,121,121,0,11888,11888,0,111,111,0,100
dc3c563492da6dccf116a98b3b381f178daf3c8c,0,0,0,0,0,0,0,0,0,0,0,0,0,0,724,2,0,0,0,0,0,0,0,0,0,100
d2dd743451563165db9f02b6c09fe16ce84a1b59,4,82,14,68,1,0,1,2,11,59,2,3,1.208077912,549,725,2,67,66,1,5762,5376,386,49,48,1,99.23722349
1dd232129455551bf5ed6c49604180e001c61f37,0,0,0,0,0,0,0,0,0,0,0,0,0,0,0,0,0,0,0,0,0,0,0,0,0,100
603559ab4e51cc7a7b58d382ab020804a5bdd196,6,366,180,186,0,0,0,5,9,408,1,2,2.114711019,765,726,3,104,97,7,5694,5146,548,49,43,6,100
d42fc51e172d14df6d6205c032ac2af433cbdd23,0,0,0,0,0,0,0,0,0,0,0,0,0,0,1,1,0,0,0,0,0,0,0,0,0,100
7910dc3175497202ea4b5b4d02fc9262c1f63163,5,42,1,41,0,0,0,20,43,45,2,5,2.152895278,2360,2,2,400,394,6,23828,23518,310,274,269,5,100
800a3f5415577b6deec58d2c5e8d11c6658c9bce,6,128,1,127,0,0,0,20,44,29,2,6,2.015791113,2695,3,3,508,490,18,27262,26125,1137,316,302,14,100
9fba4b6064c2102ef3e1a9083cfeb9b8db495cde,0,0,0,0,0,0,0,0,0,0,0,0,0,0,4,4,0,0,0,0,0,0,0,0,0,100
9a7483a0209dcef6a2020ef919f271e5dd456c98,0,0,0,0,0,0,0,0,0,0,0,0,0,0,7,0,0,0,0,0,0,0,0,0,0,100
b6702d1adacb98d83cc470e9b24877ab7785cdf8,6,130,1,129,0,0,0,20,45,0,2,6,1.713949359,2805,5,5,526,508,18,28545,27262,1283,328,316,12,100
fa76e52ba2befbb2e279ff638cb9e2784bc1a1ab,16,885,265,620,8,0,8,2,4,115,1,2,3.58857722,416,727,3,92,49,43,7285,3577,3708,41,27,14,97.98957558
8253419e096e354774b60297dacdf8648be35ab0,6,189,3,186,0,0,0,20,46,0,2,6,1.657113454,2922,6,6,549,526,23,31233,28545,2688,344,328,16,100
03078390c696b4316cd34345dd422391bbad8c38,0,0,0,0,0,0,0,0,0,0,0,0,0,0,25,0,0,0,0,0,0,0,0,0,0,100
b2db51abe7699f77ddf9cfbb5ca1fea7f4df6ccd,0,0,0,0,0,0,0,0,0,0,0,0,0,0,0,0,0,0,0,0,0,0,0,0,0,100
cc213b1e08e461bc46fd576b3686f610a16cc3b2,0,0,0,0,0,0,0,0,0,0,0,0,0,0,1,1,0,0,0,0,0,0,0,0,0,100
14a193083633de4f3ab68251e23b00ad3f9a8430,0,0,0,0,0,0,0,0,0,0,0,0,0,0,2,2,0,0,0,0,0,0,0,0,0,100
6048bbe1369c5e0e73b80951fae81b8f492e31fa,0,0,0,0,0,0,0,0,0,0,0,0,0,0,26,1,0,0,0,0,0,0,0,0,0,100
f8800d6b18bb1b4f15aabe1949153e2061dc86e3,5,113,2,111,0,0,0,20,47,20,2,5,1.635119982,2754,7,4,465,446,19,29746,28626,1120,322,313,9,100
c28f016d6d09a511c4284b66c940af8d1d685211,6,120,1,119,0,0,0,20,48,4,2,6,1.814883905,3190,8,5,584,568,16,33658,32353,1305,366,353,13,100
19c2f349d86b46cd9850d4a5a19a038c820a4fce,0,0,0,0,0,0,0,0,0,0,0,0,0,0,3,3,0,0,0,0,0,0,0,0,0,100
20e0de400f725ba68c1d696590109db23fdb53c4,5,105,0,105,0,0,0,21,49,0,2,5,1.330616442,2954,0,0,485,477,8,31797,30967,830,341,334,7,100
debac336e923111b63ece886901e43f8961f5fbe,0,0,0,0,0,0,0,0,0,0,0,0,0,0,27,2,0,0,0,0,0,0,0,0,0,100
35129054dfe4fb84ecebad19b531a2a67b9101eb,0,0,0,0,0,0,0,0,0,0,0,0,0,0,28,3,0,0,0,0,0,0,0,0,0,100
9669a838a57cc738da754bd36f0a5c189281a691,0,0,0,0,0,0,0,0,0,0,0,0,0,0,4,4,0,0,0,0,0,0,0,0,0,100
5cb7a2100189b5a96035cdb4bbf530c8c570e3d0,5,142,4,138,0,0,0,22,50,1,2,5,1.617078928,2731,9,6,530,507,23,30358,28250,2108,304,291,13,100
74114ad14a747a5d8fa8408293780f8cbfb743f3,6,69,3,66,0,0,0,21,51,0,2,6,1.815616753,3510,10,6,625,615,10,37280,36596,684,394,386,8,100
3a3b5b33bed7bdf34ae928f95af7a56c8065f4ff,1,3,3,0,0,0,0,15,41,1,1,1,0,854,29,4,241,241,0,6703,6703,0,104,104,0,100
a768abd319b772892f753335455720b6c794de69,6,118,8,110,0,0,0,21,52,0,2,6,1.611566194,3570,1,1,633,625,8,38182,37280,902,401,394,7,100
e6f112c48010032dbc4404f0b1239043df0c3253,5,31,21,10,0,0,0,21,51,0,2,5,2.12250334,3549,11,5,632,631,1,37655,37455,200,400,399,1,100
cc3a012e12a0561e6c1c96be95f96aac97ede3d9,6,226,2,224,0,0,0,21,53,0,2,6,2.029338914,3664,12,6,674,634,40,40369,38382,1987,422,402,20,100
8b2afd6d018acb6fd2713d3c880acddef9e21918,0,0,0,0,0,0,0,0,0,0,0,0,0,0,13,6,0,0,0,0,0,0,0,0,0,100
9fc39b39fee65bf715250ff9f1944c9d7b2f150f,0,0,0,0,0,0,0,0,0,0,0,0,0,0,14,7,0,0,0,0,0,0,0,0,0,100
e9f30b2c7d70a2c5e9a4650634c61f5b1d107186,3,96,0,96,0,0,0,21,54,6,1,3,1.299657119,1434,2,2,187,176,11,15750,14787,963,184,173,11,100
8a1c404612e710badede5264811ce955b420799e,5,99,2,97,0,0,0,21,55,2,2,5,1.351447066,3534,3,3,563,555,8,39159,38179,980,400,393,7,100
007bb615397edf26d4e398fac79faadb1b423577,3,90,0,90,0,0,0,21,56,3,1,3,1.253893578,1535,4,4,199,189,10,16815,15948,867,196,186,10,100
86d08f99e6b04b819e89de3048934c3430752198,0,0,0,0,0,0,0,0,0,0,0,0,0,0,15,8,0,0,0,0,0,0,0,0,0,100
d8eb59a7b074e734edf03e09c27e7870541cb7d2,3,112,0,112,0,0,0,21,57,0,1,3,1.21366456,1614,5,5,212,199,13,17942,16815,1127,209,196,13,100
bc82249075b47f3b20c8b57671e1ccd9db8a8ddd,0,0,0,0,0,0,0,0,0,0,0,0,0,0,16,9,0,0,0,0,0,0,0,0,0,100
a9a019b23086ff251b1f5f8ff21e459ade4cbcfe,3,496,35,461,1,0,1,3,3,44,1,2,1.176062383,67,30,3,75,5,70,3424,441,2983,36,4,32,99.85250737
0c7a2792769a4c959c6373318c85cf122cef41e3,3,73,0,73,0,0,0,21,58,6,1,3,1.250340915,1713,6,6,220,212,8,18676,17942,734,217,209,8,100
01414111b0e5ab8715428a72a3f03377c77dc456,3,198,0,198,2,0,2,3,3,22,1,2,1.48612388,49,31,4,23,5,18,1714,396,1318,10,3,7,99.63316214
11cc30348d355b8d8a3aedfc28932db4ba06da6c,0,0,0,0,0,0,0,0,0,0,0,0,0,0,32,5,0,0,0,0,0,0,0,0,0,100
467f7ab72bccb2f8b2c436b34f56fdbbe4469072,3,56,1,55,0,0,0,21,59,0,1,3,1.182137707,1778,7,7,226,220,6,19224,18676,548,223,217,6,100
f0221db3d6f611865c45caafc7d42e7c4abe91ad,0,0,0,0,0,0,0,0,0,0,0,0,0,0,17,6,0,0,0,0,0,0,0,0,0,100
b93dfa38474f8caf685a2d0a8327161a340449a2,5,45,0,45,0,0,0,21,60,16,2,5,2.079158744,3909,8,6,604,600,4,42916,42435,481,441,437,4,100
c7642009719f1c1fad7b8d8ad6d435f999594efc,5,31,2,29,0,0,0,22,61,20,3,5,1.689662324,3080,0,0,541,538,3,29701,29473,228,367,364,3,100
3a1e8c6cb725d680cfb5c6e54b612e1e5b245645,1,31,4,27,0,0,0,2,2,85,1,1,0,95,33,3,19,18,1,1061,794,267,6,5,1,100
d13099f53af7ed8eec058221320119e812078f85,5,164,10,154,0,0,0,5,62,368,1,3,1.825048791,718,9,7,83,68,15,7580,6338,1242,81,66,15,99.04200442
9108472d676b482b6a1fbe236cd90896f05605f6,2,86,12,74,1,0,1,1,2,45,1,2,0.665580063,61,34,4,19,6,13,814,588,226,9,4,5,99.70348406
58f76928b0fa02255eaf31b7ed554a858c43c2cf,3,44,0,44,0,0,0,22,63,5,1,3,1.102652051,1872,10,8,235,231,4,20178,19696,482,232,228,4,100
348a102f8ae787615883cdbab37423dc5355a758,0,0,0,0,0,0,0,0,0,0,0,0,0,0,35,5,0,0,0,0,0,0,0,0,0,100
af3aac6f613561fd7502edef7ad1b2eb3fe155b8,2,16,2,14,0,0,0,3,4,30,1,1,0.503258335,368,36,6,66,64,2,2706,2633,73,31,31,0,100
8d7ca3707b104941de33699ac769f80c781a9234,3,69,0,69,0,0,0,2,64,659,1,3,0.803009956,277,11,7,33,23,10,2582,2197,385,26,19,7,100
d4d01104f83c87cb1e387ee773ffd7131359c6fe,0,0,0,0,0,0,0,0,0,0,0,0,0,0,18,2,0,0,0,0,0,0,0,0,0,100
d1f8b0eee4e1b146fd384d975457d182b3293940,1,0,2,2,0,0,0,5,7,271,1,1,0,111,37,7,25,25,0,927,945,18,16,16,0,100
b9b26cc559296f362b0d477c55dc1ca747c3b482,0,0,0,0,0,0,0,0,0,0,0,0,0,0,10,0,0,0,0,0,0,0,0,0,0,100
51c869fa688d076b3758a17b3dcee5176b528670,2,11,9,2,0,0,0,2,3,61,1,1,0.970950594,144,38,8,17,16,1,1074,1046,28,8,6,2,100
2dbccbf46c88a8a0b767053c798ee5509d44e6fe,5,54,0,54,0,0,0,22,65,17,2,5,1.972689986,4013,1,1,620,611,9,44067,43668,399,454,448,6,100
49f7d6f13555aaf2a3d79321e04c0c9025350a7e,0,0,0,0,0,0,0,0,0,0,0,0,0,0,728,0,0,0,0,0,0,0,0,0,0,100
eb5b8d52e88399d75c5c0b141f7a13b5f1699d15,0,0,0,0,0,0,0,0,0,0,0,0,0,0,19,2,0,0,0,0,0,0,0,0,0,100
16b755d26d201eb018dd56b736362a4a77fbe969,0,0,0,0,0,0,0,0,0,0,0,0,0,0,2,2,0,0,0,0,0,0,0,0,0,100
877197259b8fe90031aec9040aac9e29fdf877b4,0,0,0,0,0,0,0,0,0,0,0,0,0,0,3,3,0,0,0,0,0,0,0,0,0,100
a8c8ea76771394ae45ef2badd48efa8b2e767a4c,0,0,0,0,0,0,0,0,0,0,0,0,0,0,4,4,0,0,0,0,0,0,0,0,0,100
81f62d6c1c6abcb6a87a21b4f2affb4ba7d65f0e,0,0,0,0,0,0,0,0,0,0,0,0,0,0,5,5,0,0,0,0,0,0,0,0,0,100
746a2dc3bc7f7c9e1a02383168522cac91349f2d,0,0,0,0,0,0,0,0,0,0,0,0,0,0,6,5,0,0,0,0,0,0,0,0,0,100
ebe5cdb90d52ea5277df0bc06ed028c92f9dc040,0,0,0,0,0,0,0,0,0,0,0,0,0,0,7,6,0,0,0,0,0,0,0,0,0,100
d1addaea59d027d523cede4a3b72e3e150e63513,0,0,0,0,0,0,0,0,0,0,0,0,0,0,20,2,0,0,0,0,0,0,0,0,0,100
18d28dc5573e842e5b4bac7d6dc28d779452cee2,0,0,0,0,0,0,0,0,0,0,0,0,0,0,8,7,0,0,0,0,0,0,0,0,0,100
e43ed84a086b9ba8fee35cae0ce49769b588b45a,0,0,0,0,0,0,0,0,0,0,0,0,0,0,9,8,0,0,0,0,0,0,0,0,0,100
e386928a2b0489f798c29fff47b47e3043221a5b,0,0,0,0,0,0,0,0,0,0,0,0,0,0,10,9,0,0,0,0,0,0,0,0,0,100
c57e9622cdb1f4052e805ea7d034e5e27ca8a771,2,16,0,16,0,0,0,2,2,132,1,2,0.954434003,162,21,3,14,11,3,1252,1145,107,11,8,3,100
0861db9f4f149800e3b72b50ac6c126b1507c93a,0,0,0,0,0,0,0,0,0,0,0,0,0,0,22,4,0,0,0,0,0,0,0,0,0,100
81582e6c348c6b6cb2ac511adda14688ec2030ef,1,6,9,3,0,0,0,2,2,132,1,1,0,78,39,4,11,11,0,477,524,47,3,3,0,100
e668e30347d5d002befb5f8de7d2bd5f6b72a78a,0,0,0,0,0,0,0,0,0,0,0,0,0,0,11,10,0,0,0,0,0,0,0,0,0,100
ab5f11061b495a6e5c77e9236c1e495c0bf962fa,2,31,0,31,0,0,0,2,3,0,1,2,0.962900415,174,23,5,20,14,6,1485,1252,233,16,11,5,100
b90dd6bfc4c7a178aecc3f278a9058f8caf9228e,2,31,1,30,0,0,0,3,4,10,1,2,0.896038233,200,12,11,24,20,4,1719,1485,234,20,16,4,100
b3710694355eaed2bb44f7b0afcedd6f7207e1c4,0,0,0,0,0,0,0,0,0,0,0,0,0,0,0,0,0,0,0,0,0,0,0,0,0,100
c340a9763f2d580ec59473da8e97fc18955b0ae4,5,68,0,68,0,0,0,6,66,150,2,5,1.977396455,758,12,0,86,79,7,7500,7027,473,72,68,4,100
8d5c76d52d855f6ee7de6e0132117cfa52ab40c7,6,223,118,105,1,0,1,2,5,40,1,3,2.288016132,462,40,2,54,51,3,4706,4123,583,37,33,4,99.77843427
bb872004448faa65bdcfa03657c171480703c929,0,0,0,0,0,0,0,0,0,0,0,0,0,0,729,1,0,0,0,0,0,0,0,0,0,100
d56fa57cf3e1c7538f1b1d80aa145582457a223b,4,117,7,110,0,0,0,4,6,60,1,2,1.640227909,388,24,5,51,39,12,4376,3417,959,32,23,9,100
6eedd19fb01412c18d9cdb1fb6b96b13710e53ef,7,197,53,144,2,0,2,3,7,0,1,3,2.061243286,508,25,6,48,43,5,5625,4724,901,45,40,5,99.41219691
d7d73ea85dfb834c996175e80b596a445704b1c1,5,98,0,98,0,0,0,22,67,33,2,5,1.763677313,4061,13,1,633,620,13,45146,44074,1072,462,454,8,100
5eb11d3b5e0fb73b34d266ec2d1dc4be96e1802b,5,42,0,42,0,0,0,22,68,5,2,5,2.067031495,4145,14,2,638,633,5,45580,45146,434,466,462,4,100
2a5fe3e0080a13cf6b32d5f73d5688675981112d,3,223,9,214,0,0,0,4,5,61,1,2,0.67206347,235,26,7,37,24,13,3669,1789,1880,24,11,13,100
af67bd77ab5c0b5b6b07cc517b8aaa2640655045,5,84,27,57,0,0,0,4,8,10,1,3,1.86469362,515,27,8,59,53,6,4694,4246,448,46,39,7,99.78054133
f1d94b7d8c1729ed30ab36239881133e4ae0139e,0,0,0,0,0,0,0,0,0,0,0,0,0,0,730,1,0,0,0,0,0,0,0,0,0,100
e94a886e305701cc283ba17aa831174976888a89,0,0,0,0,0,0,0,0,0,0,0,0,0,0,41,2,0,0,0,0,0,0,0,0,0,100
063c4f670e6d4b57939882e95861967d8a6c9c57,6,199,36,163,0,0,0,4,9,4,1,3,1.995007655,561,28,8,78,59,19,5918,4261,1657,59,41,18,99.78054133
f0cee53f88fcb8681744a0317c258b69fba82614,3,17,6,11,0,0,0,2,51,44,1,2,1.477746834,1434,29,9,424,423,1,11625,11525,100,164,163,1,100
8846620e29f74f04e7337ff11f34a608aeb028d8,2,20,3,17,0,0,0,4,8,86,1,2,0.998635964,158,42,3,15,13,2,1629,1476,153,12,12,0,100
fcd91bae57b6bed8952d1738c0185d70f234442c,2,161,7,154,0,0,0,2,4,96,1,2,0.855126186,225,30,10,61,34,27,3295,1959,1336,13,8,5,100
9428bcaffa1fc045338b6ebe75fdf4096d48fed1,34,160,2706,2546,0,0,0,1,10,1149,2,8,3.642072823,5415,731,2,370,568,198,28707,38602,9895,222,385,163,99.26199262
2754997b10b8a0fa1da21b1360f486c9bbb77ae6,3,79,4,75,0,0,0,23,63,11,2,3,0.490073992,2562,15,3,370,367,3,31576,30962,614,274,271,3,99.70215934
7d18456fe9797c8bea5f721f1b097b9902155191,2,83,3,80,0,0,0,3,5,24,1,2,0.782444129,116,31,8,17,8,9,1825,1312,513,10,7,3,100
3999f2e35ab166d1ab3e96cded49f10987923ec6,5,92,2,90,0,0,0,6,69,23,2,5,2.101782285,817,16,4,101,86,15,8301,7514,787,80,72,8,100
f7e9e0b2f44cf69f02de35f5fc99edf311ff3d3c,0,0,0,0,0,0,0,0,0,0,0,0,0,0,732,3,0,0,0,0,0,0,0,0,0,100
b6d160ab0196b78a5fea6f585f3f197612611b3f,2,115,0,115,2,0,2,1,1,0,1,2,0.915369971,0,32,8,11,0,11,618,0,618,6,0,6,99.62880475
4dad249693d15d1db24ec1708e9fcbc41cdcad8c,1,23,0,23,0,0,0,4,10,9,1,1,0,278,13,1,24,22,2,2995,2697,298,24,22,2,100
60bd7af176d82b3cacae4517ec7079215a4c3185,3,101,6,95,0,0,0,1,6,1,1,2,0.823366132,180,33,9,36,25,11,2355,1283,1072,18,13,5,99.26686217
4e45489f47d958456ad5abd0db5e9adc490bc5e1,0,0,0,0,0,0,0,0,0,0,0,0,0,0,34,10,0,0,0,0,0,0,0,0,0,100
679146447a58f1b81b56a51f67f2e280ce3ebff5,2,40,0,40,0,0,0,4,11,12,1,2,0.992774454,430,14,2,52,47,5,4373,4014,359,47,44,3,100
6e296a862be8e57c924363d0220d3217f1112e39,8,340,124,216,1,0,1,1,7,7,1,4,2.130857994,746,43,3,123,113,10,8606,6840,1766,48,40,8,98.97510981
10b5fff0acaccc1ec5c8194e4c7ada46243e74b6,3,5,13,8,0,0,0,2,6,2,1,2,1.435520504,418,44,4,58,60,2,4176,4193,17,17,17,0,100
d2ee90f00781125825e4bdcc60c5d8e58a18dbab,5,90,1,89,0,0,0,22,70,14,2,5,2.058444338,4247,17,5,649,641,8,46982,46196,786,475,469,6,100
0794529eb052777fb15a0c81b5d5de2100aef6fa,3,165,7,158,0,0,0,3,7,29,1,2,1.570194864,600,45,5,126,103,23,6151,5005,1146,43,39,4,100
b4665785494b77eea4b2e8a036de145af922c13c,0,0,0,0,0,0,0,0,0,0,0,0,0,0,15,2,0,0,0,0,0,0,0,0,0,100
4b0f1c07adebf82cf49d0607bee157dd531ec8a0,15,161,229,68,0,0,0,8,66,485,3,10,2.645152804,5418,733,4,768,779,11,53148,53038,110,494,495,1,99.85228951
212fa8a3dba4cf8a43607c2ad951e46e75eee60c,2,36,0,36,0,0,0,5,9,10,1,2,0.979868757,210,16,3,26,23,3,2316,1935,381,17,15,2,100
32e04d7417141cd4d086c087a607658d6990b796,2,102,2,100,0,0,0,1,3,31,1,2,0.995727452,140,35,11,25,7,18,2473,1309,1164,14,7,7,99.85207101
0c494f3d314c0ded2e324671102896a5e8546c83,13,224,167,57,3,0,3,22,71,1,3,8,2.829094571,5625,36,11,901,901,0,56799,56752,47,570,570,0,99.26308032
0a8d07f216485dfb70225ea4c8fbec3cabc32cfe,2,101,0,101,0,0,0,3,4,5,1,2,0.962262396,182,17,4,33,22,11,2542,1719,823,17,11,6,100
23b9f294763df7ad3a52ed240502949f1c6661ba,2,19,0,19,0,0,0,5,10,2,1,2,0.831474388,240,18,5,28,26,2,2481,2316,165,19,17,2,100
92fb141d8ab4fb5541622f1acbc865f2ce6792ef,2,166,0,166,0,0,0,3,5,4,1,2,0.922259647,256,19,6,48,33,15,4181,2542,1639,23,17,6,100
9c585f066e5a71652519ae8e8acca876090df9c0,0,0,0,0,0,0,0,0,0,0,0,0,0,0,734,4,0,0,0,0,0,0,0,0,0,100
61087435b704d2bae73f1583f9e17752c46d6f72,0,0,0,0,0,0,0,0,0,0,0,0,0,0,735,5,0,0,0,0,0,0,0,0,0,100
d5405cc29e2ff8f27a8d2daa304a8b23c5fa4273,0,0,0,0,0,0,0,0,0,0,0,0,0,0,37,9,0,0,0,0,0,0,0,0,0,100
6c3d6e659c2a3e2da7a3cc526eb33545e79e160b,2,141,0,141,1,0,1,1,4,11,1,2,0.944087018,46,20,7,13,4,9,1260,257,1003,7,1,6,99.12216533
2827dc4ac69a00500dd2aba5299d4f85d7c55c5c,0,0,0,0,0,0,0,0,0,0,0,0,0,0,38,8,0,0,0,0,0,0,0,0,0,100
3c71c2c88d460cabc59ae28060fd70bd94e994fc,2,129,0,129,2,0,2,1,1,0,1,2,0.994748565,0,21,8,9,0,9,778,0,778,6,0,6,99.27272727
8da5061b451ede6f4d505d6f3bb27f88754526d0,4,385,36,349,0,0,0,3,24,27,1,3,1.411033436,831,46,3,213,175,38,9936,7084,2852,94,80,14,99.78213508
5f9ab0e92972bb4f9ad7d611d81593671ff5ee81,1,1,2,1,0,0,0,2,3,876,1,1,0,134,47,4,29,29,0,695,695,0,20,20,0,100
976f52a78e66a4c04292409cd1abbc06d25696a6,5,135,17,118,2,0,2,1,9,10,1,3,1.898191978,403,22,8,85,77,8,4073,3132,941,31,29,2,99.42070963
43c53707bd87221c9f8a1c925d6167d2322f105d,2,33,5,28,0,0,0,1,2,6,1,2,0.899743759,102,23,8,12,9,3,1472,956,516,6,3,3,100
8e0c3cccb831a34c1502941b3d0db4e0ddee9ffd,4,65,51,14,0,0,0,22,68,161,2,3,1.57869016,2480,48,5,266,266,0,29113,28979,134,241,241,0,100
7ed65fe7197f7c75c7e6c679cf234d6b244a3881,3,372,0,372,1,0,1,1,28,0,1,3,1.035939477,1443,49,5,154,126,28,21986,18892,3094,132,118,14,99.63924964
10f87c4df9257cad997d51c02eb1e1b72ac7306e,4,20,11,9,0,0,0,2,9,29,1,2,1.876496786,380,50,4,60,59,1,2933,2919,14,26,25,1,99.78370584
9327ffd3f6cfa43f713982cba321c3e1a3d81ed2,2,65,0,65,1,0,1,1,3,64,1,2,0.619382195,94,24,5,16,12,4,917,562,355,8,4,4,99.7124371
d5ae944d6097565a707a6390a81a4f7b704d6315,1,5,3,2,0,0,0,1,1,0,1,1,0,48,736,2,3,3,0,285,276,9,3,3,0,99.71305595
d7c22c0dc734496950f0421ef97aaa63a5f8b297,1,0,1,1,0,0,0,1,2,0,1,1,0,50,737,3,3,3,0,276,285,9,3,3,0,100
254aa04f95747ff29c42d6284d165a357b2a6332,0,0,0,0,0,0,0,0,0,0,0,0,0,0,738,4,0,0,0,0,0,0,0,0,0,100
ad16e38b641409aa8018d6db2da95d0f7628cc3a,146,38,70,32,0,0,0,2,7,2,3,33,4.053988419,14472,739,3,1500,53,1447,88315,7914,80401,832,33,799,58.82789318
6a69b494d0b35710b2c07b70dcb4f8c7e73c2525,0,0,0,0,0,0,0,0,0,0,0,0,0,0,13,0,0,0,0,0,0,0,0,0,0,100
dd6b58dadf443c8000f1fb9199ff43254799d5d0,0,0,0,0,0,0,0,0,0,0,0,0,0,0,14,1,0,0,0,0,0,0,0,0,0,100
57f12b69cf30099733c037f31f9a0273287ae489,2,74,0,74,0,0,0,3,7,44,1,2,1,399,25,4,52,46,6,4957,4147,810,25,22,3,99.46153846
3680718d15dcdd32d1d5cabf49ec3272797c27bd,0,0,0,0,0,0,0,0,0,0,0,0,0,0,740,4,0,0,0,0,0,0,0,0,0,100
649d750421d6297e75fe03595d7df7fd174af4d8,40,1,1,0,0,0,0,1,1,0,1,9,0,4526,741,5,466,120,346,28531,28160,371,189,120,69,87.69230769
bd331f018795475347fc75b5c68b040682b8a20d,5,37,29,8,0,0,0,4,10,38,1,2,1.999161976,956,51,3,185,184,1,7745,7690,55,70,69,1,100
c71ebd4b0f6a80507d58dad93708d28878d39265,0,0,0,0,0,0,0,0,0,0,0,0,0,0,15,2,0,0,0,0,0,0,0,0,0,100
483ad201e03746c3d7e3dab50e7722038c06cd37,2,54,0,54,0,0,0,3,9,1,1,2,0.999010271,460,52,4,60,52,8,5367,4959,408,28,25,3,99.69278034
d58baa8a3354b3b727c1806cb46b751a62a28f39,0,0,0,0,0,0,0,0,0,0,0,0,0,0,53,5,0,0,0,0,0,0,0,0,0,100
8ab6e91d84c3008d3aaf39ed6404cc5a6340e45a,4,275,3,272,0,0,0,2,10,41,1,2,1.593671147,296,26,3,45,26,19,7057,2722,4335,26,17,9,99.5388163
deeb8287be5180d606d577b6f5f4a9818de2344d,7,323,125,198,2,0,2,3,8,70,1,3,2.533895851,413,54,6,79,59,20,3940,3053,887,40,23,17,99.15966387
6fc96ba1b68bd08dcd52cc16f385fec4d29ece42,4,29,29,0,0,0,0,2,29,38,2,4,1.130136319,2160,16,3,231,231,0,24319,24319,0,163,163,0,100
f35277c04e57247d8b01c5e321c91fad62981c09,0,0,0,0,0,0,0,0,0,0,0,0,0,0,17,4,0,0,0,0,0,0,0,0,0,100
645224242e1979e48a7c1d8f4d925769237e279c,5,186,5,181,0,0,0,4,11,3,1,3,1.734485866,703,39,0,142,111,31,7638,6020,1618,59,45,14,99.69535415
11286988d406d01c7ca8b19481d2eda81c53a98a,2,21,0,21,0,0,0,3,6,2,1,2,0.918295834,307,27,3,42,40,2,2667,2502,165,24,22,2,100
aa00f87f7c842e5feb5d8c99b707b0d7c32c4ec0,0,0,0,0,0,0,0,0,0,0,0,0,0,0,18,5,0,0,0,0,0,0,0,0,0,100
4e2761d74c8018b8de10e1dd25f77b37482fc120,3,55,5,50,0,0,0,3,10,10,1,2,1.485475297,649,28,4,77,72,5,7170,6685,485,42,40,2,100
e2baf5265844ecad1d7f30601921f99fdbbdf078,1,0,1,1,0,0,0,2,2,26,1,1,0,449,55,4,53,53,0,2744,2750,6,29,29,0,100
66ff9dcc559f7962c0138d73c1e3cb3233fda2f7,2,41,0,41,0,0,0,3,7,6,1,2,0.901170196,337,40,1,47,43,4,3182,2784,398,29,25,4,100
7220e1cbbdb2cffaba284fae35ae52d0ac2ea714,0,0,0,0,0,0,0,0,0,0,0,0,0,0,742,2,0,0,0,0,0,0,0,0,0,100
dad4d99734ded7d55e9bcaf08b1a3bc4e90741d0,2,202,8,194,0,0,0,1,4,51,1,2,0.758424667,124,29,4,29,12,17,3088,1465,1623,10,6,4,99.77081742
fb20a843012378c0cd8360e3a5b97543177f6cad,2,52,2,50,1,0,1,1,2,13,1,2,0.691289869,89,56,5,12,9,3,711,512,199,11,8,3,99.69535415
98060b40fe60bde9947ce198cad66e4b06a4a9e9,2,609,3,606,0,0,0,4,9,76,1,2,0.9730146,388,30,4,134,62,72,8461,3745,4716,57,14,43,100
bb48b994e18938057078132c19c6be52a7ad0704,4,288,78,210,0,0,0,1,12,49,1,3,1.996106434,741,31,5,167,149,18,7937,6262,1675,63,54,9,99.39117199
fbba349d444df16daaa7e6515a46567773f7b7fa,7,956,127,829,2,0,2,22,72,64,2,6,2.529441732,4349,6,0,719,640,79,53941,47701,6240,510,470,40,99.62034928
d5a396223195764d41877ce1a9d09f37815a136b,0,0,0,0,0,0,0,0,0,0,0,0,0,0,32,5,0,0,0,0,0,0,0,0,0,100
99239524f17389fc4ae9548ea88756f8ea538bb9,0,0,0,0,0,0,0,0,0,0,0,0,0,0,19,2,0,0,0,0,0,0,0,0,0,100
0eae42576c2588fe278f75cef3b17fee600eac90,0,0,0,0,0,0,0,0,0,0,0,0,0,0,743,1,0,0,0,0,0,0,0,0,0,100
2a0b36989aa895c0781f9a10c907dd726506d0b7,0,0,0,0,0,0,0,0,0,0,0,0,0,0,20,2,0,0,0,0,0,0,0,0,0,100
49764b6751079963c7edf18bd09b927bd35b370d,0,0,0,0,0,0,0,0,0,0,0,0,0,0,21,2,0,0,0,0,0,0,0,0,0,100
40bc1f91374f4cd3737a24fb9d49a5841928bfcd,1,1,1,0,0,0,0,4,8,35,1,1,0,191,41,1,33,32,1,1452,1444,8,14,14,0,100
5a3fe4c42c3d7c6f8a7ad10dec5f92cc3925d2c3,1,1,1,0,0,0,0,4,13,15,1,1,0,327,42,2,73,73,0,2956,2946,10,22,22,0,100
66e3ddc64be3300be56e4d0ecbe3fb8833668637,0,0,0,0,0,0,0,0,0,0,0,0,0,0,43,3,0,0,0,0,0,0,0,0,0,100
16c79721437b6618a1a458970247f7dd1e42f5f7,0,0,0,0,0,0,0,0,0,0,0,0,0,0,33,4,0,0,0,0,0,0,0,0,0,100
db07953021619b4bb3878fd212d34000e87d6b6d,6,31,31,0,0,0,0,1,2,72,1,2,2.58135833,877,744,2,104,104,0,5682,5694,12,49,49,0,100
b135e8eb52d086815be6bbf75692c40c637247a7,2,312,0,312,0,0,0,2,6,100,1,2,0.984262514,166,44,4,57,13,44,4034,1247,2787,17,7,10,99.5478523
e23e98cfdaae6241adec975ca7c85e4dfddb789c,0,0,0,0,0,0,0,0,0,0,0,0,0,0,34,5,0,0,0,0,0,0,0,0,0,100
0ab5cd631d70750e3e41fb97967b35fbd0f4c41d,1,10,13,3,0,0,0,3,11,55,1,1,0,179,57,1,35,36,1,1498,1499,1,13,13,0,100
68e334f679f99f989c2345140029b4c9d2471404,0,0,0,0,0,0,0,0,0,0,0,0,0,0,58,2,0,0,0,0,0,0,0,0,0,100
22ee91d7ebb0f62dbec38b465f014f3d4f00ab15,0,0,0,0,0,0,0,0,0,0,0,0,0,0,45,4,0,0,0,0,0,0,0,0,0,100
7d948bf5fda9b27cd5f0a358e418636ecb865b47,0,0,0,0,0,0,0,0,0,0,0,0,0,0,35,6,0,0,0,0,0,0,0,0,0,100
556af1681e46146bfbff90a98883b705b761da8e,0,0,0,0,0,0,0,0,0,0,0,0,0,0,59,3,0,0,0,0,0,0,0,0,0,100
b4642f28e50de6ec2445f21d08ca37e376dc3aba,0,0,0,0,0,0,0,0,0,0,0,0,0,0,745,2,0,0,0,0,0,0,0,0,0,100
89a200675dad54f80315325420730dc735391178,0,0,0,0,0,0,0,0,0,0,0,0,0,0,746,3,0,0,0,0,0,0,0,0,0,100
df32d2e7e5c0830d2a63c11d9a626966a6c0d027,0,0,0,0,0,0,0,0,0,0,0,0,0,0,747,4,0,0,0,0,0,0,0,0,0,100
7ee22de364d4f518b9f7d74a1acacfe3aa2c736d,0,0,0,0,0,0,0,0,0,0,0,0,0,0,748,4,0,0,0,0,0,0,0,0,0,100
d1ee421fddef0f37634f43503e8f5c1a75ff1cad,0,0,0,0,0,0,0,0,0,0,0,0,0,0,749,5,0,0,0,0,0,0,0,0,0,100
06e7d679ff979a4f052e0afe5df0b303bf8d70fb,0,0,0,0,0,0,0,0,0,0,0,0,0,0,750,6,0,0,0,0,0,0,0,0,0,100
bd864a9fd6b1a1341282f4a7995d8a37f61328cc,0,0,0,0,0,0,0,0,0,0,0,0,0,0,22,0,0,0,0,0,0,0,0,0,0,100
8ff2e4e74c0897623af0df832205bff1da89e00b,0,0,0,0,0,0,0,0,0,0,0,0,0,0,23,1,0,0,0,0,0,0,0,0,0,100
ad9c09698d7e7cde9cc72cb511540cb603756a09,0,0,0,0,0,0,0,0,0,0,0,0,0,0,24,2,0,0,0,0,0,0,0,0,0,100
ce39b9d8138550a5d7557b13528f40d43c286c94,36,30,37,7,0,0,0,2,13,205,3,23,5.140716056,4457,25,3,447,447,0,32349,32349,0,257,257,0,100
1b7be880b7e1631db594eabd858e8c81efb879d7,0,0,0,0,0,0,0,0,0,0,0,0,0,0,0,0,0,0,0,0,0,0,0,0,0,100
5bd0172a8865b162d93320d1229ec59f57a79088,2,81,2,79,0,0,0,5,13,216,1,2,0.776116266,473,0,0,61,55,6,4899,4419,480,51,47,4,100
2f4f9ddb6f038938e25f3dbdcc948f6fd837d3b8,1,4,0,4,0,0,0,22,70,116,1,1,0,1009,60,0,127,127,0,10035,10000,35,124,124,0,100
3412696a65cf646b88d15a536e08d392d80a8a9b,0,0,0,0,0,0,0,0,0,0,0,0,0,0,46,0,0,0,0,0,0,0,0,0,0,100
d756a9ab870f043946147672158d3b2c9daf8935,4,142,3,139,0,0,0,23,71,90,2,4,1.340720212,4440,1,1,696,665,31,50412,49201,1211,487,483,4,100
60443f5ab4bc98713795b5ad9d078b8f36bb2c0a,0,0,0,0,0,0,0,0,0,0,0,0,0,0,47,1,0,0,0,0,0,0,0,0,0,100
d99ab70a1c8b25f58f3c770c2004771a71fde2f1,2,13,0,13,0,0,0,23,72,117,1,2,0.995727452,1042,2,2,130,129,1,10585,10379,206,127,126,1,100
f459b31bcc486f22a2f34e4f7ad0a6fe4325cca6,0,0,0,0,0,0,0,0,0,0,0,0,0,0,751,0,0,0,0,0,0,0,0,0,0,100
4c5fa8333b2c61850d5664b878df9493c7915066,0,0,0,0,0,0,0,0,0,0,0,0,0,0,752,1,0,0,0,0,0,0,0,0,0,100
