CommitID,NMF,TotalAddLines,TotalDeleteLines,LC,FileAdd,FileDelete,NAD,NDEV,NUC,AGE,NS,ND,Entropy,LT,EXP,REXP,CommitComplexity,LastCommitComplexity,CFC,CommitTokenCount,LastCommitTokenCount,NCC,CommitMethodNum,LastCommitMethodNum,NMC,a2a
9af2318248f47d69c56c20c0749f4174d03cb562,0,0,0,0,0,0,0,0,0,0,0,0,0,0,0,0,0,0,0,0,0,0,0,0,0,100
47f48bfafb4a895a4df75abb9a3b898064a0802a,0,0,0,0,0,0,0,0,0,0,0,0,0,0,1,1,0,0,0,0,0,0,0,0,0,100
d97273dc01d4a1a64f8d83fccf9b7ff88a6d8058,0,0,0,0,0,0,0,0,0,0,0,0,0,0,2,2,0,0,0,0,0,0,0,0,0,100
e623f523d9416477c80b18bbdc076dfbabd65e90,0,0,0,0,0,0,0,0,0,0,0,0,0,0,3,3,0,0,0,0,0,0,0,0,0,100
f288944f6d418c488176a0fb8fcaca7a91ca6470,4,360,71,289,3,0,3,2,2,1,1,2,1.940119,228,0,0,49,15,34,3003,1588,1415,24,5,19,99.82352941
2494e474da483ba315ae8836447f1d643e7d9f69,2,11,15,4,0,0,0,2,2,4,1,2,0.930586129,165,1,1,21,21,0,1028,968,60,6,6,0,100
d9ae4caf9d67092fa79b62ad9b0537cd08fe6c3e,2,0,6,6,0,0,0,2,2,6,1,2,0.650022422,171,0,0,25,25,0,1081,1081,0,6,6,0,100
a87485798d63b4801b15e90a01ac76d6f75d980a,1,1,1,0,0,0,0,2,2,7,1,1,0,65,1,1,7,7,0,456,456,0,1,1,0,100
e5bc6f5fc7662bda38027651ffeb0d9c5ae6cf97,6,11,11,0,0,0,0,2,2,6,1,4,2.413088436,135,2,2,0,0,0,271,282,11,0,0,0,100
d182c4fefd9e690584ade69dc4d8ea25e8dd57d9,2,0,44,44,0,0,0,2,2,6,1,2,0.998509099,39,3,3,0,0,0,0,35,35,0,0,0,99.85298442
7f132acfa4e6164b10aa2da81ec6099171ff45f8,17,148,383,235,2,0,2,1,1,0,2,9,2.85925322,999,0,0,68,102,34,4410,5839,1429,18,37,19,99.67599411
e85c77f3c99ba82102d86df2406f8792f6b02406,0,0,0,0,0,0,0,0,0,0,0,0,0,0,4,4,0,0,0,0,0,0,0,0,0,100
765513213047100806365c0c4d47071cf9e2f249,17,383,148,235,3,0,3,2,2,0,2,9,2.85925322,803,4,4,102,68,34,5839,4410,1429,37,18,19,99.67599411
d92373d87a79b589a74159ab736f4174e3bcc40b,0,0,0,0,0,0,0,0,0,0,0,0,0,0,6,6,0,0,0,0,0,0,0,0,0,100
d2ae22f90533e6bfa11458ad6fdab976edcce2d0,0,0,0,0,0,0,0,0,0,0,0,0,0,0,1,1,0,0,0,0,0,0,0,0,0,100
0c35025031cdcaf29d67c5335a0fb6068dd936fe,0,0,0,0,0,0,0,0,0,0,0,0,0,0,0,0,0,0,0,0,0,0,0,0,0,100
2e86c665118fe7e8f8307a7b22d180988f743c43,4,7,23,16,0,0,0,2,2,8,1,4,1.662154965,699,4,4,115,117,2,5050,5088,38,51,53,2,100
6a16dea16c5fd6472098c6f6341d4570408a8ca5,1,4,2,2,0,0,0,2,3,0,1,1,0,215,5,5,31,31,0,1579,1566,13,14,14,0,100
ac99498d0e2db64b2d6fdd4cb71cf4adfe98e447,3,0,52,52,0,0,0,2,3,5,1,2,1.115419284,68,6,6,0,1,1,49,105,56,0,1,1,99.85255087
3374718afbb946728935cb10a8c4db83dedd022a,4,130,106,24,0,0,0,2,3,7,1,3,1.509626388,441,7,7,12,19,7,3104,2980,124,12,11,1,98.76058041
5665772c0c590152635c7681ea36781acdbee22c,1,1,1,0,0,0,0,2,2,11,1,1,0,30,8,8,1,1,0,83,83,0,1,1,0,100
882acad87d224617363a5938a8f3aa3b386ca2eb,12,180,138,42,2,0,2,1,2,0,2,9,2.626001107,1225,0,0,138,128,10,8256,8299,43,66,64,2,98.67189858
5a3dbbf5b740e0c1edbf3622d61497bd48af56b3,0,0,0,0,0,0,0,0,0,0,0,0,0,0,1,1,0,0,0,0,0,0,0,0,0,100
47b47f5a705828f50c67f766c5c8841904c1cc58,12,142,184,42,0,0,0,2,3,0,2,9,2.597407121,1238,7,7,128,138,10,8299,8256,43,64,66,2,98.67189858
ddfe7c80248d35fe6f38cea1f459295e6ee7422c,15,184,208,24,1,0,1,2,2,0,2,12,3.061797833,1607,1,1,210,198,12,11171,11172,1,97,94,3,97.51199041
ea3168deea56a6f13a6947b8494d66babb83eee4,12,142,184,42,0,0,0,2,3,0,2,9,2.597407121,1238,2,2,128,138,10,8299,8256,43,64,66,2,98.69008634
6e7b3b29a3cc83a98261cda4562af87a5f6a851e,3,61,43,18,0,0,0,1,1,0,1,3,1.559781767,387,2,2,70,72,2,2861,2915,54,30,31,1,98.80110667
978177c08c8b07355381be53f94541725c949d05,3,43,61,18,1,0,1,2,2,8,1,3,1.559781767,382,3,3,72,70,2,2915,2861,54,31,30,1,98.80110667
31b13c0a6ac22686f99dacc3f227e1c242d5627c,0,0,0,0,0,0,0,0,0,0,0,0,0,0,3,3,0,0,0,0,0,0,0,0,0,100
72fe6a667f8f93c320c1c747a829b2d1f8c2f45a,0,0,0,0,0,0,0,0,0,0,0,0,0,0,5,5,0,0,0,0,0,0,0,0,0,100
4f9f5c524923ff915aa89dc8f3c73257dc2e5cd1,0,0,0,0,0,0,0,0,0,0,0,0,0,0,6,6,0,0,0,0,0,0,0,0,0,100
7842daf534bd38f37e8ae3dc7cc5072086378ae6,1,1,1,0,0,0,0,2,2,16,1,1,0,31,7,7,0,0,0,143,143,0,0,0,0,100
fbfe5a6c64fde2c6b937db2c9cf15eb22522a383,1,1,1,0,0,0,0,1,1,0,1,1,0,31,0,0,0,0,0,143,143,0,0,0,0,100
d00cc3d2731dc0e2c23f9645d29f62f752f7f796,0,0,0,0,0,0,0,0,0,0,0,0,0,0,0,0,0,0,0,0,0,0,0,0,0,100
5389a387a1f5e0a1db5acc326c430334548a03a3,0,0,0,0,0,0,0,0,0,0,0,0,0,0,1,1,0,0,0,0,0,0,0,0,0,100
aeeff979fffe7d412a4b6a2bcf3ca99c49a84ae8,0,0,0,0,0,0,0,0,0,0,0,0,0,0,0,0,0,0,0,0,0,0,0,0,0,100
31626371adb1c115574149d21d95fdb9a6c7706f,11,52,290,238,0,0,0,2,3,9,1,7,2.72932783,902,9,9,61,67,6,4323,5619,1296,36,41,5,98.61852433
85c14f1284311bfd190057009b4f0783d6a015e5,11,290,52,238,3,0,3,1,2,0,1,7,2.72932783,704,8,8,67,61,6,5619,4323,1296,41,36,5,98.61852433
2eba537c55331c6652e8c6a43394bac615347ca2,0,0,0,0,0,0,0,0,0,0,0,0,0,0,9,9,0,0,0,0,0,0,0,0,0,100
4e12a605199f07582af1b43641bb6054d60b0f62,1,3,0,3,0,0,0,1,2,20,1,1,0,41,10,10,2,2,0,166,159,7,2,2,0,100
15acc7c5a07fa3afedd01e0e281689fd257b88c9,1,0,3,3,0,0,0,1,1,0,1,1,0,42,8,8,2,2,0,159,166,7,2,2,0,100
3bf45f2a2f17d8ca9e754f0ac166b650503b4405,11,52,290,238,0,0,0,2,3,9,1,7,2.72932783,902,9,9,61,67,6,4323,5619,1296,36,41,5,98.61852433
ddb8d6d5ba67889673dd7dae44f0aeaa6a85ead4,2,0,266,266,0,0,0,2,2,20,1,2,0.872861093,239,10,10,0,19,19,0,1473,1473,0,5,5,99.71042471
3e823c0bcf703da81e670f758e08bf9a0e6b297c,5,6,353,347,0,0,0,2,2,20,1,3,1.394895461,123,11,11,0,8,8,117,429,312,0,5,5,99.80744544
cb7d9d97730b8a30d565580ddc59605010c73ac9,4,10,5,5,0,0,0,2,3,15,1,3,1.796791632,478,12,12,48,47,1,3605,3569,36,19,18,1,100
f20d286b8be818f55980a5f917406243f64ff5b1,3,51,63,12,0,0,0,2,2,21,1,2,1.49024406,1147,13,13,116,116,0,15612,15963,351,28,28,0,100
a498359f12efe9474a8911c1ce4fa4204dc6dcc6,1,1,1,0,0,0,0,2,2,22,1,1,0,41,14,14,1,1,0,183,183,0,1,1,0,100
8197a4b52be15cf476a2899840e237972d2d9602,2,10,2,8,0,0,0,2,2,22,1,2,0.918295834,303,15,15,34,33,1,2563,2512,51,14,13,1,99.67855995
c4db3925c98de59a0b03b380ffc4abfb5c5838b8,3,27,20,7,0,0,0,2,4,14,1,2,1.054917449,708,16,16,40,40,0,6791,6715,76,23,23,0,100
f86a89097e4ac0dd3644312e82e11cd4995f1b18,1,0,178,178,0,0,0,2,2,23,1,1,0,147,17,17,0,3,3,0,912,912,0,3,3,99.80713597
4d654631d940391457b336cd8f4e3451ff57cc6e,4,36,52,16,0,0,0,2,2,24,1,2,1.670025719,387,18,18,24,20,4,2591,2731,140,17,13,4,100
1b65d02abfefa1ee377bb244b7266f07bbeeebfc,18,47,148,101,0,0,0,2,3,14,2,9,3.387988162,751,19,19,43,50,7,2669,3315,646,31,39,8,98.93754024
ba208893701d7ac9e033022538f812745e096e72,42,1084,184,900,9,0,9,2,2,0,2,26,4.086454025,3646,8,8,319,288,31,37319,33648,3671,138,123,15,97.90187218
a4605c063f402779d373e61d88f4e37833bb0fdd,43,191,1096,905,0,0,0,1,4,0,2,26,4.134761401,4278,20,20,290,321,31,34024,37733,3709,125,140,15,96.70602859
493159cfb2d615f7b714c54e8195f66a55634ae0,20,115,20,95,0,0,0,2,3,11,2,10,4.201758906,1056,21,21,87,70,17,6007,5806,201,71,54,17,100
eb0650e6d84929f88e0b0bf14b4458028af69092,3,2,7,5,0,0,0,2,3,8,2,3,1.435520504,241,22,22,12,12,0,1839,1862,23,8,8,0,99.94011976
d4c28b79cacee4cfb39ff78fb1d0894ecaca2e50,54,1121,306,815,10,0,10,1,2,0,2,32,4.562574521,4528,1,1,380,366,14,42597,39066,3531,183,185,2,96.64179104
bc15d0ed99482137f18272a5816958af9c2df6a9,54,306,1121,815,0,0,0,2,4,0,2,32,4.560507839,5051,0,0,366,380,14,39066,42597,3531,185,183,2,96.64179104
209dd6885242decf923ddc1e982d6ef46efc6ef8,0,0,0,0,0,0,0,0,0,0,0,0,0,0,1,1,0,0,0,0,0,0,0,0,0,100
1865dc0bad3fecc8a88455866b43d1fe6340011c,0,0,0,0,0,0,0,0,0,0,0,0,0,0,3,3,0,0,0,0,0,0,0,0,0,100
2febeb1f6737bddee6e712a785c36512149acf4b,91,1806,937,869,17,0,17,1,2,0,2,54,5.402847317,7389,0,0,728,734,6,61669,58368,3301,337,352,15,95.06833036
a34e83a65bef6b3f359335cca946a6a23520f2ae,43,713,672,41,5,0,5,2,3,0,2,26,4.443575784,3238,2,2,414,385,29,22124,21093,1031,189,175,14,95.79496624
8a46d35e367d29636fc86e8270dd4b02afb0f028,43,686,727,41,7,0,7,1,2,0,2,26,4.400306967,3307,1,1,385,414,29,21093,22124,1031,175,189,14,95.79496624
f5c4c7325cf9115e481f256f1f559f2b8420ec19,92,1018,1792,774,5,0,5,2,4,0,2,54,5.453992166,7922,1,1,743,728,15,59169,61669,2500,353,337,16,94.8816568
2f7951f0307e7284c97f5f6964fb95013a0e904c,4,3,12,9,0,0,0,2,2,28,2,4,1.825605199,370,10,10,60,60,0,2785,2785,0,30,30,0,100
b5b319506c359ed89a43e19fee9c3947c15abe09,3,29,9,20,0,0,0,1,2,25,2,3,1.474726008,337,3,3,60,55,5,2655,2555,100,24,23,1,99.97029115
6610616dabb3bc79846805f4e2a5a2cc4f1fb631,1,0,3,3,0,0,0,2,3,0,1,1,0,140,4,4,21,21,0,1144,1168,24,2,2,0,100
675e54563015107b4d36f0a3020c399d33eb968c,1,1,5,4,0,0,0,1,3,0,1,1,0,84,5,5,9,10,1,818,858,40,1,1,0,100
5f58a60489e36714b6eba7d40e6aecec9d5ec9f6,7,14,29,15,0,0,0,1,2,20,2,6,2.239763592,715,23,23,106,110,4,4861,4884,23,37,38,1,99.97029115
90b5692cc7ef3f98a50d9716bf0d1650ae24b2a3,0,0,0,0,0,0,0,0,0,0,0,0,0,0,2,2,0,0,0,0,0,0,0,0,0,100
c5582023f67e1d96077c1f4f577539d3cbb51838,0,0,0,0,0,0,0,0,0,0,0,0,0,0,2,2,0,0,0,0,0,0,0,0,0,100
22185b0ce1a7b5eb0b1d200080229d30c8e798e4,0,0,0,0,0,0,0,0,0,0,0,0,0,0,3,3,0,0,0,0,0,0,0,0,0,100
e336747df99fa9f48f8660fe2b2326ed6d4c8f38,0,0,0,0,0,0,0,0,0,0,0,0,0,0,24,24,0,0,0,0,0,0,0,0,0,100
35b7e9736cbd2010b86fde2ce1cd004f30985ab9,1,1,1,0,0,0,0,2,2,16,1,1,0,31,9,9,0,0,0,143,143,0,0,0,0,100
42c9ca7fb87493bf9b04deb0537828d8bba0b4cc,4,22,9,13,0,0,0,1,3,9,2,4,1.437436633,368,2,2,59,55,4,2734,2698,36,24,23,1,99.97029115
c8ece66937e33ac35c350e934f5520a5f9eae359,1,1,1,0,0,0,0,2,2,16,1,1,0,31,10,9,0,0,0,143,143,0,0,0,0,100
3eaa80c780fa4a2b207f7da34feab6b8ce9a9fe7,2,0,70,70,0,0,0,2,2,52,1,2,0.591672779,88,25,17,1,11,10,117,303,186,1,11,10,99.88105858
d02bd3b7000e635adae79483458f73d75237dd87,21,107,73,34,0,0,0,2,4,39,1,15,3.816590829,1597,26,17,199,198,1,10866,10512,354,79,78,1,97.83447048
eebf7ddf28eefb1cbd3007a765cab6e69f05bdab,0,0,0,0,0,0,0,0,0,0,0,0,0,0,27,18,0,0,0,0,0,0,0,0,0,100
42b058cb5c38020dd26318431163988f827c0566,1,3,0,3,0,0,0,1,2,20,1,1,0,41,11,8,2,2,0,166,159,7,2,2,0,100
92ecb3a8dcfa459e2e596330955595fa7f1b0b9a,32,178,140,38,1,0,1,1,4,7,2,23,4.297808328,2439,10,2,332,325,7,15515,15680,165,154,146,8,97.68820391
a98ed5d30b1cdc058fb5be7921bdbed7ccd5f4f6,0,0,0,0,0,0,0,0,0,0,0,0,0,0,11,3,0,0,0,0,0,0,0,0,0,100
8c460065e3ad2eb843bfd8b1b12cd7ed596ea6ce,0,0,0,0,0,0,0,0,0,0,0,0,0,0,12,4,0,0,0,0,0,0,0,0,0,100
5ce6f223067b2b50c86611d6bc8a3198198ecfa2,0,0,0,0,0,0,0,0,0,0,0,0,0,0,13,5,0,0,0,0,0,0,0,0,0,100
c2784733c22884b5fdb96be9f4d85480a9031739,1,13,0,13,1,0,1,1,1,0,1,1,0,0,14,6,1,0,1,45,0,45,1,0,1,99.94061758
b7471909987faf4ad7b019bd2af54cd3749a1b9d,1,1,1,0,0,0,0,1,2,0,1,1,0,7,15,7,1,1,0,41,45,4,1,1,0,100
4b76b8fb5319410c622458884b27fc9c8486f93a,0,0,0,0,0,0,0,0,0,0,0,0,0,0,16,8,0,0,0,0,0,0,0,0,0,100
1670fd0875f0797daa68045af0c5a0ddca43e8f6,33,140,191,51,0,0,0,1,4,23,2,24,4.367970042,2470,2,2,325,333,8,15680,15556,124,146,155,9,97.63033175
f3ca677bea8e895443b80b62f595caae504c6bce,0,0,0,0,0,0,0,0,0,0,0,0,0,0,14,1,0,0,0,0,0,0,0,0,0,100
15974409d869473603fcbecf640bd4fd4c752217,0,0,0,0,0,0,0,0,0,0,0,0,0,0,3,2,0,0,0,0,0,0,0,0,0,100
226831a09afa5d0e659c193391354dbdf9dc4613,1,0,56,56,0,0,0,1,2,75,1,1,0,47,15,2,0,8,8,0,130,130,0,8,8,99.9408284
080fa2d87018b6882116aeeff65e891d9915ec52,0,0,0,0,0,0,0,0,0,0,0,0,0,0,16,3,0,0,0,0,0,0,0,0,0,100
ae69096a2f472c799a8f59df924ce34eecff1da9,34,259,144,115,3,0,3,1,4,9,2,25,4.33280548,2439,17,8,346,325,21,15755,15680,75,163,146,17,97.56965027
b7745c7d09ee3e7b0bfb44e537d08cf5f416d866,33,144,203,59,0,0,0,1,4,23,2,24,4.356700107,2478,4,2,325,338,13,15680,15625,55,146,155,9,97.63033175
154837f3acb8c2eb59a52c82717ac7e1e6e76ffa,23,1459,0,1459,23,0,23,1,1,0,1,11,4.382932279,0,4,2,141,0,141,6836,0,6836,62,0,62,98.42748981
a6854e63a931853034d570072e5013c0d199d12b,24,0,1515,1515,0,0,0,1,2,3,1,12,4.449116203,1298,17,3,0,149,149,0,6966,6966,0,70,70,98.36829837
cfebc8cd6b16702461671a7ff033db7a0d9b0bef,24,1515,0,1515,24,0,24,1,1,0,1,12,4.449116203,0,5,3,149,0,149,6966,0,6966,70,0,70,98.36829837
f61fda37e33974a5e2d69ae97b06828f1af9693b,0,0,0,0,0,0,0,0,0,0,0,0,0,0,6,4,0,0,0,0,0,0,0,0,0,100
8e618d9d799fbf0ce6f4b68f3f3cd438a0c14511,1,13,0,13,0,0,0,1,2,1,1,1,0,68,7,5,11,8,3,447,393,54,6,5,1,100
6bf0d00f0a42c8b826d126c180ed3b0e83375c0e,23,0,1472,1472,0,0,0,0,0,0,1,11,4.380144682,1263,4,1,0,144,144,0,6890,6890,0,63,63,98.42748981
246d4279095dafb011d27baa8fe313ec4eb1a3ac,25,1662,0,1662,25,0,25,1,3,0,1,11,4.482501036,0,8,6,166,0,166,7950,0,7950,71,0,71,98.28388598
0ab5a98f4e37cab876d3db69206249f2c7d84cd1,25,0,1662,1662,0,0,0,0,0,0,1,11,4.482501036,1431,12,3,0,166,166,0,7950,7950,0,71,71,98.28388598
1ab3dd47f90347bff96ab73b40a27ab1c5cceead,0,0,0,0,0,0,0,0,0,0,0,0,0,0,28,3,0,0,0,0,0,0,0,0,0,100
f7012ee61f14d1b3b309a2975590229d9782ed3d,8,55,16,39,1,0,1,1,6,39,1,5,2.673949416,680,20,11,110,102,8,4202,4052,150,58,57,1,99.94089835
e96dd9287e95543917df03c6efb357740de5a785,5,46,20,26,0,0,0,1,4,50,1,5,2.035137902,899,21,11,167,164,3,7064,6987,77,48,48,0,100
546b43a45d5840220496247922149111637365fc,13,35,156,121,0,0,0,1,4,16,2,9,3.108225812,1664,18,4,265,284,19,10998,11355,357,104,113,9,99.88172679
84b52a431ad248e7e49253ea2329ebb018b70a1a,1,56,0,56,1,0,1,1,1,0,1,1,0,0,5,1,8,0,8,130,0,130,8,0,8,99.9408284
9d1f2acd019c736b1e2649f76d184c9ade66a14b,25,1662,0,1662,25,0,25,1,3,0,1,11,4.482501036,0,9,7,166,0,166,7950,0,7950,71,0,71,98.28388598
291c2a5d49102ded81039f10c83c2c622c255b42,36,82,1679,1597,0,0,0,0,6,9,2,19,4.719167824,3003,22,12,276,431,155,11225,18948,7723,105,175,70,98.22674419
95737c4b0751373b60eec3d590d8491991e90cac,37,1639,122,1517,21,0,21,1,4,3,3,19,4.741010526,1709,10,8,431,275,156,19010,11368,7642,175,104,71,98.22674419
a7f4b0bb8ccfb48bdb2e0860975ae575de9ea523,27,13,1720,1707,0,0,0,1,2,5,2,13,4.576052091,1538,3,1,5,177,172,414,8446,8032,1,80,79,98.22467986
8331e4be8a538ec4980d5417bf31fbc142143c2f,14,138,61,77,1,0,1,1,3,78,2,9,3.27999438,1173,28,2,163,155,8,7585,7169,416,58,49,9,99.9112426
4d7229d2ccd8910126bed83b5dda5d1f21579f32,14,48,136,88,0,0,0,1,2,5,2,9,3.228776483,1240,5,1,153,163,10,7121,7585,464,49,58,9,99.9112426
cb28812969841a2b7709aaca23c7cf3c491c4877,13,156,35,121,2,0,2,1,6,39,2,9,3.108225812,1572,22,11,284,265,19,11355,10998,357,113,104,9,99.88172679
a51ce2d6ca0f29b17e82d251946317be24d41a37,0,0,0,0,0,0,0,0,0,0,0,0,0,0,24,13,0,0,0,0,0,0,0,0,0,100
c1b9a7d93738cc5c43149157389186177d3f3872,1,0,56,56,0,0,0,1,2,75,1,1,0,47,26,15,0,8,8,0,130,130,0,8,8,99.94089835
851b555b71fed18c5c2d133abf4ec99e7fc96c9f,0,0,0,0,0,0,0,0,0,0,0,0,0,0,27,16,0,0,0,0,0,0,0,0,0,100
9bd96e4585cf068d3d3e7a10e5967822be2396ee,25,1662,0,1662,25,0,25,1,3,0,1,11,4.482501036,0,28,17,166,0,166,7950,0,7950,71,0,71,98.28388598
f423c2bc60b1c842873d7ea26962262867d037ce,13,80,48,32,0,0,0,3,3,88,2,8,3.366963661,1164,29,18,155,153,2,7455,7121,334,50,49,1,99.94275902
685d7a6818ea6ae022a6b3c7d370ccf8f1f00cb5,54,297,1768,1471,3,0,3,2,4,2,2,30,5.151963773,4378,3,1,453,616,163,20217,27416,7199,164,232,68,97.91304348
a610c251d9c502a40406de9ee6ccfce537549922,50,1842,83,1759,26,0,26,3,6,20,2,27,5.027647932,2736,12,10,597,418,179,26630,18119,8511,226,153,73,98.23903002
75dd9fd782f1dbd557b46b988fd4055e0b54c744,8,55,332,277,0,0,0,0,4,4,2,6,2.863904067,439,19,5,27,39,12,1455,2484,1029,7,13,6,99.57240593
6a3df5e02d9c6c0e3af0fb45eb6d388c5421bd93,0,0,0,0,0,0,0,0,0,0,0,0,0,0,20,6,0,0,0,0,0,0,0,0,0,100
5f618fa5f328d2aa29a04f7b3760d0d356b2411f,7,330,42,288,6,0,6,1,3,8,1,5,2.733268481,137,21,7,35,21,14,2098,1021,1077,11,5,6,99.57240593
d824a7c8bbdbca5cbc9736f45191ce928b7436d2,8,44,343,299,0,0,0,0,2,15,2,6,2.863904067,448,30,18,25,41,16,1407,2532,1125,7,13,6,99.57240593
df3969103851f76066ad05dfe6515dacfaf8faf2,0,0,0,0,0,0,0,0,0,0,0,0,0,0,31,19,0,0,0,0,0,0,0,0,0,100
afe86834a09e734d4c4235a8c762d2011bea2daf,1358,65791,65793,2,677,0,677,1,7,0,3,344,9.703651665,53622,32,20,7219,7899,680,347387,386492,39105,3615,4295,680,28.59416446
e05fac6d5c4140b3cd0b1e1c34b6b1154348cbb6,8,343,44,299,6,0,6,1,2,0,2,6,2.863904067,200,33,21,41,25,16,2548,1423,1125,13,7,6,99.65517241
37e44290d629dc726440ca3576a48994a726e4d9,3,33,149,116,0,0,0,1,2,0,1,3,0.864151905,181,34,22,7,25,18,433,1295,862,3,13,10,99.95088409
bf35ede03a55df9c851669e16c59049f696e0b6d,4,7,7,0,0,0,0,2,2,0,1,3,1.664497779,202,35,23,18,18,0,1109,1085,24,6,6,0,99.95085995
2bae0044361437155ec73fa7ce64bec6affbd1db,2,2,2,0,0,0,0,2,3,0,1,2,1,108,36,24,12,12,0,605,597,8,3,3,0,99.87714988
b72c796f691232028e8479970e8a476ecbad37cc,0,0,0,0,0,0,0,0,0,0,0,0,0,0,37,25,0,0,0,0,0,0,0,0,0,100
d74165fa4c82fd698be874ad5dc66a58bd349589,7,5,234,229,0,0,0,1,3,0,2,5,2.114567173,505,38,26,47,71,24,2349,3111,762,16,25,9,99.90167158
c99e1e9c7034c018b743515e990775a31d74842d,0,0,0,0,0,0,0,0,0,0,0,0,0,0,39,25,0,0,0,0,0,0,0,0,0,100
86fe855d0f5eb4fb9b15c748c01128eba7452108,0,0,0,0,0,0,0,0,0,0,0,0,0,0,40,21,0,0,0,0,0,0,0,0,0,100
5bffdfd3a9af0f65fd7257d4de114a198a73cce9,1,15,10,5,0,0,0,1,2,9,1,1,0,217,41,22,34,31,3,1664,1620,44,14,14,0,100
db5d61a668b808d0d53ad5af8c2b9a8ef30c5e9d,0,0,0,0,0,0,0,0,0,0,0,0,0,0,0,0,0,0,0,0,0,0,0,0,0,100
4329ef12365fbf163fc91126271ddad0d54198b9,5,9,9,0,0,0,0,1,1,0,1,3,2.113283334,216,14,9,14,5,9,1100,545,555,6,5,1,99.50811608
86e3d6d0d9684c96f5f9a145e96514eb65bc79e3,4,6,12,6,0,0,0,2,2,12,1,4,1.974937501,196,15,10,9,9,0,1289,1349,60,4,4,0,100
c38b9221dc7671fc87b781374fee4b44f1c32e03,1,3,2,1,0,0,0,2,2,18,1,1,0,78,16,11,8,8,0,521,495,26,5,5,0,100
ca6abfbe5c49a2a5713e94fa6655296a68866852,9,23,18,5,0,0,0,1,3,0,1,7,3.073436383,442,1,1,29,20,9,2647,2169,478,14,13,1,99.50811608
2c3005c99e7182d719755a5d61305c1627d9ce82,0,0,0,0,0,0,0,0,0,0,0,0,0,0,8,3,0,0,0,0,0,0,0,0,0,100
22929cb22cac980bcc5c290c7eb6a066ffe2d4c8,0,0,0,0,0,0,0,0,0,0,0,0,0,0,2,2,0,0,0,0,0,0,0,0,0,100
0783ee3425245627826db0c2cb193c51cd498dd4,0,0,0,0,0,0,0,0,0,0,0,0,0,0,0,0,0,0,0,0,0,0,0,0,0,100
e931c210d55f02d836f94c12f7bd037b7d9309d0,0,0,0,0,0,0,0,0,0,0,0,0,0,0,9,3,0,0,0,0,0,0,0,0,0,100
be7a62014dfe196931957c0f493bf870cb5cce26,0,0,0,0,0,0,0,0,0,0,0,0,0,0,3,3,0,0,0,0,0,0,0,0,0,100
4046666b170d4b3d8b3fcbcf3fc1b24e55f0d2dc,9,18,23,5,0,0,0,2,2,8,1,7,3.073436383,449,17,8,29,20,9,2649,2128,521,14,13,1,99.50811608
f9d688f00fc431a176a283d5d7caf43f1617e3a8,9,23,18,5,0,0,0,1,3,0,1,7,3.073436383,442,10,4,29,20,9,2647,2169,478,14,13,1,99.50811608
b7f23722235ce37585faec2c959b86f5197e3ba5,0,0,0,0,0,0,0,0,0,0,0,0,0,0,11,5,0,0,0,0,0,0,0,0,0,100
dc5b5ab38f830c942d9c22bd9bb0003dbc915839,0,0,0,0,0,0,0,0,0,0,0,0,0,0,42,21,0,0,0,0,0,0,0,0,0,100
b12c28f590c2f3614474c4065c8bf0766516b2c6,1,4,1,3,0,0,0,2,2,24,1,1,0,22,14,5,1,1,0,60,41,19,1,1,0,99.9754058
dfcf1409856521925fdb326c086da58f318fd334,10,19,27,8,0,0,0,2,2,4,2,8,3.235336283,473,18,9,30,21,9,2690,2188,502,15,14,1,99.48352189
43bae921711c2db6c505d0b4bca444ed7dd871d5,9,23,18,5,0,0,0,1,3,0,1,7,3.073436383,442,43,20,29,20,9,2647,2169,478,14,13,1,99.50811608
a9d064a739ce16d4697246de6fe1f0274781456e,0,0,0,0,0,0,0,0,0,0,0,0,0,0,44,21,0,0,0,0,0,0,0,0,0,100
92a040843aa046b7c01d949c9a8579e83ece8186,9,18,23,5,0,0,0,2,2,8,1,7,3.073436383,449,42,19,29,20,9,2649,2128,521,14,13,1,99.50811608
6f29955aeec4112318ab9ee5cdd52318376737c2,1,4,1,3,0,0,0,1,2,32,1,1,0,22,43,20,1,1,0,60,41,19,1,1,0,99.9754058
5d977e6ba3cb2282a05b520693ee059b2c31f0d7,10,24,22,2,0,0,0,1,3,0,2,8,3.235336283,466,11,5,30,21,9,2688,2229,459,15,14,1,99.48352189
34fa6d90a8cfe21a8ad85ce852b648a4a05cc363,31,776,85,691,9,0,9,2,3,10,2,17,3.800258335,1319,30,1,204,129,75,12314,7364,4950,93,58,35,98.65558543
9f3d2721471279744bdafd183408b89be12cd224,31,68,813,745,0,1,1,1,3,0,2,17,3.832208456,1914,45,22,143,190,47,8080,11649,3569,61,90,29,98.65558543
3de5cce698e2da3db223c468d28388ae5189a2e2,45,1541,106,1435,23,0,23,2,4,0,2,21,4.785960209,1319,31,2,244,129,115,15638,7364,8274,116,58,58,97.88681078
58a9555e28894e707d0dad528758dceb2e08d20f,1,1,1,0,0,0,0,2,2,32,1,1,0,78,32,3,12,12,0,648,648,0,3,3,0,100
b5efa1544344255587fbb3fa415a050795258e8d,46,90,1579,1489,0,0,0,1,3,0,2,21,4.809754297,2657,46,22,155,242,87,8728,15621,6893,64,116,52,97.88681078
4959646a6a4a57836ef94f18a93d60b4964de972,0,0,0,0,0,0,0,0,0,0,0,0,0,0,47,23,0,0,0,0,0,0,0,0,0,100
2ed0eaa5b3696c50ae8c6873588edbce8237ccc1,0,0,0,0,0,0,0,0,0,0,0,0,0,0,48,24,0,0,0,0,0,0,0,0,0,100
0a078a571fa687b26ac36645d226341e1d599127,0,0,0,0,0,0,0,0,0,0,0,0,0,0,49,25,0,0,0,0,0,0,0,0,0,100
8509591a3b691c7c1292d7f5164763e9877a752a,0,0,0,0,0,0,0,0,0,0,0,0,0,0,50,26,0,0,0,0,0,0,0,0,0,100
aee5d6fa2e919e6eff2f21f4c047256cf4e86775,0,0,0,0,0,0,0,0,0,0,0,0,0,0,51,27,0,0,0,0,0,0,0,0,0,100
6b9dc1c4b440d1a6709e643f931068ac534962dc,0,0,0,0,0,0,0,0,0,0,0,0,0,0,52,28,0,0,0,0,0,0,0,0,0,100
b372df2af9dd3c59f184d83f59a6938fe515ccb1,0,0,0,0,0,0,0,0,0,0,0,0,0,0,49,25,0,0,0,0,0,0,0,0,0,100
53b1da503cc0319879e75c8477b6f0ab4862bc13,0,0,0,0,0,0,0,0,0,0,0,0,0,0,54,30,0,0,0,0,0,0,0,0,0,100
0637cad6cf0c068c968cdfe8b957226372888225,10,22,24,2,0,0,0,2,2,7,2,8,3.235336283,471,57,33,30,21,9,2709,2169,540,15,14,1,99.48352189
66c3ef520e76791c0c664712c74564fb721b856e,0,0,0,0,0,0,0,0,0,0,0,0,0,0,4,4,0,0,0,0,0,0,0,0,0,100
b11a223a452b6a11d4a111175ca26948663d17ef,37,1567,65,1502,25,0,25,2,5,0,2,15,4.676560899,942,33,3,231,128,103,14208,6487,7721,105,50,55,98.39689094
31890530bb00ef38284b9df0d4838ffa3eb2c356,37,67,1569,1502,0,0,0,1,2,0,2,15,4.679874632,2263,5,5,128,231,103,6487,14208,7721,50,105,55,98.39689094
de30b151e0780c1242099c8c2aa24b2cccf09145,6,255,115,140,0,0,0,1,3,33,1,4,1.427223485,707,58,27,138,113,25,5338,4856,482,46,37,9,100
369093cd74c5091fc2a05cc53400301f64b91d87,0,0,0,0,0,0,0,0,0,0,0,0,0,0,59,27,0,0,0,0,0,0,0,0,0,100
f2fa44d7b21157facec5ebb9fa09b98781a998a5,0,0,0,0,0,0,0,0,0,0,0,0,0,0,60,28,0,0,0,0,0,0,0,0,0,100
91aa216a81505a8d3b9162cccfd8da3b558e0929,0,0,0,0,0,0,0,0,0,0,0,0,0,0,61,29,0,0,0,0,0,0,0,0,0,100
3ee73e8d5953b1c51d3c8c7d2af24ff417ca57f5,37,1567,65,1502,25,0,25,2,5,0,2,15,4.676560899,942,62,30,231,128,103,14208,6487,7721,105,50,55,98.39689094
9ffec2423e4131add3ce6b56969fc3ed9a16cf7b,0,0,0,0,0,0,0,0,0,0,0,0,0,0,63,31,0,0,0,0,0,0,0,0,0,100
ad4dc2ea93e7e27977241d3b9686506acd10effd,43,181,1823,1642,0,0,0,1,2,0,2,18,4.770963819,3103,6,6,241,369,128,11343,19546,8203,87,151,64,98.39689094
296b145791c4cc0fe83e6c9ac66dac5d15a3cca8,43,1822,180,1642,25,0,25,1,5,0,2,18,4.766532342,1649,64,32,369,241,128,19546,11343,8203,151,87,64,98.39689094
403e959d80b4a71455a31ab8931ac8804c026295,0,0,0,0,0,0,0,0,0,0,0,0,0,0,65,30,0,0,0,0,0,0,0,0,0,100
5334a23d0709b34b718c3be7cc0408ae090f7d61,0,0,0,0,0,0,0,0,0,0,0,0,0,0,66,28,0,0,0,0,0,0,0,0,0,100
e362b6f33b32f7afb13c215d545e18aed8baca94,28,1391,167,1224,12,0,12,2,6,30,2,14,3.890971677,1401,23,0,222,170,52,16937,10280,6657,112,71,41,98.83232135
eda2f96a879ad34ef8209c9cb508648a86fc0385,0,0,0,0,0,0,0,0,0,0,0,0,0,0,67,9,0,0,0,0,0,0,0,0,0,100
9f9531679d9d22b0a9c3912ace485f3e89f4a6f5,8,71,57,14,0,0,0,1,3,31,1,5,2.523563626,611,68,10,50,52,2,3812,4312,500,28,28,0,99.72702457
2076130d07aa9a31c098453c12eeae64cbda3266,0,0,0,0,0,0,0,0,0,0,0,0,0,0,69,11,0,0,0,0,0,0,0,0,0,100
56a0523e210bd9e925065b43c4d2f126fb324c4d,0,0,0,0,0,0,0,0,0,0,0,0,0,0,70,12,0,0,0,0,0,0,0,0,0,100
2734b42221346ca4eb7bf27894e89bac89f45ab8,0,0,0,0,0,0,0,0,0,0,0,0,0,0,13,0,0,0,0,0,0,0,0,0,0,100
52b8e58b1af53273782454f52e61b4f4700626c9,30,211,203,8,2,0,2,1,7,33,2,21,4.277208921,1868,71,13,196,197,1,11668,11969,301,104,100,4,99.31926481
20808642471c879b0e4a656a3023fde726b5570a,0,0,0,0,0,0,0,0,0,0,0,0,0,0,72,14,0,0,0,0,0,0,0,0,0,100
0c583e5d90f1053599fdf64ab9c8c693c4f5e9be,1,44,0,44,1,0,1,1,1,0,1,1,0,0,73,15,1,0,1,130,0,130,1,0,1,99.95475113
628e8753759294d3dfb5a0295493a1f2ef264631,23,563,499,64,9,0,9,2,4,25,2,9,4.227022628,1189,34,0,141,151,10,7999,8118,119,68,71,3,99.27699955
b6f83353d54a62f1f06df9c29337ee056f599c9e,2,59,133,74,0,0,0,2,4,96,1,2,0.827374478,160,35,1,13,21,8,676,1078,402,4,5,1,100
89f788a9b0bed5be4fe41c913261566dc136f1f8,0,0,0,0,0,0,0,0,0,0,0,0,0,0,74,4,0,0,0,0,0,0,0,0,0,100
feaeabc18454bc760cbc247bba6a1ba80047b118,13,642,9,633,8,0,8,2,5,33,1,5,3.203739182,883,24,0,151,112,39,9891,7015,2876,65,42,23,98.57627119
dea3112d3772b8242f5831d50959b19ab6981c97,0,0,0,0,0,0,0,0,0,0,0,0,0,0,25,1,0,0,0,0,0,0,0,0,0,100
4e77f11d9497a0ffb492c899ebba211493850ef8,16,1022,4,1018,12,0,12,1,2,28,1,7,3.440797356,414,26,2,198,59,139,8139,2926,5213,75,26,49,98.82565492
23b32b12a19c1b2359f565664f42d0d3864f943c,0,0,0,0,0,0,0,0,0,0,0,0,0,0,27,3,0,0,0,0,0,0,0,0,0,100
8537d4557461d107e6e0835971174d8f56a91396,0,0,0,0,0,0,0,0,0,0,0,0,0,0,14,0,0,0,0,0,0,0,0,0,0,100
dd72acebafae12cbcff2422e279f1b2432f3cc8d,0,0,0,0,0,0,0,0,0,0,0,0,0,0,75,1,0,0,0,0,0,0,0,0,0,100
e087501378ecf68e04e2546a46f718c845d06a70,26,1484,9,1475,22,0,22,1,6,9,3,17,4.253867927,598,36,0,202,81,121,11062,4694,6368,121,38,83,98.86287625
ce64b4202de6f6b093cd96414449a7d1af3f9047,0,0,0,0,0,0,0,0,0,0,0,0,0,0,15,1,0,0,0,0,0,0,0,0,0,100
dd26aa430194f489c475432bf34978d454e494b5,4,77,0,77,0,0,0,1,2,156,1,3,1.999638097,183,76,2,20,20,0,1953,1953,0,9,9,0,100
da8f419c67b5ef42dcc480a19ca7ebce5a9a16b9,102,2873,910,1963,17,0,17,2,7,20,3,35,5.208156706,5699,77,2,802,731,71,45399,41100,4299,397,232,165,93.83230904
178d0664629eb753e68378f70bb6b3905efab113,4,16,14,2,0,0,0,1,6,10,1,3,1.592784662,663,28,4,26,26,0,4994,4996,2,22,22,0,100
db2bbf91b30e8cc00adaadb64affb863dd41dc44,0,0,0,0,0,0,0,0,0,0,0,0,0,0,29,5,0,0,0,0,0,0,0,0,0,100
90a1fb3f886c2246841dd4a3c0df8136946813a2,2,40,12,28,0,0,0,2,3,104,1,2,0.779349837,63,30,6,9,5,4,304,249,55,5,2,3,100
48870eafe49dc4088d73303cf111c6636c7abe83,0,0,0,0,0,0,0,0,0,0,0,0,0,0,78,3,0,0,0,0,0,0,0,0,0,100
f6c63e78a6e16e647e4c245332fc83b934397450,1,0,1,1,0,0,0,2,2,9,1,1,0,216,37,1,35,35,0,1636,1643,7,14,14,0,100
c1485aac543cff1245b7eab359a89d60c35424b1,51,221,180,41,2,0,2,1,5,80,2,24,4.544130726,3432,79,4,427,354,73,21649,21398,251,200,145,55,96.91912709
a979b0f2a19d2bd8f1f5313baad021ee4efd2821,5,30,13,17,0,0,0,1,4,4,1,2,2.057841734,601,80,4,99,96,3,4570,4440,130,37,37,0,100
8f8a58f98f545ae1c75fb4aadd3a17a6f8e7f02e,0,0,0,0,0,0,0,0,0,0,0,0,0,0,81,5,0,0,0,0,0,0,0,0,0,100
d00513ce52063f41a7577ac40d7081e446228a6c,0,0,0,0,0,0,0,0,0,0,0,0,0,0,82,6,0,0,0,0,0,0,0,0,0,100
13bb16cf44cb41ae0be235bd7f5fcfcf27c86bea,24,883,342,541,6,0,6,2,7,19,4,16,3.218616175,1997,83,7,277,254,23,17457,14948,2509,118,102,16,98.63945578
4688a9ccbf8a906ab9f394d456c7c46422cae4b3,0,0,0,0,0,0,0,0,0,0,0,0,0,0,84,8,0,0,0,0,0,0,0,0,0,100
52a89dc6d15ed18177256fec0326833dc6c846fb,0,0,0,0,0,0,0,0,0,0,0,0,0,0,85,9,0,0,0,0,0,0,0,0,0,100
dcfeae75998af071dffe9a78ba3dfdd957285241,0,0,0,0,0,0,0,0,0,0,0,0,0,0,86,10,0,0,0,0,0,0,0,0,0,100
2ac5985f963ed06624bdfc679432f5e86e8efb25,0,0,0,0,0,0,0,0,0,0,0,0,0,0,87,8,0,0,0,0,0,0,0,0,0,100
bd3b555a156e60f989b490c0596edc07a509d01f,1,4,0,4,0,0,0,1,2,37,1,1,0,179,88,8,14,14,0,1234,1221,13,8,8,0,100
f213bab049c9f19e7a1e8ecee25c7cbd76a3c318,9,144,185,41,1,0,1,1,8,30,2,6,2.677094445,663,89,8,30,36,6,4087,4494,407,20,21,1,98.61519094
0a984939832534acf2f867f9dfffed339be5859c,12,179,45,134,0,0,0,2,9,63,1,10,2.652355725,1555,31,0,255,225,30,12498,11757,741,101,90,11,99.97956682
caa2dfef50edb6801edc06c4fc1ec4a25e3dccb8,0,0,0,0,0,0,0,0,0,0,0,0,0,0,32,1,0,0,0,0,0,0,0,0,0,100
88d0126cb2e8a74f01aef968c553de763d1e5212,37,1920,363,1557,23,0,23,1,5,22,2,14,4.705793156,1209,33,2,300,165,135,14943,7992,6951,162,83,79,97.0793912
fba3aebae232ba4090dc3fdc64dbdd2946b197ce,0,0,0,0,0,0,0,0,0,0,0,0,0,0,2,0,0,0,0,0,0,0,0,0,0,100
c7ce706b4217d8e68388bf1fffade2eec489f2bc,27,42,35,7,0,0,0,1,10,139,3,19,4.405952612,2596,90,0,321,321,0,18798,18893,95,133,133,0,100
9fb932cfcb9296e4c608fab6b869381876093246,2,3,3,0,0,0,0,2,3,59,2,2,0.918295834,341,91,1,27,27,0,2489,2486,3,15,15,0,100
62db846d6df909639b6b57d4951358634d5f3bfc,0,0,0,0,0,0,0,0,0,0,0,0,0,0,0,0,0,0,0,0,0,0,0,0,0,100
46155d97c9316b5d91a1e992dae23abdad5ec644,0,0,0,0,0,0,0,0,0,0,0,0,0,0,1,1,0,0,0,0,0,0,0,0,0,100
86f2f8f0ec8d44934c4396e7bf9d678ed9306a72,0,0,0,0,0,0,0,0,0,0,0,0,0,0,92,2,0,0,0,0,0,0,0,0,0,100
f9a921157c6104fda91251fa5bf01e5f2c3dcdc5,0,0,0,0,0,0,0,0,0,0,0,0,0,0,93,3,0,0,0,0,0,0,0,0,0,100
eb0734b6f1eb0d868f7d8d39d5e543a11d87d0bb,1,4,2,2,0,0,0,2,2,16,1,1,0,114,2,2,17,17,0,832,828,4,7,7,0,100
d37643b0ae7c3fe22fe2794a9fa18ec74b8f9eb2,17,634,102,532,7,0,7,1,4,97,2,9,3.403947597,932,94,4,143,88,55,8942,6150,2792,66,32,34,98.47535505
1965b4aff6f27b971effc7bd5be0fd773a686789,0,0,0,0,0,0,0,0,0,0,0,0,0,0,95,5,0,0,0,0,0,0,0,0,0,100
6f4fb5c4b4084067e4ad9abcfd0feef931cbd84e,0,0,0,0,0,0,0,0,0,0,0,0,0,0,16,0,0,0,0,0,0,0,0,0,0,100
7bc5d9a65bc53aa1019eac380c3acfdd17976619,0,0,0,0,0,0,0,0,0,0,0,0,0,0,17,1,0,0,0,0,0,0,0,0,0,100
d9ef76d9756fbf7c8992918b6f99fa2ca4c392fd,0,0,0,0,0,0,0,0,0,0,0,0,0,0,18,2,0,0,0,0,0,0,0,0,0,100
2b09be95443ae7f2658e772362d5a91b5dd571d6,28,59,56,3,0,0,0,3,11,104,2,17,4.59337076,2717,20,0,357,357,0,19229,19219,10,153,153,0,100
1a3b9b0861c0cfb7750e27c94d3a152570cebdfb,0,0,0,0,0,0,0,0,0,0,0,0,0,0,19,3,0,0,0,0,0,0,0,0,0,100
d394a8e34ddb758f1f6f96bf40346d176859628b,23,286,504,218,3,0,3,1,4,207,2,11,4.190132413,1060,21,1,115,132,17,5789,6162,373,35,53,18,99.06858594
a641aca155531edaf4e6ab843d6aa2c7f4eff022,0,0,0,0,0,0,0,0,0,0,0,0,0,0,96,5,0,0,0,0,0,0,0,0,0,100
6732a4e6eefc1891ca9119ca10d35874a0784584,0,0,0,0,0,0,0,0,0,0,0,0,0,0,20,4,0,0,0,0,0,0,0,0,0,100
ce2d54c1d9fc5d85d2d4a8b143f9a05f02f8d4d6,51,560,345,215,9,0,9,0,10,28,4,28,4.790725254,3629,3,0,489,472,17,25381,25018,363,206,188,18,99.06858594
1b74ed649371518d00cc750d3aa72acb2b9bb8be,3,21,18,3,0,0,0,2,2,165,1,1,1.584962501,221,4,1,35,35,0,1319,1319,0,18,18,0,100
66258977a13e40b0b0e9c16a946293456eeed2b2,54,363,581,218,3,0,3,1,11,122,4,29,4.906566516,4001,3,0,507,524,17,26337,26700,363,206,224,18,99.06858594
37c0fe16afbbd6bccb7c0d24b9afd464b807655d,3,21,18,3,0,0,0,2,2,165,1,1,1.584962501,221,6,3,35,35,0,1319,1319,0,18,18,0,100
cad5d965ca597fc52109a38f1d0b265abb7cbe45,0,0,0,0,0,0,0,0,0,0,0,0,0,0,7,4,0,0,0,0,0,0,0,0,0,100
cab2e42d06d0cb5cea9f6f61b6f4b81570eacab4,0,0,0,0,0,0,0,0,0,0,0,0,0,0,4,1,0,0,0,0,0,0,0,0,0,100
625f7c19a8827c1cae762b0d4ab7e0e5a9b23d4f,0,0,0,0,0,0,0,0,0,0,0,0,0,0,21,5,0,0,0,0,0,0,0,0,0,100
124de31aabcb33154d4e3546bac36fb42917cd21,0,0,0,0,0,0,0,0,0,0,0,0,0,0,22,6,0,0,0,0,0,0,0,0,0,100
84d4723d8263b1c16b54efff3da04f79373bc583,0,0,0,0,0,0,0,0,0,0,0,0,0,0,34,0,0,0,0,0,0,0,0,0,0,100
267a8d385e10c000e117b32436ed6b69608a9d39,0,0,0,0,0,0,0,0,0,0,0,0,0,0,35,1,0,0,0,0,0,0,0,0,0,100
16ae0c316bb84c290abbdfee8376637132f7bb62,1,21,1,20,0,0,0,3,7,99,1,1,0,240,97,1,46,43,3,1996,1867,129,20,17,3,100
91b195650a6fc796aba5c91c85408925bdf0a61b,1,1,21,20,0,0,0,3,6,55,1,1,0,256,23,6,43,46,3,1867,1996,129,17,20,3,100
bdd79e46c3cc4a422065a7c829f5a9d320538332,0,0,0,0,0,0,0,0,0,0,0,0,0,0,97,1,0,0,0,0,0,0,0,0,0,100
986a9996f9d9e80f53f841bbfe61cffab566eacf,0,0,0,0,0,0,0,0,0,0,0,0,0,0,98,2,0,0,0,0,0,0,0,0,0,100
c8c826b3017983830a372aef66612569cd31201a,0,0,0,0,0,0,0,0,0,0,0,0,0,0,99,3,0,0,0,0,0,0,0,0,0,100
4c1831aa1682c4f5fc332e4577df6bd7eb3e787b,0,0,0,0,0,0,0,0,0,0,0,0,0,0,100,4,0,0,0,0,0,0,0,0,0,100
ffd84fa0e2dcf2fd3a8d444e1b589341789f6bcd,53,1114,333,781,5,0,5,1,4,179,2,30,4.860001929,4473,101,5,718,597,121,35223,30314,4909,361,318,43,96.7800045
877ca9369a1ffda6e17a62a2ebcb2b51ac49995f,0,0,0,0,0,0,0,0,0,0,0,0,0,0,102,6,0,0,0,0,0,0,0,0,0,100
e0529d4d59287fa7d18b6d636a4d28b50b9ff408,0,0,0,0,0,0,0,0,0,0,0,0,0,0,103,7,0,0,0,0,0,0,0,0,0,100
123e80993f10b356d96dc3efa5e07f9775503bed,0,0,0,0,0,0,0,0,0,0,0,0,0,0,104,8,0,0,0,0,0,0,0,0,0,100
e21da5c2943cb49f6eb59df9ed7c9c950db6f5b5,0,0,0,0,0,0,0,0,0,0,0,0,0,0,105,9,0,0,0,0,0,0,0,0,0,100
8ce8d384c5fda4d8087d9c6d8eb0aa9afec528f1,0,0,0,0,0,0,0,0,0,0,0,0,0,0,106,10,0,0,0,0,0,0,0,0,0,100
34aec7e9a99e231be74193f4446943ca49488f0f,0,0,0,0,0,0,0,0,0,0,0,0,0,0,102,6,0,0,0,0,0,0,0,0,0,100
45f7c7067b8a44c6fe630b859998c1bbb707e65d,0,0,0,0,0,0,0,0,0,0,0,0,0,0,108,12,0,0,0,0,0,0,0,0,0,100
c6b76b9d7effa3594168da5af6b219330e215b97,1,21,1,20,0,0,0,3,7,99,1,1,0,240,110,14,46,43,3,1996,1867,129,20,17,3,100
c4bdb63f83e5d7d12924466e5eea778fbd061a8e,1,1,2,1,0,0,0,1,2,6,1,1,0,174,111,15,28,28,0,1309,1316,7,9,9,0,100
0605b34faaff218a847bb8b2b7ea9e2ae114b32f,12,360,44,316,3,0,3,1,5,38,1,9,2.941609046,1351,112,15,256,215,41,11951,10139,1812,103,88,15,98.11494253
f9b1316717c0f1083b2b84284ddb2ddfd44d3ca7,0,0,0,0,0,0,0,0,0,0,0,0,0,0,113,16,0,0,0,0,0,0,0,0,0,100
60f4fcf5caf1c7027ec9ad43fb0538b7af16f5fd,0,0,0,0,0,0,0,0,0,0,0,0,0,0,24,2,0,0,0,0,0,0,0,0,0,100
46ad97843b8ed54b88a813040568aa23f0c5f73a,0,0,0,0,0,0,0,0,0,0,0,0,0,0,25,2,0,0,0,0,0,0,0,0,0,100
57aa3d3acc25fb0d5d75757268c3fed2ca3eb9b0,0,0,0,0,0,0,0,0,0,0,0,0,0,0,26,3,0,0,0,0,0,0,0,0,0,100
c2c187789270b3559b1cccb3c9a7dd9ef655dc14,0,0,0,0,0,0,0,0,0,0,0,0,0,0,27,3,0,0,0,0,0,0,0,0,0,100
a3986fccbcb9e50d51184810f928441f6f24bc44,11,134,112,22,1,0,1,2,4,145,2,9,2.888569545,672,22,0,86,84,2,4525,4252,273,29,31,2,99.73474801
1026b84877abd2fd0ab49bd734d47cccbff54d07,1,2,2,0,0,0,0,2,3,62,1,1,0,106,3,0,14,14,0,847,843,4,2,2,0,100
ee6c6ad6d07c1294605d42a05926bff7a20481c2,0,0,0,0,0,0,0,0,0,0,0,0,0,0,0,0,0,0,0,0,0,0,0,0,0,100
6a0a11f2da3c0d11091fcc2e2f05258f61a3da99,0,0,0,0,0,0,0,0,0,0,0,0,0,0,0,0,0,0,0,0,0,0,0,0,0,100
48ac798da4bdfa14c96604b277b14dec4f44181c,0,0,0,0,0,0,0,0,0,0,0,0,0,0,114,0,0,0,0,0,0,0,0,0,0,100
f6aebe631c20685674c0d5c57b29c0ff257ddcc8,0,0,0,0,0,0,0,0,0,0,0,0,0,0,23,1,0,0,0,0,0,0,0,0,0,100
f311630fb8cb7a77d3543c01dd299bbc6f1e9090,1,4,10,6,0,0,0,1,2,426,1,1,0,49,115,1,2,2,0,201,295,94,2,2,0,100
8e338fea1a36a7842e72ab23e80c6a29654cb59d,0,0,0,0,0,0,0,0,0,0,0,0,0,0,28,0,0,0,0,0,0,0,0,0,0,100
60325aa2fccc81d47a3f2e27799bb697a6b06381,6,37,12,25,0,0,0,1,4,120,1,6,1.698362928,388,116,2,49,46,3,2365,2272,93,30,30,0,100
7cfb19e5937a7eb2c3a3c81cbfca5aa20d822d3f,0,0,0,0,0,0,0,0,0,0,0,0,0,0,1,1,0,0,0,0,0,0,0,0,0,100
3b405cbf821d96074c556cf0f2c6cb8374c0ee3b,0,0,0,0,0,0,0,0,0,0,0,0,0,0,117,3,0,0,0,0,0,0,0,0,0,100
772938ade85474072a27c312efc18315598e3497,0,0,0,0,0,0,0,0,0,0,0,0,0,0,118,4,0,0,0,0,0,0,0,0,0,100
c46cc7e23e2bcd40bed2d2bda4cf8f01dfbca975,0,0,0,0,0,0,0,0,0,0,0,0,0,0,0,0,0,0,0,0,0,0,0,0,0,100
f9b1bc7b63c0cd6a180689dc831890d7778f8432,0,0,0,0,0,0,0,0,0,0,0,0,0,0,119,5,0,0,0,0,0,0,0,0,0,100
12e4395fda473e6474d556843b21bb576b79c2fd,22,276,104,172,2,0,2,2,5,170,1,10,3.330936706,1392,24,1,180,171,9,8969,7999,970,107,100,7,98.20587576
48b59525110c4073ff75b371f58c8ebabd159b7b,0,0,0,0,0,0,0,0,0,0,0,0,0,0,120,6,0,0,0,0,0,0,0,0,0,100
4bcf78abcb67836d3b7b204ecb81f9701a76e45f,0,0,0,0,0,0,0,0,0,0,0,0,0,0,25,2,0,0,0,0,0,0,0,0,0,100
72b79c5588964039b69b4625b04f5035136b6751,0,0,0,0,0,0,0,0,0,0,0,0,0,0,121,7,0,0,0,0,0,0,0,0,0,100
01f48fe8034a9eaf935e1576d442f3c348b66d84,2,19,2,17,0,0,0,1,6,77,1,2,0.958711883,324,122,8,53,49,4,2611,2452,159,20,19,1,100
74a2655d99d12d752ce149cf8ec718ec6530f53e,0,0,0,0,0,0,0,0,0,0,0,0,0,0,123,9,0,0,0,0,0,0,0,0,0,100
1ea33dcc8ed25349389c759d94f0506729cc438e,0,0,0,0,0,0,0,0,0,0,0,0,0,0,124,10,0,0,0,0,0,0,0,0,0,100
ed270c9e38f0316ecb9a2b6bcba5d1169d81ba2f,0,0,0,0,0,0,0,0,0,0,0,0,0,0,29,1,0,0,0,0,0,0,0,0,0,100
5d82c61099416c99e3a3f011d0851c0589ddf383,0,0,0,0,0,0,0,0,0,0,0,0,0,0,26,3,0,0,0,0,0,0,0,0,0,100
99b25759c0f742bea27a60773808bf5b8ceffc3d,0,0,0,0,0,0,0,0,0,0,0,0,0,0,27,3,0,0,0,0,0,0,0,0,0,100
ecf75b280ba63733b285ee18925f0489f69601f0,36,1186,150,1036,18,0,18,2,5,103,4,23,4.465402016,1536,28,4,275,214,61,14903,11907,2996,135,79,56,98.80388174
035a9f6949e3ef378e98c9fad84c3087afef5e4d,0,0,0,0,0,0,0,0,0,0,0,0,0,0,29,5,0,0,0,0,0,0,0,0,0,100
c2574fe40d0ff6c9d81febc3acde87b757b17953,36,150,1186,1036,0,0,0,1,4,26,4,23,4.465402016,2412,36,0,195,294,99,10672,16138,5466,79,135,56,98.80388174
a725ea5578917fde915675123c5251eb6afd99b9,36,1186,150,1036,18,0,18,2,5,103,4,23,4.465402016,1536,30,4,275,214,61,14903,11907,2996,135,79,56,98.80388174
d8be43f1f7ea22fccf8478dc335bbde42ce856f4,2,8,8,0,0,0,0,4,8,375,2,2,0.811278124,161,31,5,17,17,0,1237,1293,56,8,8,0,100
f90a0a49a6cb4b9c2d10881c5fe2cd80c3b9d72e,38,158,1194,1036,0,0,0,1,7,22,4,23,4.514879886,2569,37,1,212,311,99,11965,17375,5410,87,143,56,98.80388174
02fcb79d7dcb959338547bec280cff1991b33cdb,38,1199,158,1041,18,0,18,2,8,116,4,23,4.51510984,1697,32,5,294,231,63,16196,13200,2996,143,87,56,98.36689038
cf4b277a1645087df306e3b2f2c133c58a8826e2,1,2,1,1,0,0,0,3,5,153,1,1,0,425,33,5,20,20,0,3366,3359,7,16,16,0,100
8087ec0b64f3809360361233d2d356fea4b19364,1,1,1,0,0,0,0,3,6,0,1,1,0,426,34,6,20,20,0,3366,3366,0,16,16,0,100
6768fe4924fe321c4c89736f8118e17f0c8ab8fb,0,0,0,0,0,0,0,0,0,0,0,0,0,0,35,3,0,0,0,0,0,0,0,0,0,100
8dad5fe6fd83b76674e4df6e6bd50e0b11f3bec0,1,15,6,9,0,0,0,3,4,140,1,1,0,106,0,0,16,14,2,901,847,54,2,2,0,100
50ff38d99de630d6cb4ced324317237bcca65e8b,0,0,0,0,0,0,0,0,0,0,0,0,0,0,38,0,0,0,0,0,0,0,0,0,0,100
8dbbf7100f12ddd75215e1ae99384623dd5cf3f7,1,40,6,34,0,0,0,1,2,288,1,1,0,133,39,1,27,20,7,1224,945,279,6,6,0,100
8df78b185eaba1c094ae7b713b4342a476e9b92a,1,13,8,5,0,0,0,2,2,559,1,1,0,218,40,2,34,34,0,1605,1605,0,7,7,0,100
e7433a3b1647131433fd1473d9514d64fdac5643,0,0,0,0,0,0,0,0,0,0,0,0,0,0,41,3,0,0,0,0,0,0,0,0,0,100
9ad4b635d1bad7d7db9470b7ab48d99d1e4aa3e1,1,39,18,21,0,0,0,3,8,215,1,1,0,256,42,4,46,46,0,2012,1996,16,20,20,0,100
e618d256e4854602d01a6440f51d9962be7eedea,0,0,0,0,0,0,0,0,0,0,0,0,0,0,43,5,0,0,0,0,0,0,0,0,0,100
5578cfd912d70ebc0bb52a754f145996c6e5efd8,1,43,0,43,1,0,1,1,1,0,1,1,0,0,44,6,1,0,1,188,0,188,1,0,1,99.95606327
253f99bce6fb72fd18823dca0d496516fda6dde0,8,511,0,511,7,0,7,1,3,26,2,5,2.825927808,111,45,7,56,18,38,3660,682,2978,27,10,17,99.67170059
4ad4b5ccfcd3d3df16d03080ac9a73a1465c2d3d,0,0,0,0,0,0,0,0,0,0,0,0,0,0,0,0,0,0,0,0,0,0,0,0,0,100
0a76242d13c3163acc830877459a89dc20d16f42,0,0,0,0,0,0,0,0,0,0,0,0,0,0,30,0,0,0,0,0,0,0,0,0,0,100
fd39e6e14ed5cdca1e7b4314b2b4e5e1d1d97425,27,1357,5,1352,23,0,23,1,4,46,1,12,4.425696221,262,0,0,129,37,92,8552,1791,6761,65,8,57,96.43243243
ffd5fddd357effae7aaf2384a2a9b6d479f9c930,3,29,6,23,0,0,0,1,2,105,1,2,1.15617873,187,36,1,25,21,4,1456,1289,167,8,6,2,100
341816d48657ef79252b41c46df4b0b4a10d14dc,6,121,45,76,1,0,1,2,5,427,1,3,2.176325909,364,37,2,63,54,9,2427,2132,295,24,20,4,99.93573265
614c118ef3d739cccb18bdeed0bbdb58b757649f,279,27304,0,27304,279,0,279,1,1,0,1,70,7.744895553,0,4,0,2579,0,2579,135634,0,135634,1647,0,1647,81.9740064
656dd2305754e5ed0d19f36008c11276ca4010a1,31,484,31,453,0,0,0,2,2,0,1,13,4.931811724,1525,0,0,260,260,0,10909,10909,0,169,169,0,100
737e5a2d50c9d479d6810bfb7562e54a2d0dfb47,359,4,5,1,0,0,0,1,3,2,2,96,0.764204507,25934,125,0,3130,2864,266,171071,441892,270821,1951,2149,198,76.52468538
8dc70df42f917c58f2fca131ec45c418be68c055,0,0,0,0,0,0,0,0,0,0,0,0,0,0,126,1,0,0,0,0,0,0,0,0,0,100
1d51f826c735096aa3c4cc1eb16362359c1d3b29,21,339,138,201,1,0,1,1,2,0,1,9,2.903384216,1394,127,2,194,164,30,9803,8734,1069,138,109,29,99.13153324
9850801123d408194ffbd84cd215344c15fd3240,3,0,110,110,0,0,0,1,2,6,1,1,1.572295744,78,128,3,0,4,4,0,185,185,0,4,4,98.50988014
9d16f213c991a816b4cf89732a51243b871b0c5a,3,2,229,227,0,0,0,1,4,154,1,3,0.197633163,434,129,4,36,65,29,1407,2405,998,32,61,29,99.88608625
eef4930c3b9cac7d8c596af684ba098ec2b2229d,107,770,487,283,6,0,6,2,7,310,4,55,5.082739159,10655,46,0,786,758,28,91292,88082,3210,397,411,14,98.84758968
8b646715edbe8f0e3a4a2d926c10e4a942117085,34,0,2896,2896,0,0,0,2,5,410,1,10,4.787542082,2391,47,1,0,315,315,0,16421,16421,0,147,147,96.93168334
7f6269cd913a2d31f45eba4e791b223011cfec0d,9,307,42,265,6,0,6,1,2,0,1,2,2.961464311,202,48,2,31,15,16,2003,1216,787,18,6,12,99.75216853
f857cbe42a351157d00204345b96105f798b534c,6,341,5,336,1,0,1,2,3,58,1,5,2.181642607,633,38,0,141,91,50,5875,3916,1959,123,88,35,99.96468927
fe50912574dfe2126da0154b8544d81022126acc,112,11129,10,11119,111,0,111,1,3,2,2,21,6.245013916,352,49,0,1456,71,1385,58311,3271,55040,762,18,744,95.21731834
72a1501c3ff645d93067b4fd9907f8183c2763b6,103,3442,866,2576,28,0,28,2,6,74,2,43,5.680772199,6734,5,0,973,765,208,60050,46131,13919,552,449,103,97.04104359
160f674cd17f5530e08524179c2bf1ea83090ccf,1,3,7,4,0,0,0,2,3,3,1,1,0,43,130,0,2,2,0,190,225,35,1,1,0,100
0b77d947a4ebdb996d837414c9e3eaa8b0f06093,2,6,11,5,0,0,0,3,3,2,1,2,0.936667382,233,0,0,24,24,0,1569,1639,70,12,12,0,100
1dffec09ccb084c484e0427d2ce2cb567403cf21,33,1092,941,151,12,0,12,2,6,231,1,11,4.697217562,1159,50,1,118,188,70,8498,8863,365,65,114,49,97.06754017
f3e7687e33ebe519b09660332bcf24a78630392a,0,0,0,0,0,0,0,0,0,0,0,0,0,0,51,2,0,0,0,0,0,0,0,0,0,100
9f6fea4ab65f4e7386d01b936b3a5d913ebee7e6,37,2955,0,2955,37,0,37,1,1,0,1,11,4.941048227,0,39,0,340,0,340,12435,0,12435,264,0,264,98.5902683
3ac32770d4dec422428560fd6f5e96f3d27b219b,4,111,0,111,1,0,1,3,4,378,1,2,0.515569805,382,40,1,77,63,14,3367,2843,524,32,27,5,99.9701225
9d32fb1726785df7a4a7054f155bd50df5f2a77b,1,6,4,2,0,0,0,2,3,271,1,1,0,68,41,2,8,8,0,331,293,38,8,8,0,100
0cbce7f7b4bee1845f223403357c88ea7c0be583,0,0,0,0,0,0,0,0,0,0,0,0,0,0,42,3,0,0,0,0,0,0,0,0,0,100
a153b233f9e9e0470cebb7e45ffe858067f73195,4,6,4,2,0,0,0,3,4,272,1,2,1.570950594,655,0,0,33,33,0,6058,6044,14,13,13,0,100
04468a9f87d528db994b1334238d40d88f9db8d6,0,0,0,0,0,0,0,0,0,0,0,0,0,0,1,1,0,0,0,0,0,0,0,0,0,100
f0af3e5dc7cebdff426d0450bea7256a31ca77ec,32,695,142,553,2,0,2,3,4,57,1,19,3.88270421,4604,6,0,586,542,44,40248,37394,2854,317,294,23,99.92538427
e21b073f6a21e2b9b6aa580d11dbadfa474c9c4c,125,4926,19,4907,73,0,73,1,5,12,5,43,6.001146674,4658,131,1,1161,323,838,48362,17155,31207,804,255,549,94.67514124
e73e35da0fa778564fb23582478541fe390f2a0a,43,931,358,573,11,0,11,2,2,0,3,15,4.583026604,1724,1,0,279,162,117,13825,9823,4002,213,129,84,98.79632134
ef84ca1e3c3b0bfc04ece5d6f453262b00ccff95,0,0,0,0,0,0,0,0,0,0,0,0,0,0,2,2,0,0,0,0,0,0,0,0,0,100
fabfc25b9d30faff7b72f45c2ca39e392726eda8,1,2,2,0,0,0,0,2,3,8,1,1,0,64,132,1,6,6,0,376,376,0,6,6,0,100
f1a93b1bbc29aadbda5f09ddf2622252e8893b0b,6,172,64,108,0,0,0,3,4,88,1,6,1.475552973,341,7,1,31,22,9,3764,3028,736,21,15,6,100
043a103fd6137fd9367e5ad520fb19fffb954469,11,140,87,53,2,0,2,2,3,9,2,5,3.065382875,598,133,2,90,89,1,3728,3675,53,71,70,1,99.75576662
c017fe4cdfcba0c95b9a32f665e8314a8bf99271,6,68,94,26,0,0,0,2,4,8,2,5,1.3726467,548,134,3,70,79,9,3740,3682,58,59,67,8,99.76889614
8777936d2edfd02ff55f3f7cd6a9caa78b8c74bd,3,34,34,0,0,0,0,2,4,8,2,2,1.16202149,156,135,4,27,27,0,1253,1252,1,20,20,0,100
4d7ccd18e817ac65e81fe80ca992801b6ed90174,5,10,8,2,0,0,0,2,4,66,3,5,2.113283334,818,3,3,142,142,0,7821,7838,17,44,44,0,100
7e9dfaf3d5a51b52539ba5b298fbeb9d559ddd07,2,1,1,0,0,0,0,1,5,1,1,2,0,269,136,5,58,58,0,2086,2087,1,44,44,0,99.94525048
994a1e584432e8bef5463be57faf955553bd4d01,14,145,160,15,0,0,0,3,6,58,1,8,3.110889042,1794,8,2,209,210,1,15105,15185,80,124,124,0,97.90094663
b7536783206d3e131040eb43b613093b83a35325,4,20,18,2,0,0,0,2,5,4,2,4,1.294995075,291,137,6,27,27,0,2066,1974,92,24,24,0,100
0feba43d4bb93b431f8eccc41ab001859793cecd,12,194,71,123,3,0,3,1,5,6,2,9,3.217434699,499,138,7,86,71,15,4359,3790,569,65,59,6,99.52348536
0d613195173c6f6b2f869b8c70e9e90206ade1a0,0,0,0,0,0,0,0,0,0,0,0,0,0,0,4,4,0,0,0,0,0,0,0,0,0,100
557ccf9b15166dbb2c1db72b62eb42386b42e812,1,4,4,0,0,0,0,2,3,29,1,1,0,102,139,8,23,23,0,546,546,0,21,21,0,100
5b190a5a936ef90d3b25d58e591be388ee215a86,5,54,3,51,1,0,1,1,6,8,1,4,1.505376146,249,140,9,34,29,5,2011,1831,180,27,22,5,99.53728906
f2f07211d3b71e70903e04d6875aab098fc49689,1,1,1,0,0,0,0,2,4,20,1,1,0,37,141,10,3,3,0,350,350,0,3,3,0,100
037b97ad627148c81d53aa8444e599f0103020e5,5,165,2,163,3,0,3,1,3,14,2,4,1.732095298,112,142,11,28,19,9,1602,885,717,17,10,7,99.57580733
30db8ef87ed0d8a2c16e3cb05d572c48db575626,0,0,0,0,0,0,0,0,0,0,0,0,0,0,143,12,0,0,0,0,0,0,0,0,0,100
4ad1a4182ae6525e338b9f17cc60d1ff39ff2ebe,59,1778,1068,710,18,0,18,1,6,0,4,19,5.22493561,1997,144,13,289,189,100,14160,9295,4865,223,147,76,98.39644253
89a5bcca7fb71756f9edb46e4b3150c7868a943f,2,43,1,42,1,0,1,1,3,0,2,2,0.359101626,51,145,14,4,2,2,457,318,139,2,1,1,99.9333955
6f8b82ef0d0f5d2597f0ec4549c0cce3ca5fec54,4,83,89,6,1,0,1,1,7,0,1,3,1.356988151,164,146,15,32,24,8,1583,1168,415,28,20,8,99.81295925
1c7cb62e580524a45eb58e0f28c64ea809aafd7e,0,0,0,0,0,0,0,0,0,0,0,0,0,0,5,3,0,0,0,0,0,0,0,0,0,100
9581b66c3cc0cf68ef41cbbb8d4ef83867e8febf,1,17,1,16,0,0,0,2,2,4,1,1,0,15,0,0,4,4,0,81,81,0,4,4,0,100
c0b90247214949410925d95de1ae562ce1299c80,7,22,24,2,0,0,0,1,8,75,2,7,2.18244664,697,147,15,66,67,1,4998,5002,4,47,48,1,100
2115d0ad59d675fedfbeb581c62c7e20cc284d31,1,17,13,4,0,0,0,2,3,169,1,1,0,122,148,16,3,2,1,965,929,36,3,2,1,100
1d842563ae7a7d0416a58324eb75760dbdc8d06f,19,1003,206,797,15,0,15,1,5,50,3,8,3.88321518,671,52,0,114,80,34,8812,4982,3830,58,36,22,99.43977591
660bfbd3fac6febddb612b9b629a8d466b536b3d,45,1221,1444,223,5,0,5,2,8,79,5,25,4.346336006,3200,53,1,314,309,5,19097,21101,2004,193,189,4,99.23513121
5c0db6aff007defee467878a820845edcb70f9d9,5,35,13,22,0,0,0,3,9,40,2,5,2.035428514,358,54,2,62,60,2,2781,2535,246,47,47,0,99.98689727
5bf2c62d264ebc7922b18d932995b4f2b46c4a1a,109,8257,438,7819,54,0,54,1,5,14,2,29,5.732238704,4785,1,0,1858,896,962,71212,37530,33682,1153,328,825,97.03504043
32d96b2952f578a0397e3227358cad608243daf5,1,1,1,0,0,0,0,4,5,57,1,1,0,185,0,0,19,19,0,1369,1368,1,14,14,0,100
53370c2e79fc418edf6c7697aa6fc3ac7fce3747,7,197,43,154,1,0,1,1,5,102,3,5,1.655829572,420,55,3,64,43,21,3527,2724,803,26,18,8,99.8489426
17670acae1ad64ca378e8a60676f027845528dd8,164,1880,9826,7946,4,0,4,1,7,2,5,60,6.278491354,15655,0,0,1272,2178,906,62423,90638,28215,612,1354,742,96.16080662
a0458ba2605a4026d1d139816f1bf3efb8112d5a,161,9697,1896,7801,60,0,60,2,9,29,5,58,6.244208593,8607,9,1,2279,1311,968,95982,64170,31812,1406,575,831,96.16080662
ad5becc9fbac37653fc63b5f4eee75d6a410d120,36,154,582,428,0,0,0,1,10,0,5,19,4.633443311,2183,149,16,228,270,42,12167,13831,1664,172,213,41,99.27820691
9b10f22221b60f0f6451e71ac3396b326f9565ef,2,51,4,47,1,0,1,1,4,0,1,2,0.549910905,76,150,17,8,7,1,696,485,211,7,6,1,99.97454823
17bd3b89746433f0493ddc37541de06cb70027d5,1,9,8,1,0,0,0,3,5,15,1,1,0,65,56,4,10,10,0,534,531,3,3,3,0,100
e2532a1dbd564ce5b857ea1f720e83579a3f9680,9,676,4,672,8,0,8,1,2,25,1,4,2.851913506,70,57,5,59,8,51,4085,637,3448,24,3,21,99.13501316
678437aadb5ca6e5c7256fabd40b4966e4227911,3,436,73,363,1,0,1,3,6,40,1,3,1.372976754,513,0,0,91,53,38,5691,3667,2024,58,42,16,98.06077075
c65138b8b4a4ff1695c2edd93fdfad2d0f563ece,8,192,578,386,0,0,0,2,5,57,2,6,2.372173665,1381,2,1,139,177,38,7265,9324,2059,70,88,18,98.01062647
6d5907daaf1b164f1e399df2a50ab87dbf2ca1c9,39,806,176,630,16,0,16,1,11,4,5,22,4.902399503,1346,151,15,167,145,22,10924,8887,2037,116,91,25,98.78019029
08abde5130da77e2d6d65c3940728b2beccb3f52,5,19,21,2,0,0,0,2,12,0,4,5,1.945238412,308,152,16,32,35,3,1878,1899,21,28,31,3,100
a772a05568ac30fcfbff21cfaf94e72022b6fe68,3,436,73,363,1,0,1,3,6,40,1,3,1.372976754,513,10,2,91,53,38,5691,3667,2024,58,42,16,98.26610476
d74c186fca81ebd3d5cb0f7fa1796eb1a5bd83ba,6,505,53,452,4,0,4,1,6,17,1,3,2.295169554,217,11,3,42,21,21,3531,1465,2066,29,16,13,99.00035702
43d229eec09e01dc09f89c04e28b9cbe405032b5,20,776,65,711,10,0,10,2,5,0,2,10,3.667755696,471,153,16,126,74,52,5929,3115,2814,72,46,26,99.1412775
27513f7b7cf4d3c34523f811ecf4454611012368,44,1247,842,405,12,0,12,1,9,200,2,12,4.968414158,2224,58,6,279,237,42,16139,14967,1172,136,94,42,98.58147574
45dd605f25a8b3b27e1cbc5863a0dde615e35d62,1,0,34,34,0,0,0,1,2,0,1,1,0,28,59,7,0,1,1,0,49,49,0,1,1,99.96375936
a7a5358d8df9a256677a7a78869a922ebb4fa38f,1,32,0,32,1,0,1,1,1,0,1,1,0,0,60,8,1,0,1,49,0,49,1,0,1,99.96375936
9a7fedcc9db8611ec0e6c9e46d38727cbffc8ad6,0,0,0,0,0,0,0,0,0,0,0,0,0,0,1,0,0,0,0,0,0,0,0,0,0,100
cc12615536626dcbb71e47d37fc1f7df95dcdd20,10,292,64,228,0,0,0,2,6,111,1,7,2.765049766,967,12,3,147,120,27,8900,7487,1413,91,76,15,99.01623217
502c7e37f842eabc4021c47053dd95bdd1c7efde,0,0,0,0,0,0,0,0,0,0,0,0,0,0,61,9,0,0,0,0,0,0,0,0,0,100
15e1c8335ada8d6e492affc9113f8f0b39fb7d9d,31,473,423,50,3,0,3,3,8,236,2,14,4.510597264,2363,62,10,308,284,24,15860,15192,668,122,104,18,99.46155773
984586580b3840f254f36e2f24a786c1eca98370,22,655,417,238,7,0,7,2,7,147,4,11,4.036482478,912,63,11,76,69,7,7063,6799,264,39,39,0,99.29903617
0f7ddab58da25f50144d60008f49677b4614cf84,0,0,0,0,0,0,0,0,0,0,0,0,0,0,64,12,0,0,0,0,0,0,0,0,0,100
0f11a591a1521bfd50b6646aa5f27ada4c68c402,151,118,11745,11627,0,0,0,1,9,303,5,51,6.840103496,10421,65,13,88,1144,1056,5614,62970,57356,39,611,572,94.43708609
c66b52554e7de8bd8c1be1928aee90303ada8fbd,0,0,0,0,0,0,0,0,0,0,0,0,0,0,66,14,0,0,0,0,0,0,0,0,0,100
b4732cb2fc104350e2f9e6c3edb8518f41a21a11,24,204,721,517,2,0,2,1,7,308,4,13,4.074214129,1091,67,15,42,66,24,4750,6074,1324,23,43,20,99.33672029
1517c132658408952e790e27565496b9587da06b,4,0,526,526,0,0,0,3,6,56,1,2,1.410954379,400,13,4,0,34,34,0,2592,2592,0,20,20,99.87239473
ecabbe4ca98b43356e8e1410b6f4eabc159791d6,5,540,6,534,4,0,4,2,5,155,2,3,1.585892769,254,0,0,80,45,35,4130,1470,2660,62,41,21,99.87239473
18ae3bbbbdbfbfa6b2462670d7c55c7322d81fc1,72,397,3581,3184,2,0,2,1,5,553,3,23,5.417608276,4522,68,16,198,568,370,11575,24613,13038,75,318,243,96.64082687
46afec3953405592d9a74f1b051877fe07c14835,13,0,1210,1210,0,0,0,2,6,58,2,5,3.288584361,978,69,17,0,101,101,0,5694,5694,0,69,69,99.3559719
d3a7e480af180a6e72f30dd826577e60f2e0e5f9,0,0,0,0,0,0,0,0,0,0,0,0,0,0,14,5,0,0,0,0,0,0,0,0,0,100
58f66a857f12ab0676b5e091dc5cdeda0904fca9,13,543,105,438,4,0,4,1,5,73,1,8,3.124323414,1124,15,6,163,119,44,11331,8814,2517,92,70,22,98.78644369
e383e879622b27bf43ff1be4fd062acda1cfbbd5,15,120,98,22,1,0,1,3,7,18,3,11,3.416105497,1132,70,18,114,107,7,7833,7701,132,51,51,0,99.88095238
2cd17cbfa2a5788e9514a441c90d0e7076ca17ba,2,47,7,40,1,0,1,1,7,7,1,2,0.691289869,161,1,1,27,24,3,1522,1402,120,13,10,3,98.5840708
48bb082e709b029aee61684fff7a4eb2522aa153,8,147,39,108,0,0,0,2,4,104,1,4,2.292680896,761,16,7,151,136,15,5235,4508,727,93,87,6,99.17725173
92ca7c54233a71689da8cffd01e282ee8f8de05e,37,660,1001,341,10,0,10,1,6,140,1,14,4.812615547,1828,71,19,138,187,49,8835,13302,4467,75,75,0,98.00894532
6fc103338fa3e3275a1357144dfab2feb1a103ec,7,35,31,4,0,0,0,3,13,35,1,5,2.347592406,803,72,20,138,134,4,5091,4973,118,117,115,2,100
076f3a491ae656bb9e938643ea4c0d5672bc5e04,9,117,316,199,1,0,1,2,8,133,1,5,2.097731766,949,73,21,107,139,32,5761,7103,1342,36,42,6,99.27504069
5bb91c4bd306ef6c612058dcbd88c14c29a49151,1,16,0,16,0,0,0,1,2,0,1,1,0,27,74,22,2,2,0,255,255,0,1,1,0,100
2c63fdf0ce3b4edfa75c2bb3a9de838fdd8311b7,8,2,10,8,0,0,0,3,5,115,1,5,2.751629167,1454,75,23,77,77,0,13532,13570,38,40,40,0,100
34e77cafc4ef73802b9a5716dca6a6f7b54e10c5,5,36,3,33,0,0,0,2,3,9,1,3,1.235104645,522,17,8,56,47,9,3594,3466,128,31,18,13,99.82014388
9432fcf91ab94cd9e228eb353e1b93739f977e67,2,50,3,47,1,0,1,1,2,410,1,2,0.509515718,299,1,1,70,68,2,2380,2202,178,24,23,1,99.95507637
acee5cb334a266ed1f7cb215d0f8252fd5b4e067,17,260,125,135,4,0,4,1,7,10,3,8,3.498356579,1502,154,7,193,210,17,12046,13055,1009,83,94,11,99.08778226
d6ec142d3b1a6de28787e5fcda94f8f28cf02a3e,62,1094,507,587,10,0,10,2,4,22,1,20,4.647501937,6392,2,2,1072,1498,426,44859,51806,6947,638,1125,487,98.2042149
b31bac50b267fbd72b543eba65594c3a98bc67fc,46,164,926,762,1,0,1,1,7,226,4,24,4.416308632,3065,76,23,254,285,31,16465,18432,1967,118,134,16,98.80495721
6d21774a26753ca5ede259f3c6966ba9a0572982,11,80,29,51,0,0,0,1,8,14,3,9,3.10796326,371,77,24,29,22,7,2526,2118,408,21,17,4,99.67508492
fad4b3b546e293badf73ed59f76b58743c95b87c,0,0,0,0,0,0,0,0,0,0,0,0,0,0,78,25,0,0,0,0,0,0,0,0,0,100
38beb8b2c2c38a5bbf954e791732ada81a408991,7,8,1,7,0,0,0,4,6,7,1,4,2.641604168,1330,2,2,60,60,0,12966,12952,14,31,31,0,100
a197eb027552348b9e35fe51394d74cf63b183ee,16,546,510,36,1,0,1,3,7,146,3,13,3.281995947,1153,155,6,120,119,1,7358,7272,86,61,60,1,99.97047535
71f253c919afbcafbf2d125c56daeab6eec7abaf,1,49,8,41,0,0,0,1,2,221,1,1,0,95,79,24,22,13,9,839,610,229,1,1,0,100
4b891ba01328ccc02a7d2d80dbbd7e4bc46e1284,3,14,2,12,0,0,0,3,5,15,1,2,1.298794941,321,3,3,39,37,2,2406,2309,97,20,19,1,100
97c5f1ec966c443df37cd997e345ed2cf64ef6c2,2,8,1,7,0,0,0,3,3,16,1,2,0.918295834,738,0,0,105,103,2,6808,6725,83,30,30,0,100
b52405f128dee0354c1791bd4b7995a730c9050c,2,70,0,70,0,0,0,4,4,14,1,2,0.951762676,568,1,1,130,116,14,4819,4462,357,60,52,8,100
0bde482be40f208ba944d32ece23533714c87133,32,1276,895,381,4,0,4,1,5,43,1,6,3.768994253,3222,156,5,584,580,4,23938,23562,376,177,171,6,99.66111684
6a55b59f0a53f6e832318691ac1dee5a6d0b90e7,19,153,93,60,0,0,0,1,3,199,2,7,3.886402056,1048,2,1,122,107,15,6114,5899,215,79,74,5,99.98528979
0b852cbcd4243e71f51ae7a42c68e1ce7571545e,139,1768,1567,201,0,0,0,2,6,21,2,30,5.606481329,14786,2,2,2363,2362,1,87664,87568,96,1510,1508,2,100
b54a63e0497f6dbca6203fc3024ca649bc767f25,20,392,279,113,4,0,4,3,5,26,1,10,3.997243981,2038,157,6,284,281,3,15230,15085,145,117,112,5,98.52809991
24e6622cacf6189fc04dbf7dfeb32eb123fcbc35,1,2,2,0,0,0,0,5,9,18,1,1,0,162,0,0,24,24,0,1400,1400,0,10,10,0,100
6f5f972c966ea1edc2adf0573dbdb1b0d5ff9671,8,163,165,2,0,0,0,4,6,0,1,6,2.111620821,1339,1,1,214,223,9,10679,11010,331,76,76,0,100
b5fd782c0968ce8dd499de1899464c8edbf50dfd,47,0,0,0,0,0,0,1,1,0,1,5,0,2977,3,3,488,141,347,12107,3431,8676,428,47,381,96.02973978
a846c401c0b9fad912578cc17b0b0e31d52e983a,1,16,1,15,0,0,0,4,6,42,1,1,0,234,6,0,13,10,3,2038,1970,68,8,8,0,100
7f37267160af48b5cb46b4bcbd85a3a82957b192,8,98,6,92,0,0,0,4,7,21,2,6,2.208324078,1886,3,3,337,316,21,14019,13479,540,192,181,11,100
c5d05abd1d5f71d78dbe9a577a3975dc5b964d51,3,54,11,43,0,0,0,3,8,27,1,3,0.938925486,300,80,22,33,29,4,2390,2021,369,21,21,0,99.85257261
36f9a8481e507d3ac0a4522da28a600f0ec6d451,1,1,0,1,0,0,0,4,5,2,1,1,0,599,2,2,103,103,0,6101,6094,7,37,37,0,100
000b746041ec07774e4ed5d5562f9c66307f1c20,8,83,51,32,2,0,2,2,9,142,1,7,2.501471575,595,81,20,78,69,9,4115,4129,14,37,34,3,99.89664846
a10eeb7019b8eff964316b084c0b25b68bf58b44,1,53,0,53,0,0,0,4,6,17,1,1,0,140,0,0,11,8,3,1767,1257,510,11,8,3,100
4f4fd0c4f606a8bc8ab83c66510aca4226becef8,12,189,168,21,4,0,4,2,6,5,1,6,3.158300317,1358,0,0,193,209,16,10915,11213,298,73,77,4,99.36192313
3cc183017da19889cff6bb2c57ecfe41dfbc71e8,4,192,155,37,1,0,1,1,7,6,1,2,1.639022884,719,1,1,134,122,12,6866,6697,169,46,46,0,99.94031632
da7f5520613c4860fb2dfb2cb5fad64f9d5d727b,6,168,29,139,1,0,1,2,10,26,1,4,1.664429923,703,18,4,107,97,10,6466,5666,800,65,57,8,98.92569382
4aa5b45260e9bf4ea029a84dd04ed87eae4dc38b,8,183,2,181,1,0,1,4,6,16,1,6,2.24198819,1034,4,4,150,136,14,7663,6449,1214,53,45,8,99.9552506
a66f64cf9f4212f4923f0e6ea6c7270449aa2ce4,19,670,180,490,4,0,4,4,8,6,1,9,3.074551668,3422,4,3,685,628,57,28375,25674,2701,273,252,21,99.74676002
8de69a88df0df12363007a47a801e71c29269953,8,21,101,80,0,0,0,3,7,151,1,4,2.019967759,816,19,2,150,156,6,4232,4610,378,103,106,3,99.94044961
c940f56c27296c5fec657bd240e96c5522199262,4,19,20,1,0,0,0,4,7,2,1,4,1.831398392,937,5,5,144,143,1,6359,6333,26,47,46,1,100
e77877518ba0cba6cbd3c20ccd0d040c5a3cd86b,1,0,2,2,0,0,0,4,7,2,1,1,0,201,0,0,52,53,1,1059,1075,16,37,37,0,100
3f7004f1cc939ba2e633e38248c322d2216e48a9,9,40,67,27,0,0,0,4,9,19,2,7,2.354121436,1548,2,2,228,232,4,12536,12732,196,80,80,0,100
9488afc15e3d721f55aaaf10da46673d3ebb69a7,6,29,28,1,0,0,0,1,9,11,2,5,1.960625597,1244,3,3,205,203,2,9756,9744,12,104,104,0,100
b2b16b745e210eb80929d970820c322d557d93e0,8,200,51,149,2,0,2,1,8,10,1,6,2.218273147,663,6,6,79,68,11,5357,4476,881,27,24,3,99.79163566
ebbaad091b797945efa7147698de554a53117955,17,1372,26,1346,8,0,8,1,8,47,1,11,3.257268215,1548,20,2,371,257,114,19376,11851,7525,184,129,55,99.7036598
4a15e18f9c90f50fabdbd78f8d79264824962176,2,16,9,7,0,0,0,2,9,6,1,2,0.998845536,257,21,3,61,59,2,1474,1437,37,42,40,2,100
b66e27b909156644b68f4ec12e28565ce3dc8ee4,0,0,0,0,0,0,0,0,0,0,0,0,0,0,7,1,0,0,0,0,0,0,0,0,0,100
8774b85cd97b7b4c386c1b04cff36c13b3bb82d3,17,228,133,95,1,0,1,4,9,15,1,6,3.275058189,2620,7,6,452,434,18,20493,19560,933,120,116,4,99.95572609
3110c72e47f697f5c59b5f7d6559d527cf25db3a,24,202,195,7,3,0,3,1,8,27,2,11,4.158008122,3587,5,2,584,254,330,24337,14408,9929,361,104,257,99.35084096
fce6ae3f0c33ded811e78ca4bf8ff4c0a7ff3935,4,43,12,31,0,0,0,1,4,20,1,2,1.468058439,623,6,3,105,100,5,5285,4923,362,23,23,0,99.94099425
f81ae06217235a04745997f70ddcd1c4d92707e9,4,70,9,61,1,0,1,1,5,118,1,4,1.398652582,199,22,4,40,36,4,1851,1438,413,23,20,3,98.61172001
0a2ce9ed33e0291ad5e187df72756d8c57e2c754,1,16,0,16,0,0,0,1,2,0,1,1,0,35,23,5,2,2,0,362,362,0,1,1,0,100
3324279e42e17c0a063922be355a135cce8c975c,6,16,31,15,0,0,0,4,7,56,1,5,2.185829729,577,24,6,69,70,1,4971,5043,72,35,36,1,100
21187b55c9e549de9d8b797a59516b0c99507f90,92,7713,7136,577,7,0,7,2,10,293,4,45,3.192859489,11461,158,0,1916,1837,79,83978,74169,9809,1089,1062,27,99.53650058
9899a58dc3250c677c5df19bc88f02458e72f55a,11,155,19,136,1,0,1,2,6,45,1,3,2.766104961,812,82,2,105,87,18,5388,4767,621,68,54,14,99.85475672
c2a7576e2d05a2b8e280590cde15b79dcde7466a,0,0,0,0,0,0,0,0,0,0,0,0,0,0,8,2,0,0,0,0,0,0,0,0,0,100
2958bc8b4655312a094720d87ce3634b05e9f219,12,214,71,143,1,0,1,1,6,89,1,7,3.170932673,771,3,1,91,73,18,5954,5081,873,44,30,14,99.14789139
a0fc870849a5fa5d54c0980b21226977eef81920,334,6326,6556,230,0,0,0,2,11,0,1,79,7.453512812,26274,159,1,3329,3329,0,178846,180949,2103,2028,2028,0,100
ecbdec8efae12a7b6044d0d998934a6653936d5a,47,1125,1113,12,1,0,1,3,10,61,1,26,4.153146988,4623,160,2,656,656,0,30369,30399,30,358,358,0,99.7277937
f45ec4370184b8563b1d170bd924a726c58bb9d1,3,13,13,0,0,0,0,1,3,0,1,2,1.548580607,206,161,3,24,24,0,1451,1451,0,12,12,0,100
3db5cdbacd8a6976e853c1128e8476972f378403,14,1131,60,1071,8,0,8,1,6,34,1,5,3.280416024,397,3,0,171,68,103,8587,2314,6273,84,41,43,99.48790896
c752ed868cbb7d93306e66f890c291c621411a33,61,808,827,19,1,0,1,1,14,71,5,24,5.211202033,3499,162,4,421,408,13,21319,20357,962,271,275,4,99.33868017
4ba634d551c16be6b2987940b2bfa359d126107f,0,0,0,0,0,0,0,0,0,0,0,0,0,0,163,5,0,0,0,0,0,0,0,0,0,100
4e7c5f2b7c687f4994d6e8c98bec2ce0342246d7,0,0,0,0,0,0,0,0,0,0,0,0,0,0,164,6,0,0,0,0,0,0,0,0,0,100
7f41d4278d47327f018d00291aaf0787aa401336,23,1277,106,1171,11,0,11,4,9,0,1,8,3.883518308,1146,25,7,270,158,112,14230,7431,6799,144,95,49,99.10878484
fcaf14a4e6dcfc9f06aae51cfa7cc25a79a3ddd2,0,0,0,0,0,0,0,0,0,0,0,0,0,0,165,7,0,0,0,0,0,0,0,0,0,100
2c30276caebf7a920c4a3d09f84f80f0986b31c0,14,929,0,929,12,0,12,4,11,1,2,7,3.360277927,294,8,4,106,20,86,6525,2027,4498,53,10,43,99.60182025
83bd4e3d7c538052bb1f3048dfad4ad1f05a7738,38,692,373,319,4,0,4,1,15,14,3,16,4.639720569,1985,166,8,297,248,49,12960,12053,907,213,181,32,99.21182266
2fd72527f189ab030db60eca4cb81db23b4e0a47,0,0,0,0,0,0,0,0,0,0,0,0,0,0,167,9,0,0,0,0,0,0,0,0,0,100
ec80d1b8c40e1763c74e49dd3b2e47b682c9a39d,0,0,0,0,0,0,0,0,0,0,0,0,0,0,168,10,0,0,0,0,0,0,0,0,0,100
0903ed2c918b13b99f5c10b334a3c82b5ebd37f2,2,16,3,13,0,0,0,2,7,61,2,2,0.485460761,135,169,11,23,21,2,1021,910,111,11,11,0,100
6e723650117232f0a4c77fa8a7e5d9bb54910cc2,0,0,0,0,0,0,0,0,0,0,0,0,0,0,170,12,0,0,0,0,0,0,0,0,0,100
2306c43a5d2e9e73feb3d0514f279d193d7cfebd,6,21,16,5,0,0,0,1,9,9,2,5,2.267973033,387,171,13,44,40,4,2792,2379,413,20,19,1,99.48062886
a0005997cce58aa6a4095f0de740393e84d751d6,2,18,8,10,0,0,0,1,2,176,1,1,0.930586129,80,172,14,22,20,2,465,436,29,17,15,2,100
3706dc7e628f5bf5375dd88638796f99f1db06e7,12,612,112,500,5,0,5,5,10,14,1,5,3.109094667,923,2,0,157,116,41,9987,7074,2913,83,55,28,99.03927663
02aab65b722fbc9bce61ee21d8fd05b8165d012f,0,0,0,0,0,0,0,0,0,0,0,0,0,0,173,15,0,0,0,0,0,0,0,0,0,100
83bb66661b46e8d69497e9459d7cca78264a1300,8,101,35,66,0,0,0,4,11,38,1,5,2.377338673,1735,9,2,279,273,6,14123,13540,583,111,107,4,99.94331869
98dff2480f9bf7105554c4c2d62aebacafb3a858,3,259,17,242,1,0,1,5,11,109,1,3,1.072683862,236,4,0,40,13,27,3701,2157,1544,20,13,7,99.94333475
dcb2b5de1e82d27293405bb03969715f357d5521,1,20,9,11,0,0,0,3,5,34,1,1,0,271,26,4,46,44,2,2061,1994,67,21,20,1,100
158a1524bf016676f7f7b3ca52029b1cfd94afcd,1,1,1,0,0,0,0,1,2,38,1,1,0,189,174,16,29,29,0,1406,1410,4,5,5,0,100
d100d03ed0cadcb6f9a024147868e601a8383b85,11,138,89,49,1,0,1,4,9,35,1,9,2.983245368,2496,10,2,363,356,7,21576,21244,332,126,124,2,99.92921857
b02e304b36ea84f23408d9ccf5f822c2b6e80bc5,0,0,0,0,0,0,0,0,0,0,0,0,0,0,175,17,0,0,0,0,0,0,0,0,0,100
187fbdeddb82a72488273223afc61a24d1ad4a9a,0,0,0,0,0,0,0,0,0,0,0,0,0,0,27,4,0,0,0,0,0,0,0,0,0,100
269cdcf87e47dede5c288a2a247c00a6ac62941b,2,47,9,38,0,0,0,3,5,38,1,2,0.491237342,185,176,17,21,16,5,1284,1106,178,11,11,0,100
b4bbecdc4bc60c82dc3106b678e4abc5cc404650,2,7,6,1,0,0,0,2,6,23,1,1,0.995727452,309,28,3,48,47,1,2166,2152,14,22,22,0,100
48a2c6f5596623b25a92633be8a3a9f4ff33f54a,1,1,1,0,0,0,0,3,7,0,1,1,0,284,29,4,47,47,0,2087,2087,0,21,21,0,100
020a5b3cfb3dfe37db54db7f91343b925623ec49,8,206,19,187,1,0,1,1,5,27,1,6,1.761542832,1014,3,1,124,111,13,9032,7670,1362,49,44,5,98.96527286
cfd5c7f826a2816bd5bf8db194932d2b3ec9ff4c,32,1482,361,1121,15,0,15,3,12,39,2,14,4.361639968,2818,7,0,519,403,116,28835,22416,6419,210,148,62,99.37782805
e6c77f762088f36d4e948785cc16dc9581d7a620,3,172,123,49,2,0,2,1,4,0,1,1,1.537723146,94,177,14,14,12,2,835,1300,465,6,6,0,99.90145009
ce9aae294b4bea995800902e4a99209700341059,4,23,14,9,0,0,0,2,5,47,1,1,1.907798138,79,30,4,12,9,3,512,440,72,8,8,0,100
2583a72e33e770e76fac3759ecb12fd4a3cb497a,0,0,0,0,0,0,0,0,0,0,0,0,0,0,31,5,0,0,0,0,0,0,0,0,0,100
2fcb22128b5361b6fa0632066c3f7ceb6cc58c0f,5,26,32,6,0,0,0,2,4,14,1,3,1.842110169,703,32,6,70,70,0,5527,5557,30,25,25,0,100
ad6a53490fcf3cf725c1cf4b842b7db0ca40716d,2,11,4,7,0,0,0,3,6,14,1,2,0.721928095,201,4,2,30,30,0,1548,1517,31,11,11,0,100
45ff4b8f58f9de4a7f4f01b452ba4ca5071cde0c,10,34,32,2,0,0,0,2,12,52,2,9,3.036392593,1302,11,2,192,190,2,9632,9578,54,80,80,0,100
16c17067a8d75ae065c492be61f29078dee5c7b1,6,46,12,34,0,0,0,4,10,23,1,3,2.452856652,645,5,3,121,109,12,4328,4072,256,51,49,2,100
c897f74b544e037cfea72968aacbeca97e07fd37,1,43,22,21,0,0,0,1,2,23,1,1,0,148,5,1,31,25,6,1142,1011,131,5,5,0,100
0fac33799e21ae92d9b4a7e98e5090b032145b06,1,55,30,25,0,0,0,2,5,58,1,1,0,139,33,7,34,33,1,1190,1037,153,10,9,1,100
1fa490e0c5b0c1b827791909968fcee7adc8ea7c,1,7,1,6,0,0,0,2,6,0,1,1,0,154,34,8,35,34,1,1217,1190,27,10,10,0,100
afb897940021caec79982e29f7194f2b6c733b49,0,0,0,0,0,0,0,0,0,0,0,0,0,0,0,0,0,0,0,0,0,0,0,0,0,100
eb26286126c34272967d1159d07b0d645157c61a,9,270,49,221,1,0,1,2,8,11,1,4,1.833610327,1045,6,4,143,124,19,9172,7703,1469,46,42,4,98.60728075
a1285351d82c86b27d12bf0a4872f5e3e745c72e,0,0,0,0,0,0,0,0,0,0,0,0,0,0,35,9,0,0,0,0,0,0,0,0,0,100
50ddd604cf43ae6d86e57ca5b864314107565f00,1,13,2,11,0,0,0,2,6,18,1,1,0,318,8,1,61,58,3,2787,2699,88,8,8,0,100
d61d3469822dfae3a85d6b796d135f68d58dd0ba,1,8,8,0,0,0,0,3,3,60,1,1,0,178,1,0,42,44,2,671,700,29,42,44,2,100
89d8e3a0935ac9d6dd04d8b9d9ccf6e3410c732e,11,62,25,37,0,0,0,2,8,11,1,3,2.980696443,1284,7,5,137,132,5,9979,9591,388,54,51,3,100
5e59407eb71204ae90d81bceae149548fd78c59d,1,14,13,1,0,0,0,2,8,1,1,1,0,225,8,6,44,44,0,1821,1782,39,10,10,0,100
039bf25d6bd61f5b0d3227318ddd477a3e4564d7,18,446,36,410,4,0,4,1,13,29,4,13,3.403847511,1245,4,0,208,154,54,10124,7967,2157,146,123,23,99.81132075
f1cd71e90241f0f6cb6f9b543b50df04239c7aa3,4,22,8,14,0,0,0,1,9,16,1,3,1.770894436,450,9,7,73,71,2,3311,3241,70,25,23,2,100
f6fad2ebe8a384a6d17e40c609041ff77f6a692c,2,94,15,79,0,0,0,4,8,64,1,2,0.687644533,723,6,2,90,83,7,6068,5540,528,48,47,1,99.52900013
4f348e3dc40fbf992a672acbd534f1f7a16b6d02,6,377,7,370,3,0,3,1,9,36,1,5,1.732925353,597,36,10,144,98,46,6867,4732,2135,55,34,21,98.59978249
c5279cab10f47fdf289f698faedfa1a365cbff58,3,36,18,18,0,0,0,3,7,55,1,2,1.547363588,327,37,10,61,59,2,2184,2058,126,37,35,2,100
9339c2c90932d9bc9708f68939d0d5528f163303,16,161,122,39,0,0,0,2,11,14,1,5,3.302074824,1932,38,11,269,258,11,14442,14185,257,126,120,6,100
17cb77f3a6e4431194155dfb86c95d721e11e418,1,1,1,0,0,0,0,4,10,0,1,1,0,139,39,12,30,30,0,889,889,0,7,7,0,100
f12c82f8ae354bad96c40ab778cb38600947559f,3,26,8,18,0,0,0,3,9,0,1,2,1.492790774,327,40,13,61,59,2,2184,2058,126,37,35,2,100
f467954acc427763d5ab900214018a6be4830f02,2,157,2,155,0,0,0,2,8,61,1,2,0.287731285,611,41,11,60,54,6,6046,5014,1032,31,28,3,100
7d43cfe1057f9f926832d1056f433a6dbe57be96,3,55,8,47,0,0,0,5,9,40,1,3,1.13936128,366,178,0,63,59,4,2266,2061,205,53,49,4,100
c629ca1eba2b139c2b62fb60163f9301e3a02031,10,39,65,26,0,0,0,1,10,43,3,7,2.794646661,510,179,1,54,52,2,2237,2064,173,51,49,2,99.11821438
91643e84dab0f21916b47a552c0e02b277ee05f8,1,68,0,68,1,0,1,1,1,0,1,1,0,0,43,0,7,0,7,295,0,295,2,0,2,99.97232217
ae88577723ea85cf261d773e5983b85094b4e195,1,4,40,36,0,0,0,1,3,34,1,1,0,168,7,2,21,31,10,820,1142,322,5,5,0,100
8ba1b844cdb9e165844896b526631eec5a1b64aa,2,16,2,14,0,0,0,3,9,51,1,2,0.503258335,762,180,2,73,70,3,5876,5740,136,57,55,2,100
9e87377052314f559918fc384f667b60c74f4394,47,3336,0,3336,46,0,46,1,14,0,2,16,5.249446783,177,44,1,337,26,311,16577,1425,15152,190,8,182,98.47007853
17316124af9d82e07c0589550854c274d0cb1059,4,327,6,321,1,0,1,3,15,70,2,3,0.286234252,568,12,1,111,80,31,5945,4589,1356,36,26,10,99.93376606
0277ff75e10620cdfc17d01823a37719af63995b,1,2,2,0,0,0,0,2,2,33,1,1,0,22,181,3,3,3,0,152,152,0,3,3,0,100
d9b82b45daa3adb678fff7138855bd07a241afb6,4,89,12,77,1,0,1,1,16,48,1,4,1.371307393,274,182,4,43,34,9,2270,1991,279,21,14,7,98.16597294
4e5641c356b4e5ae4dad1d7d012bd418fc7b408d,0,0,0,0,0,0,0,0,0,0,0,0,0,0,0,0,0,0,0,0,0,0,0,0,0,100
4b53793d3c76025aa2b47ed93b730beccef8d019,1,36,2,34,0,0,0,3,9,2,1,1,0,327,183,5,65,62,3,2174,1933,241,48,47,1,100
7d5025336b647ed7afc21e6ddbbeaac2c074ea36,1,3,3,0,0,0,0,1,3,96,1,1,0,44,184,6,3,3,0,172,172,0,3,3,0,100
36df3ee7a556b9e430df2d54ccbf6c483344b6e2,0,0,0,0,0,0,0,0,0,0,0,0,0,0,1,1,0,0,0,0,0,0,0,0,0,100
9205433bccefd1b8e477dc09ef7e7ef5ae15ab41,1,1,1,0,0,0,0,7,17,2,1,1,0,176,45,2,26,26,0,1418,1418,0,8,8,0,100
757f510a14a2c79b4d20b4c156aaf079cc1683fe,1,2,2,0,0,0,0,3,10,2,1,1,0,358,185,7,65,65,0,2174,2174,0,48,48,0,100
6f9fb4eed47c7e4b4ff1b955861a4fdbf8cf296f,0,0,0,0,0,0,0,0,0,0,0,0,0,0,2,2,0,0,0,0,0,0,0,0,0,100
97978c60d5feebf47ff214db310e7816f2dea52e,0,0,0,0,0,0,0,0,0,0,0,0,0,0,3,3,0,0,0,0,0,0,0,0,0,100
fa85dc3e20f163ff84f39ca51d16c5d54fad0482,10,37,82,45,0,0,0,3,12,46,2,6,2.618209855,1619,13,1,240,251,11,11236,11503,267,115,116,1,100
fc2407cd53438a31b4c1072ce7d5b08578b8e43d,21,476,183,293,2,0,2,2,18,61,3,15,3.361181627,1660,186,8,237,201,36,12299,10186,2113,141,117,24,98.29104091
279bc01cd6115281d44df7f81ac3b2be9f3b748f,2,16,13,3,0,0,0,2,11,102,2,2,0.849751137,205,46,3,36,34,2,1271,1266,5,10,10,0,100
6823410fc85fe13d9295125d9093754d38e4f0ac,6,78,1,77,0,0,0,2,13,84,1,6,2.15263806,709,187,9,137,126,11,4709,4337,372,112,101,11,100
3301c9d68acc9b780c62d032aabbfe69db3e7b5d,0,0,0,0,0,0,0,0,0,0,0,0,0,0,9,0,0,0,0,0,0,0,0,0,0,100
74c3cbb5b1653974870e805b717987eb75e5113d,2,12,5,7,0,0,0,3,12,104,1,2,0.936667382,258,8,2,38,37,1,2107,2092,15,14,14,0,100
4dfb528c4bf2d8935bac78b10a82b6bc15f0be59,2,6,2,4,0,0,0,3,12,104,1,2,0.954434003,287,9,3,68,66,2,1641,1624,17,42,42,0,100
1d0f9f5b03acefbfb9af97a83ca19ad3d02d638a,0,0,0,0,0,0,0,0,0,0,0,0,0,0,4,4,0,0,0,0,0,0,0,0,0,100
a3df074379b3952c366e1d9d876d0223ca24ffed,2,46,51,5,0,0,0,3,10,34,1,2,0.199023775,188,10,1,22,20,2,1060,1142,82,9,7,2,100
806a29c15ad20fed8457ac39c52ac62f4c26641d,2,2,8,6,0,0,0,2,10,8,2,2,0.881290899,480,188,10,12,13,1,4023,4031,8,11,12,1,100
5e57c7bbc81bf2603ed56ccb5428aeb9869fa48d,0,0,0,0,0,0,0,0,0,0,0,0,0,0,47,4,0,0,0,0,0,0,0,0,0,100
0bca234ff8d6b747a62853ff1f3028fc9ab1e4f9,0,0,0,0,0,0,0,0,0,0,0,0,0,0,5,5,0,0,0,0,0,0,0,0,0,100
7bd5d1d2adb909eef7f59424f758fc0818fb683b,2,13,15,2,0,0,0,1,2,94,1,1,0.940285959,166,14,2,18,17,1,1049,1012,37,9,10,1,100
649adb1ae400e026a8e932d53bd813f03fecb2d1,14,797,10,787,12,0,12,1,8,10,2,6,3.563656559,111,9,0,97,11,86,3712,773,2939,85,11,74,99.26778243
f3204bcafc345edc9b600715776af77d0d1f4496,0,0,0,0,0,0,0,0,0,0,0,0,0,0,6,6,0,0,0,0,0,0,0,0,0,100
e6f9d1bbd6894c31b60bec4d23f42da07e6fe713,0,0,0,0,0,0,0,0,0,0,0,0,0,0,48,5,0,0,0,0,0,0,0,0,0,100
c6ac2eb6f1b5ba6d6c8702e79e7f669e77dcb0a7,1,3,2,1,0,0,0,1,3,0,1,1,0,71,15,3,7,7,0,513,513,0,1,1,0,100
2e715e3e94a6b98e0f3073d5d384878a0a845b72,2,7,4,3,0,0,0,2,4,108,1,2,0.684038436,383,42,6,65,64,1,3030,3008,22,16,16,0,100
98d1964ff6bd19c706952fd4b09ad40dbc5a4870,2,5,2,3,0,0,0,3,10,71,1,2,0.591672779,292,10,3,28,28,0,2002,1998,4,17,17,0,100
8ff8ecf1b8d9ace5c87ad6acc30235b4a43d98bf,1,2,2,0,0,0,0,1,4,0,1,1,0,71,16,4,7,7,0,521,513,8,1,1,0,100
00e92d993bc7de3cb253c87622a9041cf614844f,0,0,0,0,0,0,0,0,0,0,0,0,0,0,7,7,0,0,0,0,0,0,0,0,0,100
7279ee711587a4c6364e324002baa1daea089270,2,16,36,20,0,0,0,2,4,108,1,2,0.391243564,769,43,7,45,45,0,6868,7121,253,25,25,0,100
1a74b09b714412d023c99c4fbf6498cc16984657,3,43,0,43,0,0,0,2,4,108,1,3,0.317901215,345,10,1,65,57,8,2015,1872,143,57,49,8,100
97edbbbe315b9b927bf5e3386a2162e7e4ad99bf,6,127,8,119,3,0,3,1,6,78,2,4,2.037653444,163,189,11,37,30,7,1224,842,382,31,25,6,99.86970684
33b9720656b8cd7ec5df883b79b20bccd5bddb3e,0,0,0,0,0,0,0,0,0,0,0,0,0,0,8,8,0,0,0,0,0,0,0,0,0,100
b103e201ebe7b1500ba3d0297bb7aa88e7aa811a,9,82,310,228,1,0,1,1,9,0,1,3,2.828425601,403,11,2,17,41,24,1533,2278,745,10,29,19,99.71275623
e8a73893d5d395fdba37167100007f728e8768ae,1,16,0,16,0,0,0,2,2,0,1,1,0,60,190,12,7,7,0,554,554,0,3,3,0,100
a6bc0a52413db0dbc56060c7b6c25230422b7153,13,459,39,420,3,0,3,1,11,65,1,8,2.461275686,1001,191,13,191,153,38,10198,7791,2407,130,104,26,99.85611511
a710082d486e10b4732c00a06dd367dc556df60a,1,26,9,17,0,0,0,3,5,160,1,1,0,247,2,0,39,36,3,2029,1915,114,10,10,0,100
eda6e586bb598d443e11bbf6db6a72ca966d0b9b,2,62,0,62,0,0,0,2,12,58,1,2,0.889034904,420,192,14,74,66,8,3026,2546,480,51,49,2,100
ecda7d5abfe30125f9c9b7ee3ebf8e8a49ce054e,0,0,0,0,0,0,0,0,0,0,0,0,0,0,9,9,0,0,0,0,0,0,0,0,0,100
473496747d42b9bfe72f32cb89c312eef1a360bf,12,244,103,141,1,0,1,3,7,107,2,6,2.841815078,1009,17,5,142,115,27,7382,6362,1020,51,47,4,98.38370565
3d6a29ec2e67a83742158a08d378cfc5cad59814,1,5,5,0,0,0,0,3,7,118,1,1,0,90,49,6,6,6,0,816,791,25,2,2,0,100
a781937e978025b708ccc70d47ddaadc18668948,16,54,594,540,0,0,0,5,12,98,1,5,2.487618338,2565,18,6,385,451,66,16936,19558,2622,103,125,22,99.43495401
310935d27d8be8dd12f246ceceba958c1005e2e9,1,1,1,0,0,0,0,1,2,171,1,1,0,24,193,15,1,1,0,34,43,9,1,1,0,100
2479d32791dd1a424af7513279ba28543baf6af4,1,10,10,0,0,0,0,3,8,0,1,1,0,112,19,7,12,12,0,712,712,0,8,8,0,100
76fc4410bbfcddc4757eeb6ebabaa8baf658036a,5,275,275,0,0,0,0,3,4,0,3,4,2.21298422,247,194,16,15,15,0,1283,1283,0,9,9,0,100
c3bde0194f405deea438a553a4f83abb03d599d9,0,0,0,0,0,0,0,0,0,0,0,0,0,0,195,17,0,0,0,0,0,0,0,0,0,100
adc2ba900a2d29352e96489ad48addde17bedccf,0,0,0,0,0,0,0,0,0,0,0,0,0,0,196,18,0,0,0,0,0,0,0,0,0,100
6dbdb4f72ec5adf89f4f7a13bf766e01e3ff6705,8,460,178,282,3,0,3,1,13,0,1,3,2.492085916,868,197,19,168,121,47,7702,7102,600,106,73,33,99.7519906
71a4bb013c2acabb54e03d8988f5b07c4923384c,6,39,70,31,0,0,0,4,10,87,1,3,2.051061935,1057,20,8,126,129,3,8125,8303,178,48,49,1,100
855b86ef3820cbe7405d43576995e5876c551887,1,2,2,0,0,0,0,3,6,21,1,1,0,194,50,7,23,23,0,1513,1503,10,9,9,0,100
453c3a5fa209c6c6e40dc25be6951adada61f72f,9,261,101,160,5,0,5,1,4,57,1,3,2.842189614,315,12,3,41,33,8,2346,1976,370,23,14,9,99.83077324
6f88c30f855249c401a40efc6941090a152670f3,4,64,23,41,0,0,0,1,14,30,1,3,1.465454052,960,198,20,132,108,24,7541,6952,589,76,76,0,99.85717995
c45ac6d57a29cecde179476b93ca53fd2ef89cc1,6,32,44,12,0,0,0,1,5,76,1,3,1.460672183,554,21,9,62,64,2,3550,3627,77,28,28,0,100
44259aeca48554b9ee60d127cbc4d39649067943,1,3,1,2,0,0,0,3,11,18,1,1,0,140,11,1,23,22,1,866,858,8,9,9,0,100
c3bdf46ca290cd9b36a09d79943d680af2ece5f4,1,2,4,2,0,0,0,4,11,2,1,1,0,528,22,10,76,76,0,4865,4861,4,23,23,0,100
8991b61e2dcf92aaf76ffba7cd15f344cf9495d5,9,12,25,13,0,0,0,2,14,78,3,8,2.864992058,664,23,11,70,71,1,4379,4428,49,29,31,2,99.67645917
64fce8f80745d6180ff04b6950364a802d73723e,10,871,474,397,4,0,4,1,15,0,1,4,2.400883465,973,199,21,198,147,51,9831,6515,3316,116,100,16,99.65098242
605c8b21afcecd5d09444755302bce34b3400c2b,2,96,93,3,0,0,0,1,2,1008,1,2,0.876716289,118,200,22,17,17,0,527,509,18,8,8,0,100
d76fa311b2f8c5e3a51ef12700807f01c8f2e98c,8,137,31,106,2,0,2,4,12,42,1,4,2.342686341,881,24,12,117,110,7,7064,6781,283,62,49,13,99.89656064
823c66dae5accefa9631b03bb6e3ab607a12bd55,2,10,1,9,0,0,0,2,2,104,1,2,0.945660305,165,51,8,26,25,1,1134,1070,64,11,11,0,100
538e88f71c0cf8011dc4709b62b3e45b04ac1982,5,34,16,18,0,0,0,2,14,8,1,4,1.64637013,632,25,13,100,95,5,4465,4338,127,45,44,1,100
49db82c5e129c7dc1d0bd5932c97518891c6158e,11,367,25,342,6,0,6,1,5,7,1,10,2.976791849,289,201,23,46,34,12,3253,1755,1498,38,28,10,98.52998066
4472fa1f5a5a664acc6b9f486d6fe5c46a3b01ac,10,193,59,134,2,0,2,1,19,62,1,7,3.000807044,802,202,24,121,111,10,6625,5889,736,62,60,2,99.87138264
eafff46c3df9e245120e5d7235a040d06a3715ce,3,16,4,12,0,0,0,2,2,33,1,3,1.360964047,370,0,0,39,36,3,2922,2849,73,15,14,1,100
cb6c0cb02410245f8e65846a0fb5a71066e10eec,2,59,33,26,0,0,0,3,5,128,1,2,0.996929708,320,12,2,49,42,7,3138,2845,293,15,15,0,100
281aa52b089f5f2fc8cf069b67ce0244bc532041,2,28,12,16,0,0,0,4,9,64,1,2,0.881290899,785,44,2,91,90,1,6192,6068,124,49,48,1,100
3980dcb4c34f024e8247747a48f5966438415c82,2,46,0,46,0,0,0,3,11,125,1,1,0.755375413,155,52,9,31,23,8,935,719,216,29,21,8,100
8d662e3a2ee4fc4411fa903cb5005cd81a65aba5,4,12,3,9,0,0,0,4,15,56,2,4,1.889246429,467,26,14,50,50,0,3610,3558,52,21,21,0,100
435451eff2d845b1953d99f57948ee79c70cadf3,13,247,133,114,1,0,1,2,12,180,2,7,2.859901178,838,203,23,91,90,1,5694,5269,425,48,46,2,99.4273352
8bd30aec1e75f964a0e45af605f37e1b672ba312,1,2,2,0,0,0,0,7,20,7,1,1,0,188,204,23,28,28,0,1539,1532,7,8,8,0,100
56e7048ff75a9d8865173961e1537daf18eeb41c,1,2,31,29,0,0,0,5,13,32,1,1,0,161,11,3,20,24,4,1249,1400,151,6,10,4,99.96220234
e520e4011796ebdea52f80ca43b9bffddf3aa50a,1,12,5,7,0,0,0,4,7,15,1,1,0,194,27,14,23,23,0,1570,1513,57,9,9,0,100
c15e7f81497f6873dee25421c69f4c1351fdcb9c,12,340,1072,732,0,0,0,5,12,67,1,3,3.192335814,1448,13,3,75,135,60,7009,11806,4797,35,60,25,99.26776922
8a34294ec604b42bee5dd99f40ba6e9f9fc498b5,1,2,1,1,0,0,0,4,8,0,1,1,0,201,28,15,23,23,0,1562,1570,8,9,9,0,100
3ff3e55ac6a5c1031a75491085e75b6e07b15f36,14,438,69,369,2,0,2,1,12,74,1,6,2.333237457,1367,45,3,215,186,29,10934,8562,2372,104,90,14,99.92412747
698b302821c7a89cee1172dbf8d2cdb296506b54,9,238,37,201,4,0,4,1,13,29,2,9,2.77256541,343,205,20,54,38,16,2975,2060,915,35,29,6,99.79795429
6b87fb3a714f6adf47ba4752b61284b638035f0e,1,1,1,0,0,0,0,4,14,0,1,1,0,126,206,21,21,21,0,838,833,5,11,11,0,100
15f39705d0e4c86803d1c552810a3adf2f9b50d6,1,11,0,11,0,0,0,4,13,14,1,1,0,513,29,16,73,71,2,4854,4786,68,26,24,2,100
7a2255670c0404fa734859792ed3f2878174ef72,1,4,4,0,0,0,0,4,16,15,1,1,0,417,30,16,76,75,1,2664,2661,3,51,51,0,100
852bac94eba470527207398893c687c0610d80d8,2,8,9,1,0,0,0,2,5,21,1,1,0.672294817,166,46,4,26,28,2,1683,1711,28,11,11,0,100
1f5126a1481ac3557247e6711e0f94880bd8b662,0,0,0,0,0,0,0,0,0,0,0,0,0,0,10,6,0,0,0,0,0,0,0,0,0,100
8e00cdfe0506b91c8653443cf8195cb0566464f7,0,0,0,0,0,0,0,0,0,0,0,0,0,0,11,7,0,0,0,0,0,0,0,0,0,100
278b0961c9c198ce68dc0596b7f9b71ffd89b038,6,28,18,10,0,0,0,3,5,196,2,6,1.911271695,478,13,4,52,49,3,3056,2948,108,29,29,0,100
ee65453dbbfb2f829201d4e8189ee716bcc849de,2,5,19,14,0,0,0,3,5,0,1,2,0.543564443,126,14,5,9,12,3,649,779,130,7,7,0,100
8d26a4f129f0d3a8729f8bac356bb748090d834b,7,59,10,49,0,0,0,5,17,21,2,6,2.206977821,1038,31,17,148,142,6,7211,6761,450,85,84,1,100
1add6d96f198fb3b8aecd20243bc087b3973f656,0,0,0,0,0,0,0,0,0,0,0,0,0,0,12,7,0,0,0,0,0,0,0,0,0,100
f077777066c6bdc53bbe3004555ff3f24953ed25,18,404,5,399,2,0,2,4,18,93,1,11,3.393630384,2599,53,6,459,398,61,19917,17777,2140,326,282,44,99.43410463
2e5cb719c3a49da920d8d6807e10bcfdb6e55934,15,116,91,25,0,0,0,5,19,19,1,9,2.521106807,2702,54,6,403,402,1,19015,18662,353,252,246,6,100
ab1c9b64f6aec62d43e26dca2417e967b7740543,0,0,0,0,0,0,0,0,0,0,0,0,0,0,13,6,0,0,0,0,0,0,0,0,0,100
c4a0b94d760b54b3613e11d67e355e982a18910f,3,10,9,1,0,0,0,3,13,88,1,3,1.189731917,854,32,16,158,157,1,7019,7060,41,72,72,0,100
6002c61404d952a553b929e5026dcd681eb5639c,1,1,1,0,0,0,0,4,6,5,1,1,0,134,15,5,19,19,0,1036,1036,0,11,11,0,100
cbf6d3c10211ba2a5650f6f583e7c2e8ca1432c8,2,90,7,83,1,0,1,1,3,75,1,2,0.66959206,36,16,6,12,4,8,483,130,353,12,4,8,99.93735121
38d46c8bb549c9d6673c48f00a07bb82f57ad43a,1,4,7,3,0,0,0,4,20,0,1,1,0,456,33,16,86,86,0,2913,2931,18,55,55,0,100
e3f358c8462af497fdc9f4498dbf374599af57e6,3,48,14,34,0,0,0,5,12,14,1,3,0.730898785,1068,12,1,127,120,7,8288,8146,142,69,67,2,100
4250e2d32f2cb33760af5d3b1d7f06a9bb91748f,0,0,0,0,0,0,0,0,0,0,0,0,0,0,14,6,0,0,0,0,0,0,0,0,0,100
4ff963b47fd82cb1ca8394027518a9183f39176e,1,45,36,9,0,0,0,2,6,15,1,1,0,132,34,17,16,14,2,1126,1097,29,8,7,1,100
3eacc828313a76afed017d8f3c846bd767ac20d8,7,51,21,30,0,0,0,2,21,97,2,4,2.228446105,1093,55,6,183,178,5,7107,6960,147,111,110,1,100
e71d6d8524a4066ffcf7cb49b914e71abf2cef88,0,0,0,0,0,0,0,0,0,0,0,0,0,0,15,5,0,0,0,0,0,0,0,0,0,100
7848680d362e3c14480149e8c100efdfcd6782dc,4,24,4,20,0,0,0,3,7,90,1,4,1.788703141,302,35,17,52,48,4,2268,2179,89,22,19,3,100
6385174eda387f821ae05f26ebbf497ae22e6c5e,0,0,0,0,0,0,0,0,0,0,0,0,0,0,16,6,0,0,0,0,0,0,0,0,0,100
fa4334e1ef5371efed6a37f771aff40bda186eee,3,39,1,38,0,0,0,3,22,17,1,3,0.707343668,802,36,18,145,142,3,5804,5376,428,76,76,0,99.96238716
9954b4e1187bbcd8f4b4961b9ca4fa1d06c99cbb,2,2,2,0,0,0,0,3,7,22,1,1,1,259,14,3,31,31,0,2519,2517,2,15,15,0,100
6b0ed3d0de8fb7302d412f3a190e4793ea0c7977,6,39,51,12,0,0,0,5,11,105,2,5,1.532128891,674,56,6,91,91,0,4367,4517,150,41,41,0,99.8746553
56c2c4114fc9dee8a1c2da47fa8045036f7d01bc,0,0,0,0,0,0,0,0,0,0,0,0,0,0,37,17,0,0,0,0,0,0,0,0,0,100
21fcd7333e3e11ccf74525fac0c38774eba6e9ed,0,0,0,0,0,0,0,0,0,0,0,0,0,0,17,7,0,0,0,0,0,0,0,0,0,100
77524c7c4f8e3a186bb1fb5c802b73a582585e5b,2,27,1,26,0,0,0,2,23,83,1,2,0.811278124,481,207,9,92,88,4,3129,2992,137,58,55,3,100
8abbd23304bfed5c1a402353838eae9d511f84a7,0,0,0,0,0,0,0,0,0,0,0,0,0,0,3,0,0,0,0,0,0,0,0,0,0,100
0cd117c1fb798b6deda7c10bc72bd1e22dfd4da4,0,0,0,0,0,0,0,0,0,0,0,0,0,0,18,8,0,0,0,0,0,0,0,0,0,100
c57f86dd186a87ec749420e50fdf3180959cb16f,32,206,191,15,0,0,0,2,13,34,2,14,4.591154045,3704,17,4,520,529,9,26396,26594,198,171,173,2,99.67447102
8beda32daa55b6bbe148140aaf95c8d17ba7b6ff,20,158,282,124,0,0,0,1,12,116,2,13,1.887502232,2624,57,6,300,317,17,19804,20523,719,180,190,10,99.83721513
2bc25969a14972a4922270acba536798d49d96da,0,0,0,0,0,0,0,0,0,0,0,0,0,0,19,9,0,0,0,0,0,0,0,0,0,100
f108c7f456a02d92c70479895f61d3ab724745f8,23,352,59,293,3,0,3,2,3,47,1,9,3.639453773,1361,1,1,188,162,26,8559,7272,1287,130,113,17,99.71278721
e39c76ce8b503fcf447814cd9ea51c9ced2fee81,0,0,0,0,0,0,0,0,0,0,0,0,0,0,0,0,0,0,0,0,0,0,0,0,0,100
3595f29dc800a52cc6b8932a1fa3bc7a5a660c8b,0,0,0,0,0,0,0,0,0,0,0,0,0,0,20,10,0,0,0,0,0,0,0,0,0,100
725786cdb0626a73b63180c846c27521df30d53b,0,0,0,0,0,0,0,0,0,0,0,0,0,0,2,2,0,0,0,0,0,0,0,0,0,100
3e09327bbd881b0d08d7943490c6f0bc705681c0,1,2,2,0,0,0,0,2,3,3,1,1,0,123,58,6,20,20,0,775,771,4,12,12,0,99.91254373
82b1c2249f9edd02b0a2f00bdcc55c4d265e7e6a,1,9,3,6,0,0,0,3,4,0,1,1,0,123,47,3,20,20,0,826,775,51,12,12,0,99.91254373
38f2926448f1227761edafa367080d95ade9d255,0,0,0,0,0,0,0,0,0,0,0,0,0,0,15,2,0,0,0,0,0,0,0,0,0,100
ca0fae40712fe5bb6962554b5fe17e7ff360763f,48,1058,1011,47,0,0,0,2,6,230,1,13,4.635303454,2963,0,0,371,369,2,16929,16861,68,218,217,1,100
0952732e6bb0e428daaedbc6c0df0e6f19e86b86,3,91,25,66,1,0,1,1,6,65,1,2,1.398339532,101,4,0,9,4,5,838,494,344,7,3,4,99.9502054
66baf258c37fa035e57f7aa4de1bab16ee433fe6,8,387,32,355,2,0,2,3,7,166,1,5,2.050136793,805,0,0,129,104,25,8860,6218,2642,60,40,20,98.19373995
d4be077b892b62ac614908fb8f129d56efb2b191,0,0,0,0,0,0,0,0,0,0,0,0,0,0,18,5,0,0,0,0,0,0,0,0,0,100
9f64be00e9d0e9156e0a187650a3ef9b4185d5b6,2,32,0,32,0,0,0,2,4,0,1,1,1,274,208,3,21,21,0,2386,2386,0,15,15,0,100
300c457c0392c81f6498d0796caa964e2cbcecb2,2,52,3,49,1,0,1,2,6,145,1,2,0.980597441,68,38,9,13,8,5,694,513,181,11,8,3,99.9754058
ceeebb42371dc00bc39f65269d00de6145e73aca,0,0,0,0,0,0,0,0,0,0,0,0,0,0,21,11,0,0,0,0,0,0,0,0,0,100
a28e2c4858f4c66172106e95f7c63e34adc651b2,5,31,0,31,0,0,0,4,24,24,1,3,2.207058908,1583,59,6,266,262,4,10900,10639,261,176,172,4,100
3f8a33d8bb6b2fd936852f77b1de6ab28b980627,0,0,0,0,0,0,0,0,0,0,0,0,0,0,22,12,0,0,0,0,0,0,0,0,0,100
eaab4a9e0e5ec6077059c26fbf136ecf6d84a99f,4,176,4,172,1,0,1,1,9,20,1,4,0.36292161,456,60,7,80,78,2,4770,3711,1059,26,25,1,99.37137927
607e74a7485d557016b39ad4c7910ec732c21c48,4,83,34,49,0,0,0,5,13,60,1,3,0.694423898,610,16,2,102,89,13,5204,4918,286,54,50,4,100
a5537c0c2ce283ba2013f9b2f46e81efc5c72c58,0,0,0,0,0,0,0,0,0,0,0,0,0,0,23,13,0,0,0,0,0,0,0,0,0,100
cb3bf7b6063adff6ef566650b7a438dfe4b52290,2,46,9,37,0,0,0,2,2,56,1,2,0.869892686,419,48,1,34,30,4,4035,3721,314,24,22,2,99.23982344
f21145635a609dc25477f0384cbb14fb17fbd0be,6,202,295,93,0,0,0,2,12,131,1,3,2.298873621,694,49,2,57,54,3,4192,4324,132,31,35,4,99.91483149
02cbdb68d677e1d286149caad8ca7efcb64489ee,5,64,10,54,1,0,1,4,14,59,1,4,1.529011875,550,61,8,107,105,2,3535,3307,228,61,60,1,99.95134412
60206b5b5d0e078102d78c5b2f73da28afb49f38,0,0,0,0,0,0,0,0,0,0,0,0,0,0,24,13,0,0,0,0,0,0,0,0,0,100
bd5f242307fa184b9e8f272a862d7468e4dedd23,1,2,1,1,0,0,0,4,8,2,1,1,0,187,62,9,45,45,0,1450,1437,13,12,12,0,100
6ec928941364bcb565ec2b20d6da20336aaa3578,1,4,1,3,0,0,0,5,9,0,1,1,0,188,13,1,45,45,0,1451,1450,1,12,12,0,100
ab3ed13e18c85fa3fd64a08a070aaf24391aeb1e,7,24,17,7,0,0,0,4,14,84,1,6,2.478092092,1991,4,1,295,295,0,17863,17799,64,90,90,0,100
1d549abbea9a18d1cd5c28e646b9f70a2565f62a,6,30,30,0,0,0,0,2,4,205,1,3,1.932904356,284,1,1,30,30,0,1412,1409,3,13,13,0,100
81114c3b50ca5186c8e661c5dcd066a92acb82fe,2,13,10,3,0,0,0,4,14,25,1,2,0.666578358,311,17,3,45,45,0,2504,2489,15,13,13,0,100
137b9e038e8fe056e003f2b39e8385cdd63db160,8,546,30,516,3,0,3,1,4,130,2,5,1.673846,483,5,1,57,38,19,7427,3401,4026,44,29,15,99.79346373
53a74633e90c9638554a96b7d21ef1a0bbbd4755,6,342,0,342,6,0,6,1,1,0,1,1,2.545913096,0,5,2,12,0,12,1703,0,1703,12,0,12,98.29113135
327351b92ce2f050d4cfc6a3cd6f3990b22555a5,6,161,170,9,1,0,1,5,7,156,1,3,1.167826307,1299,1,1,47,48,1,13081,13135,54,30,30,0,99.88458579
2f4df34cfbcce2ab0cd72f52c45a7873ec689722,0,0,0,0,0,0,0,0,0,0,0,0,0,0,1,0,0,0,0,0,0,0,0,0,0,100
4df63def83f1e33fd0899693d5ac751b24bf39a2,7,25,28,3,0,0,0,3,3,924,1,1,2.56867686,311,2,2,32,32,0,1393,1407,14,18,18,0,100
9a5cdb26d6db15e05a21cc1d6c70e94aded181d7,3,26,12,14,0,0,0,4,15,34,1,2,1.521806865,600,18,4,98,94,4,4683,4607,76,34,34,0,100
db28ae2b280387d88b3b922dbce0912adbadf6b9,0,0,0,0,0,0,0,0,0,0,0,0,0,0,209,2,0,0,0,0,0,0,0,0,0,100
1da8dc4f1fbb46c5ce76cd3b2af7f680f6f8cc29,0,0,0,0,0,0,0,0,0,0,0,0,0,0,25,13,0,0,0,0,0,0,0,0,0,100
2b61cef585b02fb6f40d5c3de7f7c5c060926ecd,33,1930,146,1784,25,0,25,2,14,16,1,8,4.712149203,793,6,2,206,156,50,17460,4565,12895,161,112,49,97.94494482
a88e1cef80b3f9c6e896d5948154cd5b5b37d643,4,28,26,2,0,0,0,2,8,76,1,3,1.579969931,227,3,3,27,27,0,994,973,21,17,17,0,100
32582d2300306d6321fcd026b62b17ff1707d95c,41,225,264,39,0,0,0,3,15,165,1,13,4.221124153,2550,4,4,376,376,0,15757,15827,70,220,220,0,99.87460815
3099a9e8ccabd3c371afe8f61fd8a1a151083232,7,163,11,152,3,0,3,1,10,31,2,5,2.325486107,180,210,3,25,18,7,1767,1129,638,24,17,7,99.78710081
ad8cc9c99bf33c75ebc1de60f87fc91128535039,1,1,1,0,0,0,0,3,5,2,1,1,0,401,7,3,22,22,0,3794,3790,4,18,18,0,100
8f8fe57e6ab7484f400333d3369bb849cb2c0e6e,1,3,3,0,0,0,0,4,15,50,1,1,0,126,63,9,21,21,0,814,838,24,11,11,0,100
0a0d1f6ee9dcb36ca96721a90392a676b2652d28,5,31,17,14,0,0,0,4,25,5,1,3,2.038520986,1609,64,10,275,266,9,11130,10900,230,176,176,0,100
75ab7722cd9e87e2380d9fac4fd6922513cc23f3,8,215,26,189,0,0,0,3,15,117,1,8,1.852930103,862,19,5,157,139,18,7684,5748,1936,86,76,10,100
38ec7fc23d06c77b6e083ad2dfb9c61e729901e0,15,706,648,58,2,0,2,3,13,40,1,9,2.626895298,1657,211,4,221,205,16,12782,12323,459,133,125,8,99.89988737
aa7b0254ddd1b8aa665f581eebf6a88c9d694563,1,1,2,1,0,0,0,5,13,8,1,1,0,176,50,3,19,19,0,1234,1270,36,12,12,0,100
45af18e7faac26eb564ae247cb702f89f9e886d2,1,32,1,31,0,0,0,6,14,0,1,1,0,174,65,10,21,19,2,1476,1234,242,14,12,2,99.9875
8b504792bbc551908be280cd50b357bebb8dad25,1,31,0,31,1,0,1,1,1,0,1,1,0,0,0,0,1,0,1,49,0,49,1,0,1,99.9625281
41cb7e1a06c6d2479d27d0d8bba160094289efba,16,144,56,88,0,0,0,3,15,40,3,9,2.867657978,2818,39,3,381,365,16,21347,20645,702,185,183,2,100
44a4d660b3e32cb13ba7b4ffcfb21f2612abe449,0,0,0,0,0,0,0,0,0,0,0,0,0,0,212,5,0,0,0,0,0,0,0,0,0,100
c1ce6ea4f62c2f2ed53099e0b0ccb3a130128c30,10,233,4,229,3,0,3,6,16,43,3,8,2.32381966,624,40,3,75,62,13,5531,4393,1138,33,25,8,99.91266376
9795fbccba96a8b6b336398115b8e325303b0c89,6,21,16,5,0,0,0,2,9,29,2,4,2.330151915,327,41,3,20,20,0,1822,1782,40,12,12,0,99.98753428
8bb32c012dd8b4c4f588824a54e4a2f0693762d9,2,110,107,3,0,0,0,3,12,7,1,1,0.18246504,140,213,6,13,14,1,1039,1031,8,13,14,1,100
446c22720d930bc832fc5f3e32addf72115429a4,4,42,156,114,0,0,0,4,14,126,1,3,1.05139171,786,42,4,111,121,10,4682,5156,474,38,40,2,99.75034328
164e844c1ec9e16b4228eddd5fb6a2ba8196e661,4,234,90,144,2,0,2,1,3,45,1,3,1.951919911,156,19,2,28,23,5,1660,572,1088,21,22,1,99.91255465
fbac5c3cc16150dbdc13d654e3425d197ed74300,1,6,6,0,0,0,0,3,5,5,1,1,0,59,51,4,6,6,0,312,306,6,3,3,0,100
8b648011df4b9f10394ac853978256f0e62e014d,5,57,76,19,0,0,0,3,9,97,3,4,1.030647427,591,66,8,43,44,1,3874,3974,100,23,25,2,100
18f74d4487eb42518f06d16f22c87c5353c19558,3,50,6,44,0,0,0,6,13,3,2,3,0.849092166,187,43,5,15,9,6,1516,1218,298,10,7,3,100
ce8e1c5080c0f9a8fae9010cbd29dc3c138f13d8,3,128,14,114,0,0,0,1,4,3,1,3,0.9849043,219,20,2,37,22,15,2120,1292,828,26,18,8,100
4874433a59c59e599b73a1235819db92e3248ce1,1,6,1,5,0,0,0,8,9,24,1,1,0,601,67,9,105,104,1,6156,6141,15,36,36,0,100
d6e78bec28b804f3c6bfaec2f69774a717f5cbaa,13,647,1,646,11,0,11,1,2,38,1,6,3.491159142,260,8,4,89,60,29,4614,1028,3586,89,60,29,99.40313355
3005c4be8f16f71839fa9358c8c10583a37821a6,4,193,2,191,2,0,2,1,4,3,2,3,1.323366262,186,44,6,46,17,29,2268,1134,1134,12,9,3,99.92572419
30b671cf2a208dfac2657dddcba3390fbe8cc3f9,3,143,8,135,2,0,2,1,2,364,1,2,1.375166122,166,2,2,34,27,7,2131,1391,740,15,8,7,99.95053178
03dc7d8488366ad87889ee2398ef5aac62eaf985,4,259,0,259,4,0,4,1,1,0,1,3,1.878400508,0,6,2,13,0,13,1308,0,1308,13,0,13,99.18444166
fd650be8fc19e2434257dd8675cb8f52264241df,0,0,0,0,0,0,0,0,0,0,0,0,0,0,3,0,0,0,0,0,0,0,0,0,0,100
ddb45f56e86c0f49ca1ee81a6aa9a7335eeeb040,0,0,0,0,0,0,0,0,0,0,0,0,0,0,214,5,0,0,0,0,0,0,0,0,0,100
57da45a8dd5086a2e086f1447929f8e3df5c0328,7,426,0,426,7,0,7,1,1,0,1,1,2.753147409,0,7,3,14,0,14,2426,0,2426,13,0,13,98.11877536
14d55dd51eaf3ccd51d28f23ad151ccd916d70aa,11,398,17,381,4,0,4,3,8,54,3,7,2.622312474,414,45,6,58,30,28,4409,2210,2199,25,14,11,99.82248521
dc9fe0b4735d4900922de9019e54d478cb49c4d2,11,57,57,0,0,0,0,2,7,700,1,7,3.202501253,2062,68,7,358,356,2,15027,15187,160,134,133,1,100
b821439bce99e03591136436bf71ef22e4d0d655,29,74,881,807,0,0,0,2,7,8,3,15,4.158004391,3175,215,6,386,430,44,17397,21862,4465,147,172,25,97.93069671
a267e731e13b2b382a1a115a65259f96ee0b4e5f,31,888,80,808,11,0,11,3,8,267,3,16,4.216878741,2751,69,8,463,419,44,23712,19247,4465,185,160,25,97.93069671
620959bbdd334aab15fd43e8312554f5e67b4a75,24,80,462,382,0,0,0,2,7,11,3,15,3.599906439,3079,7,3,419,449,30,19247,21286,2039,160,172,12,99.82248521
7471eced641b132df7e2950a93a00914be75cc97,11,398,17,381,4,0,4,3,8,54,3,7,2.622312474,414,45,6,58,30,28,4409,2210,2199,25,14,11,99.82248521
225d53973f4016e9fb22cf95b3166b2ef27e7a8d,11,57,57,0,0,0,0,2,7,700,1,7,3.202501253,2062,68,7,358,356,2,15027,15187,160,134,133,1,100
229d6b32f8e4d5e87c623e58ca9ac0a44346ff2a,0,0,0,0,0,0,0,0,0,0,0,0,0,0,216,7,0,0,0,0,0,0,0,0,0,100
30b127b8db310201acae1dd7801c14a8c8e62e78,2,7,6,1,0,0,0,1,5,72,1,2,0.89049164,275,217,8,33,33,0,1850,1850,0,13,13,0,100
dacb86f3178bff034dbc7efea17f555bf453d390,10,193,16,177,2,0,2,1,16,37,2,7,2.070696745,1733,71,9,291,277,14,13205,12260,945,166,160,6,98.88294712
a39ca45cb146f3d4cf681f36f789538fa6995bad,4,7,7,0,0,0,0,1,5,0,2,4,1.950212065,345,47,8,28,28,0,2358,2354,4,8,8,0,100
7499be694a6ae2c334751d49927cc5eaac6f5f2b,2,180,31,149,0,0,0,2,7,187,1,2,0.885308503,172,9,4,25,24,1,2358,1115,1243,13,9,4,99.86818454
8d7f81e1cdcc61e16769677dda2c371897f25dca,8,254,55,199,2,0,2,3,11,96,1,6,2.160650852,888,5,3,92,89,3,7686,7537,149,65,59,6,98.9773821
929a21da7182986dc62db953639e27cc983f6f23,10,111,48,63,0,0,0,1,13,8,3,8,2.590454146,875,48,9,110,94,16,6334,5828,506,30,29,1,100
adeaa0f9e1be4f8f017449c7155f52b072052ed7,1,3,0,3,0,0,0,1,3,0,1,1,0,122,49,10,24,23,1,909,895,14,3,3,0,100
3becca68929cd005416605da0b9be4cbdb0c0cba,2,29,4,25,0,0,0,1,7,1,1,1,0.532835063,306,50,11,56,51,5,2268,2141,127,10,10,0,100
65de7b0acaeff274b07b2e9318fcb6c41d77deed,4,843,29,814,2,0,2,1,16,7,1,3,1.564862743,663,10,2,123,76,47,13365,6106,7259,60,29,31,99.68678472
8042f9e44201b485537ac7a96d729dc9e4f1d694,5,17,8,9,0,0,0,1,8,0,3,4,2.173911951,525,51,12,73,72,1,3599,3538,61,14,14,0,100
de061d599c35735abd6b9447d37949289827e1e3,5,35,7,28,0,0,0,2,5,27,1,5,2.098260324,850,4,1,136,130,6,6589,6386,203,55,53,2,100
52dc7a5d99ed37b7778813c8b6483a4227e7c0ee,3,25,15,10,0,0,0,1,5,1,2,3,0.568995594,261,52,13,26,24,2,1856,1828,28,7,6,1,100
6a0529e96e1f581c4fa476a82e5e897fc2509828,7,203,11,192,3,0,3,2,6,35,2,6,1.875456473,449,72,6,76,60,16,4164,3212,952,43,31,12,99.59634335
4d4d8c0eafa06d537a307291df03f344cdae6ef5,17,250,80,170,1,0,1,5,9,143,3,15,3.068960861,2058,11,3,211,199,12,18245,17010,1235,103,96,7,99.87111892
7976858ee068ca4a85d67f70f7bf574f3e75115f,14,1026,1,1025,11,0,11,4,5,17,1,7,3.363318647,229,9,3,49,10,39,7615,1537,6078,49,10,39,98.35419564
aeec7f389ec44bf0be0291f310a27d7d312ebc8e,1,1,3,2,0,0,0,1,3,8,1,1,0,407,12,4,25,25,0,4367,4380,13,21,21,0,100
70600b2609c20c3f1385e60813823abf48c63c03,15,386,153,233,1,0,1,3,16,122,1,10,3.019546318,2034,20,0,268,237,31,18195,16653,1542,135,116,19,98.89390519
dcefa206835542c187059878d2ffbae50c1df1a3,14,72,37,35,2,0,2,3,17,137,1,6,3.480444264,1202,13,5,173,169,4,10202,10136,66,73,69,4,99.01438767
c69f94eff767a7c1cef3b66f23be21aae0d2ec71,2,41,9,32,0,0,0,2,6,62,1,2,0.904381458,494,10,4,40,33,7,5080,4846,234,25,24,1,100
021c2bddddd98892442f43d0425c67effa192273,17,291,35,256,1,0,1,2,26,53,1,11,3.118460416,3184,73,7,502,473,29,23272,21738,1534,335,319,16,99.79188345
286034ff3b68eb8ba1650c6fd013dd5d6feb68f5,4,476,0,476,4,0,4,1,1,0,1,2,1.73056151,0,6,1,19,0,19,3979,0,3979,18,0,18,99.83837451
fb853dfd8ce722a8ee4ee970f9416b2dbfc79d8c,0,0,0,0,0,0,0,0,0,0,0,0,0,0,218,4,0,0,0,0,0,0,0,0,0,100
285524efb7e898c1ace70c70a62933d8370b1f63,0,0,0,0,0,0,0,0,0,0,0,0,0,0,219,5,0,0,0,0,0,0,0,0,0,100
ff2253754c265ffb81727a52b3e0f2f196697184,1,1,0,1,0,0,0,6,12,2,1,1,0,157,53,10,36,36,0,1075,1069,6,9,9,0,100
10572c296f58532897cdea4f80132d1420890679,70,3432,2048,1384,16,0,16,3,16,44,7,40,4.859675083,4051,220,6,643,457,186,31565,27521,4044,383,237,146,98.86337543
e7a80deb051cdd15a87a13ec7e1956a4704d53a0,0,0,0,0,0,0,0,0,0,0,0,0,0,0,221,7,0,0,0,0,0,0,0,0,0,100
f39ffe9151cee6bb363515f88aef1cfe62484171,0,0,0,0,0,0,0,0,0,0,0,0,0,0,222,8,0,0,0,0,0,0,0,0,0,100
68a3e8bde3418add34c0b585a206236ee227c6e0,0,0,0,0,0,0,0,0,0,0,0,0,0,0,223,9,0,0,0,0,0,0,0,0,0,100
df9d9b085714c55c1bdc5a4d4e71a96c5d0c9c30,1,0,1,1,0,0,0,4,5,50,1,1,0,25,54,10,1,1,0,319,342,23,1,1,0,100
c52e23c748ba5f0f497622f8a2d50bcd7de340a9,1,8,4,4,0,0,0,7,21,116,1,1,0,188,55,11,29,28,1,1558,1539,19,9,8,1,100
a0f134422dbab0c4a98bd181b75f78cf7a8c3343,1,7,1,6,0,0,0,2,3,254,1,1,0,59,21,1,12,11,1,254,227,27,11,11,0,100
a292c1556058126e5fcb897cab58a31ab6dbb49d,3,48,0,48,0,0,0,2,2,6,1,2,1.584962501,84,22,2,8,8,0,654,654,0,7,7,0,100
e6c4b0a731942c9c4bf746ecc6b067429d755ff6,1,3,1,2,0,0,0,3,3,9,1,1,0,173,11,4,10,10,0,1386,1360,26,6,6,0,100
aef7ea36c1473b29f76420dd67d646e738f7d10b,4,167,56,111,0,0,0,2,8,20,1,4,1.128499716,542,12,5,97,77,20,4930,4224,706,31,26,5,100
30e35de60c532502731ef5b51360df15c0026397,21,815,567,248,1,0,1,1,27,21,1,14,2.688837824,3357,74,6,505,493,12,24504,23036,1468,308,295,13,99.24600495
3a84a2c6285146d7765a120ca64567183af6bdf8,0,0,0,0,0,0,0,0,0,0,0,0,0,0,56,11,0,0,0,0,0,0,0,0,0,100
e5e215e0bc0d4829e120069cab92922e0fef5f5a,2,64,5,59,0,0,0,3,3,108,1,2,0.999848483,644,57,12,89,81,8,6636,6099,537,32,30,2,100
1c81c0865c70b9a0a91b86d7813be923e86e1dba,32,1216,124,1092,12,0,12,5,16,20,3,17,4.288832078,2167,224,10,417,315,102,20368,14712,5656,258,186,72,99.68029986
f899ca1c29533f571e1d2abcfa93e164519937c6,2,78,11,67,0,0,0,2,2,16,1,2,0.768691303,118,10,0,21,14,7,1083,448,635,14,14,0,99.9341961
0d1dcc408ddf499a09e3868480494062e45cb736,21,251,227,24,1,0,1,2,8,78,2,12,3.385610995,1722,75,7,221,219,2,11248,10928,320,115,110,5,99.25712385
976edcd868b3b90327efe34ee088db579dfc6e89,9,144,49,95,2,0,2,2,18,75,1,6,2.497650835,858,14,5,107,101,6,7476,7163,313,46,40,6,99.93278817
f833e9831f473660a084327f67418197b5f00d02,2,27,13,14,0,0,0,4,9,133,1,2,0.954434003,208,15,6,29,27,2,1864,1757,107,19,17,2,100
9f4e7633d939580ce640d7488ec1fdeb07c00c3e,4,16,7,9,0,0,0,3,19,73,1,4,1.75993053,304,23,3,37,36,1,2492,2436,56,16,16,0,100
5da9df8221a51252b5e91127d20dea3165553b68,7,107,10,97,1,0,1,1,8,17,2,7,1.246295725,902,13,4,90,85,5,8281,7639,642,55,51,4,99.9104043
188ddf50086ef29b4af5c6afe498197dbc7aa0aa,0,0,0,0,0,0,0,0,0,0,0,0,0,0,14,5,0,0,0,0,0,0,0,0,0,100
8416f64da7dcba0c48527aa678a5b2ec9a37d4a8,0,0,0,0,0,0,0,0,0,0,0,0,0,0,225,7,0,0,0,0,0,0,0,0,0,100
5ef6c183f5b8708f83d08c5e51b2556c6371b82a,0,0,0,0,0,0,0,0,0,0,0,0,0,0,226,8,0,0,0,0,0,0,0,0,0,100
6a7842fc554862fb2e2bf53a2133ac7804876cf0,10,38,47,9,0,0,0,4,28,16,2,8,2.880430873,2174,76,4,302,303,1,15240,15328,88,188,188,0,100
dcf9e32f70ed92cf2bacc8f021ca908ecc132f06,0,0,0,0,0,0,0,0,0,0,0,0,0,0,26,0,0,0,0,0,0,0,0,0,0,100
3914e39ddce1bbadebdf56732e81701a6bdf5c70,0,0,0,0,0,0,0,0,0,0,0,0,0,0,27,1,0,0,0,0,0,0,0,0,0,100
269ff147f29cde959af50b1b9a4e528112ec4799,4,19,1,18,0,0,0,2,7,140,1,2,1.543751954,353,227,9,59,55,4,2114,2036,78,25,23,2,100
162aac84f1d1e01d232c8a43b98d5f06280ddaa3,8,132,37,95,1,0,1,4,17,62,2,6,2.388242741,1253,77,5,262,251,11,9755,9239,516,114,110,4,99.95517705
dd9cd7c51cd5454fd201cd27377f22eb2d60d9ec,0,0,0,0,0,0,0,0,0,0,0,0,0,0,28,2,0,0,0,0,0,0,0,0,0,100
c1dcfb13b47588b886a9bc0fc002eaf87e713523,0,0,0,0,0,0,0,0,0,0,0,0,0,0,228,10,0,0,0,0,0,0,0,0,0,100
cfd4d38fdbe9fa3922dcec566461f0ead810cf0c,0,0,0,0,0,0,0,0,0,0,0,0,0,0,229,11,0,0,0,0,0,0,0,0,0,100
02abe02c37cd4351ea456ccf42fe24fb9544682d,3,26,1,25,0,0,0,1,2,24,2,3,0.986426729,295,230,12,43,40,3,1730,1635,95,30,27,3,100
aa8d3c9b9a17ffa66c599fb88bd06e898328d431,8,75,20,55,0,0,0,2,11,36,3,8,2.583631101,1061,58,5,136,129,7,9131,8533,598,51,50,1,100
0fd2d7774acba6a33d192e3d81627ec947b626a1,9,252,14,238,2,0,2,1,8,11,2,6,2.22543354,610,231,13,117,86,31,4596,3423,1173,84,64,20,98.90625
7ad45fd1bd63c76b294faecc7e13bad8c8145799,0,0,0,0,0,0,0,0,0,0,0,0,0,0,232,14,0,0,0,0,0,0,0,0,0,100
e99b2fedf158f36857cc78279771e4b95a582776,1,11,4,7,0,0,0,1,2,1,1,1,0,95,233,15,13,11,2,676,608,68,6,6,0,100
268096f193926547f76c52cf40cf7775b581dc80,1,1,1,0,0,0,0,1,10,8,1,1,0,191,59,6,29,29,0,1305,1301,4,7,7,0,100
3025e5d7285ebac8236e8988df7dc52690420117,0,0,0,0,0,0,0,0,0,0,0,0,0,0,234,16,0,0,0,0,0,0,0,0,0,100
b12abb38d973d470f9bebdaba8e7b76b7dee5326,1,2,2,0,0,0,0,1,2,37,1,1,0,72,235,17,3,3,0,455,455,0,2,2,0,100
b27998f822a492c33ed587d729ba894280660ab1,0,0,0,0,0,0,0,0,0,0,0,0,0,0,236,18,0,0,0,0,0,0,0,0,0,100
743de733050e87653f64aca449d5d0a0eb15532d,1,6,2,4,0,0,0,3,4,104,1,1,0,101,24,3,11,10,1,636,617,19,4,4,0,100
7c6315311f2f08992773d175d80314c449c7e9b6,5,169,3,166,0,0,0,4,20,46,1,4,1.917594303,937,25,4,116,93,23,8421,7257,1164,66,61,5,100
f5f07402d40c19962ea6650092509c32aafb12e6,0,0,0,0,0,0,0,0,0,0,0,0,0,0,237,17,0,0,0,0,0,0,0,0,0,100
87feb883c68a9251a3e9d09222e49ea223da169d,0,0,0,0,0,0,0,0,0,0,0,0,0,0,29,3,0,0,0,0,0,0,0,0,0,100
84ceeb150a2cdbc9a44be001fb5a86c4079644e1,3,33,18,15,0,0,0,6,15,160,1,2,1.086312841,1263,60,6,305,301,4,9867,9806,61,107,106,1,100
d6987af2bbd04e1fe44263720d0b8eb41905bd02,4,42,19,23,0,0,0,4,21,83,1,4,1.555603698,856,26,5,64,64,0,7704,7475,229,28,28,0,100
9ca2cebaed3dd91a9504326f753cb36a97f150d5,6,85,13,72,1,0,1,5,16,95,1,3,1.700425482,998,61,7,150,145,5,8313,7941,372,43,41,2,99.97778271
880ba738c54251734da14411cf873d5aebd13d76,0,0,0,0,0,0,0,0,0,0,0,0,0,0,238,14,0,0,0,0,0,0,0,0,0,100
7639ff2237352884c76e862fd14826cb053bb0fc,4,39,20,19,0,0,0,3,10,87,1,4,1.452212304,635,62,8,74,73,1,4939,4753,186,33,33,0,100
8734c37cbaeb00120eba9127f92f7d44f0f1736e,2,8,4,4,0,0,0,1,3,151,1,2,0.918295834,176,239,15,29,29,0,1017,999,18,20,20,0,100
67c91512787ed50ebb976d0218cead62756f0b82,1,1,0,1,0,0,0,2,3,318,1,1,0,36,63,9,1,1,0,189,180,9,1,1,0,100
f430f521faea959491208c199b59244386cef438,11,1110,20,1090,8,0,8,7,14,10,3,7,2.961841033,358,78,4,188,53,135,8668,2331,6337,75,24,51,99.78947368
3082b5e6264eb0051a60e7929cc5a78390cb7ac4,4,11,12,1,0,0,0,2,2,0,2,3,1.632105718,516,240,16,65,65,0,3769,3728,41,25,25,0,99.98894295
bb71d37df856fa7738af9d654afc3a772a0ef8f8,1,3,3,0,0,0,0,2,3,0,1,1,0,92,241,17,6,6,0,627,627,0,4,4,0,100
8fe968cb7e340e2f21711b5a0f701e760cb91d59,11,350,33,317,5,0,5,6,17,72,2,6,3.07577668,951,64,8,177,150,27,8917,7528,1389,54,36,18,99.66725821
e24de5c7e85f7dba7eb5dfc4aee56b421c0e8ec4,8,42,35,7,0,0,0,6,16,32,1,5,2.669217219,673,65,9,69,67,2,4425,4397,28,30,28,2,99.75601641
229d7b9073a430de7dbbb12d39ddc330646eb458,1,6,3,3,0,0,0,6,16,0,1,1,0,204,66,10,31,29,2,1250,1233,17,11,11,0,100
a89275bfc86c4db63688e28ff12196ee97a78207,3,115,123,8,0,0,0,3,7,78,1,3,1.145702461,705,79,5,111,113,2,5750,5709,41,30,29,1,100
725e733778dd405c2056249e766d342cbed32e8a,13,235,41,194,1,0,1,3,15,37,4,11,2.504235623,954,242,18,122,103,19,7708,6489,1219,63,51,12,99.9005415
12a0fb96144f70a9bd73939d7e968a2160b9999a,6,44,32,12,0,0,0,3,22,91,1,5,2.428831595,865,243,18,133,131,2,6479,6392,87,62,62,0,100
a34ef878a21dada05c8c297a4b66f93889361d50,4,22,4,18,0,0,0,2,17,145,2,3,1.352030102,417,244,19,59,55,4,3107,3031,76,19,19,0,100
73642a4ee2e307a572457bca664b790385038c81,1,1,1,0,0,0,0,3,4,38,1,1,0,89,0,0,13,14,1,488,496,8,4,4,0,100
4f4a7a3b349f005c4eae5642ba7ed8006235cf61,0,0,0,0,0,0,0,0,0,0,0,0,0,0,30,1,0,0,0,0,0,0,0,0,0,100
89d136ae927bc1c32fc5d05175258bc44e921227,1,216,0,216,1,0,1,1,1,0,1,1,0,0,7,0,13,0,13,1698,0,1698,8,0,8,99.8896856
231560ad3eb11678d489923b03c4a017d307e8b5,0,0,0,0,0,0,0,0,0,0,0,0,0,0,245,13,0,0,0,0,0,0,0,0,0,100
91a63d583601a141768b154685434a2cf6fecf0a,0,0,0,0,0,0,0,0,0,0,0,0,0,0,80,1,0,0,0,0,0,0,0,0,0,100
62f8c78d39f1e80fa2f04c1ec2dc9606138c28f8,0,0,0,0,0,0,0,0,0,0,0,0,0,0,21,0,0,0,0,0,0,0,0,0,0,100
77fbff720145e08e5ea6ad30117317ef5b1e031d,17,489,24,465,4,0,4,3,16,185,4,12,3.097972078,1188,81,2,171,115,56,10179,7570,2609,89,61,28,98.76743432
ab50e62acb2483dd009d87b2d68814e13e3e3d92,4,24,14,10,0,0,0,3,10,84,2,3,1.613665667,899,82,3,129,128,1,8014,7958,56,46,46,0,100
8b3729f97f73901ad5fa70a79ff7b6a8a19f0659,15,19,443,424,0,0,0,2,10,723,2,8,3.490422393,807,246,4,69,92,23,2624,4007,1383,49,64,15,99.75529312
d2fee6e6ff319f6a35e4c8209bd89d2d4e864c5c,2,25,3,22,0,0,0,2,3,256,1,2,0.863120569,232,0,0,24,20,4,1844,1649,195,15,14,1,100
257a3517bf0b191dfe931c21232810f65cfc5a63,0,0,0,0,0,0,0,0,0,0,0,0,0,0,15,0,0,0,0,0,0,0,0,0,0,100
c9c475e2a6b6e3406764c5d7fbfa44a3c5eeead8,11,47,23,24,0,0,0,4,11,207,3,8,3.133882711,1450,83,3,160,155,5,11773,11665,108,84,81,3,100
02d6cce73679ce90fe610dbdb30fd1cbdd062897,2,11,14,3,0,0,0,4,17,69,1,2,0.989587521,944,67,0,99,98,1,9372,9357,15,47,47,0,100
18424b9f5f6ceaa54a5574eda391b19d4a4e3e57,1,5,0,5,0,0,0,2,3,85,1,1,0,72,16,1,3,3,0,483,455,28,2,2,0,100
0d4f109fa51d2f1c409e8335f8c4e5d48a66a87b,0,0,0,0,0,0,0,0,0,0,0,0,0,0,31,0,0,0,0,0,0,0,0,0,0,100
2adbbf59f23b7088cf60fa4e82540b4017c3693d,0,0,0,0,0,0,0,0,0,0,0,0,0,0,32,1,0,0,0,0,0,0,0,0,0,100
b4695801f6c93ca0991fd9758c470b784aa8c781,44,1659,33,1626,23,0,23,2,18,48,3,28,4.62151915,3432,68,1,548,409,139,36837,29201,7636,260,165,95,99.41451991
3af9ac4802a9dec2f2160aa98cd3b90287e14d48,0,0,0,0,0,0,0,0,0,0,0,0,0,0,247,1,0,0,0,0,0,0,0,0,0,100
2a2b07cb960032ec17b48968b02af030d0954c7a,0,0,0,0,0,0,0,0,0,0,0,0,0,0,17,2,0,0,0,0,0,0,0,0,0,100
0622ae1f402d834753db6a7eb7312b9a6a29cce8,0,0,0,0,0,0,0,0,0,0,0,0,0,0,0,0,0,0,0,0,0,0,0,0,0,100
3523480c458b475763bf27c21c9f65929abeb478,2,7,4,3,0,0,0,5,29,109,1,2,0.845350937,649,16,0,143,143,0,3808,3773,35,102,102,0,100
0a4299766b852b82e33b02b5194a106998f9f4d8,135,566,569,3,0,0,0,3,19,408,5,44,4.259017749,15057,3,0,2243,2243,0,87203,87151,52,1875,1875,0,100
71c1f95a46fef70bff42cf0b1db56cfc3f6b1d3c,6,249,4,245,4,0,4,1,9,54,1,5,2.202897923,221,17,1,45,28,17,2422,1332,1090,24,10,14,99.69237297
74d722406dd776c0d1a3c1065ad80b0c6637236e,1,2,2,0,0,0,0,4,6,111,1,1,0,243,18,2,12,12,0,1985,1985,0,8,8,0,100
abdeb3a369717dd4c23bff7f2dcb938bc3dfb98e,0,0,0,0,0,0,0,0,0,0,0,0,0,0,18,3,0,0,0,0,0,0,0,0,0,100
14f7f3fa3c08abab9babe72387cbb4d36dc383d3,0,0,0,0,0,0,0,0,0,0,0,0,0,0,248,1,0,0,0,0,0,0,0,0,0,100
2160673c81af3ee850f9cb514104421e8b6b74dc,9,135,121,14,0,0,0,2,10,81,2,7,2.073651741,919,249,2,92,90,2,7268,7260,8,49,47,2,100
e38c19e135ec649b0816fa016e24800ba0b4a7d6,1,13,11,2,0,0,0,1,4,113,1,1,0,139,250,3,18,17,1,972,967,5,8,8,0,100
ff31d571790b97cc9ddd1174b53f6f46307f71ad,1,1,1,0,0,0,0,3,3,259,1,1,0,65,1,0,4,4,0,378,378,0,3,3,0,100
2534a34c5087a30ea95c8baeed90d485ae5777ac,0,0,0,0,0,0,0,0,0,0,0,0,0,0,19,4,0,0,0,0,0,0,0,0,0,100
1550c8954b23b443ac41f6d13a7caa02d2a6af6a,0,0,0,0,0,0,0,0,0,0,0,0,0,0,20,5,0,0,0,0,0,0,0,0,0,100
2cc61baa57ca0293228b6f788747f9326cf7bc38,0,0,0,0,0,0,0,0,0,0,0,0,0,0,21,6,0,0,0,0,0,0,0,0,0,100
6537254848d21a730833bfe2e6bc5c8f82069e7a,0,0,0,0,0,0,0,0,0,0,0,0,0,0,251,4,0,0,0,0,0,0,0,0,0,100
9c71b0ea05d3dcec51024873667865c695075ac1,0,0,0,0,0,0,0,0,0,0,0,0,0,0,22,7,0,0,0,0,0,0,0,0,0,100
015d577883f72707d7c38015840607be4ae226fb,3,12,11,1,0,0,0,2,9,93,1,3,1.264672679,437,84,1,66,66,0,3328,3326,2,25,25,0,100
eae6e8f11367c397c3a9ce39f2c59cf341f33847,39,1542,89,1453,11,0,11,4,20,47,1,16,4.210774494,2997,85,2,681,450,231,30246,21950,8296,264,165,99,98.99400685
9381c2d17e3e10a02e9f0f359a05d0728ee17752,4,9,4,5,0,0,0,2,3,8,1,3,1.950063756,363,86,2,51,51,0,2464,2404,60,27,27,0,99.74054054
dbec60fc1120317d436270a43e5e8a4caa7503f6,1,1,1,0,0,0,0,3,4,30,1,1,0,131,87,3,22,22,0,570,570,0,22,22,0,100
031835c772a87f1ca5228a409b21145caad79ff4,2,6,5,1,0,0,0,2,3,32,1,2,0.994030211,132,19,3,9,9,0,851,833,18,6,6,0,100
5e4c937e3479a09b7a21cd5176b7b2ebdd6c8287,9,165,21,144,1,0,1,2,6,257,1,6,2.765905709,601,88,4,86,71,15,4469,3473,996,58,51,7,99.42578548
ce53540f3d3128ed9aeec2112d184fa214edca45,0,0,0,0,0,0,0,0,0,0,0,0,0,0,33,0,0,0,0,0,0,0,0,0,0,100
efeda20085ceec841195cd4697c017549369398a,0,0,0,0,0,0,0,0,0,0,0,0,0,0,23,0,0,0,0,0,0,0,0,0,0,100
f9bce30848b5bb688d9ec264e5bdb160b610a18f,0,0,0,0,0,0,0,0,0,0,0,0,0,0,20,0,0,0,0,0,0,0,0,0,0,100
1cfff2b9a9ade5dd7c9fd1b9c5e8f5928963da85,0,0,0,0,0,0,0,0,0,0,0,0,0,0,21,1,0,0,0,0,0,0,0,0,0,100
ac577675017a6ef437b8a774aa2c0e43cc973502,1,5,6,1,0,0,0,3,4,95,1,1,0,169,2,0,31,31,0,1199,1182,17,11,11,0,100
67c170f9354a56a65efc31ed0413abc75724bb88,0,0,0,0,0,0,0,0,0,0,0,0,0,0,34,1,0,0,0,0,0,0,0,0,0,100
83d9c8277b32003fceacf755df37ada1963c536c,0,0,0,0,0,0,0,0,0,0,0,0,0,0,35,2,0,0,0,0,0,0,0,0,0,100
7681287cb2e3b841f7d35a9d1c760d840cca676c,0,0,0,0,0,0,0,0,0,0,0,0,0,0,24,1,0,0,0,0,0,0,0,0,0,100
49ca3b0ec481f6fcfbf339cb6d3b63b4dede1011,44,1151,599,552,6,0,6,7,30,275,5,30,3.795860575,4528,252,0,604,552,52,35111,32588,2523,313,282,31,98.32659479
000ac3c0012c79f6eb1f6d7384a254a1e5f8ac9c,0,0,0,0,0,0,0,0,0,0,0,0,0,0,36,3,0,0,0,0,0,0,0,0,0,100
5628dca7f666d174224be3bab8d930f2d83a385e,0,0,0,0,0,0,0,0,0,0,0,0,0,0,69,0,0,0,0,0,0,0,0,0,0,100
4ed406abc69f47321e54c53fd809a6888719151d,0,0,0,0,0,0,0,0,0,0,0,0,0,0,253,1,0,0,0,0,0,0,0,0,0,100
077e27b236c4b31454a45bb66a7372bfcd01e13a,8,308,10,298,3,0,3,1,21,94,1,7,2.018965069,934,89,0,157,120,37,9989,8052,1937,62,44,18,99.74448316
d9bb79952283c07f2682fd91f9f04ccbcfd4fd42,0,0,0,0,0,0,0,0,0,0,0,0,0,0,22,2,0,0,0,0,0,0,0,0,0,100
26e1f067704e5059b4c71fddacd29c0fb3f51335,0,0,0,0,0,0,0,0,0,0,0,0,0,0,8,0,0,0,0,0,0,0,0,0,0,100
255f00f177f007f5aae32a39de60327f1b8d413d,0,0,0,0,0,0,0,0,0,0,0,0,0,0,23,3,0,0,0,0,0,0,0,0,0,100
71522d95648d93cf8791c4a4112d3756a0b601bc,0,0,0,0,0,0,0,0,0,0,0,0,0,0,37,4,0,0,0,0,0,0,0,0,0,100
db26c1cf140e2bd6bb2961de33cd57a3825800e3,2,76,62,14,0,0,0,1,5,6,2,2,0.189278431,123,254,2,14,10,4,751,674,77,6,5,1,100
73d03b9e5b534a737e0fb96bd2f09e4c51591321,0,0,0,0,0,0,0,0,0,0,0,0,0,0,38,5,0,0,0,0,0,0,0,0,0,100
3027e5fbc7d30f938371c17caddb3b2d91ad5b54,5,18,29,11,0,0,0,5,22,92,1,5,2.036877897,1355,70,1,118,117,1,12971,13081,110,60,60,0,100
579e83f5f78b79e61569d64708b895985ba1d72e,5,69,41,28,0,0,0,2,9,145,3,5,2.11208559,398,71,2,47,38,9,2786,2631,155,13,12,1,100
c85056736b9d41df17dd895ecf9cb66ecce2f433,0,0,0,0,0,0,0,0,0,0,0,0,0,0,39,6,0,0,0,0,0,0,0,0,0,100
a27289fd3158f5c8cf8398b24d1a102a22d3ea5e,1,9,2,7,0,0,0,5,31,12,1,1,0,447,255,3,81,80,1,2814,2749,65,58,58,0,100
4a5c4a43c1c38bea07867306028e5f3a4b856552,15,412,120,292,3,0,3,2,8,184,1,8,3.1366889,1123,90,1,173,150,23,8984,7365,1619,114,92,22,98.15528313
45a6493999853328b89c16cd1dbc462a4315953a,25,150,58,92,1,0,1,6,19,103,1,8,3.514706949,3419,72,3,542,534,8,23257,22747,510,299,295,4,99.9765148
3fe82b81768887b42b019c43178887261f984a9b,1,1,0,1,0,0,0,8,20,0,1,1,0,513,73,4,104,104,0,4836,4824,12,15,15,0,100
9f4649d1abe65fa9ee7f626825aae52db8f78bbb,1,1,1,0,0,0,0,8,21,0,1,1,0,514,74,5,104,104,0,4829,4836,7,15,15,0,100
278fe87b175f308b1cb49a3cd8d5f4945a0a711b,0,0,0,0,0,0,0,0,0,0,0,0,0,0,3,1,0,0,0,0,0,0,0,0,0,100
271fa7ff56897d8d148c25896284cf835ca7fac4,2,56,37,19,0,0,0,5,20,230,1,2,0.730447286,684,52,0,106,105,1,5221,4997,224,51,51,0,100
c0198a0cea7d3aca506b3252b045e24ce90f5921,1,9,0,9,0,0,0,5,18,122,1,1,0,163,75,6,25,23,2,1345,1268,77,6,6,0,100
c32b7152595bb074745523cfd9d829484458d90e,9,363,162,201,2,0,2,1,1,0,1,6,2.701529896,254,25,2,15,5,10,1942,1470,472,12,5,7,99.02268761
c6866e5fb57cd5c4481158d5b492f30abbc5c90c,0,0,0,0,0,0,0,0,0,0,0,0,0,0,40,6,0,0,0,0,0,0,0,0,0,100
a7df69e3ad19ec43f59a9592cf399cd86d6fa418,3,8,5,3,0,0,0,2,6,636,1,2,1.460484681,345,5,0,51,51,0,2329,2321,8,19,19,0,100
94b597b774464d33c30b290538a4231075a363e1,44,1293,479,814,11,0,11,1,18,155,4,27,4.733332862,3012,256,4,497,362,135,26666,21068,5598,275,181,94,98.30587143
e220ae1fe28c0698fca1987694eb2bf3e61c8ca3,4,14,4,10,0,0,0,1,22,24,2,3,1.816340114,727,91,2,126,123,3,6368,6267,101,27,27,0,100
b1c8f2442345eaa520dee5ac5f7adfaaa69bb0f1,0,0,0,0,0,0,0,0,0,0,0,0,0,0,41,7,0,0,0,0,0,0,0,0,0,100
81ad0311d1b402a28d9ef5644f5c7115af6f7dbf,5,20,14,6,0,0,0,1,21,26,3,4,1.959094371,871,257,5,145,148,3,7365,7466,101,29,29,0,100
86eed4f567f82fdbf3b53014837ec0eb847a7f28,4,14,4,10,0,0,0,1,22,24,2,3,1.816340114,727,258,6,126,123,3,6368,6267,101,27,27,0,100
610b9f2ecc1221c6aee2243615860a86a3e16593,0,0,0,0,0,0,0,0,0,0,0,0,0,0,26,3,0,0,0,0,0,0,0,0,0,100
167ec0815db237b787cfeb7b3eea1c74ff5a39e3,0,0,0,0,0,0,0,0,0,0,0,0,0,0,259,7,0,0,0,0,0,0,0,0,0,100
051dc69c5cc50bc354e72a4951472ae2c9a25524,0,0,0,0,0,0,0,0,0,0,0,0,0,0,260,8,0,0,0,0,0,0,0,0,0,100
3011fdf845e429d842e528ff00a4a7b7b55038e9,3,194,0,194,2,0,2,1,4,168,1,3,1.344523135,32,76,7,18,2,16,1019,107,912,11,1,10,99.95331466
75586658ba1aa202ee0ebec8c4cc52546cb0aae2,3,34,19,15,0,0,0,3,12,223,1,3,0.787043555,475,92,3,80,77,3,3619,3588,31,40,38,2,100
5ec75f2abce494d01319998c3970301c991960bd,1,1,1,0,0,0,0,1,7,5,1,1,0,58,261,9,5,5,0,272,272,0,1,1,0,100
086d11e1ddc0f00f5209d4b74086dd6a920eaa85,1,8,8,0,0,0,0,2,4,506,1,1,0,261,262,10,45,46,1,1536,1538,2,41,42,1,100
a42f7891c90e654a6a74283f1eaedddd531ad39d,0,0,0,0,0,0,0,0,0,0,0,0,0,0,42,8,0,0,0,0,0,0,0,0,0,100
af33ae3c364aa3edf57df5469c97ab28cf0ce3c1,2,74,1,73,0,0,0,3,5,240,1,2,0.242292189,743,77,8,98,95,3,7923,7157,766,35,33,2,100
97ae1da52d09d8c22b37a63b53dac0649b2c024f,0,0,0,0,0,0,0,0,0,0,0,0,0,0,27,3,0,0,0,0,0,0,0,0,0,100
6e0fc410d4d148eba238c86d3bb7b2be507f6d82,10,528,372,156,2,0,2,2,8,115,2,7,2.352965502,674,263,11,112,92,20,4418,3733,685,88,71,17,99.81347633
7bfe55de7bf37242a0c60b47f3759fe706ff44b1,2,211,0,211,2,0,2,1,1,0,1,2,0.998038619,0,78,9,13,0,13,1045,0,1045,10,0,10,99.95342338
1c90aa46d23e8ed2f35bddc37e34900392060dac,0,0,0,0,0,0,0,0,0,0,0,0,0,0,43,9,0,0,0,0,0,0,0,0,0,100
07990e3e7cbda78babada5dfe2b7295e837115a0,0,0,0,0,0,0,0,0,0,0,0,0,0,0,44,10,0,0,0,0,0,0,0,0,0,100
605e53a9004b357aa04d0fb54f73ff1cfe3ae6e2,0,0,0,0,0,0,0,0,0,0,0,0,0,0,45,8,0,0,0,0,0,0,0,0,0,100
75a92dcf6ef57321ac1d7bd32a4756520da08d27,1,1,1,0,0,0,0,1,4,428,1,1,0,44,264,10,3,3,0,172,172,0,3,3,0,100
a8d82d55f53a25d24cdab45c4b59a24007e9085e,2,21,6,15,0,0,0,3,9,127,1,2,0.764204507,191,265,11,36,33,3,1187,1123,64,24,22,2,100
8d79f0888eac4e3380bc094907c0ea7728dccbae,2,46,32,14,0,0,0,1,19,26,1,2,0.435613373,286,266,12,36,29,7,2299,2202,97,6,6,0,100
287a1c109c003140959781870222b608778524e2,0,0,0,0,0,0,0,0,0,0,0,0,0,0,46,9,0,0,0,0,0,0,0,0,0,100
c75eadd44d097df3e6ff830ddaebadbf7751a637,2,35,19,16,0,0,0,5,10,358,1,2,0.99107606,273,53,1,33,32,1,2106,2051,55,15,14,1,100
d766f68152d6cd120d3d0487907f7ee85f7a614a,28,763,214,549,4,0,4,6,17,97,2,17,4.030698654,2094,79,7,347,272,75,17051,13319,3732,159,144,15,99.65253648
af6dd7d4c039d5a55cf223102a05693e7c26adea,2,10,0,10,0,0,0,2,4,0,1,2,0.970950594,164,80,7,24,21,3,1356,1315,41,5,5,0,100
25dfff7b092c7a65df167ba8e98094d2c0306721,2,20,15,5,0,0,0,2,5,0,1,1,0.999411065,259,81,6,44,41,3,1939,1739,200,26,24,2,99.89588154
1accc24def11259d863b86261d69b53b5e3e7db2,0,0,0,0,0,0,0,0,0,0,0,0,0,0,47,7,0,0,0,0,0,0,0,0,0,100
b6165aab3dabef98c2ed7c2d3fe7ae7f58589c5a,0,0,0,0,0,0,0,0,0,0,0,0,0,0,48,8,0,0,0,0,0,0,0,0,0,100
1085dae698371fd58f60c2aa728430edfef916b8,1,8,6,2,0,0,0,2,6,7,1,1,0,120,82,5,18,17,1,1135,1100,35,4,4,0,100
dd16620e235478b27e83565432ac2c98d070a175,0,0,0,0,0,0,0,0,0,0,0,0,0,0,49,6,0,0,0,0,0,0,0,0,0,100
d5dce2b3498960417da498895e3f2d9c4241f66b,24,1031,13,1018,17,0,17,1,11,32,3,13,4.089631655,981,267,4,250,165,85,12324,7498,4826,140,95,45,99.52606635
56c2b8a6f828e36eb399a780a7705000222475e6,2,22,6,16,0,0,0,1,5,27,1,2,0.985228136,310,268,5,47,43,4,2338,2236,102,14,13,1,100
a71a36bf4ea212e23ac21c117adae51568e13295,0,0,0,0,0,0,0,0,0,0,0,0,0,0,50,7,0,0,0,0,0,0,0,0,0,100
7e41ed0b9d9c6bcbd5fef156ae5ca1cdc7e16c28,4,154,7,147,0,0,0,1,6,227,1,3,1.766128035,361,269,6,143,73,70,3032,1628,1404,65,59,6,100
9066920586174c2ba967fbd2434a21fa5b8353fa,5,151,28,123,1,0,1,4,15,205,1,4,1.312344564,738,27,0,37,30,7,7430,6597,833,29,24,5,99.95398067
93f83f4a975dd3303f776c4fc9b3da8a53384aa3,0,0,0,0,0,0,0,0,0,0,0,0,0,0,51,6,0,0,0,0,0,0,0,0,0,100
3fe637eb573c0d8aa85420c5d6101efd6aef13e4,40,744,319,425,4,0,4,2,23,239,2,20,3.932404582,3681,93,0,486,433,53,28005,25340,2665,272,240,32,98.9524577
ab5bf1076e3d199edfe58659fb9b14904d63ac8f,14,904,4,900,7,0,7,3,6,159,1,9,3.010731988,632,270,6,171,65,106,9933,4311,5622,68,30,38,98.21206292
0071c79abfd9d6535fe726721c0a17286b29af43,7,441,20,421,3,0,3,1,6,80,3,5,2.335015,604,94,1,164,116,48,5997,3728,2269,92,60,32,99.78886543
33ad0a58b34745afb01887f7b042811f042cfb61,4,58,33,25,0,0,0,4,11,188,1,4,1.584546843,666,95,2,107,99,8,5136,4944,192,37,37,0,99.96667777
b1f6b35286e5077b47dfea5d5c5e5071522fd98f,0,0,0,0,0,0,0,0,0,0,0,0,0,0,28,0,0,0,0,0,0,0,0,0,0,100
b31b5470ec8a58fc97b7b02909cf69221c50eda0,0,0,0,0,0,0,0,0,0,0,0,0,0,0,29,1,0,0,0,0,0,0,0,0,0,100
ec52457cdda61be2d26c1f08935198447bde3d86,8,45,69,24,0,0,0,2,18,0,1,7,2.649635211,781,96,3,85,92,7,5069,5245,176,30,32,2,100
fa713a48eb15d75bf596fcbe5e50cd9859cb5259,0,0,0,0,0,0,0,0,0,0,0,0,0,0,9,0,0,0,0,0,0,0,0,0,0,100
877d3e77b18c162455d1970a0cff9d5e04dc44b2,7,331,3,328,3,0,3,3,11,159,2,5,1.940558232,290,10,1,49,17,32,3156,1607,1549,28,7,21,99.88904915
c96c1927ecb59b670cf7461841b30cc41e9b27ec,0,0,0,0,0,0,0,0,0,0,0,0,0,0,11,2,0,0,0,0,0,0,0,0,0,100
a1c6a3948c574e646e89ceb77396f35d9d49fad7,8,26,26,0,0,0,0,1,16,308,1,6,2.42947381,845,271,4,112,110,2,6499,6442,57,72,70,2,100
1e7250d8e4ca942bbb3dde8ad37d9d0f5b31d614,0,0,0,0,0,0,0,0,0,0,0,0,0,0,272,5,0,0,0,0,0,0,0,0,0,100
0d47184a6bd5f6f1d6b28095acd2267cd41c3945,0,0,0,0,0,0,0,0,0,0,0,0,0,0,52,5,0,0,0,0,0,0,0,0,0,100
84d661e65e6232e62450ecbceb520e25e9d13b8a,0,0,0,0,0,0,0,0,0,0,0,0,0,0,53,6,0,0,0,0,0,0,0,0,0,100
d9842b75c6622bce09c45f1cdd45113105f2854b,0,0,0,0,0,0,0,0,0,0,0,0,0,0,273,6,0,0,0,0,0,0,0,0,0,100
5630417334c64e36c0573f71677af34d39ec5d35,1,1,1,0,0,0,0,2,3,569,1,1,0,24,24,0,1,1,0,55,55,0,1,1,0,100
c616c22c0049a91b602bdb1d64963cae712081df,0,0,0,0,0,0,0,0,0,0,0,0,0,0,274,7,0,0,0,0,0,0,0,0,0,100
4e8d8c2053749193e88b49e82a07dfb2bb2edd6e,1,1,1,0,0,0,0,8,13,73,1,1,0,604,97,4,105,105,0,6156,6156,0,36,36,0,100
95a506b441829a617d0a0740fafa02b9ce0a9cab,0,0,0,0,0,0,0,0,0,0,0,0,0,0,4,0,0,0,0,0,0,0,0,0,0,100
0cda01b58f4a4bb06a1ab71bae597fdc4f7c39cf,7,68,72,4,0,0,0,2,9,278,1,5,1.090148827,607,98,5,91,91,0,3914,3955,41,27,26,1,100
673a81e440914ca292b14b26ec2eb8b757a01e8f,11,840,32,808,7,0,7,3,9,50,3,7,2.511722004,668,25,1,104,50,54,10604,5920,4684,61,22,39,99.73489451
368197f622b83ab342f1e245b318815fb8a96df0,0,0,0,0,0,0,0,0,0,0,0,0,0,0,54,5,0,0,0,0,0,0,0,0,0,100
3fb7ff27d4011a4a93e349df63099766486b37cb,2,1,2,1,0,0,0,3,5,37,2,2,0.918295834,163,26,2,17,17,0,990,997,7,16,16,0,100
812002740cd6acea8c5e4b2f0e2267e47668aa10,0,0,0,0,0,0,0,0,0,0,0,0,0,0,30,2,0,0,0,0,0,0,0,0,0,100
4e228a8ded607a9e77676e7f48463a02d1145022,2,1,3,2,0,0,0,6,12,34,1,1,1,226,12,3,19,19,0,1373,1388,15,6,6,0,100
8e76d34ea30bafc6d02c818319ac547ef132a4dc,3,109,102,7,0,0,0,2,3,747,1,3,0.678642749,424,99,5,66,66,0,3100,3091,9,22,22,0,100
a64b622cc086198a2ae056cc9cc59fab8b4f628d,0,0,0,0,0,0,0,0,0,0,0,0,0,0,100,6,0,0,0,0,0,0,0,0,0,100
c01a258b6f9b8fa0ca340b605e7ef942b95c3afd,3,18,9,9,0,0,0,6,11,443,1,3,1.17303067,485,101,7,82,80,2,3451,3374,77,30,30,0,98.78307469
8b40dae567b2cfc68d3507af0adb67cd968000a1,0,0,0,0,0,0,0,0,0,0,0,0,0,0,55,1,0,0,0,0,0,0,0,0,0,100
dd2c098888d5850adececc03c4a4f563aab4f7ff,0,0,0,0,0,0,0,0,0,0,0,0,0,0,56,2,0,0,0,0,0,0,0,0,0,100
ee55054a7a5de8e20abecf0dc233c312a70d2e98,0,0,0,0,0,0,0,0,0,0,0,0,0,0,275,0,0,0,0,0,0,0,0,0,0,100
0c52711b897a4fd6d5aaf7330e89572582f1d189,0,0,0,0,0,0,0,0,0,0,0,0,0,0,31,1,0,0,0,0,0,0,0,0,0,100
29b79761477311367cf42e2bf2f213c0d3a08ab1,4,21,6,15,0,0,0,3,10,140,1,4,1.909371894,503,11,0,35,34,1,4636,4432,204,22,22,0,99.76383266
20b4bea3edc12e95ed0056594e630564e28fd4a9,2,49,3,46,1,0,1,1,5,32,1,2,0.51594693,204,27,0,47,45,2,1009,837,172,47,45,2,99.97766361
7c0d83f3c4847dac450ba505153a5bf17d30fd73,2,76,30,46,1,0,1,1,3,344,1,2,0.962698379,60,102,3,4,8,4,370,343,27,4,3,1,99.96651038
b5d729bd75f817390df9dd127ba1004b23c31b2b,0,0,0,0,0,0,0,0,0,0,0,0,0,0,22,0,0,0,0,0,0,0,0,0,0,100
4ff4d628f52b88bc3fc9b570abe1446f525a1e16,0,0,0,0,0,0,0,0,0,0,0,0,0,0,103,1,0,0,0,0,0,0,0,0,0,100
01553a34639423621b534bc9837dea4cf4c71b4b,0,0,0,0,0,0,0,0,0,0,0,0,0,0,13,0,0,0,0,0,0,0,0,0,0,100
e8d572dc1630e024a270fce1e04a52b885d935a9,0,0,0,0,0,0,0,0,0,0,0,0,0,0,57,2,0,0,0,0,0,0,0,0,0,100
9b488f1fe8d0db7974241c46c8883443c18a9394,0,0,0,0,0,0,0,0,0,0,0,0,0,0,28,1,0,0,0,0,0,0,0,0,0,100
c243f4161d9ac62e9cb8af90c604ca5452afd7cc,0,0,0,0,0,0,0,0,0,0,0,0,0,0,29,2,0,0,0,0,0,0,0,0,0,100
d20f2e1162f986c66fd5e5e23c85a22aabd5d417,0,0,0,0,0,0,0,0,0,0,0,0,0,0,5,0,0,0,0,0,0,0,0,0,0,100
31f2582da42c0c4cc75bf5c93edacab603a30b89,0,0,0,0,0,0,0,0,0,0,0,0,0,0,5,0,0,0,0,0,0,0,0,0,0,100
fc7281d715f57f2f911079d24f5c09b1f79c50cf,2,55,0,55,1,0,1,1,6,178,1,2,0.684038436,65,104,2,13,9,4,603,355,248,7,5,2,99.64416769
ecb5129ec5b1ccc2be528a3ae98d94754a3b92df,0,0,0,0,0,0,0,0,0,0,0,0,0,0,0,0,0,0,0,0,0,0,0,0,0,100
d182819d8d72276d3ae29b3904007d0f01ce8c15,0,0,0,0,0,0,0,0,0,0,0,0,0,0,14,1,0,0,0,0,0,0,0,0,0,100
391c6723b3281ac0a4f41b1f87760216dfa08102,0,0,0,0,0,0,0,0,0,0,0,0,0,0,32,1,0,0,0,0,0,0,0,0,0,100
cc5d23baed2a30bafc31bba713cc1dbffed86971,37,118,124,6,0,0,0,5,9,293,3,22,4.629535348,2814,1,1,350,179,171,16821,11203,5618,167,107,60,98.67335563
3b66c0d3c710b7c64be7839c0246218edf806e8b,3,16,11,5,0,0,0,4,5,172,1,3,1.392147224,267,105,3,34,32,2,1885,1847,38,18,18,0,100
8b402e7cd003e13d95cff19b75b6d205b45f3299,0,0,0,0,0,0,0,0,0,0,0,0,0,0,33,2,0,0,0,0,0,0,0,0,0,100
b4d07113933aa79e8575715370b08ef79c287444,1,2,2,0,0,0,0,7,18,129,1,1,0,208,106,4,31,31,0,1250,1250,0,11,11,0,100
e3afe444f59d3117fbe9d778120a47c411e2aa99,2,36,37,1,0,0,0,3,4,398,2,2,0.847107491,159,2,2,10,10,0,1036,1055,19,5,5,0,100
84d40ae6f7eb50214de231b4f9744a034cff1a4a,0,0,0,0,0,0,0,0,0,0,0,0,0,0,34,2,0,0,0,0,0,0,0,0,0,100
eaad6cf74c896a97a061a3f600a0ec64a95c0963,1,11,3,8,0,0,0,6,12,103,1,1,0,300,107,1,52,51,1,2287,2227,60,21,21,0,100
47f00f159231958fb39748b4a6a01c4520371dec,1,24,7,17,0,0,0,7,24,233,1,1,0,194,108,1,32,29,3,1741,1588,153,9,9,0,100
8da06636b8e3834f7bebf6b1af923ad24b7d6d8b,14,263,52,211,2,0,2,1,20,265,2,8,3.115789357,2283,109,2,419,396,23,16931,15685,1246,214,203,11,99.87690242
31aa29f593c7adeda50c755569a59493152d3e60,0,0,0,0,0,0,0,0,0,0,0,0,0,0,7,0,0,0,0,0,0,0,0,0,0,100
845f891517a2befccb73267c54fc08f8dc2c811a,0,0,0,0,0,0,0,0,0,0,0,0,0,0,58,0,0,0,0,0,0,0,0,0,0,100
342df9974c91f845608c9ff3c65b8c1818d56884,0,0,0,0,0,0,0,0,0,0,0,0,0,0,59,1,0,0,0,0,0,0,0,0,0,100
7111b7656e28fa2e30dc2dfdbb79e53a75c20f45,0,0,0,0,0,0,0,0,0,0,0,0,0,0,58,0,0,0,0,0,0,0,0,0,0,100
7d39863f48916116e99cdff98527e60f9379a475,1,3,2,1,0,0,0,8,14,184,1,1,0,604,110,0,105,105,0,6158,6156,2,36,36,0,100
3e62a756c6c7991fa3f1901e2d807fbd9c182788,0,0,0,0,0,0,0,0,0,0,0,0,0,0,110,0,0,0,0,0,0,0,0,0,0,100
af9b056dc453f46c6a2aeb92d8dd6fe503f1b577,10,27,14,13,0,0,0,2,11,421,4,6,2.254456612,1037,111,1,166,164,2,4939,4754,185,155,155,0,99.92201426
43bd197d6a2fdbb3781cf7d91928be404ae941aa,24,557,72,485,5,0,5,4,19,273,2,16,3.401584476,1777,112,2,273,218,55,14183,11551,2632,148,119,29,98.97491821
e8a58b66f1fce57f1f73f9d97e1aaf2944e69a74,1,24,12,12,0,0,0,3,6,276,1,1,0,264,113,3,45,42,3,2305,2240,65,17,17,0,100
cf3e0b21d1c5cd73ceb63595d0f07cab4ec68b5c,34,86,584,498,0,0,0,1,18,68,4,21,3.663553748,3231,111,1,382,439,57,16305,19122,2817,274,303,29,98.88548951
f02b6df19df1caa69ffc142f5e89236b5a172abe,34,665,86,579,5,0,5,2,19,313,4,21,3.520753295,2814,114,4,447,382,65,19488,16305,3183,313,274,39,98.88548951
1fb60cc762da24625f37c599c2ea89d693adad67,2,47,4,43,0,0,0,3,5,606,1,2,0.71401528,818,115,5,89,85,4,7845,7524,321,31,30,1,100
d6d859fbdbd8d3d86cd4595303a9101d0ae0dddd,34,86,665,579,0,0,0,1,18,68,4,21,3.520753295,3299,112,2,382,447,65,16305,19488,3183,274,313,39,98.88548951
a37d2e1bc3082507ed2bad41e33920ac6ebc42ea,34,665,86,579,5,0,5,2,19,313,4,21,3.520753295,2814,60,0,447,382,65,19488,16305,3183,313,274,39,98.88548951
1db33df5ab97e91e60711b512f5177142123a1b2,0,0,0,0,0,0,0,0,0,0,0,0,0,0,61,1,0,0,0,0,0,0,0,0,0,100
e2fbb861389ebfeb7d0c96743f7a79b185857e43,17,388,115,273,3,0,3,6,21,298,1,8,3.208630436,1886,116,2,328,276,52,15242,13315,1927,166,148,18,99.83962365
e963abeda31db0f561b401cebe0709a551afdd62,0,0,0,0,0,0,0,0,0,0,0,0,0,0,117,3,0,0,0,0,0,0,0,0,0,100
f7994cd2f586ebba3fa3005783c3911f929b3fb8,0,0,0,0,0,0,0,0,0,0,0,0,0,0,62,2,0,0,0,0,0,0,0,0,0,100
a260c9efeee7ef11fd1b756d15e264547b5f526f,0,0,0,0,0,0,0,0,0,0,0,0,0,0,118,2,0,0,0,0,0,0,0,0,0,100
2398c7b7e6159f48468bacd468c02a51f6c13a6b,0,0,0,0,0,0,0,0,0,0,0,0,0,0,63,3,0,0,0,0,0,0,0,0,0,100
737cf467fe32af4e27d426b37768817b8604bef6,0,0,0,0,0,0,0,0,0,0,0,0,0,0,64,4,0,0,0,0,0,0,0,0,0,100
dd61a490ebbbbc5c30dbb457aee72bf4a5fc225d,0,0,0,0,0,0,0,0,0,0,0,0,0,0,65,5,0,0,0,0,0,0,0,0,0,100
62d5530f7d598c91108748784255ec6a28fc93b2,0,0,0,0,0,0,0,0,0,0,0,0,0,0,66,6,0,0,0,0,0,0,0,0,0,100
092ddbe487e8c9262df449cac453336abc639068,12,764,1,763,9,0,9,1,7,72,1,10,3.05235908,358,119,3,129,58,71,6412,2299,4113,49,11,38,99.66887417
ffbcfb372fccbf8bedabad620817ba302a728584,0,0,0,0,0,0,0,0,0,0,0,0,0,0,67,6,0,0,0,0,0,0,0,0,0,100
a4f953516248df6eccb65014c712f385a36e3d26,0,0,0,0,0,0,0,0,0,0,0,0,0,0,68,7,0,0,0,0,0,0,0,0,0,100
a51bf5e1ab054fbd03d7679e48847b9caa85ebfc,0,0,0,0,0,0,0,0,0,0,0,0,0,0,69,8,0,0,0,0,0,0,0,0,0,100
aa136afa9e99381835356f647daccbf6b7a8be9f,1,3,3,0,0,0,0,3,10,158,1,1,0,186,120,2,35,35,0,1415,1409,6,21,21,0,100
9a844290b67db50f7d7924147e322b47c60a8a61,63,191,1806,1615,0,0,0,1,20,76,4,38,4.828334539,6401,113,0,740,879,139,32526,40474,7948,436,527,91,98.38445585
39ab83e625a271a2f3d55a9395c60a43c61f09da,63,1817,202,1615,17,0,17,2,21,249,4,38,4.826240355,5058,6,0,904,716,188,41142,31919,9223,528,433,95,98.38445585
053648be16bafca31a0c9bc43d0dcc0a754050d1,63,191,1806,1615,0,0,0,1,20,76,4,38,4.828334539,6401,8,0,740,879,139,32526,40474,7948,436,527,91,98.38445585
d85ac92b39c7b005e44f8a88566abd4ff09dd51a,0,0,0,0,0,0,0,0,0,0,0,0,0,0,83,0,0,0,0,0,0,0,0,0,0,100
783257bd1f188514a5595b55ea73d1621ad4d54b,63,1817,202,1615,17,0,17,2,21,249,4,38,4.826240355,5058,83,0,904,716,188,41142,31919,9223,528,433,95,98.38445585
ea28bccec3552c20bce40fb6584c9e0848898059,63,191,1806,1615,0,0,0,1,20,76,4,38,4.828334539,6401,9,1,740,879,139,32526,40474,7948,436,527,91,98.38445585
8c738eadad5aa020a8d93206b131cfa8d9114d0d,63,1817,202,1615,17,0,17,2,21,249,4,38,4.826240355,5058,7,1,904,716,188,41142,31919,9223,528,433,95,98.38445585
d0f07ae3e41688b82e8e1d55aef60caa77beee4e,6,123,40,83,0,0,0,1,2,54,1,6,1.374354545,495,121,1,68,51,17,4017,3398,619,27,24,3,100
16c037b080a4ab410125663677ea1229c69a3582,1,1,1,0,0,0,0,1,3,0,1,1,0,187,122,2,32,32,0,1426,1426,0,10,10,0,100
f20bf0eb31bd46f08ff0386dc86546bf7ae306df,1,13,12,1,0,0,0,2,4,8,1,1,0,187,70,0,32,32,0,1432,1426,6,10,10,0,100
53247e195cbcfc07f6a6803563b7562cd285f476,63,191,1890,1699,0,0,0,1,20,76,4,38,4.784816109,6478,10,0,740,896,156,32526,41099,8573,436,530,94,98.38445585
c930a7ab4a4fb78a1cbacd8f8419de3b5dbf1bd7,0,0,0,0,0,0,0,0,0,0,0,0,0,0,11,1,0,0,0,0,0,0,0,0,0,100
ba79b5485622b9de92373d612631d1b96a245287,64,1950,219,1731,17,0,17,2,21,253,4,39,4.812373772,5122,123,0,940,727,213,42543,32467,10076,537,438,99,98.37371753
93095296a16a72986e04a9f720fc8d5a28a181fb,0,0,0,0,0,0,0,0,0,0,0,0,0,0,276,0,0,0,0,0,0,0,0,0,0,100
7bb0007cdab1680548d042f606dc7ee0360130c8,64,208,1939,1731,0,0,0,1,20,78,4,39,4.813114534,6570,276,0,751,915,164,33074,41875,8801,441,536,95,98.37371753
06d971622b6707d37871b0ffea07b71ad1108262,0,0,0,0,0,0,0,0,0,0,0,0,0,0,12,2,0,0,0,0,0,0,0,0,0,100
798c2e840fb4d89a579cbf72d26743618aca143b,64,1950,219,1731,17,0,17,2,21,253,4,39,4.812373772,5122,8,0,940,727,213,42543,32467,10076,537,438,99,98.37371753
dc38466c6415eec3876a19ede84d4f8b6e1ce5b2,2,11,0,11,0,0,0,3,7,852,1,2,0.439496987,246,0,0,44,43,1,1586,1509,77,32,32,0,100
0b9c91b8788e166ff203e342baf1940d4bd3247c,66,208,1950,1742,0,0,0,1,20,81,4,40,4.836977305,6824,277,0,794,959,165,34583,43461,8878,473,568,95,98.37371753
9fbc796bded9469c57e6c577403b90234e4f5b83,0,0,0,0,0,0,0,0,0,0,0,0,0,0,278,1,0,0,0,0,0,0,0,0,0,100
7628ade8810aaaa1e02ec237985f43b63ce285e4,64,1950,219,1731,17,0,17,2,21,253,4,39,4.812373772,5122,280,2,940,727,213,42543,32467,10076,537,438,99,98.37371753
3c46266d8fad3cfedfd8638d450c3dc044d1695c,2,11,0,11,0,0,0,3,7,852,1,2,0.439496987,246,281,3,44,43,1,1586,1509,77,32,32,0,100
1b7abb0a99feb91beafb0b53eba3502b17108cea,0,0,0,0,0,0,0,0,0,0,0,0,0,0,282,4,0,0,0,0,0,0,0,0,0,100
5991e52fe8081453ce3bb3d6179ee03d31ae11ce,2,2,31,29,0,0,0,1,15,812,1,1,0.439496987,710,128,0,106,108,2,4705,4902,197,61,62,1,100
78cc24fc06cb675cc46532a89dd8eab6d767e866,1,1,1,0,0,0,0,4,7,1190,1,1,0,48,0,0,1,1,0,343,343,0,1,1,0,100
5ee33c85036d97349b2b71f1b6d08b49b525c0a0,17,18,18,0,0,0,0,2,7,1262,2,10,4.05881389,1490,0,0,65,65,0,12164,12164,0,57,57,0,100
732a8654c98b8fc8b01d669d3c9ac99657072566,2,5,1,4,0,0,0,6,24,1058,2,2,0.918295834,809,1,1,115,115,0,7200,7160,40,37,37,0,100
52edcd1b7bbb4965957e7942b20379453fc10244,2,21,5,16,0,0,0,3,17,880,1,1,0.619382195,207,2,2,36,28,8,1523,1403,120,10,10,0,100
e256503d3d240158589a3b2271ad4b0d7651d22f,13,1166,1144,22,0,0,0,2,3,2311,1,2,1.891191109,1360,85,0,151,151,0,12665,12642,23,67,67,0,100
6b8ed3361130d16dbb679fa37b10049d7be6b121,0,0,0,0,0,0,0,0,0,0,0,0,0,0,86,1,0,0,0,0,0,0,0,0,0,100
7f4dd3b46d08a0ebf577bf1498e2d1bd6a79a600,0,0,0,0,0,0,0,0,0,0,0,0,0,0,87,2,0,0,0,0,0,0,0,0,0,100
31706c05adfa699fdb092bd1dd563ccd799d3a8c,0,0,0,0,0,0,0,0,0,0,0,0,0,0,88,3,0,0,0,0,0,0,0,0,0,100
eaef3d6ebed34a37778e762ea40507c7490e0742,2,13,11,2,0,0,0,2,4,1389,1,2,0.994984828,399,0,0,66,66,0,2918,2838,80,14,14,0,100
b51453857c75398f024c5a18ea97f904e239442b,0,0,0,0,0,0,0,0,0,0,0,0,0,0,3,3,0,0,0,0,0,0,0,0,0,100
06a828f0806900d0e740a4ca00b83a889044be7d,0,0,0,0,0,0,0,0,0,0,0,0,0,0,4,4,0,0,0,0,0,0,0,0,0,100
c970bb426b9460939e7283e77e2f505b6ba3c9d5,62,5043,4868,175,0,0,0,3,4,2137,1,7,5.183611014,5670,5,5,716,716,0,46110,46052,58,337,337,0,99.94659831
6e919c2e8d20957775ed22410557a4fee83339a4,123,7478,7037,441,0,0,0,2,9,2012,1,16,6.037111919,10278,6,6,1466,1466,0,67451,67295,156,682,682,0,100
68fc0668c7fc30fa0dc4c24da79c979f9500a902,2,2,0,2,0,0,0,6,25,186,2,2,1,813,89,0,115,115,0,7218,7200,18,37,37,0,100
d74a82681e47212885c1d5646f162d1cf5c23593,0,0,0,0,0,0,0,0,0,0,0,0,0,0,90,1,0,0,0,0,0,0,0,0,0,100
3c6b2b7308ecc92e8aed8f3dafd16c31ed615a96,18,135,123,12,0,0,0,2,6,2151,1,8,2.872373979,1176,91,2,178,178,0,6203,6204,1,127,127,0,100
80e2fe40e5042bcb68034b8f15ee9cfd287a2a06,0,0,0,0,0,0,0,0,0,0,0,0,0,0,92,3,0,0,0,0,0,0,0,0,0,100
f4370ac3394595f21d67d35ebd0afa05009712fc,1,1,2,1,0,0,0,4,10,1051,1,1,0,245,93,4,37,37,0,1524,1524,0,14,14,0,100
dba01fbf57f77c1d8773e24dc4a01ca5f238f5b6,1,1,1,0,0,0,0,2,3,1151,1,1,0,209,94,5,33,33,0,1706,1700,6,13,13,0,100
e37349c2f797cfb236f6bddd552e5b6179672d28,0,0,0,0,0,0,0,0,0,0,0,0,0,0,95,0,0,0,0,0,0,0,0,0,0,100
7ac9421c2c27d12ae88f001866b4444310fcaa3f,2,2,2,0,0,0,0,3,3,330,1,1,1,81,96,1,10,10,0,303,303,0,6,6,0,100
d1326e2ad2f3bdd8b995bbc82c9d5abb1106ccfd,30,1286,1010,276,0,0,0,2,9,3112,2,18,3.458056408,3457,0,0,384,409,25,27925,26257,1668,179,200,21,100
b553aeeb05897df2b88a1094f7ab03b8f36b0466,0,0,0,0,0,0,0,0,0,0,0,0,0,0,283,0,0,0,0,0,0,0,0,0,0,100
df0e91de65cf9428f0f735065eba580e37183030,0,0,0,0,0,0,0,0,0,0,0,0,0,0,1,1,0,0,0,0,0,0,0,0,0,100
