CommitID,NMF,TotalAddLines,TotalDeleteLines,LC,FileAdd,FileDelete,NAD,NDEV,NUC,AGE,NS,ND,Entropy,LT,EXP,REXP,CommitComplexity,LastCommitComplexity,CFC,CommitTokenCount,LastCommitTokenCount,NCC,CommitMethodNum,LastCommitMethodNum,NMC,a2a
e3c93472c070613a5406e43de00258fd0f2d63d6,0,0,0,0,0,0,0,0,0,0,0,0,0,0,1,1,0,0,0,0,0,0,0,0,0,100
a105a481165b5dee1f8ac04479d2df69010272ca,0,0,0,0,0,0,0,0,0,0,0,0,0,0,2,2,0,0,0,0,0,0,0,0,0,100
6bd6284ce1f7e551f72246249b125a89a02c9c1c,0,0,0,0,0,0,0,0,0,0,0,0,0,0,3,3,0,0,0,0,0,0,0,0,0,100
c367700f6410beb05e900d5f8f2502ad683b431a,0,0,0,0,0,0,0,0,0,0,0,0,0,0,4,4,0,0,0,0,0,0,0,0,0,100
c501a0d34cf738893cb3777b643a79183f1868c9,0,0,0,0,0,0,0,0,0,0,0,0,0,0,5,5,0,0,0,0,0,0,0,0,0,100
605573324a328cf52b46483ea21a41b9a871c5d5,2,83,0,83,1,0,1,2,2,19,2,2,0.626177654,157,0,0,18,10,8,1015,560,455,14,10,4,98.98989899
8205ad6174ba8d95f31e4a6cf15eb1119bf65852,0,0,0,0,0,0,0,0,0,0,0,0,0,0,1,1,0,0,0,0,0,0,0,0,0,100
a9985f11a77da18f4673fe75ad765f19fd78ff16,3,61,87,26,0,0,0,1,2,26,2,2,1.499642268,304,6,6,24,28,4,1237,1477,240,13,16,3,98.98989899
2eaf6bb3de9f2fce0af5fe0cb85db8876d74de77,0,0,0,0,0,0,0,0,0,0,0,0,0,0,7,3,0,0,0,0,0,0,0,0,0,100
1b2d28be9f5f594806ecf72a9b3d02027c6003db,3,6,6,0,0,0,0,1,2,42,1,3,1.251629167,288,8,4,47,47,0,1901,1901,0,16,16,0,100
ef1660677e64884d76d270ed54844434d4429f90,3,179,4,175,1,0,1,2,3,38,2,2,1.232899371,271,0,0,41,21,20,1786,1103,683,21,15,6,98.98989899
6981b7c0785bd868cf725a024161c6f6553a9802,0,0,0,0,0,0,0,0,0,0,0,0,0,0,9,3,0,0,0,0,0,0,0,0,0,100
0e4e55afa463ce88cf59c5b49c17e48aeb87e69d,4,227,179,48,1,0,1,1,2,9,2,3,1.54870251,403,0,0,66,41,25,2368,1786,582,26,21,5,98
01b86fdda0af558d0841b88842f78bab3ace83d7,4,179,227,48,1,0,1,2,3,30,2,3,1.54870251,445,1,1,41,66,25,1786,2368,582,21,26,5,98
a4f11962ecf50bd58fa1e1b86ae0c489663ed49d,2,161,0,161,1,0,1,2,4,4,2,2,0.666578358,224,2,2,30,13,17,1465,773,692,18,13,5,99.00990099
713cd8b4e893cb2094f7063ff6eff6e246185147,6,257,340,83,1,0,1,2,2,22,2,4,2.136671468,546,1,1,69,60,9,2744,2753,9,29,28,1,97.02970297
f6c3b02a655574a0fae306a321fe986d01ee3d9b,1,22,3,19,0,0,0,1,3,1,1,1,0,174,2,2,45,45,0,1265,1265,0,11,11,0,100
966bd53ad6f315e5d76aace5ad4cd4c211d75478,6,340,276,64,2,0,2,1,4,15,2,4,2.110660686,487,10,1,60,69,9,2753,2744,9,28,29,1,97.02970297
d9ec0137f4e1567f9eb01f2a88b4238c8d59aceb,2,83,0,83,1,0,1,3,6,4,2,2,0.626177654,247,11,2,22,14,8,1283,828,455,18,14,4,99.02912621
0b26cb7f41441f91055ca37382bdb472131244d0,2,272,0,272,1,0,1,2,3,46,2,2,0.307871414,32,12,3,48,2,46,1641,275,1366,14,2,12,99.04761905
0e534bc08dca50126de012657cc22820edb17f69,6,47,432,385,0,0,0,1,4,6,2,3,2.394151231,755,3,3,72,111,39,2500,4198,1698,31,41,10,97.08737864
a7d4a33f4e85f992708750ee990540480b42bdf1,5,423,4,419,3,0,3,3,6,17,2,2,2.129806314,271,13,4,66,21,45,2933,1103,1830,30,15,15,97.08737864
6d101c64adab2a1539c07320c6bb9be07060ee9e,1,9,43,34,0,0,0,1,3,1,1,1,0,204,13,4,45,51,6,1265,1397,132,11,16,5,100
61f6d111c802345affdc2acf40624383773f79e3,1,43,9,34,0,0,0,1,4,0,1,1,0,174,15,6,51,45,6,1397,1265,132,16,11,5,100
81f8e0eb32151e7082400826ca2e29330641689e,6,33,460,427,0,0,0,1,5,6,2,3,2.41264848,785,4,4,70,117,47,2471,4330,1859,29,46,17,97.08737864
7c9389bdfbfea6084d09558f463e2862de279bec,5,423,4,419,3,0,3,3,6,17,2,2,2.129806314,271,16,7,66,21,45,2933,1103,1830,30,15,15,97.08737864
0b2901a28d09bdcea7cc31d8fec837562585877e,1,2,2,0,0,0,0,2,6,1,1,1,0,198,17,8,49,49,0,1377,1368,9,14,14,0,100
04d7eb13b3f5f9da3a20e9338c836c45f5e37239,1,96,42,54,0,0,0,1,2,98,1,1,0,238,18,9,40,30,10,1668,1520,148,9,6,3,100
abffeeb65147865b5bc7c7754e075a7945f9ffd8,1,5,4,1,0,0,0,1,3,54,1,1,0,126,19,10,16,16,0,882,862,20,7,7,0,100
dc73d92d6e1e2a1a3e62285f31f905f0552f177f,1,52,28,24,0,0,0,1,2,98,1,1,0,96,20,11,16,15,1,707,668,39,8,5,3,100
25f750a1b5ab06cecc605618ef4a44173639db41,2,23,57,34,0,0,0,1,4,29,1,2,0.790858091,189,21,12,20,23,3,982,1296,314,8,10,2,100
be7730dda2a00d33970465b1ee4c4f2f619b6bd1,0,0,0,0,0,0,0,0,0,0,0,0,0,0,22,13,0,0,0,0,0,0,0,0,0,100
518454fb90696a1664623d12e6ba6448b55202cb,0,0,0,0,0,0,0,0,0,0,0,0,0,0,23,0,0,0,0,0,0,0,0,0,0,100
c95f5362a537098a617bb7f2e9a2af799df52a14,0,0,0,0,0,0,0,0,0,0,0,0,0,0,24,1,0,0,0,0,0,0,0,0,0,100
944521956fc99f9ae1872ca692fdc85e02c28f47,0,0,0,0,0,0,0,0,0,0,0,0,0,0,25,2,0,0,0,0,0,0,0,0,0,100
08072e6057b8146143b47ab0c4443ae81563611c,1,37,61,24,0,0,0,1,3,216,1,1,0,120,26,0,15,16,1,668,707,39,5,8,3,100
96d96dfbb04329b92e71d9c70ee55a7b68bcc29a,0,0,0,0,0,0,0,0,0,0,0,0,0,0,27,1,0,0,0,0,0,0,0,0,0,100
c02e2afff16c53157a0b14e087a7932a2fa66b85,2,41,0,41,0,0,0,2,4,113,2,2,0.964956767,138,28,2,26,18,8,1278,1044,234,9,8,1,100
98edc8ad24a164161c20c325478f81cef4a6e04c,7,198,40,158,2,0,2,2,7,121,2,3,2.481704692,538,29,3,122,103,19,4481,3613,868,45,37,8,97.68518519
0b14bdfde1b8702177025014aa1bbaa3fd500b37,3,93,9,84,0,0,0,2,8,0,2,2,1.231374529,350,30,4,72,68,4,2846,2592,254,27,25,2,100
c9d07de47c307bdc9e448787aa1c86c03ca6f8fb,6,68,21,47,0,0,0,1,9,98,1,1,1.971901082,561,31,5,104,104,0,3615,3615,0,34,34,0,100
a78f37e8828574ec4c4a475ec6c2a9b355421d13,0,0,0,0,0,0,0,0,0,0,0,0,0,0,32,6,0,0,0,0,0,0,0,0,0,100
85f22d87f66d068ae7a59b30eafc15c3584d8d11,0,0,0,0,0,0,0,0,0,0,0,0,0,0,33,7,0,0,0,0,0,0,0,0,0,100
44fae61fc018c58bfab41ee9061ca8ab1e3aec3a,0,0,0,0,0,0,0,0,0,0,0,0,0,0,34,0,0,0,0,0,0,0,0,0,0,100
1609d33e3de0d9d97a82eb9285ff47743bd0bbe6,0,0,0,0,0,0,0,0,0,0,0,0,0,0,35,1,0,0,0,0,0,0,0,0,0,100
2699e4a0406339ccca0abd55abc868cd174470b4,0,0,0,0,0,0,0,0,0,0,0,0,0,0,36,2,0,0,0,0,0,0,0,0,0,100
70ce599d031f5f899137a07dc019e2500568f492,0,0,0,0,0,0,0,0,0,0,0,0,0,0,37,3,0,0,0,0,0,0,0,0,0,100
9cb66fa2b626c100c3f583bbf30458a2cb794835,0,0,0,0,0,0,0,0,0,0,0,0,0,0,38,4,0,0,0,0,0,0,0,0,0,100
184930d2f26c4c1e38d970b0902d1130b485cbd1,0,0,0,0,0,0,0,0,0,0,0,0,0,0,39,5,0,0,0,0,0,0,0,0,0,100
96680bd981dd79acf75a97b942dc97a1783d9e86,0,0,0,0,0,0,0,0,0,0,0,0,0,0,40,6,0,0,0,0,0,0,0,0,0,100
f48b5d399f5f1d604b430a59bc1b2143141e8ce9,0,0,0,0,0,0,0,0,0,0,0,0,0,0,41,7,0,0,0,0,0,0,0,0,0,100
d063937519f6365958e26a1750dfdd30686613ff,0,0,0,0,0,0,0,0,0,0,0,0,0,0,42,8,0,0,0,0,0,0,0,0,0,100
8af67576c9221d4adaf6b316bc5a30816470600f,0,0,0,0,0,0,0,0,0,0,0,0,0,0,43,9,0,0,0,0,0,0,0,0,0,100
f3e8af44de6bb1268b17e3acbdb22dfb68f9f39c,0,0,0,0,0,0,0,0,0,0,0,0,0,0,44,10,0,0,0,0,0,0,0,0,0,100
b8dc70888611d5850b1cce5fa7e28cf76f92cfdb,4,189,22,167,0,0,0,1,3,461,2,4,1.292162778,961,45,0,167,138,29,6453,5814,639,66,58,8,100
850ba2d40fd45d8d0811bd42051977defed10acf,2,69,0,69,1,0,1,2,6,155,2,2,0.996208884,124,46,0,17,12,5,1602,1077,525,12,9,3,96.875
ac7f823e214b255297b625cae47f9aefde9d6ff0,2,59,23,36,0,0,0,2,7,0,2,2,0.839004061,177,47,1,23,17,6,1642,1602,40,13,12,1,100
e7dd686f6637bc890b99aaee2e1cf495b7a2e2b0,0,0,0,0,0,0,0,0,0,0,0,0,0,0,48,2,0,0,0,0,0,0,0,0,0,100
8906856b163115c650fd993ed13d2f0f3e29dbe1,2,38,5,33,0,0,0,2,8,2,2,2,0.446481347,197,49,3,27,23,4,1780,1642,138,14,13,1,100
1da8dbbb58b21d188310d9bbf5d3df5fc3ae391c,1,9,1,8,0,0,0,2,3,636,1,1,0,93,50,0,15,14,1,534,507,27,5,5,0,100
635106ce7f3ea22a6f4b1c06931736dca20bae4a,2,3,11,8,0,0,0,1,4,143,1,2,0.863120569,437,50,0,65,66,1,2385,2416,31,14,14,0,100
6fcb8f869d5bef2cdbe924c32e845765253234bf,1,9,1,8,0,0,0,2,3,636,1,1,0,93,52,1,15,14,1,534,507,27,5,5,0,100
f913a3442808f47bc6b6e536cb18cccfcc555db2,0,0,0,0,0,0,0,0,0,0,0,0,0,0,53,0,0,0,0,0,0,0,0,0,0,100
53ec13942a8abdce338e6a07f62769b736fee147,3,239,16,223,0,0,0,2,10,514,2,2,0.843239043,425,54,1,101,82,19,4827,3243,1584,42,28,14,99.56140351
6cc6f2fae471f3542de98ffd2aa4a9505eb17de7,0,0,0,0,0,0,0,0,0,0,0,0,0,0,55,2,0,0,0,0,0,0,0,0,0,100
7af1c284400a0465210b1e1be4dfd0deae56ee7f,0,0,0,0,0,0,0,0,0,0,0,0,0,0,56,3,0,0,0,0,0,0,0,0,0,100
33fdc32352879fe577c06381e70bfe98370ef23a,0,0,0,0,0,0,0,0,0,0,0,0,0,0,56,3,0,0,0,0,0,0,0,0,0,100
7399e12b1e98ccd89ee16beeab0da748e22e61d3,0,0,0,0,0,0,0,0,0,0,0,0,0,0,58,5,0,0,0,0,0,0,0,0,0,100
1bed9a5edec65ebe46dfc54d0c0aa30640c78f75,0,0,0,0,0,0,0,0,0,0,0,0,0,0,59,0,0,0,0,0,0,0,0,0,0,100
eaa03e94e58016a5bf1e8fcc7b1c41d1635c7d09,0,0,0,0,0,0,0,0,0,0,0,0,0,0,60,1,0,0,0,0,0,0,0,0,0,100
5a6fb815e21455c05a848f4c22b187c6ecb63f90,2,17,53,36,0,0,0,2,7,1083,1,2,0.749595257,320,0,0,20,20,0,1178,1287,109,19,19,0,100
0c53ba762dd3e10a6ac31c2430b126720bb7e5fe,6,1824,0,1824,6,0,6,1,1,0,2,2,2.495961976,0,0,0,290,0,290,10061,0,10061,81,0,81,95
a617a14589da166591b6b90d7ba13d4945f6f9d9,1,2,2,0,0,0,0,1,2,2,1,1,0,290,1,1,60,60,0,2077,2077,0,16,16,0,100
422d53cf2926b8e9b9d024b8bf1d4dc939b627fa,2,47,0,47,0,0,0,1,3,1,2,2,0.903453555,356,2,2,67,65,2,2811,2662,149,23,21,2,100
5e4706bbacae8bd88c53617c7481b8f8ee7d1af8,6,85,33,52,0,0,0,1,4,6,2,2,2.509742713,1486,3,3,294,292,2,10554,10210,344,85,83,2,100
e4f4a3bb1cb129d065e7947e0c81837f64ce318a,0,0,0,0,0,0,0,0,0,0,0,0,0,0,0,0,0,0,0,0,0,0,0,0,0,100
0d99577f3da8f9f4114292c317eede66aceb3a89,0,0,0,0,0,0,0,0,0,0,0,0,0,0,1,1,0,0,0,0,0,0,0,0,0,100
3e96d0cd52a5ed8ac2c3dd8da87c6ce16cc22cac,10,155,10,145,0,0,0,2,5,366,1,2,3.317019765,1684,2,2,329,329,0,11250,11250,0,88,88,0,100
f60cf6b5dee6b5cf4cd34ea177e99137d5616c81,0,0,0,0,0,0,0,0,0,0,0,0,0,0,3,3,0,0,0,0,0,0,0,0,0,100
b1eff33e1d7af2d19226e8e84e8b4587c55731be,0,0,0,0,0,0,0,0,0,0,0,0,0,0,61,0,0,0,0,0,0,0,0,0,0,100
1b92a66a8512d0692d3b48510971895ec259c51d,1,8,6,2,0,0,0,2,5,1078,1,1,0,116,4,3,15,15,0,707,707,0,6,6,0,100
756788b8ac1ff47e010fbcb420c9854527601116,1,24,28,4,0,0,0,3,4,25,1,1,0,61,5,4,4,5,1,137,275,138,2,2,0,99.6031746
31803724cd0d0e9e1c7647cde39a33e7e13c9dfc,1,2,2,0,0,0,0,3,5,0,1,1,0,41,6,5,4,4,0,137,137,0,2,2,0,100
a1f69ecc57c038fa21ce0f74d23ce4dac982186f,2,111,1,110,1,0,1,1,4,305,1,2,0.371232327,162,62,1,37,31,6,1537,1034,503,18,13,5,99.21259843
550b582c5605245696ae7aabb850be5bec4dae08,1,7,0,7,0,0,0,1,2,6,1,1,0,80,63,2,5,5,0,467,467,0,4,4,0,100
cf1e3d7dccabc0955bbc2c33520b0aa680dbaf83,5,219,140,79,1,0,1,0,8,154,2,4,2.001446818,567,4,0,73,67,6,3253,2886,367,41,38,3,97.27626459
517356e7f3e2ef30e7ab42a5af12eed8a91a9adc,0,0,0,0,0,0,0,0,0,0,0,0,0,0,1,0,0,0,0,0,0,0,0,0,0,100
65e5512c609f7c81c97303c1fa875cf66de24fbd,2,6,1,5,0,0,0,2,5,10,1,1,0.863120569,203,7,3,26,26,0,1071,1071,0,12,12,0,100
02d8b2e549a1c01e7e9fd2bea9e8249c7b4e7e69,0,0,0,0,0,0,0,0,0,0,0,0,0,0,8,4,0,0,0,0,0,0,0,0,0,100
dd63ca0683eacab9798cdb8fe984a603528ac1cd,0,0,0,0,0,0,0,0,0,0,0,0,0,0,9,5,0,0,0,0,0,0,0,0,0,100
4ebc93ca45438db92982a9bfa19e73948cfab4ce,0,0,0,0,0,0,0,0,0,0,0,0,0,0,62,0,0,0,0,0,0,0,0,0,0,100
2e6dc57d9a34f9e26f4b707840cbbff5fbb000dc,0,0,0,0,0,0,0,0,0,0,0,0,0,0,63,1,0,0,0,0,0,0,0,0,0,100
d9bd10cf8dde070661ab2d07c06d30198a753578,0,0,0,0,0,0,0,0,0,0,0,0,0,0,64,2,0,0,0,0,0,0,0,0,0,100
ae3330d92b44959333f6fe9dead6537de2266cf2,1,1,1,0,0,0,0,3,6,195,1,1,0,308,65,3,60,60,0,2099,2099,0,16,16,0,100
f26e47c8239427845d9997ae815344fd5c86229a,0,0,0,0,0,0,0,0,0,0,0,0,0,0,66,4,0,0,0,0,0,0,0,0,0,100
08301f4ff5b6b1c716e8d92ef2be3f7631aa4acd,0,0,0,0,0,0,0,0,0,0,0,0,0,0,0,0,0,0,0,0,0,0,0,0,0,100
dc33e0b70be7bfe17056faeec016b2e8d70d74af,0,0,0,0,0,0,0,0,0,0,0,0,0,0,1,1,0,0,0,0,0,0,0,0,0,100
39f7674ee9b56315cfc00f0a8c7c82b2e0dc8af2,8,60,263,203,0,0,0,2,7,691,2,6,2.268398479,1022,4,0,118,130,12,4858,5623,765,48,56,8,97.64705882
df85e7196f0629abeea4a82dbfc5f9bb7729956b,6,256,57,199,1,0,1,5,8,222,2,4,2.084622956,805,67,0,121,110,11,5162,4430,732,52,44,8,97.64705882
50e827665090fc08d5764322c4d665a4e895ad94,2,33,13,20,0,0,0,3,3,721,2,2,0.965636133,130,0,0,20,17,3,867,695,172,9,8,1,98.84169884
4957df689048a9d9e44628e2b12c0c7771346810,0,0,0,0,0,0,0,0,0,0,0,0,0,0,68,1,0,0,0,0,0,0,0,0,0,100
784977d4216e306c346ed3a2bd8956814e5c5de4,0,0,0,0,0,0,0,0,0,0,0,0,0,0,0,0,0,0,0,0,0,0,0,0,0,100
0dffc6f121c552d0146e2366b783077ca899be6e,0,0,0,0,0,0,0,0,0,0,0,0,0,0,69,2,0,0,0,0,0,0,0,0,0,100
5dcd1a771c8cd79485af86c60bd0acba81c7ea94,5,69,38,31,0,0,0,1,5,280,2,4,1.8837183,583,0,0,104,100,4,3797,3676,121,30,30,0,98.84169884
e20dac78e4127e262ed02b72266fcf41ae56cbaf,1,3,3,0,0,0,0,2,4,0,1,1,0,114,1,1,21,21,0,749,753,4,5,5,0,100
48516733d1ec9a70223a73d551d099c6a732881a,1,2,2,0,0,0,0,2,5,0,1,1,0,114,2,2,21,21,0,749,749,0,5,5,0,100
a459cc7c4360b727e254015b66603ebdc933b787,4,38,22,16,0,0,0,3,6,760,2,3,1.595000038,490,70,2,85,83,2,3183,3044,139,26,25,1,98.84169884
fb76eccaf1aaf84ef4ff03186c713e6e3d104069,4,21,84,63,0,0,0,1,2,11,2,3,1.783015904,309,67,0,38,46,8,1438,1833,395,13,15,2,98.84169884
2322b5df5a9e5560fe13b0448ee1e942c4c15491,4,84,21,63,0,0,0,3,5,712,2,3,1.783015904,262,72,4,46,38,8,1833,1438,395,15,13,2,98.84169884
e7215753f993e8399936d80807b8caeba1bd1ff6,0,0,0,0,0,0,0,0,0,0,0,0,0,0,73,5,0,0,0,0,0,0,0,0,0,100
5a7d69af9fd905da92ed0666a9f52a43de31ec6a,0,0,0,0,0,0,0,0,0,0,0,0,0,0,74,6,0,0,0,0,0,0,0,0,0,100
3762d57fd0e73875ee22f52ff4df5a08e92e1d1b,2,27,1,26,0,0,0,5,9,272,2,2,0.591672779,374,5,0,32,31,1,1815,1736,79,25,24,1,100
88a240d7d12b401c2120477fb223339ec7920fa0,0,0,0,0,0,0,0,0,0,0,0,0,0,0,5,0,0,0,0,0,0,0,0,0,0,100
8c3566c16887e203484828dca2199e25c40a3777,0,0,0,0,0,0,0,0,0,0,0,0,0,0,7,2,0,0,0,0,0,0,0,0,0,100
3abab0b1d45fed1ad066b224e94ec44054c30092,1,6,6,0,0,0,0,5,10,0,1,1,0,280,8,3,17,17,0,1209,1209,0,17,17,0,100
833a553fcaf3a760205fa26a7db51ce287dad333,0,0,0,0,0,0,0,0,0,0,0,0,0,0,75,7,0,0,0,0,0,0,0,0,0,100
dd16fce7c3c6b76a845f30db10e9c036ad1a5ebb,3,410,74,336,2,0,2,5,11,1,2,2,1.57915899,280,3,0,58,17,41,2491,1209,1282,28,17,11,97.33840304
f0112a819594ad89725f209a8a9b182c3f3c5b30,3,74,410,336,0,0,0,5,10,0,2,2,1.57915899,507,76,6,17,58,41,1209,2491,1282,17,28,11,97.33840304
3d23580ef2447e44cbe03825f7b5ea8f159c389a,0,0,0,0,0,0,0,0,0,0,0,0,0,0,77,7,0,0,0,0,0,0,0,0,0,100
89bbc3f8f8d00899383f157d62d4c30169f5f112,3,410,74,336,2,0,2,5,11,1,2,2,1.57915899,280,4,1,58,17,41,2491,1209,1282,28,17,11,97.33840304
716c183959f7b49f2491364ff392a501e0bf39a5,2,119,72,47,0,0,0,5,12,2,2,2,0.978358512,400,5,2,46,40,6,2179,1809,370,26,24,2,98.87640449
1cce20f4ac8c01037a4c5d262f3ca9a6c5a0de8b,0,0,0,0,0,0,0,0,0,0,0,0,0,0,78,8,0,0,0,0,0,0,0,0,0,100
75a1c069a052d899482d789b80b2f4f49f1682c0,0,0,0,0,0,0,0,0,0,0,0,0,0,0,79,9,0,0,0,0,0,0,0,0,0,100
e3a84da3221273ef7843cb0a2573130a49262d21,2,118,1,117,1,0,1,1,4,308,1,2,0.355488678,162,82,10,37,31,6,1537,1034,503,18,13,5,99.25925926
973a7f6d6d9069f9f35b00a3d53b3f6854f082f8,2,8,119,111,0,0,0,0,4,494,1,2,0.546321213,247,80,0,32,37,5,1080,1537,457,13,18,5,99.25925926
6d516bf5ac4c6a6495b5907519fbe9b42703ee0a,0,0,0,0,0,0,0,0,0,0,0,0,0,0,2,0,0,0,0,0,0,0,0,0,0,100
e2311f959b1505e73a66361f4e0df355ab810a39,0,0,0,0,0,0,0,0,0,0,0,0,0,0,81,1,0,0,0,0,0,0,0,0,0,100
b1a0f8ec236ab98ff455bc7e398f8edc80defc23,0,0,0,0,0,0,0,0,0,0,0,0,0,0,82,2,0,0,0,0,0,0,0,0,0,100
1f48f56b4d7f3feb2fd977fb6e6b842061806a8f,2,118,1,117,1,0,1,1,6,13,1,2,0.355488678,168,86,3,38,32,6,1583,1080,503,18,13,5,99.25925926
2ddace090c8fa1c0ea584bb1eb511c3043ce6341,1,9,0,9,0,0,0,1,7,0,1,1,0,173,87,4,34,33,1,1178,1116,62,15,14,1,100
f49eafd012bb80e7a08ab4a69da83e3370986352,1,10,4,6,0,0,0,1,8,0,1,1,0,181,88,5,35,34,1,1222,1178,44,16,15,1,100
b2c4538dccb50bc614f35621b0ab30ff0a695946,2,4,136,132,0,0,0,0,4,494,1,2,0.735985802,267,83,3,32,40,8,1080,1689,609,13,20,7,99.25925926
8cc1997f7e3004d294add3c7f8ab446807e10001,0,0,0,0,0,0,0,0,0,0,0,0,0,0,84,4,0,0,0,0,0,0,0,0,0,100
ceb8779bc3deaad6ae971a33c30024830a62ec55,0,0,0,0,0,0,0,0,0,0,0,0,0,0,3,1,0,0,0,0,0,0,0,0,0,100
582dbbf4552d7c90a8503329d60dda4c238a0d51,0,0,0,0,0,0,0,0,0,0,0,0,0,0,85,5,0,0,0,0,0,0,0,0,0,100
5267560b90ae463aa8c8c70c70c19ef789b1b032,1,18,3,15,0,0,0,1,9,2,1,1,0,168,89,6,34,32,2,1186,1080,106,15,13,2,100
02fcf40bb51908af3bac075d47309328d71cd7ae,0,0,0,0,0,0,0,0,0,0,0,0,0,0,90,7,0,0,0,0,0,0,0,0,0,100
061e006d6f50b044f0cbe6d4f06476f0674044a0,0,0,0,0,0,0,0,0,0,0,0,0,0,0,94,11,0,0,0,0,0,0,0,0,0,100
3f7f08255b15e96773e2d095fa65551ab64687e8,1,3,18,15,0,0,0,1,4,989,1,1,0,182,86,6,32,34,2,1080,1186,106,13,15,2,100
3fa0932eb99b6767bacc1151f41aac6c7a531205,1,18,3,15,0,0,0,1,9,2,1,1,0,168,96,13,34,32,2,1186,1080,106,15,13,2,100
88d5b3fed18508764c353dd17e9973656247cbed,0,0,0,0,0,0,0,0,0,0,0,0,0,0,97,14,0,0,0,0,0,0,0,0,0,100
198fad06d631b543ccc2ff4a5273fef997beb794,0,0,0,0,0,0,0,0,0,0,0,0,0,0,98,15,0,0,0,0,0,0,0,0,0,100
0aaf90211862f8a72b6a1bee4fd3f1c91964f8a3,2,12,6,6,0,0,0,6,13,163,2,2,0.503258335,424,0,0,36,36,0,1995,1952,43,29,29,0,100
b17612ed42b66ce76a3e9529902439d18f4600fd,0,0,0,0,0,0,0,0,0,0,0,0,0,0,99,0,0,0,0,0,0,0,0,0,0,100
bce41b901d19b3c2b62f259a6f8822b6524d0a56,1,1,3,2,0,0,0,5,8,0,1,1,0,116,100,1,15,15,0,590,614,24,8,8,0,100
23bf98b1b00223213ede5076f14e6b64bb816e81,0,0,0,0,0,0,0,0,0,0,0,0,0,0,4,0,0,0,0,0,0,0,0,0,0,100
cb073e3b881aaaa2951e9bdb15f9a952466e7807,0,0,0,0,0,0,0,0,0,0,0,0,0,0,5,1,0,0,0,0,0,0,0,0,0,100
165565441c157570fcc89e4eeccb15f74ab089a5,0,0,0,0,0,0,0,0,0,0,0,0,0,0,101,2,0,0,0,0,0,0,0,0,0,100
eaa18e9594f8a15af0d375d251ece7323c68a5bd,0,0,0,0,0,0,0,0,0,0,0,0,0,0,102,3,0,0,0,0,0,0,0,0,0,100
c95a03451002413e6dbbfe00ed1841a4e6528668,1,1,1,0,0,0,0,2,10,722,1,1,0,294,103,4,28,28,0,2776,2776,0,24,24,0,100
44b04835651db07b9b0b7bf6546f3bbe294a029c,1,1,1,0,0,0,0,2,11,0,1,1,0,294,104,5,28,28,0,2776,2776,0,24,24,0,100
e21cb1458baf8abc2c17ad055b7fe96ba29f8a08,0,0,0,0,0,0,0,0,0,0,0,0,0,0,102,3,0,0,0,0,0,0,0,0,0,100
d0c1bb5e3bf63ebd28ad8e254a06a6a1daf4c104,1,1,1,0,0,0,0,1,2,1754,1,1,0,38,103,0,3,3,0,116,116,0,1,1,0,100
91c8c751941b7060f6d5b66caef1e5897914e937,0,0,0,0,0,0,0,0,0,0,0,0,0,0,9,0,0,0,0,0,0,0,0,0,0,100
1fd48810b6d8d05a9057e71392d32160b9b96bf4,0,0,0,0,0,0,0,0,0,0,0,0,0,0,104,0,0,0,0,0,0,0,0,0,0,100
2341fd52d58d66b62461eb4c6261884b0e9c0b32,1,2,3,1,0,0,0,3,11,979,1,1,0,267,0,0,64,64,0,1842,1838,4,17,17,0,100
3b830d24ee9f008b6df18c54b83ce7856a2dadbf,1,14,2,12,0,0,0,4,12,0,1,1,0,266,6,0,66,64,2,1892,1842,50,17,17,0,100
e6fa1db0ebd5e20da2dff6da3fc8fab12970b5d6,1,1,1,0,0,0,0,2,3,449,1,1,0,134,105,1,25,25,0,833,833,0,5,5,0,100
6aa8fba660b881a9934f91d6e85930057be0e021,2,137,5,132,0,0,0,6,14,370,2,2,0.816811428,419,106,2,51,39,12,2747,2063,684,29,25,4,99.62686567
d063733891ab48169a5f5419e427e8eda2409372,7,571,151,420,3,0,3,6,14,129,2,4,1.971147296,950,6,0,233,142,91,8074,5472,2602,89,51,38,97.09090909
657af7cbca4b23c03e2319d72cce8e379206a9c4,4,151,8,143,0,0,0,6,16,225,2,3,1.275900394,830,7,1,143,129,14,5513,4775,738,52,48,4,99.64539007
b7fc061f6759fae79c09e32de811fb040297b01e,1,1,1,0,0,0,0,1,2,0,1,1,0,179,8,2,63,63,0,1619,1619,0,28,28,0,100
98e7ae283280738a0097eaa74786af83b7d3b1d9,0,0,0,0,0,0,0,0,0,0,0,0,0,0,107,3,0,0,0,0,0,0,0,0,0,100
c9b4f76181c1ee892442969cc9d28537b6eba65e,7,188,594,406,2,0,2,1,15,0,2,5,2.160015981,934,10,1,63,160,97,3414,6166,2752,33,69,36,94.62365591
2e288ea53f03d6feb681b1860cf9a4bbee8f0380,4,563,0,563,3,0,3,6,18,0,2,3,1.302898003,387,11,2,133,28,105,5251,1911,3340,62,20,42,97.52650177
f5ad41c4152a67bd8e68556d23b1daebb8cf4602,1,0,20,20,0,0,0,1,2,0,1,1,0,101,12,3,4,5,1,385,484,99,4,5,1,100
737a808f8caf15efa6b7f3db1537176fc97c3579,4,31,168,137,0,0,0,0,16,112,2,4,1.547749859,645,111,4,56,63,7,2867,3356,489,28,33,5,97.2027972
bfc42c39c9ce82904fc3d533e10abd014240527a,2,177,0,177,2,0,2,1,1,0,2,2,0.989822056,0,112,5,22,0,22,796,0,796,5,0,5,98.6013986
3d14d30c6c078ea03d8d43f3c0909509827972e6,1,26,0,26,0,0,0,1,2,0,1,1,0,61,113,6,14,10,4,549,408,141,4,3,1,100
4a4c8987edc19209b0ef660652c9372272051682,0,0,0,0,0,0,0,0,0,0,0,0,0,0,114,7,0,0,0,0,0,0,0,0,0,100
c622215f072d47966dbc3273866260b54d75aea2,1,2,2,0,0,0,0,1,2,0,1,1,0,62,115,8,13,12,1,388,388,0,2,2,0,100
f0ad8d22cef3ee1bca1ca87b634a0f7395d366f1,0,0,0,0,0,0,0,0,0,0,0,0,0,0,0,0,0,0,0,0,0,0,0,0,0,100
cd3f9bf939e98683918be0d969b63b81d76945cc,8,293,16,277,4,0,4,1,10,525,2,3,2.781924426,368,116,9,69,56,13,3226,2173,1053,32,25,7,95.66666667
3c311e6409eccaae6ab5b514b8696c956910e470,2,12,12,0,0,0,0,1,4,12,1,1,0.918295834,140,117,10,16,16,0,790,790,0,6,6,0,100
b8da295ceea5d1054ed8726558b0be891f06d096,8,16,293,277,0,0,0,1,9,0,2,3,2.781924426,504,116,9,56,69,13,2173,3226,1053,25,32,7,95.66666667
1cb8e7c0dd33188429537730fc691b24e9695090,8,293,16,277,4,0,4,1,10,286,2,3,2.781924426,368,119,12,69,56,13,3226,2173,1053,32,25,7,95.66666667
155f3576b13a8643e0607a9df80420070946a3e4,0,0,0,0,0,0,0,0,0,0,0,0,0,0,120,13,0,0,0,0,0,0,0,0,0,100
47af62730405fe4ef940388b9fccb822cb704024,0,0,0,0,0,0,0,0,0,0,0,0,0,0,121,14,0,0,0,0,0,0,0,0,0,100
9f1733e329cdcc689d8b530a4de39c94892063e1,0,0,0,0,0,0,0,0,0,0,0,0,0,0,122,15,0,0,0,0,0,0,0,0,0,100
a2e03ac32f2e50320466642593c43794cd97a39b,0,0,0,0,0,0,0,0,0,0,0,0,0,0,123,16,0,0,0,0,0,0,0,0,0,100
b76e054506899e1076c2e2354147be47979554bd,2,127,26,101,0,0,0,1,6,1354,2,2,0.626751137,174,124,17,25,18,7,1670,1135,535,8,7,1,99.67741935
d529d50de7a049b1d4f27c957ca6ab664efa31c7,14,210,451,241,2,0,2,1,18,77,3,8,3.434405219,1295,13,3,137,150,13,6664,7763,1099,65,68,3,92.76315789
c6ba27510aa08556b64a338683beff34b2a447b6,5,456,31,425,3,0,3,1,3,10,2,2,1.907925238,114,14,4,73,9,64,2419,571,1848,40,7,33,97.70491803
6ce949f5051189fcce1d93837d66f0b16ed63ebd,0,0,0,0,0,0,0,0,0,0,0,0,0,0,117,9,0,0,0,0,0,0,0,0,0,100
b9712f97099702f766e648ce1a8153fb1980c1fa,0,0,0,0,0,0,0,0,0,0,0,0,0,0,118,10,0,0,0,0,0,0,0,0,0,100
8069d44c00cd301a89c83e423712ce9d6c390988,17,463,635,172,4,0,4,1,16,322,3,9,3.566163542,1529,125,17,150,201,51,7763,8512,749,68,98,30,91.31832797
65956bb75761fcd27bbb909b0fdf9410d84e946e,7,593,31,562,5,0,5,1,18,6,2,3,2.256347633,551,128,20,127,56,71,5204,2867,2337,66,28,38,95.3271028
5891af60230b9b7e7d09db59f3af44e9b157bc17,6,218,184,34,0,0,0,1,10,1221,2,3,2.117999109,646,129,21,43,58,15,4390,4976,586,38,43,5,98.18181818
2bbd43627534055e564704026914afbd53d280c5,7,154,10,144,0,0,0,2,11,1470,1,7,2.555059682,564,130,22,45,45,0,4602,4500,102,35,35,0,98.7804878
f7ee99d3778fdb0d4c082a8ce9d1324cc1ce8c33,2,3,3,0,0,0,0,1,1,0,2,2,0.918295834,78,131,23,7,6,1,399,470,71,3,2,1,97.56097561
f73e26e142c27a47bbaa4d79242ab07065d670ba,1,79,5,74,0,0,0,2,4,3,1,1,0,139,132,24,6,6,0,567,528,39,5,5,0,98.1595092
e3af540a390ca4ec1e5cb396ced4fac2f81af915,0,0,0,0,0,0,0,0,0,0,0,0,0,0,133,25,0,0,0,0,0,0,0,0,0,100
c72471079f25e5df533ff1ce3668da7ccad319ae,4,184,37,147,0,0,0,2,13,616,2,2,1.369083081,705,133,25,124,115,9,5900,5337,563,51,46,5,100
bf69db8b6b3112e73782ee4fd7124670121c8933,0,0,0,0,0,0,0,0,0,0,0,0,0,0,135,27,0,0,0,0,0,0,0,0,0,100
cab1187ad600bccce8a01ec0ce65f79a8c439bad,0,0,0,0,0,0,0,0,0,0,0,0,0,0,136,28,0,0,0,0,0,0,0,0,0,100
af34cdbea869a6e5b98d25406bb34d364b443be2,1,1,1,0,0,0,0,2,3,3,1,1,0,49,137,29,7,7,0,324,324,0,4,4,0,100
ba93c32c76769f016666161613577e74e42bba89,0,0,0,0,0,0,0,0,0,0,0,0,0,0,138,30,0,0,0,0,0,0,0,0,0,100
db8f5193d3f4da8777b698c9181fef8d6d78b1ff,2,5,5,0,0,0,0,1,3,0,1,1,0.970950594,286,139,31,28,28,0,2097,2093,4,14,14,0,98.7654321
4cb1ea85c37e1efccba292aef39527c56ccbecb0,4,7,7,0,0,0,0,1,1,0,2,2,1.664497779,246,140,32,29,16,13,1281,1540,259,11,16,5,95.0617284
f3a9aa27c6820d7aa76be24f029a90aac241979b,2,0,138,138,0,0,0,6,19,956,2,2,0.558629373,483,141,33,28,43,15,1903,2458,555,20,24,4,99.37888199
2f57ff54e5f3935203b6d674d6050dd770cb5f8b,10,157,19,138,1,0,1,1,18,588,2,8,1.763892718,1012,134,25,113,173,60,6388,11544,5156,55,103,48,91.92546584
6133485669d18ede7f934e23a7afdce8a03e0f79,9,13,151,138,0,0,0,1,19,212,2,6,1.507580684,1064,143,34,92,76,16,5605,5358,247,49,49,0,93.16770186
fe571933faad13bc6322b5e141af7bf7fbe249a1,2,56,67,11,0,0,0,1,3,15,1,2,0.996134484,153,144,35,8,8,0,1010,1064,54,3,3,0,99.37106918
d1fec7815725d3ed531fef62140fda2e41b2f36e,1,3,3,0,0,0,0,1,4,0,1,1,0,145,145,36,8,8,0,1010,1010,0,3,3,0,100
8775946c9e6dbc4f92695f120b1a5d0f4da69b68,0,0,0,0,0,0,0,0,0,0,0,0,0,0,146,36,0,0,0,0,0,0,0,0,0,100
02670b7db4187ca508dc64d64ffb3f1e788a0294,10,130,0,130,0,0,0,2,7,25,1,4,3.083906275,1025,147,37,227,227,0,7171,7171,0,89,89,0,100
7951ac1462c4f2d1a9bbe718663a7252865ef1d8,8,105,27,78,1,0,1,2,20,253,2,4,1.92215846,896,9,0,144,144,0,5632,5468,164,64,62,2,96.85534591
93419183bef67e9e9716884c6fe54436cc1b2588,9,30,107,77,0,0,0,1,19,421,2,5,2.077997429,1024,15,2,141,161,20,5541,6228,687,65,69,4,96.85534591
58390919ba866b8e0151dc9a7284118383507651,8,105,27,78,1,0,1,2,20,253,2,4,1.92215846,896,148,32,144,144,0,5632,5468,164,64,62,2,96.85534591
0c4ce41d8702df2beedc2df6a98af15dccd8f985,1,368,19,349,0,0,0,6,21,6,1,1,0,391,149,32,29,29,0,2061,1944,117,21,21,0,98.7460815
a5eb97af0be7cb5e4d58cf9813890b4893f04b17,0,0,0,0,0,0,0,0,0,0,0,0,0,0,150,33,0,0,0,0,0,0,0,0,0,100
61b1c7a6e098984086cf1b8cdb58eabf61fc6c8f,11,44,0,44,11,0,11,1,1,0,1,11,3.459431619,0,151,34,0,0,0,77,0,77,0,0,0,93.52941176
7a0d89c44e3f26664cb59464d4aa135962a95de0,1,12,2,10,0,0,0,2,4,8,1,1,0,57,152,35,6,6,0,417,280,137,4,4,0,100
a770fd70890ce7d94c10b5cde87d33db385de1c6,3,94,24,70,0,0,0,1,5,406,2,2,1.077317678,936,153,36,136,136,0,5455,5417,38,53,53,0,98.89502762
64f084357c385cef226c044ce8b0552a81897205,4,92,85,7,0,0,0,2,6,140,1,1,1.652573918,423,154,37,100,100,0,2872,2872,0,36,36,0,100
4e4093c03f01f847cf830b4e0cd1eb508dd13656,0,0,0,0,0,0,0,0,0,0,0,0,0,0,155,38,0,0,0,0,0,0,0,0,0,100
b47b7ebce773a525110c310d85115a8b8bf18d18,0,0,0,0,0,0,0,0,0,0,0,0,0,0,155,38,0,0,0,0,0,0,0,0,0,100
1770b990f6a28193dfb884dd42ca7320472663bb,0,0,0,0,0,0,0,0,0,0,0,0,0,0,157,40,0,0,0,0,0,0,0,0,0,100
48dd37ac0796d8eee4737dc64dab66d9180aac6a,2,61,23,38,0,0,0,1,6,7,2,2,0.16232618,402,156,39,57,55,2,2359,2267,92,15,13,2,100
b1c82bf9b8ff0415190bd4eff7e4bbfb444622a9,0,0,0,0,0,0,0,0,0,0,0,0,0,0,159,42,0,0,0,0,0,0,0,0,0,100
1e3af359bd3bcd60864c77dd284691304d568249,2,191,0,191,2,0,2,1,1,0,2,2,0.999822034,0,10,1,14,0,14,923,0,923,4,0,4,98.90710383
b5a8a446ed995674e81705371d5f07de036ccb79,1,1,1,0,0,0,0,1,2,0,1,1,0,58,11,2,6,6,0,461,451,10,2,2,0,100
0d7daa165d6b0e328338bef8f832063a387cb9b8,0,0,0,0,0,0,0,0,0,0,0,0,0,0,160,35,0,0,0,0,0,0,0,0,0,100
7bda3fa0c338b3f361a340cb6626975831be279a,4,11,5,6,0,0,0,2,6,13,2,3,1.905639062,372,161,32,87,87,0,2803,2803,0,34,34,0,98.91891892
101d0a5d4a6863020422deb6c90eeeab3f5c95a1,3,122,3,119,0,0,0,1,8,30,2,2,0.439460621,322,162,32,36,32,4,2976,1992,984,14,11,3,99.19137466
9e2f9461c0b8848093804e6c789f86d48ee71579,2,113,7,106,0,0,0,1,6,0,2,2,0.90071968,288,163,32,23,18,5,2945,2216,729,13,8,5,100
a73863bf223361f2af65815414ff33cb9e092619,8,47,27,20,1,0,1,1,7,19,2,5,2.390477375,1124,164,30,161,159,2,6140,6133,7,69,67,2,98.66666667
53808988aab91c611ab463f3c9c971d6a4f5ee53,2,18,8,10,0,0,0,2,6,28,1,1,0.391243564,264,165,30,50,50,0,1476,1476,0,24,24,0,100
4f7db6f452d11e01c34d3e35f4bf6caa6cf67839,2,2,2,0,0,0,0,2,7,0,1,1,1,264,166,27,50,50,0,1476,1476,0,24,24,0,100
0025f4ea5ccd40cbeb8be0e182c3afac41ada23d,1,4,5,1,0,0,0,2,3,31,1,1,0,134,167,28,25,25,0,833,833,0,5,5,0,100
18b6389d74c55ab95bbf31521c849525899424f6,1,1,1,0,0,0,0,1,2,42,1,1,0,44,168,29,4,4,0,164,164,0,2,2,0,100
ac31ab8cf4c7adf17296912a9090acfd579a09f0,0,0,0,0,0,0,0,0,0,0,0,0,0,0,169,30,0,0,0,0,0,0,0,0,0,100
87836ec12e720261c53f440ffb1d8f8e8e58ed91,7,17,81,64,0,0,0,4,14,67,1,5,2.648657651,1260,170,30,216,223,7,7129,7327,198,65,72,7,100
93fa407f1219210f4c9f5c1d90c4e552043fd7a2,2,109,13,96,0,0,0,2,6,30,2,2,0.966985296,349,171,23,59,49,10,2264,1696,568,30,25,5,100
3154c5c35ea211ae75710235d1ed492e65339929,1,36,0,36,0,0,0,2,6,0,1,1,0,209,172,24,18,14,4,1317,1071,246,8,7,1,99.20844327
21d8214f898b5133ea13848178c08d08123ca7c7,1,42,0,42,0,0,0,2,7,0,1,1,0,238,173,25,24,18,6,1542,1317,225,9,8,1,99.73684211
73b411f5d42535dcbdc2c69e641bba12c11b712d,1,38,0,38,0,0,0,2,8,0,1,1,0,271,174,26,28,24,4,1855,1542,313,10,9,1,100
81facd025941689eaa6bab747113d0071df96b5c,3,43,61,18,0,0,0,1,3,1353,2,2,1.113512216,112,175,27,9,8,1,382,400,18,5,6,1,99.47089947
b8ed6558e0f77ec2fcbfe5823993f8e6690b4417,1,89,0,89,0,0,0,2,13,53,1,1,0,347,176,28,36,30,6,3755,3004,751,29,27,2,99.2
51be9c05e82b93ab817a49ca8483627675476c24,1,0,89,89,0,0,0,2,12,0,1,1,0,423,1,0,30,36,6,3004,3755,751,27,29,2,99.2
36b6dac89be8733c612e1c1a65ca4d2420d5e7da,2,172,0,172,0,0,0,2,13,52,1,1,0.999122033,467,177,29,51,39,12,5320,3979,1341,40,36,4,98.67021277
992f4a6624c2a80812ec402dfd444e71b582c659,6,294,10,284,0,0,0,2,7,678,2,2,1.286006135,1678,178,30,321,300,21,13290,11177,2113,95,87,8,99.20212766
bf05b1d278ab03a895abdab050d5ff483e93b9dd,0,0,0,0,0,0,0,0,0,0,0,0,0,0,179,31,0,0,0,0,0,0,0,0,0,100
70f1c738c165a22a22e6ce58b18db7649e996201,3,210,11,199,0,0,0,6,22,323,2,3,0.645501944,716,180,32,84,80,4,5354,3909,1445,45,41,4,99.73404255
c6bda8068cccd33dff3c478a247631e049906442,7,32,12,20,0,0,0,1,10,978,1,1,2.539852428,703,181,33,105,105,0,4342,4342,0,33,33,0,100
dffbe71a38c0fa314c70921b4bd15d554a2f1e73,0,0,0,0,0,0,0,0,0,0,0,0,0,0,182,33,0,0,0,0,0,0,0,0,0,100
7df43152543d2e21a0a15988152b1698009446b2,3,121,109,12,0,0,0,6,23,34,2,2,1.05191544,689,12,2,51,47,4,4154,4164,10,27,27,0,99.46524064
56927aac4af11b74e9d6804771537da61cdd36df,1,20,4,16,0,0,0,2,4,0,1,1,0,94,13,3,20,20,0,689,689,0,4,4,0,100
67571313a81bbf2576f791c054386b970b594bac,0,0,0,0,0,0,0,0,0,0,0,0,0,0,183,32,0,0,0,0,0,0,0,0,0,100
790c107514126ad563d0ffd007884463ca5c3be4,1,2,0,2,0,0,0,2,3,32,1,1,0,44,1,0,4,4,0,177,164,13,2,2,0,100
94610c793598aeb53d415eca68f8edf0811e2b8c,0,0,0,0,0,0,0,0,0,0,0,0,0,0,184,24,0,0,0,0,0,0,0,0,0,100
fa74166ebe1944b6f9309036800fa2fe286b5605,3,6,0,6,0,0,0,2,10,27,1,2,1.584962501,476,185,25,87,87,0,2797,2758,39,33,33,0,100
21ce117007633b0f83d102655f1a6f3f2c9f66c5,0,0,0,0,0,0,0,0,0,0,0,0,0,0,186,26,0,0,0,0,0,0,0,0,0,100
5fc778d9f2028786d0ca887022b5fbeccf1c6d28,2,160,0,160,2,0,2,1,1,0,2,2,0.865469897,0,14,2,8,0,8,343,0,343,4,0,4,98.93617021
ab2c467f280e2043635b9788222aa162d4be0cd3,0,0,0,0,0,0,0,0,0,0,0,0,0,0,187,25,0,0,0,0,0,0,0,0,0,100
728fe2ccb36165041fc43f7d96a13d002b818c9d,0,0,0,0,0,0,0,0,0,0,0,0,0,0,188,26,0,0,0,0,0,0,0,0,0,100
65e8ac3ac6a0bea3fa99ee706054e9251f0088b7,0,0,0,0,0,0,0,0,0,0,0,0,0,0,189,27,0,0,0,0,0,0,0,0,0,100
82c8a6e1b62b66b3682e163d4db21eea18a8e2ff,0,0,0,0,0,0,0,0,0,0,0,0,0,0,190,28,0,0,0,0,0,0,0,0,0,100
1dc64c1467777460ad5cb87124fad9f0d2924dd6,1,1,1,0,0,0,0,2,4,39,1,1,0,207,191,11,39,39,0,1622,1622,0,11,11,0,100
5a9674a84603a66aa56c94ac85d9f0e3119ffc14,3,205,22,183,0,0,0,2,6,66,2,3,1.010773749,372,189,9,89,66,23,3267,2596,671,24,17,7,100
3fde8742d0a3ee524c2c3809cd4a940f46272159,1,1,1,0,0,0,0,2,4,39,1,1,0,207,193,13,39,39,0,1622,1622,0,11,11,0,100
03ce35c077b7c48912ed8dbf000f82caa084faed,2,81,0,81,1,0,1,6,24,17,2,2,0.997249633,574,194,14,38,31,7,3698,3465,233,26,23,3,99.47643979
d42364b2dd1e8c7e8083d8a15505e9abc1218cc8,2,214,23,191,0,0,0,2,7,2,2,2,0.937962644,271,195,13,68,50,18,2286,1645,641,18,13,5,100
0c5cab1c5e8277e8dccafe3c85e2ea4fc338dd6a,1,3,6,3,0,0,0,2,8,0,1,1,0,222,196,14,37,37,0,1510,1477,33,9,9,0,100
f385ec70233401563d2aacc0c53de1b85c080523,0,0,0,0,0,0,0,0,0,0,0,0,0,0,2,0,0,0,0,0,0,0,0,0,0,100
2d82057ab04c5caf8a956be6e02e15b631a85334,3,189,0,189,1,0,1,2,25,0,2,3,1.511965415,815,197,15,84,69,15,5710,5034,676,37,33,4,99.48186528
dcfaaad3a6c7371c92afe4fc37bce168df80cec0,7,70,63,7,1,0,1,1,11,32,1,2,1.651214439,688,198,16,136,136,0,4482,4529,47,50,50,0,99.23076923
d1757e8cfb49f094d5bcf5923e5b2a19e94902a1,3,130,61,69,1,0,1,2,10,2,2,2,1.118453866,422,199,16,82,73,9,2777,2554,223,23,19,4,98.98734177
c5fad98647b6d9f3affef88258c165b07efca62e,12,351,385,34,1,0,1,2,25,239,2,4,3.001769924,1769,15,1,251,251,0,11079,10838,241,96,98,2,97.20101781
c66c7c174965a3f0d786a002a4c2ecbfe263ce96,0,0,0,0,0,0,0,0,0,0,0,0,0,0,197,10,0,0,0,0,0,0,0,0,0,100
11be8e9778d9c9381320781794b8dff8f8f0db56,11,385,120,265,3,0,3,2,27,21,2,4,2.858421131,1628,3,1,253,229,24,10950,10098,852,100,92,8,97.72151899
735855c91f2c81f469709820394830a0e8af8101,0,0,0,0,0,0,0,0,0,0,0,0,0,0,201,1,0,0,0,0,0,0,0,0,0,100
44440cf0fe1703276d497fcb3d5c2837759327d8,2,29,21,8,0,0,0,3,9,104,2,2,0.529360865,367,11,0,36,35,1,2222,2200,22,15,14,1,100
f3737bfc91823574c5763226a78b6e98893b03d2,0,0,0,0,0,0,0,0,0,0,0,0,0,0,12,1,0,0,0,0,0,0,0,0,0,100
72ac9bc7e357b4b9bd84543b783093f1a6c2840a,0,0,0,0,0,0,0,0,0,0,0,0,0,0,4,1,0,0,0,0,0,0,0,0,0,100
bb62c567c0412e3d2d4a2c73d899eb33ee702a32,0,0,0,0,0,0,0,0,0,0,0,0,0,0,202,2,0,0,0,0,0,0,0,0,0,100
be1c334cd07756a7c8e28a9359fff74198a5b746,0,0,0,0,0,0,0,0,0,0,0,0,0,0,203,3,0,0,0,0,0,0,0,0,0,100
d0196265d9c557ce088dd8a4d20cb696e0d4aebd,1,6,1,5,0,0,0,3,9,5,1,1,0,72,16,0,8,8,0,367,367,0,5,5,0,100
d0453432558eaeaeead41937807cefe747e30023,0,0,0,0,0,0,0,0,0,0,0,0,0,0,204,4,0,0,0,0,0,0,0,0,0,100
d37de744ba123a51a8fcb77050fb15ed8f1b7d4d,1,3,4,1,0,0,0,3,10,0,1,1,0,72,205,5,8,8,0,367,367,0,5,5,0,100
03d6a62ebce1ab7f3df5e22ccc4d3e3674f0d4a4,0,0,0,0,0,0,0,0,0,0,0,0,0,0,206,5,0,0,0,0,0,0,0,0,0,100
5298fff223421269c8a278ef2723cd9a787261ce,0,0,0,0,0,0,0,0,0,0,0,0,0,0,207,6,0,0,0,0,0,0,0,0,0,100
dfa38748afecd136a2667d17044434c61a8f702a,0,0,0,0,0,0,0,0,0,0,0,0,0,0,208,7,0,0,0,0,0,0,0,0,0,100
17b6139b2a5b30b3354b9006a4a57d6ee3cb12cb,0,0,0,0,0,0,0,0,0,0,0,0,0,0,209,8,0,0,0,0,0,0,0,0,0,100
c6700237b5cd48146e2a944e6d66995169b634b6,0,0,0,0,0,0,0,0,0,0,0,0,0,0,210,9,0,0,0,0,0,0,0,0,0,100
3aeca75c7d24c8713f6d780d76801a7fc49607f1,2,477,0,477,2,0,2,1,1,0,2,2,0.909680849,0,0,0,39,0,39,1729,0,1729,20,0,20,98.77149877
9bde4e5474e2e4c2f86fadde85fd51bdfb8b9fb7,0,0,0,0,0,0,0,0,0,0,0,0,0,0,211,10,0,0,0,0,0,0,0,0,0,100
afbd6825efa21a7392884e906821712b2b5a6b57,2,17,1,16,0,0,0,2,8,110,1,1,0.764204507,358,212,11,70,70,0,2052,2052,0,28,28,0,100
350b863b294504f6098acae430ca5e78eee5cffc,0,0,0,0,0,0,0,0,0,0,0,0,0,0,213,12,0,0,0,0,0,0,0,0,0,100
302ba53466f5d7ac222cf8c84d79d26d5d94bc85,0,0,0,0,0,0,0,0,0,0,0,0,0,0,214,13,0,0,0,0,0,0,0,0,0,100
0594fbfbbc398f3cde8f22c90ae2a127eee432df,0,0,0,0,0,0,0,0,0,0,0,0,0,0,215,14,0,0,0,0,0,0,0,0,0,100
c2cfc5bf2d0aec55d1162e63667e35e131f77f03,0,0,0,0,0,0,0,0,0,0,0,0,0,0,216,15,0,0,0,0,0,0,0,0,0,100
397e3e531c63d9c7254d80930fb7df19bdc53c4e,0,0,0,0,0,0,0,0,0,0,0,0,0,0,217,11,0,0,0,0,0,0,0,0,0,100
0a70d175f07ee60bd33df6010635dc5bc9503ece,81,14701,0,14701,81,0,81,1,1,0,1,11,5.736439102,0,218,0,1178,0,1178,59681,0,59681,636,0,636,69.59459459
f695fdfa4c2e30acdecdd71865fc27f1efb8e563,0,0,0,0,0,0,0,0,0,0,0,0,0,0,219,1,0,0,0,0,0,0,0,0,0,100
2d0245cfb416c126d1cfda143ce1dc39babeb9cc,0,0,0,0,0,0,0,0,0,0,0,0,0,0,220,2,0,0,0,0,0,0,0,0,0,100
30a5b80d35e458fff468ec55b399bbc7493880e3,0,0,0,0,0,0,0,0,0,0,0,0,0,0,221,3,0,0,0,0,0,0,0,0,0,100
07da2ec02caa4fac9c7edec14d6f432a952b19a6,0,0,0,0,0,0,0,0,0,0,0,0,0,0,222,4,0,0,0,0,0,0,0,0,0,100
bbbd24b69f7e0ed900b68ec2459ab89b7c75abe9,6,240,15,225,2,0,2,1,2,24,1,4,2.108653147,886,223,5,127,111,16,6762,5821,941,64,59,5,99.35649936
6b1f49621b4cd75c7307c92a4023916ffbb9a4d6,4,80,33,47,0,0,0,1,2,44,1,3,1.75529329,955,224,4,136,134,2,6556,6159,397,69,69,0,100
383138c6e221c6c148bee17b3e67306ec5a89ab7,0,0,0,0,0,0,0,0,0,0,0,0,0,0,225,5,0,0,0,0,0,0,0,0,0,100
e1f6850d263a9681247cf7f21e44738accd9c739,0,0,0,0,0,0,0,0,0,0,0,0,0,0,226,6,0,0,0,0,0,0,0,0,0,100
1af30932bf0d000d14e98b10d7a4bbc2e3022bff,9,192,42,150,0,0,0,1,3,28,1,5,2.683305604,1420,227,4,186,181,5,10418,9471,947,103,100,3,100
39429c7a13e45c7eda9938a99a6c06b301176c18,0,0,0,0,0,0,0,0,0,0,0,0,0,0,228,5,0,0,0,0,0,0,0,0,0,100
46582e38d9de3557fbbec9501f578387eacae514,0,0,0,0,0,0,0,0,0,0,0,0,0,0,0,0,0,0,0,0,0,0,0,0,0,100
ba51251d7209870018feba1d9943bfaa0f95c43a,0,0,0,0,0,0,0,0,0,0,0,0,0,0,1,1,0,0,0,0,0,0,0,0,0,100
8837eeb30ec7356016f7583e750faf743208a974,0,0,0,0,0,0,0,0,0,0,0,0,0,0,2,2,0,0,0,0,0,0,0,0,0,100
5683f07c4cf140b0c464c6ce19720ef030272f85,1,8,1,7,0,0,0,2,8,332,1,1,0,112,3,3,19,18,1,808,747,61,5,5,0,100
c125fa0ba32a7364f08661d64ffdc527716dbfe8,1,11,3,8,0,0,0,2,4,1966,1,1,0,82,4,4,17,16,1,612,546,66,5,5,0,100
07c8ea3e9e1751609a80b576f98ace94277bbf56,1,8,1,7,0,0,0,5,15,288,1,1,0,273,5,5,66,65,1,1924,1863,61,16,16,0,100
bd41c391541c3c907b6a7c4aec063630afd3d9b7,0,0,0,0,0,0,0,0,0,0,0,0,0,0,229,6,0,0,0,0,0,0,0,0,0,100
856597603792d9a8dc3905385937f6b727dcbf7e,3,77,43,34,1,0,1,3,5,206,2,2,1.260545886,104,6,6,9,9,0,576,533,43,5,5,0,99.49044586
0121faefafe914d4ca59f70f2d7145cd6bb96386,3,58,40,18,1,0,1,2,2,168,2,2,1.443198983,73,7,7,8,8,0,386,343,43,4,4,0,99.494311
0032be7ef88dfffa570a35332a96cbf00d6c0398,0,0,0,0,0,0,0,0,0,0,0,0,0,0,8,8,0,0,0,0,0,0,0,0,0,100
530ae1cd2190a923afbfdd2ec8523fbdbaa67f52,0,0,0,0,0,0,0,0,0,0,0,0,0,0,9,9,0,0,0,0,0,0,0,0,0,100
4e01f9a664abe3f443b368b07cceb2c85ae4a38b,6,83,135,52,0,0,0,1,4,2,2,2,2.335297034,208,0,0,17,17,0,876,962,86,9,9,0,98.98477157
f0afe1cad1494a99aaf7946af764d5c9e63645f7,0,0,0,0,0,0,0,0,0,0,0,0,0,0,230,7,0,0,0,0,0,0,0,0,0,100
83ab33f489707c22f823b12c4eff58bd45ad8e41,2,90,1,89,1,0,1,2,4,142,2,2,0.877223623,38,0,0,8,2,6,405,164,241,7,2,5,99.74489796
f8af203fabd380cf7c5e77701d1ec2186807e84a,0,0,0,0,0,0,0,0,0,0,0,0,0,0,1,1,0,0,0,0,0,0,0,0,0,100
a6a9e5036ea926c996ac965481fe7302dcfa8f64,1,16,0,16,0,0,0,1,2,0,1,1,0,21,2,2,4,4,0,131,131,0,3,3,0,100
00db29745dc46ffe16170df05e9192ac708dbb6e,2,1,106,105,0,0,0,1,3,26,2,2,0.972033487,104,1,1,2,8,6,164,405,241,2,7,5,99.74489796
1bbb7c39330563397409234ae59c7e3f0c2d9108,0,0,0,0,0,0,0,0,0,0,0,0,0,0,231,7,0,0,0,0,0,0,0,0,0,100
4005a0ff7ff96c93e4f1b915afcbbbca1dfe5895,2,106,1,105,1,0,1,2,4,142,2,2,0.972033487,38,232,8,8,2,6,405,164,241,7,2,5,99.74489796
ecc9b7a0cac2818d00c572093148e48e5b3283fb,6,135,83,52,2,0,2,2,5,186,2,2,2.335297034,177,233,9,17,17,0,962,876,86,9,9,0,98.98989899
d369351ac4790c65086b724d219fd25b31abd3ab,2,2,2,0,0,0,0,2,2,20,1,1,1,57,234,10,8,8,0,235,235,0,2,2,0,100
c213088152014d6fabd4c0a947e30342e56a3ade,0,0,0,0,0,0,0,0,0,0,0,0,0,0,235,8,0,0,0,0,0,0,0,0,0,100
2635856e24e123fd5991d28ac0236620cd28c3a9,1,1,1,0,0,0,0,2,3,32,1,1,0,36,236,7,4,4,0,131,131,0,3,3,0,100
e198a6ba221b3c454b8cb043ac9881bcf903a391,6,7,20,13,0,0,0,2,9,199,1,3,2.424790858,574,237,8,101,101,0,2924,3008,84,34,34,0,100
6dfe46c8f71c4c5c9c58cadeee57f2cac0287e0e,0,0,0,0,0,0,0,0,0,0,0,0,0,0,238,8,0,0,0,0,0,0,0,0,0,100
2c106f34424e57c00382c6b1fc5538c5f7206b78,4,365,2,363,1,0,1,1,3,302,2,2,0.952336315,230,239,0,60,27,33,2134,1189,945,22,12,10,99.37578027
3fe90ddc81ec9e8e63bdc308edbbd6f8ac266db7,2,151,0,151,2,0,2,1,1,0,2,2,0.94068639,0,240,1,12,0,12,581,0,581,7,0,7,99.5049505
ae291045f44b96cabf111189827a81b2e4f14846,109,612,15932,15320,3,0,3,1,14,22,3,21,6.017089349,11704,1,0,343,1563,1220,12285,74460,62175,120,772,652,66.2358643
5994fbc9852873f3b6613b42c8082b24bf843fe6,99,15411,106,15305,86,0,86,2,15,41,3,17,5.87796194,1361,2,1,1454,244,1210,70361,7964,62397,725,76,649,68.49757674
84525822f48b6a4faae30bfef957acd879152fe8,94,750,576,174,0,0,0,2,28,456,2,23,5.250843108,10207,239,0,1381,1416,35,61862,63610,1748,520,534,14,99.13043478
07ea143f9f9425cd0cd1b3b7a690935f4a47ff88,94,588,747,159,3,11,14,2,27,250,2,23,5.278779281,10531,241,2,1426,1381,45,63388,61862,1526,537,520,17,98.88198758
6955f7b1ef27ee0a02c4fe82d50f22f517a7c540,1,2,2,0,0,0,0,1,2,393,1,1,0,61,242,3,8,8,0,472,472,0,2,2,0,100
43a972de1be62dcbebf6c79976c76cf7f07a3016,12,597,524,73,3,0,3,0,3,21,2,7,2.853390751,937,3,2,109,119,10,5169,4916,253,48,51,3,98.27586207
e1d373d94fbb5c98e6917de2c730ce3cdb2fcc67,89,713,72,641,0,0,0,2,28,473,2,23,5.949952964,9549,4,3,1342,1342,0,60133,60133,0,500,500,0,100
8cbbca45746e3ffa383a7c5e39ca9a516c227c8a,97,596,1310,714,3,11,14,2,27,244,2,23,5.057069382,10889,243,4,1426,1416,10,63388,63641,253,537,534,3,98.27586207
2408df415cd65086059369d5de71e67c11a83155,0,0,0,0,0,0,0,0,0,0,0,0,0,0,244,5,0,0,0,0,0,0,0,0,0,100
d1a288398c62f2a879c6d7f003cccd5494615ecc,91,745,72,673,0,0,0,2,28,456,2,23,5.99453772,9965,5,0,1383,1383,0,62036,62036,0,522,522,0,100
64eaa781b0a0fb218ef832d49b5648079c6e4777,91,84,765,681,0,11,11,2,27,264,2,23,6.009515263,10595,245,6,1383,1383,0,62003,62036,33,522,522,0,99.87684729
af1f28263ad368b40354b7acc994f1c2e141d837,94,1326,90,1236,3,0,3,2,28,438,2,23,5.204940596,9962,5,4,1418,1383,35,63815,62003,1812,536,522,14,99.02319902
60cbbef2e5d37464f80c7e489a5991b67ca9e061,2,15,5,10,0,0,0,1,4,0,1,1,0.721928095,387,6,5,52,51,1,2224,2186,38,21,21,0,100
23184f28fe485314663686e2f36965ed4a816c20,94,148,1336,1188,0,11,11,2,27,251,2,23,5.183656317,10963,246,7,1384,1419,35,62065,63853,1788,523,536,13,99.02319902
42fdccf7f55173618beec98113cc4977e5fa8968,94,1344,148,1196,3,0,3,2,28,438,2,23,5.169238954,9980,7,6,1419,1384,35,63853,62065,1788,536,523,13,99.02319902
b5e28c4cc87b12ba8539d7c4afcaeb6979841b7b,1,13,3,10,0,0,0,1,5,0,1,1,0,140,8,7,15,15,0,834,834,0,3,3,0,100
38c298701ccfe44d1a6c12ed6bf4b330071ac290,9,18,609,591,0,0,0,0,18,62,2,4,1.91594669,1321,6,1,148,184,36,5433,7283,1850,48,62,14,99.02319902
c93694183b3058fcc805ba98943f7d10b9495934,5,589,6,583,3,0,3,1,5,54,2,2,1.611480704,382,247,8,75,39,36,3546,1729,1817,34,20,14,99.14529915
3903277bb725130f888c5bdd67b55f61bc8d808e,0,0,0,0,0,0,0,0,0,0,0,0,0,0,248,9,0,0,0,0,0,0,0,0,0,100
72edff9ee9d13c750abf1e2bc90fc05fbc742c34,6,18,18,0,0,0,0,1,4,83,1,3,2.46132014,2289,249,10,202,176,26,17847,16034,1813,125,114,11,95.2853598
76413325d7715120c0f974b92fce46d5791b5301,5,639,129,510,2,0,2,1,5,76,1,4,1.420874941,303,250,9,101,46,55,4648,2013,2635,54,26,28,99.11504425
7934a1eca7a18377e3fe668726c74a630a31367c,1,61,1,60,0,0,0,1,2,2,1,1,0,285,251,10,30,29,1,2119,1978,141,21,20,1,100
ecba0bc59334a3e3288e666e1df8f77362370c32,4,39,17,22,0,0,0,1,6,96,1,2,0.996675425,957,252,11,146,142,4,6053,5928,125,69,69,0,100
367249322e0f7ce2081b2ad4c96d2775a1c2307d,1,5,5,0,0,0,0,1,4,0,1,1,0,304,253,12,30,30,0,2092,2119,27,21,21,0,100
d75db20bf25f145b25585bcb051b32a0f1e66224,0,0,0,0,0,0,0,0,0,0,0,0,0,0,254,13,0,0,0,0,0,0,0,0,0,100
93ae2d4640806f63ba7662c779d556f0b5807d19,0,0,0,0,0,0,0,0,0,0,0,0,0,0,255,14,0,0,0,0,0,0,0,0,0,100
72cbf2bcacc83119651a5fccaae7a50492bb6805,0,0,0,0,0,0,0,0,0,0,0,0,0,0,256,15,0,0,0,0,0,0,0,0,0,100
72b5e245982c869de67819c2650854797ffefacd,0,0,0,0,0,0,0,0,0,0,0,0,0,0,257,16,0,0,0,0,0,0,0,0,0,100
d75ffff7dcd7ff2d9c7886e1bbaaff32a2b47ee1,0,0,0,0,0,0,0,0,0,0,0,0,0,0,258,17,0,0,0,0,0,0,0,0,0,100
372a318a3aa2110a115f2326111d6ffdce0e8efe,0,0,0,0,0,0,0,0,0,0,0,0,0,0,259,18,0,0,0,0,0,0,0,0,0,100
5252f9d54e671a2c68723e027ab20be1bbfd5dbd,0,0,0,0,0,0,0,0,0,0,0,0,0,0,260,19,0,0,0,0,0,0,0,0,0,100
d8475e2d4aaef62492c9a7c58f056a82766ad32a,0,0,0,0,0,0,0,0,0,0,0,0,0,0,261,19,0,0,0,0,0,0,0,0,0,100
ab4a99b17d3488f42b0b25a1374aba574cda7d5e,0,0,0,0,0,0,0,0,0,0,0,0,0,0,262,19,0,0,0,0,0,0,0,0,0,100
acb9367b6ae02313be5c77c3134e3abe0e8949b6,0,0,0,0,0,0,0,0,0,0,0,0,0,0,263,16,0,0,0,0,0,0,0,0,0,100
8b18f0ada7d4a08df1408889eb0fc7c80aab304a,1,74,6,68,0,0,0,1,2,227,1,1,0,164,264,15,29,20,9,1232,956,276,5,5,0,100
dbce0a6f7ddf57c3276c2af502a99876d1a1e5b3,0,0,0,0,0,0,0,0,0,0,0,0,0,0,265,16,0,0,0,0,0,0,0,0,0,100
7db4db3695ad63df7e13516876112dddccfccc81,1,58,0,58,0,0,0,2,7,90,1,1,0,171,267,0,9,8,1,709,647,62,9,8,1,100
5f04eee87ec3bd85425a696980abfae911226755,0,0,0,0,0,0,0,0,0,0,0,0,0,0,268,1,0,0,0,0,0,0,0,0,0,100
404f280a742d74d230b7a797c8de9bbe820456bb,0,0,0,0,0,0,0,0,0,0,0,0,0,0,269,2,0,0,0,0,0,0,0,0,0,100
73cacba4090b81f5d131944a3a9d480bb99b2b1d,3,37,5,32,0,0,0,1,2,126,2,3,1.553763114,230,270,3,43,43,0,1352,1352,0,15,15,0,100
c50d6d35229f55e947eceda35dc388b858268947,0,0,0,0,0,0,0,0,0,0,0,0,0,0,271,4,0,0,0,0,0,0,0,0,0,100
9d7dffd65c9de040c9dc9bc91ba85687b199e987,97,1562,1265,297,0,0,0,2,29,93,2,23,6.599740745,11253,272,3,1463,1463,0,65234,65234,0,552,552,0,100
e8084146843bd546f9af51bffa32f29fbf7633db,16,3809,6,3803,14,0,14,1,12,2,2,4,3.593018535,302,0,0,306,58,248,12769,1516,11253,160,32,128,96.24697337
862a7fb3abb1df6b8488af708548e182b9f92ae9,0,0,0,0,0,0,0,0,0,0,0,0,0,0,273,1,0,0,0,0,0,0,0,0,0,100
4414e8cac8d9126173cef0ff0e98347e800e653c,4,176,2,174,0,0,0,2,13,5,2,2,1.454320943,962,274,2,145,137,8,6058,5602,456,62,60,2,100
614c1f16cf7e26677cefc8fedad12f7f921e442b,0,0,0,0,0,0,0,0,0,0,0,0,0,0,0,0,0,0,0,0,0,0,0,0,0,100
c95f0f79a95fe043ecd0d7413fab0b5dbe37a15e,0,0,0,0,0,0,0,0,0,0,0,0,0,0,17,0,0,0,0,0,0,0,0,0,0,100
4a598c2592ddad10a2739d283d2c8269c0494f83,0,0,0,0,0,0,0,0,0,0,0,0,0,0,1,1,0,0,0,0,0,0,0,0,0,100
650c85adbcf59a91ca0053971a65e271609555b9,0,0,0,0,0,0,0,0,0,0,0,0,0,0,18,1,0,0,0,0,0,0,0,0,0,100
d2f8cf2da19a4b498ad086c9b3bff28d1106ca6e,0,0,0,0,0,0,0,0,0,0,0,0,0,0,17,0,0,0,0,0,0,0,0,0,0,100
38a670eef54278e0a305ff32e198b007c7984988,0,0,0,0,0,0,0,0,0,0,0,0,0,0,20,3,0,0,0,0,0,0,0,0,0,100
a4b17da901968a4bb704e4d04aa9a6e53baddf29,3,511,131,380,1,0,1,1,6,20,2,2,1.305672832,388,9,0,56,39,17,2580,1735,845,25,20,5,99.76689977
424e3b4857c0f2db13fcfd65812b08962b8e004a,3,130,510,380,0,0,0,0,5,100,2,2,1.307524444,618,275,3,39,56,17,1735,2580,845,20,25,5,99.76689977
41a0c2ccfc5e980b715d5d11d54eb673462de1a7,3,511,131,380,1,0,1,1,6,20,2,2,1.305672832,388,276,4,56,39,17,2580,1735,845,25,20,5,99.76689977
99e46e2cd80be6d7cecf56308b17a707d61d6660,7,864,0,864,7,0,7,1,1,0,2,2,2.691682414,0,0,0,60,0,60,2897,0,2897,22,0,22,98.28571429
90c754e08c997f12f0c794fc67cfa3f354793a2b,9,119,864,745,2,0,2,0,1,0,2,4,3.014750314,581,0,0,4,63,59,325,3014,2689,3,23,20,97.83845279
9a4264504f14b7ee19e3692b2c9826e9dad2aab3,2,0,119,119,0,0,0,0,0,0,2,2,0.962540093,85,1,0,0,4,4,0,325,325,0,3,3,99.53703704
0fda7e952f0c06e3166b1aa0059f8e80c2e035a2,7,864,0,864,7,0,7,1,1,0,2,2,2.691682414,0,277,4,60,0,60,2897,0,2897,22,0,22,98.28571429
d8cec6a5c84d9c0cf545c410eb8a0cf1bc427a22,2,119,0,119,2,0,2,1,1,0,2,2,0.962540093,0,278,5,4,0,4,325,0,325,3,0,3,99.55257271
7b1aeb198b197af245b92bfc582fb194d83261ce,0,0,0,0,0,0,0,0,0,0,0,0,0,0,0,0,0,0,0,0,0,0,0,0,0,100
16a82e8b42c302d95bafcd6b2a92e1f1fa8a4399,1,1,1,0,0,0,0,6,20,45,1,1,0,294,279,6,66,66,0,1903,1903,0,16,16,0,100
d4a5c5d434c33c6b614ae08ee4179661fda0d358,2,74,13,61,0,0,0,8,30,98,2,2,0.865281703,765,1,0,55,53,2,4434,4360,74,35,33,2,100
b2134e66063b06ab1fd7813368faa30ecf945f78,1,95,0,95,1,0,1,1,1,0,1,1,0,0,2,1,5,0,5,590,0,590,3,0,3,99.77777778
4aa2ef2a425dab3e3d5f5bdacf095af0b18fb993,9,1281,1289,8,2,0,2,1,2,52,2,2,2.707323312,1836,3,2,136,133,3,7149,8253,1104,74,85,11,97.7827051
778bef1eb64173891565a4c9ea15501619388aa6,126,112,119,7,0,0,0,1,1,0,2,28,4.283980834,15457,280,0,1822,756,1066,82662,58086,24576,725,252,473,44.32194046
b516cb87279dd4a4b8eb357e432a2b71939997c9,0,0,0,0,0,0,0,0,0,0,0,0,0,0,281,1,0,0,0,0,0,0,0,0,0,100
787260863b9a9641857567341bb3baee26f89609,0,0,0,0,0,0,0,0,0,0,0,0,0,0,282,2,0,0,0,0,0,0,0,0,0,100
9c6475a994901d6bc6340b3c880e25b3b7c55c58,0,0,0,0,0,0,0,0,0,0,0,0,0,0,283,3,0,0,0,0,0,0,0,0,0,100
00a0442d997529ef7b097f39efa85b6238cb4e8e,0,0,0,0,0,0,0,0,0,0,0,0,0,0,283,0,0,0,0,0,0,0,0,0,0,100
270b5366acbb4187cd439b9a1f6d631576702161,6,10,8,2,0,0,0,1,4,515,1,1,2.281036113,1598,284,1,238,234,4,9929,9902,27,85,85,0,100
1cbe8c2997a19af5a780007908a1857de3a78eed,6,8,10,2,0,0,0,1,3,73,1,1,2.281036113,1599,284,1,234,238,4,9902,9929,27,85,85,0,100
83a1dec05d662d97baf1eb3c06639e251711bcf5,2,9,7,2,0,0,0,2,2,158,1,2,0.954434003,807,0,0,59,59,0,4783,4766,17,33,33,0,100
4b629c352157da06502f3241a3f763cf24cd9a5f,6,10,8,2,0,0,0,1,4,533,1,1,2.281036113,1598,285,2,238,234,4,9929,9902,27,85,85,0,100
e160f80538997c6421d7dcb3248ee141e1c13a92,0,0,0,0,0,0,0,0,0,0,0,0,0,0,4,0,0,0,0,0,0,0,0,0,0,100
ac57a45820336724c6e4b055590223cfe277998b,0,0,0,0,0,0,0,0,0,0,0,0,0,0,288,4,0,0,0,0,0,0,0,0,0,100
e26e0a9f26588c8bdc1e8e6ac74cd47a0c1089d6,0,0,0,0,0,0,0,0,0,0,0,0,0,0,289,5,0,0,0,0,0,0,0,0,0,100
e2100de5368b0132adcd776a088269d4898f5fd6,0,0,0,0,0,0,0,0,0,0,0,0,0,0,7,0,0,0,0,0,0,0,0,0,0,100
8f52118e1c7bb2b6a8c1c58483b48de1544ff24f,0,0,0,0,0,0,0,0,0,0,0,0,0,0,8,1,0,0,0,0,0,0,0,0,0,100
45746ac235fe9bd50fe692098e661470cdef26c2,0,0,0,0,0,0,0,0,0,0,0,0,0,0,290,1,0,0,0,0,0,0,0,0,0,100
9708a83234c37cf9d2a896915391df2eb90cd001,0,0,0,0,0,0,0,0,0,0,0,0,0,0,9,2,0,0,0,0,0,0,0,0,0,100
fe2440505235404af01eb6b9cf731e231f6e7dca,0,0,0,0,0,0,0,0,0,0,0,0,0,0,10,3,0,0,0,0,0,0,0,0,0,100
4d02d119e19a588cab3b5f1e380290fd3444662d,0,0,0,0,0,0,0,0,0,0,0,0,0,0,11,4,0,0,0,0,0,0,0,0,0,100
e15390f10c2b1ff73ca9316ac4be73084cffe546,0,0,0,0,0,0,0,0,0,0,0,0,0,0,291,1,0,0,0,0,0,0,0,0,0,100
544e5af08c81671e8f14832fc3657de696cd313b,26,2869,0,2869,26,0,26,1,1,0,1,7,4.210219191,0,0,0,161,0,161,8675,0,8675,80,0,80,94.21487603
75162f64ddb60cc879b1ed67fd03bada5b9b5ae4,2,400,339,61,0,0,0,3,3,62,1,2,0.465123132,809,10,0,60,59,1,4848,4783,65,34,33,1,100
e6715a42accf4e6bd25e89ca7f99477dcf85c878,107,1882,1513,369,22,0,22,1,2,130,2,20,6.599573707,9977,11,1,1274,482,792,65143,22652,42491,673,281,392,68.8867745
3cfcea78d5dfed961625f8dfce0f75579ac0b0ff,3,29,11,18,0,0,0,2,2,225,1,2,1.225157039,190,0,0,19,15,4,723,623,100,10,10,0,100
f75f9c4fdf9b94944b3d51cf6dab256e077899e7,0,0,0,0,0,0,0,0,0,0,0,0,0,0,1,1,0,0,0,0,0,0,0,0,0,100
6d3acbb36cd8ad650dd3cb402da5efa71d3c863a,0,0,0,0,0,0,0,0,0,0,0,0,0,0,12,3,0,0,0,0,0,0,0,0,0,100
5d4ccfd769b2655a9226cdc09320af6fc307a4be,0,0,0,0,0,0,0,0,0,0,0,0,0,0,2,2,0,0,0,0,0,0,0,0,0,100
a36cab397505837113a5193de52e6439bd12c831,6,166,9,157,2,0,2,1,2,156,1,3,1.941082117,496,3,3,121,115,6,3509,3170,339,46,41,5,99.26199262
c4149151e608a27d1e02dadd2f571a034be4f34f,1,2,2,0,0,0,0,2,3,0,1,1,0,63,292,2,9,9,0,256,256,0,7,7,0,100
faab884c278a3ab5197ec3cd8931f84a664f4904,5,8,165,157,0,0,0,2,4,10,1,2,1.872359013,434,293,2,84,90,6,2399,2738,339,33,38,5,99.26199262
412b14bc9169a8f4f7433f02551cbbf698846f20,3,157,157,0,0,0,0,1,2,175,1,2,1.046305681,916,294,3,84,84,0,5878,5878,0,33,33,0,100
e59348fc687a3492e9e0d75f22e1f6ee1d92fa06,2,0,166,166,0,0,0,2,2,3046,1,1,0.943876757,96,13,0,0,18,18,0,491,491,0,7,7,99.53401678
384783d776fdeb77bc04064ffa6a03012fa5a3f4,1,2,2,0,0,0,0,2,2,140,1,1,0,192,14,1,28,28,0,1253,1253,0,11,11,0,100
8b1d5b6c3501db722f445814393be6a5b25cda6e,6,320,2,318,5,0,5,1,1,0,3,4,2.274126233,192,2,0,52,28,24,2042,1253,789,22,11,11,98.98053753
8af19806a403418dbb2f84868902b046be66952f,3,2,168,166,0,0,0,2,2,2076,2,2,1.082490913,288,15,2,28,46,18,1253,1744,491,11,18,7,99.53917051
40e6423f191acf28a16c7e904796692f40057101,0,0,0,0,0,0,0,0,0,0,0,0,0,0,0,0,0,0,0,0,0,0,0,0,0,100
db3838ad67089e91a5fb70208d120656026c1421,0,0,0,0,0,0,0,0,0,0,0,0,0,0,295,0,0,0,0,0,0,0,0,0,0,100
0f9b853be2efd7176091c433bc08180aa81bc453,81,538,452,86,0,0,0,2,5,275,2,23,5.691989715,9900,16,0,1480,1480,0,56212,56212,0,601,601,0,100
b7bef9c888397763b736cc0147f1b8a469a0cd62,2,220,0,220,2,0,2,1,1,0,1,2,0.912115631,0,1,0,21,0,21,1072,0,1072,9,0,9,99.63099631
639268a6880a0a33c6a2426f069015ac9658f8f1,1,15,14,1,0,0,0,3,3,163,1,1,0,75,12,0,10,8,2,379,367,12,5,5,0,100
3b6554aa24634c7dd635900321f3f85db663db3e,3,166,15,151,2,0,2,1,2,154,1,3,1.474512107,76,3,0,15,10,5,747,379,368,7,5,2,99.63369963
2fef6eab201ef574d9c7ba8a54efac0b4c977c4d,1,15,14,1,0,0,0,3,3,272,1,1,0,75,12,0,10,8,2,379,367,12,5,5,0,100
83e1f5411af0043ba249e9bda5493952c8c44757,0,0,0,0,0,0,0,0,0,0,0,0,0,0,296,0,0,0,0,0,0,0,0,0,0,100
598fd9247c042e273930c0c2d3c732d6b1173d74,3,350,192,158,1,0,1,4,4,450,1,2,1.260372468,897,0,0,87,77,10,5900,5476,424,41,41,0,99.27272727
89fe0bec6717e1f68e5cce5f065620d5cb5a8a3c,2,7,5,2,0,0,0,5,5,0,1,2,0.650022422,938,17,0,86,86,0,5714,5697,17,40,40,0,100
fe9b86eaf0a5f8c23c21de10068885dda4fc538e,2,42,5,37,0,0,0,5,6,0,1,2,0.784992089,938,18,1,89,86,3,5801,5714,87,41,40,1,100
ecb03180b734f39ab63cc01b1ac8b0d7e2c100ac,0,0,0,0,0,0,0,0,0,0,0,0,0,0,2,0,0,0,0,0,0,0,0,0,0,100
966da2f3821dc7459eb8455293031cfa367c8ba3,81,0,182,182,0,0,0,2,5,446,2,18,6.240052575,8690,3,1,1275,1275,0,50141,49418,723,560,560,0,99.09338169
e7835c11fef9753d477dd40fead57a5a328ac06f,4,4,4,0,0,0,0,3,5,0,1,3,2,432,297,0,56,56,0,1706,2429,723,25,25,0,99.09338169
13469643924d477c8e38e7eac43fcf5342486d46,0,0,0,0,0,0,0,0,0,0,0,0,0,0,298,1,0,0,0,0,0,0,0,0,0,100
1563535f20cba433497664262717d861775c5f9b,3,211,11,200,2,0,2,1,7,6,1,2,1.346101194,719,0,0,60,42,18,4684,3986,698,38,32,6,99.63898917
ad4766482e21638e3d62977d05db711d72e453e5,0,0,0,0,0,0,0,0,0,0,0,0,0,0,19,2,0,0,0,0,0,0,0,0,0,100
3eda18951b08b002aa5dade393415c9f92578fdb,0,0,0,0,0,0,0,0,0,0,0,0,0,0,20,3,0,0,0,0,0,0,0,0,0,100
aaac12fd7a61a37e331283c2f5ecd51a42f70d02,0,0,0,0,0,0,0,0,0,0,0,0,0,0,21,4,0,0,0,0,0,0,0,0,0,100
745a230f2ab5bdd3d6f2017a0b89edf30aebcce3,0,0,0,0,0,0,0,0,0,0,0,0,0,0,299,0,0,0,0,0,0,0,0,0,0,100
163fc26ad9abe30f3a9c0be4622c6e4e187e8505,13,113,153,40,0,0,0,6,8,1002,3,6,2.374175157,4101,22,0,335,344,9,29921,29666,255,222,222,0,100
cd12eb426fe87584d3a4c9318d5c6fd9280544e1,0,0,0,0,0,0,0,0,0,0,0,0,0,0,23,1,0,0,0,0,0,0,0,0,0,100
1f658687711ebc753ec66caff946cd978cf93d02,0,0,0,0,0,0,0,0,0,0,0,0,0,0,24,2,0,0,0,0,0,0,0,0,0,100
394ab0b909c93896319f54bb1aadae4f17c1ba3a,0,0,0,0,0,0,0,0,0,0,0,0,0,0,25,3,0,0,0,0,0,0,0,0,0,100
d33b5a1654528cc9990826778e9d1ad7b89797b4,0,0,0,0,0,0,0,0,0,0,0,0,0,0,4,0,0,0,0,0,0,0,0,0,0,100
49928a8411aa2e75ced803408a4dfc5625253df4,2,229,1,228,1,0,1,7,9,101,1,2,0.864757266,753,0,0,55,44,11,4792,4367,425,37,34,3,99.82046679
433994c470fb3cf9b907ce8b5ce14c5ac8d47e4b,1,13,9,4,0,0,0,2,2,0,1,1,0,68,26,0,10,10,0,319,319,0,2,2,0,100
b921ca57a06f6e7d6435ee53692aa1be42a16422,0,0,0,0,0,0,0,0,0,0,0,0,0,0,27,1,0,0,0,0,0,0,0,0,0,100
7ed3902e7c0c081d91dd2f31e8c5a891ca375130,1,144,30,114,0,0,0,3,3,818,1,1,0,78,0,0,34,10,24,1078,331,747,17,6,11,99.73142346
643543706e6ad63c9c997f94bfdc979c63506339,1,4,11,7,0,0,0,4,4,0,1,1,0,176,28,0,31,34,3,1000,1078,78,17,17,0,99.73142346
87f55b425035201036e5823bdcd081b6ec7c962f,1,17,17,0,0,0,0,4,5,173,1,1,0,170,29,0,31,31,0,1000,1000,0,17,17,0,100
9e5fd3a58b65122ce2178f1eb32c0984c82e9da1,0,0,0,0,0,0,0,0,0,0,0,0,0,0,30,1,0,0,0,0,0,0,0,0,0,100
a7687d34ec399511929d918ed0140107a73ce5c3,0,0,0,0,0,0,0,0,0,0,0,0,0,0,31,1,0,0,0,0,0,0,0,0,0,100
282a42f643aa5e2a1635e07d41bf615c8dbbdf6b,4,8,8,0,0,0,0,2,2,1836,1,1,1.811278124,381,32,2,44,44,0,2142,2142,0,14,14,0,100
f03e9ba6c87a345db364bb1461bd6eb653c327f5,1,1,1,0,0,0,0,2,2,1838,1,1,0,73,33,3,8,8,0,359,359,0,2,2,0,100
ef94e55d1592acdd1d9340ab77f6b02cbdc2d60f,0,0,0,0,0,0,0,0,0,0,0,0,0,0,5,0,0,0,0,0,0,0,0,0,0,100
158f999121c3296deed3982421f0eeabbb250656,0,0,0,0,0,0,0,0,0,0,0,0,0,0,34,3,0,0,0,0,0,0,0,0,0,100
be4a95f7a8381e258f0301279620b44bd618dceb,0,0,0,0,0,0,0,0,0,0,0,0,0,0,35,0,0,0,0,0,0,0,0,0,0,100
13bae36617a6265c3043dfff387e0793ab14124c,0,0,0,0,0,0,0,0,0,0,0,0,0,0,36,1,0,0,0,0,0,0,0,0,0,100
f8d31403af90be67df2cdc98326c273f746aea12,0,0,0,0,0,0,0,0,0,0,0,0,0,0,37,2,0,0,0,0,0,0,0,0,0,100
0456797ef1a820b4163a3d7d8ea2e256b0ec977b,0,0,0,0,0,0,0,0,0,0,0,0,0,0,38,3,0,0,0,0,0,0,0,0,0,100
92a56e49f96fb3a1e3cfbfaade55e7a7e1748b07,0,0,0,0,0,0,0,0,0,0,0,0,0,0,39,4,0,0,0,0,0,0,0,0,0,100
f7c9b232fe1f7a9a2c445f7c25bb73a3c6a099c1,1,33,4,29,0,0,0,2,2,2108,1,1,0,44,0,0,8,4,4,252,137,115,5,2,3,100
a15a15c58164cc39c62235c0da6a7b1d8d7db9e2,1,30,0,30,0,0,0,7,10,555,1,1,0,787,40,0,46,45,1,4835,4473,362,36,35,1,100
6a7739538133c63612856246999a9d5b7b444f6f,4,89,149,60,0,0,0,7,9,566,3,4,1.202779456,1169,40,0,107,112,5,6054,6531,477,67,71,4,100
19261c68e25b93d6fdddfbc98ac62548b0c23c81,4,149,89,60,0,0,0,7,10,1085,3,4,1.202779456,1121,41,1,112,107,5,6531,6054,477,71,67,4,100
af31db6a3431a99932bd1f899c0514b3bf546281,2,85,86,1,0,0,0,3,4,1034,2,2,0.091837166,290,43,0,58,58,0,1444,1444,0,30,30,0,100
27c1af40375a0c45fff984e5d37e609875bab218,2,67,24,43,0,0,0,8,11,378,1,2,0.902941672,879,0,0,62,56,6,5563,5154,409,41,38,3,99.91039427
4519690c65ab5243f63e8ccfd557b861b7dc65ef,2,484,78,406,1,0,1,9,12,166,1,2,0.99941525,832,0,0,93,47,46,6847,5182,1665,62,37,25,99.82110912
53251bbe70802022afa41a91b1a8d66d4a32bbd0,0,0,0,0,0,0,0,0,0,0,0,0,0,0,44,0,0,0,0,0,0,0,0,0,0,100
6812d08ecf47e4776260b9dac652abdc9dc142cb,0,0,0,0,0,0,0,0,0,0,0,0,0,0,45,1,0,0,0,0,0,0,0,0,0,100
9eab8e5bb897681921500d0479ea1d419686cc3a,0,0,0,0,0,0,0,0,0,0,0,0,0,0,46,2,0,0,0,0,0,0,0,0,0,100
60a5a4f1874b4ba4d00631e8dea1e10a0a702292,0,0,0,0,0,0,0,0,0,0,0,0,0,0,47,3,0,0,0,0,0,0,0,0,0,100
3e0cb8dd7627279d0c5a1411b07bd255a9fcd5c8,0,0,0,0,0,0,0,0,0,0,0,0,0,0,48,4,0,0,0,0,0,0,0,0,0,100
17098d707d1ef2905dd1039a66b03b61ca232654,0,0,0,0,0,0,0,0,0,0,0,0,0,0,49,5,0,0,0,0,0,0,0,0,0,100
797c61f238a0f6837291419a090cab5b650c13d7,0,0,0,0,0,0,0,0,0,0,0,0,0,0,50,6,0,0,0,0,0,0,0,0,0,100
4f0b95e107cc4ad2b90f523f72f87590d5856093,0,0,0,0,0,0,0,0,0,0,0,0,0,0,51,7,0,0,0,0,0,0,0,0,0,100
b0e9cc9b6f910dfa006048fa582d427766965dbe,0,0,0,0,0,0,0,0,0,0,0,0,0,0,49,4,0,0,0,0,0,0,0,0,0,100
6d18cc424e336a498707e2750620dbc045c9934d,0,0,0,0,0,0,0,0,0,0,0,0,0,0,50,1,0,0,0,0,0,0,0,0,0,100
39d75393843f92b79ff98604977b3bcf6ed31119,0,0,0,0,0,0,0,0,0,0,0,0,0,0,54,0,0,0,0,0,0,0,0,0,0,100
68190ca2c212dd71fb315b49233cc366b71dbcb7,0,0,0,0,0,0,0,0,0,0,0,0,0,0,55,1,0,0,0,0,0,0,0,0,0,100
8155b474262e6d24e7034c4e226b5b2a390a51b9,0,0,0,0,0,0,0,0,0,0,0,0,0,0,56,2,0,0,0,0,0,0,0,0,0,100
e89c780bfe827b3d9e82d18fb8f421a4c44d63c4,0,0,0,0,0,0,0,0,0,0,0,0,0,0,1,0,0,0,0,0,0,0,0,0,0,100
0b4b2e1784d2a965c18de56c7978e39109cd1fc0,1,17,1,16,0,0,0,5,6,2105,1,1,0,168,2,0,58,56,2,1515,1442,73,23,23,0,100
fa28ee6915c7076ca9684bb3c721da2d51ba3ba9,2,53,2,51,1,0,1,2,2,1616,1,2,0.869892686,218,0,0,40,38,2,1465,1272,193,20,18,2,99.64381122
278e3587b8ec48408dea27f457426f5f7d6e9e4d,1,12,6,6,0,0,0,3,3,0,1,1,0,225,57,0,39,39,0,1376,1379,3,19,19,0,100
2240db9c46796d30d54da351ec4d918d4eb32d20,0,0,0,0,0,0,0,0,0,0,0,0,0,0,58,1,0,0,0,0,0,0,0,0,0,100
c53c1b97168cef6f19b24f1b7655e1642b12b6d5,0,0,0,0,0,0,0,0,0,0,0,0,0,0,59,2,0,0,0,0,0,0,0,0,0,100
19837e6c2e1542b09343b6e33a89f7e84ef0b9bb,3,138,178,40,0,0,0,2,3,3524,1,2,0.153152376,516,0,0,47,39,8,3231,3644,413,24,17,7,100
a831aa37953ad930415e4f7cb31cd3be4db3f101,0,0,0,0,0,0,0,0,0,0,0,0,0,0,60,0,0,0,0,0,0,0,0,0,0,100
c93acb64d11a40c666c9c12669fdb95a10c6f179,0,0,0,0,0,0,0,0,0,0,0,0,0,0,61,1,0,0,0,0,0,0,0,0,0,100
5b648e2fbb6f1305e6252805d3a1b5421e0a806d,2,108,3,105,1,0,1,1,4,256,1,2,0.405977038,229,1,0,41,39,2,1691,1376,315,21,19,2,99.82269504
d92e8439506a7d8740c049587dd45220474f01a1,0,0,0,0,0,0,0,0,0,0,0,0,0,0,2,0,0,0,0,0,0,0,0,0,0,100
4f8c4e85bfd2c415a335a97c1b495ee596512061,1,64,0,64,1,0,1,1,1,0,1,1,0,0,4,0,1,0,1,114,0,114,1,0,1,99.82332155
3612902e84352b34b2af9485b9a34ca0659ecfed,0,0,0,0,0,0,0,0,0,0,0,0,0,0,3,0,0,0,0,0,0,0,0,0,0,100
900c45b6a23973e265ef7e3c97fd9d06da80b524,0,0,0,0,0,0,0,0,0,0,0,0,0,0,0,0,0,0,0,0,0,0,0,0,0,100
ccde3f8c93a450268aff8fe8fb9d422b08a772ef,0,0,0,0,0,0,0,0,0,0,0,0,0,0,62,0,0,0,0,0,0,0,0,0,0,100
be116404b8bd4bb0314c72182b50e3e5951d17dc,0,0,0,0,0,0,0,0,0,0,0,0,0,0,4,0,0,0,0,0,0,0,0,0,0,100
4a3e83cb963978425b975a4ff7e6895b748c0e20,0,0,0,0,0,0,0,0,0,0,0,0,0,0,1,0,0,0,0,0,0,0,0,0,0,100
5edb36a33240663ba1e62b86261559857071fbe2,2,433,0,433,2,0,2,1,1,0,1,2,0.995806102,0,5,0,47,0,47,2276,0,2276,14,0,14,99.56101844
b2b3beb233bee81f1604f3dea514eb6fe96d8b1d,4,160,3,157,2,0,2,2,6,3898,1,2,1.62926451,170,4,0,34,28,6,1290,957,333,15,10,5,99.39077459
5262f075159215aff7ab3d1be89d27779f5dbf30,4,557,0,557,3,0,3,1,3,993,1,2,1.783507616,95,5,1,46,4,42,1747,290,1457,24,4,20,95.5311973
c39313da6d9aa49808c0c93004eb6455c0808dff,1,4,4,0,0,0,0,2,2,0,1,1,0,81,63,0,9,9,0,326,326,0,5,5,0,100
ca459d73d63985846dfdff8045a0770471a24e09,0,0,0,0,0,0,0,0,0,0,0,0,0,0,64,1,0,0,0,0,0,0,0,0,0,100
1d50a8e0ce5a0d6be5c525ed0b004fb0aeb07de9,0,0,0,0,0,0,0,0,0,0,0,0,0,0,65,2,0,0,0,0,0,0,0,0,0,100
3e79e10cb38fa187f7434bd26dafe14842438901,0,0,0,0,0,0,0,0,0,0,0,0,0,0,66,1,0,0,0,0,0,0,0,0,0,100
42378d031f886c97e12093041cc213efcf1e7fc5,0,0,0,0,0,0,0,0,0,0,0,0,0,0,6,0,0,0,0,0,0,0,0,0,0,100
b52b1fe782f30dac917042a08f677c87003c731d,0,0,0,0,0,0,0,0,0,0,0,0,0,0,67,2,0,0,0,0,0,0,0,0,0,100
7d4fb64b1b1379020b340d2e045315ed5a8bac23,1,15,19,4,0,0,0,3,3,3453,1,1,0,82,68,3,10,11,1,452,430,22,3,3,0,100
df4b39fcdeb3b896361ad4831b139f22ef2a8cda,0,0,0,0,0,0,0,0,0,0,0,0,0,0,69,4,0,0,0,0,0,0,0,0,0,100
a73f884c10deefb4ba546ed84c3a138faaef81ac,0,0,0,0,0,0,0,0,0,0,0,0,0,0,70,5,0,0,0,0,0,0,0,0,0,100
fa5c15a205979bf51b137d5a3215a582d8d4e584,1,19,15,4,0,0,0,2,2,570,1,1,0,78,65,0,11,10,1,430,452,22,3,3,0,100
9bbf2a2bba6d7bec208391a0df8ee1bd2ca240f7,1,15,19,4,0,0,0,3,3,3453,1,1,0,82,72,6,10,11,1,452,430,22,3,3,0,100
e0e5065e7a3314fa40342becb935c92707422159,0,0,0,0,0,0,0,0,0,0,0,0,0,0,73,7,0,0,0,0,0,0,0,0,0,100
4ee7f466dd4f96a4f3fad4477b612b3181b64c25,0,0,0,0,0,0,0,0,0,0,0,0,0,0,74,8,0,0,0,0,0,0,0,0,0,100
678a26082754d77d7aff8d1eada6afb6f88a41e9,0,0,0,0,0,0,0,0,0,0,0,0,0,0,75,9,0,0,0,0,0,0,0,0,0,100
d4afac6d5fc5e79bbbe3747b294a3e054c214f11,0,0,0,0,0,0,0,0,0,0,0,0,0,0,76,0,0,0,0,0,0,0,0,0,0,100
105fa711a1c4f921850cc61ce934705c04212a0a,0,0,0,0,0,0,0,0,0,0,0,0,0,0,77,0,0,0,0,0,0,0,0,0,0,100
1304bdff0b3da5e584e07ea6193df07c6e4407d3,0,0,0,0,0,0,0,0,0,0,0,0,0,0,78,1,0,0,0,0,0,0,0,0,0,100
ee5d8c177693ef87d73cb51b8017a8bace0dbec9,0,0,0,0,0,0,0,0,0,0,0,0,0,0,79,2,0,0,0,0,0,0,0,0,0,100
16451421b0113b902a42e7b53124c333dd31bac6,0,0,0,0,0,0,0,0,0,0,0,0,0,0,80,3,0,0,0,0,0,0,0,0,0,100
93e9fa50a053d4f0e09fbbd16584c15d375355b0,0,0,0,0,0,0,0,0,0,0,0,0,0,0,81,4,0,0,0,0,0,0,0,0,0,100
0c5826cb827039946ccf3f190359dd8b0a2a1260,0,0,0,0,0,0,0,0,0,0,0,0,0,0,82,5,0,0,0,0,0,0,0,0,0,100
7c252eae97dd3c0883f1ac0944b318f300b325a1,0,0,0,0,0,0,0,0,0,0,0,0,0,0,82,5,0,0,0,0,0,0,0,0,0,100
e73a7242573aea337ef1efa1b3b20916ee001ab9,0,0,0,0,0,0,0,0,0,0,0,0,0,0,84,7,0,0,0,0,0,0,0,0,0,100
d090b4b011e06aff35ea851c3c7a87167b837f6c,0,0,0,0,0,0,0,0,0,0,0,0,0,0,85,8,0,0,0,0,0,0,0,0,0,100
d624e0737cd6378d6d0fee583f64efa60cc976db,1,3,0,3,0,0,0,2,4,2641,1,1,0,33,86,0,4,4,0,221,221,0,2,2,0,100
c406e6115dfd7162e15ee6f88f73310ab8878ccc,1,0,3,3,0,0,0,2,3,759,1,1,0,33,83,0,4,4,0,221,221,0,2,2,0,100
73989cfa6cced0a57bb5bda436976a0e9bfbbda6,1,3,0,3,0,0,0,2,4,2641,1,1,0,33,88,2,4,4,0,221,221,0,2,2,0,100
8dae166c0f755a07a65cfa371f3da2d32993de65,0,0,0,0,0,0,0,0,0,0,0,0,0,0,89,3,0,0,0,0,0,0,0,0,0,100
a0d1366d5c3a0beecf07f551d7eaf682b7adfdf1,1,39,1,38,0,0,0,2,3,4517,1,1,0,370,7,0,33,31,2,2118,2046,72,13,11,2,100
17f034a076835e956a4efab7fbc3c7bf4102033f,0,0,0,0,0,0,0,0,0,0,0,0,0,0,90,4,0,0,0,0,0,0,0,0,0,100
1e69bf12d2448512af243e9cb438fec928bf36b4,2,11,8,3,0,0,0,4,6,1798,1,2,0.297472249,251,91,4,40,40,0,1326,1326,0,22,22,0,100
857cf164c30883d739c4895c9a9c758880526435,2,397,0,397,2,0,2,1,1,0,1,2,0.77664761,0,8,0,46,0,46,1256,0,1256,21,0,21,99.67266776
8bccf5b0967e0c780355513b17cfe66fb0e3efbf,0,0,0,0,0,0,0,0,0,0,0,0,0,0,0,0,0,0,0,0,0,0,0,0,0,100
c4b5cc8ff55a0d63f6874401d47f8138ea0734fc,0,0,0,0,0,0,0,0,0,0,0,0,0,0,1,1,0,0,0,0,0,0,0,0,0,100
f7ec4c7adef5e3b80117333cfbda416eea710e9e,0,0,0,0,0,0,0,0,0,0,0,0,0,0,2,2,0,0,0,0,0,0,0,0,0,100
e81ea8666467fb89ceba37465e5905b9674633f9,2,39,5,34,0,0,0,1,5,1552,1,2,0.266764988,297,9,0,42,41,1,1795,1691,104,22,21,1,100
0d0842719c1ecc8b9569d076f7fc1656cc3f36a8,0,0,0,0,0,0,0,0,0,0,0,0,0,0,3,3,0,0,0,0,0,0,0,0,0,100
183e434401063799dfe986d65628fb3166d4396a,0,0,0,0,0,0,0,0,0,0,0,0,0,0,4,4,0,0,0,0,0,0,0,0,0,100
3e52d11f75956ac3e6d2384816affeba565ab61d,0,0,0,0,0,0,0,0,0,0,0,0,0,0,10,0,0,0,0,0,0,0,0,0,0,100
1d9c58e2185e9752e9236777de17ba35814b071a,0,0,0,0,0,0,0,0,0,0,0,0,0,0,11,0,0,0,0,0,0,0,0,0,0,100
466b9fe1ce749e64fedafe11bfc2d6f5e6bbb926,0,0,0,0,0,0,0,0,0,0,0,0,0,0,5,0,0,0,0,0,0,0,0,0,0,100
cd9ca3f15e5b0f8888a9daf5f59e42aa6745bdd5,0,0,0,0,0,0,0,0,0,0,0,0,0,0,0,0,0,0,0,0,0,0,0,0,0,100
a05782f96dde826a1e950cd8a935ec6aac9dde6b,0,0,0,0,0,0,0,0,0,0,0,0,0,0,12,0,0,0,0,0,0,0,0,0,0,100
c95685fd079d9152e108a6417039f9b426d69abf,0,0,0,0,0,0,0,0,0,0,0,0,0,0,92,0,0,0,0,0,0,0,0,0,0,100
40e25e469eb40419a367d032b6f8adcbc829bfdf,0,0,0,0,0,0,0,0,0,0,0,0,0,0,93,1,0,0,0,0,0,0,0,0,0,100
bddee303d9e233d050728327b0835c4769c39b01,0,0,0,0,0,0,0,0,0,0,0,0,0,0,94,0,0,0,0,0,0,0,0,0,0,100
90f42640f55e744c65706f7d995d36912ae0288c,5,104,109,5,0,0,0,3,6,4392,2,3,1.36774322,636,95,0,76,77,1,4541,4537,4,36,37,1,100
19dd986cf784dafd088a35aaecd5c66b86e0d49a,0,0,0,0,0,0,0,0,0,0,0,0,0,0,96,0,0,0,0,0,0,0,0,0,0,100
a697117793df3f5462500a0d2e229b8726d4ea18,0,0,0,0,0,0,0,0,0,0,0,0,0,0,97,1,0,0,0,0,0,0,0,0,0,100
8b517984e3af31387af53e0414379ea1798e1d10,0,0,0,0,0,0,0,0,0,0,0,0,0,0,0,0,0,0,0,0,0,0,0,0,0,100
55b6d19e1f47aa455e9e92a6fc3543d62abc55d3,0,0,0,0,0,0,0,0,0,0,0,0,0,0,98,2,0,0,0,0,0,0,0,0,0,100
75509a1ddeb02b4fb532b9ad9146844c358db2d6,4,121,106,15,0,0,0,2,4,2511,1,3,1.72302017,542,99,3,117,117,0,3171,3179,8,51,51,0,100
a8cfb367502dff0fbac293bd8486b01ab5b1f51e,0,0,0,0,0,0,0,0,0,0,0,0,0,0,100,0,0,0,0,0,0,0,0,0,0,100
f79f300ee7b1a9dd5872410961fefdf2174134db,0,0,0,0,0,0,0,0,0,0,0,0,0,0,0,0,0,0,0,0,0,0,0,0,0,100
d1f198e065e5a1c326334d448dcfb7afc6c7c8ae,0,0,0,0,0,0,0,0,0,0,0,0,0,0,0,0,0,0,0,0,0,0,0,0,0,100
af79454721bab3c0b45a163ccceadc5579161d2a,0,0,0,0,0,0,0,0,0,0,0,0,0,0,0,0,0,0,0,0,0,0,0,0,0,100
c886053fcee10d9a1dd98c028c6313a63edacdd0,0,0,0,0,0,0,0,0,0,0,0,0,0,0,13,0,0,0,0,0,0,0,0,0,0,100
4a49fb59abae388e205fbf652ed39907f3c25e62,0,0,0,0,0,0,0,0,0,0,0,0,0,0,14,1,0,0,0,0,0,0,0,0,0,100
09a68527f5921e026c04e8e9940ef0466b41a7c0,0,0,0,0,0,0,0,0,0,0,0,0,0,0,15,2,0,0,0,0,0,0,0,0,0,100
c7a7e7fc184ccfe6bf1b5062411d3ea665f684e5,0,0,0,0,0,0,0,0,0,0,0,0,0,0,16,3,0,0,0,0,0,0,0,0,0,100
4cd8f5dd4299dd29423254e3dc7da68aa6adbb56,0,0,0,0,0,0,0,0,0,0,0,0,0,0,17,4,0,0,0,0,0,0,0,0,0,100
fc00a01485e7028b17fdfcc7cdd8235ab133177d,0,0,0,0,0,0,0,0,0,0,0,0,0,0,18,2,0,0,0,0,0,0,0,0,0,100
021061a2cc11fd95b7b1ac693d4b742c83ebe345,0,0,0,0,0,0,0,0,0,0,0,0,0,0,18,0,0,0,0,0,0,0,0,0,0,100
5d25625a0d777e686d520c982680f3c57cf64e10,0,0,0,0,0,0,0,0,0,0,0,0,0,0,20,2,0,0,0,0,0,0,0,0,0,100
70ed409d03e61e799ff82d1be72177857e931b77,0,0,0,0,0,0,0,0,0,0,0,0,0,0,21,1,0,0,0,0,0,0,0,0,0,100
a7b722efdd6eea06d7461518e53cc512ff0c2547,0,0,0,0,0,0,0,0,0,0,0,0,0,0,0,0,0,0,0,0,0,0,0,0,0,100
5a275cd91e5dbd4361c7f1a7b261470f38965769,0,0,0,0,0,0,0,0,0,0,0,0,0,0,22,0,0,0,0,0,0,0,0,0,0,100
42687bb7c2d8ed7d525adfd0bf8f83a2c3d2f0b7,0,0,0,0,0,0,0,0,0,0,0,0,0,0,1,0,0,0,0,0,0,0,0,0,0,100
56b3caccd25be65b618219eac7693af515859689,0,0,0,0,0,0,0,0,0,0,0,0,0,0,23,0,0,0,0,0,0,0,0,0,0,100
8289c627fad10516b9cc3560ae279b607936bed3,0,0,0,0,0,0,0,0,0,0,0,0,0,0,2,0,0,0,0,0,0,0,0,0,0,100
1a7b710a1e672ea246491ddab1c469073cece9c0,0,0,0,0,0,0,0,0,0,0,0,0,0,0,24,0,0,0,0,0,0,0,0,0,0,100
4d663b1f47e21b0535f07370e97424fb2cabce12,0,0,0,0,0,0,0,0,0,0,0,0,0,0,3,1,0,0,0,0,0,0,0,0,0,100
274e9d9957fd81a12883c97f0f5efa3379395e98,0,0,0,0,0,0,0,0,0,0,0,0,0,0,25,1,0,0,0,0,0,0,0,0,0,100
e33b15a0fde1578a5e51407b78fb71ea410696e9,0,0,0,0,0,0,0,0,0,0,0,0,0,0,26,2,0,0,0,0,0,0,0,0,0,100
b01d2cf739d5d9d854321f6e1f7d850afac5152f,0,0,0,0,0,0,0,0,0,0,0,0,0,0,27,0,0,0,0,0,0,0,0,0,0,100
670feb3bdad2c39d3243e12f6d3ca83669101046,0,0,0,0,0,0,0,0,0,0,0,0,0,0,1,0,0,0,0,0,0,0,0,0,0,100
d018dadda8ce154b505a198e04b7563afab6da1d,0,0,0,0,0,0,0,0,0,0,0,0,0,0,2,1,0,0,0,0,0,0,0,0,0,100
608dd46b134336a6acfe614cf917a59da414d323,0,0,0,0,0,0,0,0,0,0,0,0,0,0,4,0,0,0,0,0,0,0,0,0,0,100
d20ed8c7ff0b2096f21f697cf9c58e1517029576,0,0,0,0,0,0,0,0,0,0,0,0,0,0,28,1,0,0,0,0,0,0,0,0,0,100
b564cd59c05dc8f27b523ee05867ddfd71d3f63f,0,0,0,0,0,0,0,0,0,0,0,0,0,0,29,1,0,0,0,0,0,0,0,0,0,100
705fda39156b1a3c48754d7115be207339544790,0,0,0,0,0,0,0,0,0,0,0,0,0,0,30,2,0,0,0,0,0,0,0,0,0,100
3bc8f60fb3c57ef95501b466431238658505518b,0,0,0,0,0,0,0,0,0,0,0,0,0,0,0,0,0,0,0,0,0,0,0,0,0,100
4e3661481c2f37a96a5c30285d1d0b1a5d10e3d0,0,0,0,0,0,0,0,0,0,0,0,0,0,0,31,0,0,0,0,0,0,0,0,0,0,100
d1798cae64f108d178589409a1ef74feeb55a32f,0,0,0,0,0,0,0,0,0,0,0,0,0,0,0,0,0,0,0,0,0,0,0,0,0,100
e0e9e6c20444ac17dc15ff513abf1805db14de57,0,0,0,0,0,0,0,0,0,0,0,0,0,0,0,0,0,0,0,0,0,0,0,0,0,100
a304691ea16cb47711546658663bdc7833de5635,0,0,0,0,0,0,0,0,0,0,0,0,0,0,32,0,0,0,0,0,0,0,0,0,0,100
32257d8333a79390a0db9ee52d87bc1d1c94da05,0,0,0,0,0,0,0,0,0,0,0,0,0,0,33,1,0,0,0,0,0,0,0,0,0,100
96b83a8eaaf026fea20f64c8c7e04851fa0c4ce5,0,0,0,0,0,0,0,0,0,0,0,0,0,0,34,0,0,0,0,0,0,0,0,0,0,100
0b4d1327bcedee9da12c4c74412de2595f69ec27,0,0,0,0,0,0,0,0,0,0,0,0,0,0,0,0,0,0,0,0,0,0,0,0,0,100
649955e1eab9ddf51e77017a648e1b75c9b909e6,0,0,0,0,0,0,0,0,0,0,0,0,0,0,1,0,0,0,0,0,0,0,0,0,0,100
e4f3359f4463b1f5b42aa62c9e7aff6cd641fcf1,0,0,0,0,0,0,0,0,0,0,0,0,0,0,35,0,0,0,0,0,0,0,0,0,0,100
98d7508aa5e62483745375735186173d79c309bb,0,0,0,0,0,0,0,0,0,0,0,0,0,0,36,1,0,0,0,0,0,0,0,0,0,100
992e126eada0829cd2c75b6cac8da582e8194067,0,0,0,0,0,0,0,0,0,0,0,0,0,0,5,0,0,0,0,0,0,0,0,0,0,100
2719ed7f072de002524c59b5c9e95318ce3fabff,0,0,0,0,0,0,0,0,0,0,0,0,0,0,37,2,0,0,0,0,0,0,0,0,0,100
25aebbd6a48f616e7bd8b571cecb24ef6dc1d9f1,0,0,0,0,0,0,0,0,0,0,0,0,0,0,1,0,0,0,0,0,0,0,0,0,0,100
06160824d0aea8e3f6e6f2df3103210aff77a82e,0,0,0,0,0,0,0,0,0,0,0,0,0,0,38,0,0,0,0,0,0,0,0,0,0,100
6f383e0a88d8940b24bfe9e82e174b67fe9fc970,0,0,0,0,0,0,0,0,0,0,0,0,0,0,39,1,0,0,0,0,0,0,0,0,0,100
460ac2a3f2be8964d04cb8cded15bf7af119526c,0,0,0,0,0,0,0,0,0,0,0,0,0,0,40,1,0,0,0,0,0,0,0,0,0,100
c8923ccf3be3fa7760c62b870efa7354b606441a,0,0,0,0,0,0,0,0,0,0,0,0,0,0,0,0,0,0,0,0,0,0,0,0,0,100
6ec53f2a499b0f19f6fb56de338d6ecde046e763,0,0,0,0,0,0,0,0,0,0,0,0,0,0,41,0,0,0,0,0,0,0,0,0,0,100
41f1a91b0febd163e134948c5cb5f290a3d7198e,0,0,0,0,0,0,0,0,0,0,0,0,0,0,0,0,0,0,0,0,0,0,0,0,0,100
