CommitID,FileNum,TotalAddLines,TotalDeleteLines,LC,FileAdd,FileDelete,NAD,NDEV,NUC,AGE,NS,ND,Entropy,LT,EXP,REXP,CommitComplexity,LastCommitComplexity,CFC,CommitTokenCount,LastCommitTokenCount,NCC,CommitMethodNum,LastCommitMethodNum,NMC,a2a
44e178d742832d9a757f48e6ea195ffda6c9cd9f,8,372,15,357,0,0,0,1,2,0,2,3,2.760794446,36,3,3,28,0,28,1194,256,938,26,0,26,90.24390244
f2cd1c48f637fe1b05fe8a67ad5b112243af9fe3,1,47,0,47,0,0,0,2,3,0,1,1,0,93,0,0,9,9,0,452,452,0,9,9,0,100
dad2222fcf41bd9f328959b68a2df414ec48aa37,1,31,12,19,0,0,0,2,4,0,1,1,0,93,1,1,9,9,0,569,452,117,9,9,0,97.61904762
5eafc8a8f92410e2f2a0efbe18ed493b4bd8f6d5,0,0,0,0,0,0,0,0,0,0,0,0,0,0,2,2,0,0,0,0,0,0,0,0,0,100
5df8aec84baccf1c812073dd345063679c7cfee8,1,7,2,5,0,0,0,3,5,2,1,1,0,101,0,0,10,9,1,583,569,14,9,9,0,100
e3eb6da8d6610387fcaccb6c4aece2100cbcd151,4,94,82,12,2,0,2,1,3,2,1,3,1.525565088,177,4,4,19,16,3,1008,891,117,19,15,4,87.23404255
157243e16e0216f649d003b560d1b79a45b4ba58,1,81,7,74,0,0,0,3,7,0,1,1,0,92,5,5,10,9,1,592,455,137,9,9,0,98.07692308
47f319ade70aa610d5d081f2309db6f13f236fc1,1,1,1,0,0,0,0,1,1,0,1,1,0,27,6,6,1,1,0,77,70,7,1,1,0,92.30769231
cc0caa2687a80c11cb55a60a2780366080827cd4,24,1906,112,1794,14,0,14,0,5,0,2,7,4.019599807,421,1,1,134,30,104,4678,1479,3199,124,27,97,40
e203c131486754fbad8d273916ba68601008ebb6,4,87,1,86,2,0,2,1,7,1,1,3,1.320876965,177,2,2,20,16,4,1152,891,261,19,15,4,95.57522124
d071e85811157d94c598ccb2e0aa441c0e17babb,1,1,2,1,0,0,0,3,8,0,1,1,0,107,3,3,10,10,0,585,592,7,9,9,0,100
6ba96c9520ef30b627768a70beb87aaf2cd3d30e,1,1,0,1,0,0,0,3,9,0,1,1,0,106,4,4,10,10,0,585,585,0,9,9,0,100
6cd0b1146a80657dc3cf9a718cc0e435adead0a6,1,1,1,0,0,0,0,2,2,2,1,1,0,27,5,5,1,1,0,77,77,0,1,1,0,100
a9dae49096fc97296010771ff009c9f9e680eb23,3,64,19,45,0,0,0,1,4,0,1,2,1.511215508,155,6,6,22,18,4,1049,820,229,14,13,1,100
d9517e8b5c66913f6c3c01f5e7ceaf97872bb74e,1,1,0,1,0,0,0,3,10,1,1,1,0,106,7,7,10,10,0,585,585,0,9,9,0,100
3158eb208c9e29c2e6ca9648c6f8c10c758e78a0,0,0,0,0,0,0,0,0,0,0,0,0,0,0,8,8,0,0,0,0,0,0,0,0,0,100
b14cc37a11d28a96e3c0c24f17872227ceca535c,0,0,0,0,0,0,0,0,0,0,0,0,0,0,9,9,0,0,0,0,0,0,0,0,0,100
5e74b82175c2a378cec1d654c48de495227c8239,1,1,1,0,0,0,0,2,3,0,1,1,0,27,10,10,1,1,0,77,77,0,1,1,0,100
f683330ca8b7f38523ccebde49322a889807c19d,1,1,1,0,0,0,0,2,2,2,1,1,0,27,7,7,1,1,0,77,77,0,1,1,0,100
3dd5e3689c29c5d53a434d2ba5ac73235147a210,1,1,1,0,0,0,0,2,3,0,1,1,0,27,11,11,1,1,0,77,77,0,1,1,0,100
5c0d6febc75ec61fbf77c9fb1d11adc1881c6323,1,37,16,21,0,0,0,1,3,0,1,1,0,62,12,12,8,8,0,445,455,10,5,5,0,100
ff38b1fc68ec1e9021171ddea6b244b1382f189b,4,144,89,55,0,0,0,1,5,0,1,2,1.729256212,234,13,13,27,25,2,1275,1107,168,18,16,2,95
aed10c25e06df78b4097d52664cc2159d4f11930,0,0,0,0,0,0,0,0,0,0,0,0,0,0,14,14,0,0,0,0,0,0,0,0,0,100
3a37d62b55e768dc3492ff21d1966a6963774c4a,5,250,202,48,0,0,0,3,11,2,2,3,1.571930324,358,15,15,40,34,6,1907,1841,66,30,25,5,95
c23934b438dde4c287d774126871c6df337afc87,1,17,11,6,0,0,0,2,7,0,1,1,0,92,16,16,14,13,1,487,469,18,8,8,0,100
ecb5efb15b73501057b1df375c6ad8e1b4dcc032,9,36,28,8,0,0,0,2,12,0,2,6,2.854476665,574,17,17,67,64,3,2801,2770,31,53,52,1,100
c5a1c0886465150294ae000586969995b10b0624,2,9,14,5,0,0,0,3,13,16,1,1,0.987692509,156,18,18,13,14,1,729,756,27,12,13,1,100
0920f4442a4e9ef705d7366c83c9e6ac1dbd0ded,6,59,55,4,0,0,0,3,14,12,2,4,2.197538841,414,19,19,41,42,1,2072,2012,60,31,31,0,100
861447c465180dd6fca19da7d3f7e0a8cae8d0fc,2,186,0,186,2,0,2,1,1,0,2,2,0.751032417,0,20,20,7,0,7,530,0,530,7,0,7,95.12195122
7de014e040d8f2b6ba909fa8c693537fe2c99539,1,1,0,1,0,0,0,1,2,0,1,1,0,90,21,21,6,6,0,494,494,0,6,6,0,100
d685f5cb527106f12320274cec19a3de22bef560,3,51,9,42,0,0,0,2,10,6,1,2,0.917901846,197,22,22,23,21,2,1045,921,124,16,14,2,96.875
c7d7ada3e4dd1026400dfa0894a44e8e367f2944,3,11,12,1,0,0,0,2,11,0,1,2,0.513185179,212,23,23,23,23,0,1027,1045,18,16,16,0,100
b2fcc486cd96059a64b8923b433a16bd2090707a,14,168,79,89,0,0,0,1,11,25,1,2,2.213347729,589,24,24,106,100,6,3143,3040,103,100,95,5,99.21875
d49a5ad030e05dadf632b3b6b4c4e164a47a9830,18,2042,3,2039,16,0,16,1,8,0,2,4,3.762059338,155,25,25,115,11,104,4312,865,3447,109,11,98,75.15151515
a6ae87891b8a66fc17400b56b8ec57ad98e4fbfd,17,149,122,27,0,0,0,1,12,0,1,3,2.291821735,716,26,26,119,117,2,3979,3947,32,108,106,2,100
9efd35e4a443b2d2c2798e68c592262659cae5d8,4,216,0,216,4,0,4,1,1,0,1,2,1.978266919,0,27,27,6,0,6,541,0,541,6,0,6,92.16589862
a1c4dbf3dc366e1bfa16a8dcac43cae50848abe9,0,0,0,0,0,0,0,0,0,0,0,0,0,0,28,28,0,0,0,0,0,0,0,0,0,100
9c7846f0aa05573d4de7b4f469b4638de0ba66ae,2,6,2,4,0,0,0,1,2,4,1,1,0.811278124,75,29,24,6,5,1,241,235,6,6,5,1,98.27586207
67c7af8a28b3dd938d4113a8174ee1a34b8d8063,0,0,0,0,0,0,0,0,0,0,0,0,0,0,30,25,0,0,0,0,0,0,0,0,0,100
3626d24178d1c972ab3992461c5a4e5d66fbec61,30,455,2122,1667,2,0,2,1,4,0,1,3,4.267292203,1136,31,15,121,215,94,3472,6368,2896,117,206,89,77.38693467
338ebff0be9f1920107f96b2e3ca651c75489622,2,64,28,36,0,0,0,1,6,13,1,2,0.615253891,98,32,14,7,5,2,695,479,216,7,5,2,98.79518072
88401c9f2678e37d89d972414f1e50b90e7ef899,4,26,3,23,0,0,0,1,9,15,1,4,1.931402878,189,33,15,18,15,3,1139,1023,116,15,12,3,100
9369777be3b7b551072398668f9d6c6eebe96cef,1,1,1,0,0,0,0,3,15,29,1,1,0,116,34,16,12,12,0,689,689,0,9,9,0,100
7b15778707d72d606276ce83454feb582dba321e,7,197,5,192,3,0,3,1,16,4,2,6,1.966059411,263,35,17,32,21,11,2139,1349,790,29,18,11,91.22807018
1ab77db70184fd412f98a828309faa26646f4ea2,3,30,28,2,0,0,0,1,17,0,1,2,1.233230506,227,36,18,21,22,1,1216,1214,2,18,19,1,100
9ba33a72be65a57a15a9f7f06b9da492dff229b3,8,145,79,66,1,0,1,1,5,13,1,5,2.727122643,268,37,11,18,16,2,1439,1303,136,18,16,2,95.53072626
3608243b8d6f0996b377e433c2154161f247b9d9,1,27,0,27,1,0,1,1,1,0,1,1,0,0,8,0,0,0,0,39,0,39,0,0,0,97.83783784
ea66c1586adc08a25be097018fa07248ae047909,3,41,62,21,0,0,0,0,13,28,1,2,1.428565419,179,38,11,18,19,1,751,827,76,12,12,0,97.31182796
3508dd03aaf182db6c461a822b5582a9ddd16f87,1,27,0,27,1,0,1,1,1,0,1,1,0,0,39,12,0,0,0,39,0,39,0,0,0,97.86096257
c9ee19ba9a8d53548a5cd5fc31fa63e40efc9a03,40,92,93,1,0,0,0,1,1,0,2,14,4.911696949,1887,9,1,212,240,28,8914,19760,10846,196,240,44,18.27411168
86598ce4103f77670d25c6fabd55824488e9293c,10,275,35,240,4,0,4,1,2,0,2,8,2.708792974,419,10,2,58,38,20,3071,2325,746,41,29,12,94.85981308
310d9c6bcb1d60d43064f54097a5c69bf4339f0b,1,1,1,0,0,0,0,2,3,0,1,1,0,22,40,11,0,0,0,39,39,0,0,0,0,100
c3651abe09354ffeb12cdfd7c4a8044b1aaf2a51,2,117,112,5,0,0,0,2,2,6,1,1,0.749010165,76,41,12,18,18,0,424,417,7,17,18,1,100
33dab9e0e5707590f26be99e33894a420fe78b06,2,142,0,142,2,0,2,1,1,0,1,1,0.900979971,0,42,11,10,0,10,417,0,417,8,0,8,97.81659389
37b018f8ceaf871b9471958e9e30d14a8d60def3,0,0,0,0,0,0,0,0,0,0,0,0,0,0,43,12,0,0,0,0,0,0,0,0,0,100
2e4485e3e5dba595977b7cbcba483840863e5083,3,62,12,50,1,0,1,1,2,0,1,2,1.534290552,97,44,13,11,10,1,594,417,177,9,8,1,99.15254237
4b8bb5e3e1b1ef845a6075f2163be939d8e3ab64,12,453,263,190,1,0,1,0,3,6,2,7,2.860764169,386,11,3,73,40,33,2837,1406,1431,49,33,16,93.16239316
4393efa54ad11f9e4fcb9bdb77156a963827ee78,5,309,112,197,3,0,3,1,2,2,2,3,2.060429625,76,12,4,29,18,11,1018,417,601,26,18,8,97.0464135
6a68a41d14a58cb6631443ee0a02e6769d2d2920,10,105,390,285,2,0,2,1,3,0,1,8,2.457550528,449,45,8,13,55,42,831,2420,1589,9,31,22,94.69387755
c796a2cc40a24f3c74456f28605a71210f587506,8,390,3,387,2,0,2,1,3,6,1,6,1.911487188,171,46,9,55,11,44,2420,388,2032,31,7,24,96.38554217
779a101f1231bea94fd764489519b8b1e756041f,5,270,64,206,2,0,2,1,3,12,1,2,2.142694924,139,47,10,33,11,22,1166,594,572,31,9,22,97.66536965
24a9814b9a6822254113ca3261868c347748e9fa,1,7,8,1,0,0,0,2,4,20,1,1,0,174,48,11,23,23,0,1234,1238,4,11,11,0,99.61832061
1981f0050bd821fe87513f29e545d3e2a702f62e,8,241,31,210,1,0,1,2,3,24,2,5,2.477764976,446,49,12,71,50,21,3434,2196,1238,45,36,9,94.27480916
b5baefbdbe4ab3bb319dbdcdd116bb527a1929e1,1,4,0,4,0,0,0,2,4,5,1,1,0,177,50,10,22,21,1,1371,1335,36,9,9,0,100
13170c93114520e53fd399c3fa598ea1c8973a9e,1,4,2,2,0,0,0,2,3,6,1,1,0,62,51,11,4,4,0,327,317,10,4,4,0,100
70513a130ac4d9a2e4af1851ffa227051e810257,1,4,3,1,0,0,0,2,4,0,1,1,0,64,52,11,4,4,0,323,327,4,4,4,0,100
8d2f0649abaeb01fc0e78b6979b8c84c9aced7e0,5,75,3,72,0,0,0,2,4,39,2,5,1.657796482,371,53,4,47,41,6,2298,1924,374,35,33,2,98.47328244
c7c2d9f814e3a823c1ad065d8b9232c09766096f,6,28,59,31,0,0,0,1,5,36,1,5,1.978249274,319,54,4,24,24,0,1545,1829,284,18,18,0,92.5
f82aed86c6076c31773f68ed3758ff01651d359b,59,4491,0,4491,59,0,59,1,1,0,1,5,5.625127431,0,55,5,423,0,423,15317,0,15317,376,0,376,64.12776413
9ddadfd2331bf937cbc3971254035d0d799e28fd,27,198,28,170,2,0,2,1,5,7,1,10,2.875460654,1299,56,6,202,198,4,7423,6691,732,191,192,1,84.58646617
b774bae22c9f0b7083c0c243ba23fa99fe97f112,2,60,1,59,0,0,0,1,2,0,1,2,0.349184374,109,57,7,18,14,4,740,630,110,18,14,4,100
99cd8ac3a26a3787b240b87a806ffb00bfb8ab4a,19,393,51,342,3,0,3,2,5,3,2,12,3.622772122,1262,58,8,177,150,27,9232,7471,1761,118,111,7,95.8781362
bd57a93fb4ad5007451baeef5a683a03b36a01e1,1,4,10,6,0,0,0,2,4,44,1,1,0,58,13,0,9,11,2,269,273,4,3,5,2,100
29a9f5996bbd7b31b9cca66d2a29399009921f70,0,0,0,0,0,0,0,0,0,0,0,0,0,0,14,1,0,0,0,0,0,0,0,0,0,100
465fea38a555937638d8994ae9bc626d40139829,28,282,261,21,0,0,0,2,6,0,2,11,4.102802149,1787,59,9,222,231,9,10738,10611,127,177,192,15,90.14084507
12516720c8ab985953a3afcd638a7fbc201eda77,1,1,14,13,0,0,0,1,4,1,1,1,0,149,60,10,30,34,4,729,796,67,30,32,2,100
4397fc340bd75d060aa73bbc3a7f2adcfbbd03d6,13,231,86,145,3,0,3,2,7,0,3,8,1.945573648,697,15,2,63,46,17,4743,6662,1919,38,27,11,91.47005445
833907011afaa6828c93554b4858bf9fa4e6fe75,2,109,62,47,1,0,1,2,6,1,2,2,0.972966127,160,61,8,14,12,2,1215,1075,140,12,10,2,95.63636364
725130f26a18f81c6d167ed6b3f374c6259fe1c3,1,2,2,0,0,0,0,2,6,3,1,1,0,111,62,9,11,11,0,616,620,4,8,8,0,100
65aa079bc94307e1264e08b3eff4f4b17eaf80f3,20,142,273,131,0,0,0,1,5,0,1,4,3.99407691,1155,63,10,203,193,10,7053,7008,45,166,166,0,99.12587413
72db7ed3cc552a505dd098a4d45d159a249d1b6c,1,13,1,12,0,0,0,2,8,9,1,1,0,175,16,3,23,22,1,1431,1317,114,9,9,0,100
c4a4c2d0ba5728a2c3cd526beca43ae9f4ff3ca5,1,1,1,0,0,0,0,2,2,11,1,1,0,66,64,11,4,4,0,271,254,17,3,3,0,100
92e99f57e5ec8e6e62b9765eebdad09f74efe5ff,2,9,5,4,0,0,0,2,9,6,2,2,0.591672779,316,17,4,34,34,0,2431,2362,69,15,15,0,100
86e07ad5194f864e676b2be61b9d628832f62e3f,5,49,6,43,0,0,0,2,10,3,3,5,1.906377131,611,65,12,69,66,3,4325,4129,196,47,44,3,100
58fee6d8d10d13d62219fd3fabcaac7c95de9b73,10,463,225,238,5,0,5,2,11,2,3,5,2.926188503,409,66,13,53,39,14,3484,2735,749,28,17,11,95.90443686
ae494c1dc241373575878710c7e6e09eba5a4d65,2,524,0,524,2,0,2,1,1,0,1,2,0.94937388,0,0,0,52,0,52,2908,0,2908,35,0,35,99.33110368
93099070e2110d875505ecb4dc73794a3108fcde,2,16,16,0,0,0,0,1,2,0,1,2,0.337290067,393,1,1,52,52,0,2908,2908,0,35,35,0,100
e5a77ef7ecafbbe6b571528d65731ed51e30592c,9,338,602,264,0,0,0,2,12,7,4,7,2.219954108,1044,67,14,87,111,24,5739,7097,1358,46,72,26,99.00662252
f0d458cfc12e5d106f646cd83db8c48bb4774040,2,524,0,524,2,0,2,1,2,0,1,2,0.94937388,0,68,15,52,0,52,2908,0,2908,35,0,35,99.3442623
a279ce477f8d017c0e3752e859ae0c5002a84d86,7,78,338,260,0,0,0,2,11,2,3,5,1.582345179,857,2,2,59,87,28,4189,5739,1550,37,46,9,99.67105263
c0da90ec3d5b5ec23c7ff5fd22c8eb8ea6265d47,7,338,78,260,0,0,0,2,12,8,3,5,1.582345179,651,3,3,87,59,28,5739,4189,1550,46,37,9,99.67105263
c6a6843e00c357f2a0efd50136a3d5665e02b01c,6,323,366,43,1,0,1,2,3,1,2,2,1.864728691,463,4,4,42,39,3,2988,2938,50,22,21,1,98.05194805
c28017e0abb9af0f91d6be0c1538109cfa113187,1,236,252,16,0,0,0,3,13,2,1,1,0,223,5,5,31,31,0,1698,1721,23,10,10,0,98.86363636
37893f7003ddc34af3508007d81bc8243d2805b4,4,60,15,45,0,0,0,2,4,8,2,3,1.371308791,407,69,16,48,44,4,3053,2803,250,23,23,0,100
ca1e2f6fc333801d90bdad6884c615831ccb1c1b,3,50,26,24,0,0,0,2,9,0,2,2,0.848197879,444,70,17,47,46,1,3286,3085,201,27,26,1,100
5ff15e8d97014e6f5deafb729f52a7f165471283,1,5,5,0,0,0,0,2,6,0,1,1,0,247,71,18,28,28,0,1921,1914,7,11,11,0,100
9f667caedb794aa5fe53f63e6cb2c22f0ea46773,10,163,227,64,1,0,1,2,8,10,3,7,2.721940912,832,6,6,74,75,1,5273,5562,289,47,47,0,98.6970684
f83d1f018611808fc99a144e1bf49e1372c8f3fa,5,91,22,69,0,0,0,2,9,0,3,3,1.211724404,563,7,7,60,55,5,4318,3860,458,35,34,1,100
6b68f48362c9db92ac7a8af4911f81d487bf6165,1,154,150,4,0,0,0,3,10,0,1,1,0,168,8,8,16,15,1,1141,1083,58,14,13,1,98.68421053
adb0f12ae605a5bcfccc5bb753198bc845ceb3b6,1,9,5,4,0,0,0,1,2,0,1,1,0,51,9,9,11,7,4,326,270,56,4,4,0,100
33addcf05a3cc550f40343e7e2aabdcb60686a33,2,34,73,39,0,0,0,2,7,0,2,2,0.230162741,368,10,10,40,41,1,2631,2859,228,19,19,0,100
f973c89bd14429924d9e619021d7baa58be5faf0,2,5,5,0,0,0,0,2,8,2,1,1,0.970950594,248,11,11,27,27,0,1780,1792,12,11,11,0,100
d0f2662944c66c5397186ad4128a7bef732d3d5f,0,0,0,0,0,0,0,0,0,0,0,0,0,0,12,12,0,0,0,0,0,0,0,0,0,100
98cf291b509b3f90aa5817ffb0126a6c0ba476ba,1,65,8,57,0,0,0,1,3,6,1,1,0,236,13,13,53,40,13,2151,1753,398,33,24,9,100
a51e4e9110b13c62ba8703a701bc52af03fa0af7,0,0,0,0,0,0,0,0,0,0,0,0,0,0,72,11,0,0,0,0,0,0,0,0,0,100
3def7dfc8b942d545705432981f772e62222b92c,7,708,530,178,2,0,2,1,14,23,3,5,2.35573845,937,18,3,138,130,8,7446,6757,689,77,74,3,97.52883031
2cca8667263fe2da704b15983bad9dca255aac30,1,65,8,57,0,0,0,1,3,6,1,1,0,236,19,4,53,40,13,2151,1753,398,33,24,9,100
88b602945154c1c83e7cc617f23a647b538035bf,20,7,1197,1190,0,0,0,1,5,34,1,6,3.872676141,783,73,11,17,138,121,741,5064,4323,9,104,95,90.14336918
dd5f701cfd78b0512efdd0d8be523257f78dfb99,13,1252,0,1252,13,0,13,1,1,0,1,4,3.511726912,0,74,11,64,0,64,2872,0,2872,55,0,55,93.76218324
dd10a2c3f24e940ad1154c6d9ab6b9af081a360a,1,47,12,35,0,0,0,1,2,128,1,1,0,36,20,4,5,2,3,349,123,226,3,2,1,100
e3de68a920d6c7bcf3e8a60764d1cd00581bb8e1,13,481,453,28,4,0,4,3,15,5,4,6,2.962179459,1091,21,5,128,145,17,7417,8977,1560,67,73,6,86.33776091
2d8ac98edaeed3a5c9bfb6ab913efccd967d6ec2,12,261,54,207,3,0,3,2,7,19,1,6,2.999586934,627,75,12,93,75,18,4687,3414,1273,74,68,6,92.22423146
f296e7aa483f2cb480e4a460ea78079e820a7f69,19,343,354,11,1,0,1,1,7,0,3,9,3.407646965,1238,22,6,160,142,18,7260,7721,461,123,103,20,90.8438061
9e73bc6d802dd7be611d6ebb78a95bb677bb5e3f,12,259,52,207,3,0,3,2,7,19,1,6,2.975933953,627,23,7,93,75,18,4695,3414,1281,74,68,6,90.57591623
59eedbd1efe54f96b05f6c4593b8e566f38c9955,10,103,298,195,0,0,0,1,8,1,3,5,2.19430131,976,76,13,88,124,36,5168,6002,834,65,91,26,96.77966102
a61b9c68e96c1e8c022bc39194f36a5838fd3966,8,291,95,196,1,0,1,1,7,0,3,4,2.002620499,543,24,8,87,51,36,4269,3449,820,57,31,26,96.77966102
34150b6e39326201b17474b35b67c88f25f54205,9,98,294,196,0,0,0,1,6,1,3,5,2.086172399,742,77,14,57,93,36,3647,4470,823,37,63,26,96.77966102
3aeb6d22f371d99318f3e18230d78cc455d7d149,8,291,95,196,1,0,1,1,7,0,3,4,2.002620499,543,25,9,87,51,36,4269,3449,820,57,31,26,96.77966102
84ef9f47ea0837150cf3eb258de388397a2401eb,9,97,293,196,0,0,0,1,6,1,3,5,2.064569022,742,78,15,57,93,36,3647,4467,820,37,63,26,96.77966102
517461942052494b709659aa8d9f2917da8e1ba4,1,3,3,0,0,0,0,1,5,0,1,1,0,36,79,16,6,6,0,201,198,3,6,6,0,100
c19eef1c7b20dc0a87601cd4c76fddb54ac1c317,8,291,95,196,1,0,1,1,7,0,3,4,2.002620499,543,26,10,87,51,36,4269,3449,820,57,31,26,96.77966102
144906993bc08d1f64f4dec48c44532406742893,0,0,0,0,0,0,0,0,0,0,0,0,0,0,27,11,0,0,0,0,0,0,0,0,0,100
6c57d17379de98ced5f1f6aa942f64d6b0e11b53,2,12,12,0,0,0,0,2,5,2,1,2,0.918295834,120,28,12,9,11,2,750,740,10,9,9,0,100
af42519a7e89d170adf6764a7ee6adb5e923ffe9,10,139,316,177,0,0,0,3,9,2,3,5,2.452119803,909,80,17,64,98,34,5509,5942,433,41,67,26,96.77966102
223d9d42c1be30d8788dd4dcae17ff1ce1d58f5f,1,1,1,0,0,0,0,1,4,0,1,1,0,76,81,18,2,2,0,525,525,0,2,2,0,100
a426c14873f000cf28adaa5a928336735a4df69b,9,293,96,197,1,0,1,2,8,14,4,5,2.048822712,583,82,19,86,52,34,4466,3636,830,58,32,26,96.77966102
da10da03efb3d4dbe4c3454919d0921d0fa9a2ea,7,109,107,2,1,0,1,1,9,4,4,4,2.347178609,562,29,13,56,57,1,4008,4446,438,29,32,3,99.33993399
fa2ff5009681964b4b5d4de4167a8d7cb42e647b,4,49,29,20,0,0,0,2,11,37,3,3,1.384444781,293,30,14,16,16,0,2552,2155,397,13,13,0,100
dee3fd173a8f36b914aa45ba3057322810d0a1c5,4,77,19,58,0,0,0,3,13,30,3,3,1.219588127,656,31,15,85,74,11,4872,4432,440,39,38,1,100
9958bbea0d88b858520d5fc02180e2a4494d89ac,7,326,84,242,2,0,2,3,16,1,3,5,2.095218268,877,32,16,128,111,17,7436,6177,1259,67,53,14,87.28522337
459349a67df4972b0aa4822c38d18a53be7caeec,16,291,501,210,0,0,0,2,15,7,4,11,3.273202927,1778,83,19,173,191,18,11008,11867,859,96,107,11,86.56987296
23fcbe4d0d28a6f27aac05f8ebd336783de6d073,9,403,103,300,2,0,2,3,16,14,3,6,2.498219442,986,84,20,148,120,28,8281,6582,1699,75,60,15,85.43165468
9af82c9c9ed3aa07c11cc7edbdbac172d6e788ec,1,15,12,3,0,0,0,1,4,0,1,1,0,88,33,17,12,12,0,507,475,32,4,4,0,100
a0e79f528ddf93bb97798d27f635a1aeb00291ac,0,0,0,0,0,0,0,0,0,0,0,0,0,0,85,21,0,0,0,0,0,0,0,0,0,100
59ba4a512fb20f69dd5b3ff1751f3abf0ed10306,1,1,1,0,0,0,0,3,17,0,1,1,0,292,86,22,40,40,0,2041,2041,0,16,16,0,100
e455ef382ecddcfa05f8a8540107bd91077e83ab,6,340,154,186,3,0,3,3,18,1,2,4,2.213926558,659,87,23,81,70,11,5403,4681,722,46,38,8,95.76719577
af65fce98075309c88c596d0a8196f4b237ce103,5,120,13,107,1,0,1,3,19,2,2,5,1.53342067,841,34,17,108,94,14,6550,6049,501,56,52,4,94.40677966
7da7fde9320bbd3f3872a6a73e85da72581b9235,1,2,4,2,0,0,0,3,20,0,1,1,0,230,88,23,35,35,0,1586,1599,13,14,14,0,100
b9faacfec13903ab91ee008125f649819928ca65,1,1,1,0,0,0,0,3,21,0,1,1,0,228,89,24,35,35,0,1590,1586,4,14,14,0,100
1a2d6c5fa2471efa31c886bc53724d18a478d2d1,4,149,7,142,1,0,1,3,21,0,2,4,0.831137594,657,35,17,82,70,12,5543,4735,808,50,41,9,98.86178862
1736596b2042c0a785e3697d0ce264acdcf7028d,1,1,1,0,0,0,0,3,23,0,1,1,0,228,36,18,35,35,0,1590,1590,0,14,14,0,100
8c7b2cb9c55c6623640c5223ecea6fa65fa24078,1,3,3,0,0,0,0,1,2,0,1,1,0,78,37,19,15,12,3,461,449,12,3,3,0,100
c917077691e9d69856587280005a01fd11441304,3,62,30,32,0,0,0,3,20,0,2,3,0.60150718,682,38,20,68,64,4,5103,4919,184,43,40,3,100
60e5cf84f0d22d6159a5918fe4e8ba9522518c6b,79,2574,3454,880,23,0,23,3,21,0,3,14,5.885194336,3244,90,25,271,457,186,15270,22066,6796,195,364,169,70
f1bc807ea663a2ff17bd947d92b2bdc5b73cee77,0,0,0,0,0,0,0,0,0,0,0,0,0,0,91,26,0,0,0,0,0,0,0,0,0,100
920450a1fcdfef57588f2d53751ad4433bf42e53,1,8,1,7,0,0,0,1,3,2,1,1,0,115,39,21,11,10,1,802,751,51,8,8,0,100
50b9508a5ebf25ce245419a145b8183d45b6c321,9,136,62,74,0,0,0,3,22,1,3,5,2.77277116,1150,92,26,86,81,5,9809,9017,792,62,60,2,98.72727273
81f7645c0be18fb696a51a0f8530381f41e04615,1,8,1,7,0,0,0,1,3,2,1,1,0,115,93,27,11,10,1,802,751,51,8,8,0,100
7089d93f909328d63ff7f332b90cb9779084eb9f,1,2,2,0,0,0,0,1,2,8,1,1,0,121,94,28,11,11,0,801,789,12,5,5,0,100
e85d619cd4c5d3545313537d0d895a2846f5924e,29,723,1154,431,0,0,0,3,24,28,3,16,3.969883144,2756,14,14,263,258,5,17734,18843,1109,156,169,13,94.07407407
e5dcf6ee6caf6a7d1a51fdafa9707b87eb78d202,7,86,60,26,0,0,0,3,24,1,2,4,2.321383154,998,15,15,93,89,4,8412,8062,350,52,50,2,97.51908397
248d65af0f2d63421c4ab38b4200a4f96172b293,4,39,9,30,1,0,1,3,13,6,1,2,1.391339014,197,16,14,39,37,2,1568,1501,67,13,11,2,96.53179191
1155014a1c5e3c70dac0f518c69cfa52a4c7cde7,1,2,2,0,0,0,0,1,4,35,1,1,0,283,17,13,53,53,0,2153,2151,2,33,33,0,100
7c2fa8f539be089fb90444e44554e2f7e13af3f0,2,5,2,3,0,0,0,2,4,9,2,2,0.985228136,395,95,23,80,80,0,3111,3106,5,39,39,0,100
d02333496fe8241ef9f7ea276dcc0ad24a081da7,33,895,1528,633,4,0,4,3,25,16,5,19,4.270789315,2771,18,4,291,331,40,17305,19846,2541,152,176,24,88.03088803
a150eece9d2699bc44ab7c11fc00cb657559b122,0,0,0,0,0,0,0,0,0,0,0,0,0,0,19,5,0,0,0,0,0,0,0,0,0,100
563ff4986e7ec90abf15a106f149638804292144,1,5,1,4,0,0,0,1,2,2,1,1,0,248,20,6,37,36,1,2301,2255,46,14,14,0,100
9e5edce2e50eda3c62e488d36eabe583f001cc7b,2,2,2,0,0,0,0,3,6,2,2,2,1,149,21,7,15,15,0,977,977,0,11,11,0,100
a42525c9dbef8e2d90a612bd398abe48487ebacd,13,500,20,480,8,0,8,1,25,8,4,6,3.233555344,927,40,2,129,92,37,8833,7074,1759,76,54,22,91.92439863
d6dc80da82465638a163e7a84eff62dd7708a104,2,32,11,21,0,0,0,1,2,0,1,2,0.999609836,140,41,3,12,11,1,861,722,139,7,6,1,100
7d1aa987e739fa7245838f5d1b75a789be5a0f16,3,7,3,4,0,0,0,3,8,0,2,3,1.370950594,397,42,4,52,51,1,3273,3227,46,25,25,0,100
23b18b00b7da016974544d82c3a21687f8dd7cd2,12,15,518,503,0,0,0,0,24,1,3,5,3.134823312,1286,22,8,82,121,39,6761,8673,1912,46,69,23,91.92439863
e6193ed359f3a4664308144f7854598fec07521f,11,518,13,505,8,0,8,1,25,6,3,4,3.110856633,601,23,9,84,45,39,6372,4428,1944,55,32,23,91.92439863
1db284219351913bba1d765b7b9031a37712f9d4,13,454,177,277,1,0,1,3,26,15,3,9,2.755139834,1576,24,10,207,161,46,15904,13174,2730,108,96,12,93.08072488
0ef3d1ecacbc08b80ea6afa525e9640b1ede83ed,0,0,0,0,0,0,0,0,0,0,0,0,0,0,25,11,0,0,0,0,0,0,0,0,0,100
2afbb761c8d290287a9b51666fc4f17d722bad22,6,731,1,730,4,0,4,1,2,8,3,5,1.925743629,158,43,3,103,17,86,4945,988,3957,60,14,46,96.37305699
a5973e525a62f3223d47b6bec647378ab594c6cf,3,19,9,10,0,0,0,1,19,0,2,3,1.378783493,520,26,12,76,72,4,4617,4559,58,32,31,1,100
65a82f2e9c30d52a3ab09ad2c9d51b12b56393e8,4,26,100,74,0,0,0,1,20,3,3,4,1.025375268,920,27,11,139,149,10,7798,8496,698,47,48,1,100
0b82645de5e22c90c5901135a6273633e2ada621,6,114,41,73,1,0,1,1,18,9,3,4,1.701155087,926,44,4,156,150,6,8864,8187,677,53,53,0,99.65986395
5720464108d3ee0581c2c6a7d9124edcfa4b0370,4,192,147,45,0,0,0,2,9,8,2,3,1.268197502,492,45,5,58,55,3,5096,4869,227,28,25,3,99.83050847
9d9314bc0f904a432e613a5d088f327251d23d09,5,41,105,64,0,0,0,2,20,2,3,4,1.466599084,908,46,6,141,147,6,7504,8144,640,46,46,0,100
4f54ac9bc8b2c116ee81b36a6a6422c2bc0370eb,59,7410,208,7202,52,0,52,2,8,0,2,9,5.487000295,671,96,1,443,64,379,17324,5879,11445,380,32,348,75.57436518
cc86c32bcde135c7a2038d0fcba4662a5ac4fc5d,52,0,7256,7256,0,0,0,1,2,0,1,3,5.394146699,2101,97,2,0,382,382,0,11717,11717,0,351,351,76.72727273
09b7ea1a7ce68852e068a3b3e72143c3a2830dcb,0,0,0,0,0,0,0,0,0,0,0,0,0,0,98,3,0,0,0,0,0,0,0,0,0,100
5dda610ec9dffd4503de53e10036528a5c9ca1e3,4,200,146,54,1,0,1,3,9,4,2,3,1.266543558,494,99,4,61,58,3,5144,4880,264,29,26,3,99.65986395
8440c07da21c0b5f68651f89758ffeef57ea1f0b,19,351,80,271,3,0,3,2,10,11,5,11,2.930409945,1374,47,7,175,125,50,11388,10074,1314,95,59,36,88.63261944
f4fe7bbc552d10677cbf61b1e486e027823fe548,4,8,8,0,0,0,0,3,7,0,2,4,2,260,48,8,11,11,0,2428,2436,8,10,10,0,98.07692308
88d9766b070bed7d47367695eb3b0b3fc0256321,3,63,2,61,1,0,1,1,8,7,3,3,0.395060465,203,49,9,25,22,3,2280,2048,232,16,13,3,98.51239669
507fbef13ac4bf83ebc49228e78f7e013fce8688,5,33,12,21,0,0,0,1,10,0,4,3,1.992274554,658,50,10,75,76,1,5822,5632,190,38,37,1,100
4b6107e8c45aff8008445faa69f22549510028b1,1,3,2,1,0,0,0,1,5,1,1,1,0,173,51,11,19,19,0,1297,1286,11,13,13,0,100
8447203dbba8fd650865e6656b995a94147f78ca,4,56,8,48,0,0,0,1,11,0,3,3,1.574549592,585,52,12,73,67,6,5495,5221,274,36,33,3,93.89179756
5da6569bc77ec777d5f2b6cb25d310cb39591a9c,28,708,821,113,2,0,2,3,21,54,2,10,3.922893462,1535,100,4,263,249,14,11796,10570,1226,173,190,17,91.5904936
f303f0f6e08ff75f64fa70f1ff5c17f8c4fb78dc,0,0,0,0,0,0,0,0,0,0,0,0,0,0,101,5,0,0,0,0,0,0,0,0,0,100
09275bf33682234d4bcb79282f0ab2e35e68dc7c,0,0,0,0,0,0,0,0,0,0,0,0,0,0,102,6,0,0,0,0,0,0,0,0,0,100
23d47ee5fd51278af36ed8f12836018521f50ba2,39,1411,797,614,2,0,2,3,27,2,7,18,4.445548227,3220,53,13,431,407,24,25303,22558,2745,287,255,32,89.67391304
b563180f64a845d0e20f3da206e11757b9138ca9,28,708,821,113,2,0,2,3,21,54,2,10,3.922893462,1533,54,14,261,247,14,11781,10555,1226,173,190,17,86.52094718
2be0d859530684fc3729ffa348bae5060bdde50e,1,1,1,0,0,0,0,3,28,0,1,1,0,541,55,15,35,35,0,4425,4420,5,25,25,0,100
5062036d2a1ca37158cbf9591475d51c6c79815f,3,37,31,6,0,0,0,3,29,0,3,3,1.468333691,916,56,16,86,87,1,7404,7319,85,47,47,0,100
4d073b63d4dc557d71fcef828d0b7f7e20860a93,5,552,4,548,2,0,2,3,22,0,1,4,1.323290086,637,103,7,125,74,51,9283,5448,3835,61,29,32,98.31144465
b5d47de8510bb1695a23c1089532a93b4e6d38e1,1,33,4,29,0,0,0,1,7,3,1,1,0,187,57,17,26,22,4,1655,1373,282,15,15,0,87.73424191
1faee8d8902d48ab3530ea2af6fc47518ba782f6,6,123,13,110,0,0,0,3,30,3,2,4,2.151122969,1183,104,8,134,118,16,10489,9684,805,61,56,5,96.67194929
1f7782ab3d7ee07ae0942618ecf74e6785a70990,7,249,213,36,2,0,2,1,2,2,2,2,2.373142289,275,105,9,38,27,11,1720,1029,691,34,26,8,96.80511182
996afbd9a9ba669d1b5a88b28c524beaf86d91c8,1,58,3,55,0,0,0,1,2,2,1,1,0,40,106,10,7,2,5,482,155,327,3,2,1,100
cb465c858b10055987973f2826c4187d6860e438,10,420,239,181,1,0,1,3,12,10,5,6,1.860093332,1148,107,11,168,154,14,10796,9388,1408,77,68,9,99.20255183
2c37d47117828d745a4cb830885fd205822ac190,0,0,0,0,0,0,0,0,0,0,0,0,0,0,108,12,0,0,0,0,0,0,0,0,0,100
f1b18bdd982d5762679148ecda066baa651942e9,33,1530,1060,470,8,0,8,1,31,11,6,12,4.192451897,3298,28,8,470,387,83,28736,24806,3930,228,187,41,85.98820059
3ec42fbc1e7823f69cfa6b0ed3e45baa53575980,18,759,487,272,4,0,4,3,14,2,5,8,3.244650542,1429,29,9,211,183,28,12907,10630,2277,112,96,16,96.84499314
98045063b21c5dbb758a4fe900353ba1774ece90,13,51,68,17,0,0,0,3,24,16,2,8,3.373734826,1731,109,13,248,248,0,14206,14220,14,139,139,0,99.45280438
9e12a0d06880b494e97ff327c0922b086eae455e,11,707,17,690,9,0,9,1,6,8,1,4,3.144533568,86,58,15,72,5,67,3534,416,3118,50,3,47,89.7680764
9b9f083a04a38d3e1dc2d4861674f14fde46581f,2,2,3,1,0,0,0,1,3,0,1,2,0.970950594,146,59,16,14,14,0,901,912,11,8,8,0,100
9c41b68316f64f22f2b12210882afa6833ef54b7,2,13,8,5,0,0,0,2,10,2,2,2,0.591672779,573,30,6,93,93,0,4707,4706,1,36,35,1,93.9869281
b88b7dc976ae851f4321e4df20b56605a943d9cb,4,16,20,4,0,0,0,2,27,63,2,3,1.729573959,852,60,17,132,132,0,6545,6527,18,52,53,1,93.9869281
7e094f7f67d212e1af91c1bbd7127bc6c14b64b2,1,2,1,1,0,0,0,1,5,0,1,1,0,43,61,18,6,5,1,214,206,8,3,3,0,100
a1cfd0e4af7d582dc5e1ae0f27321795b52a70a5,1,2,2,0,0,0,0,2,6,0,1,1,0,44,0,0,6,6,0,214,214,0,3,3,0,100
a54b83419869a6dd2e9272e8d6623286d135086b,2,13,8,5,0,0,0,2,10,2,2,2,0.591672779,573,1,1,93,93,0,4707,4706,1,36,35,1,93.9869281
5b06943272791cf3570851f039ae68228974f510,3,8,10,2,0,0,0,1,26,36,1,2,1.382102253,342,31,7,52,53,1,2233,2258,25,26,26,0,100
be9541a74b96a5d495e7cc58331066bf779d734b,2,9,7,2,0,0,0,3,27,1,1,2,0.988699408,275,32,8,40,39,1,1847,1820,27,17,17,0,100
4602184f24f9cbf2c8777782774cfa5050afa1ce,12,690,472,218,1,0,1,1,16,3,5,6,2.898051428,1276,110,14,188,155,33,11897,10284,1613,101,90,11,98.23899371
3d00cdd6b080d01f645fbf0bc4143282c182460f,14,544,691,147,4,0,4,3,28,0,6,7,3.11518204,1632,62,19,176,209,33,11678,13119,1441,95,106,11,89.93464052
35b9794ddb02a3753492187b6c2d33e4bba5e593,1,1,1,0,0,0,0,1,2,6,1,1,0,65,63,20,13,13,0,413,411,2,9,9,0,100
cb404bf5f8ab438df59206ee4d494dea0261fb67,5,89,88,1,1,0,1,1,27,1,3,3,2.096686452,679,33,9,119,108,11,5161,5039,122,44,41,3,91.67750325
998f6bbf29a0618300ebff2766340efff5d218a7,3,72,1,71,2,0,2,3,28,1,2,2,1.291781906,233,34,10,34,34,0,1807,1633,174,14,14,0,91.461837
889ddf7f06feb05f301d0d5d37c81fd65cfd770e,1,5,5,0,0,0,0,2,12,0,1,1,0,406,35,9,80,80,0,3316,3301,15,27,27,0,100
a8bdd480e96677ad6fc9a1fb5d3341889d842a77,1,1,1,0,0,0,0,1,3,3,1,1,0,65,36,10,13,13,0,415,413,2,9,9,0,100
63a2abfeee81ba3d57d70a89c18450976600ca07,11,689,471,218,1,0,1,3,16,4,4,5,2.884731091,1211,111,15,175,142,33,11486,9871,1615,92,81,11,98.11574697
ff76bf685862899b50fcc7eb6039bdad9ee49ab0,9,378,355,23,0,0,0,2,17,4,5,6,1.877591115,1664,112,16,236,228,8,13456,12875,581,115,112,3,99.1902834
c0aadfe2c054aff80bea3de237b8d72d59af09af,2,320,0,320,2,0,2,1,1,0,1,1,0.965201699,0,113,17,22,0,22,1745,0,1745,11,0,11,99.46236559
c63b7b6c4f16b71215da25ef1b8dfcccae4037a0,0,0,0,0,0,0,0,0,0,0,0,0,0,0,114,18,0,0,0,0,0,0,0,0,0,100
c5a3dc29673bee5ea23b6e09ee75518ffe03f367,2,10,0,10,0,0,0,3,18,0,2,1,1,468,115,19,66,64,2,4512,4448,64,19,19,0,100
4922c78851419ba7b04534c69905ad0cd8611820,2,4,4,0,0,0,0,3,19,0,2,1,1,474,116,20,66,66,0,4532,4512,20,19,19,0,100
ccd555773e5c96e21850c543cfb7551f59abb0a0,1,8,8,0,0,0,0,2,11,1,1,1,0,296,117,21,45,45,0,2307,2318,11,24,24,0,100
8712deff2ffbeeb35ce30ed5869225a2f04233ae,1,3,0,3,0,0,0,3,20,0,1,1,0,258,118,22,40,40,0,2574,2538,36,9,9,0,100
777cc762c999447b8beee0e0ce43827a6d7b1466,22,1304,1430,126,7,0,7,1,15,1,6,11,3.844447362,2684,64,20,343,384,41,20778,22484,1706,174,182,8,95.47270306
6be3755cd238e27db93d2c2b086724796ad786af,18,1427,781,646,4,0,4,1,20,1,6,9,3.54629981,2133,65,21,372,306,66,21448,17865,3583,177,152,25,96.44736842
c88a658e1f1cfda86ddc467dede7192b9cdb954b,1,1,1,0,0,0,0,2,7,0,1,1,0,271,66,22,40,40,0,2122,2122,0,17,17,0,100
a4a90e0804923b786cf035b918d8e033911f2d34,68,1024,533,491,6,0,6,2,22,0,5,18,3.010079411,3101,119,23,546,485,61,20915,22451,1536,363,172,191,66.23544631
887f655426d85ed6e668840a7f88cca7cc106731,5,522,2,520,4,0,4,2,7,0,2,4,1.455561261,272,120,24,87,40,47,5815,2124,3691,42,17,25,98.85931559
9cc2d6f9d59491f1bc6215555a491bbea6ab3655,4,7,6,1,0,0,0,2,5,0,2,2,0.391243564,157,121,25,16,15,1,562,621,59,12,11,1,94.24379233
a92fc38c82b83f7b17f2a14e27cf5cf008a09b37,3,19,9,10,0,0,0,3,21,5,2,3,0.589626181,641,122,26,91,89,2,5244,5200,44,47,45,2,100
de2e399fb67f82b8b36a647f6b0e46ec0ef2ff78,95,1019,3088,2069,3,0,3,1,28,5,8,28,4.615629997,7186,33,5,828,909,81,39486,49613,10127,508,490,18,67.38428418
ed72f4f9b3d7d320edd4f28f79091d89a81c10f3,85,3047,788,2259,16,0,16,1,30,0,8,24,4.358608151,4711,38,10,975,616,359,46046,31905,14141,567,343,224,69.08163265
bc80fae476d8cd0df171a564fd1a8354f8bac09d,31,43,233,190,0,0,0,3,28,2,7,13,3.555540359,2791,123,23,391,426,35,18689,19964,1275,235,253,18,97.95121951
d9c1fde6797795c494ba7a92318c461aa9b5f3d9,1,1,1,0,0,0,0,3,23,0,1,1,0,260,124,24,40,40,0,2592,2592,0,9,9,0,100
680de0ed8d642c816aaaa623d7c1dcf349e0a550,29,230,40,190,0,0,0,3,30,5,6,11,3.459691112,2248,39,11,376,341,35,16642,15358,1284,239,221,18,97.95121951
6cfd9fe2c0d1b6cfefa00e7f1c10730141035e47,32,139,231,92,1,0,1,3,28,2,6,14,3.686634708,2550,67,20,358,389,31,16992,17479,487,229,246,17,97.55142018
ed11221abf67028ef3380333155ad4eb8397ad2e,5,122,174,52,0,0,0,0,24,2,2,4,1.462006619,559,125,25,61,62,1,4186,4849,663,24,20,4,99.58762887
8b67ffb1332e6105a3a933a8d29fb4fed2616596,4,103,5,98,1,0,1,1,15,10,2,4,1.412465901,215,126,26,22,18,4,2257,1460,797,11,10,1,99.58762887
261c4a9f6b79769014747d71cb9457b59782d4e1,29,228,38,190,0,0,0,3,30,5,6,11,3.455377303,2248,40,12,376,341,35,16642,15348,1294,239,221,18,97.93510324
d1bdb548d965b64f465e10e975b3f64c8e3eca83,30,39,230,191,0,0,0,3,28,2,7,12,3.505181125,2504,127,27,352,387,35,15846,17143,1297,225,243,18,97.93510324
e9dd618f10d32f08f7ba8852cc38c86064914e6e,2,42,31,11,0,0,0,1,2,4,1,2,0.181166402,452,128,28,75,76,1,3196,3011,185,32,33,1,100
eeeeb4826169ec9273524be04ef5979de7f29a92,3,16,17,1,0,0,0,1,5,7,1,2,0.654047184,434,129,29,55,55,0,2922,2841,81,41,41,0,100
b94002f696b5760abf91de8344ba5fd445eca8d0,2,31,26,5,0,0,0,1,3,32,1,2,0.918295834,427,130,30,48,48,0,3690,3564,126,30,30,0,100
89d572b8a557f70f7cd746349898d624ba4d12b7,13,738,1062,324,0,0,0,2,25,11,7,9,2.498664219,2498,37,9,337,370,33,19290,20863,1573,134,146,12,95.68181818
4d0adeb79b22f1f6b4731fb4e4366ed2bec35354,2,21,25,4,0,0,0,3,13,0,2,2,0.558629373,272,38,10,43,44,1,2172,2215,43,24,25,1,100
9b7ee57be97890d2c754db0ba4e34bcd013f3c2c,13,1057,729,328,0,0,0,2,24,3,7,9,2.506388137,2223,131,28,370,336,34,20863,19247,1616,146,133,13,95.68181818
124f29124c94afe28675ceb79908b09a74725eaa,22,514,248,266,6,0,6,1,23,11,6,17,3.659380185,2518,2,2,360,327,33,20278,18987,1291,183,170,13,96.44670051
1e7170c408cede595166e98e5ab2939086c77b9f,21,808,1076,268,0,0,0,2,25,6,8,15,2.894929737,3867,3,3,525,557,32,29553,30646,1093,240,249,9,98.42931937
aa65b287d8a01e6d32050eafa45f4a3b6919226a,14,42,368,326,0,0,0,0,12,13,4,10,3.264825217,1156,39,11,105,140,35,6304,8114,1810,57,74,17,92.94117647
c2c30b74b87b520daffa42f67b2f3842849aab3b,28,224,35,189,0,0,0,3,30,5,6,10,3.37485892,2241,44,16,376,341,35,16602,15317,1285,236,218,18,99.11838791
438b27ffe8dcc67e795ed759cd6b116ca3c8e383,45,2109,1166,943,3,0,3,1,28,2,7,18,3.677712873,4621,132,28,767,695,72,39479,35034,4445,408,376,32,94.67723669
b1009f77db181ded131e8d97b621bfc3eeec5db6,14,730,1058,328,0,0,0,2,25,10,7,9,2.51616401,2577,133,29,347,381,34,19622,21234,1612,142,155,13,95.71106095
e43decc468de0ff531305a5a2817da50e529d190,39,611,1198,587,1,0,1,1,32,4,6,15,3.427907984,4329,45,17,533,563,30,29029,31664,2635,323,338,15,93.39622642
dbb5f99b14e0a6223eb2be7e78d44c0577e36db8,8,1018,214,804,3,0,3,1,16,10,3,5,2.144212846,727,46,18,170,97,73,9939,5821,4118,86,49,37,93.06818182
b4285a57da3ddc2e12170038b51222bd1eeb17e8,2,4,10,6,0,0,0,2,5,1,2,2,0.863120569,463,134,30,63,65,2,3212,3251,39,38,38,0,98.24150059
14b7b9e7f7087354039ba492d1cb5fe0634c9c74,1,8,2,6,0,0,0,1,3,5,1,1,0,270,47,19,46,44,2,1776,1737,39,29,29,0,100
f2eb7a75a7b34301049ba0887ec13a75be5191af,5,190,223,33,0,0,0,1,20,1,4,4,1.405099992,933,48,20,134,138,4,7754,7828,74,53,57,4,98.93238434
c88a74345b6f06ec1f3d63e86f0b25c4674efa3a,1,2,8,6,0,0,0,1,4,0,1,1,0,275,49,21,44,46,2,1737,1776,39,29,29,0,100
3769e7a10a6cf625c337c4ba33d209c8efedaa40,58,1267,1685,418,6,0,6,1,31,6,6,26,4.379443802,6034,4,4,745,777,32,43310,45111,1801,421,446,25,89.95157385
a42c5c147201af3a9b2171c6390a220d4745e447,41,1585,603,982,3,0,3,1,33,4,6,15,3.602283441,3967,5,5,636,526,110,35067,29575,5492,376,321,55,92.19288175
9c6d361cd42fbb95305b10cb204ff19e71315f5d,3,43,19,24,0,0,0,2,27,1,2,3,1.017128664,593,68,10,89,83,6,5577,5434,143,27,26,1,99.89293362
f26e3f6261a14762bb9f14629a682cb12eedfa4a,3,22,59,37,0,0,0,2,19,1,3,3,0.394203354,442,69,11,36,42,6,4539,4843,304,26,27,1,100
e11f2129494dc39b267de0ea4c5a76676e042a2e,4,60,23,37,0,0,0,1,18,3,3,4,0.548564991,546,135,30,64,58,6,5811,5500,311,32,31,1,100
4ec3502792a58bdbc66f02b31de0b7227ad6328e,3,22,59,37,0,0,0,2,19,1,3,3,0.394203354,442,136,31,36,42,6,4539,4843,304,26,27,1,100
b08179fac98ab48e4a058dc33e7aed79b7088f08,4,5,115,110,0,0,0,2,4,9,2,2,1.121575936,187,137,32,15,30,15,502,997,495,11,22,11,96.50273224
09a952df7999a7b0ed305510f5c6b7dc0ea708be,10,498,20,478,7,0,7,1,34,4,1,5,2.996281837,601,138,32,117,80,37,6448,4538,1910,51,32,19,97.91666667
39355e472fc0e146bd4ec0ca436526bdb8d8f3a6,1,14,23,9,0,0,0,1,2,6,1,1,0,60,139,31,6,8,2,217,238,21,4,4,0,100
b93c97ca632f6828ff77af8cc5d97ba07b6e1b81,7,208,198,10,0,0,0,2,21,7,5,4,1.093620518,1152,50,20,186,177,9,9752,9678,74,77,74,3,100
8dce5848e2a419c281ea75776caf29ee7b200923,4,38,24,14,0,0,0,2,35,5,3,3,0.684362895,874,51,21,150,149,1,7519,7485,34,52,51,1,100
5a3994f643048f9224fb06769de89fdda744ea9c,15,854,262,592,3,0,3,2,35,1,6,9,2.646760053,2197,70,12,412,342,70,21174,16801,4373,168,138,30,92.48197734
5f5e9b53e7880b99d3f86e3eed228e81d3fcc1bd,1,0,33,33,0,0,0,1,2,0,1,1,0,190,71,13,40,52,12,1375,1561,186,12,15,3,100
0a25885a929d80a04406a1e53edc3e502588fede,1,0,1,1,0,0,0,1,3,0,1,1,0,164,72,14,40,40,0,1364,1375,11,12,12,0,100
b077849f9ce94cf3b25b0c602e364a4ecac8f73a,9,221,197,24,0,0,0,2,37,6,6,5,1.145268992,1492,73,15,231,221,10,12298,12190,108,95,91,4,100
1da2d1b4d93e4b0b628692b2021553c87719ca46,8,30,612,582,0,0,0,4,35,8,4,7,2.118637771,1910,52,22,252,320,68,10559,14843,4284,88,119,31,92.48197734
3b8971f9a7fedbef6a357da00abbfeb7ac62cc2c,9,616,35,581,3,0,3,4,37,4,5,8,2.194545059,1571,74,14,342,274,68,15822,11527,4295,124,93,31,92.48197734
e216c654466f7540b62d6eefceda2a552d77f11c,1,1,1,0,0,0,0,2,21,2,1,1,0,445,75,15,96,96,0,3852,3852,0,28,28,0,100
fe5d0dc01249d7e50e100e5e4b6556c5ffcc5af5,1,32,11,21,0,0,0,2,22,0,1,1,0,445,53,22,100,96,4,3928,3852,76,29,28,1,100
113c77fdf7aa38dee94e5c206f38b9d2e7c71354,4,32,7,25,0,0,0,3,38,2,3,3,1.579138674,1064,54,23,196,192,4,8769,8544,225,67,66,1,100
119d83384eb0b3c664b02504eeb81d2bdf01ece3,1,57,9,48,0,0,0,2,24,0,1,1,0,453,55,24,110,100,10,4237,3913,324,33,29,4,100
a073a5e3b678ecb75c9f5f1f3000ab096a1d6d88,1,1,1,0,0,0,0,2,25,0,1,1,0,497,56,25,110,110,0,4233,4237,4,33,33,0,100
eb542e2577ae15995b2316ef5ab39ad6e146be73,17,221,750,529,1,0,1,2,35,3,5,12,3.226157818,2679,0,0,365,434,69,15652,19976,4324,138,165,27,91.78644764
85dec22680e86666cc396c099698719719c454fb,11,735,60,675,3,0,3,3,38,5,5,8,2.644809734,1881,1,1,407,321,86,18855,13939,4916,150,113,37,92.52814739
c0c289f39f3f21ef181ae0b7bf1d7265ea2f550d,18,174,323,149,1,0,1,1,37,1,4,11,3.523549367,2369,76,14,350,371,21,16837,17684,847,137,146,9,98.72423945
888b9f310db52573a93ac32b674e41e8035b69c5,10,280,40,240,1,0,1,2,38,5,3,7,2.633874749,1303,77,15,250,215,35,10802,9589,1213,96,80,16,99.31439765
fc6d9de4a5eeab686b9b9b824600cf88c1b10989,8,42,133,91,0,0,0,2,15,1,3,5,2.503790187,945,2,2,119,135,16,6788,7248,460,48,57,9,99.41291585
8cd8a0cee24cd1f70d83c67df8179bcce0e55d94,8,133,42,91,1,0,1,3,16,6,3,5,2.503790187,872,78,16,135,119,16,7248,6788,460,57,48,9,99.41291585
4edcde4113513c4081ff450ef6f2ce1b7ac003f1,3,14,11,3,0,0,0,1,1,0,1,2,0,229,79,17,31,51,20,1285,1962,677,16,21,5,98.61660079
88662ce35f4cb11a914ef9bc2793e49e40c489c7,0,0,0,0,0,0,0,0,0,0,0,0,0,0,3,3,0,0,0,0,0,0,0,0,0,100
af1b3bb4f89517c1e0185ea42f732293722396ac,3,3,2,1,0,0,0,1,28,5,1,3,1.521928095,459,80,18,61,52,9,4210,3619,591,16,11,5,99.2
c215a6ec042b28f9a0f40ad073601f802ae2ab4b,0,0,0,0,0,0,0,0,0,0,0,0,0,0,81,19,0,0,0,0,0,0,0,0,0,100
1766e0ef5316a2e331f10f0c042e106b6872e0b2,1,4,0,4,0,0,0,1,5,2,1,1,0,174,82,20,43,43,0,1479,1426,53,14,14,0,100
f565394c3671bbf6aa4fd61fe92043a44c2cd694,19,78,323,245,0,0,0,1,27,0,4,12,3.570577975,2354,57,24,324,428,104,16793,19582,2789,115,154,39,96.52432969
9b3360138c624f7f83c26579743659fcd43603cb,18,315,70,245,2,0,2,2,28,1,5,12,3.476958414,1658,58,25,248,206,42,13682,11316,2366,101,85,16,96.52432969
ee12033404746411275192b96fc951c2b4b82564,4,67,7,60,0,0,0,4,39,3,3,4,1.917425334,1448,83,19,275,265,10,11170,10820,350,97,94,3,100
947f429d4c9f6abaae736696952d5b345828674e,1,34,0,34,1,0,1,1,1,0,1,1,0,0,84,20,1,0,1,79,0,79,1,0,1,99.40179462
7350e92f6bee5ca0db229153702a848c2c9c21e3,1,7,7,0,0,0,0,2,26,5,1,1,0,497,85,21,110,110,0,4228,4233,5,33,33,0,100
126c2efad4dea90867da41337c091f0697a5991b,8,287,197,90,2,0,2,3,27,16,3,3,1.888234898,1093,86,22,222,205,17,9703,9133,570,72,67,5,96.41393443
2c963b4c3d414edcb9138221300a427dc503e4c2,10,280,353,73,0,0,0,3,27,5,4,3,2.573371979,1294,59,22,220,233,13,10167,10594,427,79,81,2,96.41393443
5a704bfadc802332a7163ecd8ed55908740842fb,17,476,295,181,3,0,3,3,29,13,5,7,3.162418213,2282,87,23,365,345,20,20802,19553,1249,145,136,9,96.22833843
1b7a11d9db9c6c80134ae4770fa13efad053d81f,5,77,65,12,0,0,0,3,29,6,4,2,2.017310046,800,88,24,137,133,4,6526,6422,104,54,51,3,99.79079498
cc5b5c83fdd53e0a48b201e96f82c16c1e8442dc,1,36,0,36,0,0,0,1,2,0,1,1,0,71,89,25,11,9,2,841,515,326,7,6,1,100
75fd41ce3a05ebd109f1118423374794deef653b,8,360,104,256,2,0,2,1,40,12,4,8,2.461774023,1264,90,26,278,230,48,11671,9339,2332,91,80,11,98.36901121
2fda5bf1815566351a09f604f6a482e9efd0c693,2,7,0,7,0,0,0,1,4,13,2,2,0.591672779,108,91,27,18,18,0,625,576,49,8,8,0,100
eb50687ea0622b90b3b9e227d7747a6b930b16d6,9,67,17,50,0,0,0,4,41,13,4,8,2.680181807,2231,92,28,452,439,13,17205,16897,308,148,144,4,100
60c5ed677daceb112cee097585bd0b6c2f631c6f,1,7,1,6,0,0,0,2,32,0,1,1,0,521,93,29,119,118,1,4510,4464,46,34,34,0,100
632e23add3e5821c154679b58704a484d06dd020,1,7,0,7,0,0,0,3,11,0,1,1,0,144,94,30,37,36,1,1203,1146,57,8,8,0,100
92f360d57455ddab8d5ee0127ffe8f7143c8d3fd,1,1,1,0,0,0,0,3,12,0,1,1,0,150,95,31,37,37,0,1203,1203,0,8,8,0,100
cf30082ce6daa114834fa51ce02c119614e234e2,2,11,6,5,0,0,0,1,30,12,1,2,0.977417818,441,96,29,60,60,0,4379,4313,66,16,16,0,100
392b0414ea65a3aea03db95f7b61464793664604,42,1029,1143,114,4,0,4,1,38,4,8,22,4.44055469,5621,4,4,803,852,49,42529,43996,1467,359,359,0,93.77470356
d5786ca4915510c9636aa53c4052f8aa4af9ed00,30,1043,367,676,5,0,5,1,41,11,6,17,3.985392385,4022,5,5,738,625,113,36665,30922,5743,285,245,40,94.61312439
5a8654967cf5db52fb8e137e1b6bd4ee9067fbcd,2,16,3,13,0,0,0,2,31,16,2,2,0.485460761,784,6,6,79,79,0,6343,6279,64,31,31,0,100
21ec01d7ac16f28e2088c55a428d7b847a687363,3,11,1,10,0,0,0,2,3,9,2,3,1.384431504,253,7,7,21,21,0,1504,1427,77,12,12,0,100
c99eadbb26b04f05a43dcc0f6fd4dddfe67fef6c,53,976,1888,912,3,0,3,1,39,6,8,27,4.758300509,7110,59,19,902,995,93,47769,54060,6291,417,456,39,93.5546875
11bf6f92949c9fd46a0f47b1c41950ab7a879f8b,43,1726,468,1258,9,0,9,2,43,6,8,25,4.476397529,5514,61,21,938,789,149,50674,42314,8360,417,352,65,94.4980695
e44310c2e33c5b2a8b8e13b06ecfffbee57e690a,30,288,1219,931,0,0,0,1,41,2,7,17,3.896896978,4671,97,29,531,633,102,29304,34585,5281,251,307,56,98.2473223
f8d998e4fc2931aa0ab3aea2159e66bf780800ef,16,683,98,585,4,0,4,2,31,17,6,11,2.81966541,2062,98,30,275,229,46,19297,16085,3212,158,128,30,99.01477833
b2991255321b18ef20c0d4c0513d58781c171da9,6,50,43,7,0,0,0,2,9,3,2,5,1.763443797,594,8,8,58,57,1,4043,3776,267,32,31,1,98.647343
b2d00b6d4814e118d43836d35078096f40564999,1,10,6,4,0,0,0,4,5,38,1,1,0,62,9,9,7,7,0,325,292,33,3,3,0,100
ff3c663d6b5141c31f1a72fd2130212da47c67e7,1,6,4,2,0,0,0,1,4,0,1,1,0,139,10,10,13,13,0,847,862,15,9,9,0,99.3236715
025d7402d4602ca592894c3aacaadb4d9a6cc402,1,0,11,11,0,0,0,1,5,0,1,1,0,140,11,11,11,13,2,773,847,74,7,9,2,100
0671076f69a5ba30650f0e2156d36d719818b6db,3,145,2,143,1,0,1,1,32,7,2,3,0.434881383,465,12,12,78,71,7,5465,4452,1013,24,19,5,99.70760234
2de2c2873c9a04bcf9ad3cf2d3ee29944000ef22,2,13,17,4,0,0,0,1,33,0,1,2,0.948078244,465,13,13,55,56,1,4488,4524,36,15,15,0,99.61089494
1d16f1ee4f41225d55b31a95ff5fc1c15b8057b1,2,28,0,28,0,0,0,4,13,13,1,2,0.905928216,356,14,14,54,51,3,3252,3060,192,19,17,2,100
7ab3242bed6e908e124d86b404109669f8d83873,0,0,0,0,0,0,0,0,0,0,0,0,0,0,99,31,0,0,0,0,0,0,0,0,0,100
f0b56aa37b54d06c86ce958f69fe5c904b02e24f,1,2,3,1,0,0,0,2,33,14,1,1,0,526,100,32,119,119,0,4500,4510,10,34,34,0,100
943d3222c3b153e40a1a8d2f0867580b95b5e957,34,1462,709,753,7,0,7,2,44,8,7,20,4.145907806,4298,62,19,682,576,106,37259,32805,4454,303,247,56,92.97725025
3220e6a9643ad35d0721bec086194a01925ffd9f,13,234,63,171,1,0,1,2,37,3,5,11,2.669085447,2016,63,20,316,308,8,17717,16337,1380,111,105,6,98.41584158
dd4a31e66c2bfd5a144ac6bb0636a26b5af18d8b,2,13,5,8,0,0,0,2,2,1,2,2,0.764204507,275,64,21,21,20,1,2150,2117,33,21,20,1,100
9b4eaa48921f3e86b67bfe100d5ec3d65605e238,5,24,21,3,0,0,0,3,34,24,4,3,2.244190511,804,65,22,111,109,2,7542,7469,73,51,51,0,100
7ee8838aa51406038c2afc594e3d3dcfadee641e,1,5,0,5,0,0,0,2,4,0,1,1,0,99,66,23,19,18,1,618,604,14,13,12,1,100
75685286cbaafa590458a13a5ecb6399be1223ef,5,134,136,2,0,0,0,2,22,5,2,3,0.80276365,652,67,24,108,111,3,4728,4713,15,53,50,3,100
5b516f7136a87a6f8752b86d84dc038bd0592753,6,141,105,36,0,0,0,4,38,7,4,4,1.615558823,1027,68,18,198,188,10,8542,8316,226,68,67,1,99.11678116
0323bad04ddc143d6a5dd0023be44027f822f549,34,760,1741,981,0,0,0,2,41,1,7,18,4.095506987,5686,15,15,651,775,124,37947,43894,5947,321,390,69,93.7254902
26ba12c2f64e628d95808c5ace7587ae5aaa4f61,32,1665,692,973,7,0,7,2,44,10,7,16,3.96186845,4127,16,16,693,572,121,38926,33001,5925,333,265,68,93.7254902
8f647b20a0fc7d7f10b5e060178a9599fa2a8fc0,3,3,3,0,0,0,0,2,2,93,1,3,1.584962501,123,69,19,3,3,0,727,727,0,3,3,0,100
2a21422997ab7f913a8ce20695f3948c729d14d9,0,0,0,0,0,0,0,0,0,0,0,0,0,0,70,20,0,0,0,0,0,0,0,0,0,100
cd9adf1967e2cf7bb7511bde1dc919d88e8c0556,10,116,143,27,0,0,0,3,39,2,5,6,2.204502095,2103,71,21,320,322,2,18387,18677,290,126,126,0,99.09547739
f26ac5efb176d78123d4f71a8944f98ca101a30e,2,8,6,2,0,0,0,3,40,11,2,2,0.749595257,644,72,22,145,144,1,5678,5647,31,45,45,0,100
0ca764ca35572dbcf43caaa3bb9d88d7c8b26087,14,149,274,125,0,0,0,3,38,14,6,9,2.847346703,2357,17,17,338,349,11,19653,19944,291,140,148,8,98.78787879
c9e87e9716e607f76c2c8e67e22db0a37f897e20,11,123,148,25,0,0,0,3,40,3,5,7,2.370748424,2194,18,18,332,333,1,19125,19384,259,135,135,0,99.08629442
3c85d2ac055acd3dea224ae90ca0aead9471f98d,0,0,0,0,0,0,0,0,0,0,0,0,0,0,19,19,0,0,0,0,0,0,0,0,0,100
75224aeb8811ff2394d3f3f2ea69cb64bf85c191,0,0,0,0,0,0,0,0,0,0,0,0,0,0,20,20,0,0,0,0,0,0,0,0,0,100
ccd0d0a306df7d10b9afc8c1b3df096a4d4692d4,4,152,2,150,2,0,2,1,41,0,3,3,1.161253181,612,73,20,151,138,13,5767,5209,558,49,41,8,99.48612539
527c3a313eef0b9e493aae682899cf25ec936c25,3,1,151,150,0,0,0,1,2,19,2,2,1.075216083,181,74,21,5,17,12,269,819,550,5,13,8,99.48612539
d1d8feeea2e02d7aa2256bf88cad35b77cea9c4d,5,60,67,7,0,0,0,3,45,44,3,4,1.60062069,866,75,20,83,89,6,6576,6692,116,45,45,0,100
b3654ba0306b8759919d24a6f4cd835d7427a611,1,8,2,6,0,0,0,3,9,11,1,1,0,136,76,21,14,12,2,1083,1033,50,6,6,0,100
ed879c384e4bed6172c0aed32e1429eccf19e6ae,7,70,69,1,0,0,0,3,44,16,4,5,1.942657558,1558,21,21,234,231,3,12665,12607,58,87,87,0,100
a141ac5d8f05eba5205de1abc9909d32d05cdd3d,7,69,70,1,0,0,0,3,45,32,4,5,1.942657558,1555,22,22,231,234,3,12607,12665,58,87,87,0,100
bc949555dbf38d7d50b3e38330b7c31bcd888895,1,1,1,0,0,0,0,3,12,35,1,1,0,78,77,20,4,4,0,655,653,2,2,2,0,100
348343fef3a84b7daf7b391f6d7c7a4350edc2df,0,0,0,0,0,0,0,0,0,0,0,0,0,0,78,21,0,0,0,0,0,0,0,0,0,100
ae82e1406fe2d3ce7a527716cc1fb4fe4070d358,2,30,5,25,0,0,0,2,42,2,1,2,0.315997133,631,79,22,142,138,4,5721,5603,118,40,38,2,100
75fc828f424a12c0cf1f1732f33e21d17ec11b9f,2,5,30,25,0,0,0,2,41,18,1,2,0.315997133,646,23,19,138,142,4,5603,5721,118,38,40,2,100
0376ddd3a6c2afb00350e39669db69b0093e7534,2,30,5,25,0,0,0,2,42,2,1,2,0.315997133,631,24,20,142,138,4,5721,5603,118,40,38,2,100
78e3767dde884839675428c64cc158698e64b392,1,1,1,0,0,0,0,2,5,36,1,1,0,74,25,21,8,8,0,354,354,0,3,3,0,100
cf20f1d35568db15ffca64ad56de0762e59c5d03,4,62,60,2,0,0,0,2,9,57,2,4,0.807568976,1247,26,22,156,158,2,8219,8222,3,72,72,0,100
e4aafbfc79e8091c7212d038693e7d72677aa303,6,68,68,0,0,0,0,1,43,6,3,6,1.263594531,1894,80,20,305,302,3,13655,13641,14,113,113,0,100
8dde451deec1bc0c68a73d6f3efa8ba5c5ecd632,5,63,61,2,0,0,0,2,9,53,2,5,0.913659696,1321,81,21,164,166,2,8573,8576,3,75,75,0,100
e7b83a34addfcd583499a583b87a122889413401,1,35,24,11,0,0,0,2,44,0,1,1,0,570,82,21,140,139,1,5091,5079,12,39,38,1,100
1207a8c9b460c4c4500c5c846f6107d02c7416d3,1,4,4,0,0,0,0,2,45,0,1,1,0,574,83,21,141,140,1,5099,5091,8,39,39,0,100
363271af4f6900e6dba735b902d6b5b255aad602,1,8,1,7,0,0,0,3,7,101,1,1,0,44,84,22,8,6,2,265,214,51,4,3,1,100
1260ee40df8fcdfa0339887fdf9e58c79e5b16c5,2,16,7,9,0,0,0,3,14,66,2,2,0.987692509,176,85,23,19,16,3,1389,1340,49,11,10,1,96.63366337
1b76cbc2e1e1849850be3b7fbfa21798fec310dd,1,11,1,10,0,0,0,2,3,2,1,1,0,44,86,24,6,4,2,197,161,36,5,3,2,99.52244508
5be54219e7f7bf22fc9245611216f0db9dd382ef,2,6,4,2,0,0,0,3,46,2,2,2,0.881290899,624,87,25,150,149,1,5398,5364,34,43,43,0,100
be74c7f7d0c00eb791e77d21b6deded18eb5b517,6,542,451,91,1,0,1,2,46,25,2,5,1.240511331,1650,27,15,261,256,5,13198,12835,363,96,94,2,99.61868446
348c66d49726ab0bc1e4dd429eaf7c19c5826b95,2,6,4,2,0,0,0,3,46,2,2,2,0.881290899,624,28,16,150,149,1,5398,5364,34,43,43,0,100
1cf7c7be40492f0975753313efb2daeb12d5d81a,6,447,539,92,0,0,0,2,47,12,2,4,1.191157595,1834,88,26,277,282,5,13497,13888,391,100,102,2,99.61868446
21b5d051a9deca1743b57a5ea38d5aece804ebb4,4,538,445,93,1,0,1,2,46,15,1,3,1.162078904,1024,89,27,112,106,6,7834,7437,397,53,51,2,99.61868446
7e9ee231bf040e24f2e558e7fad3f62d2f6ec71f,4,37,8,29,1,0,1,1,46,10,2,3,1.070214505,787,29,16,182,183,1,6485,6442,43,56,56,0,98.66539561
c68ad2011a2d9315f0c2ab4e08808cf731bfd051,2,2,1,1,0,0,0,1,47,19,1,1,0.918295834,715,30,17,171,170,1,6060,6054,6,49,49,0,100
916b9c84a774b0d7b221a1df91dcabbbbf0e9554,3,26,19,7,0,0,0,1,15,14,2,3,1.172253928,384,31,16,38,37,1,2987,2880,107,16,16,0,100
d8c74da3b9374fc18fd049f730b9db9143021eb7,2,8,1,7,0,0,0,1,4,18,2,2,0.99107606,131,32,17,19,17,2,826,786,40,12,11,1,100
2ea1e5e4d25ddd3075f40c3e8fed199e93230d31,2,6,4,2,0,0,0,1,48,1,2,2,0.468995594,645,33,18,148,148,0,5567,5532,35,41,41,0,100
96b29bdd4a2edaface018c9055fb5bcf0df95678,2,22,15,7,0,0,0,2,6,24,1,2,0.179256067,178,34,19,24,23,1,1157,1125,32,9,9,0,100
8c16d0ddc1ca65110c9a1970c8532e97c7a3c5bd,1,4,1,3,0,0,0,2,4,44,1,1,0,33,35,20,1,1,0,204,171,33,1,1,0,100
463b468cc0427bc56805ca07c6bd2723ae6e1108,1,1,1,0,0,0,0,2,6,2,1,1,0,447,36,21,30,30,0,2897,2897,0,21,21,0,100
478744ffdc4fcb82a917fd0770879fb5f2e135b3,0,0,0,0,0,0,0,0,0,0,0,0,0,0,37,22,0,0,0,0,0,0,0,0,0,100
0c166cfdde0999a3e697ec5f8d3536523f712769,10,392,436,44,0,0,0,5,47,48,6,7,1.035273484,1484,90,25,201,200,1,12286,12221,65,93,91,2,100
b8dc1aefa52664739d5eebd67678494fe14c688c,0,0,0,0,0,0,0,0,0,0,0,0,0,0,38,23,0,0,0,0,0,0,0,0,0,100
c8762ac5b9509aa48dc7ed70dcc6a7a84d449fe8,1,1,1,0,0,0,0,2,6,0,1,1,0,64,91,24,11,10,1,356,349,7,8,8,0,100
d76eec14ac02b1a875451fb63fb95ec04dbdb90f,0,0,0,0,0,0,0,0,0,0,0,0,0,0,92,25,0,0,0,0,0,0,0,0,0,100
949633eca9702dd875ffdc32f03a06c940f8b57d,4,43,11,32,0,0,0,1,16,31,2,4,1.531559002,514,39,24,58,56,2,3864,3661,203,30,29,1,100
9fe72afb37f126fdfb845c445b784c27caee2e5d,1,1,1,0,0,0,0,2,6,0,1,1,0,64,40,25,11,10,1,356,349,7,8,8,0,100
2ea486806789880f225a293a445ef32b202d4f64,1,1,2,1,0,0,0,4,16,0,1,1,0,137,41,26,15,15,0,1199,1224,25,8,8,0,100
9bc8ca5298969e494c826adc9505ebfb4cb0346f,27,409,331,78,0,0,0,2,49,36,6,15,3.570313938,3700,93,24,638,629,9,28750,28484,266,298,296,2,96.41509434
7318a9b4737125d63d57bfb99d44200bc590c4aa,2,18,18,0,0,0,0,1,17,2,1,2,0.309543429,333,42,25,35,36,1,2644,2660,16,14,14,0,100
4e1692f8f396fc00284c2f7bcaff41465633a36c,1,1,2,1,0,0,0,3,50,0,1,1,0,613,43,26,148,148,0,5302,5304,2,40,40,0,100
125fe5e59617142441449849c46bc5509c158382,2,18,18,0,0,0,0,1,16,1,1,2,0.309543429,332,94,25,36,35,1,2660,2644,16,14,14,0,100
e766c4085abceb4ce00d0a392fb79d1caec6efaa,1,1,1,0,0,0,0,1,6,0,1,1,0,109,95,26,19,19,0,733,733,0,4,4,0,100
53e0c80f0de87feb793d2ac3e83ce9aa76646669,2,18,18,0,0,0,0,1,17,2,1,2,0.309543429,333,96,27,35,36,1,2644,2660,16,14,14,0,100
b229e07b9a3fce90d8c127724339a653857c2a3f,2,5,5,0,0,0,0,4,18,20,2,2,0.721928095,363,44,27,48,48,0,2911,2911,0,16,16,0,100
f78facc3a4bb61d9cdcbbe1c56c5ef15279bb139,1,1,1,0,0,0,0,1,6,0,1,1,0,109,45,28,19,19,0,733,733,0,4,4,0,100
b048ccf23a8ad9a716c814c647de823b7e2861ac,3,25,13,12,0,0,0,1,51,0,3,2,1.371243785,732,46,29,155,154,1,6146,6078,68,43,42,1,100
fed5717baf32cacd655df3f592def467430ec5b9,4,18,30,12,0,0,0,1,51,10,3,3,1.789181437,996,97,27,183,184,1,8255,8324,69,54,55,1,100
34541a576bb8d78b9bea96f506b54142ca65739f,4,29,17,12,0,0,0,1,53,0,3,3,1.799344963,986,98,28,184,183,1,8323,8255,68,55,54,1,100
026b779eb7d77331c2c6b8c8dda610abe163530b,4,16,19,3,0,0,0,4,38,6,3,2,1.919438809,598,47,30,76,79,3,5486,5497,11,31,32,1,100
602bca3fa75494c466d406b47e4c0c64b786a7b1,1,1,1,0,0,0,0,2,5,6,1,1,0,35,48,31,1,1,0,204,204,0,1,1,0,100
02fa490a8c9934cffb1cfd3587ebc89bd38a84da,1,40,0,40,1,0,1,1,1,0,1,1,0,0,49,32,2,0,2,136,0,136,1,0,1,99.62825279
2d34fda5d39efe705ac4fddc52b31d7f2cec1ea5,1,3,3,0,0,0,0,2,7,2,1,1,0,256,99,27,37,37,0,2217,2217,0,17,17,0,100
29508327a3b78fda3bf7ba52efc15dcbfa8c580f,1,2,0,2,0,0,0,5,39,0,1,1,0,328,100,28,48,48,0,3374,3331,43,9,9,0,100
03af637b313357a836169902ad2d33e335fdd7bd,0,0,0,0,0,0,0,0,0,0,0,0,0,0,50,33,0,0,0,0,0,0,0,0,0,100
34ba1b5fdafe831fb22e1cb414c0140b4d7f23f8,1,4,1,3,0,0,0,5,40,0,1,1,0,330,101,29,48,48,0,3395,3374,21,9,9,0,100
842f0cc86226f7a534cf2d39449ba5dd67e6eb70,2,4,7,3,0,0,0,5,41,20,2,1,0.945660305,537,102,30,76,76,0,5216,5237,21,27,27,0,100
2ee13a1bc18e1e1c12e19a60041196b63e0e3ce4,2,12,5,7,0,0,0,5,42,0,2,1,0.522559375,535,103,31,77,76,1,5270,5216,54,27,27,0,100
08b13ff1ba4dd0ac6e0d2b68fd6508f0b003fa51,2,2,2,0,0,0,0,5,43,0,2,1,1,541,104,32,77,77,0,5270,5270,0,27,27,0,100
6f364599b76922e05a88b8cf6b7436c66a292361,0,0,0,0,0,0,0,0,0,0,0,0,0,0,51,34,0,0,0,0,0,0,0,0,0,100
2dca6475581cefa2ced912f683ef59ac886b2e90,1,25,28,3,0,0,0,3,54,9,1,1,0,626,105,32,150,150,0,5385,5388,3,41,41,0,100
96d4e7df838e340ec68baa3392a68f3fd9411cca,0,0,0,0,0,0,0,0,0,0,0,0,0,0,52,35,0,0,0,0,0,0,0,0,0,100
9e8f3ceff815beb4ce00ba8715c66660aae9e4cd,0,0,0,0,0,0,0,0,0,0,0,0,0,0,106,33,0,0,0,0,0,0,0,0,0,100
c774c16968e25482b766c42021a1d0806b4bd541,0,0,0,0,0,0,0,0,0,0,0,0,0,0,53,36,0,0,0,0,0,0,0,0,0,100
6549e3a91b25cd1aa1b5c902b45e6f6924c829f7,0,0,0,0,0,0,0,0,0,0,0,0,0,0,107,34,0,0,0,0,0,0,0,0,0,100
99d2994f68a7959d5b5542fd6af2fcf5ad2f4472,0,0,0,0,0,0,0,0,0,0,0,0,0,0,108,35,0,0,0,0,0,0,0,0,0,100
e701475b4df33413453cca8801518f3dcdc04171,0,0,0,0,0,0,0,0,0,0,0,0,0,0,54,37,0,0,0,0,0,0,0,0,0,100
2b3c88938bc14586b5e8a9ee0834d5340836b446,5,122,72,50,0,0,0,1,6,170,2,3,1.066258372,386,109,36,48,43,5,2517,2291,226,31,30,1,99.62894249
cdd42a12212e39bb3ac082293bfecaa09d98ab90,8,75,125,50,0,0,0,5,23,32,3,6,1.333306068,680,55,38,56,61,5,4874,5100,226,42,43,1,99.62894249
8e82ad877cab526f6bb62448a9cbc45b32e26b30,0,0,0,0,0,0,0,0,0,0,0,0,0,0,56,37,0,0,0,0,0,0,0,0,0,100
1fedc8903156485dfb20b87a4d144657235bbe64,11,148,81,67,0,0,0,5,55,103,4,9,1.853150929,1677,110,37,294,284,10,14153,13787,366,108,106,2,99.62894249
dff424477d213656016a8cd7e22d526c4d0d725c,8,75,125,50,0,0,0,5,23,32,3,6,1.333306068,680,57,38,56,61,5,4874,5100,226,42,43,1,99.62894249
3e3c2c7a0154c8cab2cc0e82b812e6000c595369,0,0,0,0,0,0,0,0,0,0,0,0,0,0,58,39,0,0,0,0,0,0,0,0,0,100
b7cca69ad348e004de21a11d799ffe6f92314de5,0,0,0,0,0,0,0,0,0,0,0,0,0,0,59,40,0,0,0,0,0,0,0,0,0,100
1cec9434d0415fe171aba29acd60fbe8ee55505a,1,1,0,1,0,0,0,4,17,17,1,1,0,136,111,32,15,15,0,1206,1199,7,8,8,0,100
cef4ba094abfea22254368ed5312d33f490697cf,47,603,890,287,0,0,0,2,46,7,7,26,4.467910934,6078,0,0,845,875,30,44512,46149,1637,409,419,10,94.82109228
0078aeeb2caf302f7e290ee9deb4293616ace74e,47,890,603,287,3,0,3,2,55,22,7,26,4.467910934,5817,112,33,875,845,30,46149,44512,1637,419,409,10,94.82109228
f5c54fcc4ee32f3a2c6b016c70fd92e2a7bf7920,4,144,70,74,1,0,1,1,6,196,1,2,1.165075689,196,113,34,32,24,8,1224,872,352,15,11,4,99.53660797
f3affc9f426cc6bec9ca499a84a4dc9614074c44,51,681,1037,356,0,0,0,2,46,7,7,26,4.603254873,6340,1,1,871,907,36,45429,47373,1944,420,434,14,94.35559737
6b978354507d1e69b3b4b1ec34031e96bc971f94,50,1033,672,361,4,0,4,2,55,32,7,26,4.590719426,5875,2,2,895,857,38,46335,44346,1989,428,414,14,94.35559737
224c5a55ca2cf72ef633754bb9fba5cc08370465,5,18,54,36,0,0,0,3,49,59,4,4,1.732093517,883,114,34,105,109,4,7023,7143,120,50,51,1,99.81447124
9ac277cc3bfda341bd0dcf15c7db2fed0dc89682,9,397,100,297,3,0,3,1,56,10,5,6,2.204478285,1205,60,34,241,204,37,10806,9417,1389,89,66,23,98.42883549
6409096da2849d6ccf279e416c22bddbd8339ba4,3,35,3,32,0,0,0,2,44,17,3,3,1.086987702,514,61,35,83,80,3,4498,4434,64,38,36,2,100
a3f6e47e6b7ebbbd30f020c516bab75b9e7679d8,2,33,18,15,0,0,0,5,45,4,1,2,0.71401528,505,62,36,62,61,1,5775,5548,227,19,19,0,100
12677f246b7ca662ff76f251666906ec12d05c08,5,32,513,481,3,0,3,1,4,44,2,4,1.314133051,431,101,0,2,48,46,145,3690,3545,2,30,28,98.98989899
53ee96aa38441c4c3e71ca1e1421916a13980399,13,314,127,187,0,0,0,3,27,51,3,9,3.034522678,1038,102,1,191,153,38,9780,8557,1223,84,66,18,99.54170486
123abac59fb82a1e20498ef2fed57c5d2364d5ef,1,14,8,6,0,0,0,1,2,2,1,1,0,185,63,37,21,21,0,1280,1258,22,7,7,0,100
252abd1dfccf562486d237820bb392cb58959c5e,2,31,5,26,0,0,0,4,28,0,1,2,0.852405179,296,64,38,49,43,6,2749,2490,259,21,19,2,100
2d82ee358aa2f07b732cc3e19e7c68c756528ec8,4,13,123,110,0,0,0,1,27,42,3,4,1.618348266,583,103,2,64,82,18,3748,4549,801,26,32,6,99.63269054
ad0ad185395f3fc091fcaa632e3345ca1ba8d3b4,3,45,13,32,0,0,0,1,28,0,2,3,1.48663256,481,104,3,70,64,6,4029,3748,281,28,26,2,100
92cb456726cd03e93b51c3ce4a16792afcf7f7cc,2,10,5,5,0,0,0,4,51,21,1,1,0.566509507,478,3,3,68,66,2,3784,3739,45,25,25,0,100
53075a460765b7ab9b945a7bff71d16d72284237,13,182,306,124,0,0,0,3,57,22,5,8,2.849984376,2079,115,28,348,358,10,16861,17441,580,117,120,3,98.83928571
b2c3ed0e95eb54f766083a6d870b479fc87a4a3b,17,323,636,313,2,0,2,5,57,28,8,11,3.023020829,2698,105,4,427,450,23,19612,21894,2282,166,176,10,97.92979298
66686c47c079fd4d4d464505055d698d3559171d,11,177,213,36,0,0,0,5,59,23,5,7,2.49713492,1846,106,5,334,329,5,15646,15750,104,111,112,1,98.81602914
4cddf232710f7e176735a3c105a3ba3636c73ab0,19,716,228,488,3,0,3,4,56,24,9,12,3.135434957,2943,4,4,547,518,29,26326,23242,3084,197,183,14,98.01264679
880011378308f457cb626f137bcc22f6b81d166c,1,1,1,0,0,0,0,4,9,0,1,1,0,395,5,5,73,73,0,2769,2769,0,12,12,0,100
da4ff8398b5102c85197f5efa3a1695e80d750c0,26,557,750,193,2,0,2,3,59,21,10,15,3.69376015,4049,65,23,641,640,1,32167,33306,1139,255,255,0,90.57171515
14c6c030964cd93ef6c3f650cafdb6d046983e20,1,5,4,1,0,0,0,3,7,2,1,1,0,85,66,24,17,17,0,539,530,9,12,12,0,100
b5f67c50f3c623274bbf93f3044767d9f60fa29d,3,39,19,20,0,0,0,4,53,16,2,2,0.971168913,859,6,6,141,138,3,6553,6390,163,37,37,0,100
ff611e08b839fea94d45581144e0c23030ae65d1,1,1,1,0,0,0,0,4,10,5,1,1,0,395,7,7,73,73,0,2769,2769,0,12,12,0,100
33a4bbf9963c91181ff5bc757f498ac326402683,7,179,93,86,2,0,2,3,50,10,3,4,2.129336609,1281,67,21,199,197,2,10052,9788,264,67,65,2,91.06796117
8b1c2fd610ff6e6c3ec2d41cea64f36fa5df6a7b,3,39,19,20,0,0,0,4,53,17,2,2,0.971168913,859,68,22,141,138,3,6553,6390,163,37,37,0,100
941a61efd89e6c7ac078430533e8da9c4ad28785,0,0,0,0,0,0,0,0,0,0,0,0,0,0,69,17,0,0,0,0,0,0,0,0,0,100
722bedd1539024e7fdea40614cdaeb51f48cc976,4,172,30,142,0,0,0,4,22,18,2,2,1.294539935,599,70,18,98,71,27,4990,4119,871,49,36,13,98.52813853
c1a162db640f9f80027412d5b4d222cdefb00dfe,2,10,1,9,0,0,0,1,4,6,1,1,0.845350937,381,71,19,61,59,2,2395,2359,36,34,32,2,100
8d9b9b9dd39143128b94a99ae11b391a7eb00750,1,18,0,18,0,0,0,4,29,31,1,1,0,191,72,16,23,21,2,1799,1680,119,16,14,2,99.13793103
0b85fddb4924385811a06cccec82cbea08c92600,1,1,1,0,0,0,0,4,11,39,1,1,0,142,8,8,14,14,0,1083,1083,0,6,6,0,100
8d459132fe881f79fbd23f31fc883f0f4f974cfd,2,1,19,18,0,0,0,4,28,21,2,2,0.468995594,349,107,6,35,37,2,2763,2882,119,20,22,2,99.13793103
33b2132e5b9a3629e888a4cb7792359be264059a,2,19,1,18,0,0,0,4,29,34,2,2,0.468995594,333,108,7,37,35,2,2882,2763,119,22,20,2,99.13793103
0256e2bd702678dcc4965c23ec05b3b39be1eac2,2,10,7,3,0,0,0,4,10,22,2,2,0.522559375,415,73,13,55,55,0,2901,2900,1,23,23,0,100
a245c5759d0068bdcf0923389be876b2876844ff,1,1,1,0,0,0,0,4,11,39,1,1,0,142,74,14,14,14,0,1083,1083,0,6,6,0,100
f5016225ac59f14ac680c8f18d02c965357a85ac,1,6,9,3,0,0,0,1,4,6,1,1,0,276,109,8,41,41,0,1817,1818,1,17,17,0,100
4db8c502c0bcc4960f6e961436ac2dc56c0b3f51,0,0,0,0,0,0,0,0,0,0,0,0,0,0,110,9,0,0,0,0,0,0,0,0,0,100
50a8c34fd0f434968f3b766a06f6800652bb30d3,1,9,6,3,0,0,0,1,5,2,1,1,0,273,111,10,41,41,0,1818,1817,1,17,17,0,100
3af48c063cf09369cecc42b7364352d7b592687f,3,39,21,18,0,0,0,4,54,37,2,3,1.558871848,1015,9,6,113,111,2,8066,7917,149,52,51,1,99.74003466
c06cc08cec8567cfc4e6b8eea39f3fa1fd8b1cc9,1,9,6,3,0,0,0,1,5,2,1,1,0,273,10,7,41,41,0,1818,1817,1,17,17,0,100
e4613a03498af1c7d4e079c52be7e1de19e418c1,10,301,249,52,2,0,2,3,53,6,4,4,2.928921301,1424,75,15,165,136,29,11294,10216,1078,78,68,10,97.51286449
b8efbff3d8cc332b45cb55cf173e798fbc1637d3,2,33,12,21,0,0,0,4,54,52,1,2,0.996791632,739,76,16,72,70,2,6249,6099,150,35,34,1,99.74533107
99bdac0928f14868fe5215ba3041a727cf9be18d,0,0,0,0,0,0,0,0,0,0,0,0,0,0,77,15,0,0,0,0,0,0,0,0,0,100
983d0a1188261856dadeeab615d7248eaf8c6162,0,0,0,0,0,0,0,0,0,0,0,0,0,0,78,16,0,0,0,0,0,0,0,0,0,100
27a5d6b9ba5a041a97d9b6ced76d7cd017992aa9,1,4,3,1,0,0,0,3,3,131,1,1,0,66,11,8,8,8,0,281,267,14,3,3,0,98.96373057
01ab821b1d18e33fa93556c8e75de30fe8af4d00,7,115,38,77,0,0,0,2,11,23,3,6,2.375841836,1571,79,14,223,208,15,11099,10427,672,97,97,0,100
b11d617186e9cd3df43865210a1b41d7ea553968,1,4,2,2,0,0,0,1,3,0,1,1,0,134,80,15,20,18,2,1062,1031,31,5,5,0,100
fd2e32ccffd679ae212b599223c8c545f03e06f6,1,2,2,0,0,0,0,1,4,0,1,1,0,136,81,16,20,20,0,1055,1062,7,5,5,0,100
ba82f6eca81f31f62b2bcda9f43adfcfcfa16098,1,2,2,0,0,0,0,1,3,0,1,1,0,136,0,0,20,20,0,1062,1055,7,5,5,0,100
7dde24d4dd5cc5e90a44967576aed621c8c14b0d,1,3,3,0,0,0,0,1,5,0,1,1,0,136,82,17,20,20,0,1057,1062,5,5,5,0,100
2c197b70599f4c2fc94a8c2b5e1e45027900b1e2,0,0,0,0,0,0,0,0,0,0,0,0,0,0,1,1,0,0,0,0,0,0,0,0,0,100
ec10c702712eecdc1223586a2c25db7e43349a40,0,0,0,0,0,0,0,0,0,0,0,0,0,0,2,2,0,0,0,0,0,0,0,0,0,100
8dd911eb5b1b6f6e53c596d382b4e78b2507a6d6,0,0,0,0,0,0,0,0,0,0,0,0,0,0,83,18,0,0,0,0,0,0,0,0,0,100
09022823811b5757632d18872e7cc1417eb75013,1,1,1,0,0,0,0,1,3,9,1,1,0,31,84,19,1,1,0,62,62,0,1,1,0,100
4da192488054c64ce980733ac4cf455809ec425a,0,0,0,0,0,0,0,0,0,0,0,0,0,0,85,20,0,0,0,0,0,0,0,0,0,100
e3daccd30797e70fc1038a5a5a7bb1268e7a436a,2,16,1,15,0,0,0,1,2,82,1,2,0.522559375,76,116,1,9,8,1,495,388,107,7,6,1,100
3f9347d80699b3827612f18a3adb10169258cf5f,17,228,148,80,1,0,1,2,48,49,6,13,3.162247888,2222,112,5,296,286,10,20910,20131,779,138,135,3,99.47780679
a2218f66ae30867e7a0eada83e7ae544d0551722,0,0,0,0,0,0,0,0,0,0,0,0,0,0,86,21,0,0,0,0,0,0,0,0,0,100
a5f43ca285ace8179d085f5de40982a4fc51b570,1,15,0,15,0,0,0,2,2,161,1,1,0,45,117,1,8,7,1,433,326,107,6,5,1,96.3028169
cb3a1e140c0032ec0b7067f014f2ea997d6a60cb,12,0,15,15,0,0,0,1,1,0,2,8,0,1412,113,6,168,96,72,9531,5163,4368,79,72,7,93.10043668
4d48eb0f54fdf7123d46e7b0bd2f890e490a2a57,0,0,0,0,0,0,0,0,0,0,0,0,0,0,114,7,0,0,0,0,0,0,0,0,0,100
d8f0f6c4362384fb5b5177f93756ba6c6db67d3d,11,0,1,1,0,0,0,1,1,0,1,7,0,1356,115,8,161,88,73,9192,4730,4462,74,66,8,96.23931624
49429c9775bdb9cfd613c8c575b9b681f4b4e3a1,12,28,1,27,0,0,0,4,36,1,2,7,0.787667201,1769,12,6,181,105,76,12925,8249,4676,91,82,9,96.23931624
801725a6f7ffe455a8c2476180d85a0397524a3b,11,0,1,1,0,0,0,1,2,0,1,7,0,1360,13,7,163,88,75,9219,4730,4489,74,66,8,96.23931624
c8b8c0271a80b7255e42030b9e43a23ea1894f6d,10,312,83,229,3,0,3,3,13,14,3,6,2.532282027,1074,116,9,168,102,66,9370,6178,3192,79,43,36,98.05084746
282ad54ffe09f99e2cb14ad9162df1e74724fd08,1,15,0,15,0,0,0,2,2,161,1,1,0,45,118,2,8,7,1,433,326,107,6,5,1,96.93094629
38b52ffe3ab6a2dda55d4f2182b7b5873e80b84e,20,255,470,215,0,0,0,2,26,29,5,13,3.608009417,3095,87,18,336,321,15,20883,20668,215,174,184,10,95.18486672
6cf8e7d805bf573d5ed0c6b9ec13fdcf0c9a5ee4,11,327,83,244,3,0,3,3,13,26,4,7,2.666048511,1118,88,19,176,109,67,9807,6508,3299,85,48,37,95.18486672
a149f6c9b216c6b457dae35fe154bd5d15e49e11,1,1,1,0,0,0,0,3,8,0,1,1,0,327,89,20,54,54,0,2411,2411,0,41,41,0,100
46dd29d272414a602016647ffefb44daf646e2c2,15,331,224,107,2,0,2,3,26,18,5,11,3.248108927,2288,117,10,265,250,15,17194,16434,760,151,141,10,95.75551783
c6da6a0565de27cd535cc8f43b7fdb3a8f62876b,3,322,0,322,3,0,3,1,1,0,1,3,1.561424079,0,118,11,22,0,22,1294,0,1294,14,0,14,99.18032787
52755cfb267e3bbcd094bd3c9cd5c9e0bfb53c56,11,187,143,44,0,0,0,2,26,64,4,8,2.737158889,2085,119,12,231,234,3,15461,15178,283,133,131,2,97.05159705
39e29cf3d62d4b61b8069e9eceb50c6c7f855769,3,0,322,322,0,0,0,1,2,0,1,3,1.561424079,252,120,13,0,22,22,0,1294,1294,0,14,14,99.15397631
c5a66a33a85dac24c87e7a0680f4173f4e8813c5,0,0,0,0,0,0,0,0,0,0,0,0,0,0,0,0,0,0,0,0,0,0,0,0,0,100
0fcbc3331821cf162cf7a8fb5d5fd53031c1d3ae,15,267,11,256,3,0,3,4,27,29,4,7,2.980189074,1245,121,14,218,160,58,10581,9066,1515,106,88,18,92.27738377
a9b35b44eefb5d54fb43913e8a5fa4472439886f,0,0,0,0,0,0,0,0,0,0,0,0,0,0,122,15,0,0,0,0,0,0,0,0,0,100
af36cc45f64b505148b93e5e268696144198748d,3,51,22,29,0,0,0,1,5,0,1,2,1.129861289,401,123,16,47,46,1,2887,2738,149,30,28,2,93.55805243
c2d37ca1ed3432d379f65d57f39b106cff29b625,5,28,6,22,1,0,1,1,4,4,1,2,1.497994459,270,124,15,44,41,3,2144,2025,119,19,18,1,99.53739399
666d08b45b313e08fa532a924d336bca62c0ca4a,2,6,4,2,0,0,0,1,5,0,1,2,0.970950594,246,125,16,39,38,1,1854,1853,1,17,17,0,100
0e3052a0eddf60f8310d7cde30c8d3cf03375c06,1,2,1,1,0,0,0,1,4,0,1,1,0,77,126,17,19,18,1,595,588,7,3,3,0,100
80f786506fdf2f6c44621bbe036d51ec4d25db99,10,263,144,119,0,0,0,4,37,49,4,7,1.56523152,1296,14,5,177,158,19,11017,10469,548,91,85,6,99.53739399
c49776bb196c43f85d93e4ef754646371a735c00,5,36,11,25,1,0,1,1,5,2,1,2,1.910733406,270,15,6,46,41,5,2152,2025,127,19,18,1,99.22898998
823c59bd9f6ce02019c1fd9dc55497dc286e0b38,1,1,9,8,0,0,0,4,38,0,1,1,0,442,16,7,18,19,1,3704,3763,59,17,18,1,100
9ea8db84490472e17df1ec103797baf97da13f5b,1,0,1,1,0,0,0,4,39,0,1,1,0,434,17,8,18,18,0,3693,3704,11,17,17,0,100
a8defa441a417a328bc4d004ba5b8abdf121fe06,14,770,298,472,4,0,4,4,36,60,4,12,2.835482141,2337,90,15,336,298,38,20794,17594,3200,187,163,24,93.84984026
460bf663074a00b54f0d16897059cee39b3fd19a,5,157,44,113,0,0,0,4,39,53,3,5,1.201595551,1124,91,16,149,126,23,9857,9267,590,77,71,6,100
3dfa02a0dd8761b83bf4d9a9fd43be7d2cd8f23f,29,724,906,182,4,0,4,4,36,10,5,19,3.757974804,3739,127,18,489,468,21,25648,27275,1627,284,249,35,88.5075818
91e4e2ea515d22dd0ee89dbffb3b591d3fb7c723,14,826,106,720,4,0,4,4,39,55,4,12,2.952296846,2231,128,19,359,275,84,21384,16989,4395,193,157,36,97.82270607
b7fe9fd155cf5c47d1a0b6e2eed4aa9a80e66501,1,2,3,1,0,0,0,1,2,1,1,1,0,50,129,17,18,17,1,344,335,9,5,5,0,100
0866947c29b4686d98a4556ad759da0f6eb5cdde,8,68,32,36,1,0,1,4,40,1,2,5,2.306234669,1166,130,18,146,139,7,9572,9342,230,67,66,1,99.36758893
e938cf9a55ecf56a2c4552a4af9fdd43946eefee,31,355,1457,1102,0,0,0,4,40,4,5,20,3.995202813,5064,18,7,558,714,156,30518,36040,5522,258,356,98,92.109375
79254c7176a6284a124a1ba5a7935c985ab5c9a2,26,1347,228,1119,8,0,8,2,24,22,5,18,3.676198977,2616,19,8,517,350,167,24986,18426,6560,271,170,101,92.14007782
6ed267c840a68eda953e18b822a1580258267281,8,68,32,36,1,0,1,4,42,1,2,5,2.306234669,1166,131,19,146,139,7,9572,9342,230,67,66,1,99.36758893
1f722f598bbdf0c2dda55f07303c3b969fc3d7a5,14,80,94,14,0,0,0,4,60,23,4,7,3.348443528,2639,119,3,409,411,2,20792,20930,138,176,173,3,92.27574751
a791a866f48f468973d3963476d2aa5a174e16ad,8,26,48,22,0,0,0,4,59,12,4,4,2.595557256,2218,92,13,342,347,5,17661,17753,92,144,148,4,92.80397022
7c2279cb4badcb82386ce2a5a8fb640ed207978e,8,48,26,22,0,0,0,4,60,42,4,4,2.595557256,2200,93,14,347,342,5,17753,17661,92,148,144,4,92.80397022
51888a714a443357e1922ffbbd325fa4cfc7599d,0,0,0,0,0,0,0,0,0,0,0,0,0,0,120,4,0,0,0,0,0,0,0,0,0,100
bee985116092aa7fcf3b42688a63cc985d71b161,19,701,714,13,4,0,4,1,49,21,7,10,3.660744827,2641,94,15,297,321,24,20145,20388,243,137,158,21,94.64435146
cb2d9d0c7d7e7d8355e899ca3e46fdc9eb6528d8,0,0,0,0,0,0,0,0,0,0,0,0,0,0,95,16,0,0,0,0,0,0,0,0,0,100
5b133e4d8ce24f0ffc9ad52152e2e1d4bcd6ec7c,0,0,0,0,0,0,0,0,0,0,0,0,0,0,96,17,0,0,0,0,0,0,0,0,0,100
17ac046d59bf3134746cc828b132e76e2472b171,38,1219,941,278,1,0,1,4,59,16,9,17,4.463242263,5446,132,20,790,720,70,44018,41804,2214,361,332,29,94.26294821
3b421f9f4f8dc25984b2aeb13cb1ef76567dc0df,2,2,3,1,0,0,0,1,5,0,1,2,0.721928095,473,133,21,88,88,0,3368,3378,10,29,29,0,100
99d9ff57a9f934a777a934a32118e178b1d60090,25,733,715,18,4,0,4,4,60,22,9,12,3.796223272,4495,134,22,614,633,19,35145,35207,62,268,285,17,99.05882353
a3d0461e008b3972b56bcfd0383a93740cd697eb,3,6,4,2,0,0,0,4,45,0,2,2,1.485475297,1089,135,23,137,137,0,8973,8932,41,61,61,0,100
8e73e83c6953f709bcdfe8720c23620a2df8a36b,39,938,1421,483,0,0,0,4,60,20,9,18,4.546985111,5812,20,8,720,776,56,41255,44916,3661,351,349,2,98.43260188
5a4700367c794a5d14b67158228c8b4bc800b335,38,1239,933,306,5,0,5,4,62,11,9,17,4.455185827,5282,21,9,749,717,32,42544,40506,2038,343,348,5,98.43260188
4db3510254753d4152c0ae5a51410d7874350845,0,0,0,0,0,0,0,0,0,0,0,0,0,0,121,5,0,0,0,0,0,0,0,0,0,100
b4a559facc687db076d225c7c60bf342960d6f5e,3,14,14,0,0,0,0,5,20,7,2,3,1.295836389,627,22,10,102,101,1,5027,5017,10,37,37,0,100
19ce4358b0e7a7b1b1881d981d8b20dc2988dbe8,0,0,0,0,0,0,0,0,0,0,0,0,0,0,23,11,0,0,0,0,0,0,0,0,0,100
31dc14e5a7df52c7684e81770d765838d33c2407,1,1,1,0,0,0,0,1,5,6,1,1,0,143,136,24,27,27,0,1154,1155,1,8,8,0,100
84f77760caa2c9e1834b1d7bb49bd92fc966bf8a,11,623,225,398,1,0,1,1,14,40,3,5,2.401478874,1653,137,25,327,280,47,13151,11652,1499,196,136,60,94.75774424
a32451e337ab7df36ae9e15a225a8ef85e472e90,14,239,637,398,0,0,0,1,19,30,3,8,2.570283659,2606,122,6,381,429,48,16670,18178,1508,173,233,60,94.75774424
8ad3b2266902df2292985966a1a0a567f3983d20,14,637,239,398,1,0,1,1,20,30,3,8,2.570283659,2280,123,7,429,381,48,18178,16670,1508,233,173,60,94.75774424
8cd100b1e48e995f877a0797925ddf59cc4e3a91,2,4,3,1,0,0,0,1,10,2,1,2,0.863120569,420,138,26,60,59,1,3218,3193,25,27,27,0,100
7f1740b5fd44a826d4d97e3a0817767d246ab08e,0,0,0,0,0,0,0,0,0,0,0,0,0,0,139,27,0,0,0,0,0,0,0,0,0,100
3ef329eea758dc1969bbcfd0b7f5107de9f0fa72,14,244,120,124,2,0,2,4,52,44,7,10,2.890141423,2201,124,7,283,279,4,18986,18158,828,148,138,10,95.69034318
bd7895fd145796b8e825cfe6c81c3b93d0b04974,2,4,3,1,0,0,0,1,10,2,1,2,0.863120569,420,125,8,60,59,1,3218,3193,25,27,27,0,100
47a5f97deb2f88327e8a5df94c83abafbbdac780,26,1178,604,574,14,0,14,1,10,4,3,10,4.179198474,1409,97,10,211,205,6,11519,10813,706,114,107,7,96.26459144
af2acb9d1df2c14368c87e0d5f4d41fb4acad1f4,17,2,2,0,0,0,0,1,9,0,2,6,0,1288,98,11,153,167,14,7301,7087,214,80,78,2,95.71865443
2ad023a2454a1ca4ec0ee04d24cad0540646c8ab,17,2,2,0,0,0,0,1,8,0,2,6,0,1288,24,10,153,167,14,7301,7087,214,80,78,2,95.71865443
4dcbe370f440e53487cd29022d061e948adb4f67,17,2,2,0,0,0,0,1,9,0,2,6,0,1288,25,11,153,167,14,7301,7087,214,80,78,2,95.71865443
cfd3a631e384976231751bdf8e736ce6a6f76422,2,23,9,14,0,0,0,2,10,6,2,1,0.543564443,483,126,8,92,91,1,3576,3467,109,35,34,1,100
14a1331f3f47e6ca6aa8b35f419a867aeda93607,0,0,0,0,0,0,0,0,0,0,0,0,0,0,26,12,0,0,0,0,0,0,0,0,0,100
331305fd9524b763958f6b6c4fcd57c74098dc3b,2,8,3,5,0,0,0,5,21,14,1,2,0.684038436,574,27,13,97,92,5,4807,4752,55,27,27,0,100
772bb4d1a4272828e26a9702cb2f718225ddd6cb,53,1530,1823,293,7,0,7,2,63,8,11,26,5.036746819,6211,140,24,906,910,4,44711,46899,2188,444,442,2,86.8466899
97ea8b039d2abc64398f825234f46132960af252,40,1369,696,673,15,0,15,4,46,10,11,19,4.553278192,4013,141,25,602,578,24,33217,31659,1558,287,273,14,88.48594742
959d0b9d8e4da1a740ccd1589a58e2162682a7de,3,13,13,0,0,0,0,1,13,7,1,3,1.419556299,720,142,26,117,117,0,5463,5463,0,47,47,0,100
772e490db4dfdd6c2d4455a175ae8f9013119801,2,13,19,6,0,0,0,1,64,0,1,2,0.997180399,917,143,27,213,211,2,7216,7304,88,78,79,1,100
25d9ef8e03efc1e94d95eb0371622800c2cbdc7f,35,883,551,332,4,0,4,4,65,33,6,18,4.108408754,4477,127,8,620,595,25,37548,35734,1814,274,257,17,91.90515127
1445fbd25c08ff44ab0d86e35e594bd26329e1ef,4,20,37,17,0,0,0,2,13,4,1,3,1.057188414,794,144,23,104,106,2,5954,6028,74,50,50,0,100
4200a7fed62d330a93d476877fa4395acc7ac41b,10,141,128,13,0,0,0,4,66,13,5,5,2.794427826,2781,128,9,446,445,1,22505,22444,61,185,184,1,99.91803279
634a6688a2bc5a62a06215ed3d3a8f860e5535a0,10,89,96,7,0,0,0,4,67,31,4,7,2.621560872,2565,129,10,424,423,1,20576,20561,15,154,153,1,93.14546839
7bd4b7b74e716f0bcdb915ae8dffbc9fcc7e64ba,2,11,5,6,0,0,0,4,68,2,2,2,0.811278124,921,145,21,230,227,3,7930,7877,53,74,74,0,100
2d05b1e5bf0ed336772ca7038ef5e6f9cdaf6e19,4,19,27,8,0,0,0,2,17,8,1,2,1.327484782,1129,130,11,181,183,2,8965,9037,72,71,72,1,100
52334c8409230a45fb3423940d951009f07769e8,4,7,5,2,0,0,0,2,69,5,3,3,1.729573959,1493,131,12,300,298,2,12443,12415,28,97,97,0,100
985a2401fc167f6a87b9b213e122b304337b79d6,34,465,2282,1817,0,0,0,4,70,53,7,15,4.346400685,4954,132,13,552,765,213,29010,38747,9737,235,366,131,96.59173314
279f378fffea3008aac29f5c4d747c1ce2172ff5,2,2,2,0,0,0,0,2,20,0,1,1,1,501,133,14,100,100,0,4163,4161,2,32,32,0,100
625d1c4b8d2458f31ac07e6925da9f72191fa9c5,23,917,172,745,5,0,5,3,71,24,9,17,3.707773051,3593,99,7,672,620,52,34221,29740,4481,312,282,30,95.2732644
deb484634204471958adb760c78011478ee40b2a,0,0,0,0,0,0,0,0,0,0,0,0,0,0,100,8,0,0,0,0,0,0,0,0,0,100
8b37536952db0c5d2870511d5185dfdcb1cbc2c4,0,0,0,0,0,0,0,0,0,0,0,0,0,0,101,9,0,0,0,0,0,0,0,0,0,100
510519b0c92ef5506eebeea202a8f8179a165c4e,1,2,2,0,0,0,0,2,17,8,1,1,0,328,134,14,42,42,0,2598,2598,0,25,25,0,100
5ee86b19d2f8dff8935127d055ece3f84cbf0b73,7,210,110,100,2,0,2,1,18,36,2,4,2.236535425,401,102,5,58,50,8,2595,2263,332,24,21,3,99.03988183
07eb3d40ded1f8ff592a1d4dd609e321eda28b58,24,868,795,73,3,0,3,4,72,21,6,13,3.659070614,4022,146,9,657,647,10,31502,32701,1199,278,276,2,97.36842105
e34b48555588afb76575e410705b5d07c62c811d,3,24,20,4,0,0,0,3,14,18,3,3,1.022629779,1122,103,6,135,133,2,7797,7770,27,51,51,0,100
2dea44a9b0a61ad7869c61be2306c71b823e4ad9,2,2,2,0,0,0,0,2,73,1,2,2,1,918,104,7,202,201,1,7644,7636,8,61,61,0,100
311f7b83ac761e85ec3abe2479a700677a6b6073,1,1,1,0,0,0,0,2,2,2,1,1,0,89,105,8,7,7,0,759,759,0,7,7,0,100
3497412d273d624f120035b9ab51b4dd0d611c07,1,11,10,1,0,0,0,3,13,0,1,1,0,459,106,9,31,31,0,2988,2983,5,22,22,0,100
3735506cb53d2fdaa7a27b1270ef186487a6594b,3,23,106,83,0,0,0,4,22,3,2,2,1.349582989,865,135,11,135,145,10,6566,7035,469,59,63,4,100
1ad6cdb00c8aeb89412a25f93e87e68ce173d2c2,14,233,146,87,0,0,0,4,74,28,6,8,2.957785879,2772,136,10,560,544,16,22612,22039,573,209,207,2,97.36434109
adcbb0ffb69ade5deb5cf26e4b86ee0f0c7f337c,15,146,236,90,0,0,0,4,73,18,6,9,3.00075731,3110,28,4,616,633,17,24172,24758,586,220,222,2,97.36434109
0be8d65bd291a50da6d8ffbd802b82de6e24305d,14,233,146,87,0,0,0,4,74,28,6,8,2.957785879,2772,29,5,560,544,16,22612,22039,573,209,207,2,97.36434109
2094a7faafe4c9813beb22c08493cbddd3569fbc,26,1084,1064,20,6,0,6,1,75,38,5,12,3.666946041,2676,30,6,406,412,6,19910,20894,984,144,155,11,91.55332856
d82b785345e4f1c5f14f0bc76f6b54759271d9f1,4,35,20,15,0,0,0,1,30,59,2,3,1.959652207,731,31,4,135,137,2,6014,5915,99,41,39,2,89.71471471
f54b98401d007e6668dce459ab4b86f96ebe150e,2,4,6,2,0,0,0,1,3,2,1,2,0.721928095,187,32,4,21,21,0,1225,1251,26,10,10,0,100
b6c7c6b807ba7bd5ce736f9cf8a5f618b1252be0,102,952,6404,5452,3,0,3,4,76,99,9,30,5.973493964,9041,137,10,1075,1378,303,58707,69357,10650,448,712,264,79.35349322
78e7a6fb30243db97f831e09f0bbb863da55a320,11,50,51,1,0,0,0,4,77,0,5,8,3.047081552,2752,33,5,470,470,0,24375,24375,0,169,169,0,100
a3d217c34f57fa2c023ea15f5b6d843c2f302077,27,473,436,37,2,0,2,2,78,12,7,15,3.244545827,4402,138,10,665,654,11,39373,38549,824,260,258,2,95.88719154
740864752437ffd562f37c69c38bab71f7b9a012,39,806,646,160,1,0,1,4,79,19,7,20,3.745176129,4613,107,8,644,632,12,33992,33099,893,286,276,10,93.79679144
9b75fcc66ab40e5d0448ffe3773d81c693bc98dc,43,663,836,173,0,0,0,4,78,3,9,23,3.888052907,5316,139,9,710,723,13,39016,39977,961,303,313,10,93.36898396
c3f6b6a9bc31a20142b2596ac9440ba59ee5f1b6,39,806,646,160,1,0,1,4,79,19,7,20,3.745176129,4613,140,10,644,632,12,33992,33099,893,286,276,10,93.79679144
323b75a33a89c5ae5c2a45ce234fcd24a9eabec5,6,421,60,361,3,0,3,1,24,11,2,4,2.039228341,379,147,1,92,33,59,5570,3120,2450,38,16,22,99.41520468
015c0ea69064514eacfe271c35478c9b1155a98f,12,109,468,359,0,0,0,3,30,12,5,9,2.692641183,1897,141,9,247,306,59,12764,15178,2414,105,128,23,99.41520468
86fbbf573ab70bb075732f8a36198ad69b392818,6,421,60,361,3,0,3,1,24,11,2,4,2.039228341,379,142,10,92,33,59,5570,3120,2450,38,16,22,99.41520468
667132535d5efbbb4ab79d51f8cb3ab6a2225cff,0,0,0,0,0,0,0,0,0,0,0,0,0,0,108,9,0,0,0,0,0,0,0,0,0,100
5d55ea2336f7004454f8073bdce17d5d6301cebc,1,1,1,0,0,0,0,4,25,0,1,1,0,221,109,10,27,27,0,2202,2202,0,11,11,0,100
ed543031c7286dd3aed307b442befbcfdf181542,2,8,3,5,0,0,0,2,24,13,2,2,0.684038436,378,143,11,59,56,3,3554,3525,29,20,19,1,100
96d78968280448cae6c20adb5b5ac9a916a429f2,1,1,1,0,0,0,0,4,25,0,1,1,0,221,144,12,27,27,0,2202,2202,0,11,11,0,100
685441eaedea5fcd7c438e706438fc4956ff7f08,1,5,1,4,0,0,0,4,10,15,1,1,0,115,145,13,23,21,2,906,867,39,7,7,0,98.05725971
2bd691afc0c2621f3f54748e270f05688055feec,1,6,3,3,0,0,0,2,26,0,1,1,0,386,148,2,85,84,1,3286,3270,16,25,25,0,100
33a558c0a0e109f5ac45daa7408f7a3a728a9341,6,69,57,12,0,0,0,3,80,6,5,5,2.005288489,1558,146,14,307,301,6,12881,12885,4,96,94,2,100
35d0819d556655445b356a3372dc8dd910664644,4,52,21,31,0,0,0,2,81,6,4,3,0.764092913,1030,147,15,226,215,11,8994,8730,264,64,61,3,100
17c4e9c8c974de58e71f08c685a0ddcb34fd736a,13,319,131,188,3,0,3,1,80,11,7,10,3.041650032,2100,149,3,396,385,11,17892,16390,1502,143,140,3,97.68907563
9ced96258e0281e6171027ba8b0bc54385342a53,8,113,70,43,0,0,0,2,83,6,5,6,2.277316352,1652,150,4,323,306,17,13671,13411,260,101,96,5,100
4e5aa0ac903eaf471d6b09b3fcfe5d47108c596f,3,30,4,26,0,0,0,1,84,10,2,3,1.036054335,1091,151,5,248,239,9,9395,9231,164,75,73,2,100
83f95b4675187d7e4f5f1a0d3fa020b109685015,10,47,47,0,0,0,0,3,26,6,6,8,2.655086173,1667,110,11,240,241,1,13068,13035,33,118,118,0,100
afab938b866da4d34ad63c275683f62eb0f302d7,11,51,50,1,0,0,0,3,27,13,6,8,2.834402213,2055,152,6,326,325,1,16320,16354,34,143,143,0,100
508d0345f5190650e5481356f02bc85bbc07795f,10,47,47,0,0,0,0,3,26,6,6,8,2.655086173,1667,153,7,240,241,1,13068,13035,33,118,118,0,100
92534ccea8cb967d72daab9cc02239bf53fe3ac4,4,50,18,32,0,0,0,1,5,14,1,2,1.463985724,159,111,12,14,11,3,877,660,217,9,6,3,98.36065574
1e638986c5b267a62a60636d9ab12de948f53e72,1,0,1,1,0,0,0,3,5,0,1,1,0,51,112,13,5,5,0,234,243,9,3,3,0,100
b117666217301633b94ab61fba7ee729c54858bf,16,109,171,62,0,0,0,4,28,24,4,8,3.391508562,1893,148,14,262,271,9,13442,13678,236,130,138,8,96.74711438
7b43a79c449b26db5806a40ba8f5877c15ecc92c,4,49,18,31,0,0,0,1,5,11,1,2,1.468011952,159,149,15,14,11,3,868,660,208,9,6,3,98.27956989
013f4e2f18cea2f2a07583224d588066af6cc825,12,122,91,31,0,0,0,4,27,8,3,6,2.952992849,1681,113,14,257,251,6,12810,12782,28,129,124,5,98.41938883
fe44812541a23045708104b363143c697328f1b4,12,91,122,31,0,0,0,4,28,29,3,6,2.952992849,1707,114,15,251,257,6,12782,12810,28,124,129,5,98.41938883
3e16beb141c3ec6500b966aa9a17243333386101,2,19,0,19,0,0,0,5,34,20,1,1,0.998000884,475,115,13,42,40,2,4318,4199,119,30,28,2,100
e201621ede4a35dc2bb10c23c3206635ca470ba0,0,0,0,0,0,0,0,0,0,0,0,0,0,0,150,15,0,0,0,0,0,0,0,0,0,100
179aa96469b1d5daae8a676923cdbe44b3fbd993,1,1,0,1,0,0,0,2,29,14,1,1,0,329,154,7,68,68,0,2649,2630,19,21,21,0,100
d3407ecff52a8f601564254f1877c066f81480da,1,2,2,0,0,0,0,3,11,32,1,1,0,190,34,6,42,42,0,1466,1466,0,12,12,0,100
f169344b97cb253c8122d3025218cf0af6a7e3bd,5,205,146,59,0,0,0,3,28,19,4,5,0.976668606,1751,116,9,267,262,5,12673,12462,211,112,106,6,99.89200864
7d4065e308f6a5b5e6858f44ff88af67693c93e9,2,3,2,1,0,0,0,2,29,23,2,2,0.721928095,519,117,10,110,110,0,4115,4096,19,33,33,0,100
2a5318732a9e1adbdd2f0c61097a5ff1a4900f0d,1,2,2,0,0,0,0,3,4,18,1,1,0,147,118,11,20,20,0,1121,1104,17,6,6,0,100
154fcbd3e9b4146012f6b3a57cf4c0a3a80bb1b5,1,1,1,0,0,0,0,3,15,0,1,1,0,508,119,12,36,36,0,3221,3221,0,28,28,0,100
3d1f8f00f1cd442121e1cc4b298ec65705e15bdf,1,0,1,1,0,0,0,3,16,0,1,1,0,508,120,13,36,36,0,3210,3221,11,28,28,0,100
70acec03e65f8e8c2f0c5d846ced576734ca75a4,1,1,1,0,0,0,0,5,18,20,1,1,0,336,35,7,77,77,0,2882,2882,0,37,37,0,100
0c2654543713183ef8e4185851d7a7b260439f24,1,7,2,5,0,0,0,3,6,38,1,1,0,150,121,14,13,13,0,1089,1089,0,10,10,0,100
29f7b194ea6467e95ab84d97e7992a4181177ba0,17,548,246,302,2,0,2,1,85,14,5,10,3.144820426,3335,122,15,580,553,27,27287,25464,1823,270,253,17,98.91891892
2967fd374920f7fe46b39fd2a4c7ad5b7e685148,1,1,1,0,0,0,0,3,7,0,1,1,0,155,123,16,13,13,0,1089,1089,0,10,10,0,100
87f42986685618cd2fb5b2cd9590c9c167a3af83,52,765,1311,546,2,0,2,4,85,7,9,26,4.679051794,8501,150,13,1224,1259,35,64624,67699,3075,515,549,34,96.09544469
b90b0684e29709278d8ed3a7c6bf5d43523829ca,42,791,554,237,3,0,3,4,84,10,10,26,4.340226701,7457,155,8,1168,1131,37,61205,60619,586,480,469,11,96.96641387
48bf19788d1db4a0010542411eb091e94977a890,18,549,247,302,2,0,2,1,85,14,6,11,3.162239233,3490,156,9,593,566,27,28376,26553,1823,280,263,17,98.91891892
47e55db5b911dbd2ebb471d59be2539a21d98d12,37,404,542,138,0,0,0,4,87,14,9,20,4.330977427,6261,152,14,985,983,2,51258,51944,686,407,415,8,97.06840391
a24a42b0ae0b9c59e2c33d1004152800f4107b85,9,91,266,175,0,0,0,2,55,12,2,7,2.004696889,2237,153,15,270,285,15,16564,17923,1359,145,149,4,99.89106754
4792bd3179804fe91ed67ee853b87675092292a3,2,8,15,7,0,0,0,3,11,60,1,2,0.965636133,542,154,16,67,68,1,4227,4300,73,33,33,0,100
5b4820f8657f8262b6398c85ccc12fd164f4cf75,6,115,31,84,0,0,0,3,88,0,4,6,1.836055647,1955,124,17,421,403,18,16726,16357,369,162,154,8,97.55351682
2f5e18345ec349f5e321a4e84c97cff9d7c03c1e,1,8,11,3,0,0,0,4,89,0,1,1,0,814,125,18,206,205,1,6853,6877,24,57,57,0,100
e682857f5b7ecd37084c7c43a8bef863f53b27fb,1,3,3,0,0,0,0,4,90,0,1,1,0,811,126,19,207,206,1,6864,6853,11,57,57,0,100
0718fc44cd70ba779669afc690695068c468bed6,0,0,0,0,0,0,0,0,0,0,0,0,0,0,0,0,0,0,0,0,0,0,0,0,0,100
7f1ed8fd196a4730d8a64ffee2b1349699965dd3,3,57,22,35,0,0,0,4,88,2,2,2,1.555374944,1477,155,16,271,271,0,12834,12562,272,97,96,1,100
20f328fbdb6fac7e16100d705722efa0cafc8667,1,8,11,3,0,0,0,4,90,0,1,1,0,814,156,17,207,205,2,6864,6877,13,57,57,0,100
af1a91ad918b3cbdf24bc2490c2d0610bf670339,6,83,57,26,0,0,0,4,91,11,3,4,1.629419144,1887,127,19,423,424,1,15604,15456,148,136,136,0,99.71236817
53d215cc84fd59d32f355d608e5af3a8c456fb9b,6,57,83,26,0,0,0,4,90,2,3,4,1.629419144,1910,157,16,424,423,1,15456,15604,148,136,136,0,99.71236817
d7944999a62795693c94ca136dd6e6e289d576c7,6,83,57,26,0,0,0,4,91,11,3,4,1.629419144,1887,128,20,423,424,1,15604,15456,148,136,136,0,99.71236817
15d2c7c5ae71d077fa1bc9bdb6582cca8fa2efe3,0,0,0,0,0,0,0,0,0,0,0,0,0,0,129,21,0,0,0,0,0,0,0,0,0,100
75c12c8f3eb34120bfc28766f4968f50a4e900c9,1,1,1,0,0,0,0,4,14,1,1,1,0,257,130,22,38,38,0,1924,1924,0,14,14,0,100
5f4e0a76cdca2d452434176538c2e3bb79caaa00,1,2,2,0,0,0,0,4,92,5,1,1,0,812,131,23,207,207,0,6844,6844,0,57,57,0,100
c1ca06691060c7582c72dec3a071504b7316b28e,1,2,2,0,0,0,0,4,93,0,1,1,0,812,132,24,205,207,2,6817,6844,27,57,57,0,100
d69388751afc9cfebaa6b3adeb8649e39ba67458,4,103,7,96,2,0,2,4,57,30,3,4,1.743318211,463,157,10,36,25,11,4267,3693,574,26,20,6,96.40980736
4bc8110a2bf8cd74a3074d30cff93dca7f21852e,4,100,56,44,0,0,0,1,94,41,4,4,0.810792603,1223,158,10,298,290,8,9014,8771,243,138,137,1,98.53300733
d79cea9c6d48fd7bc7ab6154b637c0e9471ad508,2,29,14,15,0,0,0,1,95,0,2,2,0.99648599,901,159,10,219,216,3,7682,7607,75,61,60,1,100
1864333431baf7839ca7fe001879ad44d99029c1,9,78,223,145,0,0,0,4,93,1,6,9,2.279962529,2038,133,23,345,364,19,14742,15582,840,168,176,8,95.65217391
02de1221a23a4b229a3532213a0704cc64d09370,8,221,66,155,2,0,2,4,95,30,5,8,2.106552109,1686,134,24,337,315,22,13356,12464,892,165,157,8,95.65217391
1398db567a9728cd370d0366c425b727889fce6d,2,3,13,10,0,0,0,3,33,14,2,2,0.543564443,564,160,11,96,98,2,4880,4924,44,32,32,0,100
f20f3bbdebccd9754e66214727b501940f7b1014,1,12,2,10,0,0,0,4,28,17,1,1,0,224,161,12,30,27,3,2278,2226,52,11,11,0,100
8b4169479a4c312cca400ca353080823d38d64e9,9,315,239,76,0,0,0,4,93,6,5,8,2.173743088,3044,36,2,557,549,8,22536,21979,557,253,246,7,98.53300733
eafc41c72c75a612f5af2618cecfad66640b2d30,5,130,61,69,0,0,0,1,95,29,5,5,1.096453769,1447,37,3,331,317,14,11367,10997,370,150,148,2,98.53300733
c8b586aba83aef6d454501a00da98407bb3a415d,1,1,1,0,0,0,0,3,33,9,1,1,0,329,162,13,69,68,1,2654,2646,8,21,21,0,100
bb3bd81f299c5c8c111b32cbb91184421782ce07,2,19,15,4,0,0,0,1,96,2,2,2,0.522559375,910,163,12,217,219,2,7713,7682,31,61,61,0,100
d1e63b1a7ccb6435a56a37103456127427e62557,10,92,112,20,0,0,0,3,58,31,4,8,2.326178865,1708,135,22,143,143,0,12369,12552,183,106,105,1,89.48948949
3e585fca075e7ca322f93caefa0c47c971be2d34,6,147,90,57,0,0,0,1,97,17,5,3,2.364939447,1137,164,10,241,233,8,9930,9293,637,72,70,2,100
6f719028fc172fbd80a651b67aa10be6846e2e0d,9,160,188,28,0,0,0,4,96,13,6,6,2.902490764,2479,38,4,401,407,6,18009,18422,413,152,153,1,100
3704688c6ca4e91d19bc63ab2aeb2b0282f1e651,6,147,90,57,0,0,0,1,97,17,5,3,2.364939447,1137,39,5,241,233,8,9930,9293,637,72,70,2,100
27a5a8a39a1bfc94a10bb876176cd6639e2ccf84,1,4,8,4,0,0,0,4,98,2,1,1,0,891,165,11,217,218,1,7454,7471,17,59,60,1,100
2c726e0881ac32ea114728402318fa7eb708f6b9,1,1,1,0,0,0,0,3,7,20,1,1,0,231,166,12,26,26,0,1984,1991,7,12,12,0,100
60254346b1c6eb73632a91ca486397069853533e,17,1228,932,296,3,0,3,4,99,36,7,11,1.298950975,2258,136,20,410,402,8,17200,16324,876,141,137,4,97.86700125
f4358d62b240fa29db65363c2ab0eaaee98d1698,19,1018,1258,240,1,0,1,4,98,12,7,13,1.53659778,3196,40,6,513,507,6,21795,22225,430,193,195,2,97.86700125
52c565f2dedcbc5153f1652041ad4bdf8134de38,18,1229,933,296,3,0,3,4,99,35,7,12,1.308406319,2492,41,7,437,429,8,19194,18325,869,154,150,4,97.86700125
e378ddb9d08221c3fbd89e9d1ea2af64780e6a1c,19,963,1315,352,1,0,1,4,98,23,7,12,1.543673299,3109,167,13,488,510,22,20018,21315,1297,184,190,6,97.86700125
d7010700a235fa394b31e28fb6cd1b404aa5ce91,18,1313,961,352,3,0,3,4,99,34,7,12,1.527751916,2684,168,14,495,473,22,20680,19365,1315,185,179,6,97.86700125
fed8b2c3060015dd517ac46311a3b49b9e91764b,1,9,3,6,0,0,0,3,8,0,1,1,0,111,169,15,16,15,1,698,653,45,5,5,0,100
fbed2a267b6f9d900ea40a8483fa7832e30231b6,1,3,2,1,0,0,0,5,22,0,1,1,0,458,170,16,84,84,0,3493,3470,23,43,43,0,98.62842893
0f976d4c4986025ae32e38b85ce0afb67c9b7248,1,1,1,0,0,0,0,3,9,0,1,1,0,117,171,17,16,16,0,698,698,0,5,5,0,100
cc1ef952c5aa6930c7165727a3e50e6948138696,3,121,19,102,0,0,0,4,23,11,2,3,1.565261369,1345,42,8,202,181,21,9857,9168,689,87,83,4,99.11727617
19c834a372f25754533c7d0c6a459b5d6ddcfdfd,6,377,26,351,2,0,2,1,34,18,4,6,1.526505525,668,137,21,82,60,22,8081,5961,2120,49,32,17,99.37106918
2fc48498bee08a44f2b6c4e53b7f8671ed5a85dc,8,51,394,343,0,0,0,1,33,11,5,8,1.908097765,1963,43,8,236,257,21,13297,15333,2036,93,110,17,99.37106918
f1a24d5564698a6be733dea7ac3e40925bf1cffb,6,377,26,351,2,0,2,1,34,18,4,6,1.526505525,668,44,9,82,60,22,8081,5961,2120,49,32,17,99.37106918
c65f92800e2b6238c8e7a2a8842cc1b873d22367,2,18,26,8,0,0,0,5,23,12,1,2,0.773226674,1005,138,14,175,176,1,7252,7336,84,61,61,0,100
513f2bd8d5e061a4a1da1e191e3d3aaa5ff7945c,2,25,17,8,0,0,0,5,24,0,1,2,0.791858353,994,139,15,176,175,1,7336,7252,84,61,61,0,100
3b7409f4dc7ea20f623a7278c0485919e56a603d,3,9,2,7,0,0,0,5,37,30,1,2,1.494918848,567,158,6,116,114,2,4910,4863,47,36,36,0,100
84cd38146871a823e5503abfd8c946b044f12a0c,0,0,0,0,0,0,0,0,0,0,0,0,0,0,159,7,0,0,0,0,0,0,0,0,0,100
181b9c544a9d2033192e71f76c96c6b14608bbd5,4,3,10,7,0,0,0,1,36,11,2,3,1.884313528,754,140,16,136,138,2,6237,6284,47,44,44,0,100
8b5b4a80e8fdaa3d846868ace5d664f024fbecdb,3,9,2,7,0,0,0,5,37,30,1,2,1.494918848,567,141,17,116,114,2,4910,4863,47,36,36,0,100
4b52294141e452ce7b4bd7dd47741f17c2233431,7,65,2,63,0,0,0,1,9,53,2,3,2.363033415,576,142,18,65,57,8,3726,3358,368,36,32,4,97.37783075
2319d354cdf5c6102d2a9820764b8e4aceb34d66,1,14,9,5,0,0,0,3,10,0,1,1,0,133,143,19,15,14,1,1031,984,47,4,4,0,100
4c987b977f1f022c1941c896c5df53b126760546,2,77,12,65,1,0,1,1,6,0,1,2,0.840980534,138,144,20,18,16,2,998,759,239,10,8,2,97.05882353
0a3903fccb8be9eb815a5010158c4cbc2593370c,1,0,1,1,0,0,0,2,7,0,1,1,0,138,145,21,15,15,0,728,739,11,8,8,0,100
c72ac22e237373d803a15980faff626daa1c90fe,3,5,5,0,0,0,0,1,8,0,1,2,1.370950594,227,146,22,22,22,0,1193,1171,22,15,15,0,100
5ce8b9542aba9a48c86f805797b9c2ca18181b45,0,0,0,0,0,0,0,0,0,0,0,0,0,0,147,23,0,0,0,0,0,0,0,0,0,100
2c5616cb6afe0397eb64a7614f6ecd6850a65d49,3,31,6,25,0,0,0,3,37,21,3,3,1.577662373,571,148,23,70,62,8,5875,5659,216,35,35,0,100
c0dd09f9318ad79f6408ac919c7bfa47950d320a,4,11,33,22,0,0,0,3,100,21,3,4,1.95880091,1647,160,5,284,290,6,13277,13456,179,95,95,0,100
0f717cff619a357e5e396a248f81fca13d0ca83c,3,31,6,25,0,0,0,3,37,21,3,3,1.577662373,571,161,6,70,62,8,5875,5659,216,35,35,0,100
3b8c4d51ecf121aa3046d9a11e4926bd6cb1e07e,2,3,10,7,0,0,0,4,99,8,2,2,0.995727452,1555,172,15,301,304,3,11035,11088,53,76,76,0,100
75290489d45ba3a878585b7004cc95ab47f2d5c5,2,10,3,7,0,0,0,4,100,10,2,2,0.995727452,1548,162,4,304,301,3,11088,11035,53,76,76,0,100
6382f288a4a6fab86a6cfb796783ded7d0449487,1,1,5,4,0,0,0,4,20,17,1,1,0,503,163,5,81,82,1,3454,3470,16,16,16,0,100
bcd0ff1b2f3c4899936dc22671717797ed0278b5,0,0,0,0,0,0,0,0,0,0,0,0,0,0,164,6,0,0,0,0,0,0,0,0,0,100
739a485235552b81a3664f75d5fd7c649cd59d95,0,0,0,0,0,0,0,0,0,0,0,0,0,0,0,0,0,0,0,0,0,0,0,0,0,100
91c3540dfedff500ada286da5af3ab278cf8807a,2,49,5,44,0,0,0,1,3,96,1,1,0.605186577,198,173,1,53,46,7,1831,1380,451,12,11,1,100
7cc3c7bccbc946fe35c7968ef597ed4206d669cf,0,0,0,0,0,0,0,0,0,0,0,0,0,0,174,2,0,0,0,0,0,0,0,0,0,100
2b7c5e605dd7114c7a903296704760cc66c7d826,1,3,3,0,0,0,0,4,101,33,1,1,0,1052,175,3,222,222,0,7618,7618,0,60,60,0,100
107a89c2794e83a8e663552d3eefd903f77961c1,0,0,0,0,0,0,0,0,0,0,0,0,0,0,149,11,0,0,0,0,0,0,0,0,0,100
c9e9a57a5c34ed3074fbca0c4bbd8c23d38aa06b,1,10,4,6,0,0,0,3,11,36,1,1,0,139,150,12,16,15,1,1072,1031,41,4,4,0,100
5ccecee9634b996ad8fcc08c74c92780b51f8020,1,2,2,0,0,0,0,3,12,2,1,1,0,144,151,13,16,16,0,1074,1072,2,4,4,0,100
e8672d699cfa54ce62faff2a61d47e44d41cd209,2,57,4,53,0,0,0,2,25,78,1,2,0.349184374,527,176,4,123,118,5,4800,4508,292,57,52,5,100
95e97e2c1d749d5d8a7425504e5bd91055790b6b,2,54,1,53,0,0,0,5,10,66,2,2,0.225363639,73,177,5,13,6,7,784,430,354,5,3,2,100
fd712112838970b34d394bce8da0b806dcd41043,22,553,238,315,4,0,4,4,102,41,6,13,3.530866599,3372,178,6,637,576,61,26756,25420,1336,249,213,36,95.65217391
523f2d5310a053a4e4d70642afa8707a089e3494,1,5,3,2,0,0,0,1,2,0,1,1,0,176,179,7,37,36,1,1444,1436,8,23,23,0,100
0fdd86c252a299ba1bc784db3387957d74ca43ed,2,4,0,4,0,0,0,2,4,2,2,2,1,115,180,8,7,7,0,628,602,26,7,7,0,100
0c36bd0987715607112bd149acade3a122ea9083,1,2,2,0,0,0,0,1,2,3,1,1,0,44,181,9,7,7,0,320,316,4,3,3,0,100
ce16ecb0b328102a43414298dd01076e8a8f4a0d,1,1,1,0,0,0,0,1,3,7,1,1,0,178,182,9,37,37,0,1446,1444,2,23,23,0,100
393daed7325ee207011b33e6a90cb7a746469924,3,79,20,59,0,0,0,6,62,79,2,2,1.198269287,628,183,10,77,72,5,7412,6771,641,31,30,1,99.89224138
7a7b51d6262c836a9ff8e75ea6ad12ddce2ac6ab,4,32,11,21,0,0,0,3,31,93,2,4,1.435538162,746,152,3,114,114,0,6211,6024,187,40,40,0,100
f93903a9a49aa03b05d4e3df0d0533e74b0c58fb,0,0,0,0,0,0,0,0,0,0,0,0,0,0,184,6,0,0,0,0,0,0,0,0,0,100
1cfcb52e7f2a0184626e3942e7ac7e5c58d00cb1,0,0,0,0,0,0,0,0,0,0,0,0,0,0,185,7,0,0,0,0,0,0,0,0,0,100
b4f7878f0acde8efa0f06314b4641faf9859d6c7,0,0,0,0,0,0,0,0,0,0,0,0,0,0,165,0,0,0,0,0,0,0,0,0,0,100
bea597b96604df91264fa60e00405c2cde99e837,2,14,1,13,0,0,0,5,25,99,1,2,0.918295834,1001,166,1,177,175,2,7453,7320,133,62,61,1,100
fa2fdbbe2f3000a7ce294873bd0bed4a56cfa13c,0,0,0,0,0,0,0,0,0,0,0,0,0,0,186,2,0,0,0,0,0,0,0,0,0,100
49b7c866509a57ed5b50d6820a9e5fc8ae2eb9c7,0,0,0,0,0,0,0,0,0,0,0,0,0,0,187,3,0,0,0,0,0,0,0,0,0,100
e4d9a225e92e00c9e925a4bec63301a81a0ad3c7,0,0,0,0,0,0,0,0,0,0,0,0,0,0,188,2,0,0,0,0,0,0,0,0,0,100
2938b26e89bb3ccff96b5abd1483e3b9c8c6a25d,0,0,0,0,0,0,0,0,0,0,0,0,0,0,189,3,0,0,0,0,0,0,0,0,0,100
57db284e5cbea50db166d23bdd4be8606ab222a3,0,0,0,0,0,0,0,0,0,0,0,0,0,0,190,4,0,0,0,0,0,0,0,0,0,100
beb999107c6cfa0fc7894133a0d114cbe283ccdb,0,0,0,0,0,0,0,0,0,0,0,0,0,0,0,0,0,0,0,0,0,0,0,0,0,100
1d360c39c8007113bb1f36ec0a45de7d1828f75b,0,0,0,0,0,0,0,0,0,0,0,0,0,0,1,1,0,0,0,0,0,0,0,0,0,100
74eaf98ebfa3c3fc68ae2d245f39106349f03dba,0,0,0,0,0,0,0,0,0,0,0,0,0,0,2,2,0,0,0,0,0,0,0,0,0,100
691af520e8fb614bfb354d454c4b2ffa80102933,0,0,0,0,0,0,0,0,0,0,0,0,0,0,140,0,0,0,0,0,0,0,0,0,0,100
283bd4f46ec114cff43123a740ad0c60a793c922,0,0,0,0,0,0,0,0,0,0,0,0,0,0,141,1,0,0,0,0,0,0,0,0,0,100
e2cc6912f17e1fdec335701d0cacd668d7ab853b,0,0,0,0,0,0,0,0,0,0,0,0,0,0,142,2,0,0,0,0,0,0,0,0,0,100
39772691e71f03a8ea15745b29f7e51777aff5dc,0,0,0,0,0,0,0,0,0,0,0,0,0,0,143,3,0,0,0,0,0,0,0,0,0,100
da0faaeb7dc3f15f1c1925af38d5c6720f85b100,0,0,0,0,0,0,0,0,0,0,0,0,0,0,167,0,0,0,0,0,0,0,0,0,0,100
c9cf9a93a873c3566ed921f76200388620d57cf9,0,0,0,0,0,0,0,0,0,0,0,0,0,0,168,1,0,0,0,0,0,0,0,0,0,100
4dcb77bc1c680b58a95c9517899b4d4e7ec06486,0,0,0,0,0,0,0,0,0,0,0,0,0,0,169,2,0,0,0,0,0,0,0,0,0,100
f062a3af4a98964cf3cf58f33eb260586796eb11,4,46,44,2,0,0,0,4,38,232,2,4,1.088141722,589,170,3,81,78,3,4747,4745,2,33,34,1,99.67776584
084185d7a11f5dc743b6232145ebb676234ea3d0,1,9,0,9,1,0,1,1,1,0,1,1,0,0,171,4,0,0,0,45,0,45,0,0,0,99.67880086
83349d9f8511e53a4cab7422d14867b3e6ecbe2d,4,65,28,37,0,0,0,2,15,237,3,4,1.137837952,459,153,0,55,50,5,3535,3208,327,31,29,2,100
dfaec240b0edda747445961028cc85a66c8bf127,4,28,65,37,0,0,0,2,14,41,3,4,1.137837952,492,191,0,50,55,5,3208,3535,327,29,31,2,100
3b31ef1dccd04742bd545087df84c3652fd74de5,4,65,28,37,0,0,0,2,15,237,3,4,1.137837952,459,172,0,55,50,5,3535,3208,327,31,29,2,100
418305b0d5d5e335f4693f9658089aea1494db5d,0,0,0,0,0,0,0,0,0,0,0,0,0,0,173,1,0,0,0,0,0,0,0,0,0,100
a020ad0a13ad3315ed440c67806d5728ca389c24,3,37,3,34,0,0,0,5,38,241,1,3,1.53949107,580,154,0,122,116,6,5095,4906,189,56,52,4,100
37445fb61943741b647a31f01c42fbca382d579b,4,43,7,36,0,0,0,3,36,157,2,3,1.73646752,831,155,1,139,133,6,7168,6922,246,39,38,1,100
03f2d1bf5a3d924076b0c37a1d48a2337869e4ee,5,23,32,9,0,0,0,4,63,181,3,3,1.742811986,687,156,2,69,70,1,5659,5710,51,28,28,0,100
52b5569fa71fdd8052289b3649a741ff8d3e37e5,2,6,1,5,0,0,0,4,44,1,2,2,0.863120569,234,157,3,46,44,2,1948,1902,46,11,11,0,100
3374f8e14ff17e29d6aa5e83d71ebbf5a63335fb,15,123,102,21,0,0,0,5,103,135,7,10,3.347679605,4192,174,2,665,669,4,33998,33757,241,237,235,2,90.02624672
4f619fc877f41753b0778e59a70e5c479386a14c,9,71,39,32,0,0,0,3,63,102,5,6,2.703179062,1517,175,3,210,203,7,12866,12625,241,67,66,1,100
8fc6c804fd87b8cd4f870312f9c55e79c219486f,4,22,6,16,0,0,0,6,64,133,3,2,1.940285959,798,158,4,92,88,4,8207,8078,129,44,44,0,100
b087334b12396a452944d45b75d3fd391602d023,1,1,1,0,0,0,0,4,104,3,1,1,0,1073,176,4,229,229,0,7788,7788,0,62,62,0,100
f5a9c4fada3c8824d957da242c0d4cdbc8fa0803,4,7,7,0,0,0,0,4,103,143,2,2,1.950212065,1526,159,5,266,266,0,11125,11125,0,81,81,0,100
d9834c651e915d7db065cbb82109ebe202498230,1,1,1,0,0,0,0,4,104,3,1,1,0,1073,160,6,229,229,0,7788,7788,0,62,62,0,100
60b6df17418553408becb339578fbb6512cfae5e,2,3,3,0,0,0,0,3,22,142,2,2,0.918295834,467,161,7,62,62,0,3852,3845,7,31,31,0,100
6c623236db9607e1abc82e6b87f2c9e3fff63c64,24,477,382,95,0,0,0,3,104,182,8,17,3.252593535,5609,176,4,914,899,15,46034,45235,799,346,340,6,100
942781c0d91dcde7d21365f3d39fb1a3e1ea14b4,8,31,10,21,0,0,0,3,42,146,5,5,2.853447358,1505,178,6,163,159,4,13335,13148,187,86,86,0,100
620b2bcba6937d47f2ab8903ce578dcc8a2ab50f,6,182,74,108,1,0,1,4,34,111,2,6,2.12465601,909,179,5,152,144,8,8969,8155,814,49,44,5,98.47560976
56bbfe286bd2eb34b405e4159949d6ba0d697e26,2,7,1,6,0,0,0,3,37,14,2,2,0.811278124,414,180,6,85,82,3,3136,3096,40,30,30,0,100
68ca33235eaead48c67557b55d985ab28ba348e9,13,310,129,181,3,0,3,1,16,207,6,8,3.030089646,884,162,7,109,85,24,6883,5573,1310,51,40,11,88.18097876
e418435fa965976e7b5345105e2208edd0db785e,5,337,0,337,5,0,5,1,1,0,2,3,2.029516919,0,163,4,11,0,11,1438,0,1438,9,0,9,91.26794258
4a2d55af891ddd8cb50c886ffffaf5dc566d32e2,16,29,548,519,0,0,0,1,43,45,6,11,2.848328646,1608,181,4,126,161,35,8019,10763,2744,60,80,20,85.49172347
f19193c7c8498576c93b681a5983c39e724b4813,15,546,28,518,5,0,5,1,16,75,6,10,2.816039058,884,182,5,120,85,35,8321,5563,2758,60,40,20,85.49172347
6543073d086d0657767ceac39f9229412fbe3768,1,7,5,2,0,0,0,6,44,0,1,1,0,273,183,6,42,41,1,2450,2446,4,20,20,0,100
9b2952f8da042cfe0a9a6761d2a66006c1a805c2,9,168,33,135,0,0,0,6,65,48,4,7,2.824875175,1739,164,2,267,251,16,17880,16515,1365,99,95,4,100
b8063c5f2ab5eeaaae6d7932b334d0ea7072ee19,1,7,6,1,0,0,0,6,46,0,1,1,0,274,165,3,42,41,1,2450,2452,2,20,20,0,100
8ea47a6b8689215bbb5035a41f6a7f91893e6a80,0,0,0,0,0,0,0,0,0,0,0,0,0,0,166,4,0,0,0,0,0,0,0,0,0,100
78b90217d736ae2f883c40c705671152347c8f6a,1,1,1,0,0,0,0,4,32,12,1,1,0,245,167,5,30,30,0,2422,2422,0,11,11,0,100
5c9d840040a32a9da2a90e2a515fe476ebc7c766,1,2,2,0,0,0,0,4,33,8,1,1,0,245,168,6,30,30,0,2429,2422,7,11,11,0,100
73074dd77d640c6687b81733615a8f6cdad68d53,7,80,21,59,0,0,0,4,47,151,2,4,2.464061693,1096,169,7,200,193,7,9543,9134,409,69,66,3,100
a42042c36f2c45cb3cd576115b73dbe993433d98,3,12,6,6,0,0,0,3,15,242,2,3,1.571541672,560,170,6,60,60,0,4311,4229,82,27,27,0,100
0681050a78533f091680a945548401047d419877,5,17,5,12,0,0,0,4,34,36,2,3,1.968130014,584,171,7,57,54,3,4613,4523,90,25,24,1,100
82ec9292fedff590c01e2b30696b5edd0e41c576,33,199,321,122,0,0,0,5,65,106,7,19,4.123487916,6093,184,0,838,851,13,48709,49903,1194,367,370,3,90.38901602
de3bd51eb275b8dd2ac2eef5fec5196b662aeee2,23,276,60,216,0,0,0,3,67,155,5,14,3.952161574,3440,185,1,500,473,27,30163,28222,1941,226,217,9,99.58634953
c3895967465f805a2988e322a754a15f39baabf0,0,0,0,0,0,0,0,0,0,0,0,0,0,0,172,5,0,0,0,0,0,0,0,0,0,100
653cc42823428b7190e69d43fda4a915b8ae3f00,0,0,0,0,0,0,0,0,0,0,0,0,0,0,173,6,0,0,0,0,0,0,0,0,0,100
facd508c38e81bb0808ea589e1ef614a99989380,1,1,1,0,0,0,0,4,46,20,1,1,0,117,186,2,18,18,0,1078,1076,2,6,6,0,100
24e1114fcef34ed5f676f29a342048d39b350a09,0,0,0,0,0,0,0,0,0,0,0,0,0,0,187,3,0,0,0,0,0,0,0,0,0,100
52c7fe4bdef6d1bbcf3d70324614eb578e1e9504,1,18,17,1,0,0,0,4,47,2,1,1,0,117,188,4,18,18,0,1081,1078,3,6,6,0,100
8af69c9ce02b123177bb3332905eef68f3f78677,2,14,11,3,0,0,0,4,105,64,2,2,0.989587521,1287,189,5,291,289,2,9714,9677,37,74,74,0,100
09d352b94679fcc8a8b9e669e15508440469766c,1,4,1,3,0,0,0,4,37,26,1,1,0,245,190,6,30,30,0,2453,2426,27,11,11,0,100
553357d5718aa3dd307c0832720b4ec0b50fc35e,6,88,46,42,0,0,0,5,106,188,5,3,1.731101561,1803,191,0,285,285,0,14407,14018,389,98,97,1,100
8d0b86041dbb6bb0ec65230539e8ffa80f6489e0,20,120,154,34,0,0,0,5,104,204,7,13,3.329948964,3935,174,0,606,606,0,31034,31354,320,200,201,1,100
a2d358173b29fc1244291bf62d249fff438d1803,8,126,75,51,0,0,0,5,106,128,5,5,2.194016898,2267,175,1,374,372,2,18779,18321,458,119,118,1,100
16f39a588e42414618a511b7b21d4fa93971b747,0,0,0,0,0,0,0,0,0,0,0,0,0,0,176,2,0,0,0,0,0,0,0,0,0,100
b162f926dee3402ab0d292c63c3cfa21475751c4,0,0,0,0,0,0,0,0,0,0,0,0,0,0,177,3,0,0,0,0,0,0,0,0,0,100
cec2f5fb5b856ee7c72693e41dd1a1c887391583,10,19,19,0,0,0,0,1,40,0,4,9,3.031116172,1246,178,4,180,180,0,9647,9647,0,65,65,0,100
6c041181ae6a609bb61a58c8600e77c03fce5f4b,3,11,11,0,0,0,0,6,69,56,3,1,1.435371391,765,179,5,106,106,0,7303,7295,8,42,42,0,100
bc3f16c705a027aff789fcb7c1419203626b788b,0,0,0,0,0,0,0,0,0,0,0,0,0,0,192,0,0,0,0,0,0,0,0,0,0,100
087d454251ccee4fb0ef3a5aac746df85f7fc750,16,273,3,270,0,0,0,4,29,616,3,11,3.973055162,1589,193,1,313,313,0,12868,12870,2,157,157,0,100
1effe89c341bbec50aa242f297d8aeae4c9c0185,16,3,273,270,0,0,0,3,28,35,3,11,3.973055162,1844,1,0,313,313,0,12870,12868,2,157,157,0,100
effbd7ba72ab48fc0e0e4c95c2c1a20fcedcc318,16,273,3,270,0,0,0,4,29,616,3,11,3.973055162,1589,2,1,313,313,0,12868,12870,2,157,157,0,100
6663e692d8e2ed130896df836f833352e67d8d40,0,0,0,0,0,0,0,0,0,0,0,0,0,0,3,2,0,0,0,0,0,0,0,0,0,100
f44531e978b1660554f064db47056a02ca090768,0,0,0,0,0,0,0,0,0,0,0,0,0,0,180,0,0,0,0,0,0,0,0,0,0,100
e26cb49497be22f641406d134f04be6a0919765e,0,0,0,0,0,0,0,0,0,0,0,0,0,0,181,1,0,0,0,0,0,0,0,0,0,100
b3b2038fff08979817841ba3519293b1068433bc,0,0,0,0,0,0,0,0,0,0,0,0,0,0,182,2,0,0,0,0,0,0,0,0,0,100
525caaca81e1ff60b519066160163c4ddc6f8d11,0,0,0,0,0,0,0,0,0,0,0,0,0,0,0,0,0,0,0,0,0,0,0,0,0,100
bbf6950203fd4995d1f1fa4c02073104e4d8f18a,0,0,0,0,0,0,0,0,0,0,0,0,0,0,0,0,0,0,0,0,0,0,0,0,0,100
73984494a7078d612b8f1eb6dd809d43a2e68e34,1,7,0,7,0,0,0,3,8,719,1,1,0,78,194,0,9,8,1,427,407,20,8,7,1,100
b59520c34b338c544548da91031bcd0a7db7bfaf,0,0,0,0,0,0,0,0,0,0,0,0,0,0,195,1,0,0,0,0,0,0,0,0,0,100
891c7c36806c67e732c16c074c2cfc8c2a3a9aa4,3,8,7,1,0,0,0,6,39,395,3,3,1.5058231,527,6,0,32,33,1,5797,5739,58,25,26,1,100
dd628df902eea5dbf6186f6a00c744a20ad63548,1,7,0,7,0,0,0,3,8,719,1,1,0,78,7,1,9,8,1,427,407,20,8,7,1,100
d3902f583a7085febb7040d120120a70be13cc98,1,2,4,2,0,0,0,6,40,1,1,1,0,216,8,2,14,14,0,2965,2993,28,11,11,0,100
7c92ca112ab42cb47dc1d514ee1b87d60d54ea06,5,18,5,13,0,0,0,6,62,372,2,4,1.924673369,1525,9,3,127,127,0,11842,11730,112,89,89,0,99.89648033
2fcd3c695d946bb0a393da2f35b1020e35db4d03,1,2,2,0,0,0,0,2,11,198,1,1,0,182,10,4,22,22,0,1372,1374,2,8,8,0,100
ee598ddbb7787479ca6f7152de04459f60b47cd5,0,0,0,0,0,0,0,0,0,0,0,0,0,0,11,5,0,0,0,0,0,0,0,0,0,100
6539ec55b7c525cdd89a3ca3114695c2e2ea410c,9,268,104,164,0,0,0,6,63,375,5,7,2.383300911,1684,183,0,172,154,18,14789,13555,1234,88,82,6,91.2
79e9c2da0697ac65bec62ba7a67c5b2a50825e8c,4,23,30,7,0,0,0,3,107,381,3,4,1.331097945,1392,12,0,278,276,2,10268,10285,17,74,74,0,100
7b3fd006b2e3c7c4cd2f7d3a8382384e8a2938b8,0,0,0,0,0,0,0,0,0,0,0,0,0,0,13,1,0,0,0,0,0,0,0,0,0,100
8efaf7b95fd23fc796913e268ea2bcbb0c7fcae0,0,0,0,0,0,0,0,0,0,0,0,0,0,0,0,0,0,0,0,0,0,0,0,0,0,100
d9eadb56071cd51e8ba8834fe2f503026001b581,0,0,0,0,0,0,0,0,0,0,0,0,0,0,1,1,0,0,0,0,0,0,0,0,0,100
eb3f162ff74ff7e0f2ef0f62203b92b9efa79511,1,22,1,21,0,0,0,5,108,6,1,1,0,1061,14,2,237,232,5,7919,7782,137,65,64,1,100
8e2fe22448b0b2e8f2abca644c22651914a0568e,1,8,21,13,0,0,0,5,109,0,1,1,0,1081,15,3,235,237,2,7835,7919,84,65,65,0,100
55882c1818e9ac90b45072f6d04e41f09549c01f,1,11,14,3,0,0,0,5,110,0,1,1,0,1068,16,4,234,235,1,7840,7835,5,64,65,1,100
fa540cce5e98a71034d7113d51ed5c6f8add455f,1,919,919,0,0,0,0,5,111,0,1,1,0,1066,17,5,234,234,0,7840,7840,0,64,64,0,100
7b2f0f650f8e6cf46544c5a63a1071c8391272d8,1,1,1,0,0,0,0,5,112,0,1,1,0,1066,18,6,234,234,0,7829,7840,11,64,64,0,100
5956501de224dd72e0f04afd91f982d1190c1d65,0,0,0,0,0,0,0,0,0,0,0,0,0,0,19,7,0,0,0,0,0,0,0,0,0,100
2577f1309e5f4897f7556f506c6de25a4dc2bb5a,0,0,0,0,0,0,0,0,0,0,0,0,0,0,192,0,0,0,0,0,0,0,0,0,0,100
c1cd5444e90c74874c32a7d19843922fc6a3a764,12,82,107,25,0,0,0,4,42,529,6,8,3.296391979,1648,20,0,130,129,1,13992,14158,166,87,86,1,87.68796992
72865f0ee3d9a78834d56d661613fa51120193a5,1,0,1,1,0,0,0,3,7,78,1,1,0,133,184,0,12,12,0,1049,1056,7,5,5,0,100
2c0a3143ff61d45814310893451a664a13f2f2c9,1,5,2,3,0,0,0,5,113,71,1,1,0,1066,196,0,234,234,0,7866,7829,37,64,64,0,100
939fa587a1b3cc39e2063b202fecd1840300c11e,405,26450,26448,2,202,0,202,5,114,253,13,127,8.113074165,22022,1,0,2951,3152,201,154963,191925,36962,1486,1687,201,33.36113428
0398491db4c9c4a438d754a767bc85f46b5eb846,0,0,0,0,0,0,0,0,0,0,0,0,0,0,2,1,0,0,0,0,0,0,0,0,0,100
63ddb3dd5a06e40b06d1b8c9e30fba16ce714560,0,0,0,0,0,0,0,0,0,0,0,0,0,0,3,2,0,0,0,0,0,0,0,0,0,100
dfaf33f2087a32ea6f90a7945d278960669905f4,198,742,166,576,0,0,0,1,4,5,12,63,6.815670953,20762,4,3,2807,2807,0,142964,142964,0,1419,1419,0,100
ce2589e2b36786a4fe3e61163ad58b62ccbe0e37,2,70,12,58,1,0,1,1,3,1,1,2,0.712064055,82,0,0,25,18,7,804,401,403,17,13,4,95.93082401
b09c5ee0e947b96777548058b16dc135c5988145,1,17,0,17,0,0,0,1,2,0,1,1,0,55,1,1,10,10,0,425,425,0,4,4,0,100
2e147a6dd3c9a80591f7c2caa25e689900213590,0,0,0,0,0,0,0,0,0,0,0,0,0,0,2,2,0,0,0,0,0,0,0,0,0,100
b047ce2b4af86e823bca01be0db2f9bd0c619be6,0,0,0,0,0,0,0,0,0,0,0,0,0,0,3,3,0,0,0,0,0,0,0,0,0,100
a4d79f0c516580d92935fcded7b5d25fb89168b3,186,9423,9313,110,0,0,0,2,5,0,13,63,6.447239621,18658,4,4,2852,2852,0,150587,152371,1784,1395,1394,1,99.78118162
e69b220564e9d63c52dbaccfdc1fd0765a639a8b,15,213,161,52,0,0,0,2,4,2,1,7,2.818031217,1640,5,5,315,318,3,11931,11918,13,148,147,1,100
74a1c6584d6e5c9f31636e0973e4573859a89edf,1,2,3,1,0,0,0,2,5,0,1,1,0,63,6,6,16,16,0,414,427,13,7,7,0,100
b1fcaacccdc2574704c0631c8ab625ec590c04f2,8,18,7,11,0,0,0,2,6,0,4,5,2.722292189,1029,7,7,192,192,0,7991,7993,2,100,100,0,100
bdadf2ed680b338d3ec48cb179300f50db69fee0,69,665,485,180,0,0,0,2,4,0,4,27,4.952168292,5313,8,8,864,855,9,43980,43923,57,429,418,11,100
afbcea089140baf9c7400d8e31fa99748c9f8d2e,3,35,24,11,0,0,0,2,5,2,1,3,1.353988848,428,9,9,53,53,0,4079,4073,6,21,21,0,100
46f07b342e8f0b5e2dcc670d2f1f6c949ac4f355,6,48,37,11,0,0,0,2,4,0,1,2,2.352982648,714,10,10,84,84,0,5699,5686,13,45,45,0,100
2a94690df67c1df868dcb7f816fffa6cd2f6651b,9,44,20,24,0,0,0,2,4,10,1,4,2.79359621,319,11,11,43,42,1,2260,2252,8,25,24,1,100
6119bedb1e2087e565381e4cfcd5e9357fd69f37,0,0,0,0,0,0,0,0,0,0,0,0,0,0,12,12,0,0,0,0,0,0,0,0,0,100
968f197dff0053fc91505432d356fff334901198,4,10,10,0,0,0,0,2,6,0,1,3,1.921928095,715,13,13,144,144,0,5169,5169,0,81,81,0,100
9bfdf3bb2236496e1f16f0722004902e8c347c23,5,21,18,3,0,0,0,2,5,0,1,3,1.983579634,806,14,14,93,92,1,7184,7174,10,59,58,1,100
2a2fa50a3a1ec5138d1a6dd9b10342373432596d,1,1,1,0,0,0,0,2,6,0,1,1,0,59,15,15,8,8,0,583,583,0,4,4,0,100
223d8f02190e08a39c23da62f8f97528f6c44a5d,1,2,2,0,0,0,0,2,5,0,1,1,0,79,16,16,8,8,0,580,580,0,8,8,0,100
9b4d845f018c4f6a0a659cde63131ed08f0fa811,19,275,172,103,0,0,0,3,6,0,1,11,2.448783525,2525,17,17,448,446,2,19192,19071,121,196,194,2,100
8dbbd5caffb4fe4886cf796be8c765c04141c1c5,1,1,1,0,0,0,0,2,4,0,1,1,0,125,18,18,19,19,0,1106,1106,0,6,6,0,100
f739a7e82e47aefddbd82780305fb77acb67fcb3,0,0,0,0,0,0,0,0,0,0,0,0,0,0,19,19,0,0,0,0,0,0,0,0,0,100
5c3dd0e40eb15ce230f304d2f6e1c8f05a15a815,0,0,0,0,0,0,0,0,0,0,0,0,0,0,20,20,0,0,0,0,0,0,0,0,0,100
ca7c16a2fc5bdc1806e32abcb932282edd8795bc,2,4,5,1,0,0,0,2,4,10,2,2,0.918295834,600,21,21,36,36,0,5339,5328,11,32,32,0,100
12889e2a8b0389d6f281e4eed4839caf10341099,0,0,0,0,0,0,0,0,0,0,0,0,0,0,5,4,0,0,0,0,0,0,0,0,0,100
f8b9122243af317905fc60c8555f1514851f96f3,28,219,164,55,0,0,0,2,4,5,1,14,4.385340896,3095,6,5,517,516,1,22130,22168,38,290,288,2,98.13800657
fcfd9b36c88bf375ba8c9d25fa85ea686be8839b,5,62,55,7,0,0,0,2,5,18,1,3,1.861160585,732,7,6,76,76,0,7358,7364,6,34,34,0,100
dbd980ea4f97fce2182689d12667cdb04915388e,5,36,18,18,0,0,0,2,4,16,1,2,2.265733659,455,8,7,71,73,2,3805,3825,20,28,28,0,99.56043956
6a39baf35709c9757c36952c8f1d9c13fed8da45,26,295,221,74,0,0,0,2,5,0,1,9,3.808825005,1503,9,8,208,208,0,11193,11184,9,105,105,0,100
4e39c7a960a7ed0dd2d4a934e462ca92be074dd7,2,65,87,22,0,0,0,2,3,22,1,2,0.920473223,618,10,9,75,75,0,4950,4937,13,37,37,0,100
e9979317f2a7ecddd7079baf3f1a7cfa9b7d29f5,2,11,12,1,0,0,0,2,5,17,1,1,0.886540893,172,11,10,19,19,0,1360,1358,2,14,14,0,100
f15ef92a8d70d968f727a6b50b681d33ec58d78a,13,141,106,35,0,0,0,2,5,12,1,7,3.083712672,1948,12,11,164,162,2,15895,15954,59,122,120,2,99.56284153
bfad459e175229a51bfd7946c8593f1b61967872,38,226,313,87,0,0,0,2,7,62,10,27,4.198032212,6378,22,0,1149,1162,13,49647,49598,49,480,489,9,99.78213508
f90fc4d30aaebe93ddd82e7620df88323f72057d,0,0,0,0,0,0,0,0,0,0,0,0,0,0,23,1,0,0,0,0,0,0,0,0,0,100
3e7c8d30bcd4198b0a11f5e442c4ffe9e61cdd7f,2,6,2,4,0,0,0,2,5,62,2,1,1,29,13,0,4,4,0,231,177,54,4,4,0,99.34210526
748e5583feec5086572ce603fb9d95f3a4d4089f,0,0,0,0,0,0,0,0,0,0,0,0,0,0,14,1,0,0,0,0,0,0,0,0,0,100
3572a1d477707cda873d8116c71f2ed497a96e55,1,1,1,0,0,0,0,2,5,65,1,1,0,36,24,2,5,5,0,223,223,0,5,5,0,100
122f94494a49b357d0ceeacbfa2289ffe7215cba,0,0,0,0,0,0,0,0,0,0,0,0,0,0,25,0,0,0,0,0,0,0,0,0,0,100
f2a17306ab651bb45dd1d63a559467f848dfddde,0,0,0,0,0,0,0,0,0,0,0,0,0,0,26,1,0,0,0,0,0,0,0,0,0,100
d7e2be9afa2a5dc96acd1ec9e325f39c6b2f17f7,2,45,5,40,0,0,0,2,6,248,1,1,1,402,27,0,34,30,4,4131,3850,281,21,19,2,100
614173574b0f37a7cb3c068c322ca88326722b47,12,1687,792,895,4,0,4,1,6,52,4,8,2.863246598,1776,15,0,247,298,51,21744,21236,508,170,164,6,95.38131042
d5aa7a92b8a1d7f398d5abaa8b681b90e8551ccd,3,34,23,11,0,0,0,2,5,252,1,2,1.546561811,298,16,1,23,22,1,2777,2691,86,15,14,1,100
cd7ac385f0b37d7a3ea145ff35138b9bd575e9b4,0,0,0,0,0,0,0,0,0,0,0,0,0,0,28,1,0,0,0,0,0,0,0,0,0,100
8d2d34b9d1999447b35495a75c0bd52b4396e1bb,0,0,0,0,0,0,0,0,0,0,0,0,0,0,29,2,0,0,0,0,0,0,0,0,0,100
689d52a6e98055b98e13bdda02c4ebc820e13257,3,52,2,50,0,0,0,2,6,255,2,3,1.00976893,432,30,3,67,61,6,4348,3887,461,28,28,0,100
09971e66be57d6c0884415240feed85cb2a444a6,10,597,161,436,1,0,1,2,6,136,3,8,2.367277206,1862,31,4,243,197,46,18543,16195,2348,138,116,22,99.79079498
17ce0b0f8d89d0549906b87cee18f7f8da989d7d,0,0,0,0,0,0,0,0,0,0,0,0,0,0,32,5,0,0,0,0,0,0,0,0,0,100
caa0d26b916e4079ac2fb48f990521b677370095,1,3,3,0,0,0,0,2,7,29,1,1,0,28,33,6,3,3,0,186,186,0,2,2,0,100
39eb956236f6e46b407299490eb720b154b7d506,0,0,0,0,0,0,0,0,0,0,0,0,0,0,34,7,0,0,0,0,0,0,0,0,0,100
30102983296baecb412b2f81672dbce6c9e8522b,4,44,69,25,0,0,0,2,6,132,2,3,1.722672774,2028,35,8,331,331,0,16306,16224,82,128,128,0,99.68619247
24edc18b39e752ac25db697dcc51b30a3f80ce03,0,0,0,0,0,0,0,0,0,0,0,0,0,0,36,9,0,0,0,0,0,0,0,0,0,100
9f3c4d9ecc4b27ec1322b1f610e31c39a0b32bb9,0,0,0,0,0,0,0,0,0,0,0,0,0,0,37,10,0,0,0,0,0,0,0,0,0,100
0e1e578c4be4d2cce98af1e6a54cd9b11f830ab9,0,0,0,0,0,0,0,0,0,0,0,0,0,0,38,10,0,0,0,0,0,0,0,0,0,100
027918ad6e4d82f29b7047b8920ef922cf0f1d53,0,0,0,0,0,0,0,0,0,0,0,0,0,0,39,10,0,0,0,0,0,0,0,0,0,100
46dcea2f22bad1fac9491e276458dd4128dd0647,3,188,109,79,1,0,1,3,6,179,1,2,1.417476584,118,0,0,33,18,15,1090,805,285,21,7,14,99.58071279
c050f06e1de39f9292306c765ab1010ed8962355,1,1,1,0,0,0,0,3,7,9,1,1,0,110,40,10,23,21,2,742,730,12,10,10,0,100
a740c4d6cfa3490d8a3104d1b8872086129e1bf9,0,0,0,0,0,0,0,0,0,0,0,0,0,0,40,10,0,0,0,0,0,0,0,0,0,100
b2ea2beec3932bb2c2731feff69aea763245c557,0,0,0,0,0,0,0,0,0,0,0,0,0,0,42,12,0,0,0,0,0,0,0,0,0,100
7d042084d0e3298949a341cd94f5c1c3c6e2771f,0,0,0,0,0,0,0,0,0,0,0,0,0,0,43,5,0,0,0,0,0,0,0,0,0,100
7118f16687b84c6ba6f1fa974ccdaff30d534b51,0,0,0,0,0,0,0,0,0,0,0,0,0,0,44,6,0,0,0,0,0,0,0,0,0,100
58b2a7c6075a84f81d080a6b21df4812311085f8,2,27,5,22,0,0,0,2,5,340,1,1,0.857148437,177,45,6,45,42,3,1690,1533,157,9,9,0,99.8951782
9aa2c63a71e2c1d54963bbbee0b7ad19aa908c06,1,52,15,37,0,0,0,2,8,68,1,1,0,28,46,6,7,3,4,430,186,244,3,2,1,100
33a68b7a6f1d0183acb102e825329fdb83c04bdd,5,240,11,229,1,0,1,1,7,108,3,4,1.309316655,1206,197,0,264,246,18,10692,9372,1320,84,71,13,97.87685775
416a358b0c2c2ad148295c1a0eb831061acbfdfb,17,274,214,60,0,0,0,2,7,210,8,12,3.406536376,2681,47,2,296,291,5,24071,23738,333,182,179,3,98.18956337
662c560cb4c43ebaaa48b7a3d5145a6b3ba10a0d,0,0,0,0,0,0,0,0,0,0,0,0,0,0,48,3,0,0,0,0,0,0,0,0,0,100
9a038fe7c1d780966847dad04260f6aee2fef94c,0,0,0,0,0,0,0,0,0,0,0,0,0,0,198,1,0,0,0,0,0,0,0,0,0,100
31c62be85f233c8daa77b233eb70e789b43c4fbd,7,7,9,2,0,0,0,2,7,183,6,6,2.780639062,734,49,4,57,57,0,7159,7159,0,37,37,0,100
4f86c0b1494c2271605a84b4444de84478c0ceed,5,43,92,49,0,0,0,2,6,202,3,4,2.031508549,255,50,3,29,32,3,1830,1897,67,17,19,2,99.36575053
b9604241990bc4c507bd9a09cbeda334aeab7a26,0,0,0,0,0,0,0,0,0,0,0,0,0,0,199,2,0,0,0,0,0,0,0,0,0,100
16972af8620e653208521aa8d4b5abc8b9234b32,0,0,0,0,0,0,0,0,0,0,0,0,0,0,200,2,0,0,0,0,0,0,0,0,0,100
19ba0368ea6f9bbb960781ca7dbafd93b084ad00,0,0,0,0,0,0,0,0,0,0,0,0,0,0,201,3,0,0,0,0,0,0,0,0,0,100
70b8a8e11a91fe3682028e18f249afa326d35605,0,0,0,0,0,0,0,0,0,0,0,0,0,0,51,4,0,0,0,0,0,0,0,0,0,100
8b09e1b272113e9b769a20f09b6c0c4e2ec7c18a,6,195,24,171,3,0,3,2,8,15,2,4,2.348766888,242,52,5,38,26,12,2708,2082,626,23,17,6,94.6930281
19bcf9994125bba86bf5ed79ef3d44c5bf0a2f8a,1,97,43,54,0,0,0,2,4,11,1,1,0,101,53,6,19,13,6,1045,781,264,10,6,4,100
edf03d4a85b7f047135c7c2f711de8d88484b9d1,0,0,0,0,0,0,0,0,0,0,0,0,0,0,54,7,0,0,0,0,0,0,0,0,0,100
1e6ace4327910250f60e6d1e41ce5b1726bf4a4f,20,944,124,820,5,0,5,2,8,139,4,12,3.610759706,2609,55,8,484,393,91,28318,24652,3666,211,161,50,94.56521739
c82b663fcb74fe00b6ff7572e8c2735d9f878b7c,20,124,944,820,0,0,0,2,9,0,4,12,3.610759706,3126,56,9,393,484,91,24652,28318,3666,161,211,50,94.56521739
7b128817689c11969525f82931e0c69d270e7af9,0,0,0,0,0,0,0,0,0,0,0,0,0,0,57,10,0,0,0,0,0,0,0,0,0,100
f1db98b378a36b749206682b3bc3900e0cad7716,1,43,97,54,0,0,0,2,5,8,1,1,0,144,58,11,13,19,6,781,1045,264,6,10,4,100
d422dba4816fb3003d72c8c1e3d835c19c99f50c,6,24,195,171,0,0,0,2,9,4,2,4,2.348766888,319,59,12,26,38,12,2082,2708,626,17,23,6,94.6930281
76fcef48003f0603cb0e22f75ddc9600c6aa8665,2,2,2,0,0,0,0,3,10,42,1,2,1,414,202,0,50,50,0,3948,3948,0,17,17,0,100
0dc6c6c2851f1438067418deae41d47402baa08e,13,319,104,215,1,0,1,3,10,139,7,8,3.146290846,3367,202,0,540,506,34,32318,30551,1767,228,221,7,99.68287526
fa2bc8e5cd40bbae728950e7c2ed171665f4856f,2,2,2,0,0,0,0,3,12,0,1,2,1,463,204,2,59,59,0,4449,4449,0,18,18,0,100
518dc89528b73d5c65248db56a87518a255446b7,4,33,33,0,0,0,0,2,13,22,4,3,1.917562349,1050,60,0,134,133,1,10278,10329,51,63,63,0,100
5e8238bcdf4dca74a6cc5e45783ff1a400b8eebe,1,5,2,3,0,0,0,3,6,182,1,1,0,162,205,3,14,13,1,1486,1459,27,13,13,0,100
471115687b8598eafea996f734aa5bb07f7981c4,7,71,45,26,0,0,0,3,7,351,2,6,1.91496788,765,61,1,159,156,3,6337,6125,212,62,61,1,97.22772277
acb9f6a10fb31f6fda3f5995cb670128c8254fc9,0,0,0,0,0,0,0,0,0,0,0,0,0,0,62,2,0,0,0,0,0,0,0,0,0,100
827d7a793b04890bb77cd4a7f8ba379e4e45df19,0,0,0,0,0,0,0,0,0,0,0,0,0,0,63,3,0,0,0,0,0,0,0,0,0,100
e86e1920ed3c53dba8cb193c22a4ea1753c053eb,0,0,0,0,0,0,0,0,0,0,0,0,0,0,64,4,0,0,0,0,0,0,0,0,0,100
f6d8188b7d48e1954a075c92997bde6029843e7d,1,85,46,39,0,0,0,3,8,144,1,1,0,1067,206,1,245,236,9,8436,8018,418,66,65,1,100
7abe982c705bbc79e8b5a09d5b17dc911e91fb0c,0,0,0,0,0,0,0,0,0,0,0,0,0,0,207,2,0,0,0,0,0,0,0,0,0,100
7bc8452f9e7443b67c2c02235c5253409534a047,0,0,0,0,0,0,0,0,0,0,0,0,0,0,208,3,0,0,0,0,0,0,0,0,0,100
a9c968a351a275d3ba8822069ee32fe9763b26e5,0,0,0,0,0,0,0,0,0,0,0,0,0,0,209,4,0,0,0,0,0,0,0,0,0,100
2785d1ab0a5b4c371bc665d44cf66f29e9e16402,0,0,0,0,0,0,0,0,0,0,0,0,0,0,65,2,0,0,0,0,0,0,0,0,0,100
50f59d5405e994ab023268d5a6671bef07cce93f,0,0,0,0,0,0,0,0,0,0,0,0,0,0,66,1,0,0,0,0,0,0,0,0,0,100
ef069038465684ebb4fd3334d93f2ba4fa77174e,0,0,0,0,0,0,0,0,0,0,0,0,0,0,67,2,0,0,0,0,0,0,0,0,0,100
3575b4dfd336ad4b98e3a50d291300108afb4883,5,46,53,7,0,0,0,2,8,524,3,5,1.711569938,1532,68,2,238,238,0,12020,11929,91,94,94,0,100
b47788d1112fcf949c22a3860934167237b395b0,0,0,0,0,0,0,0,0,0,0,0,0,0,0,69,3,0,0,0,0,0,0,0,0,0,100
17f901a66b6b555abb886ee55fb7b73871fb9cb2,75,6916,1124,5792,21,0,21,1,14,240,14,39,5.321213042,9339,70,0,2040,1528,512,115523,80074,35449,993,687,306,89.47849954
cd78c3aa5f60afcaad7eddd0bf5f2279ed53e35d,2,59,35,24,0,0,0,3,8,546,2,1,0.935014559,398,1,0,85,84,1,3262,3125,137,29,29,0,100
51c6eb20353adf603280d0cf08bedf2686043150,3,31,11,20,0,0,0,4,10,71,3,3,1.221694908,1126,2,1,133,133,0,10176,10066,110,75,75,0,100
2703d52ca3291b9f99f9b4422ea5d7a418de84e0,0,0,0,0,0,0,0,0,0,0,0,0,0,0,3,2,0,0,0,0,0,0,0,0,0,100
04392a6971dd6c36786968c2f22955608a94e983,2,55,5,50,1,0,1,1,8,1,1,2,0.650022422,182,4,3,28,27,1,1657,1446,211,8,7,1,95.85133967
bf63dbf192eff2f2057a3bd3a38c77f59b98976d,1,1,0,1,0,0,0,2,3,2,1,1,0,54,5,4,6,6,0,463,456,7,3,3,0,100
7de95ad78a0a8b3b2a7e856ba488d2b57a749aed,4,61,28,33,0,0,0,4,7,24,2,3,1.430671659,1360,6,5,159,156,3,12163,11927,236,78,78,0,100
9e376c20e3d9fa449c0ea10310d9fb396cf62223,0,0,0,0,0,0,0,0,0,0,0,0,0,0,7,6,0,0,0,0,0,0,0,0,0,100
c91483604bad271af9515550723dd5df56c29906,0,0,0,0,0,0,0,0,0,0,0,0,0,0,8,7,0,0,0,0,0,0,0,0,0,100
a5466768f9a364e5174dfc40745584f7ce461e2f,0,0,0,0,0,0,0,0,0,0,0,0,0,0,9,8,0,0,0,0,0,0,0,0,0,100
818ae5bf6e98434ac8001042b788cdc3d7573991,0,0,0,0,0,0,0,0,0,0,0,0,0,0,10,9,0,0,0,0,0,0,0,0,0,100
a035bdf64c55914d1ec79639c0aa329772c5cb57,2,13,7,6,0,0,0,4,13,10,1,2,0.881290899,950,11,10,137,137,0,10508,10449,59,52,52,0,100
f6f2a05681332b023a97833f374c61c22f817b24,0,0,0,0,0,0,0,0,0,0,0,0,0,0,12,11,0,0,0,0,0,0,0,0,0,100
82393d1e3e7071fd8e204cd09cab52f67da7d51b,0,0,0,0,0,0,0,0,0,0,0,0,0,0,13,12,0,0,0,0,0,0,0,0,0,100
9ffd2ad5af3645c1b55f9c39dd516929f40f47fd,2,16,0,16,0,0,0,4,9,295,2,2,0.69621226,413,14,13,72,69,3,3524,3389,135,43,43,0,100
ea508abed0b41ac27c3c05319f4cff6229e8aee8,0,0,0,0,0,0,0,0,0,0,0,0,0,0,15,14,0,0,0,0,0,0,0,0,0,100
3825357b82a8574da65d9b001a47e56208c8be19,0,0,0,0,0,0,0,0,0,0,0,0,0,0,16,15,0,0,0,0,0,0,0,0,0,100
73e54e04bd3015f895174890a0aae868cac7b796,5,42,169,127,0,0,0,3,10,206,2,3,1.197066496,1785,71,0,351,371,20,13270,13431,161,139,162,23,99.58298582
7ba640e127ccac61be116a54e24b4629bd888e58,0,0,0,0,0,0,0,0,0,0,0,0,0,0,210,0,0,0,0,0,0,0,0,0,0,100
e4d12b2619921af2a7053bf7c5e5dbad1c049924,0,0,0,0,0,0,0,0,0,0,0,0,0,0,211,1,0,0,0,0,0,0,0,0,0,100
3c27e6b89616c4f61383026d0593a7601d230003,1,4,6,2,0,0,0,2,7,99,1,1,0,134,72,1,17,18,1,940,970,30,9,9,0,100
6a505a322e2aabc5304f6e929527459ebf10ca3f,0,0,0,0,0,0,0,0,0,0,0,0,0,0,212,2,0,0,0,0,0,0,0,0,0,100
744c2911aa9b5916619c10b5c4993aa6c4dcb9a1,1,1,1,0,0,0,0,4,11,42,1,1,0,1095,185,0,243,244,1,8407,8419,12,66,66,0,100
407cf4a5abb374a0067e4828b24a317b5f30c9ca,2,130,72,58,0,0,0,3,5,743,2,2,0.727829059,208,213,2,25,20,5,2258,1776,482,14,12,2,98.01038062
a123c0497148fd739a6ac855e8048222f36ec05e,0,0,0,0,0,0,0,0,0,0,0,0,0,0,214,3,0,0,0,0,0,0,0,0,0,100
aa8383b7732583e0f6c783c2ec70f0a471baa8a1,1,8,11,3,0,0,0,3,8,134,1,1,0,289,215,4,77,77,0,2377,2375,2,16,16,0,100
3a345c9cfa6b3a242c4c205f8e6823d49ec80d04,0,0,0,0,0,0,0,0,0,0,0,0,0,0,216,5,0,0,0,0,0,0,0,0,0,100
8b479426ea9818f2515e447589de886d2ad463d7,0,0,0,0,0,0,0,0,0,0,0,0,0,0,17,0,0,0,0,0,0,0,0,0,0,100
2ded629145df0d9c537b3d65d2457c09083dfc9f,22,603,309,294,0,0,0,2,14,343,7,14,3.262824931,5417,217,4,992,932,60,50845,48276,2569,383,362,21,100
dfe20ee7a46a402ede1ed13bd474db37d4109c07,0,0,0,0,0,0,0,0,0,0,0,0,0,0,218,5,0,0,0,0,0,0,0,0,0,100
8472f129f00013ab5a3c621fd091d1d0452af729,1,8,1,7,0,0,0,3,7,508,1,1,0,171,219,6,27,25,2,1494,1440,54,9,9,0,100
28f6a4ec68f95f8f16c75aae92aa68ac156455df,7,67,34,33,0,0,0,4,13,256,4,5,2.231788172,2528,220,7,418,408,10,21726,21409,317,151,149,2,100
171a2f40960e9b165396887b109b0f3c39322056,0,0,0,0,0,0,0,0,0,0,0,0,0,0,221,7,0,0,0,0,0,0,0,0,0,100
de6cba7122597c295f670e7bdf5fcbfdd34ad12b,0,0,0,0,0,0,0,0,0,0,0,0,0,0,222,5,0,0,0,0,0,0,0,0,0,100
abd3fa48a715ab8966ea17f4ba45731ead7793cb,0,0,0,0,0,0,0,0,0,0,0,0,0,0,223,6,0,0,0,0,0,0,0,0,0,100
2bd7053b03f83a4c83383766728c3de76222ed89,5,59,1,58,0,0,0,5,15,121,3,2,2.065592688,2145,0,0,305,295,10,22677,22166,511,123,120,3,99.11971831
6bb539f3dfdf727a6a4cc647c2a5b732c2f031a2,1,2,2,0,0,0,0,5,14,25,1,1,0,1083,1,1,247,247,0,8624,8618,6,67,67,0,100
7ea43bd0ab53a45dc793e7998c99ab3bff166337,0,0,0,0,0,0,0,0,0,0,0,0,0,0,224,7,0,0,0,0,0,0,0,0,0,100
934aebd2676a5a154b5e259d0c41ee86a73ac696,0,0,0,0,0,0,0,0,0,0,0,0,0,0,225,8,0,0,0,0,0,0,0,0,0,100
ec4f4334972df1000bf60b3c8c25f0821efaa1fe,2,29,4,25,0,0,0,4,11,216,1,2,0.799048521,984,226,9,179,175,4,7815,7609,206,62,61,1,100
cf87d1353e88e1852214fda3938681bea5453fdd,0,0,0,0,0,0,0,0,0,0,0,0,0,0,227,10,0,0,0,0,0,0,0,0,0,100
81051f300e75b8a6c9fa2cebf642fb186b89eb88,1,2,4,2,0,0,0,3,8,11,1,1,0,506,228,7,85,85,0,3687,3707,20,16,16,0,100
d555dd50136e2dd0c76ccad407d56e88a03810fd,2,37,6,31,0,0,0,3,10,42,1,2,0.999609836,404,229,8,63,58,5,4352,4085,267,19,18,1,100
d1642beab5d5073dd57c43137f0b7b22cb87ecf9,27,1192,574,618,8,0,8,4,16,148,9,18,3.899943326,4682,230,9,560,469,91,44425,41360,3065,362,276,86,94.67811159
5c930440668af663c228a987e666bcbb7423e71e,9,396,4,392,1,0,1,3,15,288,5,6,2.682057072,3127,231,7,582,526,56,26863,24330,2533,212,190,22,99.32432432
2b25d3c7845b09cdd047bc9b6e9c375d07c2d03b,0,0,0,0,0,0,0,0,0,0,0,0,0,0,232,8,0,0,0,0,0,0,0,0,0,100
4ffdaef813edc1475e7827908d6fc4a4c44c1217,14,910,0,910,14,0,14,1,1,0,1,5,3.681711068,0,73,0,49,0,49,1622,0,1622,39,0,39,97.31489015
0d1855229cec9eb0b4c20b5b45b9ebe8b2eb15bd,1,104,0,104,1,0,1,1,1,0,1,1,0,0,74,1,6,0,6,171,0,171,4,0,4,99.84177215
4496b2dbf33c12e634dd52deee27b5971e522d4b,2,57,17,40,0,0,0,3,8,232,1,2,0.494182935,716,2,0,97,90,7,6584,6253,331,46,44,2,100
c1228fd7442fa641a218f4c03dc83cb9b555543e,5,200,24,176,3,0,3,3,8,15,2,3,2.015069023,553,75,2,83,68,15,5562,4725,837,36,31,5,99.37156324
7dc8a8db75c714d3c288b892235ab33f05fb1ed0,8,98,118,20,0,0,0,4,16,34,5,6,2.262099792,3658,76,3,622,618,4,30255,30565,310,215,215,0,100
2da31c328b85452f0998ef3346fb195985f084a0,0,0,0,0,0,0,0,0,0,0,0,0,0,0,77,4,0,0,0,0,0,0,0,0,0,100
2cb42dfff565bc74926da58294dc20c96ed808fd,0,0,0,0,0,0,0,0,0,0,0,0,0,0,18,0,0,0,0,0,0,0,0,0,0,100
3c51f1053a3524557d1e1e58f0a4fc778431e75c,91,2658,1268,1390,8,0,8,2,17,291,11,42,5.246901276,13898,19,1,2234,2105,129,125842,118131,7711,992,934,58,95.73495811
d5b64722c451b1cb09dcb11530c2723a33494579,6,26,22,4,0,0,0,4,11,15,5,6,2.303648693,1400,3,0,211,213,2,11943,11893,50,91,91,0,100
027efd592fc5e030e74521f9dff4df32b5b7662a,5,72,104,32,0,0,0,6,18,26,2,4,1.259501639,1945,233,0,405,417,12,16190,16455,265,120,122,2,98.69942197
1af2e92fda1859d0360c65db7e14e4d8247d826f,0,0,0,0,0,0,0,0,0,0,0,0,0,0,20,1,0,0,0,0,0,0,0,0,0,100
2570f1513fa16a195cf487590e3c909faa02973a,0,0,0,0,0,0,0,0,0,0,0,0,0,0,21,2,0,0,0,0,0,0,0,0,0,100
b42f740a886f436fba95eb0a4758f8439d1d8a0b,2,49,29,20,0,0,0,4,19,32,2,2,0.619382195,1519,234,1,350,344,6,12399,12299,100,94,93,1,100
b01d0416b1686070764c5625c508ccc964e27956,0,0,0,0,0,0,0,0,0,0,0,0,0,0,235,2,0,0,0,0,0,0,0,0,0,100
22632e676e181cc27a67809b5b2bca3e97866b0a,2,70,10,60,0,0,0,3,10,65,1,2,0.230709956,748,4,1,101,96,5,7000,6570,430,47,46,1,100
8825537ccd7697725621b766960f4e563d6131bb,0,0,0,0,0,0,0,0,0,0,0,0,0,0,5,2,0,0,0,0,0,0,0,0,0,100
bd2de46ffa3956ffe9cd14068598ea20d2016bf3,3,10,16,6,0,0,0,4,15,362,2,3,1.557930785,865,6,3,156,155,1,7145,7038,107,71,70,1,100
d57c71e6e23a4de221f2e01a4021005f51564fae,1,6,1,5,0,0,0,3,5,941,1,1,0,38,7,4,5,5,0,284,252,32,3,3,0,96.24724062
464442af25a87f9b40c6b017f75da8e083449ad1,1,2,1,1,0,0,0,6,20,32,1,1,0,1141,236,3,267,266,1,9336,9328,8,70,70,0,100
42d04f37feaeee26fd6239dfa275173660a331f9,1,2,2,0,0,0,0,6,21,4,1,1,0,1142,22,2,267,267,0,9336,9336,0,70,70,0,100
bb5e144970cf0336be859e5576afd8908861e687,5,120,9,111,0,0,0,5,18,233,3,3,1.879275208,1864,23,3,263,251,12,20644,19779,865,106,101,5,100
59c8d5001109dc8485b55bd0500ecf2d1230faf4,7,407,54,353,3,0,3,3,9,27,3,5,2.271480249,602,24,4,98,71,27,6868,4875,1993,60,42,18,86.67805295
ecb919c603ae726fa1dc6e94f1867ba699505a1b,17,2023,36,1987,6,0,6,4,13,149,4,10,2.72801926,1407,25,5,508,239,269,23500,11470,12030,245,110,135,98.67799811
b8b2fe45dc480223af1bc70ed13e70ab82b60053,4,640,0,640,1,0,1,2,16,14,3,4,1.292305023,1156,26,6,282,197,85,12737,8924,3813,99,67,32,94.51219512
7debf45137dc9f4edc2b4c7e2aef81f0075ddeba,2,2,13,11,0,0,0,2,14,0,2,2,0.970950594,704,27,7,118,119,1,5201,5275,74,25,26,1,99.42763696
5445e109bc7fbfea9295f3411a994485b65d1477,1,8,4,4,0,0,0,4,8,649,1,1,0,110,237,3,24,23,1,774,742,32,10,10,0,100
3158c0321d86c474a6edc117a008fc518215663e,2,130,1,129,0,0,0,3,6,62,1,2,0.718864131,303,28,6,57,42,15,3203,2272,931,32,21,11,100
6b3288621b2186abdf243d498a78df5f8c558caf,10,228,166,62,0,0,0,4,10,10,3,5,2.542838978,2168,29,7,376,371,5,18418,18280,138,184,178,6,100
39800a097867c4debd3f7d35ee2fce90187ccef4,1,3,2,1,0,0,0,4,10,26,1,1,0,418,238,3,45,45,0,3676,3647,29,23,23,0,100
1e7aa8e6a4e1d7a7c67897aedbd1bb4b4e1850a4,3,20,4,16,0,0,0,3,19,137,2,3,1.325011211,875,30,8,100,98,2,8898,8778,120,46,45,1,100
bb55a2c9f489c21f9c0d2e9faf1e4ed1bce8c176,1,4,2,2,0,0,0,4,11,9,1,1,0,166,31,9,26,25,1,1449,1432,17,11,11,0,100
5e43521519900f7778c7db938aaec85ee4489a52,4,132,450,318,0,0,0,3,22,116,3,3,1.230324313,1576,239,4,297,338,41,11255,12859,1604,86,112,26,99.83606557
e2545b0874d206f3be88d4b3ac7003eae1161c44,15,1909,2079,170,1,0,1,4,23,293,5,7,2.944817416,4151,240,3,666,678,12,39230,41290,2060,240,247,7,90.94368341
f769933b63a0bd11a6fb766b324d312e69700add,2,6,4,2,0,0,0,1,3,22,1,2,0.970950594,707,32,10,89,89,0,6387,6370,17,51,51,0,100
6504e7a11dc029baaa414087ed6c4d2128b6b5f2,0,0,0,0,0,0,0,0,0,0,0,0,0,0,33,11,0,0,0,0,0,0,0,0,0,100
abc97fbd47e44792698b261fe5e987a81735a19f,4,20,18,2,0,0,0,2,17,36,3,4,1.606832278,1631,34,12,281,281,0,12589,12589,0,100,100,0,100
652e4a15702cb273485b2c480cc758ce9967f089,3,31,9,22,0,0,0,1,5,337,2,3,1.578712463,739,35,13,99,97,2,6708,6580,128,57,56,1,99.78708304
1b60ebd1d0b2ebb501a3558d9a5f7afc2a0717ec,1,1,1,0,0,0,0,3,4,380,1,1,0,55,241,3,6,6,0,463,463,0,3,3,0,100
0310e95f141169cef2be8637bb4a59b0a17862d9,2,17,13,4,0,0,0,4,9,120,2,2,0.836640742,833,242,4,75,75,0,6155,6104,51,52,52,0,100
8f7c0dce361d5ec700c82d0828ed5560b9c6f27a,0,0,0,0,0,0,0,0,0,0,0,0,0,0,243,5,0,0,0,0,0,0,0,0,0,100
4e8065c58ae94ebeb2905e29b8462df468be15cd,10,1121,210,911,4,0,4,1,5,9,2,4,2.464489942,1700,36,8,395,308,87,20320,14055,6265,199,143,56,96.05425401
ab327ea9e93508e0366a03c1f5bac08aaa6db7e0,3,4,26,22,0,0,0,2,18,6,2,3,1.158938532,1316,37,9,226,230,4,10050,10184,134,80,82,2,100
a90b474067e964958b76e2ff54cc13ef86c042a7,0,0,0,0,0,0,0,0,0,0,0,0,0,0,244,6,0,0,0,0,0,0,0,0,0,100
24142a1ff304a3d9b08325580ecdd6ecf860d673,0,0,0,0,0,0,0,0,0,0,0,0,0,0,38,8,0,0,0,0,0,0,0,0,0,100
cf0512f91f87404c9002b9db0462ba3708637d83,3,7,1,6,0,0,0,4,19,10,2,3,1.5,1697,245,7,254,254,0,12639,12594,45,107,107,0,100
5cd3710099233d09e030e9cfc694a51bbcf0c209,0,0,0,0,0,0,0,0,0,0,0,0,0,0,8,0,0,0,0,0,0,0,0,0,0,100
c9792ede54c804a925a235829c374eaa1414b692,1,19,11,8,0,0,0,6,24,23,1,1,0,1097,39,9,270,268,2,9403,9386,17,70,70,0,100
b3e92753633cda9d81b5dbb1173f3c0190477b4a,1,1,1,0,0,0,0,4,11,115,1,1,0,600,40,10,37,37,0,5763,5763,0,32,32,0,100
f7284f8b0512249562203c8a6b83d8676300c849,1,2,1,1,0,0,0,3,6,950,1,1,0,57,9,1,10,10,0,334,328,6,5,5,0,100
0e81412b091f078a28dabd703e8b67130acbcf21,1,10,10,0,0,0,0,4,7,60,1,1,0,58,246,0,10,10,0,346,334,12,4,5,1,100
3eebed8cac35d9b21f1787adbd38b822678a8f1e,1,1,1,0,0,0,0,5,13,99,1,1,0,155,247,1,23,23,0,1348,1348,0,9,9,0,100
f10802d69b083852e687f62016de547da82497b2,0,0,0,0,0,0,0,0,0,0,0,0,0,0,248,2,0,0,0,0,0,0,0,0,0,100
d28ad7e04d9becbc180dc3dca5bf2e1186fdf4da,6,102,27,75,0,0,0,4,20,204,3,5,1.798473074,2341,249,3,376,358,18,20060,19447,613,144,142,2,96.89922481
9dcbdf5471191ad75200f1941e86d3d2375b5239,0,0,0,0,0,0,0,0,0,0,0,0,0,0,41,0,0,0,0,0,0,0,0,0,0,100
ae5d29b065e507bd2e13e6d04d6cf2c6c58e140a,2,73,1,72,0,0,0,3,6,200,2,2,0.966009606,242,42,1,28,23,5,2305,1851,454,14,11,3,100
946182a093afb5d5fbc15486c868ae349164a3b6,0,0,0,0,0,0,0,0,0,0,0,0,0,0,43,2,0,0,0,0,0,0,0,0,0,100
7fa6ca57e0b1121fc07de999932f5b8546222b1b,4,70,51,19,0,0,0,4,9,165,2,4,0.803102988,1041,250,4,124,122,2,10528,10378,150,57,56,1,100
173ebec197358e1881d3e58732881e27149d05a6,6,429,49,380,0,0,0,3,11,343,3,5,1.639131423,1147,251,5,191,146,45,12387,9645,2742,99,85,14,100
fbd790c45dd9a5b689314722b64661c0125e4a87,1,2,5,3,0,0,0,3,7,2,1,1,0,157,44,3,9,9,0,1254,1285,31,8,8,0,100
0728d91a5b03402b258993c6a31b72ae2ffaae8b,12,504,77,427,4,0,4,4,21,290,3,8,3.066377833,1836,45,4,347,317,30,16642,14483,2159,146,126,20,96.49643705
49593f198bbf7d5ce77774f4a5aa139423e9e54d,7,639,126,513,0,0,0,2,11,115,4,3,2.469937199,2509,46,5,446,366,80,28908,25774,3134,174,150,24,96.64041995
b765d32e822e640a6d4a5657135f3f5e5b274500,2,58,0,58,0,0,0,3,10,366,1,2,0.824657833,689,47,6,117,112,5,6611,6138,473,40,37,3,100
97f06ac0c9e87d5ff86b233e666fb448d193d012,0,0,0,0,0,0,0,0,0,0,0,0,0,0,48,7,0,0,0,0,0,0,0,0,0,100
c6bfca909c7b27b27347894f0447fa8a9d926d10,0,0,0,0,0,0,0,0,0,0,0,0,0,0,49,8,0,0,0,0,0,0,0,0,0,100
d41a7354440de27f3cf0b9d9aa782ee658a46804,4,30,20,10,0,0,0,2,11,183,2,4,1.765864217,1318,50,9,202,201,1,12809,12742,67,80,79,1,100
cb476052806799de069c5f8065a61f46213098c2,0,0,0,0,0,0,0,0,0,0,0,0,0,0,51,10,0,0,0,0,0,0,0,0,0,100
f17ed681b0a0655bc573fed3f94d09689334de5c,0,0,0,0,0,0,0,0,0,0,0,0,0,0,52,11,0,0,0,0,0,0,0,0,0,100
40a24c43457b723ac38c93e60cc239a4b16cd7df,1,1,1,0,0,0,0,4,7,7,1,1,0,153,252,4,30,30,0,1314,1310,4,9,9,0,100
f25e6c916d6229f81e454a3ff9417e10a6cb2694,1,6,0,6,0,0,0,4,10,129,1,1,0,375,253,5,44,44,0,3137,3103,34,22,22,0,100
dc0958c28799d87a3806ba0da16aaec9d1406808,0,0,0,0,0,0,0,0,0,0,0,0,0,0,53,12,0,0,0,0,0,0,0,0,0,100
49c0df4bc12c4bbe4c9c86991f06ac641213f102,0,0,0,0,0,0,0,0,0,0,0,0,0,0,54,13,0,0,0,0,0,0,0,0,0,100
8b6554bb8cf9eca6c3f3c20d6ec876a445ebaa62,0,0,0,0,0,0,0,0,0,0,0,0,0,0,55,14,0,0,0,0,0,0,0,0,0,100
c4035db227a3424547eddb953b1e28f92a2040d4,0,0,0,0,0,0,0,0,0,0,0,0,0,0,56,15,0,0,0,0,0,0,0,0,0,100
b08eacb4a240bf25200762cce0caef2809279a5c,1,3,1,2,0,0,0,4,20,20,1,1,0,627,57,16,115,114,1,4667,4641,26,23,23,0,100
8c48a2ce01641c136c00ff4c543602bff8fdb054,0,0,0,0,0,0,0,0,0,0,0,0,0,0,58,17,0,0,0,0,0,0,0,0,0,100
888a3eead53c884dbce479e0ef23b51d70abade5,1,6,1,5,0,0,0,2,2,313,1,1,0,148,59,18,26,25,1,1188,1151,37,19,19,0,100
5689007818aba0c3ced129fa185bfdaab7ff630e,0,0,0,0,0,0,0,0,0,0,0,0,0,0,60,19,0,0,0,0,0,0,0,0,0,100
ad2701d2b10148b3ee112ec7058ad3c512a2ded1,0,0,0,0,0,0,0,0,0,0,0,0,0,0,61,20,0,0,0,0,0,0,0,0,0,100
623ee4a663d5b3ba5353f7357c08784a6f5222d9,0,0,0,0,0,0,0,0,0,0,0,0,0,0,62,21,0,0,0,0,0,0,0,0,0,100
7700dc2689f9547c1dd4fd88a003543f177e39ee,0,0,0,0,0,0,0,0,0,0,0,0,0,0,63,19,0,0,0,0,0,0,0,0,0,100
397ef0c2818526d0f951bfa063fef6e97637ec75,1,15,12,3,0,0,0,4,8,33,1,1,0,482,64,19,79,79,0,4282,4262,20,35,35,0,100
a5792e4fb114a06db967d2e3b2b7b8c77fcdb60c,0,0,0,0,0,0,0,0,0,0,0,0,0,0,65,20,0,0,0,0,0,0,0,0,0,100
209c37152dd5612facbfe84130f68e63fb0bdb32,0,0,0,0,0,0,0,0,0,0,0,0,0,0,66,21,0,0,0,0,0,0,0,0,0,100
d2ac5b6e0c0c866c82c0cc6b91828ed7e4e463a2,0,0,0,0,0,0,0,0,0,0,0,0,0,0,67,22,0,0,0,0,0,0,0,0,0,100
97f89a1e6579a1f3284fa61744c14eab7bd2b2f0,2,52,43,9,0,0,0,1,6,178,1,2,0.861124706,711,68,5,92,90,2,6746,6704,42,52,52,0,100
b036d740a4dc13bb5e8102dde71519229f202506,74,599,609,10,0,0,0,3,25,373,12,33,5.690237497,11909,254,0,2121,2130,9,98273,98401,128,834,834,0,100
5afbf3585be80df06d6a0d755d0fe2569ec50a0e,2,52,43,9,0,0,0,1,8,89,1,2,0.861124706,712,255,1,92,90,2,6745,6699,46,52,52,0,100
089ecf419f989a97ea6aa8e68669b25f0ab9a13e,12,512,200,312,1,0,1,4,26,123,7,10,3.059538289,3820,256,2,697,664,33,32602,30457,2145,266,257,9,95.77056779
36d01791c9df137f6c97f59100038c737e7ee162,0,0,0,0,0,0,0,0,0,0,0,0,0,0,0,0,0,0,0,0,0,0,0,0,0,100
2129285dccb720f0f1f405b52474b9df61ee1708,5,212,30,182,0,0,0,2,13,24,4,3,1.435160531,2257,69,6,371,361,10,24245,22422,1823,141,138,3,97.12182062
b7afe36f494091e283702c28af5f42ef482226a0,6,89,48,41,0,0,0,4,14,11,4,3,1.464498319,3044,70,6,451,444,7,31390,31164,226,174,169,5,100
3d3bde558027af1f6ceb914b396cf6a41682625e,3,28,1,27,0,0,0,2,12,22,3,3,1.178559464,1207,71,7,174,166,8,13140,12947,193,78,77,1,100
5ac7544bcb0d9e578d5ddc78de9382e5057220af,5,33,77,44,0,0,0,2,9,36,2,3,1.770800532,926,72,4,133,135,2,8941,9195,254,55,55,0,99.86631016
91704c6aed86bdc8e5f2dc7981d69ade75048973,0,0,0,0,0,0,0,0,0,0,0,0,0,0,73,5,0,0,0,0,0,0,0,0,0,100
f6882282ef8394b4629522073d6100df9e29e35a,0,0,0,0,0,0,0,0,0,0,0,0,0,0,74,6,0,0,0,0,0,0,0,0,0,100
9cfd386cfe6e8bc03b7c24432d299d9ae39ed4e5,0,0,0,0,0,0,0,0,0,0,0,0,0,0,75,7,0,0,0,0,0,0,0,0,0,100
3ec559e96e07c585c5b6efd558436d4f1d30c68c,0,0,0,0,0,0,0,0,0,0,0,0,0,0,76,8,0,0,0,0,0,0,0,0,0,100
a9127c54099c109fc45cbef487f19d2173d65d9f,0,0,0,0,0,0,0,0,0,0,0,0,0,0,77,9,0,0,0,0,0,0,0,0,0,100
448e92bb5304362cc27ab8d0cbb5218ee1c4cb0b,0,0,0,0,0,0,0,0,0,0,0,0,0,0,78,10,0,0,0,0,0,0,0,0,0,100
ab07b44bb76237765e6dc2d8c576d69ac70a59a9,0,0,0,0,0,0,0,0,0,0,0,0,0,0,79,3,0,0,0,0,0,0,0,0,0,100
662adb2154cbd47bbdaebceae529013ed37d125f,2,51,12,39,0,0,0,1,6,167,1,2,0.918295834,925,80,4,131,125,6,8250,8010,240,67,64,3,100
e01dd79c73fa6bc9623dbdd87e7981eff1796c6c,2,19,1,18,0,0,0,4,9,76,1,2,0.468995594,351,81,5,66,64,2,2807,2696,111,33,32,1,99.86631016
b501baa36f89270b738f907537cda61e4fa10816,6,78,34,44,0,0,0,4,27,156,3,5,1.174340638,2939,82,6,499,495,4,26156,25927,229,182,179,3,100
b68946a02d6eff9314e242f73d7e97855c01957d,6,106,2,104,0,0,0,6,28,214,2,4,2.150066203,2158,83,7,495,481,14,18227,17576,651,152,145,7,100
1be98326bd6ce1658bf8a9db592bd9b6a768e8b2,9,146,11,135,0,0,0,4,29,196,5,6,2.907813135,3920,257,0,690,675,15,31944,30960,984,259,252,7,100
5517156e136194a49921cfbbf1d377c3bd93de94,1,35,12,23,0,0,0,5,9,45,1,1,0,103,0,0,13,12,1,920,763,157,11,9,2,99.86631016
cfd647af0e526d1de45b95fe7506157f868306d5,1,12,2,10,0,0,0,3,10,141,1,1,0,130,258,0,17,16,1,1225,1182,43,7,7,0,100
49627f0877dd457fc56a15d454cf0be49ef645d6,2,17,2,15,0,0,0,5,30,61,2,2,0.485460761,1809,1,0,328,325,3,16094,15979,115,108,108,0,100
64c2cb573fb8f3747452e3a31c503d1c5ab43c72,1,8,5,3,0,0,0,4,13,136,1,1,0,477,259,1,81,80,1,4188,4147,41,35,35,0,100
5626b2dd1d63a9762806e0e3a20d9624a46005c5,4,5,2,3,0,0,0,2,15,130,2,2,1.950212065,2413,260,2,343,343,0,25751,25721,30,128,128,0,100
57953f77b03a68317b554619c2b17f8e9c623b2e,4,51,27,24,0,0,0,3,23,65,2,4,1.637035233,1475,261,3,275,274,1,11576,11434,142,79,80,1,99.86648865
185b58885df921a0179ae2aff8e32b4ec591fa15,31,3066,2607,459,16,0,16,3,31,100,5,11,4.164986342,5497,262,4,1048,1034,14,53677,53561,116,391,387,4,83.04140127
954cd955424ca3e0cc15f251295c2ce167f87fcb,0,0,0,0,0,0,0,0,0,0,0,0,0,0,263,5,0,0,0,0,0,0,0,0,0,100
14476f9ab30414cbddabb33bf67d5e4270952fda,26,572,518,54,0,0,0,5,32,101,4,13,3.715875368,6924,2,0,1103,1116,13,66628,65930,698,434,435,1,100
6f40e2a5a6ac9df3434ad33e446157e5604ecad1,1,1,0,1,0,0,0,4,11,48,1,1,0,138,3,1,17,17,0,1236,1225,11,7,7,0,100
ed100c8ac0b2cc086556fabbf14b2ea3e8424101,2,85,6,79,0,0,0,2,4,678,1,2,0.779349837,521,78,0,97,86,11,5127,4551,576,60,52,8,100
3bb5a62affc5a87df4232865c5e8894aef0333bd,20,550,277,273,2,0,2,2,12,43,2,7,3.723264975,3611,264,0,576,556,20,37207,36290,917,240,223,17,98.92682927
b2e1032d0c455cf09139bab336f051e2ae26fb4c,2,12,4,8,0,0,0,4,16,260,1,2,0.337290067,748,4,2,73,72,1,7064,6996,68,43,42,1,100
bdcf001fe7c57ef7822ff398243ca63d7fc2a40a,186,40210,0,40210,186,0,186,1,1,0,1,24,6.845810616,0,4,0,2792,0,2792,233364,0,233364,1655,0,1655,69.09090909
ad51ca03f3af9fe7dcec47291c9f7a6ea586cb1d,37,295,277,18,0,0,0,1,2,0,1,11,4.174859116,3056,5,1,573,571,2,23468,23542,74,349,347,2,100
74e858b4f60e379e5f1f819ba0e69d28f78fc8ef,1,5,2,3,0,0,0,1,2,5,1,1,0,83,6,2,5,5,0,848,821,27,5,5,0,100
9094742b374370b41b440bb7d22de4dcaee19d5b,69,126,6302,6176,1,0,1,1,3,0,1,8,5.658848954,4865,7,3,503,878,375,23581,36075,12494,217,527,310,78.94045534
b79e10afacd727b19ac8146735020dfcc093a7f0,2,2,9,7,0,0,0,1,2,8,1,1,0.945660305,223,8,4,13,13,0,2238,2320,82,13,13,0,100
ac17551176f78da903d16c48f9181a67a1e392fa,1,2,2,0,0,0,0,1,2,8,1,1,0,89,9,5,6,6,0,850,851,1,6,6,0,100
4bc578708b0b72d5139a5b451e56d971d2550096,0,0,0,0,0,0,0,0,0,0,0,0,0,0,10,6,0,0,0,0,0,0,0,0,0,100
993534d3ff2a14b03ba295532007a983c0651d7d,2,156,7,149,1,0,1,1,2,5,1,2,0.401313922,265,11,7,22,14,8,3520,2544,976,22,14,8,98.37570621
5cb6afafac20b5ee32a5e6946b51998418894961,1,6,2,4,0,0,0,1,4,2,1,1,0,778,12,8,150,150,0,6661,6639,22,86,86,0,100
8ed874c33d90899edf1c4892a15c6e5227178c58,2,51,11,40,0,0,0,5,33,34,2,2,0.740865686,1810,265,1,323,318,5,16453,16175,278,111,108,3,100
c8820bd5e441711c7c233676719278883338a14c,1,4,0,4,0,0,0,7,34,0,1,1,0,1204,266,2,281,279,2,10332,10297,35,77,77,0,100
a13323ef60b7fd089b3f832b02b72c5add4021d2,11,55,39,16,0,0,0,2,13,31,2,5,2.597804111,2212,5,1,385,380,5,21626,21480,146,156,155,1,92.91070211
b1830605b4f50bb6bb59658118af14001795a348,5,215,12,203,1,0,1,2,14,359,3,4,2.151516482,369,84,0,67,47,20,4140,3114,1026,37,27,10,99.86928105
909888f9b6703ac4daffeac1605eb78408ccf586,2,132,20,112,0,0,0,5,10,284,1,2,0.954434003,437,85,1,83,77,6,4675,3960,715,37,31,6,100
a3c1ffe844d1c8214ab9289e33e7a1312c9949f1,4,200,21,179,0,0,0,3,15,106,1,4,0.93849651,1259,86,2,205,192,13,11954,10727,1227,86,79,7,100
adca0057d279022a9f32900c64ecca8d9f70f8a6,32,1686,398,1288,6,0,6,1,16,152,3,14,4.029859062,5211,87,3,898,786,112,51043,44555,6488,438,375,63,98.57235561
7b3e51079c6ac39808130e0a1df2e6adeb55db07,0,0,0,0,0,0,0,0,0,0,0,0,0,0,88,4,0,0,0,0,0,0,0,0,0,100
84cc3684de2b29bfd50fcaba755692dbf03cf478,2,112,29,83,0,0,0,1,2,0,1,2,0.808455794,438,89,5,70,61,9,3989,3657,332,45,41,4,100
c4de9eca72c621f544e5cf39861ff08d1ad83cc0,2,2,2,0,0,0,0,3,5,0,2,2,1,734,90,6,89,89,0,8511,8511,0,38,38,0,100
522788157d4b32ed609e5b1d0e7ff2660d78b553,1,19,0,19,0,0,0,5,16,0,1,1,0,390,91,7,89,85,4,3185,3073,112,25,24,1,99.8065764
b42c53baaf29fee4466264aac83b70dca0903af9,5,892,0,892,5,0,5,1,1,0,1,2,1.996461903,0,92,8,110,0,110,4141,0,4141,97,0,97,99.29980904
23762e55b860fa1ecf2433de0cda654e2a3f0fc1,22,1130,1146,16,4,0,4,4,15,241,5,12,3.730749013,3425,93,9,464,474,10,32712,34537,1825,232,243,11,91.95864446
c6000363a19e11745d9f3f7abc14e03f08be7f88,8,118,362,244,0,0,0,4,12,242,4,7,1.997990023,1121,94,10,144,158,14,7194,9133,1939,70,79,9,96.8011811
b9781d121cc334a76c7f5dd0dde32ca3c257db91,5,65,22,43,0,0,0,4,12,235,1,2,2.15254308,348,95,11,53,51,2,3179,2824,355,26,24,2,99.53938277
a099443758045d625da5d2bb382898e5e13009ab,9,164,477,313,0,0,0,1,9,155,2,3,2.849906677,1976,96,12,299,322,23,15796,17351,1555,157,174,17,97.53554502
1ccae452933d75f212d3d267a3cf1312d705a4cc,5,183,9,174,1,0,1,4,8,0,3,4,0.859287722,206,97,13,45,32,13,2493,1549,944,29,20,9,99.46393762
9921457c36a606b19c74f2674ff556f8e410d429,2,3,3,0,0,0,0,1,6,0,2,2,0.918295834,689,98,14,86,86,0,5966,5966,0,60,60,0,100
7ecea3ed725cff17f22bd6208d2c6851c393afaf,0,0,0,0,0,0,0,0,0,0,0,0,0,0,99,15,0,0,0,0,0,0,0,0,0,100
6bcefc3a44be8cf0622578d58459192081867e13,0,0,0,0,0,0,0,0,0,0,0,0,0,0,6,2,0,0,0,0,0,0,0,0,0,100
30b83d21a2726641435d9290320d5f54f47b3b95,2,33,2,31,0,0,0,3,6,707,2,2,0.822404226,498,267,3,116,111,5,4464,4248,216,69,66,3,100
839d44d604d3361da8517864b18ce205786e624c,1,5,6,1,0,0,0,1,3,15,1,1,0,943,13,9,186,185,1,7237,7225,12,60,60,0,100
aee6d3bf8e63763ac7924d1f4320cf23e4e6ef3a,13,766,46,720,9,0,9,1,2,180,1,7,3.464233653,111,268,4,93,20,73,2927,628,2299,65,14,51,98.7012987
947d999dee5dddc22cea4501a34350614d91a3ec,1,1,1,0,0,0,0,2,2,28,1,1,0,72,0,0,11,11,0,529,529,0,9,9,0,100
aee323d4c873296bd7a3cba41d1251b3864604c1,0,0,0,0,0,0,0,0,0,0,0,0,0,0,100,16,0,0,0,0,0,0,0,0,0,100
d6b5f417ad84740b3370e26e69cb4a70fd9c1e25,5,78,64,14,1,0,1,2,2,24,1,4,2.086812368,1772,1,1,216,219,3,19185,19030,155,67,66,1,99.81015662
3fc1e8dbbf791b59425230169be850bc49fde735,7,36,12,24,0,0,0,2,5,35,1,4,2.436396788,2308,14,9,310,306,4,20747,20486,261,158,156,2,99.6684036
69e0bff317172114e2f86d9b8808c55ec850abaa,1,20,0,20,0,0,0,5,12,30,1,1,0,367,101,17,40,38,2,3423,3323,100,29,28,1,100
a05a288c3cd37d39f872ff52fa60498548b3d69a,7,12,36,24,0,0,0,2,6,0,1,4,2.436396788,2330,15,9,306,310,4,20486,20747,261,156,158,2,99.6684036
0739777413ac8487a76b9983aa23ecb6cf42104d,22,254,168,86,0,0,0,6,13,26,4,12,3.572812283,4450,7,2,628,630,2,41624,41537,87,326,317,9,98.13128893
7827c39ea92d351865e02a60a3f82149670bfde1,7,83,32,51,0,0,0,1,10,148,2,3,2.214811871,1269,102,18,240,234,6,11466,11196,270,119,113,6,100
85427981afeacef84ef3c10fc5fc4190cf291545,6,144,29,115,0,0,0,6,14,64,4,6,2.168469774,1749,103,19,280,270,10,18503,17491,1012,117,114,3,100
62b2af0258a5c3a72cf6bd26ad6fa2d9de53b05c,15,1213,172,1041,0,0,0,3,24,322,3,6,3.316818021,4660,104,20,752,634,118,44982,37573,7409,327,296,31,99.95155039
b991e81353de8687a4e08befbc45a46366f2d0f9,1,5,5,0,0,0,0,5,11,273,1,1,0,149,8,3,30,29,1,1208,1198,10,8,8,0,100
a349aeda7b7455929fee51da56b78688239488d5,4,35,25,10,0,0,0,1,3,43,1,3,1.648506235,2356,16,9,172,171,1,22311,22137,174,93,92,1,94.74907063
bf28b31fd26d203614f348ca0d2a037ea21c3842,0,0,0,0,0,0,0,0,0,0,0,0,0,0,17,10,0,0,0,0,0,0,0,0,0,100
12abb268885d1bbececab00557e047545ca221d4,1,1,1,0,0,0,0,3,6,2,1,1,0,147,105,21,11,11,0,1244,1248,4,9,9,0,100
42de574a988684f41229e281c64fdba0b2dbfe24,13,113,83,30,0,0,0,2,4,30,1,4,3.042707877,2816,2,2,274,275,1,27248,27139,109,165,166,1,100
003daca101a5e29bc1f7d75d45c3fffd521e26f8,1,2,2,0,0,0,0,2,3,41,1,1,0,89,3,3,6,6,0,851,850,1,6,6,0,100
d5fdb3294ff15f53e92e8f6cdccc9d9b787dd69c,0,0,0,0,0,0,0,0,0,0,0,0,0,0,9,4,0,0,0,0,0,0,0,0,0,100
5000fbbd687998769cd9aac183a5373ed49ae267,1,282,0,282,1,0,1,1,1,0,1,1,0,0,18,5,12,0,12,1809,0,1809,12,0,12,99.82166741
06f52eca7b324b779aa88bdaaa12df618a03fdb2,20,109,90,19,0,0,0,3,11,74,6,14,4.008242945,4796,269,1,573,573,0,45514,45123,391,335,335,0,98.2300885
b7f5915f95cc727701aa372c3c15dc218eea3727,1,2,1,1,0,0,0,3,10,2,1,1,0,608,270,2,47,47,0,7581,7575,6,24,24,0,100
1db8712d61bbdf3f24f04a4a85b18ed91e171a21,12,198,122,76,0,0,0,4,25,147,4,8,2.206538481,5101,106,6,798,791,7,41097,40643,454,320,318,2,95.32110092
78b9c1a91b698d78d881eb5555352ebc4b259e85,2,164,281,117,0,0,0,1,3,46,1,2,0.074012162,750,19,5,25,28,3,6586,6591,5,22,22,0,100
5dfe5cdef7521d2e41de32d8abd35f9a389ae82a,6,237,289,52,0,0,0,2,4,26,1,2,2.403865528,1097,20,6,61,61,0,10569,11246,677,52,52,0,100
ffe18b0ce3092fceffccff215297f6b7e2706550,3,47,43,4,0,0,0,2,5,22,1,3,0.619319717,1149,21,7,182,182,0,11810,11742,68,48,48,0,100
b1c13df454a46c3df0f6b1041147694721b770d7,3,43,47,4,0,0,0,2,6,0,1,3,0.619319717,1154,22,8,182,182,0,11742,11810,68,48,48,0,100
e21ec9367b1a4c8b0a359acee6c35c44569180fb,2,14,61,47,0,0,0,2,7,10,1,2,0.529360865,491,23,9,80,87,7,4188,4427,239,31,34,3,95.00458295
305feb0b4deb9ba949631ccd5963772848b4981b,14,668,79,589,1,0,1,5,26,13,4,7,3.039049848,5662,107,6,947,865,82,49280,45633,3647,393,355,38,99.82547993
23eed9f6e43c0b5b028e14130ab16afd5ac5179c,9,287,83,204,0,0,0,3,12,18,2,6,1.63818039,2312,108,7,368,343,25,22270,21047,1223,209,196,13,100
9774414a6e654edf6071d70d630bcbb0a960b420,4,119,177,58,0,0,0,2,3,70,1,3,1.752319744,1003,0,0,135,135,0,9324,9647,323,62,62,0,100
fad72d2ab2b2e470ccd7f83de87993fb351e3305,62,392,90,302,0,0,0,2,8,36,1,7,5.77715179,16432,1,1,1157,1103,54,170417,169063,1354,718,666,52,100
d74dc3221f25ff99156a6b2a0aa1e8cd94d6c0f9,6,0,37,37,0,0,0,2,4,0,1,1,2.49420395,554,2,2,47,52,5,5215,5495,280,47,52,5,100
d2e5f8c9ee8c97a0a6011261f1cbabf2dbf4f309,7,253,51,202,1,0,1,4,13,96,3,4,2.236845855,1595,109,5,244,223,21,14730,13540,1190,127,119,8,97.95825771
0bd9c775b6a62aa37f2a32d6d41bbe9e9a982b0e,2,83,12,71,0,0,0,2,14,0,1,2,0.921764712,915,110,6,120,117,3,8478,8095,383,64,62,2,100
8f30ae0e0a47288e1a924ac315c377103a883927,1,2,8,6,0,0,0,4,27,15,1,1,0,818,111,7,133,135,2,6054,6089,35,29,29,0,100
7cfa00dbdffff166e37b9fc15c633356d1b30f8f,2,11,2,9,0,0,0,4,13,14,2,2,0.961236605,1120,112,8,113,109,4,8148,8035,113,52,52,0,100
2ed0112e0e2379ff95968dd33b86ebe261cf208b,12,269,166,103,0,0,0,5,28,9,3,6,2.97432365,5437,113,9,737,725,12,45303,44468,835,297,294,3,100
75f06b4fe82db9f24aca1036a45c7ad0e26d8f1e,1,47,5,42,0,0,0,2,3,5,1,1,0,242,24,8,22,20,2,2895,2554,341,16,14,2,100
3678eabab73603a7ca3e45e1a56187cc0aca3619,7,359,420,61,0,0,0,2,4,6,1,3,2.410522766,1423,3,3,93,96,3,14494,15579,1085,75,76,1,100
9f4a6d2dfece9ed5da21b085a8d6b4f1f4ad18b7,0,0,0,0,0,0,0,0,0,0,0,0,0,0,4,4,0,0,0,0,0,0,0,0,0,100
14b9add5f4af346e9cd517b6360f61fda52005cb,1,6,4,2,0,0,0,3,6,20,1,1,0,172,114,8,17,17,0,1582,1562,20,17,17,0,100
d9c115e0e9b55b8a61bdce1c43de88a4e1cc6d0d,2,50,56,6,0,0,0,2,3,8,1,2,0.657272978,283,5,5,14,14,0,3041,2838,203,13,13,0,100
6f770a34df400f3399300ea371a46c1ae0878b06,3,32,0,32,0,0,0,2,16,207,2,3,1.468177321,820,10,0,180,177,3,7197,7034,163,81,79,2,100
331ad145e172c4a862bb294578dfb333b39d28d6,6,91,32,59,0,0,0,5,13,125,3,5,2.242175656,798,115,9,112,113,1,6593,6123,470,61,58,3,100
9aad374ab75ca477ada47c4bd2b0aaacd656602a,1,5,0,5,0,0,0,2,4,49,1,1,0,96,116,10,17,16,1,742,718,24,8,8,0,100
cb11ff2599894f7c97a8c8ffdef612aff45b4343,2,0,219,219,0,0,0,2,6,17,1,2,0.131584034,252,25,7,20,27,7,707,2352,1645,11,17,6,99.9047619
be08a2e709956c32cb13e0ec66aff729a7ee234b,34,97,137,40,0,0,0,2,6,0,1,5,4.584518138,10118,6,6,686,686,0,101827,101822,5,414,414,0,100
1a3728b1f2dfc62c4c8be2bdd6c8c4e663c61955,6,193,395,202,0,0,0,3,6,0,1,1,2.356625428,1357,7,7,85,85,0,11201,13369,2168,81,81,0,100
581e5923e7589d9625fc5d49cad13f1e46569706,1,1,1,0,0,0,0,5,17,2,1,1,0,625,11,1,160,160,0,5255,5255,0,61,61,0,100
120c1c04d468e5a2aeec9c69da2d4664c6795d87,2,3,1,2,0,0,0,2,3,58,1,2,0.811278124,66,0,0,7,6,1,572,536,36,4,4,0,100
245b6b45755c375e3d5af4b113a3b206d1669727,1,28,0,28,0,0,0,2,4,9,1,1,0,475,26,7,30,29,1,5144,4938,206,26,25,1,100
051a3d29143e0bdaa74469916502114a64b18adb,55,832,1349,517,0,0,0,2,9,5,1,10,5.076761569,16067,8,8,1365,1364,1,156502,160753,4251,835,834,1,99.57244656
5766b74ae574bd8657d19ac11ab66d1293f2a0af,1,3,3,0,0,0,0,2,6,0,1,1,0,482,9,9,30,30,0,4982,4994,12,26,26,0,100
e59bef7626284efec5d0acdb43edfc5806a7d6a4,1,12,5,7,0,0,0,2,8,62,1,1,0,330,117,11,99,96,3,2892,2835,57,35,35,0,100
e9e849e73fd5478c943f1b43daac76f8f8f232b1,7,127,75,52,0,0,0,1,15,32,3,7,1.742618876,2383,118,12,328,325,3,22219,21972,247,182,181,1,100
2e3eebdff8d0446b5444c0b728c871265d70fe56,2,34,2,32,0,0,0,5,14,144,1,2,0.581321499,421,119,13,52,51,1,4851,4505,346,18,17,1,100
4bdfac48434b48bd410bc8ac8c60617032be14a0,6,59,25,34,0,0,0,3,17,72,2,5,1.92779897,1954,271,0,300,291,9,19035,18959,76,121,119,2,99.10965323
e82042defc42c164fd279817c0013b0d530497f6,1,3,0,3,0,0,0,2,4,337,1,1,0,153,120,14,27,26,1,1218,1195,23,19,19,0,100
5836d352c2cff32ead3019157735658cd86ec3ac,3,354,9,345,1,0,1,3,3,63,1,2,0.559832792,100,1,1,57,16,41,3318,745,2573,24,13,11,99.86098239
67a5497c0b9681ff66ff390a4d09fb7ba0e833ae,1,1,1,0,0,0,0,3,7,8,1,1,0,191,10,10,13,13,0,1837,1835,2,12,12,0,100
1052de9697e35098004d1792d27a2338e47e2b61,2,3,3,0,0,0,0,3,6,10,1,1,0.918295834,434,2,2,41,41,0,4905,4905,0,30,30,0,100
0510172c55a066d2f9021f579bde0ebedc5cbb01,2,19,4,15,0,0,0,3,6,15,1,2,0.828055725,301,3,3,14,14,0,3044,3011,33,13,13,0,100
bfc8766b37659d7d2060524c5181fbc695b964af,1,1,1,0,0,0,0,2,7,11,1,1,0,492,11,10,18,18,0,4632,4632,0,17,17,0,100
c54c1ef286757e67ef1da756698076c0f8cf6834,7,598,15,583,3,0,3,5,29,18,2,5,2.404909393,2698,121,12,433,357,76,23969,20644,3325,197,157,40,99.67697277
42a1b76778274eb1cc289b7e4225db63944a7572,0,0,0,0,0,0,0,0,0,0,0,0,0,0,122,13,0,0,0,0,0,0,0,0,0,100
7f98570bb736dc7307d385271300568f185d3ffe,15,946,270,676,6,0,6,5,30,68,3,8,3.112501809,3990,123,14,571,519,52,36040,31790,4250,275,245,30,98.81224303
fa0f612695fa6538a02ea1c15eb4e96c78b4641a,6,385,49,336,0,0,0,1,30,0,3,6,2.138599026,2051,124,15,261,229,32,19466,16516,2950,150,126,24,99.77303677
736bbff30ee7d2096d181654a326df65e28d0e8c,1,5,5,0,0,0,0,4,7,13,1,1,0,253,4,4,23,23,0,2420,2424,4,20,20,0,100
2094e6d761d8aa2de35f36844e888592d4217114,1,2,2,0,0,0,0,2,4,17,1,1,0,192,12,11,21,21,0,2271,2271,0,13,13,0,100
a617305086c962f900eb3e3c491ba2aaf6f425f2,2,8,8,0,0,0,0,3,8,17,1,1,0.954434003,385,13,12,26,26,0,3640,3640,0,25,25,0,100
4ed6d855eac460068ff0246aaf1be93a8f0e081f,2,4,4,0,0,0,0,3,9,8,1,1,1,383,14,13,27,27,0,3660,3666,6,26,26,0,100
66c88efda9bc57630d85d0ff169201cb263555a3,1,1,5,4,0,0,0,4,10,19,1,1,0,186,5,5,18,18,0,1875,1908,33,10,10,0,100
71cf738e49a89885d83d4d2e52ad8bec54eaccd2,0,0,0,0,0,0,0,0,0,0,0,0,0,0,79,0,0,0,0,0,0,0,0,0,0,100
864b4b0c20824e3582e4cf100bba320449863ffd,1,4,2,2,0,0,0,3,4,22,1,1,0,171,6,6,12,12,0,1770,1766,4,12,12,0,100
d999cf27bda08ee52f7da4d7073528c35b434cfa,2,5,6,1,0,0,0,1,9,114,2,2,0.845350937,272,125,16,24,27,3,2284,2282,2,15,16,1,100
96d5da9e4535812b0657cdecc817b53ef570e004,2,128,60,68,1,0,1,1,21,20,1,1,0.903453555,675,126,16,53,45,8,6771,6554,217,41,34,7,99.86351228
c333e4b91bb32f36223337fba1145282604cdfa0,0,0,0,0,0,0,0,0,0,0,0,0,0,0,15,10,0,0,0,0,0,0,0,0,0,100
df6f1d8ebc1af25b4d8eedcd49ad818d625d44cb,1,1,0,1,0,0,0,2,3,131,1,1,0,64,7,7,7,7,0,404,399,5,3,3,0,100
caa22842913419e1a3acab292ca7c5396d639d60,6,89,54,35,0,0,0,4,9,44,3,5,2.019267994,772,127,12,123,118,5,5931,5773,158,87,83,4,100
a94cb7a8b7c14f1819785f0ec5e51d8e2478d610,10,340,44,296,5,0,5,1,10,117,2,6,3.125564103,294,128,13,68,44,24,3259,2206,1053,41,22,19,99.22972361
00c6f1e5d3b3a92f7efbf872d330bb88f1df552c,10,214,205,9,1,0,1,5,16,45,3,6,2.51802463,2379,129,14,372,377,5,19086,19273,187,205,205,0,96.93117054
33b420b5d04cd08c936ddf9d6e8081eab32015c4,7,115,48,67,0,0,0,3,17,9,2,6,2.023544719,2497,130,15,352,345,7,22780,22371,409,199,195,4,100
a0f1804901abbae283ff0d04f7fc40aa36319121,1,1,1,0,0,0,0,2,17,0,1,1,0,237,131,16,35,35,0,1849,1849,0,16,16,0,100
73ce4105dfd33fbc5750558f93322509740d28dc,0,0,0,0,0,0,0,0,0,0,0,0,0,0,16,10,0,0,0,0,0,0,0,0,0,100
7dbec734e047b6dd039eda9ecef06208fd989fb4,1,6,6,0,0,0,0,3,6,19,1,1,0,109,17,11,6,6,0,1022,1022,0,6,6,0,100
7540887ae3d8b6e20c5e8c8a09830f6123a5e26b,2,31,6,25,0,0,0,1,4,24,1,1,0.571354974,281,8,8,51,43,8,2745,2615,130,16,14,2,100
353ececc609f11646d76fa4a366b65836a79bd50,1,1,1,0,0,0,0,2,4,123,1,1,0,943,18,8,186,186,0,7237,7237,0,60,60,0,100
dfdb21edf0eed8f12b623ef36a7edf0e9ffe9443,2,21,4,17,0,0,0,5,35,83,2,2,0.634309555,1828,132,11,326,325,1,16499,16371,128,112,111,1,100
6150b8abfaeb3cecd8f3568a7ea9e6bdf6935d9f,0,0,0,0,0,0,0,0,0,0,0,0,0,0,133,12,0,0,0,0,0,0,0,0,0,100
4da62d1c52b1a4bc7f866b07329235b149bbe8ca,0,0,0,0,0,0,0,0,0,0,0,0,0,0,134,13,0,0,0,0,0,0,0,0,0,100
94eb546bf420ad4809460a7f49ab85b2bed12c9c,6,238,238,0,0,0,0,3,10,39,1,1,2.489879623,1154,27,0,82,85,3,11877,11053,824,79,81,2,99.95730145
62cf8b4aa44d4eadac367c8680cd10cf9b70edc4,16,163,163,0,0,0,0,2,8,50,1,4,3.42171052,4937,19,7,205,205,0,51025,51025,0,161,161,0,100
9c74ee459a939a4b3aff31ad83b922b9c08e94da,7,250,0,250,1,0,1,1,8,95,1,6,1.463296274,1496,9,2,312,290,22,13594,12150,1444,205,191,14,99.87234043
969fbe8987d24102920dd823b83275fa8e591ea8,0,0,0,0,0,0,0,0,0,0,0,0,0,0,135,8,0,0,0,0,0,0,0,0,0,100
1a81d09f872bfbcebcdcb93f7143536cf56de2ce,0,0,0,0,0,0,0,0,0,0,0,0,0,0,136,5,0,0,0,0,0,0,0,0,0,100
3f55972afa04843e065312409401f3037e11f24b,0,0,0,0,0,0,0,0,0,0,0,0,0,0,137,6,0,0,0,0,0,0,0,0,0,100
88d9248864a202ed71db8b64b047fe000606bd05,8,157,66,91,1,0,1,3,15,169,5,6,2.413710934,1959,138,7,254,251,3,17205,16714,491,122,116,6,98.53923205
0db23f42f2acb4abe8b04954900b607b9caa384c,1,7,0,7,0,0,0,4,8,251,1,1,0,36,139,8,6,6,0,278,242,36,5,5,0,100
4e614ff1f8e60f0db092d9e08c4769c84cab04b1,2,310,61,249,0,0,0,3,6,89,1,1,0.995587997,768,10,2,159,159,0,6157,6157,0,61,61,0,100
a00b2ef9fcadcf5ecaa4b9ff6855dca5cf49222b,6,18,11,7,0,0,0,3,8,52,1,4,2.474552875,1400,20,2,178,178,0,12716,12608,108,128,128,0,100
b9c7ffd5153d95531dd3af1586d746c269951c6c,22,62,394,332,0,0,0,4,14,283,9,18,2.754764021,4069,140,8,448,501,53,35785,37481,1696,239,278,39,94.34037465
7ab8eb3f5d24ff7d7e8f891c98c665a41a5779f5,17,694,82,612,7,0,7,1,21,50,2,9,3.620333911,1736,141,9,383,334,49,15812,13566,2246,144,102,42,97.81579905
de8c94a1ef076302b42170ead7d37f3b7999d2ac,7,40,99,59,0,0,0,3,10,359,1,5,1.983396746,862,142,10,138,138,0,6216,6740,524,107,108,1,100
74b206319d16cc5c8412768a88fb50ed967dcb3c,1,1,1,0,0,0,0,4,14,0,1,1,0,136,143,11,9,9,0,1315,1315,0,8,8,0,100
5c305434c615b5e91b17d6e3918f7a47cf4551a8,1,7,21,14,0,0,0,2,5,44,1,1,0,943,21,2,183,186,3,7177,7237,60,60,60,0,100
152afb1c4a858f9ca4308016f02ef5037e3e756a,4,81,79,2,0,0,0,5,13,43,2,2,1.742431549,656,144,9,54,56,2,5489,5478,11,32,30,2,100
b0929b4432870d1ffda79604b2ed29596934cc7a,4,31,43,12,0,0,0,2,8,76,1,2,1.514596193,925,145,10,139,138,1,7658,7882,224,65,65,0,100
d82c01dafc51bba758f5c7be21e5b43219e12f2c,3,16,9,7,0,0,0,3,12,750,1,2,1.320924277,339,146,11,35,35,0,3098,3060,38,22,22,0,99.96563574
43110bd9d5708963a826e9c39389ec99491a5355,3,43,15,28,0,0,0,3,11,24,2,3,1.372553188,600,147,12,111,108,3,4707,4520,187,91,89,2,100
396db78255f03d9f7d5a04190160445da1fb96d2,1,1,1,0,0,0,0,1,2,6,1,1,0,54,148,13,7,7,0,376,376,0,5,5,0,100
c8ecb10c7aab66c6d77a20cf09b3cc8c18f7d5a7,22,905,191,714,2,0,2,2,12,63,6,12,2.884414346,4390,28,1,534,475,59,43116,38414,4702,308,296,12,99.82841455
90faa0eab6b819753d4acd2ae24ab73f8e8132d0,15,172,147,25,0,0,0,3,13,183,5,9,3.347610141,2574,29,2,346,344,2,21328,21316,12,215,211,4,99.96572995
fd547854726a941008de6c36138432ef81682cb0,16,1176,13,1163,6,0,6,1,9,59,1,7,3.028725859,2409,22,3,562,458,104,26741,19978,6763,312,252,60,98.56557377
7d6461d0deadfec14e861849eb23f89e11c265b8,1,18,0,18,0,0,0,2,2,1,1,1,0,20,11,2,4,4,0,99,99,0,4,4,0,100
ec1368034bf6918eefdf54c37c9257c41a75b417,1,1,0,1,0,0,0,4,9,42,1,1,0,256,23,3,21,21,0,2568,2557,11,19,19,0,100
66213b056235edd70b8e5899745aaa86b7323bda,1,1,0,1,0,0,0,3,4,118,1,1,0,233,12,3,26,26,0,2838,2827,11,11,11,0,100
ea8c7c6be3f2b98611bd26860f668b76997c3243,1,15,9,6,0,0,0,2,6,17,1,1,0,929,24,4,183,183,0,7262,7177,85,60,60,0,100
2a31462c5672cff235bc821a465c9648d0045352,7,75,39,36,0,0,0,5,31,110,4,7,1.533602509,1790,149,14,345,338,7,15564,15339,225,122,122,0,100
813b4ff6bcd21983adb5ceec3ecc9722d6dac3fd,1,1,1,0,0,0,0,1,2,81,1,1,0,95,150,15,9,9,0,732,732,0,7,7,0,100
80314b0d60cabb9276b5e972b66178e55fcaecc1,0,0,0,0,0,0,0,0,0,0,0,0,0,0,151,16,0,0,0,0,0,0,0,0,0,100
7cfc6002f5cea134bffb7d61498fe4d5ad8fdfa7,1,3,0,3,0,0,0,3,7,108,1,1,0,482,13,3,30,30,0,4989,4982,7,26,26,0,100
9f722b3d01fe118951ed4f7c87b16c495a3fb45e,21,927,178,749,2,0,2,4,36,188,5,9,3.676656477,7355,80,0,1353,1253,100,62945,58101,4844,544,494,50,93.72230428
c6cee1137e4a80ea868fac7b6b6748fb1e541325,3,7,3,4,0,0,0,5,11,361,3,3,1.570950594,829,12,0,142,142,0,5919,5880,39,70,70,0,100
688fc4557637bb1a12b0f1924a9e7457d94c6968,1,6,6,0,0,0,0,3,4,18,1,1,0,187,14,4,39,39,0,1577,1557,20,19,19,0,100
78e486c263048dad66e7ef979b223614b0919e8e,1,84,38,46,0,0,0,3,4,4,1,1,0,458,152,12,96,69,27,3339,3055,284,35,36,1,100
04efd178111f3e4caa73d754542341c56ca6c2f9,1,31,10,21,0,0,0,3,7,445,1,1,0,63,153,13,13,7,6,670,559,111,6,3,3,100
957aab148951690da99e84a2204a7dfa0cbdb580,1,1,1,0,0,0,0,1,3,29,1,1,0,122,154,14,15,15,0,910,910,0,6,6,0,100
c95b55b2cefa0c9ea9864f885521b51a3f18fa2a,0,0,0,0,0,0,0,0,0,0,0,0,0,0,155,15,0,0,0,0,0,0,0,0,0,100
1caadaf209f6207f7993c5e3e7866f12220caf33,0,0,0,0,0,0,0,0,0,0,0,0,0,0,156,16,0,0,0,0,0,0,0,0,0,100
15b89bc31438fd76071585aacefd9a549d99ac38,43,718,297,421,0,0,0,2,37,106,10,29,4.431811252,10368,157,17,1741,1694,47,89385,86878,2507,750,726,24,92.193755
85ad940500947894ac25e35e98578b92e4a487f0,1,1,1,0,0,0,0,3,5,18,1,1,0,234,15,4,26,26,0,2840,2838,2,11,11,0,100
0db944c87ab43de5f08f775f0944e94f7af6455b,1,16,3,13,0,0,0,3,9,25,1,1,0,89,16,5,20,20,0,834,701,133,11,11,0,98.48771267
b4cd214c7b47e7c8ee17f77ac315c596887e1f86,4,17,15,2,0,0,0,1,5,32,1,2,1.880240815,451,25,4,37,37,0,3948,3948,0,30,30,0,100
07a0b588e6f5392607199dcf7e128fc9a0b85586,5,61,63,2,0,0,0,2,9,416,2,5,0.938951522,1236,158,18,136,139,3,10483,10531,48,88,89,1,100
e4eacd2216b5dc55331a8ad9acc484bba83814c7,1,14,0,14,0,0,0,3,10,13,1,1,0,102,26,4,20,20,0,953,834,119,11,11,0,99.81929888
8013cbb2cd334be87847650c72f4cb599ba5757d,3,13,3,10,0,0,0,2,3,238,1,2,1.419736718,270,27,4,70,70,0,1945,1914,31,24,24,0,100
ebb5d4c69e6822590e97f1367a2d9405bbd9ad77,4,4,4,0,0,0,0,2,3,20,1,1,2,495,17,4,43,43,0,4294,4294,0,36,36,0,100
3c5edec9daea46c6c10a8a808d3b68ea8fa0601f,2,58,2,56,0,0,0,2,3,244,1,2,0.918295834,181,18,5,36,31,5,1982,1604,378,13,10,3,100
fd774c93d98056300e5f3a41b9e267ee446036a5,1,3,2,1,0,0,0,3,8,49,1,1,0,245,19,6,6,6,0,2515,2511,4,6,6,0,100
b80f1b1653ea2af2e0e1fecf6cc1b0c3d977e838,0,0,0,0,0,0,0,0,0,0,0,0,0,0,20,7,0,0,0,0,0,0,0,0,0,100
cdb6b94104c3fa24e070512cb0e66430ecae4e58,3,71,71,0,0,0,0,4,32,32,3,3,1.332479563,2191,159,10,262,268,6,16413,16302,111,88,90,2,100
73269d2373fde667694ff432a3ef97efa07a2219,1,7,0,7,0,0,0,3,7,1044,1,1,0,100,160,11,12,12,0,847,798,49,4,4,0,100
03d3531f16c9b2d74dcc30cc01cd9afff11db261,2,33,3,30,0,0,0,1,4,134,1,2,0.943601631,224,161,12,29,27,2,1710,1497,213,18,17,1,100
bf959ea9fa78da7ea5e652295f833473123e8fd8,2,14,5,9,0,0,0,1,4,42,1,1,0.74248757,176,162,13,22,22,0,1327,1286,41,11,11,0,100
35506d5280bcdfaf25b683e6d34d3bd8933f5495,5,457,0,457,1,0,1,1,10,50,1,5,0.595851562,1757,28,3,370,340,30,17590,14342,3248,217,206,11,99.92769342
b49360e77d69d5a7f2b027aadb561e95dd94b422,7,85,32,53,0,0,0,3,14,132,2,5,2.178929158,1969,163,11,224,217,7,17216,17036,180,142,139,3,100
20a13e3b458526153a884ce6135162245ab016cd,4,136,122,14,0,0,0,4,24,27,2,2,1.340775537,2196,164,12,322,322,0,17026,16832,194,110,107,3,100
c5c77229f2b3d6989195fc532d8d323c38aef527,4,344,15,329,1,0,1,1,8,79,1,4,0.830702779,564,29,4,148,105,43,6580,4333,2247,93,82,11,99.92790195
aa3e455fb7ec8b24a9b5c4f2d43d0704cc86aca9,5,216,54,162,1,0,1,4,11,116,1,4,1.657818482,791,21,6,99,92,7,8599,7495,1104,56,49,7,99.67684022
067047661b7228e6b202dda427d14f56d8b7b847,1,30,2,28,0,0,0,1,1,0,1,1,0,67,22,7,11,11,0,477,366,111,11,11,0,99.60531037
9f01d25da0afde30aa3cb39d3ae4f3101b0260cd,1,8,8,0,0,0,0,2,2,61,1,1,0,264,23,8,45,45,0,1613,1653,40,11,11,0,100
2bcc9f9f893575fab58c4a4a994b7ca0f5c96729,5,854,7,847,2,0,2,1,9,17,1,3,1.284915541,1202,30,5,289,243,46,16338,9627,6711,149,130,19,99.85663082
b202406f5946a4cd34be19c23caa072459689afe,1,11,11,0,0,0,0,1,2,2,1,1,0,219,31,6,35,35,0,2051,2043,8,11,11,0,100
a37899c548a000ecff428ee785e65e8db974f6a8,2,2,2,0,0,0,0,1,2,12,1,1,1,584,32,6,41,41,0,6599,6583,16,17,17,0,100
27693c6ff59e2fe8e0128e734f2d05ba8d6f9ccc,27,164,124,40,0,0,0,6,38,101,5,16,3.662675978,6742,165,6,1401,1400,1,55826,55699,127,487,485,2,99.96426019
a49775453328b9539a6c16511ff4a0d079b76a5a,0,0,0,0,0,0,0,0,0,0,0,0,0,0,166,7,0,0,0,0,0,0,0,0,0,100
82cea4fb9a5f0b26d215bdb25860a4ba8905a196,11,144,193,49,0,0,0,1,33,71,4,7,2.566402334,3260,167,8,499,507,8,25752,26028,276,203,206,3,100
9ae2f3275bffbf73fae41abcfa0c9a56de08d002,2,109,55,54,0,0,0,1,8,0,1,2,0.534943699,236,168,9,32,26,6,1847,1586,261,20,18,2,100
0fbcd7248a5b64cc55a329c0afffe9984cce9563,1,1,1,0,0,0,0,5,19,17,1,1,0,470,169,10,94,94,0,3766,3762,4,25,25,0,100
aace8f4844efffe395dc1c27dd7e9c827b43d718,8,53,28,25,0,0,0,1,34,39,4,6,2.512083747,2711,170,11,418,410,8,22136,21932,204,168,166,2,100
34533f285a6d732dcb44caca4b14b3db217cccbc,1,4,0,4,0,0,0,2,4,35,1,1,0,44,33,7,5,5,0,246,218,28,5,5,0,100
077f34f839f67e629682bb3a566875c6d9322d21,1,3,4,1,0,0,0,3,9,120,1,1,0,205,34,7,13,13,0,2066,2070,4,13,13,0,100
4371096463d0d56905618c3bff36b6ab20b500b4,1,8,5,3,0,0,0,2,7,69,1,1,0,937,35,8,184,183,1,7279,7262,17,60,60,0,100
8fc5ff611439d632217f689581769df1a39df377,13,530,68,462,3,0,3,2,10,64,1,5,2.987267491,1399,24,7,245,213,32,13696,11404,2292,176,149,27,97.98281659
ad0979e7224d879efcb70f1f6d20ae34be6326b7,5,29,20,9,0,0,0,4,11,72,1,2,2.084696647,1719,25,8,235,235,0,15222,15210,12,110,110,0,100
e99c0892c843bc033f40a2d38a6944b0f898b138,1,6,6,0,0,0,0,2,2,280,1,1,0,186,26,9,39,39,0,1544,1544,0,31,31,0,100
86e0ccfa094110ab6a38d1a2f124f597cad48a62,1,8,1,7,0,0,0,2,5,0,1,1,0,176,27,10,16,16,0,1602,1522,80,11,11,0,100
8cbd3855152edb809015d6c71d7dd3ece5d95582,2,53,8,45,0,0,0,7,39,6,2,2,0.514091279,2141,13,0,461,448,13,18505,18136,369,151,150,1,100
5acc8ad516c9f22275eb7b7c82d8723606251623,1,2,2,0,0,0,0,3,11,2,1,1,0,462,36,8,89,89,0,3734,3732,2,72,72,0,100
6113b70b0c209ccffa60dd63812552dc48e04b50,1,9,0,9,0,0,0,3,11,47,1,1,0,114,28,11,21,20,1,1039,953,86,11,11,0,100
dbdb70751cbba9992ecf7fcda200bd5ba2734bed,3,74,0,74,0,0,0,4,19,35,1,3,1.438981001,1354,14,1,223,213,10,12365,11750,615,86,82,4,100
063d64204278ac128e3413897819124aef510997,1,2,2,0,0,0,0,4,12,1,1,1,0,123,0,0,21,21,0,1039,1039,0,11,11,0,100
75d0aeb0eff13489f0ea34768e97e1850bc73eb6,0,0,0,0,0,0,0,0,0,0,0,0,0,0,171,12,0,0,0,0,0,0,0,0,0,100
e9b12f47eb16edb1b21930876cfe7b809a1cfd96,2,36,2,34,0,0,0,1,26,11,2,2,0.689201985,765,172,13,176,174,2,6288,6039,249,48,47,1,100
7cb0666b2f05118e3c86d70a71f7e27e872703e1,32,468,288,180,0,0,0,6,40,74,4,15,3.562294459,7441,173,14,1518,1496,22,61282,60315,967,533,523,10,92.84828442
dc4d6170d595a3c60d2dd393090df168f621b65e,0,0,0,0,0,0,0,0,0,0,0,0,0,0,174,15,0,0,0,0,0,0,0,0,0,100
81904565a52684ae8824ea708709c19d19d332cf,2,3,13,10,0,0,0,3,6,164,1,2,0.543564443,762,29,11,22,22,0,7601,7661,60,18,18,0,100
d2a25082b85f5075eef4cd50e18efe2fce67e46b,1,10,18,8,0,0,0,1,10,1,1,1,0,184,175,16,37,39,2,1342,1365,23,15,15,0,100
112f90094df224e47760300bf768d264cbea11ff,4,10,10,0,0,0,0,4,15,180,2,4,1.970950594,1088,176,17,123,123,0,10649,10649,0,59,59,0,100
80b0a16dc5a918f99f74071e7c7ca6a48243cba4,1,1,1,0,0,0,0,4,19,1,1,1,0,219,177,18,39,39,0,1663,1663,0,13,13,0,100
2186a360c177a549cc2b0179069b10213f4052e9,1,4,4,0,0,0,0,5,20,12,1,1,0,470,178,19,94,94,0,3770,3766,4,25,25,0,100
394055a544dc3dddf20469f3f9b2c1ee53a208bb,2,62,41,21,0,0,0,3,28,15,1,2,0.829952434,871,179,20,187,185,2,7098,6957,141,53,52,1,100
263046924caf3d7c63ee6f74c7fc8b5e94ac7609,3,14,3,11,0,0,0,2,6,9,1,2,1.159554752,394,30,9,58,57,1,3452,3395,57,37,36,1,100
f5fe0ea00087d721c8114a81fb7268769d8685fd,6,439,451,12,1,0,1,5,17,64,2,2,1.802393955,1348,81,0,254,262,8,10772,11119,347,94,98,4,93.09917355
4d783216d2182f4319bf680a18274e5083f058fb,2,59,0,59,0,0,0,5,14,20,1,2,0.983149128,570,82,1,96,87,9,5521,5079,442,42,39,3,100
6f28481c4b62679e66e1dcebc0d27abc9aa08e85,0,0,0,0,0,0,0,0,0,0,0,0,0,0,83,2,0,0,0,0,0,0,0,0,0,100
38f5450008571c6aac3bcbe2c8b0da2123c0d99f,1,21,23,2,0,0,0,7,41,10,1,1,0,1264,15,2,293,294,1,10745,10761,16,79,79,0,100
89a2295ec0026d1befc76291a2195486a6eeaf23,1,1,1,0,0,0,0,2,3,24,1,1,0,338,31,10,23,23,0,3810,3810,0,8,8,0,100
021ed91d665d046d4abb9deb862f17386664df2a,5,14,15,1,0,0,0,2,6,72,1,3,2.145281323,683,32,11,61,61,0,6118,6150,32,45,45,0,100
6f4f4b7bcecafa8345690a0903c553a3e8d4bd3e,2,4,4,0,0,0,0,3,7,2,1,2,0.811278124,254,33,10,23,23,0,2348,2356,8,17,17,0,100
b85573e22816d660e743caeb5823918b73390210,33,285,266,19,0,0,0,3,13,63,1,13,4.010353622,9451,34,10,1141,1128,13,85724,85672,52,592,590,2,100
6d334a91ac1331ae6baf49fa74e2e2ea91633448,2,2,2,0,0,0,0,2,8,0,1,1,1,352,35,11,32,32,0,3068,3076,8,22,22,0,100
59441beb7d28dd59771cfcc405ea422917693f25,2,223,0,223,1,0,1,1,7,11,1,2,0.10289979,61,4,0,12,3,9,2236,570,1666,11,3,8,99.921875
40c3e94955e1703da9ef07a7a5517b7d9aee91b0,7,132,74,58,1,0,1,4,9,227,2,4,2.170225827,638,180,15,108,103,5,4668,4466,202,58,53,5,99.60799686
839d25077982699af5ee0167eece027d79e889bf,0,0,0,0,0,0,0,0,0,0,0,0,0,0,181,16,0,0,0,0,0,0,0,0,0,100
32aaa8ed45971f01bb838ce3c6f40f84ca2a91f8,4,5,25,20,0,0,0,4,42,25,3,4,1.908612699,3840,182,17,610,612,2,30534,30667,133,211,212,1,100
ff7b5a737712419a02cd85bbd12aeeffd6ca343e,11,299,88,211,1,0,1,3,18,85,4,7,2.620054202,2124,183,18,372,348,24,18529,17432,1097,161,151,10,96.06048548
fc3094a8bed22d3b28609d5c1d69cc85d9e16034,4,16,17,1,0,0,0,1,11,58,2,3,1.470760674,337,184,19,61,61,0,2298,2257,41,33,32,1,99.91954948
60d33b615d90cdaea2a869c24b0157e9f5a798d4,2,51,2,49,0,0,0,4,17,10,1,2,0.313812964,1115,185,20,148,146,2,10212,9843,369,69,68,1,100
e8b1d11eb074e947959cb8d8aaa92a98acecd827,5,71,16,55,0,0,0,3,18,85,2,4,2.214670716,1439,186,21,211,204,7,14196,13731,465,90,90,0,94.10971223
c4dd440d9ebe5052226028ebbab66bfe2c981ae0,5,32,37,5,0,0,0,3,21,6,2,3,1.996110828,1173,187,22,201,202,1,9357,9353,4,77,78,1,100
bb04ee4b8467e12a9ebc84edf0f058ed917d8c79,4,14,6,8,0,0,0,4,21,17,1,4,1.570950594,1266,188,23,151,149,2,10983,10951,32,78,76,2,100
03ba46be93ee2e51b2445463d19c5ee30fe9959d,2,66,14,52,0,0,0,4,22,58,1,2,0.669015835,355,189,24,51,48,3,3333,2986,347,23,21,2,91.67050161
a25b31e3b43bfbf71855dc13a322447040c1405f,0,0,0,0,0,0,0,0,0,0,0,0,0,0,190,25,0,0,0,0,0,0,0,0,0,100
9121626cd2600b06d123c3a52e556c968ae26f11,0,0,0,0,0,0,0,0,0,0,0,0,0,0,191,26,0,0,0,0,0,0,0,0,0,100
80f7c87a105a4ae70005f9a939ba4f574419c127,0,0,0,0,0,0,0,0,0,0,0,0,0,0,192,27,0,0,0,0,0,0,0,0,0,100
72d0c0fa033920c93462e24eaa6d540ddb2d0e69,0,0,0,0,0,0,0,0,0,0,0,0,0,0,193,28,0,0,0,0,0,0,0,0,0,100
41b93a1ba6370b09f38e7a5eee69c09d821e3613,0,0,0,0,0,0,0,0,0,0,0,0,0,0,194,26,0,0,0,0,0,0,0,0,0,100
40c413180cccc701a00d7b7900d4fa904859932e,1,1,4,3,0,0,0,3,4,217,1,1,0,573,36,8,34,34,0,6248,6248,0,21,21,0,100
b751da76f63704d36ac4d20efc894d46d8338e24,0,0,0,0,0,0,0,0,0,0,0,0,0,0,37,9,0,0,0,0,0,0,0,0,0,100
7f795ca4bd4032fb3e17726f8c8369154a23f55c,3,25,0,25,0,0,0,5,29,675,2,3,1.409360865,867,16,1,208,204,4,6781,6597,184,66,63,3,100
bff951b2bb3850a3a3f938a4aae6deca3d4be66a,1,9,2,7,0,0,0,7,43,39,1,1,0,1260,17,1,294,293,1,10759,10745,14,79,79,0,100
9445d4733e267b0dec8b9a4b424346735581d318,38,207,812,605,0,0,0,2,13,105,1,9,3.880305547,9711,37,0,1017,1093,76,90418,92860,2442,545,599,54,97.00451375
abf17649e70e64da86449995d18cf90ceb30d3db,0,0,0,0,0,0,0,0,0,0,0,0,0,0,38,1,0,0,0,0,0,0,0,0,0,100
cc9909ae551a6841d3d417e453a7c8520d36bdad,35,477,421,56,0,0,0,3,14,125,1,14,4.389232685,6574,39,2,1124,1121,3,53951,53865,86,564,562,2,100
4e7a552dcb3cb737f352bdfef0ab4b24f9b6e31c,10,399,641,242,0,0,0,3,23,348,1,7,1.073775002,2166,84,0,127,127,0,18241,18245,4,118,118,0,100
587f0854782842457a4910f1e4a283595b3b5e48,1,22,2,20,0,0,0,5,13,61,1,1,0,128,18,2,27,23,4,1143,1092,51,9,9,0,100
387604d18047acf6923b111bf75f661d94f0f960,72,2108,1975,133,3,0,3,1,13,66,1,11,5.368335274,16220,40,3,1347,1288,59,164242,161982,2260,746,710,36,99.03108599
97b5989a18829b42df209d0dc1505438dee95c31,7,1377,0,1377,7,0,7,1,1,0,1,4,2.541980268,0,85,1,162,0,162,7411,0,7411,82,0,82,99.35483871
eafab696c11b748b8495cb03755bbe5221b17db6,0,0,0,0,0,0,0,0,0,0,0,0,0,0,86,2,0,0,0,0,0,0,0,0,0,100
107e804fc57b5f6509066dcd298e94b1c17be062,2,22,0,22,0,0,0,3,30,48,1,2,0.902393283,892,87,3,192,188,4,7263,7130,133,55,53,2,100
3875992e2d84a8c9be0deb5ac3ca00f60d82d28a,0,0,0,0,0,0,0,0,0,0,0,0,0,0,88,4,0,0,0,0,0,0,0,0,0,100
972607f9ad67a661e5e864362dc098c59d4ea89f,2,35,3,32,0,0,0,2,12,60,1,2,0.789749254,349,89,5,48,46,2,2663,2446,217,24,23,1,100
8be06f3bab687eb81fe69e08becb11d79f5a2c3b,14,40,79,39,0,0,0,3,12,43,1,8,3.410205616,3289,41,4,489,496,7,28396,28568,172,216,217,1,100
ed4a52f03dcd0ae8f1cbbd7fc5c9ba25470b8883,15,92,47,45,0,0,0,4,11,122,2,9,3.513851811,3406,90,6,527,519,8,29912,29713,199,227,225,2,100
d8c61614c8debf9fbaf4f77014204d9464939350,3,23,5,18,0,0,0,4,18,215,1,2,1.287054028,638,91,7,133,131,2,4869,4767,102,84,83,1,100
96c18c3c509e66fb628cf850ec211e5ea35dea31,14,40,79,39,0,0,0,3,12,43,1,8,3.410205616,3289,92,8,489,496,7,28396,28568,172,216,217,1,100
9f1efe09675c0eddc4a0ad04722b365d47047ca9,0,0,0,0,0,0,0,0,0,0,0,0,0,0,42,5,0,0,0,0,0,0,0,0,0,100
4f2b524d9bde075968e33b0be611d3e7152ee1b6,29,993,982,11,0,0,0,3,15,6,1,9,3.678792002,8214,38,2,737,758,21,79797,80032,235,420,429,9,99.55752212
9520370a25eeb3621db9f48e72f40302993650dd,21,89,96,7,0,0,0,2,14,41,1,10,4.147757742,4975,43,6,686,568,118,43997,39271,4726,342,248,94,98.03690616
dcc2823890d226c1ce06b919c8b3cf999cd323ad,5,8,15,7,0,0,0,3,15,49,1,4,2.052739285,1193,39,1,215,218,3,9646,9685,39,130,130,0,100
56900a2b860c257242e70bad7edbcd111528bfb3,2,28,10,18,0,0,0,4,13,20,1,1,0.175565026,463,40,2,35,32,3,4774,4611,163,32,32,0,100
bf9ed92b3a60a350d4589ff2a6f8485ab238d23e,4,77,17,60,0,0,0,4,16,77,1,3,1.548859297,308,44,7,47,41,6,3033,2619,414,32,29,3,100
c14c7b470abda802f53e21c5fdd91807bd022ca3,1,1,1,0,0,0,0,2,4,24,1,1,0,268,41,3,45,45,0,2464,2464,0,11,11,0,100
2ebfdc155b740590474119bb4f1463a3a4068b6c,4,9,6,3,0,0,0,1,12,29,1,2,1.640223929,1396,45,8,179,179,0,14451,14404,47,50,50,0,100
73c9b9f54f1d4f79597997818a1829b4be5dd7fd,7,8,8,0,0,0,0,3,17,19,1,3,2.75,2152,46,9,114,114,0,20952,20952,0,79,79,0,100
4133c9633baf709a234c493cb973ac30d3bcb14c,3,24,29,5,0,0,0,3,13,31,1,3,1.364278403,1358,42,4,249,250,1,11523,11564,41,168,169,1,100
b364820dde20ff487492146afa1f10cd094dd26d,1,4,2,2,0,0,0,3,9,22,1,1,0,119,43,5,23,22,1,825,813,12,11,11,0,100
a38cebf42b0addaf8fc2e7892f55166a3cd902b5,11,175,288,113,0,0,0,3,21,207,4,9,2.658291128,2599,0,0,348,364,16,20792,21394,602,196,202,6,100
0d608aa73588f694d15a825ce2432fde0de115b7,4,397,295,102,1,0,1,4,37,216,2,3,1.495317066,1743,1,1,282,285,3,14373,14136,237,99,99,0,96.2406015
59e036398040da1e97706160dc5a1b2cdcb0d84d,0,0,0,0,0,0,0,0,0,0,0,0,0,0,47,4,0,0,0,0,0,0,0,0,0,100
952de65174bc612775f94cfa424c8950ff38066f,1,11,10,1,0,0,0,3,5,24,1,1,0,159,44,5,9,9,0,1621,1630,9,8,8,0,100
c682b34dff6562580bcec5ab766a21acc5b1af10,1,1,1,0,0,0,0,4,14,42,1,1,0,255,45,4,19,19,0,2558,2558,0,19,19,0,100
c1ac6e6afe23bfba8e3cd8b567bb83ee2abf1bc3,6,47,100,53,0,0,0,2,15,53,1,2,1.934169099,2212,48,3,362,362,0,18693,18626,67,139,139,0,100
0bc6aef5afc9a6f4e79c964937625d57b6adfede,29,74,537,463,0,0,0,6,44,187,6,18,3.869228698,9199,2,2,1397,1458,61,78562,82058,3496,541,557,16,92.31088944
53a1196deb03b45122c696712bfc8b5c5273b2b7,0,0,0,0,0,0,0,0,0,0,0,0,0,0,49,3,0,0,0,0,0,0,0,0,0,100
95ab2f6ab05fe57e066944589859b237403cad31,0,0,0,0,0,0,0,0,0,0,0,0,0,0,50,4,0,0,0,0,0,0,0,0,0,100
e99cebd3d21d1e8d69553fdcef65f4581fa8d927,1,35,9,26,0,0,0,2,8,64,1,1,0,341,51,4,24,23,1,4007,3829,178,9,8,1,100
c936ca47a65f933bff73960e405df9968f1f5ef5,3,63,35,28,0,0,0,2,11,60,1,2,1.068217449,429,52,5,37,35,2,3929,3706,223,27,25,2,97.28682171
9827ac9e126e88ab91e902976c145eeba4bef4e4,1,2,1,1,0,0,0,2,12,0,1,1,0,194,53,6,17,17,0,1652,1652,0,12,12,0,100
06ffdf913fed07dcb8eee81f4aa0f0779b051ed0,8,541,18,523,2,0,2,1,6,137,1,5,1.946608635,662,93,0,185,129,56,8026,5330,2696,89,65,24,94.05356332
45a7b989bfdad6943dc0090c7cea2e098862c9a9,7,349,2,347,1,0,1,5,39,123,3,6,2.061874124,2408,94,1,354,305,49,22962,20956,2006,194,169,25,96.0310219
463f854890d14c0d6b64f00c89827347f58ede52,8,118,31,87,0,0,0,5,40,50,3,6,2.291062953,3793,95,2,542,532,10,32091,31488,603,225,222,3,100
14686731f7a722ceb63f7f931800ac35c6657244,1,11,0,11,0,0,0,4,13,0,1,1,0,109,3,1,9,8,1,1078,1003,75,9,8,1,100
df66fb02ba055fa37699bed12e11831bc41a61b8,4,11,17,6,0,0,0,5,45,170,3,2,1.200442301,1460,19,0,308,310,2,12655,12699,44,85,85,0,100
b18ed3ed229fec897ddcc6702f05184f248ae931,77,84,714,630,0,0,0,3,16,50,1,10,6.153695546,19462,54,7,1478,1545,67,191831,196197,4366,821,888,67,100
157d2cadca4735b80c59724ccc4b2af99af034e8,0,0,0,0,0,0,0,0,0,0,0,0,0,0,20,1,0,0,0,0,0,0,0,0,0,100
1a6b97d7695e81dc6aed1d46d522bf49447d1473,4,12,2,10,0,0,0,4,16,8,1,1,1.842370993,789,46,2,53,53,0,8159,8022,137,50,50,0,100
e7f1ee3938bb742b5c0aa272c963095d423080d2,1,6,8,2,0,0,0,2,9,13,1,1,0,100,30,0,8,8,0,986,957,29,8,8,0,100
3efe836cab9dc545e8ea9341cdb97bcae8e3ab7b,0,0,0,0,0,0,0,0,0,0,0,0,0,0,96,3,0,0,0,0,0,0,0,0,0,100
1e44fe2c77bdd84f255ffd5381aa55a739d3465d,0,0,0,0,0,0,0,0,0,0,0,0,0,0,97,4,0,0,0,0,0,0,0,0,0,100
16f9c6ecb5009759573af7e0e174e92dbdebc286,1,11,6,5,0,0,0,2,10,16,1,1,0,98,55,6,8,8,0,986,986,0,8,8,0,100
b17baec7da4665848799f666c8b57e1b526031ef,1,14,80,66,0,0,0,3,7,30,1,1,0,223,56,7,21,24,3,1431,1933,502,6,6,0,100
4a9151efc0a17248d93ba6c588bef7e2b05c7f19,11,47,23,24,0,0,0,3,41,397,3,8,3.00738624,4375,4,0,812,808,4,34801,34702,99,293,290,3,100
d2fd49e5c4aeae7046afef1a8d23fa696dd9a4eb,5,48,3,45,0,0,0,1,46,9,2,5,0.396627773,1508,193,0,341,432,91,12635,15406,2771,123,219,96,99.28762244
27e872240d118f2c55f440b653dd5ceb9de98466,9,23,23,0,0,0,0,4,22,88,2,7,2.822717805,2051,194,1,245,245,0,17477,17433,44,167,167,0,100
336408f4cc53919d4cf764513f6c570d13f4c050,6,36,12,24,0,0,0,4,16,285,2,4,1.818974184,1439,195,2,210,207,3,13860,13686,174,78,78,0,97.43481918
ea736915de2256e6d6454251df029ba24351a705,0,0,0,0,0,0,0,0,0,0,0,0,0,0,196,3,0,0,0,0,0,0,0,0,0,100
b0b9c216b4cea555b5ca998d39e96eb1018ddc7e,0,0,0,0,0,0,0,0,0,0,0,0,0,0,31,1,0,0,0,0,0,0,0,0,0,100
e21696bd3a16b70139fc399d353935b33975216c,1,5,5,0,0,0,0,4,11,56,1,1,0,135,1,0,9,9,0,1415,1395,20,8,8,0,100
c781e3f7e35917501303466523326599f03bb0a6,2,9,7,2,0,0,0,3,17,56,1,2,0.896038233,917,57,2,159,159,0,7383,7349,34,62,62,0,100
e448725847d19218815951bceb7190c06929511c,1,9,5,4,0,0,0,2,2,28,1,1,0,101,0,0,17,16,1,687,672,15,8,8,0,100
0897c346a52ad35e86ee0d0373feea0316532834,2,38,4,34,0,0,0,6,20,382,2,2,0.985228136,447,1,1,59,49,10,3813,3587,226,28,26,2,100
f0928981b9ea9cdd64cc1ad2f43c70b8115f830c,0,0,0,0,0,0,0,0,0,0,0,0,0,0,5,1,0,0,0,0,0,0,0,0,0,100
4e33639fb51f2d103d6f3458b7e3637622ec969b,1,2,2,0,0,0,0,3,14,144,1,1,0,481,32,1,96,96,0,3830,3832,2,39,39,0,100
4a9cba4a5a3eb13fd3efe8aaf169b99948a771b0,1,43,202,159,0,0,0,3,6,79,1,1,0,266,2,1,15,25,10,1946,3215,1269,11,13,2,100
bf134264ddf15d5716e35fe272d651e332c3a157,1,5,13,8,0,0,0,4,14,83,1,1,0,171,58,1,10,11,1,1653,1717,64,10,11,1,100
21692b3376ad1194be52ec4775cf8ab5f51a401d,0,0,0,0,0,0,0,0,0,0,0,0,0,0,47,0,0,0,0,0,0,0,0,0,0,100
8cacbc4f2bc56ccbedeb28a4f3d6da89840f7c1f,0,0,0,0,0,0,0,0,0,0,0,0,0,0,197,0,0,0,0,0,0,0,0,0,0,100
d9f6c2f18d0536120b529c29a8669c64210f27c0,0,0,0,0,0,0,0,0,0,0,0,0,0,0,198,1,0,0,0,0,0,0,0,0,0,100
9873648498f66a2c476a52416f8b7eb3ae51dadb,6,206,345,139,0,0,0,3,18,111,1,4,0.845649086,3444,48,1,413,431,18,31070,31441,371,223,228,5,100
e422fceb8215fb7e0552bf5cbcea62542abab1a3,1,27,16,11,0,0,0,2,8,120,1,1,0,321,59,1,25,25,0,3152,3056,96,8,8,0,100
0692b2415ebf9ae5ad6a07aae32532a1ed01ec43,82,420,479,59,0,0,0,3,18,82,1,11,5.804447131,19995,49,2,1703,1718,15,199818,199964,146,953,956,3,100
ee5213caf4fd04850ecd318086d679928244d373,1,4,2,2,0,0,0,2,7,14,1,1,0,55,60,1,5,5,0,534,521,13,5,5,0,100
86fe67f5370d98778a654c5de0a3bc33c7cc6c53,1,6,0,6,0,0,0,3,13,22,1,1,0,123,61,2,8,8,0,1284,1210,74,8,8,0,100
fd10aa4106a2706b8e1f61dd17291338eec8f722,4,238,0,238,1,0,1,1,18,266,1,2,0.633897367,173,62,3,30,23,7,3394,1538,1856,22,16,6,99.68152866
280ea92a7395b07f45d31cd64a1b892de43505e9,10,166,3,163,0,0,0,7,47,123,5,7,2.850835409,5578,2,0,875,858,17,48766,47492,1274,334,327,7,100
8f32de0f3626468ebc95fcb72d035479758bf22d,5,237,16,221,2,0,2,1,3,463,1,2,1.671511747,168,3,1,51,30,21,2683,1377,1306,20,11,9,99.80150854
1685541f705b85cf348582f17a088db9d6c91ce0,6,285,5,280,2,0,2,7,35,0,3,5,2.245177155,2271,4,2,322,294,28,22129,20611,1518,143,127,16,99.8022934
c23eaf7cc04e42d21fe766dcd8a757acd4171c00,2,226,0,226,1,0,1,1,7,19,1,2,0.335125399,179,50,1,43,34,9,2865,1410,1455,32,23,9,99.72645565
4b31d774ddbd61feb70a2dae036ea9dbd4579724,0,0,0,0,0,0,0,0,0,0,0,0,0,0,199,0,0,0,0,0,0,0,0,0,0,100
9cd986efb04b229c844a30748ec27d0a102eb368,1,3,0,3,0,0,0,5,13,384,1,1,0,112,5,3,34,33,1,916,902,14,15,15,0,100
f46b1f5d9fd9a6ce60985fdf2dd15d8ec43395a4,0,0,0,0,0,0,0,0,0,0,0,0,0,0,6,4,0,0,0,0,0,0,0,0,0,100
30a794cb0fd99d410338208722be5f9b1b2b136e,1,47,14,33,0,0,0,4,9,55,1,1,0,147,3,0,12,11,1,2359,1879,480,11,10,1,100
65cb71841a00a1aec783129aaf6d79491380936a,1,45,0,45,0,0,0,4,7,55,1,1,0,59,4,1,9,6,3,776,524,252,9,6,3,100
87bff1fc111f0fb58324db82a6734fa73cefcbc1,3,198,1,197,1,0,1,1,16,41,1,3,0.468822508,929,5,2,192,183,9,9035,7554,1481,118,109,9,99.92266048
08c213fc6a59d3f9dc32d2e64c2dcfc24504428a,4,188,3,185,0,0,0,5,18,60,1,1,1.857702373,759,6,3,57,48,9,8961,7737,1224,54,45,9,100
9dd0b27e5543c1bc78e66c1f2a151edb887e7e77,1,196,0,196,1,0,1,1,1,0,1,1,0,0,7,4,15,0,15,1306,0,1306,9,0,9,99.92277992
103dfaa086a6c3139085ff15359199e68a45c8a9,1,1,1,0,0,0,0,10,48,26,1,1,0,1263,7,5,290,290,0,10784,10779,5,80,80,0,100
594566c01e82f130c080545f6515253250363d78,2,274,0,274,1,0,1,1,6,1,1,2,0.259432169,462,8,5,108,90,18,5476,3855,1621,91,73,18,99.922899
f63a47f51f5fb6b4ea1e9d2b1291733c18e47ab0,3,101,6,95,0,0,0,5,19,65,1,2,1.293005309,1366,9,6,246,230,16,12681,11741,940,103,100,3,100
444e31e37425cd25c49afaa57fc68a5152b2090d,2,48,0,48,0,0,0,4,16,133,1,2,0.994984828,533,10,7,76,71,5,5136,4909,227,30,29,1,100
833458ac10cb9b27c5f1b10641949764a3f67f6e,1,174,0,174,1,0,1,1,1,0,1,1,0,0,11,8,14,0,14,1211,0,1211,8,0,8,99.76771196
108b36d42aadbd9d27aa2cd28ca6a01798f35867,1,135,11,124,0,0,0,4,13,67,1,1,0,453,12,9,34,29,5,5673,4717,956,27,25,2,100
23b325221b4758e1eb5df75726382f5025b162cb,2,177,0,177,1,0,1,1,15,39,1,2,0.240216038,802,13,10,167,156,11,8044,6852,1192,98,92,6,99.84453945
f66b0b9f16c2228ea0c14a2245236f9d319a4744,1,1,1,0,0,0,0,10,49,17,1,1,0,1263,8,4,290,290,0,10784,10784,0,80,80,0,100
f2e54626832598b107926d827c33f0541a6c84ad,1,18,0,18,0,0,0,2,2,417,1,1,0,78,9,4,21,17,4,478,380,98,17,15,2,100
591c2fe8895a7a8c268f07b5ee85b3c3dd582468,3,9,9,0,0,0,0,4,36,267,2,2,1.224394445,1130,10,5,233,233,0,8836,8836,0,68,68,0,100
45808eff7c42b097a2bfc434f46812319091d105,3,40,11,29,0,0,0,10,50,220,2,3,0.956178121,1612,11,6,370,365,5,13358,13282,76,116,111,5,100
e89aa777947165c816310128d5799ba50c4ded7f,0,0,0,0,0,0,0,0,0,0,0,0,0,0,200,1,0,0,0,0,0,0,0,0,0,100
b0a40c5abcf7294dc40777cd35925975e2bc1078,0,0,0,0,0,0,0,0,0,0,0,0,0,0,201,2,0,0,0,0,0,0,0,0,0,100
ccdf02e7e9dd95522a1cc1ad583d556ebf92e0d9,1,100,77,23,0,0,0,4,17,15,1,1,0,247,14,11,9,5,4,2724,2624,100,6,5,1,100
fd861453807246fc3af2c82b137c643dad2a0e1f,8,65,18,47,0,0,0,5,51,173,5,6,2.430754118,4052,12,7,696,687,9,33676,33308,368,238,236,2,100
03c86eb696c22a96408fa69d0a16026057ac1d14,3,171,0,171,1,0,1,1,11,88,1,3,0.286896864,95,15,12,18,5,13,1859,879,980,13,5,8,99.92242048
8fa2c49fd193e6ff2a216e9cc6e615a8225c2ca6,2,186,0,186,1,0,1,1,8,42,1,2,0.404448386,191,16,13,47,37,10,2685,1453,1232,27,17,10,99.92260062
ac8b7aaa97480bd58a2bb73bbdd2b0cc13aca946,3,16,3,13,0,0,0,7,42,56,3,3,1.432983121,1914,13,8,371,370,1,15103,15007,96,112,111,1,100
e9e4ba4b683064b4044accc133f9a4c92400c8bf,2,13,2,11,0,0,0,7,19,216,1,2,0.918295834,307,14,9,27,27,0,3501,3431,70,13,13,0,100
c790761e0492dbc2f0c59a91ab69f5ff35761a3f,6,58,23,35,0,0,0,4,37,364,2,5,2.40811844,1299,15,8,265,265,0,10253,10007,246,86,85,1,97.39850217
0c6f3911d2972f266f7e0aca003560b5d530ca7a,2,22,3,19,0,0,0,6,22,145,2,2,0.40217919,823,16,9,130,128,2,6901,6765,136,53,53,0,100
d5212d515dd01e1052319a1b4e8bd6c26ba45850,1,1,1,0,0,0,0,2,5,282,1,1,0,268,51,0,45,45,0,2469,2464,5,11,11,0,100
c3f6817119491a11cfbdc285e1e333c07eca4092,2,97,2,95,1,0,1,1,8,218,1,2,0.61361902,179,17,10,44,40,4,2040,1628,412,33,29,4,99.59823222
f37729df0ce2e8df50057b4c004d2e967db71560,14,391,83,308,1,0,1,6,44,99,4,11,3.066568249,5010,18,11,795,761,34,43378,41502,1876,326,302,24,99.83974359
223ea456e4d69d548901bc4532a6dc243b29c76b,2,15,4,11,0,0,0,5,24,287,1,2,0.981940787,810,19,12,179,178,1,7037,6952,85,81,80,1,100
ed3b7b0e5a68ba374562c7fe6f9b71f3a841f085,1,21,10,11,0,0,0,5,20,39,1,1,0,300,63,0,22,22,0,3335,3169,166,19,19,0,100
334669d84fc247fd74cf7c24362aff140ddb760e,6,6,1,5,0,0,0,3,12,94,1,3,2.521640636,762,64,1,45,45,0,7926,7884,42,43,43,0,100
1d7ca192b8ba88078e1716f4dc0ab81707c38144,1,9,13,4,0,0,0,5,11,43,1,1,0,309,65,2,69,71,2,2508,2512,4,25,25,0,100
2d089107ceef3383ea62bc4e151f5f8d7d11aeb1,3,5,5,0,0,0,0,4,14,22,1,2,1.521928095,468,17,4,28,28,0,4720,4702,18,28,28,0,100
7ba3da6b9234892461f83b69a8b1bc6a97611634,1,25,17,8,0,0,0,4,11,117,1,1,0,240,18,5,21,21,0,2668,2588,80,15,15,0,100
25486e3bc1153766557b666d546d5fce90091a34,5,310,9,301,1,0,1,1,20,41,1,3,0.847491457,2096,19,6,427,411,16,19575,17264,2311,209,197,12,99.76028765
4f17787b3797158177936330eec76e9e6d6123ad,0,0,0,0,0,0,0,0,0,0,0,0,0,0,20,7,0,0,0,0,0,0,0,0,0,100
89d9d265cbf9c78733993600449783c0259ae8e9,1,1,1,0,0,0,0,5,11,35,1,1,0,160,20,12,33,32,1,1360,1353,7,10,10,0,100
04ef0fdb446a5d5904a7c82e78234c322ce31027,1,4,1,3,0,0,0,10,52,36,1,1,0,1269,21,13,293,292,1,10854,10826,28,80,80,0,100
d4800401afc1d1aa70b74b8afebf5ca73321a09a,3,57,10,47,0,0,0,7,25,26,2,3,1.352538675,1293,22,9,277,273,4,11101,10827,274,108,106,2,100
bc3d23bd05155092838273337ab6c84d1bcfd78f,19,321,113,208,0,0,0,3,26,262,5,14,2.868315573,5213,23,10,802,784,18,50674,48758,1916,404,398,6,93.99264405
36df77a32d6fdd12195460ac264522521d9bd692,1,5,5,0,0,0,0,4,7,483,1,1,0,198,24,10,18,18,0,1711,1705,6,10,10,0,100
969d10e96c96b05c1ab98d02c5455f91a4175b60,1,13,20,7,0,0,0,4,11,22,1,1,0,449,66,3,86,87,1,3674,3691,17,35,35,0,100
1aac3a5027f1f43209cc4f9bcf8844822d6f7b9c,8,18,27,9,0,0,0,4,18,116,1,4,2.507508572,1849,67,4,120,120,0,18055,18083,28,59,59,0,100
693e8af52e46e673e2a47f0e3b9b44d6dd2e8422,1,5,5,0,0,0,0,5,24,18,1,1,0,276,25,5,47,47,0,2136,2122,14,13,13,0,100
d718ad737d63399e545a187d71420f106620913d,1,7,3,4,0,0,0,7,17,220,1,1,0,154,26,6,21,20,1,1377,1363,14,7,7,0,100
5b5113d19d891872fa48b8c524347a49f3f1cdf5,27,462,571,109,0,0,0,3,20,106,1,8,3.935531123,8289,68,4,839,850,11,81302,81844,542,429,434,5,99.36842105
2eaaa4b20ca16b8bba8b2e4a4fa4e166d2d4a943,2,12,6,6,0,0,0,1,4,46,1,2,0.918295834,300,27,7,69,67,2,2420,2393,27,20,20,0,100
64fdab50d11c2fd9635738d586a17453791b5717,1,3,0,3,0,0,0,6,44,49,1,1,0,839,28,8,119,118,1,6182,6154,28,25,25,0,100
ae5ba5b01cc8c0e2c8387db208fd5f9023fde614,2,8,2,6,0,0,0,10,53,49,2,2,0.721928095,1439,29,9,330,329,1,11679,11648,31,110,110,0,100
24eecc4a02e3d0e6b60c6ffc825ffd6105d15fbc,0,0,0,0,0,0,0,0,0,0,0,0,0,0,30,10,0,0,0,0,0,0,0,0,0,100
c8e46d1612d740c80c0f817840e5c4dc90c68bbf,2,16,0,16,0,0,0,5,16,133,1,2,0.69621226,939,31,10,110,108,2,9633,9491,142,51,51,0,100
6f78180ff2cac78d17a8415af5177252c8566a6e,2,20,6,14,0,0,0,5,11,276,1,1,0.391243564,257,32,10,46,43,3,2153,2109,44,17,16,1,100
0aeb6c89a7fa16ebe8183c7bf66bfa8187b563a6,6,92,26,66,0,0,0,5,39,52,4,4,2.104009313,1743,33,11,314,304,10,14492,14061,431,122,117,5,100
fe97483d701e757269df8927598c6ae393596e1a,3,231,112,119,1,0,1,1,13,12,1,2,1.043281273,275,21,0,62,49,13,3224,2196,1028,38,33,5,99.78849408
4aa036e68eae69e0eb42329eb3ad49db14522b07,1,12,0,12,0,0,0,2,4,4,1,1,0,107,22,1,30,27,3,681,645,36,18,15,3,100
adf53c86f9f6e2af8f44d31f0ad1523c401e57ac,1,1,0,1,0,0,0,5,9,66,1,1,0,189,186,0,41,41,0,1711,1699,12,30,30,0,100
c4df0a5e919884804eef7596f524e17c3c23c1d2,0,0,0,0,0,0,0,0,0,0,0,0,0,0,202,0,0,0,0,0,0,0,0,0,0,100
13bc6b6a346b632e4f5be5d130c76f95dc970338,1,1,0,1,0,0,0,2,5,1,1,1,0,116,34,11,30,30,0,688,681,7,18,18,0,100
4b0a920f6b6336e2bf4926adc8dc329f88f556e2,25,853,234,619,2,0,2,4,54,378,5,16,3.585199181,6414,21,0,1126,1059,67,60686,56577,4109,492,466,26,92.27195946
40be65d5d3d8cfba166494334e5bc7e5305b5e70,1,2,1,1,0,0,0,5,17,63,1,1,0,227,35,7,15,15,0,2356,2322,34,13,13,0,100
bc75a5f9926f20dc8d8e5dc0ce521533fbf1d90f,55,55,55,0,0,0,0,7,55,291,7,30,5.781359714,14243,36,8,2730,2730,0,117590,117590,0,992,992,0,100
f821219f13bf3a7c240862888a157e72b98f7bfc,1,4,1,3,0,0,0,6,14,469,1,1,0,269,37,9,54,54,0,2109,2086,23,24,24,0,100
8c7eaa69f015615bf3753ec434bad20669a313f9,2,2,2,0,0,0,0,5,41,14,2,1,1,931,38,10,198,198,0,7399,7399,0,56,56,0,100
395675fb0f4096dc44f1e325681536328956440e,43,805,926,121,0,0,0,3,21,74,1,8,4.161616029,12624,69,0,1197,1193,4,124672,126827,2155,658,644,14,99.3700126
f95581007c5b6177cfbc85a23bb589f315c42373,0,0,0,0,0,0,0,0,0,0,0,0,0,0,52,0,0,0,0,0,0,0,0,0,0,100
aeb6c86f431631fa02f1725a6352b0b802491d49,3,22,11,11,0,0,0,3,5,643,1,1,1.410869033,158,39,5,21,20,1,1502,1399,103,8,7,1,96.83085147
9d5429a411710d99fe83e6c82763cd2c6f3d9101,2,49,14,35,0,0,0,7,22,22,2,2,0.20307393,826,40,6,132,130,2,7211,6958,253,53,52,1,100
d0c9850e5abf56b3e3c500ee744e96e634ba7691,44,1060,1502,442,0,0,0,3,22,47,1,6,3.940044593,12805,70,1,1053,1049,4,125096,126543,1447,526,526,0,98.33804809
311baa9038964d3e2cc84929fada3686716faf08,2,16,2,14,0,0,0,5,12,165,1,2,0.650022422,95,23,0,9,7,2,970,855,115,6,6,0,100
b830ddc8798f0437602d9c39de64c2813bc7d9ed,0,0,0,0,0,0,0,0,0,0,0,0,0,0,71,2,0,0,0,0,0,0,0,0,0,100
0a389559ee5d9a81493ac300f669f5d7f640139b,1,1,1,0,0,0,0,7,16,8,1,1,0,452,41,6,47,47,0,3952,3947,5,24,24,0,100
71cfc47b8ee6e9cfd8794c09748abbde44f8fd70,0,0,0,0,0,0,0,0,0,0,0,0,0,0,42,7,0,0,0,0,0,0,0,0,0,100
1dd3018105814372362e957b6a7bf5b26e58fae7,6,26,27,1,0,0,0,6,46,50,3,5,2.248385233,3718,43,8,531,531,0,30569,30569,0,215,215,0,100
74ce00b1e1e90ed6f6dd5571028fda71c7ec7a37,2,2,2,0,0,0,0,6,13,52,1,1,1,284,0,0,66,66,0,1486,1486,0,48,48,0,100
df0c8d35a244c18ead634a938f80d42bcf08718a,3,20,19,1,0,0,0,2,12,50,1,3,1.154223892,1029,24,1,97,97,0,9561,9556,5,43,43,0,100
3db317f8a49f7e1d87de656b00019d541f9dbe5d,1,4,3,1,0,0,0,10,56,38,1,1,0,1277,44,9,294,294,0,10905,10881,24,80,80,0,100
1365064828439468996f5a523ecf59d0c2dd8754,14,1093,2,1091,11,0,11,1,13,63,1,5,3.27152237,353,72,3,155,59,96,7998,2987,5011,117,35,82,99.11785462
cecc3b427505fb88a4e1a35c9b9c1c6c512caf3a,1,15,4,11,0,0,0,11,57,2,1,1,0,1278,0,0,295,294,1,10965,10905,60,80,80,0,100
0232f1b6bddfc16762357cd0f70b9b89de0c308a,3,508,9,499,1,0,1,2,10,52,1,3,0.270321324,709,53,1,191,134,57,10173,6167,4006,111,88,23,99.93006993
a6298f8a7fdccf05a5aece2289df36431558affd,2,51,3,48,0,0,0,5,12,806,2,2,0.556421567,163,1,1,24,19,5,1450,1201,249,16,14,2,100
9124f015275a780480aa256b8538191ccc96d6e7,3,277,30,247,1,0,1,1,8,147,1,3,1.133307922,297,73,3,80,49,31,3469,2110,1359,52,38,14,99.9301676
044e4b16a3f3a37bbf6f107c2a93d32a708753ea,3,12,9,3,0,0,0,2,21,39,1,1,1.312744353,479,74,4,29,29,0,4962,4922,40,21,21,0,100
8d130d88cb8165fa543c8d3047d06a4435b944c5,1,32,37,5,0,0,0,7,17,37,1,1,0,452,45,4,46,47,1,3815,3952,137,24,24,0,100
c1b44232f8c18356ea8349b185a524d4a3f36d90,1,2,6,4,0,0,0,3,13,44,1,1,0,171,75,3,11,12,1,1741,1750,9,11,12,1,100
a421c888f5e49bba286222848b6062fd356f4e07,1,2,2,0,0,0,0,2,3,59,1,1,0,142,76,4,15,15,0,1276,1276,0,9,9,0,100
728eb36c0d00153bdaba9acbc910087ab7c7d5ac,1,4,4,0,0,0,0,3,12,251,1,1,0,290,77,5,22,22,0,3748,3740,8,20,20,0,100
bbd01241c7999b4c0362160c32659ea18a97df7b,2,31,25,6,0,0,0,6,25,83,1,2,0.99631652,505,1,1,59,62,3,4525,4492,33,27,26,1,100
844dab219f691ddaa1d657a475f6f208cba6c3bd,5,130,12,118,1,0,1,3,14,120,1,4,1.075581057,570,54,1,89,85,4,5227,4398,829,59,55,4,99.93026499
0015a3b76a526e2b86d35ffaf9a1268a44c669ce,49,143,149,6,0,0,0,3,23,177,1,17,5.044777175,11372,78,6,1494,1497,3,104328,104591,263,712,712,0,100
9da286574271e6a20af5777ef3b1c6cdd167dd3e,1,2,1,1,0,0,0,7,26,50,1,1,0,472,2,1,49,49,0,3874,3874,0,27,27,0,100
7f9a77fbcfd2dec29bf01044d295d1e39a8ec6a7,5,165,23,142,0,0,0,2,15,165,1,4,1.28030462,582,79,6,95,83,12,5612,4572,1040,57,48,9,99.96515679
208d0ee6a30b660eb6f3fdf36b6120073dc76637,1,1,2,1,0,0,0,3,11,694,1,1,0,210,3,2,35,35,0,1430,1425,5,23,23,0,100
3e81a69ab3a1784d50c817afe994f8327ba45f3d,0,0,0,0,0,0,0,0,0,0,0,0,0,0,187,0,0,0,0,0,0,0,0,0,0,100
41af88ffc07f36b80650792c8567330a26d4c43d,2,59,36,23,0,0,0,6,26,36,1,2,0.147310667,502,2,1,61,59,2,4674,4525,149,28,27,1,96.44707624
d9233f74116065ea422895d7f9c41d6d1899f2f6,1,2,2,0,0,0,0,6,20,2,1,1,0,260,3,2,18,18,0,2693,2692,1,15,15,0,100
7edb89d863631e81adefba2ab87650ee148b42b5,5,496,46,450,2,0,2,1,2,36,1,2,1.309025391,213,55,1,98,19,79,4426,1506,2920,86,18,68,99.76340694
3f23d783e8244f8b706cee541d2a1cd34c64f768,0,0,0,0,0,0,0,0,0,0,0,0,0,0,4,2,0,0,0,0,0,0,0,0,0,100
eecf7f533f32ca9274666a9a545934dcc7bdb21b,5,337,46,291,2,0,2,1,3,12,1,2,1.42194254,218,56,2,59,21,38,3397,1539,1858,47,19,28,99.76377953
ed1654fab53f64f3f09b09225183a0e18c6177bf,1,13,5,8,0,0,0,7,15,107,1,1,0,146,4,2,30,29,1,1256,1195,61,8,8,0,100
cd9ba6771eef181d2151aeaecbf12383befb49ab,0,0,0,0,0,0,0,0,0,0,0,0,0,0,5,3,0,0,0,0,0,0,0,0,0,100
d0eb98761b6dd1760fc658745d84b0c1e6f13f29,0,0,0,0,0,0,0,0,0,0,0,0,0,0,6,4,0,0,0,0,0,0,0,0,0,100
8b6c190385b6492d75f69f3a2c70cd180cbac27b,0,0,0,0,0,0,0,0,0,0,0,0,0,0,188,1,0,0,0,0,0,0,0,0,0,100
929b952086dcf0f769574f5aa08bc128c3031143,0,0,0,0,0,0,0,0,0,0,0,0,0,0,189,2,0,0,0,0,0,0,0,0,0,100
ab93ac7e4b34822fde5b3d688f0dd6f969267b1e,0,0,0,0,0,0,0,0,0,0,0,0,0,0,33,0,0,0,0,0,0,0,0,0,0,100
fc2179f643a21e03b19005ad8aef2284c2aca5b1,12,1638,36,1602,3,0,3,1,20,64,1,6,2.202041712,1969,57,3,485,364,121,26341,15108,11233,309,236,73,97.56480754
fa5690031acfee5c65f1f850eb9be65465a3de2e,1,2,2,0,0,0,0,3,5,37,1,1,0,192,58,4,10,10,0,2038,2034,4,9,9,0,100
a57481417416b3fb18571bd6a1e41cde271fef7e,1,1,1,0,0,0,0,3,16,102,1,1,0,116,59,5,8,8,0,1283,1279,4,8,8,0,100
ea30dc410af56f1267af8c3e7b0a9b22f5bdfd80,2,6,8,2,0,0,0,2,6,21,1,2,0.863120569,524,80,1,77,77,0,4025,4047,22,51,51,0,100
24d28a71be00935d29e1f7e6bcab816d8de66571,10,887,60,827,2,0,2,1,23,23,1,5,1.911964285,972,81,2,264,151,113,12670,7313,5357,144,93,51,99.76489028
a5f707b981abc231146bc91a1617db399c7d4b2d,1,1,5,4,0,0,0,4,6,673,1,1,0,123,46,0,11,11,0,1115,1159,44,5,5,0,100
6379001453005c01923ab3ae8897f09fb4709c57,0,0,0,0,0,0,0,0,0,0,0,0,0,0,47,1,0,0,0,0,0,0,0,0,0,100
1afb51079a7ebfdaca1cddb39c0c555ea58fdbcd,3,314,0,314,2,0,2,1,2,3,1,2,1.084604334,558,82,2,80,57,23,6808,4915,1893,58,38,20,99.76553341
701347aa1eb191d5cca031e79be5554794aeb3fb,0,0,0,0,0,0,0,0,0,0,0,0,0,0,190,2,0,0,0,0,0,0,0,0,0,100
05ee82e677587fad3cc3f1cddbde6405ded1bcef,4,1366,26,1340,0,0,0,1,13,30,1,3,1.299012646,721,60,4,235,147,88,12256,5524,6732,186,113,73,100
5d6f957ca2dd9009e43eca2abe604ea25f4b8efb,4,6,7,1,0,0,0,2,14,62,1,4,1.546593564,867,61,5,108,108,0,8742,8742,0,57,57,0,100
4e81193f418dadef9f04417f3ec29dde997424dc,4,166,5,161,0,0,0,2,8,43,1,2,1.239653622,640,62,5,111,100,11,5982,5016,966,64,57,7,98.98198904
cc3b343bdb9c9f9c05c16d2f8c71543ae66bee1c,2,14,12,2,0,0,0,1,14,16,1,2,0.89049164,934,63,3,94,94,0,8010,7986,24,69,69,0,100
1bae2a6f20dd751f9115cbdd4c7f0f8ead20d594,13,317,173,144,0,0,0,8,47,219,4,8,2.72427334,5456,5,0,772,748,24,47023,45891,1132,330,329,1,100
7532a5864eb9d0a9ae2f09b8af9ae5d05f04bc82,2,16,11,5,0,0,0,6,26,216,1,2,0.228538144,816,6,1,120,119,1,6814,6764,50,43,42,1,100
0a8d0cd3da06b1d8f0e5b1494b035b84d41e1237,0,0,0,0,0,0,0,0,0,0,0,0,0,0,7,2,0,0,0,0,0,0,0,0,0,100
a6107758f125163c70f53570581e4dc5b9e15e87,1,48,45,3,0,0,0,4,12,164,1,1,0,452,48,2,84,80,4,3594,3591,3,21,21,0,100
aaed4c7a83e4f1e3e2ceded35b2ab600bd73cd4d,3,13,2,11,0,0,0,4,21,169,1,3,1.399581231,640,7,0,115,113,2,5294,5213,81,49,49,0,100
2ebf12837b3fb330abdaf29d85a153ad92f96d84,4,162,81,81,0,0,0,3,21,254,1,2,1.600422365,1605,8,1,269,260,9,14099,13402,697,132,128,4,100
c6c92134efb727918da69c9cd31206dff29cddad,1,24,18,6,0,0,0,4,24,84,1,1,0,499,83,1,106,104,2,4333,4298,35,32,32,0,100
42f175a1239cfdcbdbaab08afaad2b247f7268a8,6,16,83,67,0,0,0,3,18,192,1,3,1.755010543,1861,64,4,178,184,6,17494,18093,599,152,156,4,100
9fd86b786195ac03fc25d31c6f35062c4014f10a,17,1538,29,1509,3,0,3,8,48,43,4,8,3.226701001,5764,9,2,1110,965,145,57632,47858,9774,430,359,71,95.53277188
fae479b2217adcb3b97ebe2c4e6739b56c691a0d,0,0,0,0,0,0,0,0,0,0,0,0,0,0,10,3,0,0,0,0,0,0,0,0,0,100
8ee6d45f0f695687c8646b626655f37dfd7602e8,1,1,1,0,0,0,0,2,3,39,1,1,0,563,84,2,58,58,0,4967,4967,0,39,39,0,100
ff9c78e3c82e45a4e3543924fffe834773dc3880,4,1917,50,1867,0,0,0,1,13,48,1,3,1.346974949,634,65,5,297,122,175,15776,5032,10744,200,73,127,98.14998348
84eafdb0f129280154688ddbac07e0e5849a3a6d,2,4,55,51,0,0,0,2,15,362,1,1,0.999792766,363,85,2,28,32,4,2660,3118,458,22,22,0,93.59122402
0ed1af8c34b010abcba1ad9ffded3a6ee0cc6361,3,11,12,1,0,0,0,3,20,180,1,2,1.301574289,977,86,3,181,181,0,8200,8179,21,109,109,0,100
207443e9dd73f00aaa3a00cc67971163afd1caac,0,0,0,0,0,0,0,0,0,0,0,0,0,0,66,6,0,0,0,0,0,0,0,0,0,100
041de1def1e88430534dd9ced63f983bf711b351,3,152,11,141,0,0,0,5,16,161,1,2,1.020572159,840,25,0,149,135,14,8524,7491,1033,67,62,5,100
28fd15c496f8175d242ab2f5b783aa41e1c44baf,3,138,50,88,0,0,0,2,22,141,1,2,1.297621122,590,26,1,66,66,0,6129,5599,530,37,35,2,99.86838642
b4ade492f7552ccb12d4714e08c77432287e6bf5,3,16,35,19,0,0,0,2,15,88,1,2,0.90439775,1141,67,7,210,215,5,10045,10150,105,80,82,2,100
c087f9e839107ad2ab7b8b86878aca0b3cb0ffa8,2,10,6,4,0,0,0,3,5,56,1,2,0.337290067,889,68,8,188,188,0,7376,7339,37,133,133,0,100
3849c7c520c12cc28cf8833bd664923815c13212,2,3,3,0,0,0,0,6,21,357,1,1,0.918295834,659,11,4,60,60,0,6317,6317,0,46,46,0,100
4becb74bc09c3c5fbfde0248f4271c45d7b879db,25,140,27,113,0,0,0,5,58,661,9,19,4.505402475,5597,12,5,935,935,0,47284,46239,1045,382,382,0,100
659f229f55a1132d3a4ea82c7528759f2989ce03,1,1,0,1,0,0,0,4,25,17,1,1,0,505,87,4,106,106,0,4335,4333,2,32,32,0,100
77efa6e9d913593044864aa31ca5e8682ba395a4,2,112,28,84,0,0,0,2,3,33,1,2,0.99631652,524,88,5,95,89,6,4794,4295,499,51,45,6,100
a152e078aaa91057643b3a3053e1243aaaaa2c3a,1,1,1,0,0,0,0,5,17,60,1,1,0,74,69,9,3,3,0,681,681,0,3,3,0,100
b936a69b4d99646aca65741343a458e30dfef1c2,1,5,4,1,0,0,0,2,4,5,1,1,0,748,89,6,173,173,0,6063,6070,7,124,124,0,100
8cbc33e0d99e67d6d94c0039e544a1a34db15204,1,1,0,1,0,0,0,1,3,18,1,1,0,604,70,8,29,29,0,5133,5126,7,26,26,0,100
ec3e889a755247d3e9ea83f8fc3096118647aa60,1,5,3,2,0,0,0,2,9,11,1,1,0,245,90,7,17,17,0,2864,2830,34,8,8,0,100
5ec4c708a3712894ef8c8678b637891d07570734,1,38,35,3,0,0,0,3,11,111,1,1,0,521,91,8,48,48,0,4368,4360,8,29,29,0,100
c756530723b84d23fb931df38b0c5cd54e9c4aca,2,2,22,20,0,0,0,1,2,152,1,2,0.249882293,157,92,9,20,24,4,971,1096,125,17,20,3,100
4df64f80b596997a6232fdeb44a4d80cbfe39597,15,159,60,99,0,0,0,1,24,54,1,6,2.911581455,3846,93,10,736,720,16,31424,30772,652,512,499,13,100
dfcdb31c36dcd3f93569760270ecd4e4b4703ae2,0,0,0,0,0,0,0,0,0,0,0,0,0,0,191,0,0,0,0,0,0,0,0,0,0,100
7ffe1a33b6f3e8d4005e1bee89e9f91d7db33e03,3,47,32,15,0,0,0,12,59,103,2,3,1.475556264,2213,13,6,492,489,3,19193,18957,236,169,167,2,100
e093668a832eb2b9696ab572529c37a55671a907,3,111,54,57,0,0,0,2,19,297,2,3,0.21778588,1465,14,7,223,223,0,13949,13564,385,115,115,0,100
27e1d59dab46b6674767ccbc823001dd4af1b6ab,0,0,0,0,0,0,0,0,0,0,0,0,0,0,192,1,0,0,0,0,0,0,0,0,0,100
edddc07dd1d4df95328bf454daa92041828bc040,1,2,0,2,0,0,0,3,12,185,1,1,0,118,94,11,8,8,0,1138,1121,17,6,6,0,100
77830c17ff42b76ac233239949d59273f41cadec,1,9,6,3,0,0,0,3,10,185,1,1,0,240,95,12,25,26,1,2424,2394,30,9,9,0,100
4defb913a59a9e28158a26df34753d5d6ec4628f,1,4,0,4,0,0,0,4,15,56,1,1,0,244,96,13,21,21,0,2698,2658,40,15,15,0,100
e8274648b1ad8eaf9e68fe0bc39555dff7cd7a4e,1,2,0,2,0,0,0,3,17,120,1,1,0,185,97,14,7,7,0,1960,1940,20,6,6,0,100
d23e232e9890c6454581d0e5e57cdffbe8ea853b,1,36,36,0,0,0,0,2,3,56,1,1,0,375,98,15,56,56,0,3980,3980,0,23,23,0,100
a0e1c3a77956755836da2c661d14c95d9aa56df3,5,42,53,11,0,0,0,4,16,80,1,2,1.150508671,1173,193,2,118,117,1,12093,12200,107,59,59,0,100
55ce6bb0ab3e81bbfdcd4de781f014cc6fa4aeb8,5,53,42,11,0,0,0,4,17,120,1,2,1.150508671,1162,194,3,117,118,1,12200,12093,107,59,59,0,100
c31af621452ea58dba3089ef90d3c0f7490c8eb2,2,35,1,34,0,0,0,7,30,161,1,2,0.581321499,916,49,0,188,187,1,8820,8613,207,77,76,1,100
949376197f8005cd0aded78c154fe13e97dc2749,0,0,0,0,0,0,0,0,0,0,0,0,0,0,99,12,0,0,0,0,0,0,0,0,0,100
514fa5411208426e79d9cdfed9c946586e324040,1,0,2,2,0,0,0,2,4,29,1,1,0,605,100,13,29,29,0,5115,5133,18,26,26,0,100
b73e34bd9c400f3a24a9321c3696bbdc802845bc,1,1,1,0,0,0,0,4,11,50,1,1,0,231,0,0,43,43,0,1946,1947,1,12,12,0,100
dc950f718992f5d54f6ec81da538992dfca8d246,1,17,17,0,0,0,0,5,10,29,1,1,0,129,0,0,20,19,1,1050,1035,15,12,12,0,100
8db18628a4d6cb689a2416052ccef615e288273f,13,42,19,23,0,0,0,4,21,87,1,9,3.296040733,4603,1,1,482,481,1,42377,42259,118,278,277,1,100
3189d52e4fc3ba290ce05208b9a1a3a18bb6473d,3,8,8,0,0,0,0,3,12,70,1,2,1.298794941,861,2,2,150,150,0,7473,7481,8,98,98,0,100
460dd209ab54471a93629c4d1590a02bbc671a65,2,2,2,0,0,0,0,1,3,30,1,2,1,210,101,14,22,22,0,1852,1852,0,19,19,0,100
53bd6c38e76b6bddb45f6015bf70441c7e9099e1,0,0,0,0,0,0,0,0,0,0,0,0,0,0,8,0,0,0,0,0,0,0,0,0,0,100
bd44343333e166e672a62c15c5ef306fadc46dd7,8,455,92,363,0,0,0,7,31,67,3,4,1.644171254,2894,15,0,534,507,27,27908,24851,3057,219,203,16,100
60161ae5aff18715fbae83cdd7d9fdeab83084ec,2,17,3,14,0,0,0,9,29,487,1,2,0.881290899,611,16,1,115,113,2,5129,4972,157,37,35,2,99.65843405
a61349d6eaa08e3961415b3cebcd12cf170452ac,0,0,0,0,0,0,0,0,0,0,0,0,0,0,17,2,0,0,0,0,0,0,0,0,0,100
98e12502a81e3e20b872431d1fdde06ba77c4880,7,338,5,333,1,0,1,6,49,40,3,5,2.042852313,3047,18,3,477,441,36,26759,24662,2097,177,161,16,99.94750656
aabf5e1361c87e52fd49141c57850f58f68fc785,8,219,52,167,0,0,0,6,50,112,3,4,1.848493924,4126,50,1,702,665,37,34395,33224,1171,236,230,6,100
5422ede87153a39095049737e7033f2973628d2e,2,16,19,3,0,0,0,5,22,27,1,2,0.315997133,897,3,3,176,176,0,7362,7390,28,105,104,1,100
ccbebbacd0a0957f942b69798a7f171c46a85f65,2,20,21,1,0,0,0,2,4,109,1,2,0.978869851,997,102,3,76,76,0,9425,9432,7,53,53,0,100
3b4610a3f79da886157171ce0288c4ce7dc8d556,2,5,2,3,0,0,0,2,5,0,1,2,0.985228136,997,103,4,76,76,0,9452,9425,27,53,53,0,100
867a24a6a8c69560a69c771678864adfaf8bf399,0,0,0,0,0,0,0,0,0,0,0,0,0,0,104,5,0,0,0,0,0,0,0,0,0,100
9a2992551bb68b11c01bdb4fc7058e50b8707c99,2,17,1,16,0,0,0,3,6,382,1,2,0.764204507,72,105,6,13,11,2,679,542,137,10,9,1,100
0457a1eff55a9cb37e9fc51e1df44ca3b2127223,1,12,15,3,0,0,0,12,60,66,1,1,0,1287,203,0,292,293,1,10943,10971,28,80,80,0,100
618f717d390319a8dbc022c7da1effad6eb10589,1,15,12,3,0,0,0,12,61,0,1,1,0,1285,204,1,293,292,1,10971,10943,28,80,80,0,100
e5698fad33c3004fed7ab4d02e82b2a993d525e6,7,86,10,76,0,0,0,7,27,435,2,6,2.016997135,1084,19,4,163,151,12,9764,9342,422,80,78,2,99.63302752
b36a82394998697934f282be22714222e4b2a39d,3,42,3,39,0,0,0,4,32,39,1,2,1.569488245,1883,20,3,333,330,3,16769,16541,228,138,136,2,100
9f69ae27159436721c3fa1fdc401bb0de0cdca80,16,406,275,131,0,0,0,6,18,374,1,6,3.731479913,3388,21,2,450,441,9,34899,33835,1064,198,190,8,95.0997151
5f58c380bf28d91a40d7a1a640bec742b4b72e12,16,117,152,35,0,0,0,2,25,124,1,7,3.428906082,4346,71,0,564,567,3,39582,39808,226,350,352,2,100
9066eac27897e845df867aa00545cc2f9101d1ef,1,1,1,0,0,0,0,4,7,8,1,1,0,77,22,3,11,11,0,693,693,0,7,7,0,100
09841bbeab843df681f70ca21eb1c856507149c2,0,0,0,0,0,0,0,0,0,0,0,0,0,0,23,4,0,0,0,0,0,0,0,0,0,100
c96bf897d403b77810b220694e7bdedf1fe3ccee,22,88,83,5,0,0,0,4,23,155,1,4,3.760639545,5758,72,1,509,508,1,56915,56726,189,218,218,0,100
1b47d2e7fb22622b5a327d2c0fe45af84fbfbc99,0,0,0,0,0,0,0,0,0,0,0,0,0,0,24,5,0,0,0,0,0,0,0,0,0,100
5b4cf24b745c9f04c102ed93004786eb608f46e3,2,16,20,4,0,0,0,2,11,134,1,1,0.979868757,312,73,2,38,40,2,2293,2307,14,31,32,1,100
281e9e34bdfb2f645fff20b5bc89e06d6e18d1e0,2,76,0,76,1,0,1,1,3,154,1,2,0.926819064,109,25,6,38,25,13,1049,625,424,21,18,3,98.95320197
0ff87bce85e1be6c36b18b7a435e5c30dbda6c90,1,12,32,20,0,0,0,4,6,1516,1,1,0,43,26,6,3,5,2,133,284,151,3,3,0,99.18699187
952a9e6c37b0eb035efbfb43ed73c75951bbaab4,1,32,12,20,0,0,0,4,7,3,1,1,0,21,27,7,5,3,2,284,133,151,3,3,0,99.18699187
cc80a17546db614098709d71dfbb2a270bfbf4ac,6,194,1,193,1,0,1,5,20,165,3,5,1.893288238,687,28,8,122,103,19,6721,5700,1021,49,43,6,99.90909091
6e7634e8b4cff58894fbde5df97579e7ddfaf005,8,41,23,18,0,0,0,7,51,98,3,4,2.698073242,4606,29,7,728,716,12,37398,37292,106,253,252,1,100
4cda54073f1a4389378c8e7365bca59c9728a424,2,16,5,11,0,0,0,8,30,201,1,2,0.998363673,648,30,8,88,84,4,5438,5369,69,37,37,0,100
60e96f4a4088eb70eab7d6842dfd6d51bd521c98,3,13,6,7,0,0,0,3,8,348,2,3,1.167436723,537,31,9,100,99,1,4219,4152,67,59,58,1,100
51041fc4a00e9e45aedfeb58ca56da605acbab4e,0,0,0,0,0,0,0,0,0,0,0,0,0,0,32,10,0,0,0,0,0,0,0,0,0,100
d1942f4749208fea6d3247c13d211a3918445ed5,1,4,0,4,0,0,0,4,8,17,1,1,0,43,33,11,5,5,0,314,284,30,3,3,0,99.96978852
27c9a1f8b07d7b5985ab907c439583f50f99dcdc,2,12,3,9,0,0,0,9,33,46,1,2,0.970950594,848,34,12,163,162,1,7198,7110,88,48,47,1,97.87963829
1416f5e704251b4174f1549e6f0546212ab0a842,2,34,1,33,1,0,1,1,34,0,1,2,0.315997133,781,35,13,152,151,1,6487,6428,59,38,37,1,89.60302457
f966900068693ad3a5c2bb3f33e12cbe700084f5,52,3596,201,3395,11,0,11,2,24,125,1,16,3.98723434,11950,74,3,1617,1355,262,133433,112275,21158,1086,926,160,93.77017431
69a5d4414d381d19520f3fa00dc9c6214019b320,1,3,3,0,0,0,0,5,19,0,1,1,0,319,75,4,18,18,0,3361,3361,0,16,16,0,100
b606ffcf5b69a1fa1fcb3f2195a731b6d76e6f0f,3,27,4,23,0,0,0,2,13,50,1,2,1.354584212,723,76,3,123,120,3,5974,5878,96,68,67,1,100
f64e6c162945fcf46e83e949944437c09fd5d166,7,385,0,385,2,0,2,1,22,167,1,6,1.87338046,1436,36,11,290,259,31,14193,11669,2524,181,162,19,99.72908906
5a3e1d66fb52d102696aeabd6dc66e0d62d261e0,0,0,0,0,0,0,0,0,0,0,0,0,0,0,37,12,0,0,0,0,0,0,0,0,0,100
3f00d05171e39c75713d1f6d7ff00cfbab16bf89,22,1849,59,1790,12,0,12,5,62,150,6,14,3.51622701,4207,38,12,908,706,202,44288,36074,8214,401,295,106,93.13453537
77910aefd2716f22d545eeeb32a7cc8f493bc5a9,0,0,0,0,0,0,0,0,0,0,0,0,0,0,39,13,0,0,0,0,0,0,0,0,0,100
af9c80ac970043e154c07f52a1438cc6cf9a0ffa,0,0,0,0,0,0,0,0,0,0,0,0,0,0,40,14,0,0,0,0,0,0,0,0,0,100
ca86057f6bde4319123513791be33c91646f13ac,1,0,1,1,0,0,0,6,7,4,1,1,0,192,9,0,15,15,0,1976,1987,11,12,12,0,100
bc9e355796367699f2e8f5774c21a69b2ffbc217,0,0,0,0,0,0,0,0,0,0,0,0,0,0,10,1,0,0,0,0,0,0,0,0,0,100
0bc2ed11d79dc26b620f8aad858a2933d88625a2,4,23,2,21,0,0,0,2,25,382,2,3,1.660533277,961,41,14,214,211,3,7767,7701,66,77,74,3,100
57195fa052a48be468ff7670c0fd4878aa7e34d2,1,6,4,2,0,0,0,9,47,26,1,1,0,860,42,15,211,209,2,6689,6670,19,49,49,0,100
cd0a95a48bdee3cdf1e27b1de709ea83ab5d7487,1,1,1,0,0,0,0,4,7,64,1,1,0,165,43,14,16,16,0,1531,1531,0,8,8,0,100
fccfc1c63663a9f0580a76a836ee34404e1796af,1,3,11,8,0,0,0,9,35,27,1,1,0,781,44,15,150,151,1,6373,6424,51,37,37,0,100
5c9fe56b2256b76368add5d8700bcd2b203bad40,1,50,18,32,0,0,0,8,17,9,1,1,0,285,45,16,65,59,6,2388,2176,212,25,24,1,100
0582e6197699fe422cef4b4685a45df7dfdda275,1,13,30,17,0,0,0,3,9,4,1,1,0,237,46,17,49,49,0,2059,2059,0,9,9,0,100
ef3bdce4ea8e0047b57e394d402b0c05ba2b60d6,2,2,2,0,0,0,0,9,36,66,2,1,1,826,47,18,161,161,0,6693,6693,0,44,44,0,100
459b0dd79889ac46cf65c64a6fae17fd06c2fd83,0,0,0,0,0,0,0,0,0,0,0,0,0,0,48,19,0,0,0,0,0,0,0,0,0,100
73e6e6b0df298bcc8b07226c3789a5414b0331be,1,46,11,35,0,0,0,4,21,35,1,1,0,438,49,20,16,14,2,4561,4283,278,15,13,2,100
430166209a8734e12198a44feafcdef656a5b985,1,2,0,2,0,0,0,3,20,169,1,1,0,874,50,21,93,93,0,7869,7859,10,55,55,0,100
63dca22e9f79a0e802cd60282457a11706f56cf9,1,1,0,1,0,0,0,8,19,187,1,1,0,455,51,22,46,46,0,3897,3885,12,24,24,0,100
cbb38ce18b346e107cb4ffd85d4302d889f9d80a,41,5206,196,5010,34,0,34,8,53,63,4,11,4.8980198,2858,52,20,992,389,603,51025,23621,27404,426,172,254,97.30010384
815e476951f3f1e62744c4ae9449ed8af513f11e,2,127,136,9,0,0,0,4,15,156,1,2,0.283969227,689,4,0,127,127,0,5737,5743,6,87,87,0,98.63154294
4c86021c549f0bac53915dc016f6caa94163ba25,1,7,7,0,0,0,0,5,22,3,1,1,0,468,5,1,16,16,0,4576,4561,15,15,15,0,100
016999b6d65e92666858ace015d4ab8aa3b7d041,1,1,1,0,0,0,0,8,34,7,1,1,0,672,11,2,39,39,0,6539,6534,5,37,37,0,100
e3dd84edf0651a7f51087e14ac3c6116e86dbdd1,2,53,17,36,0,0,0,6,16,196,1,2,0.512709142,508,53,17,68,65,3,4971,4679,292,41,37,4,100
f8ee609867e65ee9b62895fa8cf03ab074fe1c25,2,4,18,14,0,0,0,6,48,119,1,2,0.945660305,1138,54,18,233,236,3,9152,9228,76,65,66,1,100
d8adca9d9e1fe8ad6fbc6f0dcd8d8b7c82e0b92b,6,14,16,2,0,0,0,7,49,44,2,2,2.389898095,2883,55,17,471,471,0,23874,23862,12,155,155,0,100
81c07f61b70c43fe9767b5522e2ef06160708a9f,1,1,1,0,0,0,0,9,38,2,1,1,0,775,56,16,150,150,0,6376,6375,1,37,37,0,100
1591e49e2f84019a48b9b6a25a992f072bc923fd,1,8,4,4,0,0,0,5,8,1362,1,1,0,186,57,17,44,43,1,1536,1506,30,13,13,0,100
fef9457fbdaa3f9df8bc9f1977eb757d8354a7dc,2,2,2,0,0,0,0,1,2,40,1,1,1,266,58,18,41,41,0,2266,2266,0,25,25,0,100
5dbcec155bf2e6bd5b84582996d82ccb01280926,1,1,1,0,0,0,0,4,6,459,1,1,0,150,59,18,10,10,0,1358,1354,4,10,10,0,100
794f930873650fd423e99c3038f0088ac9984274,1,8,1,7,0,0,0,8,32,8,1,1,0,488,60,17,55,53,2,4068,4045,23,27,27,0,100
ca1a89628b810452069552a1906589cfe6b30bb3,0,0,0,0,0,0,0,0,0,0,0,0,0,0,61,18,0,0,0,0,0,0,0,0,0,100
101f8b461fb0cbbb774f9189c56487bac74a1860,1,5,2,3,0,0,0,5,19,321,1,1,0,177,6,2,17,17,0,1855,1825,30,9,9,0,100
fd50217e6b0d8d108d8952a42d8ec9a7db362da2,17,243,119,124,0,0,0,9,63,104,6,9,3.603150198,7420,62,9,1147,1130,17,64246,63280,966,453,450,3,100
9da5c56439403601367672cb165112a873733e6f,3,40,20,20,0,0,0,2,5,525,1,1,0.888233532,227,63,10,44,38,6,1961,1836,125,14,13,1,100
1224da62b440166dc7c65b486af91920509ee713,0,0,0,0,0,0,0,0,0,0,0,0,0,0,64,9,0,0,0,0,0,0,0,0,0,100
c85a3c092909efff851fd7891022fba3d09d268f,0,0,0,0,0,0,0,0,0,0,0,0,0,0,65,10,0,0,0,0,0,0,0,0,0,100
d9b824dc2f57c855f48185a3ea117c7da1bbc3a3,3,24,5,19,0,0,0,5,16,195,2,2,1.527530208,472,66,11,105,101,4,3641,3493,148,62,61,1,100
176e839c2db9ee9423013566bf0d814a73634419,0,0,0,0,0,0,0,0,0,0,0,0,0,0,67,8,0,0,0,0,0,0,0,0,0,100
dbfc29cf78c887b8c4af39cbbafe19a3b07cd1fa,0,0,0,0,0,0,0,0,0,0,0,0,0,0,68,9,0,0,0,0,0,0,0,0,0,100
8a4128cdb4cef0fabe7bf3a6bd4646a2840d9a83,0,0,0,0,0,0,0,0,0,0,0,0,0,0,69,10,0,0,0,0,0,0,0,0,0,100
f7f0ec8aee0644bd0a3230ebda3f3a76acc4c7f6,0,0,0,0,0,0,0,0,0,0,0,0,0,0,70,11,0,0,0,0,0,0,0,0,0,100
43142b1ce7f2a3444168f827ccb72e8b5023815b,23,102,46,56,1,0,1,4,18,708,5,11,4.073599869,4601,71,9,426,425,1,42071,41698,373,288,287,1,99.58419958
916e30ff3bc5eb7175d02e27b14070ccab0f9abf,0,0,0,0,0,0,0,0,0,0,0,0,0,0,72,10,0,0,0,0,0,0,0,0,0,100
f0cdb34a3fb7274490df17341a3b3c5c386f5fbe,1,3,0,3,0,0,0,9,51,30,1,1,0,849,73,11,209,208,1,6609,6597,12,48,48,0,100
5ae9f314e344d1a31a76fd694f5336f93d63036a,1,2,2,0,0,0,0,8,54,30,1,1,0,926,74,12,134,134,0,6856,6849,7,26,26,0,100
52a79381ae03d1279d416dc956a0fe6301d8d707,2,2,1,1,0,0,0,8,52,15,1,1,0.918295834,1085,75,13,243,243,0,8720,8715,5,59,59,0,100
3ec8d9534c29a3671e579dcd312034313faf4362,3,7,10,3,0,0,0,4,13,1030,2,2,1.022420704,205,76,14,22,22,0,1557,1580,23,16,16,0,100
bd002845867f886c75b773daeea5952d06fdef76,3,131,22,109,0,0,0,9,53,28,2,2,1.110630584,2050,77,15,351,339,12,18165,17541,624,143,132,11,100
717b472eb15d45abfa94590940e5b131456fc6b1,1,26,3,23,0,0,0,12,64,39,1,1,0,1304,78,16,303,296,7,11252,11070,182,81,80,1,100
222cbbee81321059091f9e0a2415f5ff65467fdd,1,5,1,4,0,0,0,7,12,456,1,1,0,124,79,15,28,26,2,893,839,54,12,12,0,100
2624fe8ef15faa21e5a811e2fa0fb27c0cb96994,2,33,0,33,0,0,0,6,54,22,1,2,0.61361902,1141,80,16,239,235,4,9594,9266,328,66,65,1,100
4ad28f6307055ee4d8388a2f65715e660f88a4af,0,0,0,0,0,0,0,0,0,0,0,0,0,0,81,17,0,0,0,0,0,0,0,0,0,100
6bbfe2366b32d885a5b67fc4accb11ed76b889ca,7,56,17,39,0,0,0,5,18,840,2,4,2.507202821,578,0,0,84,78,6,4745,4568,177,44,40,4,100
5a474ffab766a964e44096633016f6463537fd0a,1,29,2,27,0,0,0,4,6,142,1,1,0,94,82,18,16,15,1,1024,766,258,5,4,1,94.48324022
20f2acec7c0c2819da9c8005a3b3d443cebc349f,1,7,5,2,0,0,0,6,19,174,1,1,0,330,83,19,46,44,2,3139,3120,19,21,21,0,100
7624b2c8b55e241eef60391534c39c719e0702dd,3,90,22,68,0,0,0,9,65,18,3,2,1.224488378,2244,12,0,532,517,15,19097,18581,516,134,130,4,100
1c97955da6da4966bf0a58d6270cb00982dc56e1,2,10,1,9,0,0,0,1,2,88,1,1,0.684038436,306,84,20,60,59,1,2415,2369,46,16,16,0,100
e5a1d597cd23e6bb044ec63df261d765419f20ac,7,70,69,1,0,0,0,6,13,432,2,4,2.508650136,1527,85,21,210,209,1,14231,14272,41,115,114,1,100
407bb8595ec44c9f9daf992006c5d1d7d4700289,1,1,5,4,0,0,0,7,12,0,1,1,0,75,86,22,14,13,1,777,784,7,12,12,0,100
5c142ef1612aa593a7905800a37e430830f7fd12,1,1,5,4,0,0,0,7,13,8,1,1,0,128,87,21,26,28,2,839,893,54,12,12,0,100
7421c775679a39e69b704d29f49a0e21c3ff54a3,0,0,0,0,0,0,0,0,0,0,0,0,0,0,88,21,0,0,0,0,0,0,0,0,0,100
cbd7c807e4fbc5ced48923529cbb29e3af7b4dfc,1,7,2,5,0,0,0,6,10,14,1,1,0,94,89,22,17,15,2,774,751,23,7,7,0,100
d8fbec9f97ba2bd2207827c7b83a8b861c25f9f0,29,1446,241,1205,6,0,6,10,56,142,5,13,4.003953654,7372,13,1,1157,1050,107,69078,62149,6929,525,468,57,99.47349947
bb659d40bfde4dce481fdd4f4ff5fd678e6bff88,1,3,2,1,0,0,0,2,2,633,1,1,0,95,1,1,13,13,0,791,794,3,7,7,0,100
3a8659611c82b928ebb2abc7b5ec4629d4156402,8,104,48,56,0,0,0,7,33,167,2,5,2.151542843,2424,90,22,431,428,3,22339,21800,539,185,182,3,100
947ed13b71aa80236396cbe86549feeb1c509a1c,8,405,7,398,1,0,1,1,26,587,3,5,0.870278352,1734,91,22,382,337,45,16559,14427,2132,142,124,18,99.8951049
52586b3e36b93dd71d9325f190dcb0917a42bda7,2,6,1,5,0,0,0,3,5,2648,1,2,0.591672779,94,14,2,23,22,1,1013,961,52,6,6,0,100
e0c08e767c6b55b6e4432518054a097d4aeda717,6,205,4,201,0,0,0,7,29,197,1,2,2.546931042,2338,15,3,349,325,24,22063,20826,1237,140,134,6,100
ccdcd2e6fe0c8a57b1296f212147f96c04cfd410,12,190,42,148,2,0,2,7,30,91,2,9,2.307418555,2794,16,4,382,379,3,27939,27161,778,165,162,3,99.82535802
5d8b36c16c72c0bb5581ad27b61da32ab652f3c4,12,715,0,715,9,0,9,1,34,0,4,6,3.093480474,1974,92,19,358,297,61,20833,17613,3220,178,144,34,99.16753382
b806b32fd6829b4f6f49e612a6668df55c49bd03,16,137,57,80,0,0,0,11,66,6,6,11,3.528608166,7720,2,2,1194,1181,13,67577,66943,634,506,502,4,100
52ce7f8332e4f3dc9b0b644cb8cef3453ae7e1da,3,15,44,29,0,0,0,9,67,3,3,2,1.506635969,2304,93,18,529,532,3,18929,19147,218,131,134,3,100
39316936707dbf76ce990de7798373d7698caa24,2,4,1,3,0,0,0,4,21,44,2,2,0.721928095,204,94,19,11,11,0,1980,1947,33,11,11,0,100
057440ad9ce8b0c3adb4e67a7c62b33df865a498,18,80,7,73,0,0,0,3,38,481,1,7,3.980677225,4384,3,3,394,380,14,41142,40802,340,298,286,12,100
7a1ef4d27ca49718bfb39c7b0d38fc1b719fbc8e,1,10,10,0,0,0,0,9,58,0,1,1,0,873,95,20,215,214,1,6817,6799,18,48,48,0,100
4da2dc90b8cee3b56f59873b9901d4934a5e4722,1,7,4,3,0,0,0,7,14,11,1,1,0,171,17,5,36,35,1,1450,1420,30,10,10,0,100
5e4b06b7c1aaa1f8aa4142bed0781596e8c21db0,0,0,0,0,0,0,0,0,0,0,0,0,0,0,4,4,0,0,0,0,0,0,0,0,0,100
55bcc14afe9448932160568dc90f72e7ee53b363,5,12,10,2,0,0,0,8,22,118,2,4,2.02380394,1414,5,5,167,165,2,14859,14837,22,78,78,0,100
75079c2e5166ef517e500109f0015fff6df47b90,6,52,0,52,0,0,0,7,25,51,1,3,2.399188254,2028,96,15,306,300,6,18389,18008,381,122,119,3,98.86831276
11f20f4734eccc01d63516b035073237bcb79837,4,53,23,30,0,0,0,1,2,124,1,2,1.823151705,798,97,16,145,141,4,6268,6083,185,73,71,2,100
48d0723ccae09fc26b0e6294214e032acd96a115,3,18,6,12,0,0,0,7,31,17,1,3,1.28067213,750,98,17,97,96,1,6716,6613,103,42,41,1,100
8600e94654ea21b5cff1ea363560ffc17078aa53,2,19,1,18,0,0,0,2,3,126,1,2,0.721928095,258,18,6,48,46,2,2160,2039,121,20,19,1,100
cf492300e77d627b3ecfa0f4b469e3f4ff78b146,1,3,1,2,0,0,0,13,68,15,1,1,0,1355,6,5,314,314,0,11555,11541,14,82,82,0,100
6c8b33fd582f05680d8ea56efa784d26fc936428,2,88,1,87,0,0,0,7,36,16,1,2,0.99990893,1087,99,14,233,225,8,10088,9539,549,101,99,2,100
88d1055196d98b9cd81379074f5c5d68f832bc82,5,414,0,414,0,0,0,9,36,142,1,3,1.607130127,1623,100,13,210,210,0,13343,13343,0,82,82,0,100
9a2acebf79015e264240e1371c862f3ca9d0fc98,5,80,69,11,0,0,0,3,39,19,3,3,0.894399846,2036,19,6,146,146,0,19372,19095,277,122,122,0,100
8b6f7c5267ef27dd2dc6358d54358a2b645e6b9e,1,6,9,3,0,0,0,2,2,133,1,1,0,268,20,7,25,25,0,2461,2484,23,13,12,1,100
27a69b1850c948a94ad361cbdee21865381852b2,2,34,14,20,0,0,0,1,7,753,2,2,0.69621226,300,101,13,56,52,4,2390,2254,136,25,24,1,100
c462f3e058e97bfa159932ec18286f4095834ba8,1,1,1,0,0,0,0,5,12,174,1,1,0,236,102,14,52,52,0,1998,1998,0,26,26,0,100
f7ad3f487966e2c1a13a8f61c203fc11cc7c73c8,21,1785,18,1767,13,0,13,7,27,179,3,14,3.645866073,3230,103,13,575,418,157,40403,29609,10794,258,177,81,98.39411174
87920467185d895c71c29b4b13445e5593fc2f42,15,524,36,488,2,0,2,8,59,137,4,11,2.990775103,5379,104,13,1051,992,59,46781,43754,3027,334,308,26,99.5720869
8cc6810756794f0d738232b9bfc33b4fa6e5cc66,1,3,1,2,0,0,0,10,35,14,1,1,0,844,105,13,76,76,0,7888,7873,15,55,55,0,100
d6965213aa9fe28420d9e40dfcbd8dff07e27009,7,987,891,96,4,0,4,9,58,8,2,2,2.155057307,1887,106,14,212,208,4,16712,16238,474,78,74,4,99.41041598
8e0d5c584ee738ef19496c1f30a629861b69b634,10,660,7,653,2,0,2,1,26,327,1,4,2.301214883,2468,107,15,543,497,46,25499,20548,4951,260,236,24,96.85371392
4783a19c4cfbb673a647b4382961fb0df9b034a6,2,9,2,7,0,0,0,1,2,6,1,1,0.684038436,163,108,16,16,14,2,1801,1746,55,7,7,0,100
9872ce8e793f0d16ade52cb06e95bef50339e25a,2,51,15,36,0,0,0,1,4,6,1,2,0.32984607,405,109,16,72,67,5,3748,3405,343,28,28,0,100
f008f867f6c511cbe5676b5b5d205015cdd4f080,10,98,23,75,0,0,0,4,13,344,1,3,3.12219811,1928,110,17,146,146,0,19155,18165,990,93,93,0,88.63468635
b921247c3b115c430132f416d3fac5ef7f24c8b4,1,10,6,4,0,0,0,5,9,61,1,1,0,60,21,3,6,5,1,645,604,41,2,2,0,100
be95c5fc66c9537333d50b96b41680235f5fbc6c,1,13,0,13,0,0,0,7,10,256,1,1,0,97,22,3,15,13,2,1030,931,99,5,5,0,100
8062ce4b66727046e46138fe7de10dba8e24e6ac,1,1,1,0,0,0,0,6,8,100,1,1,0,120,23,4,11,11,0,1128,1128,0,5,5,0,100
1cd7f0b4571b520444eb69178a73d74629fedd39,0,0,0,0,0,0,0,0,0,0,0,0,0,0,24,5,0,0,0,0,0,0,0,0,0,100
4bc38989d34321f7498a2244f05b1d7c51399ad7,6,84,2,82,0,0,0,11,59,19,1,2,1.273102032,2000,7,0,324,316,8,16839,16444,395,112,108,4,100
d69591ad171a87222a1cc32513d6c909e3fc8d24,4,15,15,0,0,0,0,9,60,276,2,3,1.825605199,1232,8,1,271,271,0,10025,10004,21,69,69,0,100
d08f8bd74c196e535584a7c395dfaa49952b44da,0,0,0,0,0,0,0,0,0,0,0,0,0,0,9,2,0,0,0,0,0,0,0,0,0,100
f4bd1e7e53ca4f113b78d3a5cf4e55aba99fbe93,19,784,149,635,0,0,0,5,69,643,5,12,3.252859533,3764,10,3,786,674,112,33326,29815,3511,364,318,46,99.74226804
a267b46a7f80d4b0f5347f460214b81cc4d54019,1,4,4,0,0,0,0,7,10,0,1,1,0,228,25,5,26,26,0,1776,1828,52,9,9,0,100
9a43bb643dbbe4d640952621dfdae81fcf18008f,2,3,3,0,0,0,0,6,10,427,1,2,0.918295834,216,26,5,45,45,0,1585,1589,4,13,13,0,100
e3893a859b9edfcc7ad3f156d77ad70bbe0a359d,4,301,3,298,2,0,2,1,13,146,2,3,1.360315899,282,27,6,95,49,46,3189,2185,1004,56,19,37,99.82847341
ce59dc2ea32c8e6553b312f6a83df51618341e1f,0,0,0,0,0,0,0,0,0,0,0,0,0,0,111,8,0,0,0,0,0,0,0,0,0,100
2f867bc2fdfa9f29f7959cafe3e9050adf9c0975,9,214,12,202,2,0,2,2,59,53,4,5,2.917251905,2216,11,4,397,384,13,19567,18547,1020,158,150,8,99.70072681
2132a983a73abcafa6a3d03329615ade815adb9c,0,0,0,0,0,0,0,0,0,0,0,0,0,0,12,5,0,0,0,0,0,0,0,0,0,100
08fbf4f3847b00fc8437475fbc58da26e67715c9,0,0,0,0,0,0,0,0,0,0,0,0,0,0,112,9,0,0,0,0,0,0,0,0,0,100
d8182008269050e926b99c7111817d1e327c0dfd,14,545,6,539,6,0,6,9,23,59,4,8,3.477801421,2477,28,7,384,319,65,24903,22293,2610,209,179,30,99.4057725
86180d93210d1b5df4dcaa29c1d29248374bb177,0,0,0,0,0,0,0,0,0,0,0,0,0,0,29,8,0,0,0,0,0,0,0,0,0,100
666a2a26b6e9d1f4176057e7c54d1120dc8d8fd0,1,1,1,0,0,0,0,1,5,35,1,1,0,367,113,9,65,65,0,3095,3074,21,21,21,0,100
4a64dec0ee4d5cf685bde953197e84526cf32d7e,4,96,1,95,0,0,0,6,28,30,1,4,1.839453874,1336,114,9,207,193,14,12382,11808,574,79,73,6,100
e6d63f9b894a08dea46abc52c90c32d022a46708,6,126,5,121,0,0,0,2,7,35,3,4,2.477125462,685,13,6,129,114,15,6351,5675,676,75,66,9,90.61784897
68c5820036fd299889dca24bd604f96fa89aa4a5,0,0,0,0,0,0,0,0,0,0,0,0,0,0,14,7,0,0,0,0,0,0,0,0,0,100
5a55baed34084d515ff911f6a25e251fad69534a,0,0,0,0,0,0,0,0,0,0,0,0,0,0,15,8,0,0,0,0,0,0,0,0,0,100
9e6d5a6c58d99479cc58c11b5b05b11bf8d90821,32,1362,285,1077,4,0,4,1,27,193,1,10,4.270235816,8991,7,0,1345,1254,91,84533,76790,7743,831,789,42,96.62847791
4175c54a158eeb9883dc192260890eb2b73ad6f1,85,7798,1362,6436,52,0,52,1,37,35,3,25,5.781173397,10565,16,9,2230,1543,687,119243,91343,27900,1273,902,371,87.88676761
a0911bd8298049f372a845c07049e9f1c4b165e2,32,1362,285,1077,4,0,4,1,27,193,1,10,4.270235816,8991,17,10,1345,1254,91,84533,76790,7743,831,789,42,89.8589859
a3e2320f8e9bf4e9ef14e33b474e67c3ff240124,1,13,2,11,0,0,0,4,8,233,1,1,0,157,18,11,30,27,3,1282,1232,50,20,19,1,100
fcc0bc20fd2c4e30cc6b6c4f6619859a4f8871dc,0,0,0,0,0,0,0,0,0,0,0,0,0,0,30,5,0,0,0,0,0,0,0,0,0,100
542058e757f815411b7a52f77dba6af5d38f819c,0,0,0,0,0,0,0,0,0,0,0,0,0,0,31,6,0,0,0,0,0,0,0,0,0,100
f860b239e160d131e5ea30850205b1155012a3a7,0,0,0,0,0,0,0,0,0,0,0,0,0,0,32,4,0,0,0,0,0,0,0,0,0,100
ccd988c15da82ecaa9210c7e0f9a8f0d365509d9,0,0,0,0,0,0,0,0,0,0,0,0,0,0,33,5,0,0,0,0,0,0,0,0,0,100
969dffee144f79837a089018f87e8da8d0017b9e,0,0,0,0,0,0,0,0,0,0,0,0,0,0,34,6,0,0,0,0,0,0,0,0,0,100
bc9c2cd3144406a0bd3c7b125c3b80d18842a9ac,1,3,3,0,0,0,0,1,2,8,1,1,0,24,19,8,2,2,0,255,255,0,2,2,0,100
c30fce7512679b433cedb718c4bf294bcc2fdae2,2,0,14,14,0,0,0,8,19,61,2,2,0.371232327,673,20,9,131,135,4,4864,4931,67,77,77,0,100
7854e3d90e7a5258b85f45afd00694e3f5157142,11,346,108,238,0,0,0,2,61,202,5,7,2.380823882,2819,21,8,546,520,26,24168,22822,1346,210,193,17,99.81651376
8befa89f8572c10367b3e7a16d0a02a94e46d880,1,2,1,1,0,0,0,1,6,40,1,1,0,367,115,2,66,65,1,3109,3095,14,21,21,0,100
35006fe32daf28d0583e51595a41e9d5e372469f,0,0,0,0,0,0,0,0,0,0,0,0,0,0,35,5,0,0,0,0,0,0,0,0,0,100
89040a296de3d4a9bd0aa2232342438add37afee,40,2169,27,2142,9,0,9,1,38,420,5,18,4.119596997,7564,36,6,1525,1304,221,76851,64012,12839,701,590,111,96.12260938
44d5028f6a9e0994e6658611fcf9d9b17e5d39a6,3,31,6,25,0,0,0,7,30,0,1,3,1.553425561,2516,0,0,296,296,0,23575,23352,223,157,156,1,100
5ecae18ec10f7e1d5eca70e207fd4da768e5b127,2,9,2,7,0,0,0,1,2,26,1,2,0.684038436,82,22,7,18,17,1,629,587,42,8,8,0,100
49fbc8c961f4f467f7f7ae12efd1c80963c7f8a9,10,592,75,517,2,0,2,1,60,20,4,6,2.915207872,2629,23,8,483,449,34,24847,21701,3146,225,195,30,99.66172261
ffd2b78625a83b3ad0d190c3f81bb98cdd9eab71,6,59,3,56,0,0,0,8,70,46,2,4,1.793172641,2037,24,9,429,423,6,17057,16779,278,133,131,2,100
15771e863d69d1ee3128194d8e0d52ab98f842ad,0,0,0,0,0,0,0,0,0,0,0,0,0,0,116,1,0,0,0,0,0,0,0,0,0,100
9ae20e025c74f44236b66c7c48df87a6c0939d3d,2,5,7,2,0,0,0,7,14,57,2,2,0.979868757,512,25,7,80,80,0,4552,4532,20,44,44,0,100
c75f0f4465d4c3a105fe5e896edf9c7e86f4877e,0,0,0,0,0,0,0,0,0,0,0,0,0,0,26,8,0,0,0,0,0,0,0,0,0,100
932965b9e22beca008365851d76f4936e10ee24b,2,43,5,38,0,0,0,1,31,19,2,2,0.543564443,1066,117,2,242,227,15,9464,9176,288,75,73,2,100
d78dffd4ffc433f5ca58cf442771b393e76fe099,1,1,0,1,0,0,0,2,3,3,1,1,0,413,118,3,63,63,0,3719,3704,15,33,33,0,100
2876b0b9f749a658c9452fd07294fece4b3daa3b,0,0,0,0,0,0,0,0,0,0,0,0,0,0,1,1,0,0,0,0,0,0,0,0,0,100
36a7d6b8b668b71a65413a43019cc75e5aa5daa8,0,0,0,0,0,0,0,0,0,0,0,0,0,0,37,2,0,0,0,0,0,0,0,0,0,100
aa18bfdaefd7f771f45ca9314beb0ff8ac4d53f2,10,64,51,13,1,0,1,1,2,45,1,4,3.095180283,1131,27,5,232,235,3,8128,8176,48,104,107,3,87.27925771
d97052f3423fae8213e4e3bf677ee21b632b82b0,3,48,5,43,0,0,0,3,22,71,2,3,1.093194765,1007,38,2,119,119,0,10314,10043,271,60,58,2,100
ca7a912328d1935655ada94aed68b6ea55418513,0,0,0,0,0,0,0,0,0,0,0,0,0,0,2,1,0,0,0,0,0,0,0,0,0,100
7285a44875b6dae67610ff7a65fb6290c5aefbf5,3,41,20,21,0,0,0,6,32,256,1,3,1.167644462,1621,3,2,228,227,1,15086,14901,185,108,108,0,100
af2ea867d0d2a34fcd11a18fbd8c7b8c062bbe61,1,1,1,0,0,0,0,6,14,2,1,1,0,879,119,2,53,53,0,8568,8568,0,47,47,0,100
2d5516ec374333a7b39de7302c5cd511ba6ba9c8,3,269,12,257,1,0,1,1,4,93,1,2,0.571286008,460,120,3,102,79,23,5466,3590,1876,39,27,12,99.75238769
db0604da89edc4841b44ba9b5197cbc35aaff6e7,3,283,125,158,1,0,1,1,11,70,2,2,1.058318077,492,28,1,76,65,11,5928,4509,1419,49,40,9,99.60714286
4576c582f21ee7872df81193f3dc1d7fcee164aa,4,59,1,58,0,0,0,8,71,107,1,4,1.77596622,2867,121,2,467,460,7,28708,28323,385,154,151,3,100
ea8c26efa1b3b7053fe960a35eec391c8af855b7,1,5,4,1,0,0,0,2,2,91,1,1,0,177,4,3,44,45,1,1362,1375,13,20,20,0,100
7953e8aecf02b873aa3227f00bf61800cfeb7170,1,1,1,0,0,0,0,2,2,91,1,1,0,236,5,4,42,42,0,1681,1681,0,20,20,0,100
0fe2762b799c7142858bb3061541504e4e9ed654,0,0,0,0,0,0,0,0,0,0,0,0,0,0,122,3,0,0,0,0,0,0,0,0,0,100
fac91b24aa6bfba561e83e2e7bb55772b137e39e,10,67,67,0,0,0,0,1,71,59,4,8,2.800503556,4129,29,2,718,710,8,37865,37938,73,293,292,1,100
f3b781dec693f6740311c65567795a715a6bd1ad,6,65,6,59,0,0,0,2,73,92,2,6,2.228834619,3313,30,3,563,557,6,31954,31582,372,196,193,3,100
c4958773db9f7abc771c99b6b704951083020cc8,23,394,309,85,3,0,3,2,3,62,1,9,3.672872424,3024,123,4,508,502,6,25324,24840,484,250,246,4,87.68503937
f018fafb41d7d435c78ddbea71c8aea86c36a2e0,1,3,3,0,0,0,0,1,1,0,1,1,0,99,124,5,17,17,0,774,774,0,7,7,0,99.8882057
ef4e8a4b11f0920431aa0fd5c0ca1ed8d3301571,12,323,53,270,0,0,0,1,74,57,5,7,2.916829913,3960,31,3,716,696,20,36062,34459,1603,305,292,13,99.97205143
6676032c3e2746f965a25d02a17bd107b3074df4,2,45,7,38,0,0,0,11,62,82,1,2,0.995727452,1017,125,6,166,160,6,8666,8444,222,81,79,2,100
f982f86c73d48b34387ca3a985741a62dc323ca5,0,0,0,0,0,0,0,0,0,0,0,0,0,0,126,7,0,0,0,0,0,0,0,0,0,100
6d3138559e8395ac1140f10197fcd10badf64883,27,2604,61,2543,10,0,10,1,4,13,1,13,3.801053336,2056,32,4,622,328,294,32384,17358,15026,301,159,142,95.60100869
2bf90130df482e5501ba40b36a58dade8df08e64,0,0,0,0,0,0,0,0,0,0,0,0,0,0,33,5,0,0,0,0,0,0,0,0,0,100
baab41425fbdf2e7e6dc4d55195e826d540b444c,8,127,4,123,1,0,1,2,5,163,2,4,2.280761298,822,127,8,150,131,19,7001,6248,753,58,52,6,99.71925884
855852ecfc86b63d317c2615a27845eaac1c0ec1,0,0,0,0,0,0,0,0,0,0,0,0,0,0,128,9,0,0,0,0,0,0,0,0,0,100
50b02096550566d0b8b7bb2cc090da4b01bfd6eb,4,20,1,19,0,0,0,2,5,2,1,3,1.884172925,875,129,10,170,168,2,6723,6683,40,84,82,2,100
17a4fcbd6a300cc39ffc6ed2ef2d3efc95e4d01f,8,435,0,435,8,0,8,1,1,0,1,3,2.780494659,0,130,11,36,0,36,1404,0,1404,19,0,19,97.19054242
8b352fcfa230cdd9c26f5b1db29b4d7c43dda94f,11,259,37,222,1,0,1,1,75,67,4,5,2.386382078,4776,34,6,974,948,26,41901,40732,1169,289,277,12,99.47672817
1ebf025ba1f2512e1fab75edc2908123dd548657,2,58,2,56,0,0,0,7,63,116,1,2,0.987137774,1186,0,0,258,246,12,10223,9842,381,73,69,4,100
4c10e3cabf5bd571756d38c3fcc6b278e9a453db,0,0,0,0,0,0,0,0,0,0,0,0,0,0,1,1,0,0,0,0,0,0,0,0,0,100
e77e4d7abcd86ca2172175d7276df7b1ce6e75c1,1,22,9,13,0,0,0,2,8,1148,1,1,0,159,2,2,33,30,3,1255,1193,62,17,16,1,100
3487f7184a17ebb1bbfad8b7f92e29bb7c064cf5,1,7,6,1,0,0,0,10,36,205,1,1,0,845,35,4,76,76,0,7895,7888,7,55,55,0,100
97e35874fa62103ba40a8bbb908c79c4f3b79a2d,2,14,7,7,0,0,0,2,5,36,1,2,0.702466551,370,36,5,86,86,0,2761,2717,44,40,40,0,100
bbfbe087cd2812820fc434fb3bdfa33484e779fb,2,26,2,24,0,0,0,1,8,154,1,2,0.966618633,472,131,5,88,86,2,4228,4032,196,31,29,2,100
0df8e7f0a59664d246bc7834fdc60100e524d5f5,1,84,0,84,1,0,1,1,1,0,1,1,0,0,132,6,8,0,8,415,0,415,6,0,6,99.94502474
6e50f31ad0c66357181f838059553527c8c7e1ab,2,64,36,28,0,0,0,7,32,234,1,2,0.584238812,607,133,7,79,76,3,5706,5396,310,34,32,2,100
e4c635c2c6ea454d014eb72a1b199ef6b92036fd,5,50,34,16,0,0,0,1,33,129,2,5,1.281372527,2228,134,4,360,360,0,20205,20187,18,134,134,0,100
f9c8feac1ee94fd330513ea40b945fbb16cbc8b6,0,0,0,0,0,0,0,0,0,0,0,0,0,0,135,4,0,0,0,0,0,0,0,0,0,100
3059980c65400bc2dc0100cdf3b1a781927a3203,7,92,37,55,0,0,0,2,4,63,1,3,2.068364948,940,136,5,146,141,5,8074,7869,205,87,81,6,100
4445798bebd0420d86b5f091354b1155a3a09f77,1,1,1,0,0,0,0,2,2,54,1,1,0,375,137,6,61,61,0,2726,2726,0,20,20,0,100
2804c5d1a8be9d19c0198c66b45373bbfb9dc0e0,6,590,508,82,0,0,0,6,37,110,2,4,0.940104414,1955,37,3,285,255,30,19227,18118,1109,163,150,13,100
7f4ff1a37293305367b6ee3a33140eadfe1ac1b5,7,127,33,94,0,0,0,1,76,88,3,4,2.267414401,2219,38,3,489,476,13,18747,18117,630,162,159,3,100
8be383ebe43b37deb2f24fcbdb2e6e230c8deed9,0,0,0,0,0,0,0,0,0,0,0,0,0,0,39,4,0,0,0,0,0,0,0,0,0,100
15e43a883f9e67a7eded65b51040905694591c58,2,28,0,28,0,0,0,1,34,17,2,2,0.905928216,1117,138,7,249,244,5,9775,9582,193,78,76,2,100
47f8a605df3c2fe98d4690838491479b17f1fb40,1,13,5,8,0,0,0,10,42,42,1,1,0,789,139,8,157,155,2,6649,6599,50,41,41,0,100
4591ffb61f0820c674b0f84f5b18721f7cbc39e3,14,434,17,417,4,0,4,2,64,14,5,8,2.481329936,3349,140,9,608,588,20,31974,29655,2319,294,276,18,98.86209699
4b523130fbbcaff9e2ff6e577ceb52e3572aaa3c,4,61,8,53,0,0,0,7,35,48,3,4,1.778916675,1555,141,10,250,243,7,15451,14991,460,94,92,2,100
94a70585d73a09c8efcf2f134cf32b1d11cd2a6b,9,251,308,57,1,0,1,2,39,46,1,1,2.754820863,1974,142,11,212,223,11,18020,19017,997,149,155,6,93.48648649
62fb403beeb75da5f376c5c907fec5f2167842c0,1,1,1,0,0,0,0,11,63,69,1,1,0,970,143,12,155,155,0,8041,8035,6,76,76,0,100
10fcb91537c1e4589578bf14ccc6eb47c9dda173,22,377,28,349,1,0,1,2,15,44,2,11,4.095897895,3732,144,13,761,704,57,29673,27565,2108,345,328,17,99.94538504
4ba652f54bdda922f019b8ee3541a2edf4def6b7,9,162,26,136,0,0,0,2,9,6,1,6,2.334424369,2366,40,5,430,416,14,20656,19673,983,169,165,4,100
88bbe14cae68c725ffe74cbb6d3550f82bd4c891,18,721,40,681,3,0,3,6,39,104,3,9,2.8803741,5515,3,0,963,895,68,52824,48846,3978,446,412,34,99.09811424
568156e51322afd3389cd53b60bff8649663f43e,0,0,0,0,0,0,0,0,0,0,0,0,0,0,272,0,0,0,0,0,0,0,0,0,0,100
24fd717a9b01061ff6b53a51ad873747b0df577c,1,7,3,4,0,0,0,4,7,65,1,1,0,70,145,13,19,20,1,527,520,7,6,6,0,100
e64d63700794da2223351c8bd9e2a8a1ed296d81,1,1,1,0,0,0,0,7,13,311,1,1,0,71,146,14,14,14,0,776,777,1,12,12,0,100
5e270741ba7bce0c898972ad96b9bd61742af8bc,1,15,4,11,0,0,0,2,5,25,1,1,0,138,147,15,34,32,2,1120,1046,74,17,17,0,100
f4bb375e5aecff82ce2c2177bb4f08d0352d4289,4,494,11,483,1,0,1,1,14,174,1,3,0.647446749,333,0,0,92,68,24,6244,2865,3379,48,32,16,99.89053093
d1cc9d229d76e9701937db74d7b08d7db5cc21ff,0,0,0,0,0,0,0,0,0,0,0,0,0,0,1,1,0,0,0,0,0,0,0,0,0,100
7a74bb0c6ee25d1d0bc5944b3af0438527343956,5,86,3,83,0,0,0,2,19,58,2,3,2.013796654,1097,148,13,153,144,9,9080,8559,521,93,86,7,98.80031991
8671eae06c215e82597c90dd9388916d48ae3837,1,2,0,2,0,0,0,2,10,30,1,1,0,396,149,11,74,74,0,3314,3308,6,33,33,0,100
41631f955d17ac49e40f6360bba0c13cf51c7a4c,13,84,60,24,0,0,0,2,65,220,4,8,3.245242773,4732,41,4,709,702,7,41388,41202,186,309,307,2,93.24812448
8bbd6cfe7da96bfec54129d69086e72f16a6c04f,0,0,0,0,0,0,0,0,0,0,0,0,0,0,42,3,0,0,0,0,0,0,0,0,0,100
ec0a4a82e150b51e0a2a68c9d23bd2830405b605,1,7,2,5,0,0,0,3,3,211,1,1,0,558,150,8,24,23,1,4971,4927,44,19,19,0,100
205465a8c7cc3ef928119e95c4fd0c45ae589863,7,118,17,101,0,0,0,7,65,154,2,6,2.355778768,2736,151,9,456,438,18,23606,22963,643,175,169,6,100
ad9f2dea2a47cb72b5eb9f1f3ecc0f1bd0d5fe1d,0,0,0,0,0,0,0,0,0,0,0,0,0,0,152,10,0,0,0,0,0,0,0,0,0,100
5e34524fd4712dc8979244b2283de7093cf1f5a7,2,24,3,21,0,0,0,4,23,134,2,2,0.380946586,595,153,11,135,129,6,4326,4206,120,74,73,1,100
1d4068986ef369580ff04e1fd1ffed6ffc5506a0,0,0,0,0,0,0,0,0,0,0,0,0,0,0,43,3,0,0,0,0,0,0,0,0,0,100
c81db674df9506a6a49335d97d6c854d6dc52020,0,0,0,0,0,0,0,0,0,0,0,0,0,0,44,4,0,0,0,0,0,0,0,0,0,100
20bacfa134c7eb89b030dff22a5ba8aff0b4636b,1,10,0,10,0,0,0,2,7,50,1,1,0,325,45,4,64,62,2,2618,2544,74,26,25,1,100
6d0119b7b4ef23a36ca5888762900d64ef600ce8,0,0,0,0,0,0,0,0,0,0,0,0,0,0,154,9,0,0,0,0,0,0,0,0,0,100
1e3dcb73fd30b93332ae81a075a7cecbc3dd3508,6,122,102,20,0,0,0,3,28,404,1,4,1.355225466,2172,155,10,218,218,0,22243,22165,78,100,100,0,93.17817014
679167a24508994c5b4128162f856c2385de0df2,2,44,10,34,0,0,0,2,77,42,2,1,0.445064857,1804,156,11,410,402,8,15369,15213,156,118,117,1,100
054295a7de9af8b0b0f24f212a93c7bd2f27eae6,1,8,5,3,0,0,0,1,2,80,1,1,0,49,157,12,9,8,1,443,415,28,6,6,0,100
5e80dcd0ddaace24582c4e07b99e6032f053c250,2,6,0,6,0,0,0,7,23,367,2,2,0.650022422,469,158,13,59,58,1,4239,4210,29,30,29,1,100
7cde36c4104bcb43b913cbd1c22288daa773f488,5,30,14,16,0,0,0,6,20,546,1,1,2.168611795,460,46,5,67,64,3,4074,3900,174,27,27,0,100
ccb6df38bf086135d28bce9c0c92d6fd23e19459,3,30,8,22,0,0,0,2,6,45,2,2,1.167436723,664,47,6,91,89,2,5981,5823,158,43,43,0,100
eeb7ff081e905040cf98796f86361e63dd89fae1,10,130,34,96,0,0,0,4,25,342,1,4,2.723542659,4269,159,11,669,658,11,36297,35790,507,433,425,8,100
1fb9a4f20779a3c49d3e8dd8d1c03b53be48e9db,11,180,238,58,0,0,0,8,66,136,2,5,2.929044243,4264,160,12,754,761,7,33521,34402,881,272,278,6,100
85fcbc3181bfe66bfcbd617677cc22bdd0645864,2,18,1,17,0,0,0,2,12,3,2,2,0.831474388,516,48,7,88,87,1,4410,4309,101,40,39,1,100
2355a52c466ea54e185d45304c4479501ed414ec,1,5,1,4,0,0,0,11,66,25,1,1,0,1011,161,12,165,164,1,8416,8382,34,79,79,0,100
aea1ac33e3d91c23b8efa049426ac2743229eb78,0,0,0,0,0,0,0,0,0,0,0,0,0,0,162,13,0,0,0,0,0,0,0,0,0,100
13ad121bd5cfd62d3fe54010024d6df2e299e449,0,0,0,0,0,0,0,0,0,0,0,0,0,0,273,0,0,0,0,0,0,0,0,0,0,100
a087dca5dd4ae6b33120e592176366a9e14f6db7,0,0,0,0,0,0,0,0,0,0,0,0,0,0,163,14,0,0,0,0,0,0,0,0,0,100
f99534264ef2ba7162b9ba038186ae41e7a85462,5,113,16,97,0,0,0,1,37,659,2,5,1.287838943,2212,164,15,342,332,10,20672,19876,796,152,144,8,100
f8e98f4f690d3302797edf5fbf7f3ad166236bcb,4,132,38,94,0,0,0,2,16,133,1,3,1.552263663,923,165,16,126,118,8,8300,8034,266,78,73,5,100
65bd4d1d7b83b6a44f3ec810a8a697ec461966a8,12,162,41,121,1,0,1,2,14,107,3,9,2.301824067,1877,166,17,265,251,14,16309,15751,558,136,130,6,98.88503469
4656f692a3c96244f0291501c3b68e14af964f27,7,483,77,406,1,0,1,1,7,126,1,7,2.212805621,982,167,18,209,157,52,11699,9082,2617,97,76,21,96.91045136
e9e0c7b7c0aed12e36c61f2cf8b4e67458fdfd06,9,61,41,20,0,0,0,4,20,352,1,8,2.347208677,1830,2,0,259,256,3,17025,16924,101,105,105,0,96.37254902
26531b52ea77a01f91753e65037f9bb9dfdcff9e,1,4,8,4,0,0,0,6,11,15,1,1,0,54,168,19,9,10,1,412,423,11,7,7,0,100
93e17839234399f0a5ab66480393cbe5e9339074,1,2,1,1,0,0,0,2,13,12,1,1,0,436,169,20,83,83,0,3521,3515,6,35,35,0,100
35b395796164c938aec28c4b8565550007a77466,15,152,75,77,0,0,0,7,78,71,7,8,3.032514329,5992,170,20,1032,1015,17,52551,51761,790,385,381,4,100
4a7d20eeb91abd57fa2a991fc7356558d0865968,0,0,0,0,0,0,0,0,0,0,0,0,0,0,171,21,0,0,0,0,0,0,0,0,0,100
e945d2b40dfab09ecf14eae2d506e704b103936a,7,230,2,228,0,0,0,3,68,262,2,5,2.075718748,2098,172,21,361,331,30,19706,18108,1598,162,152,10,99.63484611
0657257d86adab8f8544b9088fc375d2f8c082ba,0,0,0,0,0,0,0,0,0,0,0,0,0,0,173,22,0,0,0,0,0,0,0,0,0,100
8dfc2c9368c2be34a788b58cbe034b57090e0792,5,24,2,22,0,0,0,5,40,248,3,5,1.878968701,1682,49,4,322,319,3,14485,14312,173,144,143,1,100
583651c00d1425b1156b2da92fe8f95148821a84,2,32,10,22,0,0,0,8,25,78,1,2,0.892623013,774,50,5,80,79,1,8306,8048,258,37,36,1,100
b5676c5d60a16a5d82aa55e7459500aefba3d2fc,1,6,0,6,0,0,0,2,2,243,1,1,0,64,51,6,5,5,0,586,535,51,5,5,0,100
a923059d696f98b486682a8710b8c4f64fea4fb0,1,0,1,1,0,0,0,2,3,0,1,1,0,69,52,7,5,5,0,575,586,11,5,5,0,100
32d23639f8fdf97451d2b30f9cccf2c5aead7afa,1,11,8,3,0,0,0,2,7,35,1,1,0,394,53,8,68,67,1,3243,3203,40,23,22,1,94.15288078
9864f00131eb6cb0329b502be6b4e5154fbe0f05,6,37,10,27,0,0,0,2,79,46,2,4,2.176205802,2973,54,9,581,579,2,24533,24323,210,210,210,0,100
5869c062769ad681559ebb0e6b256a4799622979,0,0,0,0,0,0,0,0,0,0,0,0,0,0,174,16,0,0,0,0,0,0,0,0,0,100
0084c355cbfe234dc00253af2913e134a6b7814e,18,68,53,15,0,0,0,6,80,427,9,16,3.417487142,6121,175,17,1306,1300,6,49386,49316,70,395,394,1,100
ccd536a8da34e9f2547c1faaf3f32987bb976098,2,42,15,27,0,0,0,2,81,1,2,1,0.297472249,1906,55,9,429,426,3,16084,15960,124,123,122,1,100
5fb3a7ab830255d9321ff4a5a8adb481c6c0d683,2,27,15,12,0,0,0,1,6,129,1,2,0.371232327,541,56,10,116,113,3,3920,3888,32,43,42,1,100
8a739e1f631a9a5c7805c5c9f0e1b0521b6c3a06,10,161,3,158,0,0,0,2,17,183,4,7,3.015232459,2425,57,11,429,411,18,20595,19316,1279,212,207,5,91.73071826
ae59db3c834dde64a3cb372904158a8ba7566a3a,15,373,847,474,0,0,0,2,80,36,5,10,1.489150563,5715,176,18,1010,1077,67,43834,46391,2557,422,432,10,91.73071826
ecefdd079731f11f90e5916ef20afd0815e2d748,13,230,33,197,0,0,0,2,81,159,5,9,3.278617041,4430,58,12,890,866,24,37044,35609,1435,343,336,7,91.73071826
65ee6106b2c8988da5f7d987bd6839892f31fe44,9,175,114,61,0,0,0,8,70,70,3,4,2.546539959,3044,177,16,466,447,19,26454,26171,283,200,204,4,100
32f1da60c410e1605b791dc34e10b2a0ef0df11a,4,31,4,27,0,0,0,6,21,48,1,1,1.988442576,422,59,10,61,57,4,3825,3651,174,20,20,0,99.88566202
a86ddb0bd1c0f0e21ace590cc65f27f673cb7875,1,1,1,0,0,0,0,2,3,33,1,1,0,122,60,11,16,16,0,988,988,0,9,9,0,100
46ecceba8df7fc480177c426c39ff0bb110aa010,2,12,3,9,0,0,0,2,7,64,1,2,0.970950594,307,61,12,65,63,2,2364,2310,54,36,36,0,94.4801027
bd147972b9336c108d0660d9ba4dd91460963102,6,75,36,39,0,0,0,2,8,77,1,3,2.316887046,909,62,13,203,195,8,6577,6423,154,74,72,2,100
093ad2797bcd3fb1caec53ab4696f30ca0db1657,0,0,0,0,0,0,0,0,0,0,0,0,0,0,6,0,0,0,0,0,0,0,0,0,0,100
5ff837819f5a6f31070d5f8bfbecacdd1eeb0ab9,2,4,3,1,0,0,0,3,6,35,1,2,0.985228136,538,3,0,87,87,0,3561,3569,8,46,46,0,100
011059b8620c6ea83f6ed4621d4591e58ac2b4b2,1,5,0,5,0,0,0,11,47,20,1,1,0,791,0,0,158,157,1,6566,6538,28,41,41,0,100
36d45e99a8ca6d8cd2c956676e2304c41de84e6a,0,0,0,0,0,0,0,0,0,0,0,0,0,0,178,4,0,0,0,0,0,0,0,0,0,100
ba8dab98a96a1cfa3014530ca23c0450727848cf,0,0,0,0,0,0,0,0,0,0,0,0,0,0,179,5,0,0,0,0,0,0,0,0,0,100
a30a1acd648f8bb4e2ac5849ef663af7f4569e38,0,0,0,0,0,0,0,0,0,0,0,0,0,0,180,6,0,0,0,0,0,0,0,0,0,100
3b8d32ffdc3451f5ec11c90cfdb7e4ea2c2940b2,1,1,1,0,0,0,0,3,4,28,1,1,0,68,181,7,5,5,0,575,575,0,5,5,0,100
33d72f77ac11dfd344d2905afc4d42e056f450b5,2,150,16,134,1,0,1,1,2,274,1,2,0.796639467,268,8,0,49,42,7,3029,2026,1003,38,34,4,95.79170451
8c52a9add412cf91143d5fd4c4285f66d88a04d6,7,301,10,291,1,0,1,1,39,345,2,4,1.931897012,2893,4,0,507,476,31,27008,24952,2056,228,211,17,99.8427673
c3912dead04bbbe8e5cd46250e43fa134330bdc7,0,0,0,0,0,0,0,0,0,0,0,0,0,0,63,12,0,0,0,0,0,0,0,0,0,100
ae08745f10cfbfa5df5a7f797ac04bded6daf3fa,5,73,55,18,0,0,0,5,13,196,3,5,0.813815269,919,64,13,154,150,4,7015,6862,153,59,59,0,99.96853367
a194329533411849da8ed9addfee77a0249bab31,1,2,2,0,0,0,0,10,31,26,1,1,0,289,0,0,46,46,0,2541,2547,6,13,13,0,100
43c7a71bb590788448da51adb3643434fb0f0a83,0,0,0,0,0,0,0,0,0,0,0,0,0,0,182,8,0,0,0,0,0,0,0,0,0,100
e85287fb84fbbc8ff2111dbc13099d084f506246,0,0,0,0,0,0,0,0,0,0,0,0,0,0,7,1,0,0,0,0,0,0,0,0,0,100
b5c0b6139af40da69667c36ad0c06a36b87f5d8c,0,0,0,0,0,0,0,0,0,0,0,0,0,0,0,0,0,0,0,0,0,0,0,0,0,100
4a76b11be2a6f7831929831d91ecc5ac46e25260,6,94,13,81,0,0,0,3,25,279,1,5,2.180452062,1919,9,1,218,213,5,17770,17164,606,156,153,3,96.53215637
84fb8618019c1dc9862f2570bb597c3b6b22ba5f,0,0,0,0,0,0,0,0,0,0,0,0,0,0,1,1,0,0,0,0,0,0,0,0,0,100
b03da47a09aa64c6fcb681a26b5a9ccb6fc11bd4,1,1,1,0,0,0,0,9,27,129,1,1,0,990,0,0,84,84,0,9268,9268,0,60,60,0,100
966a5bf401f9daeb0623421d720f678c4dc0cb46,0,0,0,0,0,0,0,0,0,0,0,0,0,0,183,5,0,0,0,0,0,0,0,0,0,100
18407844be6da0c869298a056897923d571c7212,0,0,0,0,0,0,0,0,0,0,0,0,0,0,184,6,0,0,0,0,0,0,0,0,0,100
5abb155754af391b57e328dc16f0ca8ee5b9a07a,12,550,163,387,2,0,2,2,31,147,3,9,3.034997179,1380,5,1,252,218,34,13991,11569,2422,133,120,13,99.52978056
66c6e4e8542ee778b2aa8b60f24baa6f6576609a,0,0,0,0,0,0,0,0,0,0,0,0,0,0,6,2,0,0,0,0,0,0,0,0,0,100
9cf3b711175ae8729a958da9fd22be4c1142aa69,0,0,0,0,0,0,0,0,0,0,0,0,0,0,1,1,0,0,0,0,0,0,0,0,0,100
943fc11d7494600f21e051302f5c17ef9e73f2ac,1,4,1,3,0,0,0,2,12,50,1,1,0,415,1,1,83,82,1,3541,3528,13,23,23,0,100
49050c84c5f6b3ff364d4b7ec795b9861f4d9973,5,74,1,73,0,0,0,3,82,122,2,3,2.196917563,2258,2,2,460,452,8,20036,19517,519,164,159,5,100
62da1cd3f2abe8eb9a29c72d49eaca7301dc5119,1,87,0,87,0,0,0,9,30,55,1,1,0,219,1,1,30,26,4,2233,1786,447,16,12,4,100
960812d1018521a1799cef05cd2d80451def4bad,2,8,10,2,0,0,0,3,5,516,1,1,0.918295834,451,10,2,60,60,0,4741,4767,26,27,27,0,100
d7c1a1e727c938a5c0a511a4636753a62629024b,4,267,24,243,1,0,1,3,19,441,1,4,0.878425536,1284,4,0,200,188,12,13049,11655,1394,127,120,7,99.93781095
6a29ae1147cd75b75115d8886469c7eac8ae7429,2,30,18,12,0,0,0,4,13,775,1,2,0.979868757,169,11,2,33,31,2,1326,1279,47,14,13,1,100
67c29705a4db5399bd51c1476387d0b4320b1a44,0,0,0,0,0,0,0,0,0,0,0,0,0,0,2,1,0,0,0,0,0,0,0,0,0,100
9b4acf640bfef17f1284ef5cff72678e75397766,1,7,4,3,0,0,0,8,20,322,1,1,0,232,65,0,23,23,0,1846,1812,34,10,10,0,100
44fcfc5b01a06222f6053d70cc962ea583787993,1,3,2,1,0,0,0,4,7,392,1,1,0,258,66,1,43,43,0,1905,1907,2,43,43,0,100
10ee01a85c4e7bdfaec57e298550551e067cca91,1,22,1,21,0,0,0,4,12,923,1,1,0,83,12,3,9,8,1,1003,856,147,9,8,1,94.59051073
237bab6edcefa54b1c3818d8d4f81039b893d637,3,330,17,313,0,0,0,6,21,86,1,2,0.674201624,1092,5,1,238,215,23,11334,9505,1829,100,88,12,100
54402764c124cd12645e24fa2d3cf2283f4c13bd,4,58,29,29,0,0,0,8,41,321,2,4,1.385076253,1389,39,0,323,315,8,12288,12094,194,105,104,1,100
830ab368b7454151033fff137ee1640dbcee3e41,5,291,4,287,1,0,1,1,25,199,1,5,0.767251981,1156,6,2,215,198,17,11117,9413,1704,138,131,7,99.70760234
9979a1fd815495a04f3ce2a0ce673f95c655e20d,7,451,2,449,2,0,2,1,42,43,1,5,2.187281448,3323,7,0,693,641,52,31157,29261,1896,251,233,18,99.85486212
ad18b024f125fb8411a4331fedbfc21b5186dbb9,13,1901,0,1901,13,0,13,1,1,0,1,2,3.192089416,0,0,0,218,0,218,9394,0,9394,111,0,111,96.24591948
2cd4f17d5d0f3a81634e346068620aa755c0cd6b,0,0,0,0,0,0,0,0,0,0,0,0,0,0,2,0,0,0,0,0,0,0,0,0,0,100
efa9b1441d2082725f114732ff109de0391f9d2b,1,3,1,2,0,0,0,8,17,131,1,1,0,180,3,2,38,37,1,1507,1493,14,10,10,0,100
e270b5c7058c7672eb3b2b5cd0253c4301426463,1,13,9,4,0,0,0,12,48,83,1,1,0,796,4,2,161,158,3,6609,6566,43,41,41,0,100
a058cf2b4481769b1eaf96c4a6a45e5d76c1556f,21,365,84,281,1,0,1,1,83,563,6,8,2.32961923,4063,67,2,845,812,33,33857,32276,1581,356,325,31,99.94877049
b6250688fd68a463c175c4bdb8a66b79d1fa3e74,0,0,0,0,0,0,0,0,0,0,0,0,0,0,5,3,0,0,0,0,0,0,0,0,0,100
1d37519582b4d98c6f879da33444fbcf3cd584f2,58,58,53,5,0,0,0,1,26,627,1,5,5.839460911,10234,7,2,809,809,0,107031,106728,303,530,530,0,100
8f2c0fc7f3101dd72710e04cd37ca85097b27938,1,4,6,2,0,0,0,9,26,140,1,1,0,730,8,1,68,68,0,7777,7777,0,34,34,0,100
7e554e7913a8b411f462c333cc67cdd307c6ff87,2,7,6,1,0,0,0,6,23,400,1,2,0.961236605,332,68,1,38,39,1,2669,2667,2,11,11,0,100
3251e3aa17d1f6f15e49e6d2c7c4e75c7260b387,2,20,26,6,0,0,0,2,8,168,1,2,0.79359123,598,69,2,78,77,1,5325,5378,53,37,37,0,100
6c787783bb3c150b3b913d7b65243086c1d69d61,2,3,3,0,0,0,0,3,3,310,1,2,0.918295834,277,0,0,44,44,0,2091,2090,1,22,22,0,100
f40926669a68d7ad3d548d558e490df6d53a3e0b,4,102,81,21,0,0,0,2,25,975,1,1,1.406598186,723,1,0,130,127,3,5615,5335,280,78,75,3,100
7eb362a5ed003051723fd47357d57383f2539a1a,3,492,1,491,2,0,2,1,29,62,1,2,0.988448872,610,8,1,148,123,25,8482,5415,3067,53,38,15,99.87215546
6a5d1f3db7a2f42d4c1b17741bed4f03e00406ac,2,3,3,0,0,0,0,5,30,21,1,2,0.918295834,714,9,2,131,131,0,6419,6435,16,46,46,0,100
d08d3bdbeddc3634e01dbe10f984b180946ee1e1,1,1,1,0,0,0,0,8,16,56,1,1,0,116,70,2,15,15,0,1130,1130,0,3,3,0,100
6b097cb26fc3e4173bfbc8d66f393eb5880804c1,2,42,7,35,0,0,0,9,42,162,2,2,0.88864667,685,185,0,101,97,4,5468,5277,191,56,54,2,100
9ec4c23a1ff8a5ed1f202fc4186a920d0975e5fe,9,63,15,48,0,0,0,2,19,134,2,6,2.897755079,2562,71,3,406,397,9,22987,22571,416,187,184,3,100
aec6084e7df82574c0b41063ab0f4a4115cbf25d,14,445,76,369,1,0,1,2,18,265,4,7,2.874127887,1641,0,0,258,232,26,17787,14999,2788,132,119,13,96.9412396
37468da5af90bb9180eef1eaecada53ed1f74ebf,1,34,12,22,0,0,0,6,16,34,1,1,0,265,2,1,44,41,3,2054,1790,264,31,29,2,96.67973856
8736fcbe835075ebdf345999fc81f185e3ad9fd5,0,0,0,0,0,0,0,0,0,0,0,0,0,0,3,2,0,0,0,0,0,0,0,0,0,100
ade3079bfe6b2b811048a0e43806000f68e17db7,3,24,10,14,0,0,0,3,26,153,1,1,0.915024102,606,1,1,98,93,5,4699,4602,97,58,56,2,100
c2f7a2a5e925ce790391a9d718decd5c942a59b3,9,171,27,144,0,0,0,10,41,722,4,8,2.095648629,2580,72,2,395,378,17,24432,23419,1013,205,195,10,100
820572d8afb5b1244af7f8c36c810c4efd0b749d,2,66,7,59,0,0,0,4,20,503,1,2,0.73275255,517,6,0,95,85,10,4655,4255,400,45,42,3,100
8e79ba81ad5e228ab235477860134ec6891d291a,2,9,5,4,0,0,0,6,17,69,1,1,0.591672779,184,73,3,26,23,3,1755,1709,46,5,5,0,100
10f3843addd509e3f77bad9737ee2ddb33681a94,4,6,6,0,0,0,0,3,5,40,1,1,1.825011211,539,74,4,68,68,0,5385,5400,15,37,37,0,100
de2f5c0ab1c26b8d198d067e066c579a86bce737,20,579,191,388,6,0,6,3,13,97,5,13,3.010440134,3414,7,1,449,557,108,31497,36188,4691,242,231,11,94.46514103
01fe388ad2812afe5d83a5ecef6688d6e1e248b6,4,61,38,23,0,0,0,3,9,0,2,2,1.914152181,671,8,2,111,111,0,4654,4417,237,71,71,0,99.91189427
55d86eb22440016dc30fc740dd016998abbdf79c,1,7,0,7,0,0,0,2,2,2106,1,1,0,27,0,0,2,2,0,252,216,36,2,2,0,100
f635f203aa5af1b19088b3f2dca509f3d1d222ff,0,0,0,0,0,0,0,0,0,0,0,0,0,0,0,0,0,0,0,0,0,0,0,0,0,100
685a561cd51e56aad9845ab8c41f13c33789c02c,2,5,6,1,0,0,0,8,27,102,1,1,0.684038436,525,10,0,37,37,0,5564,5571,7,34,34,0,100
df7f37e23a7d287077f07d48ecc30150bcc8b906,1,1,1,0,0,0,0,3,10,23,1,1,0,421,9,3,73,73,0,3130,3130,0,33,33,0,100
dddf6c5119dbb68df67adc3b42c8272a0fdc6696,3,19,18,1,0,0,0,7,23,96,1,3,0.702564514,659,1,1,60,60,0,6605,6600,5,34,34,0,100
78da26e279cc94caa66e930029a5646b8b047436,0,0,0,0,0,0,0,0,0,0,0,0,0,0,2,2,0,0,0,0,0,0,0,0,0,100
08399d03858f5c9ee03ed9c4f445fe723e3bfa52,2,3,1,2,0,0,0,6,15,174,1,1,1,166,1,0,22,22,0,1294,1269,25,10,10,0,100
14b1bb8f4dc6cf5c85957ea0981cbaff0b490ff3,6,113,93,20,0,0,0,2,14,23,2,5,1.722145713,762,186,0,115,113,2,6180,6050,130,60,56,4,100
fa66c17e967359c519c59717f52a705297595d3f,2,13,7,6,0,0,0,10,33,166,1,2,0.721928095,1539,2,0,222,222,0,13821,13822,1,92,92,0,100
c404da28cc5eeefa158ea5a2aca38b4b2cf731ee,6,41,29,12,0,0,0,2,6,534,2,3,1.419282097,1060,9,0,188,185,3,8203,8072,131,88,87,1,100
7bd3e97610b6c8de8dc5d9bc17b652068b357bd5,1,15,2,13,0,0,0,8,18,159,1,1,0,182,10,1,42,38,4,1610,1507,103,10,10,0,100
4bf2401ad8338b181dd67e91fa6576c26741145b,1,1,7,6,0,0,0,2,3,18,1,1,0,137,11,2,15,16,1,839,862,23,13,13,0,100
a49133aafecee7c047d201bdefe49e703f2e65b6,0,0,0,0,0,0,0,0,0,0,0,0,0,0,12,3,0,0,0,0,0,0,0,0,0,100
c52961c6a3625a7fc617b62e3c3e3fa43534e74e,14,0,1499,1499,0,0,0,9,71,457,2,5,3.400770452,2800,40,0,203,388,185,16333,24401,8068,125,200,75,99.14251922
95bf312f46bc96bc247645da6500b495c21aede3,21,1912,38,1874,16,0,16,8,18,75,4,10,3.965385328,732,41,1,318,126,192,15583,5843,9740,144,68,76,93.68117462
3e22a77fec451ae5169548f2cee70ab483eba650,0,0,0,0,0,0,0,0,0,0,0,0,0,0,10,1,0,0,0,0,0,0,0,0,0,100
6655e90a7b3990cbe8dffd2e20d3657c249b123e,12,299,249,50,1,0,1,13,72,21,4,8,2.906629486,3585,13,4,479,320,159,31579,23623,7956,225,197,28,99.15433404
2f2b816febb3171509b8af80499ac18e4c060b44,2,6,3,3,0,0,0,8,19,2,2,2,0.99107606,246,42,2,50,49,1,1967,1936,31,16,16,0,100
20bc33187f41df9c4e9efb46983ba79ef20657dc,4,179,9,170,1,0,1,12,73,3,2,3,1.34479409,1043,43,3,187,167,20,10098,9151,947,100,90,10,99.88232525
dc3e729a8b73a15b923ae6925af89b5a5644e289,4,649,37,612,3,0,3,1,68,65,2,2,1.652684861,909,0,0,309,232,77,10948,7034,3914,86,53,33,97.35840076
bc58b55a195a52a7656e2cbd813043676662ace6,0,0,0,0,0,0,0,0,0,0,0,0,0,0,3,1,0,0,0,0,0,0,0,0,0,100
62393fe33873587eeb17f062dce632f33bdb8b21,0,0,0,0,0,0,0,0,0,0,0,0,0,0,44,4,0,0,0,0,0,0,0,0,0,100
7e4dc0d923b5ef3d44f7fa5c85681d6fa89e0caf,31,948,121,827,2,0,2,3,43,256,5,18,4.007744646,6704,2,1,1398,1277,121,59272,54211,5061,586,545,41,99.47191551
c219812ca3d80a94a26f8e5e608c20921fd5001e,0,0,0,0,0,0,0,0,0,0,0,0,0,0,45,5,0,0,0,0,0,0,0,0,0,100
054aa772b404d96c38dbadcddee1e28a75861bb0,9,313,23,290,0,0,0,7,69,543,4,6,2.769386137,2754,4,0,545,507,38,24585,22391,2194,177,160,17,97.54601227
b34069b7f3fe4178bf12b4483b14fffd765290ed,1,9,2,7,0,0,0,14,70,1,1,1,0,946,14,4,243,241,2,7435,7385,50,59,59,0,100
c2a802b40efa55441b2be218a6d44c09e5adaa72,7,57,12,45,0,0,0,6,74,107,3,4,2.285697305,2480,5,1,295,292,3,22974,22561,413,147,146,1,100
7c0481eac4793102bb5124d60db14fb6fd30100c,2,152,29,123,0,0,0,2,2,22,2,2,0.372690951,500,46,6,104,86,18,4954,4201,753,31,24,7,100
aba79aae2c7235f065413fe0c9f0af5077079371,17,1502,26,1476,9,0,9,2,18,117,5,16,3.396334544,941,11,1,275,160,115,16643,7466,9177,139,85,54,99.51445087
a369461011bc41805f9b0736a2748366794cd8af,3,20,3,17,0,0,0,4,34,248,1,3,1.370862465,606,1,0,113,111,2,4632,4566,66,43,43,0,100
897aa5fd1518e07b90598f5e7097f03bec877a2e,0,0,0,0,0,0,0,0,0,0,0,0,0,0,2,1,0,0,0,0,0,0,0,0,0,100
12675022a383ccdec250d2900776cdffc409c394,5,287,44,243,0,0,0,8,75,79,2,4,1.516105866,1448,6,2,235,211,24,14297,12071,2226,137,125,12,99.83919136
b49056d6c7a79987c3d415ac6d6037fa9f1c92b9,1,2,2,0,0,0,0,15,84,174,1,1,0,1502,15,5,347,347,0,12684,12684,0,89,89,0,100
2945fa80b9a46b003d64d2cf2dbe10232e4b4e55,0,0,0,0,0,0,0,0,0,0,0,0,0,0,0,0,0,0,0,0,0,0,0,0,0,100
123391d460b5c1ed30209d10618377da023fdb4b,3,24,19,5,0,0,0,1,16,835,2,3,1.508183433,728,12,1,119,117,2,5989,5915,74,57,56,1,100
4ab28e80f908ad8f3aac65c2dd39eb7f49b213ae,0,0,0,0,0,0,0,0,0,0,0,0,0,0,1,1,0,0,0,0,0,0,0,0,0,100
6d4ff0beffdf0ae89618afcc761ed33eb73e680b,0,0,0,0,0,0,0,0,0,0,0,0,0,0,75,0,0,0,0,0,0,0,0,0,0,100
2d51db7a02394ce6856b4c622283f5afd99398eb,15,505,82,423,1,0,1,1,85,360,7,12,3.2258028,6058,13,2,1300,1242,58,53510,50850,2660,435,411,24,96.85534591
fc34d42cbe1a325d686d65fdf7d863d254d7e4d1,0,0,0,0,0,0,0,0,0,0,0,0,0,0,0,0,0,0,0,0,0,0,0,0,0,100
85345ad7e7421fbd25829381f27eb5b165d2f8d0,0,0,0,0,0,0,0,0,0,0,0,0,0,0,47,2,0,0,0,0,0,0,0,0,0,100
a83a141d60de60d97b0fd4a81c3fadce880ed308,0,0,0,0,0,0,0,0,0,0,0,0,0,0,48,2,0,0,0,0,0,0,0,0,0,100
44c10981e6d448855156802e36a4c8bdad56d469,1,7,2,5,0,0,0,2,3,39,1,1,0,178,7,1,23,23,0,1757,1713,44,5,5,0,100
bb6032b2cb46d7bff545ab4d97480ea1d4e7b27d,0,0,0,0,0,0,0,0,0,0,0,0,0,0,14,2,0,0,0,0,0,0,0,0,0,100
f3ff8b27f0a77d802306f0fc9ffdff51ae6c7486,28,762,46,716,1,0,1,13,77,491,6,18,4.021648276,10395,15,3,1721,1618,103,96149,91072,5077,763,731,32,94.40855424
1b8a933073517df19f66e60dfe1f59a35d4d9054,1,1,1,0,0,0,0,7,13,83,1,1,0,37,16,4,0,0,0,333,333,0,0,0,0,100
8bd7a5c87f9c80119471b1b29a72067e6650c20e,2,31,7,24,0,0,0,2,3,659,1,1,0.485460761,96,3,0,23,19,4,945,771,174,8,8,0,99.87288136
a88ba80aa6511a332629575d717b601a6be0c8cc,0,0,0,0,0,0,0,0,0,0,0,0,0,0,4,1,0,0,0,0,0,0,0,0,0,100
5546d3737aa347bf2e5d7c0ef54f612bd96ed71c,0,0,0,0,0,0,0,0,0,0,0,0,0,0,8,1,0,0,0,0,0,0,0,0,0,100
8c04aa0242f43825f0cc50d2205dacfb63ce51f0,0,0,0,0,0,0,0,0,0,0,0,0,0,0,17,4,0,0,0,0,0,0,0,0,0,100
5e26e11ca9ca8ce326383eebcb4145384e273b9b,2,3,1,2,0,0,0,3,4,2,1,1,0.811278124,115,18,5,23,23,0,956,945,11,8,8,0,100
98a904c2118d368e110b88ff396da86c64490ed8,4,50,22,28,0,0,0,7,18,442,3,4,1.391099905,654,4,0,109,106,3,5199,4942,257,41,39,2,100
7b78c39ebbddc6ff370e2c758c851ac22225a991,8,245,24,221,1,0,1,14,34,52,3,5,1.621153295,1107,9,2,163,153,10,10715,9173,1542,99,90,9,93.46107784
ed410e841b8465af45dbef236e83db5618508816,0,0,0,0,0,0,0,0,0,0,0,0,0,0,19,6,0,0,0,0,0,0,0,0,0,100
941c4fa325521aa1816e1ccb178d20762f726ba8,4,98,5,93,0,0,0,3,15,577,1,3,1.683224756,322,10,3,76,66,10,2852,2217,635,40,37,3,99.83566146
645e13f5016c2d7d4f2527d204dc11822c911182,0,0,0,0,0,0,0,0,0,0,0,0,0,0,20,7,0,0,0,0,0,0,0,0,0,100
2eac3ec0751262ab515257a4e7ae17355cb93e0c,0,0,0,0,0,0,0,0,0,0,0,0,0,0,5,1,0,0,0,0,0,0,0,0,0,100
a31fa545f9bf9a9266de685da1d6047affeb366f,0,0,0,0,0,0,0,0,0,0,0,0,0,0,11,4,0,0,0,0,0,0,0,0,0,100
c59aa1070b9445227b41ad0ba04ab23ed8885689,2,191,0,191,2,0,2,1,1,0,2,2,0.985536913,0,16,0,16,0,16,1030,0,1030,10,0,10,93.33651779
4ccd3b119389e9707cc69ef89e6d38dd6639cb32,1,1,1,0,0,0,0,4,14,665,1,1,0,177,49,1,39,39,0,1356,1354,2,15,15,0,100
78bb79617203d61720d38a933d0443a09749f300,1,12,1,11,0,0,0,3,4,14,1,1,0,99,12,5,15,14,1,775,715,60,14,13,1,100
6d73fad44c67b3bb013c37a2939fa00aacd12668,1,28,0,28,0,0,0,2,3,81,1,1,0,440,1,0,77,71,6,3878,3736,142,20,20,0,100
6e034074f65a6498af532fd0af143c21c410374a,11,345,1,344,1,0,1,9,35,153,2,8,2.197506135,3140,3,0,505,458,47,32491,29813,2678,213,196,17,100
a9119c6963b7862f5c784a6ffff8d3b1551ca6b5,1,5,5,0,0,0,0,4,5,1,1,1,0,107,0,0,15,15,0,775,775,0,14,14,0,100
e48877523728ccc903d9d7331782f3ba880b18a0,1,1,1,0,0,0,0,14,51,50,1,1,0,889,13,5,177,177,0,7425,7425,0,46,46,0,100
fcd066a0a04da49b6ed507f832059b61faa66a79,3,98,69,29,0,0,0,1,86,34,3,3,1.300928923,2670,21,7,645,638,7,21977,21901,76,163,161,2,100
fbd9fbedbfbf9958b03dff47be6888fdc743ec16,2,29,5,24,0,0,0,2,4,56,2,2,0.322756959,479,50,1,83,81,2,4116,3990,126,25,24,1,100
823c7d1d8397be19b6fe94a7477bebcb288c94fc,2,35,37,2,0,0,0,2,3,99,1,2,0.997772472,414,51,2,77,74,3,3358,3362,4,15,15,0,100
b53cc7090a372b24f1adef45f5321648a2add8cc,0,0,0,0,0,0,0,0,0,0,0,0,0,0,22,8,0,0,0,0,0,0,0,0,0,100
d59ff0d1bb5954ba438958fd3fc4343dcedc29a7,6,21,9,12,0,0,0,2,5,74,1,1,2.454096965,1323,14,6,204,204,0,11360,11325,35,42,42,0,100
004e612d48076b0e2022aeff5d01bb4bed4c8094,1,12,14,2,0,0,0,6,9,372,1,1,0,40,15,7,6,7,1,258,270,12,4,4,0,100
e7ab836187e2b358aec489f7a65bbe3ff0c31285,1,0,1,1,0,0,0,2,2,880,1,1,0,52,5,2,13,13,0,366,366,0,4,4,0,100
3fb6e0e756ca476a0551f232d57c0dca28a024c6,1,266,248,18,0,0,0,6,23,42,1,1,0,949,6,2,100,98,2,8597,8496,101,61,60,1,100
234acfac55cfb604e956a689f1d2b2b9d2195bdd,1,2,0,2,0,0,0,5,7,729,1,1,0,229,23,6,13,13,0,2034,2002,32,12,12,0,100
d37872e8132fb22aaf791b4396c5a6e26086a62d,0,0,0,0,0,0,0,0,0,0,0,0,0,0,17,1,0,0,0,0,0,0,0,0,0,100
9edf9e52482f1591955fe5b44d6cab666e0b2e46,19,2755,0,2755,19,0,19,1,1,0,1,3,3.364357792,0,6,1,263,0,263,12824,0,12824,129,0,129,99.0990991
48b877afd929c5bff6cecd0ee42385671f55a25b,2,11,11,0,0,0,0,5,7,216,1,1,0.845350937,273,7,2,15,15,0,2497,2442,55,13,13,0,100
2923c04c1d6434cae27f8a4e6b35934d11f1f4ab,0,0,0,0,0,0,0,0,0,0,0,0,0,0,16,5,0,0,0,0,0,0,0,0,0,100
400ef329d1816b408e759990b880c9dd1970dae2,1,9,3,6,0,0,0,2,2,32,1,1,0,138,1,1,26,26,0,1297,1270,27,9,9,0,100
ff2f9e27fb96e01a1c03598ba936eff77fd3b630,2,146,0,146,2,0,2,1,1,0,1,1,0.999864633,0,4,1,11,0,11,779,0,779,7,0,7,99.91711562
629bcfbdbd6833cf590a6f622ccde7813e5556dd,1,9,6,3,0,0,0,4,5,64,1,1,0,79,2,1,17,16,1,625,612,13,5,5,0,100
85ed40eba15039c9ed15ab9785f74a991bd50f41,0,0,0,0,0,0,0,0,0,0,0,0,0,0,8,2,0,0,0,0,0,0,0,0,0,100
16d2b39b24f30b3562874585fcdc58ecf4460ad0,2,82,1,81,0,0,0,6,10,573,1,2,0.530744567,522,9,3,65,60,5,5605,4981,624,27,24,3,100
e84fca7ff2ce235a7d804b3c4806091a2a2c3037,3,78,4,74,0,0,0,4,24,129,2,3,0.653352308,1476,17,3,180,172,8,12998,12605,393,108,107,1,99.79343111
f8707fdc6f512fdfc386b010e4dee0812f45cbd7,0,0,0,0,0,0,0,0,0,0,0,0,0,0,18,2,0,0,0,0,0,0,0,0,0,100
fb4d0b4955429e6cef413ab073814fc800361bd4,2,3,15,12,0,0,0,9,21,205,2,2,0.650022422,494,19,3,54,53,1,3930,4004,74,21,21,0,100
ea2122b6c699bdb6429e6dda6d91f3d6bdd697d7,0,0,0,0,0,0,0,0,0,0,0,0,0,0,10,4,0,0,0,0,0,0,0,0,0,100
e6526d8294b80e57abefef6afb26e2e03db968fd,0,0,0,0,0,0,0,0,0,0,0,0,0,0,24,1,0,0,0,0,0,0,0,0,0,100
2b84dd56d291299f22ba872c1b0814cdad5692fe,14,568,30,538,1,0,1,15,74,129,3,12,2.803248228,4441,11,5,1017,927,90,40934,37323,3611,350,327,23,94.39735373
ee644dd2a6639085b469f8fae96580671f4d0fe9,9,72,34,38,0,0,0,1,7,272,2,5,2.622343311,1213,52,0,209,206,3,9638,9407,231,91,89,2,100
a4e18a4d428569c37e65e281c3c36bf3ed737eed,1,1,1,0,0,0,0,5,12,315,1,1,0,239,18,0,53,53,0,1679,1678,1,16,16,0,100
32be559a061e209b0fe183cf825be21ae4193136,1,7,2,5,0,0,0,16,87,57,1,1,0,1519,76,0,356,355,1,12851,12811,40,91,90,1,100
52425d19c98c160cc1b6fff4065dc10fb9b20a6a,0,0,0,0,0,0,0,0,0,0,0,0,0,0,19,1,0,0,0,0,0,0,0,0,0,100
b2f085c7cb21b6c5208eaa3aaa8fac331e2cd05a,0,0,0,0,0,0,0,0,0,0,0,0,0,0,77,1,0,0,0,0,0,0,0,0,0,100
54430ed279909c3e7d488e4ef98d05f56c4ecf45,1,20,15,5,0,0,0,1,2,71,1,1,0,52,20,2,8,6,2,705,530,175,1,1,0,100
65c804cbac7884f28d60d18116625938a8811456,0,0,0,0,0,0,0,0,0,0,0,0,0,0,21,3,0,0,0,0,0,0,0,0,0,100
7183416a92a9f7c8285f12b997b6eacd9e6a9710,2,62,2,60,0,0,0,9,25,667,2,2,0.661976064,867,12,4,139,133,6,7613,7236,377,58,54,4,100
00a07d561fdee4aba5be24cfe841c438b17a0e69,2,15,7,8,0,0,0,4,12,300,1,2,0.684038436,318,25,1,56,55,1,2383,2307,76,26,26,0,100
df10d5ac333813edc9a6025b8f3098bd8d3e79db,0,0,0,0,0,0,0,0,0,0,0,0,0,0,53,1,0,0,0,0,0,0,0,0,0,100
e7cdda742f90744519f522fcf499f79debfeb945,0,0,0,0,0,0,0,0,0,0,0,0,0,0,3,1,0,0,0,0,0,0,0,0,0,100
d66185988ae0aa60768b272759d2312d724976f9,1,2,1,1,0,0,0,1,3,18,1,1,0,58,22,4,9,8,1,722,705,17,1,1,0,100
037e6821b6eb7dbad1c0b1a3508aa6715e77e454,0,0,0,0,0,0,0,0,0,0,0,0,0,0,20,2,0,0,0,0,0,0,0,0,0,100
d3ebf0b3d826c32e068c0c786d51dd4d39a7f08f,1,25,4,21,0,0,0,13,23,42,1,1,0,346,3,0,76,74,2,2809,2674,135,28,28,0,100
dca46a916fb5dba84c324d2a456dd1248a6176b5,0,0,0,0,0,0,0,0,0,0,0,0,0,0,21,1,0,0,0,0,0,0,0,0,0,100
3abefccf5d311e885051cf7abc6592c19af1b67d,2,3,1,2,0,0,0,3,8,272,1,2,1,696,78,2,113,113,0,5963,5956,7,69,69,0,100
aaf33261f32ba87d95c268e09a593f9ebae1f46b,2,8,4,4,0,0,0,3,15,488,1,2,0.918295834,485,22,2,74,72,2,4042,4006,36,45,45,0,100
7dab15f0036c56c06a29d36a5df0527823a930f8,17,24,24,0,0,0,0,3,27,555,1,7,3.834962501,3939,3,0,222,222,0,40072,39992,80,136,136,0,100
e8d1de35d60d32d499530412fc4592abaf16f544,0,0,0,0,0,0,0,0,0,0,0,0,0,0,23,3,0,0,0,0,0,0,0,0,0,100
b568a050a78c90b7dfc01231f3bed913e0d27f7b,13,641,12,629,4,0,4,2,42,143,2,8,2.661878133,2145,23,1,460,411,49,20702,17257,3445,206,169,37,99.77225673
2dc3b1d778a4991536705878e4e16299fc21a1dc,1,1,0,1,0,0,0,1,4,32,1,1,0,59,24,2,9,9,0,733,722,11,1,1,0,100
a78795c3d0a4e3e5bd96e47b670946cc56ae76ac,2,7,4,3,0,0,0,1,2,8,1,1,0.945660305,114,25,2,18,18,0,930,905,25,9,9,0,100
d0bc188601566dbf76555a115c7ea9c68ca13909,1,20,3,17,0,0,0,2,2,974,1,1,0,246,26,0,51,48,3,1997,1909,88,16,15,1,100
b135f28f314b1ec0a89c2e1c21b033e48e7db602,2,29,12,17,0,0,0,7,24,360,1,2,0.996134484,331,27,1,40,38,2,2770,2669,101,11,11,0,100
31ab502391cd1a75cbad28259d769088273ac0f4,0,0,0,0,0,0,0,0,0,0,0,0,0,0,54,0,0,0,0,0,0,0,0,0,0,100
679c9f51dda6a045b900c62b59cb2c8b0a6a0ac8,1,2,2,0,0,0,0,1,3,71,1,1,0,60,55,1,6,6,0,371,371,0,6,6,0,100
bb23ccf08cdc0a0a7458218bbb559947ac6e1d2d,1,2,1,1,0,0,0,11,30,155,1,1,0,996,24,3,84,84,0,9355,9350,5,60,60,0,100
c12c999b4cc89bd3fbe24873567f441eed02a4ef,3,133,0,133,1,0,1,9,22,75,2,3,1.268213185,802,5,0,83,75,8,10743,9609,1134,38,35,3,99.95867769
57fa2ff125602706b26b6d168a84b828c490ff74,1,7,10,3,0,0,0,10,36,130,1,1,0,337,6,1,61,59,2,2565,2591,26,17,17,0,100
9018ed3458d4d1def5c0643fa0e45a61fc5d82f7,5,12,7,5,0,0,0,1,5,400,2,3,2.268472752,778,56,2,153,153,0,6265,6208,57,41,41,0,100
3435e2096b17076736b4d575c74596f7f38d5e5b,1,1,0,1,0,0,0,5,9,1916,1,1,0,40,7,0,6,6,0,285,278,7,5,5,0,100
bd32b610e617ae05027b45e3a5c7672613afdfdc,2,40,30,10,0,0,0,1,5,131,1,2,0.187176257,259,57,3,47,47,0,2093,2108,15,7,7,0,100
60e2f68b867476f600ba43dc4dafb97971a78b2e,21,1240,824,416,3,0,3,2,44,136,2,12,3.143328851,3132,26,3,511,439,72,28839,27900,939,225,217,8,90.90475054
b2526d8f4b8043ed0e1c005b89533683815e2373,20,805,344,461,2,0,2,4,78,305,4,7,3.243418322,4337,0,0,810,783,27,40586,36191,4395,288,264,24,93.69230769
91f7c817c4c82399a5e7e8eef8e4d60450b92e4a,0,0,0,0,0,0,0,0,0,0,0,0,0,0,28,2,0,0,0,0,0,0,0,0,0,100
c1d37bfab3cae98a61cbe924786a0335e13135dc,2,32,0,32,0,0,0,11,35,98,1,2,0.988699408,1550,13,0,230,224,6,14161,13963,198,95,92,3,100
491cd8eaaa6b8117bb1a911280fbc580b98bf83d,5,59,65,6,0,0,0,10,42,197,2,3,1.945652384,1874,187,0,234,234,0,17594,17686,92,144,144,0,100
e46e5c4c641fd5e35eb1fbdacbeb04d116f3a6e7,0,0,0,0,0,0,0,0,0,0,0,0,0,0,188,1,0,0,0,0,0,0,0,0,0,100
f14eca88e7875e5c8cc88a31c0e9ae58928f29a1,6,54,31,23,0,0,0,2,6,18,2,4,1.932376807,1094,27,2,186,182,4,9058,8889,169,72,71,1,100
afb07cc2c7b842df928597a9e54cf05e679dab82,0,0,0,0,0,0,0,0,0,0,0,0,0,0,29,3,0,0,0,0,0,0,0,0,0,100
37848ed653dbebcee5cbaec546ccc7a9d1fdb4fe,1,9,4,5,0,0,0,16,76,23,1,1,0,1171,28,2,303,301,2,9234,9195,39,66,66,0,100
6610f36b131f53b7bb89c40a9f91b2a57bd585af,1,7,12,5,0,0,0,16,88,107,1,1,0,1522,79,0,356,356,0,12817,12851,34,90,91,1,100
609fc5bc143bc5ec11654376dc3a938f7af10169,0,0,0,0,0,0,0,0,0,0,0,0,0,0,7,2,0,0,0,0,0,0,0,0,0,100
0da2074040b95c64b49ab6fb65e57644bb022e55,5,16,12,4,0,0,0,6,89,231,3,3,2.074164743,2302,80,1,527,525,2,18566,18497,69,178,178,0,100
b6d2c134b979ce1bb130916992553a54c5e911ed,6,40,45,5,0,0,0,16,79,405,4,5,1.99435892,2894,25,0,534,535,1,24816,24812,4,200,200,0,100
9a4c18c7d380334756df84f89f57dabc42437008,1,3,15,12,0,0,0,16,78,12,1,1,0,1173,29,3,298,302,4,9137,9226,89,66,66,0,100
292dfed341b462488ab58584dc305f519f1beb4d,4,40,68,28,0,0,0,11,21,301,1,1,1.961351633,819,14,1,123,130,7,7166,7441,275,61,63,2,100
73339264d6d8cd627aee0be53007a7bd4e4956ac,2,20,20,0,0,0,0,9,23,54,1,2,0.609840305,867,8,1,80,80,0,10551,10536,15,36,36,0,100
ec4a273a8776ebdd1c50e062cad46c981b1d0122,2,27,3,24,0,0,0,2,4,577,1,1,0.996791632,128,8,0,19,19,0,1236,1076,160,7,7,0,100
ec3e49e393c45ca580795e47fb085c8e58a8f789,4,34,20,14,0,0,0,10,27,744,1,2,1.528315992,1280,9,1,150,148,2,13017,12838,179,69,69,0,100
42f47b277bca48f814f785892fd1e3b9343daa98,0,0,0,0,0,0,0,0,0,0,0,0,0,0,189,2,0,0,0,0,0,0,0,0,0,100
dc36866aff47a2bd16f26490e96a3582e8983d43,0,0,0,0,0,0,0,0,0,0,0,0,0,0,30,2,0,0,0,0,0,0,0,0,0,100
40d943637067b04747b337e714f1588567fa4751,2,19,0,19,0,0,0,15,36,168,1,1,0.74248757,619,31,3,85,81,4,5664,5484,180,53,52,1,99.92962702
752511bbe4da85f96e67a0520fb7560e7434b580,4,11,1,10,0,0,0,3,7,36,2,2,1.418295834,705,15,2,138,136,2,6565,6477,88,54,53,1,100
3ed804e92d1434e42a057dc68a6faa6d2fb248ce,5,28,18,10,0,0,0,10,21,254,2,5,2.203076643,731,32,3,108,107,1,6479,6431,48,45,45,0,100
7ec539a8c854f6cf8ad1f77f7ad84a840ef2c577,0,0,0,0,0,0,0,0,0,0,0,0,0,0,33,4,0,0,0,0,0,0,0,0,0,100
84857961d6f9dca9616ceb222b5e01eca63922d2,0,0,0,0,0,0,0,0,0,0,0,0,0,0,34,5,0,0,0,0,0,0,0,0,0,100
c588628aa94eb7e924776127cbdcd2398d533ba1,0,0,0,0,0,0,0,0,0,0,0,0,0,0,35,6,0,0,0,0,0,0,0,0,0,100
ea0492dacd3d0929751060bee26b1e5a61178431,4,14,13,1,0,0,0,4,8,98,1,3,1.836591668,760,10,2,118,118,0,6236,6209,27,44,44,0,99.85994398
f63795155dfd19844f0733837cfaab350d92cee2,3,4,1,3,0,0,0,8,16,304,1,1,1.370950594,443,36,7,25,25,0,4950,4929,21,24,24,0,100
e94dd72fad805eed25f4d035ffc90e7e71e3dffd,3,15,15,0,0,0,0,8,17,0,1,1,1.272905595,446,37,7,25,25,0,5029,4950,79,24,24,0,100
c7996deb76819fc7ef98dd28fd4dff19474b7602,14,847,10,837,5,0,5,4,90,108,4,9,2.44079904,3319,0,0,732,632,100,32303,27753,4550,258,208,50,96.87065369
117fdcfe518154d634060e7557a5efe320e33362,1,10,5,5,0,0,0,5,22,13,1,1,0,477,38,8,94,93,1,3910,3897,13,36,36,0,100
dda42366823e0fdb996ed70e34710fa8dfb4393c,2,115,2,113,1,0,1,8,19,90,1,1,0.2149782,348,39,9,66,54,12,3015,2407,608,36,33,3,99.9306198
075f02c51100de88f29421f466c1b3c566abed26,0,0,0,0,0,0,0,0,0,0,0,0,0,0,40,10,0,0,0,0,0,0,0,0,0,100
da767c2f6b2cc80af9b8bf663cdd45515bd440f0,26,1609,650,959,6,0,6,15,80,43,5,10,3.810559185,4646,30,0,635,550,85,51102,38207,12895,336,275,61,96.09860665
b0efc6fbf97c109a81b490339d2521c21fffe37e,6,140,26,114,1,0,1,1,7,77,2,4,1.948228721,911,58,0,168,155,13,7684,7022,662,59,52,7,99.7588909
3efffd4d946c0a4a8e6885f86e1da3107de52e00,14,351,96,255,1,0,1,8,25,291,5,10,2.684301574,1464,59,1,194,170,24,13902,12372,1530,77,72,5,98.90132248
723f1f7f1bb1cd052e81f757629f750393ae6a80,4,12,13,1,0,0,0,2,9,338,2,3,1.384381458,878,60,2,146,147,1,6929,6944,15,53,53,0,100
7d9687bcbc8a978ad361498084f3e473fd69fc9b,14,264,102,162,1,0,1,10,28,250,2,10,3.29179331,3375,31,1,445,414,31,35216,34331,885,203,189,14,99.95903318
c8d58b8a927281f32a94ff92049d6d70dfbc0d61,0,0,0,0,0,0,0,0,0,0,0,0,0,0,205,0,0,0,0,0,0,0,0,0,0,100
81136147dbdf32c3d2d2da4e30ae5ec944cc332f,3,21,1,20,0,0,0,17,91,188,2,3,1.322179346,2829,4,0,629,626,3,24236,24099,137,205,203,2,100
d903a6aa95c1c1755fc876e61dce64646c1ebbf3,0,0,0,0,0,0,0,0,0,0,0,0,0,0,41,8,0,0,0,0,0,0,0,0,0,100
9bed024d54cd8dc3cc8f17d6c27a402bcfa0c749,2,3,2,1,0,0,0,3,5,15,2,2,0.970950594,272,42,9,62,62,0,2125,2125,0,13,13,0,100
c57c8f448821e1c2ab9a9ebd4b4fd04dfcaab3cc,5,434,0,434,3,0,3,1,8,253,2,2,1.800750946,186,26,0,71,27,44,3462,1428,2034,47,18,29,99.85687998
cb473b4fb037f13c1e458b6a4215f53a05f42b15,2,32,4,28,0,0,0,3,5,36,2,2,0.503258335,192,61,3,21,17,4,1922,1774,148,7,7,0,100
2bea7f4742374e6b38228a798a4ab7fbf2d18507,1,5,0,5,0,0,0,1,2,0,1,1,0,99,27,1,11,11,0,762,697,65,11,11,0,100
7354f870b2bff7b5f0451a792cb06d2eee00ff38,2,112,62,50,0,0,0,6,43,599,1,2,0.29367631,1294,5,1,251,245,6,11634,11156,478,99,98,1,100
3a7c993b55564d11ae79d25d32fd5fbd63ce4fe9,2,10,1,9,0,0,0,12,29,385,2,2,0.845350937,836,6,2,81,80,1,8974,8840,134,38,38,0,100
fc27ebb84b692a7d6e961b1a1e00821ad2a3df51,5,26,13,13,0,0,0,6,27,240,1,2,2.08655895,1418,28,2,294,285,9,10505,10426,79,158,157,1,100
470f34313b0bf8210f95f6969712b12e55a9e169,5,47,5,42,0,0,0,6,92,167,5,2,1.411700544,3141,7,2,681,673,8,26112,25766,346,208,205,3,100
d55cdd0951bc2c5344ce5e9493c290e58d85234a,5,19,10,9,0,0,0,1,23,55,1,4,2.069333912,871,32,0,150,148,2,7399,7344,55,64,63,1,100
35b10b4383721c87fa9fb6102be50da015908000,2,7,10,3,0,0,0,12,30,12,1,2,0.787126586,834,33,1,88,88,0,8487,8517,30,44,44,0,100
c00975e419a4bf0f191d51de1294b3c2e044a83a,11,0,3138,3138,0,0,0,3,11,609,1,4,3.086078032,2528,4,0,24,240,216,1603,21538,19935,18,179,161,95.32924962
07427f626f289b8cd5d57ec40a3f5e19b0849a84,0,0,0,0,0,0,0,0,0,0,0,0,0,0,34,2,0,0,0,0,0,0,0,0,0,100
9655d74106433d35a7601ec67a07485db497cdea,1,12,3,9,0,0,0,1,3,140,1,1,0,518,35,3,124,122,2,4594,4509,85,27,26,1,100
edebc48aca8b2a3bb9a36481f3e6b13084e90239,0,0,0,0,0,0,0,0,0,0,0,0,0,0,190,0,0,0,0,0,0,0,0,0,0,100
d2c8adfadf0d25a5956194f3e82c85a5677a42fb,1,2,0,2,0,0,0,4,8,1031,1,1,0,108,81,0,23,23,0,1061,1047,14,6,6,0,100
864458918f11c6b63088393e1a573a56146af5d9,2,28,8,20,0,0,0,5,28,380,1,1,0.852405179,488,5,1,22,16,6,5390,5282,108,13,12,1,100
90e0d4b9cab4656507e2c0e49496f20325defd81,0,0,0,0,0,0,0,0,0,0,0,0,0,0,191,1,0,0,0,0,0,0,0,0,0,100
803211817677ad3bd2b4266ede3b2543938cc143,0,0,0,0,0,0,0,0,0,0,0,0,0,0,192,2,0,0,0,0,0,0,0,0,0,100
c3697de622e4ce077db7e569b74fc363883a704a,2,3,2,1,0,0,0,17,93,38,2,2,0.970950594,1738,8,1,408,408,0,14054,14052,2,124,124,0,100
91c0a9926f157e2883ad976004230d863258ae62,15,146,126,20,0,0,0,10,47,275,5,10,3.131813678,3881,36,4,659,664,5,31693,31543,150,281,283,2,99.85606333
21cf3717285c68d5cc55fdb52d5b811da5bc34b1,0,0,0,0,0,0,0,0,0,0,0,0,0,0,37,1,0,0,0,0,0,0,0,0,0,100
145f9bc779f4fcc66fe47a0fb9ebd6c189c3cd18,1,2,2,0,0,0,0,2,5,129,1,1,0,116,38,0,22,22,0,888,888,0,9,9,0,100
f191ea540e77fafa9b6e39aa9079e7dd375dfed8,1,1,1,0,0,0,0,1,3,129,1,1,0,104,39,1,14,14,0,571,571,0,14,14,0,100
ef57d29ad01de7b60f12900df04e8b738ba80a69,0,0,0,0,0,0,0,0,0,0,0,0,0,0,40,2,0,0,0,0,0,0,0,0,0,100
4746e039a1522af375a4e877848a6274b2de1c66,5,27,22,5,0,0,0,2,94,282,3,3,1.87938564,2581,82,0,590,587,3,21573,21550,23,154,153,1,100
aa522a5489bed408573b375f897b8385d06e3cce,19,445,235,210,0,0,0,1,95,179,4,12,3.208042469,5353,41,3,1074,1035,39,45752,44215,1537,395,379,16,100
772e38779ec1e8be4fd4aa067247299ca584bdc5,2,62,31,31,0,0,0,8,26,246,1,2,0.975760642,347,83,1,30,28,2,2941,2742,199,12,11,1,100
c980aa800afdcf38fcdafe004586abb3bafd4732,4,42,18,24,0,0,0,2,8,69,1,2,0.766509507,1039,42,4,238,232,6,8663,8501,162,72,70,2,100
54a88b8146ddaad9e230a8f090fff0f825cc778c,3,36,26,10,0,0,0,5,27,133,3,3,0.964086328,791,84,0,175,173,2,5840,5742,98,87,87,0,100
df92d2b364f96b4cc8e43ad35c8eb362a45afe8e,1,2,1,1,0,0,0,11,35,210,1,1,0,293,85,1,46,46,0,2598,2589,9,13,13,0,100
2c9295a9dac598336688f6389d158f6722d1686f,11,440,28,412,4,0,4,4,9,248,4,10,2.819714502,1281,43,0,217,187,30,12033,10201,1832,93,66,27,99.58906557
b11e0570f74c7355b0e4ef648f80c1e6ca9a3523,12,77,7,70,0,0,0,3,81,104,5,9,2.923575281,2521,44,1,349,338,11,21359,20892,467,180,175,5,100
cec771caad366f886a3806eac9e5752273ed6afe,4,101,27,74,0,0,0,4,7,344,2,3,1.639996631,815,9,0,117,112,5,7502,7123,379,40,37,3,99.92896466
03c4ca6fe1ebb5145ecc4f5568b8e87b818baa1a,0,0,0,0,0,0,0,0,0,0,0,0,0,0,10,1,0,0,0,0,0,0,0,0,0,100
3d61e96fa2076171f016529502f7c15dec2cb4a0,10,61,10,51,0,0,0,4,82,0,5,7,2.3266399,2476,45,2,346,339,7,20774,20410,364,174,171,3,96.3765409
9e25ede1f871ab86db50d4ff4833b0f85901f03d,29,7,4,3,0,0,0,1,2,11,2,6,0.684038436,2033,11,2,474,84,390,12750,3875,8875,273,43,230,90.65255732
fd384a7a3b1da39dbae603c032bd3c23eaf0b134,8,215,4,211,0,0,0,4,83,221,5,6,2.088813171,2467,46,3,379,354,25,22241,20678,1563,185,173,12,96.5143121
1b7708fa1e2258c0aca759684dad1d0dbe91bd5b,1,19,14,5,0,0,0,5,5,0,1,1,0,137,86,2,17,16,1,1021,995,26,11,11,0,100
3f50879971453f4ced61fa24c4f4a425cbf2631e,12,599,58,541,6,0,6,1,84,64,6,7,3.199124829,3252,12,3,621,582,39,30750,28090,2660,281,262,19,98.30871334
49fa46e29540a869c3a669f779f662f5543b8d10,9,396,122,274,1,0,1,4,12,7,3,7,2.689358437,1549,13,4,258,231,27,13006,11575,1431,116,94,22,99.80773339
1f28bde6f49aedd2ca95181f483c609a5304aecc,6,256,1,255,2,0,2,2,13,40,2,5,1.692815397,806,47,4,121,93,28,7468,6243,1225,68,50,18,99.72257789
37cb056b93b6e414172e12605c33c27223d2800e,6,121,88,33,0,0,0,3,36,188,3,5,1.260218494,1703,193,0,323,313,10,13970,13805,165,110,108,2,100
732395765712994a2c517291a84793b8d99e8c26,1,11,11,0,0,0,0,3,11,0,1,1,0,251,87,1,23,23,0,1798,1787,11,21,21,0,100
51a09451e9b1438909a1cc0393b05343b6d11714,0,0,0,0,0,0,0,0,0,0,0,0,0,0,14,5,0,0,0,0,0,0,0,0,0,100
c79e5e4d3a68edb021db28c68f6797c2a3641efe,20,438,109,329,1,0,1,6,85,169,7,15,3.157462949,4324,15,5,618,579,39,39984,37961,2023,342,317,25,99.87201365
3e7e08f77225d09250d0ac8a9d9fa38c5f69c3f5,5,169,71,98,0,0,0,1,21,144,4,4,1.505425039,1577,16,2,303,287,16,14049,13289,760,112,106,6,99.97867804
2f1aa291ffd1e62c8186638e62115c0df0c393a5,6,79,41,38,0,0,0,6,86,12,4,5,1.416222863,2640,17,3,407,399,8,23356,23104,252,206,203,3,100
c36a1397cee55f4ba501c45f9580fc42472e441e,10,113,14,99,0,0,0,5,87,14,5,7,2.440643044,3458,18,4,503,490,13,30881,30257,624,278,271,7,97.18595227
f241255f8c72921600ef2e567cd5ab9f8afd7056,0,0,0,0,0,0,0,0,0,0,0,0,0,0,48,1,0,0,0,0,0,0,0,0,0,100
ffda98cc1dfcc2ac64928ad3d3ab82533e5dcf6f,0,0,0,0,0,0,0,0,0,0,0,0,0,0,49,1,0,0,0,0,0,0,0,0,0,100
617d5ab9492cb8c8a07fda0411a9a7826cff091c,5,78,15,63,0,0,0,12,46,201,4,5,1.211907827,1987,19,5,300,288,12,16475,16115,360,113,109,4,99.40433643
d1052bf0a8a0ec13b859131b4dccec31d15cbbc6,8,100,56,44,0,0,0,5,17,142,3,7,1.938158498,1585,45,0,243,238,5,12202,11859,343,114,110,4,91.98482933
cdb5404aece64abe35c79dbf9cfa7ce9085e2cbc,5,284,70,214,2,0,2,1,47,5,3,3,1.676695968,1317,50,2,207,185,22,12026,10857,1169,83,71,12,91.90692969
0488de326c9df1cc4ab67678fda45d2880dce3ee,1,1,2,1,0,0,0,6,13,14,1,1,0,273,46,1,51,51,0,2072,2082,10,16,16,0,100
299b82701390c186e17a65daed44b8ff52dd6fa6,3,37,2,35,0,0,0,5,17,16,2,3,1.478534948,832,51,3,101,97,4,7540,7301,239,51,48,3,100
b48f2df4868350c4a69d26f52ac1f69971722762,3,62,65,3,0,0,0,1,88,50,2,3,1.031527806,1268,20,2,184,182,2,11236,11288,52,116,115,1,100
9946758eac38d985a0c50fddee4267e8e320f7a2,8,335,198,137,2,0,2,2,89,12,3,4,2.444210503,2957,52,4,465,454,11,25596,24982,614,242,239,3,96.5509365
3f1e0479213d74a71ed69d8877fc6a479e34b1e1,8,152,125,27,0,0,0,6,90,14,4,6,2.438975696,3063,47,2,486,480,6,26735,26604,131,255,249,6,99.8901823
bc4dcf9cf6965467221faae3d4e963e3bfc83910,2,9,10,1,0,0,0,2,91,4,2,2,0.998000884,1678,48,3,254,254,0,14736,14730,6,138,138,0,100
4f42dc117026a419d5f882c598ea2ff122f5a5c0,18,420,212,208,1,0,1,5,92,54,6,12,3.152086219,6465,21,1,1093,1070,23,55149,53691,1458,458,450,8,96.50205761
42d379463ddb7210f05153c318b1be66dbd1d5be,11,165,62,103,0,0,0,5,50,0,3,7,3.130817805,3444,22,2,524,509,15,30111,29326,785,241,234,7,94.03592814
ccc343fa84bcb257f69eb64b942e58eae2efd504,3,65,21,44,0,0,0,7,15,1377,2,3,0.900096823,465,53,2,80,75,5,3763,3488,275,35,33,2,100
9fdfe713f8d72e63fb45aaed93071cbde39b9eec,11,74,44,30,0,0,0,10,31,573,3,8,2.66239079,2904,23,3,314,314,0,31107,30524,583,135,135,0,100
8054727ce160bf7e9707cee86b6ea2b77897a26e,13,279,19,260,1,0,1,3,93,11,7,10,3.241961803,3720,49,3,601,563,38,32495,30919,1576,311,289,22,97.64938489
7c5822cf50d07cb48ae83f3ebc761926b3bc5863,12,214,76,138,0,0,0,2,94,46,6,8,2.772708043,5090,24,4,852,840,12,44862,43864,998,352,344,8,97.58877685
3f6b6902407b5a8c4c600cab0d9fb92a935bd33b,5,62,63,1,0,0,0,2,9,217,2,4,1.842410123,1202,25,5,238,238,0,9624,9540,84,81,81,0,100
86086653134d9c0ccd854237f40a6a15276c0a41,11,252,149,103,0,0,0,2,95,3,5,6,2.94721693,4230,26,6,600,587,13,37496,36795,701,313,302,11,95.89977221
ecf9aee3e61815877f3954455158dda53c5c1bf7,4,16,10,6,0,0,0,3,96,42,3,3,1.738149333,2246,50,3,302,302,0,19618,19520,98,154,154,0,100
44da87023dbbcc19aa3c1e4037dc0aff2cd51087,6,96,36,60,0,0,0,3,24,7,3,4,2.404134705,1955,51,4,288,279,9,17694,17323,371,139,135,4,100
ae510daa2fa693e0900a305533cb59bb11b2bc77,2,16,4,12,0,0,0,17,97,2,2,2,0.286396957,1344,27,6,191,191,0,12265,12129,136,114,114,0,100
6e162747b090b6433d2e1813938d4f28f6926af3,5,51,24,27,0,0,0,5,17,37,2,5,1.748044475,1824,28,2,310,303,7,14524,14343,181,115,115,0,100
3c011688bf910ee47786afa6f6c582d9c8d356ef,9,84,39,45,0,0,0,6,30,26,4,6,2.721508948,2421,29,3,392,384,8,20039,19728,311,208,206,2,100
c67556852cee96a91613df53228025adf40b9064,11,50,138,88,0,0,0,16,98,98,7,9,2.710752535,3734,30,3,534,548,14,30754,31330,576,280,285,5,100
9da6d380491f375749fa3f39f995563bf6834240,2,26,3,23,0,0,0,6,24,8,2,2,0.735508582,687,52,0,75,72,3,6604,6443,161,38,37,1,100
e132065f1e814f86e0dbc21f473e19c695a01a21,3,11,13,2,0,0,0,7,31,28,3,3,1.236440502,1075,31,4,205,205,0,8272,8317,45,96,96,0,100
2b0ad65a465ef5eb13ecefcb1993cccaa270b1ba,13,103,42,61,0,0,0,6,99,6,7,9,3.149843964,4368,53,1,646,638,8,37871,37474,397,354,349,5,99.9349523
21f0b69782d4e9008088c491d5101d89bba09bd6,1,1,1,0,0,0,0,3,14,0,1,1,0,275,32,5,48,48,0,2205,2197,8,19,19,0,100
ed2f3fb861bfd5138fd6b9b8f4b5a8314d9ade4f,1,7,4,3,0,0,0,3,15,18,1,1,0,275,54,2,49,48,1,2226,2205,21,19,19,0,100
29cbcd79b354a0672421073db4feefc5ee73da38,1,100,9,91,0,0,0,3,5,66,1,1,0,151,55,3,19,12,7,1738,1059,679,19,12,7,99.9349664
3c4957f6e5bc758f33dce20a8a7396f16a1bd2c0,4,15,1,14,0,0,0,6,33,20,2,3,1.371640762,1865,33,5,290,289,1,16333,16247,86,139,139,0,100
a5c312fcc7fec8ff338a5150f23d54baf88c52d2,1,1,1,0,0,0,0,3,16,0,1,1,0,671,34,6,104,104,0,5655,5664,9,36,36,0,100
fde979f2cf58bc6ac1b736bd2349d5e93e843f8c,2,17,14,3,0,0,0,6,27,1,2,2,0.823811633,756,88,0,82,82,0,7034,6993,41,39,39,0,100
993861c850ba38d7a3d7313c290ec614c071928f,1,11,23,12,0,0,0,4,17,0,1,1,0,280,56,4,49,49,0,2166,2241,75,19,19,0,100
0825d80a638652bc68119425e910f969602c83c6,5,97,118,21,0,0,0,4,24,28,3,5,1.402241065,1740,89,1,266,271,5,14236,14338,102,96,97,1,100
4db747682281a6e1cb55a6d4d812da6e5199e8c6,2,6,28,22,0,0,0,3,18,18,2,2,0.672294817,910,57,3,119,123,4,7202,7428,226,55,55,0,99.80561555
1565bde416e8908954195beeec5812590f2336f4,0,0,0,0,0,0,0,0,0,0,0,0,0,0,57,3,0,0,0,0,0,0,0,0,0,100
7628ca1edf9c440c9514b74e283d2ae77811dafe,6,39,8,31,0,0,0,3,24,839,3,5,2.524383736,1089,11,0,247,245,2,8772,8520,252,86,85,1,100
7fe2c33245b3032188a94f20ea83797a2843e417,0,0,0,0,0,0,0,0,0,0,0,0,0,0,11,0,0,0,0,0,0,0,0,0,0,100
b23b0a9606d2c6e8145442d97b42506314726bc8,3,11,4,7,0,0,0,4,25,13,2,3,1.399581231,1165,58,4,179,177,2,9981,9944,37,60,60,0,100
2368bccf19e164328e507df0b053a7720ac4cf6c,0,0,0,0,0,0,0,0,0,0,0,0,0,0,58,4,0,0,0,0,0,0,0,0,0,100
bf027e16995a0487296517fc0024831733e4002a,3,8,19,11,0,0,0,4,100,98,3,3,1.173012585,1855,35,2,279,280,1,15985,16035,50,150,151,1,100
6c105297e05a49e09828c4caa23433b2f38d7846,0,0,0,0,0,0,0,0,0,0,0,0,0,0,35,2,0,0,0,0,0,0,0,0,0,100
217ea0099de4302c9e443eabb35820e64a0e98cc,1,35,35,0,0,0,0,7,22,22,1,1,0,325,59,5,62,62,0,2456,2456,0,19,19,0,100
b93639cfa915eeae1380e636692c9b90d27b69a5,0,0,0,0,0,0,0,0,0,0,0,0,0,0,59,5,0,0,0,0,0,0,0,0,0,100
d826852bf7e5152c93efa909a8edaeb91b2f948e,1,1,1,0,0,0,0,17,96,326,1,1,0,1566,36,3,371,371,0,13240,13234,6,93,93,0,100
3a78efe73ee176b1458d6c57283b7695745f572c,0,0,0,0,0,0,0,0,0,0,0,0,0,0,36,3,0,0,0,0,0,0,0,0,0,100
f9fdf0f7e154958f9ae69cb488c395f4361d7d56,1,15,6,9,0,0,0,8,20,925,1,1,0,230,62,0,48,46,2,1881,1855,26,12,12,0,100
25f423ce9982e702fde614411dce91ac4bcecb89,1,2,0,2,0,0,0,1,8,80,1,1,0,180,37,2,28,28,0,1513,1486,27,11,11,0,100
06f5fa5bef16145418780b30ff2a7cb8a8e5eb1b,1,6,15,9,0,0,0,8,19,3,1,1,0,236,37,2,46,48,2,1855,1881,26,12,12,0,100
368fe538ea8cb6b60f89e4300852bb130bd201cd,2,16,7,9,0,0,0,3,20,491,2,2,0.426228657,464,60,0,67,65,2,3619,3593,26,31,31,0,100
f0a678089a306f282e52adc777b8d0aaa31d95ca,1,6,15,9,0,0,0,8,19,3,1,1,0,236,60,0,46,48,2,1855,1881,26,12,12,0,100
9cdcbc01df821c9482b1a22c8af3c5b389c6eee1,2,21,7,14,0,0,0,8,20,652,2,2,0.811278124,313,61,1,60,58,2,2456,2418,38,22,22,0,100
12106afa8f64aca1b45651b1dac8ca8a686e1655,1,6,15,9,0,0,0,8,19,3,1,1,0,236,61,1,46,48,2,1855,1881,26,12,12,0,100
3fd11e80ebba64a22b18e5e3baec1ca7e1e54e99,2,17,6,11,0,0,0,4,21,489,2,2,0.426228657,877,62,2,148,146,2,7283,7248,35,47,47,0,100
510d89e4c961384efb7d655b150e1bd8bc21fdfd,1,6,15,9,0,0,0,8,19,3,1,1,0,236,62,2,46,48,2,1855,1881,26,12,12,0,100
3dc7efe507d188543f08d6fafdb7b66de8f05703,2,18,8,10,0,0,0,8,20,474,2,2,0.706274089,412,63,3,76,74,2,3398,3368,30,23,23,0,100
bc96e1a653b2428a721b3687c6e2f761003898ae,1,6,15,9,0,0,0,8,19,3,1,1,0,236,63,3,46,48,2,1855,1881,26,12,12,0,100
9e9cb7a21d138e7489198472f3296ec237aac969,9,266,55,211,2,0,2,7,34,426,5,7,2.157587464,1350,63,1,248,222,26,11936,10943,993,115,107,8,99.89254245
1ded6415343b550af609fc452d5b98bc2a88aad8,0,0,0,0,0,0,0,0,0,0,0,0,0,0,0,0,0,0,0,0,0,0,0,0,0,100
23229a900ceb59a4759daad8604cf2fdb24a3660,9,55,266,211,0,0,0,7,33,91,5,7,2.157587464,1488,0,0,222,248,26,10943,11936,993,107,115,8,99.89254245
ded34d4bdd6367e7b271fe07800d7a856f93abfc,11,293,73,220,2,0,2,7,34,357,6,9,2.483301145,2098,64,4,367,339,28,18137,17102,1035,157,148,9,99.89254245
3eea94b833187524153b294ad025aba5cb20bf55,9,55,266,211,0,0,0,7,33,91,5,7,2.157587464,1488,64,4,222,248,26,10943,11936,993,107,115,8,99.89254245
92d2589994e1eaff380ac56164e070033a6af909,10,269,56,213,2,0,2,7,34,409,5,8,2.226762709,1678,38,0,328,301,27,14704,13705,999,131,123,8,99.89254245
017b0676fb0c5d88b2489f56ca16da386541c545,9,55,266,211,0,0,0,7,33,91,5,7,2.157587464,1488,38,0,222,248,26,10943,11936,993,107,115,8,99.89254245
c215234e642aaac263248cec722514dc780751bf,10,274,59,215,2,0,2,7,34,403,5,8,2.303649119,1733,39,1,310,283,27,14730,13714,1016,135,127,8,99.89254245
51f1ec9c347603be348bb14875946ac2992125e7,9,55,266,211,0,0,0,7,33,91,5,7,2.157587464,1488,39,1,222,248,26,10943,11936,993,107,115,8,99.89254245
52f308aa262c413c76b7d06bb159930d367ea3a3,14,308,63,245,2,0,2,6,34,306,7,11,2.706699986,3107,40,1,506,474,32,27816,26482,1334,219,210,9,99.89254245
f1a8106a228691647480e62669d27c02f249ccfa,9,55,266,211,0,0,0,7,33,91,5,7,2.157587464,1488,40,1,222,248,26,10943,11936,993,107,115,8,99.89254245
a2ef339a2686454fe51eed2fc2bf363c0dd71d70,0,0,0,0,0,0,0,0,0,0,0,0,0,0,54,0,0,0,0,0,0,0,0,0,0,100
7800d342c8da1ad6bbc4940bf57b255b92031c3f,9,266,55,211,2,0,2,7,34,426,5,7,2.157587464,1350,41,0,248,222,26,11936,10943,993,115,107,8,99.89254245
90cb996f5c555dae6ece54ca496d26d2345f15b9,1,1,1,0,0,0,0,15,25,390,1,1,0,374,0,0,77,77,0,2900,2890,10,28,28,0,100
bfd1805ba13e7755f01754edd062da3dc59aae3b,6,32,7,25,0,0,0,4,16,788,2,3,2.04910534,1435,54,0,268,266,2,11435,11170,265,99,98,1,100
84186f09e17aba7497be4a2bdec6f8b119405b0b,10,56,267,211,0,0,0,7,33,151,5,8,2.198553545,1862,55,0,299,325,26,13833,14836,1003,135,143,8,99.89254245
d07a2f7054d02b11842289911d4c82ed2a31aaa6,11,275,59,216,2,0,2,7,34,385,6,8,2.335045498,2095,55,1,400,372,28,17724,16688,1036,170,162,8,99.89254245
32806e105ff5871451e605a5c3a28bac5e2df283,10,56,267,211,0,0,0,7,33,151,5,8,2.198553545,1862,56,1,299,325,26,13833,14836,1003,135,143,8,99.89254245
82c1acc97cb8bd5ea2ee1d2d07198f74712f626b,0,0,0,0,0,0,0,0,0,0,0,0,0,0,90,0,0,0,0,0,0,0,0,0,0,100
736b3bab03b2213a797fecc4aef2251721b7e150,0,0,0,0,0,0,0,0,0,0,0,0,0,0,91,1,0,0,0,0,0,0,0,0,0,100
f67d835d1fa20c27d010131b3d982a5ee97b5a58,0,0,0,0,0,0,0,0,0,0,0,0,0,0,92,2,0,0,0,0,0,0,0,0,0,100
fb5efb33d1068522e1aec272226f6d61e2d100ca,0,0,0,0,0,0,0,0,0,0,0,0,0,0,93,3,0,0,0,0,0,0,0,0,0,100
645e5711039c082b18cd70f4482fbca0a73d85f8,0,0,0,0,0,0,0,0,0,0,0,0,0,0,90,0,0,0,0,0,0,0,0,0,0,100
6c91289117d8dd7ba75aca688348a120e5fd54f9,10,267,56,211,2,0,2,7,34,422,5,8,2.198553545,1724,91,1,325,299,26,14836,13833,1003,143,135,8,99.89254245
280328cb53f1280a8d83811ac1947aa7e75ed535,0,0,0,0,0,0,0,0,0,0,0,0,0,0,96,6,0,0,0,0,0,0,0,0,0,100
7141ca3286e46c433ab881ca853ee0016a13bc76,0,0,0,0,0,0,0,0,0,0,0,0,0,0,97,7,0,0,0,0,0,0,0,0,0,100
03b3706bf53c5825147d90502ba2f3db11f2ca27,0,0,0,0,0,0,0,0,0,0,0,0,0,0,0,0,0,0,0,0,0,0,0,0,0,100
d91fc045cec264ff3f44bef6bdf33ab03ddf1c74,0,0,0,0,0,0,0,0,0,0,0,0,0,0,48,0,0,0,0,0,0,0,0,0,0,100
fc74b9d9aa7c4966a171d2181e00381cd01622e8,2,67,6,61,0,0,0,3,20,2431,1,2,0.30642473,234,0,0,57,51,6,2321,1888,433,16,14,2,100
a819b5b56717399b53e14a5f5a8ea017279bb204,1,6,1,5,0,0,0,10,14,1873,1,1,0,253,0,0,30,30,0,2115,2067,48,11,11,0,100
3c2d79497832ce7c28dd672e4f9b161a527b50f2,1,10,8,2,0,0,0,2,3,3700,1,1,0,64,1,1,7,7,0,488,474,14,7,7,0,100
dc470882f983906c5601400590a9c1003eb27109,1,5,1,4,0,0,0,5,6,1864,1,1,0,108,1,1,15,15,0,758,764,6,6,6,0,100
d7a4eeb4ea19f731a984f40a80cb081995e57521,10,43,19,24,0,0,0,7,23,1815,3,5,2.763925208,1421,49,0,258,255,3,10919,10694,225,96,95,1,99.91412623
e7364bd55bb186097cf6f2a184871a84a0379fda,1,6,0,6,0,0,0,5,7,2716,1,1,0,9,2,2,2,1,1,91,63,28,2,1,1,100
41e4544b9eebae9f13a939315ab94bdcf9b1dfe0,0,0,0,0,0,0,0,0,0,0,0,0,0,0,206,0,0,0,0,0,0,0,0,0,0,100
f32f4045b6e7c03ad64a56b5a8722966cfedddec,0,0,0,0,0,0,0,0,0,0,0,0,0,0,50,1,0,0,0,0,0,0,0,0,0,100
dfd4894ce6a96f35bce93f66edb811f80b366f67,0,0,0,0,0,0,0,0,0,0,0,0,0,0,0,0,0,0,0,0,0,0,0,0,0,100
1a5b4f6a509187498a267b0e375c6a065f947af5,0,0,0,0,0,0,0,0,0,0,0,0,0,0,1,1,0,0,0,0,0,0,0,0,0,100
272e999c1bd5f288470adeeb6ff7d6af96ca9101,1,10,0,10,0,0,0,5,8,3576,1,1,0,116,0,0,41,40,1,823,808,15,8,7,1,100
411d90c2ffb59559770d23d4bd2f7675e46392e6,1,1,0,1,0,0,0,11,17,1620,1,1,0,410,0,0,38,38,0,3854,3847,7,33,33,0,100
90c955db16739ce6b6671576264fc89ebcdde009,1,10,8,2,0,0,0,18,81,1748,1,1,0,1169,2,0,301,300,1,9219,9205,14,68,68,0,100
39f64a08e4b1ef0fbd33f4eb1ae2d69ad408d12b,2,2,5,3,0,0,0,3,7,2467,2,2,0.863120569,187,3,1,35,37,2,1414,1438,24,16,16,0,100
20eb735da21a29dd8a21744fdb8097479637a962,1,20,0,20,0,0,0,8,10,2264,1,1,0,376,1,0,18,17,1,4039,3900,139,15,14,1,99.97853156
2cc0438e92f0af21e9a80929bd213b32e5bea6c1,0,0,0,0,0,0,0,0,0,0,0,0,0,0,1,0,0,0,0,0,0,0,0,0,0,100
00a2b3a95aee3fc68a8adf3f04c988df205fe4fe,1,8,0,8,0,0,0,18,97,1635,1,1,0,1566,0,0,374,371,3,13317,13240,77,93,93,0,100
470e5e9f5de9ba1b6149dec60e87d3a04270eda3,4,21,8,13,0,0,0,5,13,1261,2,3,1.87076753,1053,0,0,201,198,3,8285,8248,37,76,75,1,100
