CommitID,NMF,TotalAddLines,TotalDeleteLines,LC,FileAdd,FileDelete,NAD,NDEV,NUC,AGE,NS,ND,Entropy,LT,EXP,REXP,CommitComplexity,LastCommitComplexity,CFC,CommitTokenCount,LastCommitTokenCount,NCC,CommitMethodNum,LastCommitMethodNum,NMC,a2a
b7c044dc0c472a8a747541889e0cc450585e1d92,6,11,4,7,0,0,0,1,2,4,1,4,2.440223929,822,6,4,131,125,6,6859,6609,250,56,52,4,77.14285714
4e3e255cd97f083679a14a46b27e35b3908c6310,0,0,0,0,0,0,0,0,0,0,0,0,0,0,7,5,0,0,0,0,0,0,0,0,0,100
5339db364918df7a20fd4345558facc5f71dda91,21,1594,320,1274,8,0,8,1,3,9,1,6,3.491723624,1181,8,3,295,161,134,15920,9212,6708,126,74,52,75.82417582
07f5feeeabf881ada27c476fa919941345814a2b,0,0,0,0,0,0,0,0,0,0,0,0,0,0,0,0,0,0,0,0,0,0,0,0,0,100
6dd23719d845436af4759fe8669154ff8074e1a3,7,7,7,0,0,0,0,2,4,21,1,2,2.807354922,731,1,1,98,98,0,4666,4659,7,51,51,0,100
6dbd767dac486c6c8d435eb8dda2cf55cfe90bc0,2,60,17,43,1,0,1,1,2,12,1,2,0.964547659,73,2,2,18,14,4,628,474,154,9,7,2,92.72727273
b028bd35924aa5843e4913852c63b11e683cb27f,2,9,1,8,0,0,0,1,3,0,1,2,0.721928095,91,3,3,19,18,1,676,628,48,10,9,1,100
e2539dae3971d51614c892db31b5ed423ac3c2c3,3,19,11,8,0,0,0,1,4,8,1,3,1.521928095,666,4,4,111,110,1,6164,6129,35,44,43,1,100
0cbf4863ba03502dedc0d6f77360224356f461ae,8,29,59,30,0,0,0,2,5,16,1,4,2.740288576,1515,5,5,238,242,4,12505,12657,152,92,92,0,100
ad706e4c3be562349486f55db5ef4b9f1bfb9c03,2,0,2,2,0,0,0,2,5,0,1,2,1,186,6,6,17,17,0,1249,1249,0,7,7,0,100
ceb992ee1784703338c2c51273fc3e25a07939fa,26,6099,0,6099,26,0,26,1,1,0,1,2,4.335241157,0,9,0,1105,0,1105,31872,0,31872,495,0,495,66.66666667
73ce7a109aaa05a1ccb3816f1953301d22334bd2,2,3,3,0,0,0,0,2,2,56,1,1,0.918295834,40,0,0,0,0,0,48,48,0,0,0,0,100
9c76557b8c373fad8bb5c8bc91411c27abe4f0f0,6,506,1767,1261,1,0,1,2,2,60,1,2,2.329701622,1932,1,1,196,523,327,5746,15765,10019,80,215,135,93.69369369
d085b9410dd196cb65976fd984d3ca5c40063434,3,63,0,63,0,0,0,1,3,25,1,2,1.023037066,768,2,2,188,174,14,5864,5461,403,67,64,3,100
67534ed15fe28fe74751642509f5d6bbc38a353d,0,0,0,0,0,0,0,0,0,0,0,0,0,0,3,3,0,0,0,0,0,0,0,0,0,100
5b40e01dd203d3e84bb27c6ab649e82ead952120,5,110,1,109,0,0,0,2,2,80,1,1,2.254696782,654,4,4,135,111,24,3514,2997,517,80,59,21,100
dcf942cdd1c868009629cd587bb6e87ba907311d,1,31,12,19,0,0,0,2,3,4,1,1,0,120,5,5,30,29,1,658,634,24,20,19,1,100
a77e64d71ed71cbe74a7c243379b1144d6bd9acd,12,1358,6,1352,8,0,8,1,3,35,1,4,2.799677962,203,0,0,173,32,141,7186,836,6350,83,24,59,88.30188679
6011291b44c05112381cde6ce68f2e4e76fe45d3,0,0,0,0,0,0,0,0,0,0,0,0,0,0,6,6,0,0,0,0,0,0,0,0,0,100
dab28f8483ef5079b24af337fc76a1fb66cdbb26,2,5,5,0,0,0,0,2,4,8,1,1,0.970950594,245,7,7,58,58,0,1434,1434,0,40,40,0,100
e82af530b0dc26f4cdc1ce178319b4a79a7bad4a,2,54,2,52,0,0,0,2,4,50,1,2,0.940285959,171,8,8,41,37,4,1261,929,332,29,27,2,100
3f683ad8318cae4c7a4297a663761a85077811f8,4,243,0,243,4,0,4,1,1,0,1,2,1.915293518,0,9,9,31,0,31,922,0,922,16,0,16,90.81967213
9a1a44b69de5adc9ed40b182bab45a9ba65917a8,1,2,2,0,0,0,0,3,4,5,1,1,0,24,10,10,0,0,0,77,77,0,0,0,0,100
e3d68a056778871f98a8ba4f6c9dacf1391cb6a4,0,0,0,0,0,0,0,0,0,0,0,0,0,0,11,11,0,0,0,0,0,0,0,0,0,100
e63dd05d6d37e241bd55346aaef5ddf6e2d9bb1f,2,3,7,4,0,0,0,1,2,0,1,1,0.970950594,120,12,12,22,26,4,529,561,32,14,14,0,100
0a7717fc02e4064b6b10275d9eafeccdcbf2e33d,2,542,25,517,1,0,1,1,2,49,1,2,0.618380286,169,1,1,150,34,116,4539,860,3679,66,16,50,99.35483871
1b2e4e35ed2b2dce279160ea7b4541182b026ca8,11,465,1,464,10,0,10,1,5,0,1,2,3.22562131,24,13,12,32,0,32,1704,77,1627,15,0,15,86.26865672
a8a33322bbbbeb10209faefb4aeb4161528b689d,17,315,294,21,0,0,0,2,6,118,1,6,2.940269147,1885,2,2,269,276,7,14372,14614,242,119,119,0,87.96296296
c1095f4ccc9422669a97403090c20a70ae36b18a,24,77,72,5,0,0,0,4,7,16,1,5,4.075203531,2977,0,0,475,469,6,16517,16492,25,214,210,4,100
6a401e9da696494e2e3a2d8cce82dba326d9e8d7,1,23,0,23,0,0,0,2,4,10,1,1,0,132,10,0,36,31,5,969,824,145,21,19,2,100
3f526642caa2177107a632a131d6a9e8e5e23f0b,74,0,0,0,0,0,0,1,1,0,1,10,0,7740,14,13,1444,0,1444,51813,1184,50629,667,0,667,11.96013289
119a39d4f35126ffd2921175e6a96367ef5adc46,12,387,174,213,0,0,0,2,2,0,1,1,3.223164818,2278,3,3,430,423,7,11246,11094,152,194,187,7,100
6f320d75de13a19542613c35f96ade30369a80aa,0,0,0,0,0,0,0,0,0,0,0,0,0,0,15,14,0,0,0,0,0,0,0,0,0,100
06b7c8c8b9b0f9d882737a0c4f218f62194e45f4,0,0,0,0,0,0,0,0,0,0,0,0,0,0,16,15,0,0,0,0,0,0,0,0,0,100
72116a08a73d0642401bbdad1f728109296c2665,0,0,0,0,0,0,0,0,0,0,0,0,0,0,17,16,0,0,0,0,0,0,0,0,0,100
f115e352d16593675f37fa060315843d454170a1,12,167,234,67,0,0,0,1,3,0,1,3,3.087882882,1405,18,17,291,289,2,8284,8262,22,154,157,3,94.84848485
d907cbfd82e3c95f5c4871b8e36190582d2f2ea1,14,647,22,625,10,0,10,1,3,0,1,2,3.159179087,189,19,18,93,18,75,3239,720,2519,62,9,53,94.05405405
70123b4fe00f19b99c098f012b77439ffe5d8356,1,2,2,0,0,0,0,1,2,0,1,1,0,28,20,19,0,0,0,91,91,0,0,0,0,100
bca581ef8a39e41b7ddba8322dc05f9d40d6e3cf,18,467,530,63,0,0,0,2,4,0,1,7,3.314746331,2479,4,4,387,397,10,16363,16935,572,183,188,5,90.13333333
76f705e887659466f275f912fd3babd78d75e53c,2,3,4,1,0,0,0,2,2,8,1,2,0.863120569,204,5,5,23,24,1,1332,1343,11,9,9,0,100
3e44d3c5eff7f22005619ef1c96932b67544200a,0,0,0,0,0,0,0,0,0,0,0,0,0,0,11,1,0,0,0,0,0,0,0,0,0,100
8ea53775a2b4c7ade8118ec4889c83950cd805ab,5,38,98,60,0,0,0,1,3,20,1,4,1.893917172,1241,6,5,206,211,5,11207,11208,1,63,67,4,95.85635359
9aaf641bb0eb632f8c07ceff2adf2e75537c40e2,136,14981,0,14981,136,0,136,1,1,0,1,33,6.617425359,0,1,0,1628,0,1628,69955,0,69955,799,0,799,52.31213873
9b5c85f314d2fda7ff5c30e43990de5ba3ba8758,3,4,210,206,0,0,0,1,2,0,1,2,0.210198475,657,2,1,91,104,13,3305,4870,1565,36,44,8,99.50738916
fd82a6ef176606e8dff5619456a4ac0f12147204,0,0,0,0,0,0,0,0,0,0,0,0,0,0,3,2,0,0,0,0,0,0,0,0,0,100
d0667bef27c50163b39e85228dcbd896b05d95a6,0,0,0,0,0,0,0,0,0,0,0,0,0,0,4,3,0,0,0,0,0,0,0,0,0,100
0e8966c8756c287d8ae68bbcec954b9d43ca1a96,0,0,0,0,0,0,0,0,0,0,0,0,0,0,5,4,0,0,0,0,0,0,0,0,0,100
229e553847f291a9d30f5fcaf53e16dc9e263841,5,0,0,0,0,0,0,1,1,0,1,1,0,122,6,5,20,0,20,990,205,785,12,0,12,98.02371542
470d92172684c0fb0818ab6f51cbedafa4388c54,0,0,0,0,0,0,0,0,0,0,0,0,0,0,7,6,0,0,0,0,0,0,0,0,0,100
73a8c821a3f2841dcd2dceeec8cbb07ff1d48007,0,0,0,0,0,0,0,0,0,0,0,0,0,0,8,7,0,0,0,0,0,0,0,0,0,100
b5d812fc2b488aae2ae6c8eeef8f17a713be124a,4,338,0,338,4,0,4,1,1,0,1,1,1.876206981,0,9,8,23,0,23,1463,0,1463,11,0,11,98.82352941
8f47e46fb0beb28f910cdf0d83dc4e9327ffa1b2,1,92,43,49,0,0,0,1,2,9,1,1,0,103,10,9,23,14,9,1153,792,361,7,4,3,100
85740d1aaa22638acbec3b9b61260cf4e3d5c5ff,24,173,285,112,0,0,0,1,3,0,1,11,4.173094557,4058,11,10,756,807,51,28903,30007,1104,290,291,1,100
1ebc724f8ca2d058440c7f1b5fed3231808e9f76,0,0,0,0,0,0,0,0,0,0,0,0,0,0,12,11,0,0,0,0,0,0,0,0,0,100
bb4fa3ab1b48e21fa39724eb63e6d59dd353e8e7,5,23,29,6,0,0,0,2,3,53,1,4,2.194342968,498,13,12,55,55,0,3301,3207,94,26,26,0,100
5cf566bb6d8329811e1fc4435c155312ce17ebd9,0,0,0,0,0,0,0,0,0,0,0,0,0,0,14,13,0,0,0,0,0,0,0,0,0,100
09ea2054ef4fb8624edcb60ec5ba469314f03a2d,2,25,8,17,0,0,0,1,2,14,1,1,0.994030211,120,15,14,12,11,1,1103,985,118,4,4,0,100
318435c056a91da39c05ab1aec9fb165fb0cadda,1,3,3,0,0,0,0,1,3,14,1,1,0,117,16,15,16,16,0,1140,1140,0,9,9,0,100
d72f4c43d2fb349d5ad630769eb5527ee32e019c,1,1,2,1,0,0,0,1,3,21,1,1,0,56,17,14,3,3,0,466,473,7,2,2,0,100
ef3df78081536699055a9e3eb1a7b11b94af8a28,0,0,0,0,0,0,0,0,0,0,0,0,0,0,18,15,0,0,0,0,0,0,0,0,0,100
4395e08efe0aad331d9d15c062af5ae667fcdc74,9,517,11,506,8,0,8,1,4,0,1,1,3.048807145,55,19,16,42,3,39,2554,466,2088,30,2,28,97.40500463
0a099d9f84a1249cf2d92af418d34145c4250184,5,22,14,8,0,0,0,3,4,60,1,3,2.155221529,399,20,16,37,37,0,2761,2645,116,17,17,0,100
9bc5b4066c95154ba5bce43559c2078a054f9cf9,3,78,11,67,1,0,1,2,5,24,1,2,1.040554277,499,7,0,81,76,5,4583,4318,265,23,20,3,99.09255898
27a00869158170f1dbe1e11393b0d1f7a402bc06,2,1,9,8,0,0,0,1,6,0,1,1,0.721928095,181,8,1,18,19,1,1133,1188,55,9,9,0,100
6628dae4670fbc1057a0847a7bae0612818d3605,3,1,67,66,0,0,0,2,4,102,1,1,0.787004656,139,21,10,9,15,6,497,789,292,5,7,2,99.81343284
744654be9738f4bb5a0cf8f5bfdd7b6ea550b2db,0,0,0,0,0,0,0,0,0,0,0,0,0,0,22,7,0,0,0,0,0,0,0,0,0,100
10803d67d9f83d083015104fa35883aa6957c26d,7,876,321,555,5,0,5,1,3,14,1,3,2.385718609,305,23,8,130,65,65,5681,2225,3456,57,21,36,98.89604416
8bfbc180d2a6f3e607c7b47b30af6de559465d61,5,47,13,34,1,0,1,1,3,34,1,4,1.803673636,400,24,9,82,82,0,3191,3117,74,30,30,0,99.27797834
c6700b32b3c1385bbc2b89f165c43da0523fc985,1,0,38,38,0,0,0,1,2,63,1,1,0,7,25,10,0,0,0,0,74,74,0,0,0,99.54914337
5893f0267a0d2132411ca8b36386e3d5c27b73d8,4,117,10,107,2,0,2,1,2,30,1,1,1.415441157,112,26,11,37,27,10,1050,750,300,23,16,7,99.55156951
ea3a862acc037bd044686e22d75fca0be3965ce5,5,8,14,6,0,0,0,2,3,91,1,5,1.968130014,636,27,11,115,115,0,3682,3699,17,54,54,0,100
60b11d8e2591d052bbf426d11183aa66bad7ba17,7,98,13,85,0,0,0,1,4,59,1,5,2.398245738,964,28,12,179,160,19,7452,6882,570,89,85,4,100
58c82cc39e01cf6f20631f59c3c11f9662f96329,0,0,0,0,0,0,0,0,0,0,0,0,0,0,29,12,0,0,0,0,0,0,0,0,0,100
8a77a4a373a6582651885a29dd6cf5b3124378b9,3,138,0,138,2,0,2,1,2,25,1,2,1.05372694,9,30,13,13,1,12,912,81,831,10,1,9,99.5571302
749c27aec1a3e1732158f9fc8372a934aafba8de,6,151,24,127,1,0,1,1,3,73,1,5,1.473581369,391,31,2,92,82,10,3398,3074,324,49,42,7,99.73591549
819e958ad37dfe6eb28d0542eb903698e1cb24b7,1,0,130,130,0,0,0,1,2,110,1,1,0,53,32,3,0,10,10,0,324,324,0,7,7,99.82394366
c9d1f45936d39fd308cc53084aadacf3098fe962,15,50,47,3,0,0,0,1,4,81,1,9,3.794056334,2749,33,4,594,594,0,19495,19359,136,229,229,0,99.56024626
c176ef271797ac8aa6d49b8b24660333e075f56f,8,49,54,5,0,0,0,1,4,73,1,8,1.5890665,1011,34,5,220,220,0,7494,7510,16,74,74,0,99.9122807
1b4f0190db9a9b4ccbd30037b0412993de98fee4,13,790,0,790,13,0,13,1,1,0,1,3,3.666273339,0,9,0,43,0,43,3825,0,3825,22,0,22,96.00665557
567ee55e95b3b52c514dfbe4698ae247ab1c6369,0,0,0,0,0,0,0,0,0,0,0,0,0,0,12,0,0,0,0,0,0,0,0,0,0,100
0bf53b4a321d713dc3925f41867aeecd29aec6fc,1,12,6,6,0,0,0,1,4,56,1,1,0,256,35,0,56,56,0,1718,1778,60,15,15,0,100
955dea6fef5f60cbe72be2dbaa5e5a5a3b7c8bd5,1,7,2,5,0,0,0,1,2,183,1,1,0,18,36,1,5,4,1,131,105,26,3,3,0,100
88cbd2dd8e00a7b6135bc097c9ff9bc93abea2d0,0,0,0,0,0,0,0,0,0,0,0,0,0,0,13,0,0,0,0,0,0,0,0,0,0,100
6e4c3344f57ead5599c1df9c4a7bd83e5c1afc1c,0,0,0,0,0,0,0,0,0,0,0,0,0,0,14,1,0,0,0,0,0,0,0,0,0,100
3bf6d5b3fd8e42755623c44ab37032a0af09d7dd,0,0,0,0,0,0,0,0,0,0,0,0,0,0,15,2,0,0,0,0,0,0,0,0,0,100
7068665e363baa1db98af1aecd884f6b2058a9fd,5,29,0,29,0,0,0,1,5,183,1,3,2.147431415,688,37,2,88,84,4,7962,7615,347,41,41,0,100
411fe8d0c8d9c5da18976b715c6e2dd8a7df9c1e,4,149,36,113,2,0,2,1,5,50,1,3,1.750413573,306,38,2,65,55,10,2440,2185,255,35,28,7,99.60598897
b1a8b8d2a963b406daaa2e92314beeef031f6975,30,104,104,0,0,0,0,2,6,222,1,13,3.655808021,6062,39,3,1269,1269,0,43421,43413,8,561,560,1,100
281b5f0981c1ee4ffac6bff64b8a9011e18c2034,54,5659,0,5659,54,0,54,1,1,0,1,11,5.487766964,0,16,0,435,0,435,24112,0,24112,231,0,231,84.87874465
caab90d8458654e3fd65a686e9d3df8795b69be8,0,0,0,0,0,0,0,0,0,0,0,0,0,0,40,2,0,0,0,0,0,0,0,0,0,100
15881963e7298b0a33d32050cfe1b3d26850a525,0,0,0,0,0,0,0,0,0,0,0,0,0,0,41,3,0,0,0,0,0,0,0,0,0,100
946101731f238c7c43f9a6ba16daf9c8aaa893f4,7,52,28,24,1,0,1,1,4,120,1,5,2.343789909,444,42,4,92,92,0,3499,3398,101,49,49,0,97.51677852
009e1a3373e43fe0d5d49995eb1dbac997fe4cb6,22,63,39,24,0,0,0,2,7,7,1,10,4.166230771,1474,43,5,294,287,7,10871,10733,138,167,162,5,100
e1e9427458bf81a71708320d24f6d093ea87e22f,0,0,0,0,0,0,0,0,0,0,0,0,0,0,17,1,0,0,0,0,0,0,0,0,0,100
96d1ae1b687e59ce61ad357d5c0c6450d766e205,1,3,15,12,0,0,0,2,8,0,1,1,0,187,18,2,35,38,3,1287,1342,55,22,22,0,100
3f427d93598a1dae64ad7a27b6dbc52a28824dad,0,0,0,0,0,0,0,0,0,0,0,0,0,0,21,0,0,0,0,0,0,0,0,0,0,100
c8c86edb76a575582e8c12cc8e1108ea6f9f1b61,10,88,42,46,1,0,1,1,9,174,1,5,2.867227863,1030,44,4,190,189,1,9152,8872,280,107,107,0,99.65564738
8df25cda76ecfbb37d66ccd4dd685c44667d53e6,0,0,0,0,0,0,0,0,0,0,0,0,0,0,45,5,0,0,0,0,0,0,0,0,0,100
8486e67feac5d2a4a45daf2c3fe394e8a08be1bd,9,13,29,16,0,0,0,2,6,230,1,5,2.846844437,960,46,6,174,176,2,5645,5675,30,88,90,2,100
b488bb55cb6ebbb2e27ed117b22f8003db69f853,2,142,0,142,2,0,2,1,1,0,1,1,0.998711751,0,47,7,15,0,15,755,0,755,11,0,11,96.39037433
b78388a3d57656f0b02e02a33dd82f99fe369915,3,126,93,33,1,0,1,1,5,12,1,1,1.553417673,169,48,8,40,38,2,1381,1340,41,17,16,1,97.86959329
170ea9d5e05a2800f3dcb39f1e988defd9868d69,3,12,6,6,0,0,0,1,2,0,1,2,1.584962501,119,49,9,21,21,0,1133,1032,101,16,16,0,99.61290323
6e32a623e13b518e820a20266e3a26576d82abb6,53,521,328,193,3,0,3,1,10,129,1,20,4.941435039,5702,50,10,1013,1015,2,49132,47432,1700,484,471,13,98.77022654
045b0811b96e92d55bdcae24b6361bf4e315bd18,11,219,198,21,0,0,0,1,11,89,1,8,2.018106255,1253,51,11,282,277,5,9745,9583,162,103,98,5,100
6ced2664e9f3a3c3df8c480c4931d8968c512fd4,3,43,39,4,0,0,0,1,7,93,1,3,1.076712942,799,52,12,128,129,1,5220,5218,2,55,55,0,100
c056eed3392f60811d5b607404d1202fc2195086,1,4,2,2,0,0,0,1,2,274,1,1,0,79,53,13,20,20,0,592,564,28,12,12,0,100
4bd55ffe9efc9e05ee4aad90ef935b6e7203adbb,3,61,3,58,1,0,1,1,7,4,1,2,0.592431699,369,54,14,77,74,3,3181,2800,381,25,22,3,99.87113402
5dced8933f8b8b3d90a92f1154aac464375f3295,1,1,1,0,0,0,0,1,8,2,1,1,0,453,55,15,81,81,0,2954,2952,2,33,33,0,100
09028b1d443f8cefca6a99b293d9f70ab6776681,2,9,5,4,0,0,0,1,2,280,1,1,0.985228136,30,56,16,0,0,0,389,335,54,0,0,0,100
62716daff85ebbd6ef0c7e1b5ce2bba1ac366a55,28,149,160,11,0,0,0,3,7,157,1,10,4.214811645,2440,57,17,388,396,8,16342,16299,43,217,217,0,100
80161e65042a6444f521a2deb54106826385babc,50,0,0,0,0,0,0,1,1,0,1,8,0,2566,22,1,351,0,351,20605,650,19955,200,0,200,87.49194068
20813530ba7f3e480fd0a9e91af253ec4f401fa4,0,0,0,0,0,0,0,0,0,0,0,0,0,0,19,2,0,0,0,0,0,0,0,0,0,100
eefade2b45b388565f1e9ee7071614dc39ed958d,0,0,0,0,0,0,0,0,0,0,0,0,0,0,20,3,0,0,0,0,0,0,0,0,0,100
9cfa8b6994c1e76293243fa9374431821fa7c586,0,0,0,0,0,0,0,0,0,0,0,0,0,0,21,4,0,0,0,0,0,0,0,0,0,100
fbd81f33745ff6719c9542cf66fbb4f448d4dcff,22,1407,129,1278,11,0,11,1,3,10,2,9,3.947241996,559,22,5,207,73,134,11039,4974,6065,90,36,54,97.64780674
7fe72ce60bc3800a00dad94e814afd298415bd32,18,0,0,0,0,0,0,1,1,0,1,4,0,1007,23,6,150,54,96,8655,2556,6099,67,36,31,95.24103832
41b029f6f01c3ae3ce21b255a69dfb68f8f6ab68,0,0,0,0,0,0,0,0,0,0,0,0,0,0,24,7,0,0,0,0,0,0,0,0,0,100
41edba44cfcd942f3cf548b43e2f41f5b6cca0b3,18,0,0,0,0,0,0,1,1,0,1,4,0,1007,25,8,150,54,96,8655,2556,6099,67,36,31,95.07692308
3d5559af3d62686ff531b4242d28e4e1955aeb2a,0,0,0,0,0,0,0,0,0,0,0,0,0,0,26,9,0,0,0,0,0,0,0,0,0,100
ec52bcc2447139198630e985ad94a2c8b97a4e5e,0,0,0,0,0,0,0,0,0,0,0,0,0,0,27,10,0,0,0,0,0,0,0,0,0,100
d1248ed479e9d5e53d00b081fc3ca124ebce72e1,0,0,0,0,0,0,0,0,0,0,0,0,0,0,28,11,0,0,0,0,0,0,0,0,0,100
05bf7931e495432ad906d312784485485d0be328,0,0,0,0,0,0,0,0,0,0,0,0,0,0,29,12,0,0,0,0,0,0,0,0,0,100
ebc579530ed01e74115788d28f135f952b33074d,0,0,0,0,0,0,0,0,0,0,0,0,0,0,30,13,0,0,0,0,0,0,0,0,0,100
1ebec96319d73d39d5c2e7cb4ff2c8eacf1cfc47,4,28,19,9,0,0,0,1,3,8,1,3,0.913510415,175,31,12,14,14,0,1666,1617,49,7,7,0,100
42592067e2ccc7d998d7dca4cc85fa257b8165db,0,0,0,0,0,0,0,0,0,0,0,0,0,0,23,2,0,0,0,0,0,0,0,0,0,100
d8bafd5791e0e796788e63500bdfb32fda1fddb4,0,0,0,0,0,0,0,0,0,0,0,0,0,0,32,13,0,0,0,0,0,0,0,0,0,100
0391850affd7975616f57601c4250764d831a42b,54,5803,0,5803,54,0,54,1,1,0,2,8,5.530154194,0,33,14,449,0,449,28318,0,28318,174,0,174,93.28703704
ba295b0497f1c8c32a1ee475580b3db769b00f37,0,0,0,0,0,0,0,0,0,0,0,0,0,0,34,15,0,0,0,0,0,0,0,0,0,100
93e06fa3d5173b9fb57ee7b70105654afcc46ac5,5,37,9,28,0,0,0,1,4,249,1,3,2.025663346,177,58,13,38,34,4,1658,1494,164,10,9,1,100
b5a9a0a5c6cb6ece7b4648c8c2a9dd663386eb47,1,1,1,0,0,0,0,2,2,19,1,1,0,18,59,14,0,0,0,205,203,2,0,0,0,100
0d23c9c2ece0a4af7314d22435e07b5426493fbe,0,0,0,0,0,0,0,0,0,0,0,0,0,0,24,2,0,0,0,0,0,0,0,0,0,100
141e4c3d68a0045fe854d9c1ed73e184de2da87b,0,0,0,0,0,0,0,0,0,0,0,0,0,0,25,3,0,0,0,0,0,0,0,0,0,100
4a8639d8bb0218796d7fa0b433a323c5827f4579,5,22,11,11,0,0,0,2,8,117,1,3,2.017414864,1337,26,4,295,295,0,10864,10715,149,126,126,0,100
4dc6a6cde1340b6f0fa17ba70687778bbe0efd5d,2,11,9,2,0,0,0,2,2,6,2,2,0.970950594,105,27,5,9,9,0,889,903,14,4,4,0,100
b4cfbe1e180e58e8cd3471c1a3372d93aa811b2e,9,1542,3,1539,8,0,8,4,6,10,1,3,2.505833615,368,35,16,203,62,141,11645,3396,8249,67,14,53,98.6537426
b0be89b6215112a68f26ff15d554fb0e4b3bf0db,53,157,144,13,0,0,0,1,9,25,1,16,5.381755427,5575,60,10,976,975,1,46438,46253,185,429,429,0,100
dd952bb373e4f3fb0217fcb64e9f1e5566c9cd9a,2,8,4,4,0,0,0,1,6,3,1,2,0.918295834,145,61,11,27,26,1,1301,1284,17,4,4,0,100
7f6626cd2056bdbfdf16be06dc1aaa251b39995a,135,666,838,172,0,0,0,2,9,18,2,33,6.608042209,10601,62,12,1634,1644,10,81901,82355,454,737,744,7,100
78ef8aaa0036cdd02b43214a6c4ffea74323b8e5,56,819,826,7,0,0,0,2,10,19,2,17,4.899919445,5091,63,12,755,763,8,38681,38020,661,351,351,0,100
6502d605ff60847d91fc1bd7d6dd488d31d1a37f,2,128,0,128,2,0,2,1,1,0,1,2,0.69621226,0,28,6,11,0,11,424,0,424,3,0,3,99.73333333
932b53a2347a1d766c0c215f8d917b9ecab94179,24,278,276,2,0,0,0,2,5,8,1,10,2.769355098,1389,64,13,161,164,3,12618,12466,152,62,61,1,100
9ec6989af5e5c35865fa14313455e78da0e21485,1,8,0,8,0,0,0,1,7,9,1,1,0,124,65,9,26,26,0,1088,1028,60,3,3,0,100
8d109ec4f36dec47accfeeef38c991ddd10d0d5b,1,2,1,1,0,0,0,1,8,0,1,1,0,130,66,10,26,26,0,1095,1088,7,3,3,0,100
1eccbcfea0f7490afe1d255d4a89d04cbbfdf985,39,189,159,30,0,0,0,2,8,61,2,25,4.553715931,5138,67,9,883,882,1,42184,41821,363,338,336,2,99.30666667
b9432ed47a962b787344661d40d77e9255cb700c,2,30,5,25,0,0,0,1,4,17,1,1,0.999411065,64,68,10,13,11,2,444,379,65,9,7,2,100
8434e44d949b4f63be75d44e944ca35e873b25cd,38,423,606,183,0,0,0,1,7,10,1,10,4.64615766,3116,69,11,504,459,45,27619,29228,1609,259,315,56,94.57735247
955a439fea493cbe13b453b9b3ffc1436b3d2fbe,0,0,0,0,0,0,0,0,0,0,0,0,0,0,36,0,0,0,0,0,0,0,0,0,0,100
062041e4ea1914ce70a2c5da5ef3d9b28f870484,2,28,4,24,0,0,0,1,9,38,1,2,0.448864489,157,70,3,35,31,4,1445,1308,137,7,6,1,99.94714588
8413b05759ae5bf88e36d6505a129d99d8f9a3f5,0,0,0,0,0,0,0,0,0,0,0,0,0,0,37,1,0,0,0,0,0,0,0,0,0,100
c439ed00a2ccc73881ae16e96f4e408028a81a7d,0,0,0,0,0,0,0,0,0,0,0,0,0,0,38,2,0,0,0,0,0,0,0,0,0,100
3709bc58ce71b0cee169e8351484938a1e48ca3e,0,0,0,0,0,0,0,0,0,0,0,0,0,0,29,0,0,0,0,0,0,0,0,0,0,100
71e2414dbb03fc550e18a52c2be00a4d3cef2746,0,0,0,0,0,0,0,0,0,0,0,0,0,0,39,3,0,0,0,0,0,0,0,0,0,100
1b4c0e28185c33afc8f7b3c47ceb72a1f3f3a7ab,0,0,0,0,0,0,0,0,0,0,0,0,0,0,30,1,0,0,0,0,0,0,0,0,0,100
be69161283070aad24ceb880e08ca3deb2b1a42d,0,0,0,0,0,0,0,0,0,0,0,0,0,0,31,2,0,0,0,0,0,0,0,0,0,100
d1be9cf613a7425747a00479a6b02fde82c5cc42,0,0,0,0,0,0,0,0,0,0,0,0,0,0,32,3,0,0,0,0,0,0,0,0,0,100
0c74b63312a2d5a08d15b57bed67dd971944b99a,0,0,0,0,0,0,0,0,0,0,0,0,0,0,33,4,0,0,0,0,0,0,0,0,0,100
8da1d8c44da8b107fc3ac755240b4fd9c44cd63a,0,0,0,0,0,0,0,0,0,0,0,0,0,0,34,5,0,0,0,0,0,0,0,0,0,100
6a88bd3115b874d85bcc4935ef9f085f4c820e1a,0,0,0,0,0,0,0,0,0,0,0,0,0,0,35,6,0,0,0,0,0,0,0,0,0,100
ab28b8b85b416ad71335738d6f24925f16584a39,0,0,0,0,0,0,0,0,0,0,0,0,0,0,40,4,0,0,0,0,0,0,0,0,0,100
0f305a6b60cbb9e3431c4d599cf0cf7c651bf36d,6,100,0,100,0,0,0,2,3,157,1,2,2.582683189,92,41,5,22,22,0,629,629,0,16,16,0,100
e6f91abe5d815670ad52e217bfb81f3189c37a37,0,0,0,0,0,0,0,0,0,0,0,0,0,0,36,7,0,0,0,0,0,0,0,0,0,100
dd5d3579a8b7d2028789cf05c6c9848a66cc8d78,0,0,0,0,0,0,0,0,0,0,0,0,0,0,37,8,0,0,0,0,0,0,0,0,0,100
8d77cdedd886597a10d34b9a0ef81adaf33c8987,0,0,0,0,0,0,0,0,0,0,0,0,0,0,38,9,0,0,0,0,0,0,0,0,0,100
33c3ef13054ce941121ec2bdf197fdf7ebc2e563,0,0,0,0,0,0,0,0,0,0,0,0,0,0,42,5,0,0,0,0,0,0,0,0,0,100
6ce282a93accb0477bfda24f69deb09184545ea0,1,3,3,0,0,0,0,2,2,81,1,1,0,124,1,0,32,32,0,908,908,0,6,6,0,100
e8262b15f341a16146165688db009f85dfd98c15,0,0,0,0,0,0,0,0,0,0,0,0,0,0,43,6,0,0,0,0,0,0,0,0,0,100
4de1814943a6364089ec2a489bb08d0719f5b5bb,2,3,3,0,0,0,0,3,5,128,2,2,0.918295834,253,2,1,40,40,0,1911,1911,0,15,15,0,100
c4ef7efac75a45371151b27079c89e091906e394,0,0,0,0,0,0,0,0,0,0,0,0,0,0,71,0,0,0,0,0,0,0,0,0,0,100
a5e5d5dbb16d0fa9cf323c45c33c8b2f6d3602b3,37,180,149,31,0,0,0,2,8,139,2,17,4.546162409,3795,72,1,628,627,1,30976,30844,132,226,225,1,99.84143763
faad04042fb21e4c0bd1fe316a45e5491f9bfda7,0,0,0,0,0,0,0,0,0,0,0,0,0,0,44,0,0,0,0,0,0,0,0,0,0,100
4643ae503c4b0024b80e8fa880e1fb944c405d95,0,0,0,0,0,0,0,0,0,0,0,0,0,0,45,1,0,0,0,0,0,0,0,0,0,100
b0232339c0d79baab652ef79eff986cc4204c25f,0,0,0,0,0,0,0,0,0,0,0,0,0,0,46,2,0,0,0,0,0,0,0,0,0,100
34821786940919c3e12ea641a53f1506a12aeac3,0,0,0,0,0,0,0,0,0,0,0,0,0,0,47,3,0,0,0,0,0,0,0,0,0,100
82a1d6305783b6f54d80f8954b9b682e477f00f4,0,0,0,0,0,0,0,0,0,0,0,0,0,0,48,4,0,0,0,0,0,0,0,0,0,100
5c8f78f9b586d497a52c6b67616d7de5d26e2c4b,0,0,0,0,0,0,0,0,0,0,0,0,0,0,49,5,0,0,0,0,0,0,0,0,0,100
9d1dea51f2152ed3267f6293631a9a9bbf0171b9,0,0,0,0,0,0,0,0,0,0,0,0,0,0,50,6,0,0,0,0,0,0,0,0,0,100
e84d6d27b1de1d5675f81cb2a150c59272338bdc,0,0,0,0,0,0,0,0,0,0,0,0,0,0,51,7,0,0,0,0,0,0,0,0,0,100
66d0c178ab6bed84626f29522136314378c915f8,0,0,0,0,0,0,0,0,0,0,0,0,0,0,52,8,0,0,0,0,0,0,0,0,0,100
2eefb042eecda11982b5da6f0da2e218f5f94290,0,0,0,0,0,0,0,0,0,0,0,0,0,0,53,9,0,0,0,0,0,0,0,0,0,100
6a1cb5dc3731c3f4e53d391469c1d32af2217c03,2,114,88,26,0,0,0,2,6,6,1,1,0.997452818,307,54,10,29,29,0,3106,2724,382,9,9,0,100
8a84dcd0fb569d1259b88485c5a05a2655bb2e51,0,0,0,0,0,0,0,0,0,0,0,0,0,0,55,11,0,0,0,0,0,0,0,0,0,100
42d0bd0dc2dd67ba3bb415b8d9a1562905ea67ae,1,1,1,0,0,0,0,3,9,141,1,1,0,173,10,0,36,36,0,1140,1139,1,18,18,0,100
26034ec5a19caab64c0621c9bdd5b6e5b08b0440,5,219,149,70,0,0,0,2,6,5,1,1,2.273963067,361,56,12,30,30,0,4173,3408,765,8,8,0,100
d38260349531d2bd0a9846885cc1fb3248696611,7,100,5,95,1,0,1,3,7,207,1,2,2.535567094,1236,11,1,328,309,19,9547,8998,549,158,150,8,99.68337731
732f03088ef215d8c86e3663ff05eea6545612f6,0,0,0,0,0,0,0,0,0,0,0,0,0,0,57,13,0,0,0,0,0,0,0,0,0,100
35c3a29a4ea357fa6d567c7d5baa11e35ae8d2aa,0,0,0,0,0,0,0,0,0,0,0,0,0,0,58,14,0,0,0,0,0,0,0,0,0,100
e9c586d3d5aea6fe98c26dcac5cd895877f2a002,0,0,0,0,0,0,0,0,0,0,0,0,0,0,59,15,0,0,0,0,0,0,0,0,0,100
4f6b3b0c2cf019c57fd856a008a11b0fa2ba2ce0,1,1,1,0,0,0,0,2,7,0,1,1,0,59,60,16,6,6,0,726,726,0,3,3,0,100
42dde4eef7c4f7b7cfb8aec24621feabb54fae5f,0,0,0,0,0,0,0,0,0,0,0,0,0,0,61,17,0,0,0,0,0,0,0,0,0,100
358c5749d0a6fc38e9442187b78403367895478c,193,1056,838,218,0,0,0,2,11,61,2,35,7.204304278,15536,73,2,2443,2443,0,116693,116658,35,1117,1117,0,99.89451477
45e0c3e4c3190bc3c708b853641d82f0e3e9db3c,119,744,1816,1072,0,0,0,2,12,29,2,33,5.798383614,9743,74,3,1581,1590,9,70513,71204,691,735,736,1,98.47207587
4d90718c3aea5c15291e56b0d7eb35f0db6f0717,1,30,1,29,0,0,0,2,12,221,1,1,0,165,75,4,34,34,0,1254,1254,0,22,22,0,100
990d76131a4e9adbdc06b3edf62322b6d14cfbd3,1,10,5,5,0,0,0,2,13,11,1,1,0,165,76,3,35,34,1,1309,1254,55,22,22,0,100
bd220119527065ff0e60b45c8468662b8d01dbdd,11,33,53,20,0,0,0,2,10,17,2,7,2.900040325,1694,77,4,243,246,3,15492,15639,147,60,60,0,100
ed9696caacf8364aa1636c06539f284678fd34b6,0,0,0,0,0,0,0,0,0,0,0,0,0,0,62,5,0,0,0,0,0,0,0,0,0,100
260b2bd6c371961dc61d5655427e46ebce725d2f,1,1,1,0,0,0,0,3,6,33,1,1,0,59,63,6,4,4,0,523,523,0,2,2,0,100
d925b9eb30c06b112c70881987c1ceaff0214599,0,0,0,0,0,0,0,0,0,0,0,0,0,0,64,3,0,0,0,0,0,0,0,0,0,100
6c76f3c12a26774bee72723bc60a5188e8127e38,1,3,2,1,0,0,0,2,5,33,1,1,0,85,65,4,15,15,0,705,694,11,4,4,0,100
1adf75e1ce294190b3164ea119b65e6e0f5a56c4,1,1,1,0,0,0,0,2,9,33,1,1,0,59,66,5,6,6,0,726,726,0,3,3,0,100
7bb88f895e1ee2fab9732bf976c24be3759c07ff,2,36,17,19,0,0,0,1,7,206,1,2,0.698700353,186,78,5,32,28,4,1644,1547,97,19,18,1,100
67375589969cb4ecbdcd1c2fd9b93d138442f1b1,1,1,1,0,0,0,0,3,4,34,1,1,0,42,67,5,4,4,0,402,402,0,2,2,0,100
5b821555191722d104e949c6abd95e3d1bd2fe98,0,0,0,0,0,0,0,0,0,0,0,0,0,0,68,6,0,0,0,0,0,0,0,0,0,100
9a2b9647c4b4d6e36689afa39a08f7e4a301fb92,8,21,21,0,0,0,0,2,9,14,1,5,2.838546447,830,69,7,154,154,0,6568,6568,0,57,57,0,100
d86e6c006b15ad19cef7f4c28b58375a4863f504,1,2,2,0,0,0,0,2,9,12,1,1,0,184,70,8,20,20,0,1645,1655,10,8,8,0,100
f0b0dc456797aa46f16aca9a328ca26eadc9fc55,1,2,2,0,0,0,0,2,9,12,1,1,0,140,71,9,11,11,0,1486,1496,10,2,2,0,100
7b8b1743155f24068eb2028e87ae9e447f6070cb,1,1,1,0,0,0,0,2,10,0,1,1,0,140,72,10,11,11,0,1481,1486,5,2,2,0,100
307994c2d364e009c1432e7c34ba971131fc6ece,1,20,11,9,0,0,0,2,9,13,1,1,0,66,73,11,8,6,2,725,604,121,2,2,0,100
5eee7e0d8b7fa4eb45e81481ee375f5db0ea6504,1,2,2,0,0,0,0,2,10,0,1,1,0,78,74,12,8,8,0,725,725,0,2,2,0,100
f6d6b2937e756fd2a965b4505024dd67611d6309,1,7,2,5,0,0,0,1,8,4,1,1,0,153,79,6,32,31,1,1186,1150,36,18,18,0,100
9d22ce7dcdd1c9db352d51933fee01d800432d76,2,63,62,1,0,0,0,1,4,41,1,1,0.992183779,520,80,7,137,137,0,2945,2935,10,76,76,0,100
6e77677ebca428d346457af3b3b94ce4aa21324d,1,1,1,0,0,0,0,2,6,28,1,1,0,41,75,13,3,3,0,411,414,3,1,1,0,100
79d0bc2514cebea0260c56536adb6989c01591ac,22,94,94,0,0,0,0,1,9,160,1,6,3.938289284,1941,81,7,361,361,0,16937,16937,0,181,181,0,100
9fb0bd9c87d40a344a56cc6238799ff7d12799bf,12,484,29,455,2,0,2,1,10,116,1,7,1.669163805,2055,82,8,488,407,81,17879,15594,2285,172,135,37,99.63293131
3bf78f84933d0f906feabb5ac68cbee4c4e857f4,1,5,1,4,0,0,0,2,2,542,1,1,0,5,3,0,0,0,0,38,38,0,0,0,0,100
863470a46d9cac8305e52aae0f9c941797fb7af0,1,1,1,0,0,0,0,2,10,10,1,1,0,96,4,1,24,24,0,700,700,0,8,8,0,100
e851a248537271fdbb3c11f6957656cf564dad7e,11,42,64,22,0,0,0,1,11,86,1,3,3.083519615,2047,83,8,419,417,2,15503,15609,106,140,140,0,99.78902954
558c33f6796e7159ac09ef559228fb2821709a7b,11,124,79,45,1,0,1,2,11,22,2,5,2.667130547,801,76,14,105,102,3,7917,7505,412,47,46,1,99.73446628
d6235d015a5cb7b3d21d93324b807c9e0182743b,29,366,397,31,1,0,1,1,11,88,1,10,3.760706604,3013,84,8,643,663,20,22560,22851,291,279,283,4,99.41737288
d690c83fbcaf894e5ffbeb1a0b65cc212d25e8a5,4,12,11,1,0,0,0,2,11,28,1,4,1.670714506,451,85,9,67,68,1,3909,3947,38,32,32,0,100
b88e34a1607db5bedf8a3b189bbca791243a4a18,0,0,0,0,0,0,0,0,0,0,0,0,0,0,86,8,0,0,0,0,0,0,0,0,0,100
6d805f8c861e682a7c8d9317b48a6bf1ba788a06,4,76,59,17,0,0,0,2,11,41,1,4,1.448613807,517,87,9,89,85,4,4511,4431,80,29,28,1,100
112a5dbabe07c225b8299295cb1958e223b7acfa,1,1,1,0,0,0,0,2,2,12,1,1,0,37,5,2,11,11,0,233,233,0,7,7,0,100
9cac2f30be2dcf954fd3cc14e2905aec722d10ee,0,0,0,0,0,0,0,0,0,0,0,0,0,0,88,10,0,0,0,0,0,0,0,0,0,100
ff9f2f12802e1394e42934e434a28d3946a3908c,9,386,175,211,1,0,1,2,7,92,1,2,2.957465313,940,77,0,162,140,22,8980,8191,789,59,53,6,99.68186638
1e67bf5c6abea58341d4ee3a899c6bb7cacf48ae,3,85,25,60,0,0,0,1,10,489,1,2,1.153054804,572,89,0,92,87,5,4083,3822,261,44,39,5,100
f09228b2be7fc67484220fbc260996846b38942e,1,2,2,0,0,0,0,1,4,0,1,1,0,64,90,1,2,2,0,603,603,0,2,2,0,100
ed38552e1bf451dd65e14117f276ae02bda35811,1,2,2,0,0,0,0,1,5,0,1,1,0,64,91,2,2,2,0,619,603,16,2,2,0,100
58d7a84ad21b12a3ac5c710e6b9dec17fc1df0ba,234,1115,559,556,0,0,0,2,14,67,2,38,7.11461919,17594,92,0,3299,3251,48,137883,136622,1261,1578,1538,40,98.94792215
8d3a9d4dc4105b6a99d4318265910c89ba4ea930,2,132,0,132,2,0,2,1,1,0,1,2,0.902393283,0,93,1,9,0,9,423,0,423,9,0,9,99.74079834
b174f6b6ed178a1c7a67340ac00084a4b33b4479,10,512,19,493,6,0,6,3,15,12,2,4,2.694527634,355,94,2,120,63,57,4788,2499,2289,68,37,31,99.23391216
884ab10a1bcab7161eff764f8116039b4b521b96,6,108,17,91,1,0,1,1,2,0,1,1,2.012429102,260,95,3,66,48,18,2502,2029,473,31,24,7,99.54407295
64daaa4b3badd6e6db8fbbfd50d0033cf0728656,4,251,0,251,4,0,4,1,1,0,1,1,1.902731898,0,96,3,21,0,21,1089,0,1089,17,0,17,96.08650875
81d77f722c82617626f94b9a51bc59bb2f37890f,1,4,5,1,0,0,0,1,2,2,1,1,0,51,97,4,8,9,1,395,391,4,5,5,0,100
03795b0397655d29be4a54bf91432450ccb6de6f,7,858,2,856,5,0,5,1,16,3,2,5,2.259284566,204,98,5,158,37,121,5917,1526,4391,93,24,69,95.81486952
b9b837c4ee8f408710dbbfdf35806489d8385dde,7,4,13,9,0,0,0,2,11,49,1,5,2.748940047,706,99,6,80,79,1,6710,6752,42,29,28,1,100
5e56d973e947c216d0a5dd06b0af1c5fdfba8ad5,18,57,66,9,0,0,0,2,13,35,2,11,3.364228695,2767,100,7,538,538,0,20794,21112,318,202,202,0,100
8a854b4c9bcce43bd87edb6b3574d2f27633a933,1,2,2,0,0,0,0,2,2,11,1,1,0,203,6,0,40,40,0,1667,1667,0,15,15,0,100
0dece127488fd13393770e7c78b62a6903bdffad,2,271,0,271,2,0,2,1,1,0,1,1,0.818507318,0,101,7,39,0,39,1436,0,1436,24,0,24,99.76776591
ac34e851136dfc17efc55aa6af1917dbd4129cd2,1,5,4,1,0,0,0,1,2,0,1,1,0,146,102,8,28,28,0,1224,1225,1,16,16,0,100
28d8b152e15f74699ad2ddc7b7e856d1f5b78ccf,4,270,5,265,2,0,2,1,3,0,1,1,1.441849774,187,103,9,74,39,35,3018,1435,1583,42,24,18,99.76873265
0d5586e22938d4bc5de5746ead2dc9575945b3c6,5,169,12,157,3,0,3,1,4,2,1,1,1.934489367,235,104,10,57,45,12,2486,1891,595,42,29,13,99.5431704
fb482d02254f88cc431670ab5060808eab908395,3,21,2,19,0,0,0,2,17,33,1,2,0.966451629,268,105,11,53,50,3,1930,1840,90,33,32,1,100
7b5d4b5de8ec9589f9f0f56bf532fce008f3501e,2,43,11,32,0,0,0,1,18,17,2,2,0.228538144,235,106,10,51,44,7,1938,1740,198,29,28,1,100
8681219a2b1f6db69bf0b67e9d574f6ac4cca767,4,55,71,16,0,0,0,2,6,169,1,2,1.561862193,282,107,10,60,67,7,2081,2146,65,28,24,4,100
04b5a4d6491acb0c0101d3bf4cc2eadaadf4eecc,1,4,1,3,0,0,0,2,19,6,1,1,0,213,108,11,44,43,1,1576,1543,33,24,24,0,100
d36507b279bb903e3d3bbef9ae48479eb5e93dd3,13,87,26,61,2,0,2,1,14,198,1,7,3.089333497,1564,109,11,268,264,4,11194,11008,186,119,115,4,99.81949458
7cba6c80eb3aaa44c144aabf011929780fe59615,21,16,45,29,0,0,0,2,12,136,2,12,4.029425545,1704,110,12,343,343,0,12570,12570,0,176,176,0,100
8b50e89805d7c041e510041aad992dd0d6bf895a,0,0,0,0,0,0,0,0,0,0,0,0,0,0,111,13,0,0,0,0,0,0,0,0,0,100
794c3aea496ccf2b6a48467d0fce7d9c97608f11,1,29,4,25,0,0,0,2,13,110,1,1,0,60,7,0,11,8,3,545,433,112,8,6,2,100
18a586b5285ff95a7eed7e6b07ca60c7b2df91ce,1,1,1,0,0,0,0,2,11,110,1,1,0,55,8,1,10,10,0,411,411,0,4,4,0,100
a13f48fbe092c07261db975c525777522410c6a9,1,27,41,14,0,0,0,2,20,29,1,1,0,216,112,8,43,44,1,1522,1576,54,23,24,1,100
a036bf518f7eeff363cb35b45208a2b2415ef195,4,17,15,2,0,0,0,2,8,112,1,2,1.664717001,399,113,7,41,40,1,3215,3197,18,18,18,0,99.40909091
25217da1dbdba7e722db741aa11f98e86e41784d,4,76,31,45,0,0,0,1,21,55,2,4,0.725196028,339,114,7,72,64,8,2894,2755,139,31,30,1,100
328088678b7f90080150e37d774b6f42e49f7ab9,1,5,2,3,0,0,0,1,4,30,1,1,0,40,115,8,7,6,1,390,349,41,2,2,0,98.9729225
23f5202b6e8a5d0468fcc95277d166f38b64aeec,1,25,1,24,0,0,0,2,5,459,1,1,0,115,78,0,15,14,1,1126,996,130,10,10,0,100
7b3ba4655a6a4edca43e1fd09c43ee43ce4f3ba4,0,0,0,0,0,0,0,0,0,0,0,0,0,0,79,1,0,0,0,0,0,0,0,0,0,100
ded3f0f3560b623900fd99571eaf1026a2f5691f,0,0,0,0,0,0,0,0,0,0,0,0,0,0,80,2,0,0,0,0,0,0,0,0,0,100
660fc70aa2280d217d5bd2b823c9d4d3dfddcd80,3,19,15,4,0,0,0,2,14,50,1,3,0.855352913,436,116,9,86,86,0,3225,3224,1,53,53,0,100
120401405cc2154416a1785c282cf58e4b225fad,1,1,7,6,0,0,0,2,14,11,1,1,0,75,117,10,10,11,1,514,545,31,7,8,1,100
e3f80a1ee2c6aa94be0eb183856bf1c1271a67e3,4,5,5,0,0,0,0,2,9,276,1,3,1.921928095,187,81,3,18,18,0,1717,1717,0,8,8,0,100
dabdc0e22ce8673ca0998d6e2e8285c184ea7339,0,0,0,0,0,0,0,0,0,0,0,0,0,0,82,4,0,0,0,0,0,0,0,0,0,100
5b6ed8bb3cbea2fd42043602e23993a19b991f4f,0,0,0,0,0,0,0,0,0,0,0,0,0,0,83,5,0,0,0,0,0,0,0,0,0,100
a1fee6f5ae81cf932d8a262576df7aad6d3c30de,2,0,0,0,0,0,0,1,1,0,1,1,0,193,84,6,35,20,15,1418,430,988,13,8,5,99.52426261
08cce661f1efe70b3fd3dcc77c90aa61f77c54cb,0,0,0,0,0,0,0,0,0,0,0,0,0,0,85,7,0,0,0,0,0,0,0,0,0,100
7868e51d7b5d59ff93d7d93c60adc53d6bb04960,5,45,22,23,0,0,0,1,22,87,2,5,1.492692148,1120,118,9,250,247,3,7435,7305,130,123,117,6,100
5a06f0bf44bc8007c07da38276964a00dc66769f,0,0,0,0,0,0,0,0,0,0,0,0,0,0,86,8,0,0,0,0,0,0,0,0,0,100
3a4a00138bae2aaa272da85aed75c2ed1aa28058,0,0,0,0,0,0,0,0,0,0,0,0,0,0,87,9,0,0,0,0,0,0,0,0,0,100
a2e0e7a8d282bc326c9a47df388418f06a4dd86e,0,0,0,0,0,0,0,0,0,0,0,0,0,0,88,10,0,0,0,0,0,0,0,0,0,100
5a5dacc97c182fffd130131f12e0f3d757ea4f8c,0,0,0,0,0,0,0,0,0,0,0,0,0,0,89,11,0,0,0,0,0,0,0,0,0,100
1abd480c37550893ee1384e6b72af1f289d60540,0,0,0,0,0,0,0,0,0,0,0,0,0,0,90,12,0,0,0,0,0,0,0,0,0,100
c4ca4a1c53e9373777b2d1521d10408bcbe188c6,0,0,0,0,0,0,0,0,0,0,0,0,0,0,91,13,0,0,0,0,0,0,0,0,0,100
c80f45bdf74250ae6a2ec083bae4d1019c7f5b25,0,0,0,0,0,0,0,0,0,0,0,0,0,0,92,14,0,0,0,0,0,0,0,0,0,100
72e1ecc63bdbffb58c3a1f7cbdcd2a8875763930,0,0,0,0,0,0,0,0,0,0,0,0,0,0,93,15,0,0,0,0,0,0,0,0,0,100
86b32a28d6a6dd72c8772b56a4b489dac09df168,0,0,0,0,0,0,0,0,0,0,0,0,0,0,94,16,0,0,0,0,0,0,0,0,0,100
2ee03cbd73a9b873dc9d9e0100d3f85262a33b9e,0,0,0,0,0,0,0,0,0,0,0,0,0,0,95,17,0,0,0,0,0,0,0,0,0,100
70822ea7f2e24e4057ab3b6204e058a8dd50d050,0,0,0,0,0,0,0,0,0,0,0,0,0,0,96,18,0,0,0,0,0,0,0,0,0,100
6f11be6a14df540f920ca6745d60c4133bcba9b1,0,0,0,0,0,0,0,0,0,0,0,0,0,0,97,19,0,0,0,0,0,0,0,0,0,100
aa02bd62dce16e5e04b7d4d515f9c6cf7cbce7cc,0,0,0,0,0,0,0,0,0,0,0,0,0,0,98,20,0,0,0,0,0,0,0,0,0,100
cf1e1c4ff7302859505a3e88378a6fed582dbbf4,0,0,0,0,0,0,0,0,0,0,0,0,0,0,99,21,0,0,0,0,0,0,0,0,0,100
c07818cb139749e02c496142d92bf350f891554b,0,0,0,0,0,0,0,0,0,0,0,0,0,0,100,22,0,0,0,0,0,0,0,0,0,100
ad4c424428f6c1445a3b213a06098db3e6d496fb,0,0,0,0,0,0,0,0,0,0,0,0,0,0,101,23,0,0,0,0,0,0,0,0,0,100
f96d230a533ee0e180e102dccfdf0b7562488c54,0,0,0,0,0,0,0,0,0,0,0,0,0,0,102,24,0,0,0,0,0,0,0,0,0,100
57abddab07391f5b1ca3d1e9756c8ec606f4323b,0,0,0,0,0,0,0,0,0,0,0,0,0,0,103,25,0,0,0,0,0,0,0,0,0,100
a36d715eecf8815e085a2fb68fe0e4a37b398ff4,0,0,0,0,0,0,0,0,0,0,0,0,0,0,104,26,0,0,0,0,0,0,0,0,0,100
b07c0c1b57901f0edb61295c191233944377b0ce,0,0,0,0,0,0,0,0,0,0,0,0,0,0,105,27,0,0,0,0,0,0,0,0,0,100
564bea5cb2e47b83d5255b8abb8617dcea67cbf9,0,0,0,0,0,0,0,0,0,0,0,0,0,0,106,28,0,0,0,0,0,0,0,0,0,100
8da586e7205ac0e7315ffcdeabdd59a2a961cd79,0,0,0,0,0,0,0,0,0,0,0,0,0,0,107,29,0,0,0,0,0,0,0,0,0,100
0c849066e2529852feb38bf1bd9315bc94544c25,0,0,0,0,0,0,0,0,0,0,0,0,0,0,108,30,0,0,0,0,0,0,0,0,0,100
c98a2ebd27ddca0002f10fb12c1b74ffd2e9a07f,5,20,11,9,0,0,0,1,8,260,1,2,2.064261632,823,119,9,205,203,2,4705,4752,47,104,104,0,100
676ecce8cec2a4f11957709dc29c36ad7a3f8ed8,0,0,0,0,0,0,0,0,0,0,0,0,0,0,109,31,0,0,0,0,0,0,0,0,0,100
c4205ca16a4dcdd9d909441b190afc6c08264f9c,0,0,0,0,0,0,0,0,0,0,0,0,0,0,110,32,0,0,0,0,0,0,0,0,0,100
e2bce86c9dad65e2765b054aa91c44b995407645,0,0,0,0,0,0,0,0,0,0,0,0,0,0,111,33,0,0,0,0,0,0,0,0,0,100
a90eaa479bf352d85f17a13a9abe9959544bc257,0,0,0,0,0,0,0,0,0,0,0,0,0,0,112,34,0,0,0,0,0,0,0,0,0,100
a20f6b066ad624a5a1761a6318e65ef00a658460,0,0,0,0,0,0,0,0,0,0,0,0,0,0,113,35,0,0,0,0,0,0,0,0,0,100
5d2d68e70992e56d00f47fb849e97328a33eded7,0,0,0,0,0,0,0,0,0,0,0,0,0,0,114,36,0,0,0,0,0,0,0,0,0,100
992c3818296104d36a4fe406397112f20a26d2c9,0,0,0,0,0,0,0,0,0,0,0,0,0,0,115,37,0,0,0,0,0,0,0,0,0,100
ffee8afb89e5a1fc636cf4dc611223548570bdef,0,0,0,0,0,0,0,0,0,0,0,0,0,0,116,38,0,0,0,0,0,0,0,0,0,100
97e829f2de3d6a1a8f10486c37a9239667313db9,0,0,0,0,0,0,0,0,0,0,0,0,0,0,117,39,0,0,0,0,0,0,0,0,0,100
69340abee57c256c85e011fd219696d17f21e861,0,0,0,0,0,0,0,0,0,0,0,0,0,0,118,40,0,0,0,0,0,0,0,0,0,100
0f7f5c86d09ab5ff777978d9cf210c5edded10bc,0,0,0,0,0,0,0,0,0,0,0,0,0,0,119,41,0,0,0,0,0,0,0,0,0,100
a89f8b394cbed53e9906caf82ea9c7fd37592559,0,0,0,0,0,0,0,0,0,0,0,0,0,0,120,42,0,0,0,0,0,0,0,0,0,100
2ab553ad129b368fcff5ccba2222b867788b3c65,0,0,0,0,0,0,0,0,0,0,0,0,0,0,121,43,0,0,0,0,0,0,0,0,0,100
a4076014395b661c29346f495211fa6ea8655f80,0,0,0,0,0,0,0,0,0,0,0,0,0,0,122,44,0,0,0,0,0,0,0,0,0,100
0c0adfa897d39f2a6b562caed239b242c2c1e78e,0,0,0,0,0,0,0,0,0,0,0,0,0,0,123,45,0,0,0,0,0,0,0,0,0,100
a82c0db21096f3ef4518f7108441701946ec98e6,0,0,0,0,0,0,0,0,0,0,0,0,0,0,124,46,0,0,0,0,0,0,0,0,0,100
de571bca0d4df2705913c174317449ea85480200,0,0,0,0,0,0,0,0,0,0,0,0,0,0,125,47,0,0,0,0,0,0,0,0,0,100
319aa26f879515ae83be5b136df16a96e115cc9f,0,0,0,0,0,0,0,0,0,0,0,0,0,0,126,48,0,0,0,0,0,0,0,0,0,100
1318fd1e5a9815c10780723e93517cee84c7486b,0,0,0,0,0,0,0,0,0,0,0,0,0,0,127,49,0,0,0,0,0,0,0,0,0,100
042538088fecf9671e3f5f35908ab67fd929134a,0,0,0,0,0,0,0,0,0,0,0,0,0,0,128,50,0,0,0,0,0,0,0,0,0,100
683309b451a7d01201173f59522a39f5af1ed883,0,0,0,0,0,0,0,0,0,0,0,0,0,0,129,51,0,0,0,0,0,0,0,0,0,100
74fb261bf996507a8369bec88c9b4b0834bcafec,0,0,0,0,0,0,0,0,0,0,0,0,0,0,130,52,0,0,0,0,0,0,0,0,0,100
ec698213281e7115fefaf96ad17e03369504ed29,0,0,0,0,0,0,0,0,0,0,0,0,0,0,131,53,0,0,0,0,0,0,0,0,0,100
c8c90e5c6cd15de45aecefbc599454661c4102c2,0,0,0,0,0,0,0,0,0,0,0,0,0,0,132,54,0,0,0,0,0,0,0,0,0,100
3b12cc843279ab77df0fb208228ff6fca86f2f44,0,0,0,0,0,0,0,0,0,0,0,0,0,0,133,55,0,0,0,0,0,0,0,0,0,100
6799343ac3b8e5ac81c05d1b1f576e9324a26900,0,0,0,0,0,0,0,0,0,0,0,0,0,0,134,56,0,0,0,0,0,0,0,0,0,100
6c291d849a46379ed0857095aaff6ab95f03e097,0,0,0,0,0,0,0,0,0,0,0,0,0,0,0,0,0,0,0,0,0,0,0,0,0,100
d4c83316ec0f54f3a1fb5d0ebee56fcb94f5dba9,0,0,0,0,0,0,0,0,0,0,0,0,0,0,1,1,0,0,0,0,0,0,0,0,0,100
8604a31b33e343931e1eebbd0e0d4e66c58d70c3,3,17,16,1,0,0,0,1,13,196,1,2,0.928604024,645,120,0,92,92,0,4159,4154,5,44,44,0,100
42820b6da47cd8f66c8f395bc709e16c8c29e385,3,87,35,52,1,0,1,1,11,82,1,2,1.42137983,719,121,1,172,168,4,4501,4350,151,85,80,5,99.42965779
31387558ce02efbad13209af7943eca90a258df7,1,3,3,0,0,0,0,1,10,2,1,1,0,477,122,2,119,119,0,2524,2523,1,69,69,0,100
445f7d17512a44169df70d8ecbb55f6318c70e79,4,8,10,2,0,0,0,1,12,170,1,3,1.836591668,370,123,3,57,57,0,3368,3398,30,20,20,0,100
a034755f6872c1f353c903a96dcc00de523664ad,16,59,91,32,0,0,0,1,15,108,1,8,3.773598688,3404,124,4,693,691,2,22436,22508,72,282,281,1,100
821c7d9e8907553b7c846f3816c3df47ae5b04d7,1,4,7,3,0,0,0,1,3,0,1,1,0,29,125,5,7,7,0,195,208,13,5,5,0,100
2d3c57475c4c190d215850b57c6462c7905c3118,9,56,50,6,0,0,0,2,10,342,2,7,2.306940008,1207,126,6,211,211,0,11136,10971,165,82,82,0,100
1a7bf903713bbf50e0dfc3f2dbf8c8aca4e594bb,0,0,0,0,0,0,0,0,0,0,0,0,0,0,135,0,0,0,0,0,0,0,0,0,0,100
40b08ad9f7c061522a9666df989f9b3838689fa8,0,0,0,0,0,0,0,0,0,0,0,0,0,0,136,1,0,0,0,0,0,0,0,0,0,100
14a3feacbb0238220641aaf596fe8feae8f95348,0,0,0,0,0,0,0,0,0,0,0,0,0,0,137,2,0,0,0,0,0,0,0,0,0,100
51b9d94e8b396da5b79beda55fdbe043ebf071c7,1,1,1,0,0,0,0,3,8,167,1,1,0,106,127,7,17,17,0,754,756,2,7,7,0,100
43a5c740d434d2901eaf0b24c4b1045a26e46405,3,44,4,40,0,0,0,1,12,24,1,1,1.572109363,743,128,8,199,192,7,4367,4092,275,103,100,3,100
d91ba0d7e848f4792bb78b05d5ce2ac5be95a462,46,407,345,62,0,0,0,2,14,327,2,20,4.4171316,5111,129,9,1045,1045,0,45899,45884,15,453,456,3,100
4c3897952879450e18840bef4959368b92674a64,1,1,12,11,0,0,0,1,15,0,1,1,0,265,130,10,51,51,0,1898,1893,5,13,13,0,100
1bc8b432472632fdd4b76d4a8240161ee39b9bbf,0,0,0,0,0,0,0,0,0,0,0,0,0,0,131,7,0,0,0,0,0,0,0,0,0,100
db1b3ebe10055325b5c7ee9b6f55ba0cdfcb73bb,1,1,1,0,0,0,0,2,23,108,1,1,0,268,132,8,57,57,0,1910,1906,4,30,30,0,100
cce7bb3123423464b87d86e131f5b2baf6b535ad,1,1,1,0,0,0,0,2,7,418,1,1,0,142,133,9,27,27,0,1238,1238,0,7,7,0,100
4e16b527cfce42c54e27db78bcf82da11dc7d025,5,45,52,7,0,0,0,2,12,377,2,4,2.076352726,578,134,10,104,104,0,5253,5255,2,34,34,0,100
3c8a038ed7b6571d66984e7cf5756ab4816a313e,0,0,0,0,0,0,0,0,0,0,0,0,0,0,138,0,0,0,0,0,0,0,0,0,0,100
2106581be160d557eb3fb3849b5dca26714d86a4,0,0,0,0,0,0,0,0,0,0,0,0,0,0,139,1,0,0,0,0,0,0,0,0,0,100
ce91768b58508f308b9415e1600a3753c8d76219,33,3610,0,3610,33,0,33,1,1,0,2,3,4.668762411,0,12,0,329,0,329,19514,0,19514,178,0,178,95.99631845
16cd249c8d8695dd9c65ad25d341569c788d2b78,0,0,0,0,0,0,0,0,0,0,0,0,0,0,13,1,0,0,0,0,0,0,0,0,0,100
c247fa9357edf68c4d9932f1dc4110eace208483,10,490,253,237,2,0,2,3,12,187,2,3,2.983466505,791,140,2,144,124,20,8067,6820,1247,57,50,7,99.23869234
e2e966abc4ade5da8ebf44ff29fb830591aa9793,0,0,0,0,0,0,0,0,0,0,0,0,0,0,141,3,0,0,0,0,0,0,0,0,0,100
fd33ae90dee21a7c665aafa66fdedcb7f8afe43b,0,0,0,0,0,0,0,0,0,0,0,0,0,0,142,4,0,0,0,0,0,0,0,0,0,100
e6645fa8d9896b9742853bc794e40ccba1ea0693,0,0,0,0,0,0,0,0,0,0,0,0,0,0,143,5,0,0,0,0,0,0,0,0,0,100
b25dd6b61bbda943f2f6658a728253b2a8e9d36b,0,0,0,0,0,0,0,0,0,0,0,0,0,0,144,6,0,0,0,0,0,0,0,0,0,100
bfa970fc025da7a23eb61d72b0cc7be4c8851318,0,0,0,0,0,0,0,0,0,0,0,0,0,0,14,2,0,0,0,0,0,0,0,0,0,100
b2a36644582be4918493f1821fd9593b1f92995a,4,48,78,30,0,0,0,3,13,0,2,3,1.532651699,617,145,7,86,89,3,5253,5472,219,24,24,0,99.91023339
92d065769acf37ea1c278815947ca5a63adfd69c,0,0,0,0,0,0,0,0,0,0,0,0,0,0,146,8,0,0,0,0,0,0,0,0,0,100
9cb904515a81533b67de16c9f88278a5e1983edf,0,0,0,0,0,0,0,0,0,0,0,0,0,0,147,9,0,0,0,0,0,0,0,0,0,100
0b2b622be761b28fe085c7fc0792e2806e2b1cf1,0,0,0,0,0,0,0,0,0,0,0,0,0,0,148,10,0,0,0,0,0,0,0,0,0,100
95368a7d4286d236a302cfb2ce203afb2adf3479,29,127,186,59,0,0,0,2,14,16,1,5,4.339897105,2086,135,8,280,285,5,17019,17047,28,153,152,1,100
ef577dcf532aaddf1735f3aa1b9bd58c3d3dfb05,8,302,8,294,3,0,3,1,3,0,2,3,1.71450813,215,15,3,54,24,30,3332,1792,1540,30,15,15,99.64205817
29bfe1d4c99617d4f60e9366d0a48bbe720df24b,0,0,0,0,0,0,0,0,0,0,0,0,0,0,149,11,0,0,0,0,0,0,0,0,0,100
e8f874256a9a239080add01c197fd3a28dc94853,0,0,0,0,0,0,0,0,0,0,0,0,0,0,150,12,0,0,0,0,0,0,0,0,0,100
258b538f1db04b5a0656455cf4ff3fd18a2833c6,0,0,0,0,0,0,0,0,0,0,0,0,0,0,151,13,0,0,0,0,0,0,0,0,0,100
e6ee6da3b9b4d0b8cdaa1b0e083a11a0cfafd782,4,8,8,0,0,0,0,2,11,210,1,3,1.811278124,283,136,9,45,45,0,2234,2228,6,19,19,0,100
a5f14365c6c451c6e042f1e8d9052babe3b9289d,0,0,0,0,0,0,0,0,0,0,0,0,0,0,152,14,0,0,0,0,0,0,0,0,0,100
f68cbda6a26fa6ac988d6b21e185c3f32a22d89d,0,0,0,0,0,0,0,0,0,0,0,0,0,0,153,15,0,0,0,0,0,0,0,0,0,100
a3228d9f4a43f7a15a68d5b96d36579fa719097f,0,0,0,0,0,0,0,0,0,0,0,0,0,0,154,16,0,0,0,0,0,0,0,0,0,100
4f0f8e077f67bbc1c33c82d873a6b262ad6785f8,0,0,0,0,0,0,0,0,0,0,0,0,0,0,155,17,0,0,0,0,0,0,0,0,0,100
3ecf83f6af209815c876494c4b60049e0e96a550,0,0,0,0,0,0,0,0,0,0,0,0,0,0,137,0,0,0,0,0,0,0,0,0,0,100
897e904b75a26ab9578cca5b0c9824121846c028,0,0,0,0,0,0,0,0,0,0,0,0,0,0,138,1,0,0,0,0,0,0,0,0,0,100
f89f04389ca317f9d6c3975b6b0d59d965873662,0,0,0,0,0,0,0,0,0,0,0,0,0,0,139,2,0,0,0,0,0,0,0,0,0,100
5f6b134ab8e79204fef6b05f741bb3ab577b54eb,10,12,11,1,0,0,0,2,15,106,1,6,3.149229762,870,140,3,146,146,0,6570,6631,61,83,83,0,100
6b1176dc2e26a7c64fdfd72c7708bfdb97eccc84,7,738,6,732,6,0,6,1,12,39,1,3,2.503070326,246,141,4,124,45,79,5495,1899,3596,47,21,26,98.85664028
9d613083770a7f28920b6ed65be862c2f7318f24,8,390,36,354,3,0,3,1,12,46,2,6,2.164399436,547,16,0,142,101,41,5867,4181,1686,72,59,13,99.0881459
0d94cc31bd242cd284a66ed94e0bcc77a0b3eed6,2,266,0,266,1,0,1,1,8,167,1,2,0.473744354,108,142,5,78,31,47,2357,899,1458,25,4,21,98.19576004
7f4aade6993e832fd6dcb3a079365014661f5fbe,1,1,1,0,0,0,0,5,13,3,1,1,0,197,9,0,36,36,0,1204,1204,0,21,21,0,100
55f131e571bdb0128ef22e08054b504e665dc869,1,17,16,1,0,0,0,2,2,284,1,1,0,176,10,1,31,34,3,1209,1265,56,21,22,1,100
806e42d710befde918c11f5742a7dbd568c782e0,1,2,3,1,0,0,0,1,9,0,1,1,0,134,143,6,39,37,2,1123,1103,20,5,5,0,100
21ec19b3a86bc6ade4a3433fa22de5573f0ac864,1,12,1,11,0,0,0,2,24,100,1,1,0,268,144,7,60,57,3,2019,1910,109,30,30,0,99.0880073
b12b3493cceace6f5d04e7d7e801f00a572cae1a,7,19,8,11,0,0,0,2,11,128,2,7,2.397526743,848,145,8,118,116,2,7746,7710,36,57,56,1,100
14a5d584243d39f70d3590d699c01956d4a5627c,1,1,27,26,0,0,0,2,3,1,1,1,0,163,11,2,31,31,0,1159,1209,50,21,21,0,100
92385547a6c26ae57e7a8818c113769584baa20d,1,1,0,1,0,0,0,3,25,0,1,1,0,277,12,3,60,60,0,2032,2019,13,30,30,0,100
c84f4a16e16a0cdad1d42c0bd01c17192eeb4643,2,2,3,1,0,0,0,1,2,4,1,2,0.970950594,184,17,1,39,39,0,1492,1505,13,11,11,0,99.33333333
4df33688b9aa49c1b19a4a7a551ec72e40a49b82,2,8,4,4,0,0,0,3,26,0,1,1,1,435,13,4,95,91,4,3223,3191,32,51,51,0,100
d2aad3a9b0060d387eb97450f06d25f781320b77,1,14,1,13,0,0,0,2,5,140,1,1,0,60,14,5,14,14,0,412,385,27,6,6,0,100
c7626983d918ee0fe1b6c4adf7142475cf5102c6,5,350,11,339,2,0,2,1,11,52,2,3,1.594815931,587,18,2,162,115,47,6546,4609,1937,80,67,13,98.70304114
ff8a5ffa2c97528dcada15b6a4de94eaa90129bb,1,2,4,2,0,0,0,3,11,0,1,1,0,226,19,3,46,46,0,1584,1600,16,26,26,0,100
bd96a63b8f64a44a1d18c5ffffc36a75af628dac,1,14,10,4,0,0,0,1,2,289,1,1,0,56,146,9,18,16,2,439,366,73,12,11,1,99.16782247
ab30512333c848befd5c1c8064e190ebb919c0c6,2,3,1,2,0,0,0,3,27,1,1,2,1,345,147,10,80,80,0,2507,2487,20,42,42,0,99.09566873
c4115cefe758a88503f8a9b4243b621cb288fb6b,1,17,4,13,0,0,0,2,6,3,1,1,0,63,148,11,14,14,0,412,412,0,6,6,0,100
96bd5a3b13d939a82ba1aaaf2607378129bef3b4,42,54,49,5,0,0,0,3,16,223,2,25,5.293452532,4286,20,4,564,564,0,39502,39179,323,211,211,0,100
fe501e2b9f2942f1e0751e37f99d8de58d58a2b2,5,20,390,370,0,0,0,2,5,58,2,5,1.42161145,602,149,10,63,115,52,3228,5027,1799,25,61,36,99.3824228
2bbffd59d897e443a8b9a99d7d97bf9a1310792e,7,117,26,91,0,0,0,2,28,322,1,5,2.670524873,821,150,11,174,164,10,6631,6151,480,97,90,7,100
d23cf1a126732a659c16673b7c82c64a5f4f793a,1,8,2,6,0,0,0,2,8,5,1,1,0,148,151,12,18,16,2,1239,1208,31,11,11,0,100
1b9c5349ee77a32f1b269aef883e7718dc07c1aa,2,14,2,12,0,0,0,3,29,28,1,2,0.988699408,442,152,3,97,96,1,3425,3349,76,45,45,0,100
369c86fb2bb00026ca8f5feee272c61786776a5f,5,140,11,129,2,0,2,2,15,182,1,2,1.647008963,170,153,4,42,31,11,1659,1263,396,24,16,8,99.76348155
43b810ea022387cd97b8fc07d68bf00fadd1b08b,3,46,53,7,0,0,0,1,13,318,1,1,1.58190828,448,154,5,100,104,4,3338,3379,41,29,29,0,99.2481203
61bfdee84c3d32af3f389279da56d6a60e3cebdd,1,1,5,4,0,0,0,2,3,312,1,1,0,46,15,0,8,10,2,376,395,19,5,5,0,100
cdf74895119d5429cd30d5757a2c06e5ccb3ecef,1,1,3,2,0,0,0,2,3,334,1,1,0,203,155,4,40,40,0,1648,1667,19,15,15,0,100
40ee01bc95f337c5f7eec4ceb423c4c40f14f4f8,2,11,6,5,0,0,0,2,8,54,1,1,0.787126586,132,156,5,13,13,0,1107,1107,0,5,5,0,100
86a3ccf8cf660e4f9b8669c068474862f6006ee5,2,17,11,6,0,0,0,1,12,187,1,1,0.905928216,373,157,5,70,72,2,2971,3004,33,29,29,0,100
906d2ecc0749d34fecb393d033ae5a0a9bcb7237,3,12,21,9,0,0,0,2,30,82,1,3,1.095795255,584,158,6,135,138,3,3877,3926,49,62,62,0,100
4c0f0e04f6d0b10c52c7dc4e9651ce591d1e386e,2,147,0,147,2,0,2,1,1,0,1,2,0.975525951,0,21,0,13,0,13,762,0,762,6,0,6,99.76668222
18e90285f9b79c1ccbcee9fa9493fa4c99188da3,3,120,18,102,0,0,0,3,15,196,1,2,1.092331702,264,22,1,81,62,19,2721,1976,745,41,36,5,100
c433d1cd0b58e986466bd26af8ae7c145578ac7e,1,7,4,3,0,0,0,1,7,226,1,1,0,51,159,7,17,15,2,314,302,12,7,7,0,100
a3d6c426d8c1aacec2321a393dc4bd1794b9952a,1,4,1,3,0,0,0,1,15,230,1,1,0,528,160,5,86,86,0,3188,3180,8,38,38,0,100
1605504a8dd31e03f048ae33c491daebfc08770b,1,3,0,3,0,0,0,1,16,242,1,1,0,255,161,2,52,51,1,1917,1898,19,13,13,0,100
766cd3d7e3e19a83075fc95a75eb3e747d0e701f,1,4,3,1,0,0,0,3,31,48,1,1,0,285,162,3,61,61,0,2077,2077,0,30,30,0,100
b1bb1c7524f67fc699bd14e4618b5447c2cca2fb,4,11,23,12,0,0,0,4,17,149,2,3,1.422658167,588,23,0,87,87,0,5211,5241,30,25,25,0,100
e9a5145d2277ad1f365870d60dfb081ce08fa986,24,18,30,12,0,0,0,2,15,341,2,15,4.277235419,2945,163,2,502,502,0,22981,23058,77,209,209,0,100
c24581008b0681c5577519e136329c94323684a4,26,59,59,0,0,0,0,2,16,161,2,8,4.344591043,2269,164,3,377,377,0,18558,18526,32,173,173,0,100
05ccf2c38c5eed0460b2cd45cb20f4439aa655d6,1,1,1,0,0,0,0,2,7,4,1,1,0,32,165,4,5,5,0,256,257,1,4,4,0,100
ffc036cdb90d3e03ce6d2a7c6c83af75903cf17d,1,20,19,1,0,0,0,3,9,258,1,1,0,106,166,5,17,17,0,759,754,5,7,7,0,100
9551dbdfcf8d0cb1988e976672f0e9600b855e42,0,0,0,0,0,0,0,0,0,0,0,0,0,0,167,6,0,0,0,0,0,0,0,0,0,100
7f6829635ebadb2041835e8f96db71da6b954121,0,0,0,0,0,0,0,0,0,0,0,0,0,0,168,7,0,0,0,0,0,0,0,0,0,100
cbe629418a70ca2ad9736e40a4ff92c1a7eb3d32,0,0,0,0,0,0,0,0,0,0,0,0,0,0,156,0,0,0,0,0,0,0,0,0,0,100
de25169a4b6ca09cab875713bc3fb2eb60b55b1b,3,6,6,0,0,0,0,1,16,156,1,2,1.251629167,670,169,8,138,138,0,5322,5321,1,38,38,0,100
34c357ffb0499fad4613b8500e9a2f10ac6fde7f,2,113,18,95,1,0,1,1,2,85,1,2,0.97356684,139,170,9,35,24,11,1558,1151,407,18,12,6,99.20597851
cc1ac9178d30a86c89336ef7ea46f9ecdf276d5c,3,163,9,154,0,0,0,4,11,329,1,2,1.453670478,328,157,1,89,71,18,3358,2483,875,40,35,5,100
429c226a71f91343b36b45eba6bfb4e3d4798e98,1,13,2,11,0,0,0,2,10,31,1,1,0,105,158,2,10,8,2,909,806,103,2,2,0,100
9fdf7c789bad91ff6772301b6eb3494b17f7f539,1,1,1,0,0,0,0,1,13,122,1,1,0,166,171,10,36,35,1,1354,1333,21,15,15,0,100
6ecc0a0f69df52ec26604a2dc1bfc3b5f6da88a0,1,1,1,0,0,0,0,4,10,36,1,1,0,43,24,1,5,5,0,403,403,0,3,3,0,100
1437684155d8506541a756d8d6f62e0051c5bcde,4,21,78,57,0,0,0,3,12,334,1,2,1.480286588,653,25,2,95,98,3,6009,6451,442,38,39,1,99.90619137
52b70867964d2867ba135e5955463ad5b731128d,8,26,36,10,0,0,0,4,13,207,1,6,2.583679326,902,172,9,181,182,1,6842,6871,29,86,86,0,100
0df97e3106743bbdc8ae913b3027e7c0360e0c0f,6,147,9,138,0,0,0,4,16,225,1,2,2.167852387,1200,159,3,317,300,17,9927,8947,980,167,161,6,100
af7140eeaeab155f580f66cae6d756e8060ac0e3,1,2,1,1,0,0,0,2,6,39,1,1,0,82,26,2,10,10,0,710,699,11,5,5,0,100
efd2643a0ed67e540aa54097846c47610a6bb96c,10,92,24,68,1,0,1,4,18,221,2,7,3.037326301,436,160,4,47,47,0,4011,3808,203,28,28,0,98.02025783
e80a99dc680f9cb6fe528cdd96a0f139b3b403ef,1,1,1,0,0,0,0,2,4,45,1,1,0,138,27,3,28,28,0,1111,1111,0,12,12,0,100
cfbf06228de52ca2f12d16238b2c2ce46a97d9ce,1,23,14,9,0,0,0,5,14,187,1,1,0,197,161,5,37,36,1,1251,1204,47,21,21,0,100
ca7f6d9a13535e619394ec04588e143f602a8b8d,40,794,607,187,3,0,3,2,17,206,2,9,4.316656024,5897,28,4,1397,1408,11,50436,49281,1155,662,660,2,98.68896926
3e7c67bd6121919ca4d19f746b07d6575ff413c3,2,19,8,11,0,0,0,4,15,0,1,2,0.691289869,556,29,5,108,104,4,4536,4575,39,49,49,0,99.18809202
50629d68e03c26080cbe1800f6f7a07f39b3489a,3,44,0,44,0,0,0,4,16,0,1,2,1.448575666,619,30,6,111,108,3,5070,4892,178,51,49,2,100
9b10f7f6d5f8b6419dc633e1efefdea0bacb1d48,2,11,8,3,0,0,0,2,2,0,1,1,0.998000884,103,162,6,6,6,0,911,883,28,4,4,0,100
3aced6c72cf44d71d209c55c90abd19302f8815a,5,156,9,147,0,0,0,4,18,0,1,2,2.102790109,999,163,7,240,202,38,7838,7224,614,113,102,11,100
1a0efb0e5d31d700fd909e6bba92042b803428f6,1,4,0,4,0,0,0,4,19,5,1,1,0,123,164,8,12,12,0,890,890,0,6,6,0,100
b01005ae9a393cacd9393b45f0082038426f6175,2,6,4,2,0,0,0,3,3,0,1,1,1,106,173,4,6,6,0,921,911,10,4,4,0,100
032fff5eb2d8d7245acdc2773c459ea1acc06bd1,3,0,15,15,0,0,0,2,5,0,1,1,1.584962501,12,174,5,0,0,0,48,72,24,0,0,0,100
db362c22307a9cdb51bdb81fe7db6e380a7b12bc,11,781,0,781,11,0,11,1,1,0,1,3,3.133254403,0,165,9,54,0,54,3672,0,3672,25,0,25,98.89135255
f0c89957e530d2429c8fce291c5eba0569680d08,4,268,33,235,0,0,0,3,7,108,1,2,1.591415395,741,31,7,223,196,27,7804,6489,1315,84,72,12,100
bfba4bc22fdaa570c27e6ef8328ac157cc1ccaa3,1,9,1,8,0,0,0,3,32,60,1,1,0,285,175,6,63,61,2,2100,2077,23,30,30,0,100
206cee03ceea35d36720aacefd411eda5172dc32,2,14,9,5,0,0,0,1,2,0,1,2,0.666578358,245,166,10,32,30,2,2203,2171,32,9,9,0,100
98a79f4765cb4a905c38872a617df17a90195f5e,2,52,2,50,1,0,1,1,3,0,1,1,0.935711051,169,167,11,22,18,4,1887,1697,190,3,2,1,99.78137298
26cb05dd177009b4c41a50ec8427ca4d62e20890,1,3,1,2,0,0,0,1,4,0,1,1,0,183,168,12,21,21,0,1834,1824,10,2,2,0,100
4319ae37d5e973f71b60789107f452e58c4d9ea5,1,2,1,1,0,0,0,1,2,2,1,1,0,46,169,13,7,6,1,326,320,6,6,6,0,100
0d2afee5251d2116c7a4872a1b810562c5b15f1f,1,1,0,1,0,0,0,3,33,3,1,1,0,288,170,13,63,63,0,2100,2100,0,30,30,0,100
c5f77f735ec22905339dd731d1b935c743b800ba,5,10,10,0,0,0,0,4,14,41,1,3,2.121928095,1385,32,8,373,373,0,12066,12094,28,175,175,0,100
40aa3e89f5ef0e82844c602615f5c54184574b9d,40,655,484,171,2,0,2,2,19,84,3,13,4.323046347,6588,176,7,1560,1546,14,55365,54577,788,729,721,8,99.82547993
c4efb9f45815bf28b3286f4e7593767e88753f35,2,26,1,25,0,0,0,2,34,85,1,2,0.975119065,442,177,8,84,81,3,3499,3339,160,43,41,2,100
8eb6d1df1e4420365a63dd6bb2d28c4fcd1b5cb5,11,28,99,71,0,0,0,3,20,0,1,2,3.075662084,1643,33,9,448,453,5,11933,12248,315,210,218,8,100
3172bd1bb1bf533b614e0311c3e5375205cc6037,12,413,149,264,0,0,0,3,19,0,1,2,3.324116402,2344,34,10,699,674,25,20552,18838,1714,297,283,14,98.97654584
b80b5bbf6d354a1f522c25def3ca2139364ee075,9,122,230,108,0,0,0,3,21,182,2,4,2.832398619,1110,35,11,193,195,2,9209,9753,544,87,91,4,99.20634921
fdd56b559e99ad77cdbe39e9926d4515e0ee9565,1,2,1,1,0,0,0,4,16,2,1,1,0,551,171,14,88,88,0,5504,5491,13,32,32,0,100
85de9d46518d60d657cc4acfe0fc44f41412b0ae,2,16,4,12,0,0,0,4,20,8,1,1,0.721928095,732,36,12,216,216,0,5288,5288,0,74,74,0,100
781d81bf74b066208e45eadfd40e48757a9ed2cd,1,11,2,9,0,0,0,4,21,0,1,1,0,378,37,13,104,103,1,2403,2372,31,42,42,0,100
0ddd8cc06d6c110869b517e0b922fc98df5ae0eb,1,1,1,0,0,0,0,4,16,9,1,1,0,53,178,7,0,0,0,361,359,2,0,0,0,100
075ea19c17260ac3e7bff82792a604b690259c5a,42,1278,713,565,9,0,9,1,20,86,3,13,4.610175404,3458,172,13,564,503,61,32293,29724,2569,244,202,42,95.72425829
4d2a7f4b34661faac4b5316f556c749dd1b061e0,2,0,103,103,0,0,0,3,6,285,1,1,0.988478323,53,173,14,0,4,4,0,510,510,0,4,4,99.58810069
917cca0f238b6c33fbe7527a17cb619ae4451858,7,123,183,60,0,0,0,3,18,2,1,5,1.55485178,1427,38,14,266,270,4,10725,11225,500,111,112,1,98.86518384
69e6ced726f5e516f85e6bcd9620acf474b794e2,1,126,103,23,0,0,0,4,16,1,1,1,0,228,174,15,48,46,2,2292,2034,258,11,11,0,98.58898498
17d937ade65d164b0151186e2feedc2bd9d07c23,1,3,3,0,0,0,0,1,6,2,1,1,0,181,175,16,20,20,0,1881,1879,2,3,3,0,100
63e11c0028e5338410f21dd0458d59751a2d4b4d,4,140,5,135,2,0,2,1,2,0,1,3,1.760564731,40,176,17,18,6,12,882,263,619,13,4,9,95.90669014
3db6c9e31c5858600f673699a5c8fcf1d0ec513c,3,111,1,110,2,0,2,1,7,0,1,2,1.137884076,181,177,18,31,20,11,2494,1881,613,10,3,7,99.7900042
83402dc91a76de4e80ad5f86607ed71d29c1f1e1,1,99,0,99,1,0,1,1,1,0,1,1,0,0,178,19,8,0,8,766,0,766,2,0,2,99.87437186
b19a51e05eb5cea29cb7cd84a67612192cebdb92,2,2,1,1,0,0,0,1,8,0,1,1,0.918295834,263,179,20,28,28,0,2671,2661,10,5,5,0,100
be42fe00ae95b3d750f1f95f451db445d4a47f6e,12,233,361,128,0,0,0,3,17,309,2,3,2.705915502,877,39,15,130,142,12,6721,7407,686,64,66,2,99.91624791
2afb63115c63adfb7206e3f2abdf33da2dfce147,1,5,1,4,0,0,0,1,2,0,1,1,0,46,180,21,9,9,0,257,257,0,6,6,0,100
93798790e3ad53ab13ebdcda28eaac5089eafbf3,1,9,8,1,0,0,0,1,3,0,1,1,0,82,181,22,8,8,0,770,777,7,2,2,0,100
abcb7f5bea440c59ae9d3e194d5323d847d62101,12,292,255,37,0,0,0,1,7,61,2,5,2.549388659,993,40,16,139,138,1,8980,8936,44,77,75,2,98.91576314
1145c455a5316c04cdbc18917bb4b0c461af64ec,0,0,0,0,0,0,0,0,0,0,0,0,0,0,182,23,0,0,0,0,0,0,0,0,0,100
11a21dcf5e2968829930cc0810f72e77dd423bba,25,862,284,578,2,0,2,1,22,12,2,9,4.078495604,3029,183,24,733,694,39,26508,23452,3056,376,342,34,99.7928749
2ce1755e34b739bbe754805aa146206b1809d2d3,1,17,4,13,0,0,0,1,9,2,1,1,0,182,184,25,22,20,2,2078,1894,184,3,3,0,100
cfa2ed7a9d27753e39248bb1ce8c0be35bba628d,1,10,7,3,0,0,0,2,2,2,1,1,0,32,41,15,6,6,0,181,181,0,6,6,0,100
8fdd78ccbb513df5aa4399a90039cf2e7bbce8d6,8,38,53,15,0,0,0,3,20,0,1,3,1.99578521,841,42,16,143,142,1,5627,5747,120,86,85,1,99.41932808
298eee07f074a7a56f3232ba73bd7a450c1c6338,14,297,70,227,1,0,1,3,23,39,1,4,3.071034652,1295,185,26,305,273,32,9270,8251,1019,178,160,18,99.00373599
ef99043f9b20dbd10c44c25f3d1721284f8d49ff,1,2,2,0,0,0,0,3,10,6,1,1,0,44,186,27,5,5,0,371,370,1,3,3,0,100
cbc4347fa5fc2fc5690705ab969cc035aff9957e,1,1,1,0,0,0,0,4,13,6,1,1,0,53,187,28,5,5,0,513,513,0,3,3,0,100
43585266cc110b0023d69945ed84980e8f024a48,1,0,1,1,0,0,0,4,11,0,1,1,0,35,188,29,4,4,0,268,283,15,3,3,0,100
fad901ea214d6138061cfaebca7582255ed8f8b9,1,1,1,0,0,0,0,4,21,6,1,1,0,135,189,30,12,12,0,1019,1019,0,6,6,0,100
e74ae9b4119f6807a79a2b937849ec4b2460fb08,1,20,14,6,0,0,0,4,14,0,1,1,0,53,43,17,5,5,0,530,513,17,3,3,0,99.83423125
3ae4c54bfe46ac08b2a9f132de6b58c1b9b330ab,1,1,1,0,0,0,0,4,22,1,1,1,0,135,190,31,12,12,0,1019,1019,0,6,6,0,100
e9ecfe16e2689554c63224cde26c3b8bae74c242,1,19,0,19,1,0,1,1,1,0,1,1,0,0,191,32,1,0,1,69,0,69,1,0,1,99.91714996
d87b7a37608fa8ceb51bbbea96d59d642d37db70,1,4,7,3,0,0,0,1,10,3,1,1,0,196,192,33,21,22,1,2062,2078,16,2,3,1,99.4599086
addeb36841bb43a80c53fc748e29fb0a1e6fa021,1,12,2,10,0,0,0,3,8,5,1,1,0,69,193,34,12,10,2,598,526,72,2,2,0,100
ad88a2fef2c3e26176cbe18755e7928ccfe12ad9,5,200,106,94,1,0,1,4,23,1,2,3,1.677056866,581,194,35,98,82,16,6518,5203,1315,24,24,0,99.16909015
a7fc9bf00e408e57a22507198cc0e509392d1107,1,3,0,3,0,0,0,1,2,0,1,1,0,50,195,36,8,7,1,489,466,23,1,1,0,100
9d0b2199b44347c8a5fce00fdface750da9810a2,1,2,2,0,0,0,0,1,11,0,1,1,0,192,196,37,21,21,0,2062,2062,0,2,2,0,100
7c2ec2012c961e4fa82d48cf7e3814d854790f19,1,1,1,0,0,0,0,4,16,0,1,1,0,60,44,18,5,5,0,532,532,0,3,3,0,100
75e76eb0289bf752de84ed1eca27fe3341fc9df4,4,68,56,12,0,0,0,4,24,0,2,3,0.479672146,691,197,38,100,99,1,6576,6541,35,24,24,0,100
5ba24cb62939b35f5336ad3aa24119c0a74313f2,4,248,29,219,0,0,0,4,25,5,1,2,1.712829246,376,198,39,50,38,12,5768,3585,2183,17,17,0,99.87618655
d2d9d85abcc2f26449cff850c1e8a52de5f5fca5,1,3,1,2,0,0,0,1,4,0,1,1,0,53,199,40,8,8,0,503,491,12,1,1,0,100
d6db69f2b5a86113538cae86099820726faedb69,1,3,1,2,0,0,0,1,2,6,1,1,0,88,200,41,8,8,0,891,869,22,2,2,0,100
76c06269d745e27247c410f357d9e43598c3eb5b,1,14,7,7,0,0,0,1,3,1,1,1,0,90,201,41,9,8,1,987,891,96,2,2,0,99.87659399
09b74e67d69a00b9a488aa9c608bfe954fa7c888,1,5,0,5,0,0,0,4,26,1,1,1,0,240,202,42,28,27,1,2325,2270,55,8,8,0,100
40cf7d3b9c0f67fa274b3a3a650d4c7fc6a5cc71,1,112,0,112,1,0,1,1,1,0,1,1,0,0,203,43,9,0,9,923,0,923,2,0,2,99.8767461
4fb3040df537e536f87b84402e105bfe027c23f8,1,2,2,0,0,0,0,4,19,8,1,1,0,343,204,43,60,60,0,3294,3290,4,12,12,0,100
c7d3f6da3c4fcedd001a6587c8194cac356aff46,2,2,2,0,0,0,0,4,22,6,1,2,1,553,45,17,99,99,0,4634,4634,0,34,34,0,100
9acbff2a8c8b09ca713a562a738d6849c0268abf,6,257,115,142,1,0,1,4,27,8,1,4,1.41857529,875,205,42,133,122,11,9336,7993,1343,28,30,2,99.62993421
089d1329cff0a8412470b897cdc6bcd09f7a9793,5,9,7,2,0,0,0,3,28,7,1,3,2.173794941,1082,206,40,151,151,0,9915,9891,24,29,29,0,100
25166b2453e4b588460b509e461191056416cc68,34,220,176,44,0,0,0,2,29,18,2,11,4.513603705,4127,179,1,799,800,1,31093,31417,324,374,374,0,99.23325262
f55276b6465b5c91c7b5c2b7bc201be2eb937bf1,21,353,102,251,0,0,0,2,7,72,2,12,4.287920855,681,180,2,108,107,1,5213,5126,87,67,67,0,100
83637d70dd569b4cdf7d32616728ec9b7a5b8760,11,84,72,12,0,0,0,4,25,16,1,1,3.116950332,2254,181,2,635,628,7,15714,15382,332,284,282,2,100
d023be63369a9bf9bce6426442ea1d6c92428142,10,31,33,2,0,0,0,3,22,112,1,6,3.12343651,2123,182,3,468,467,1,19543,19599,56,192,191,1,100
f08dae3d162d0861183d60098134b49055cae168,2,17,0,17,0,0,0,1,5,474,1,2,0.873981048,78,183,4,27,22,5,610,503,107,14,12,2,100
8535e20f0675c7b605fa6789194beb10577d364e,4,456,3,453,2,0,2,1,17,63,1,2,1.169811894,669,184,5,156,115,41,6263,4375,1888,58,42,16,99.29660023
e02a166a1b61abb857832ee19bdc996333a38515,4,59,43,16,0,0,0,1,18,0,1,2,1.367100791,965,185,6,155,156,1,6474,6263,211,60,58,2,100
39bfe7c3eda44bbeb3434c0365efec608814690f,3,144,32,112,1,0,1,2,7,336,1,1,1.480805535,130,186,7,45,30,15,1771,1099,672,21,13,8,96.01910828
00a6c61392fff55edc17ad3339931563730a1410,3,23,13,10,0,0,0,1,18,135,1,1,1.251629167,644,187,8,96,94,2,3982,3925,57,48,48,0,100
aa1bf8f5be6428b33936202f4995647b71ce0876,6,132,16,116,1,0,1,1,19,218,1,2,2.448235195,949,188,9,175,149,26,6157,5705,452,74,69,5,99.71276159
20bb0d9afc78dcfeccef2c88e901ae76a89c5ec6,4,62,12,50,0,0,0,1,20,0,1,1,1.815949724,937,189,10,153,144,9,6048,5729,319,67,63,4,100
a9ec40f287e1d189a0b935c622eb5d98c152e259,1,19,1,18,0,0,0,1,21,0,1,1,0,601,190,11,100,98,2,3766,3642,124,44,42,2,96.1339179
b25ad9d2dadf961fb79ac37a2d4f26a9135ee3ce,321,4464,4929,465,1,0,1,2,35,245,1,60,7.453187035,26423,191,12,4752,4748,4,214373,212947,1426,2280,2279,1,99.80620155
15ff4830d7430b12c54b81a3556f7dc9a402c5a3,1,16,55,39,0,0,0,1,5,0,1,1,0,81,192,13,10,16,6,373,464,91,9,15,6,100
57db294a83b2097c7ce8a87c2ae18aadbb8e04a5,3,5,20,15,0,0,0,1,23,0,1,1,1.426960814,937,193,14,149,149,0,5664,5789,125,66,66,0,100
68640a4d9ce7f8716e7e99e7cf3da9df0ff6fa30,4,46,21,25,0,0,0,1,24,0,1,2,1.78519317,1223,194,15,176,174,2,8045,7841,204,77,75,2,100
810a5d2b30d4dd7de448802a945ba91a773e1207,4,8,10,2,0,0,0,1,25,8,1,1,1.99107606,981,195,16,155,155,0,6042,6054,12,69,69,0,100
1c1e2785caafb4c22a641ec110c63ad4c9f8fd01,6,358,60,298,3,0,3,1,26,1,1,4,2.240430732,980,196,17,160,142,18,7278,6170,1108,80,67,13,98.23108769
3581c4ffdf2a98da970d959d6c32be825704e131,2,14,2,12,0,0,0,1,2,0,1,1,0.811278124,141,197,18,18,16,2,894,864,30,13,13,0,100
3e3f96792d0c01ea1b8378d4e00197614259d79e,2,18,4,14,0,0,0,1,11,0,1,1,0.439496987,319,198,19,47,47,0,1991,2007,16,19,19,0,100
7df0ef08b59770f0ca81bd411a8d9532a2b1121a,1,103,95,8,0,0,0,4,31,9,1,1,0,232,46,1,27,25,2,2258,2213,45,6,6,0,100
31e36443aa0f58a27dc6c2ad1f99e7bf6aeaaa7f,0,0,0,0,0,0,0,0,0,0,0,0,0,0,207,2,0,0,0,0,0,0,0,0,0,100
d228006ff98143babe4a49bd1a8a8af8d7ebbad8,1,4,4,0,0,0,0,1,5,383,1,1,0,26,199,20,1,1,0,275,275,0,1,1,0,100
e290c8e9edfa6126dd0a2a62dbd14c4412df82bb,1,4,2,2,0,0,0,4,32,3,1,1,0,243,47,1,28,27,1,2272,2258,14,6,6,0,100
2d97d9387b83998ef24738c14174b4babb925bb1,8,180,170,10,1,0,1,1,9,346,1,1,2.788401289,310,200,21,30,28,2,2833,2578,255,15,14,1,99.92684711
dfdd58a01a4ceb935eefaa8a9c75ee34feeebb4e,1,2,3,1,0,0,0,2,8,413,1,1,0,87,208,1,14,15,1,712,710,2,4,4,0,100
7cb1bd97d34439b21408c36586ca577ba6b0a7cc,0,0,0,0,0,0,0,0,0,0,0,0,0,0,209,2,0,0,0,0,0,0,0,0,0,100
112116128251bea5face03c720949613064ffe4c,9,80,34,46,0,0,0,1,27,14,1,5,2.777660477,1538,201,21,275,258,17,11252,10864,388,105,104,1,100
3f0e5bbbf11a0b2c16c5199a8f68825cba18e476,5,134,125,9,0,0,0,2,17,140,1,1,1.841847411,376,210,3,43,38,5,4013,3782,231,13,15,2,99.10846954
cc1b29280664b1210a00c34a5c3a6eb99cb6486f,1,1,1,0,0,0,0,1,7,29,1,1,0,63,202,21,10,10,0,403,403,0,9,9,0,100
90366ccdd83d0020546dffbee852176611a3964d,2,161,1,160,1,0,1,1,21,4,1,2,0.309543429,172,203,20,61,37,24,2276,1501,775,19,4,15,99.84917044
b747675a040732515bd361b1b21da2909f42a071,1,1,1,0,0,0,0,1,2,100,1,1,0,49,211,4,10,10,0,386,386,0,4,4,0,100
9fff6c35b5942f3e592ee77e5b2c26d189add4cc,2,16,10,6,0,0,0,1,15,20,1,1,0.995727452,274,204,17,59,59,0,2130,2086,44,30,30,0,100
fec65570175a4e6b04d26bad702fefedf01696e3,1,29,14,15,0,0,0,2,3,57,1,1,0,94,212,5,13,10,3,1062,910,152,3,3,0,100
57139241cd217b6e910ffefd5743e8103086262c,7,159,75,84,1,0,1,2,14,37,2,5,2.296518907,726,213,6,113,100,13,7263,6617,646,27,25,2,99.03668025
7a96c08b5612a49109523d25680261ad1cf2c7cf,2,27,9,18,0,0,0,3,18,26,2,2,0.918295834,208,214,7,19,17,2,2056,1919,137,7,7,0,100
794d025c7b14d798bb747528ad943f287c5e54fe,1,2,3,1,0,0,0,1,2,3,1,1,0,28,215,8,3,3,0,207,214,7,3,3,0,100
0a949d84fff3d1592b27676e04ca6bb889c0920a,102,987,1704,717,0,0,0,2,36,83,3,32,6.082503724,9581,205,10,1561,1646,85,72116,76386,4270,753,794,41,97.1168437
4d1b7231f462d8d4a7a61566c081e6b3bae53217,1,1,1,0,0,0,0,2,3,49,1,1,0,52,216,9,10,10,0,368,368,0,6,6,0,100
a29296c7e31e9e994447737303ab31b9cddb2a96,3,88,26,62,1,0,1,1,5,31,1,3,0.926902207,207,217,9,31,23,8,2634,2048,586,6,6,0,99.80252765
9768420548fdcd149e5e663f37207a5b6024712d,1,1,3,2,0,0,0,1,14,17,1,1,0,317,206,5,32,32,0,2137,2143,6,16,16,0,100
02ba74191839b5d8cdaee35dddb9213358d4a572,1,19,15,4,0,0,0,1,10,38,1,1,0,69,207,6,3,3,0,654,652,2,3,3,0,100
bf710b538bd7ec4aae06a242de331205610adba3,1,8,9,1,0,0,0,1,1,0,1,1,0,192,218,7,21,21,0,2043,2062,19,2,2,0,99.48412698
ee4a2614f4644ff8571ae32de59908d37428e5fe,9,930,10,920,6,0,6,2,3,14,1,4,2.457804168,320,219,8,128,39,89,7810,3010,4800,54,11,43,98.04469274
3bad4df1265c82d201923e9c9ff5860e273e9ceb,5,54,37,17,0,0,0,1,2,0,1,2,2.19592358,616,220,9,86,86,0,4803,4696,107,40,40,0,99.6031746
20faad6330614d077d5a567aa7b6ebdd6bad5d60,6,141,54,87,0,0,0,1,3,0,1,2,1.556976519,642,221,10,93,89,4,5663,4907,756,44,43,1,100
d86c96740b02cb7651991984d6a3b4d80f7fbb2b,142,3325,3641,316,6,0,6,2,37,20,3,36,6.181474429,11460,208,4,1994,2022,28,86813,89759,2946,999,1000,1,96.56262347
d7b9ef38320b6b2e44e287fff4c4ad9f3cd31fc9,1,167,50,117,0,0,0,2,6,25,1,1,0,144,222,7,37,18,19,2254,1463,791,6,3,3,100
65be0f0afce788f735f44588e37cb4ee54fc8bb1,2,15,0,15,0,0,0,2,11,47,1,1,0.918295834,108,16,0,24,22,2,687,641,46,14,12,2,100
9e9182dca02ec2b83f25c07f5d834ea7ab818534,4,15,22,7,0,0,0,4,27,72,1,4,1.608726039,906,223,7,218,218,0,6620,6605,15,110,110,0,100
31a30f043a69164157fb255d82fe498042baead1,2,5,3,2,0,0,0,4,28,45,1,1,0.954434003,486,224,8,119,119,0,2755,2745,10,71,71,0,100
4a28bda3481b8ba3140c0602eb5f2d5b3bc7031a,3,4,6,2,0,0,0,4,29,29,1,2,1.370950594,829,225,9,206,206,0,5702,5694,8,118,118,0,100
f5062921d65ae46431c4595d56f27b44058d2f41,2,26,8,18,0,0,0,4,26,90,1,1,0.989992792,457,226,10,103,102,1,3000,2989,11,39,38,1,100
ead7576445a6d8629f3ceb8d90f92ac67387e034,1,3,2,1,0,0,0,4,27,1,1,1,0,400,227,10,103,103,0,2606,2597,9,39,39,0,100
a66f1a87253050d54ff081efb59fa32a1fa489fd,143,3064,2284,780,8,0,8,2,38,27,3,37,6.13715127,11312,209,3,2111,2015,96,87309,88081,772,1089,1037,52,98.46577498
accdbdbd5c33500cce48d3c72707d5f8ff9ce837,2,13,12,1,0,0,0,1,5,0,1,2,0.942683189,209,210,4,43,43,0,1488,1483,5,21,21,0,98.75146313
995c003e124bf6351606f444a7f533806063aa02,10,1448,0,1448,10,0,10,1,1,0,1,2,3.019259786,0,228,6,140,0,140,8173,0,8173,58,0,58,97.59080801
00dee57638092d89b37d447da7b662bce5f3fef7,6,320,14,306,5,0,5,1,11,3,1,3,2.431542071,70,211,3,37,21,16,1340,428,912,21,10,11,91.8245614
66764adcf988176006f4ced03bf83bda5d80b1f9,8,27,4,23,0,0,0,1,31,16,1,4,2.735035423,1553,212,4,307,303,4,9506,9409,97,183,183,0,100
f499b17bd7e496a4185e5bcbec20c18de39b7997,1,7,2,5,0,0,0,3,39,18,1,1,0,279,213,5,64,62,2,2043,2000,43,25,25,0,100
1a6d9c63efb4ca396073c33318220ae109d70b42,1,5,4,1,0,0,0,1,3,21,1,1,0,195,214,5,40,40,0,1388,1393,5,17,17,0,100
1d1145c6918885f0306a0310592668bb6d1382df,1,19,4,15,0,0,0,3,40,3,1,1,0,284,215,6,67,64,3,2129,2043,86,25,25,0,100
f3e63ce6ae465f9e34345e0c729ce2a087b082ed,19,78,32,46,0,0,0,1,32,13,1,9,3.81523279,3448,216,7,764,748,16,21953,21672,281,365,361,4,100
af8c8b5384b52bedee814a0f9b21deed07a18bfe,1,2,1,1,0,0,0,3,41,2,1,1,0,298,217,8,67,67,0,2133,2129,4,25,25,0,100
481b440d929971309f96a0043c1c294e08c99b9b,4,14,90,76,0,0,0,1,8,34,1,3,0.684310151,362,218,9,52,70,18,2384,2880,496,28,30,2,99.79108635
90d12eb7eba53eceae1263b798ec3658a0ae2058,3,13,3,10,0,0,0,1,14,24,1,1,1.5,177,219,10,35,33,2,1619,1557,62,7,7,0,100
b3ad106ae67ef13482f641351f8d190790d62347,4,37,29,8,0,0,0,1,6,182,1,1,1.656105103,137,220,11,21,20,1,1190,1124,66,16,17,1,99.89550679
94e8d0da0f416ff8c199862b8d349245d03ae8dc,4,22,4,18,0,0,0,1,42,6,2,3,1.49563213,560,221,12,121,119,2,4341,4174,167,49,48,1,99.89557953
553291ba1fffd4bf0c9de8d7624577e4c174b7d6,1,10,2,8,0,0,0,2,4,27,1,1,0,21,222,13,3,2,1,230,173,57,2,2,0,99.75584234
172ffcdad38045580e8859c4daacefad230cf186,14,84,90,6,0,0,0,2,30,40,1,4,3.319769988,2140,223,14,446,437,9,15303,15292,11,219,216,3,99.72135145
7a387ddb1c4196b25554f7fadd56a69749d79867,1,1,1,0,0,0,0,1,33,6,1,1,0,576,224,15,80,80,0,3624,3624,0,34,34,0,100
88b40a5aa99131f16b40761d460712f7746fbe60,1,28,19,9,0,0,0,1,10,21,1,1,0,173,225,16,42,38,4,1168,1128,40,20,19,1,100
758cc1bb5abdfb11484d0f3397886a4e7ef80d5c,85,533,511,22,0,0,0,2,24,160,3,38,5.807154851,6229,226,17,976,977,1,50780,51070,290,446,443,3,96.80416202
98c32ab4a436eeb0ddf90d8d3ce88a23aec720e7,1,8,1,7,0,0,0,1,17,41,1,1,0,228,227,17,41,41,0,1720,1714,6,22,22,0,100
26ac2a57ba86b53851dc14d24503d112bda07b5b,6,22,13,9,0,0,0,1,16,50,1,5,2.397411836,308,228,18,38,38,0,2253,2253,0,23,23,0,100
00fd47486821e36b4b356e785a5350349e9158c2,1,6,5,1,0,0,0,1,11,41,1,1,0,169,229,19,14,14,0,1983,1964,19,10,10,0,100
49697cc46f876b06feaa538b2165890b00dcbf5d,3,288,1,287,2,0,2,1,12,2,1,2,0.980639541,170,230,19,57,14,43,3067,1983,1084,30,10,20,99.8003992
fbe90e6ff946a96674284d1effc2178dd299090a,1,5,1,4,0,0,0,3,13,8,1,1,0,69,231,20,10,10,0,518,485,33,5,5,0,100
9125a01281b9e90412e362da9758f6b361eabb91,63,2944,1529,1415,23,0,23,3,19,40,2,18,5.377473062,2605,0,0,472,350,122,30750,19295,11455,203,123,80,92.97423888
7587515d345eb0d9f0aaa96a6a70465d4c2df9e4,3,62,24,38,0,0,0,1,43,29,1,2,1.21132135,953,232,21,156,152,4,6273,6199,74,66,62,4,100
5fc2f1b8690b247e0b8f451caec0ba1dc13d4132,2,20,0,20,0,0,0,1,5,26,1,1,1,338,233,22,84,78,6,1958,1858,100,56,56,0,100
67fafe27cc285fe0cf17a147224a059d6271a886,2,26,30,4,0,0,0,1,12,26,1,2,0.591672779,381,234,23,81,81,0,2587,2573,14,29,29,0,100
2835555933a8bbaa78b85589471b8040bdcd981a,5,94,20,74,0,0,0,4,31,54,1,3,1.733067614,1571,229,0,317,311,6,11866,11215,651,140,139,1,98.94019682
af5885061e0760ade8b973485502c4f447704fac,25,155,65,90,0,0,0,2,16,25,1,15,4.059180695,2281,235,10,358,359,1,18389,18266,123,143,143,0,100
6f08ad76e861bc6711e9861e2f4cb94b9434d95c,1,10,4,6,0,0,0,1,9,104,1,1,0,63,236,10,10,10,0,438,403,35,9,9,0,100
da03b2302af2f51253685da4030a59f5144a2ba4,68,208,269,61,0,0,0,2,25,65,3,29,4.616001518,8018,237,10,1500,1521,21,61076,61334,258,678,685,7,98.74027418
5df646ece7ffe0cdb922a04eb8485aa1d7340fa3,2,2,2,0,0,0,0,1,8,82,1,1,1,45,238,11,2,2,0,438,438,0,2,2,0,100
a4664320567a2627bd3c1f23faca84729a5962a5,12,70,84,14,0,0,0,1,21,42,1,4,3.235967929,2116,239,9,400,404,4,15453,15608,155,147,147,0,99.77884261
543213bfe62095487237be3bc07535fadabb971f,7,152,24,128,2,0,2,1,4,17,1,3,2.062414223,788,240,10,227,214,13,4932,4330,602,94,88,6,99.5951417
095f4356f145696ef9d887357dbee09aca28ce6b,0,0,0,0,0,0,0,0,0,0,0,0,0,0,230,1,0,0,0,0,0,0,0,0,0,100
90fe0a203290e1ceded177d7b354e68e9637fc2a,9,38,21,17,0,0,0,1,6,69,1,6,2.638905348,483,231,2,85,84,1,3624,3436,188,43,42,1,99.70749543
9416447d0aeb84b2c4c08833d2914c377fe26700,36,213,293,80,0,0,0,2,44,68,3,26,4.42745663,5471,241,11,825,842,17,43665,44590,925,313,316,3,97.81643227
e6f27f1171b408932a5915eaf2925ea57402c60d,2,15,34,19,0,0,0,2,4,32,1,2,0.997294382,84,232,3,14,14,0,495,540,45,7,7,0,99.92503748
5ca50f3b8975b84425a4b4fb90d5fe272dedfb93,1,1,1,0,0,0,0,2,4,57,1,1,0,190,233,4,22,22,0,2035,2034,1,3,3,0,100
217b964e9b54c0ed18c24d423ee4472e38ee034d,1,2,2,0,0,0,0,3,4,19,1,1,0,240,2,0,30,30,0,2381,2381,0,7,7,0,100
4b6a029226adaed6549439553f8983bd5bbd34b6,1,4,1,3,0,0,0,1,6,104,1,1,0,18,242,7,1,1,0,192,170,22,1,1,0,100
18d1a48178dee6d930c29e444c5352b6e9a548f2,1,90,25,65,0,0,0,3,10,209,1,1,0,50,3,1,6,6,0,1323,426,897,3,4,1,99.66216216
4020e68ad11893642913dcdf44cf824970d867bc,1,67,7,60,0,0,0,3,4,209,1,1,0,33,4,2,6,4,2,933,275,658,3,3,0,100
89607ffb61c19068b1f06ea4804ebfed835acc92,89,174,155,19,0,0,0,2,34,78,3,36,6.084268011,8490,243,8,1286,1053,233,75057,66455,8602,522,381,141,93.03370787
42f986b32a3b8b65e79bcbfe345903a5708f538b,1,69,9,60,0,0,0,3,6,209,1,1,0,127,5,3,13,11,2,1818,1120,698,7,7,0,100
b11989c85e8afe871e0c2b595968f2e319f44cde,1,1,1,0,0,0,0,3,7,0,1,1,0,176,6,4,13,13,0,1818,1818,0,7,7,0,98.46153846
0a26e036d0337a22bbc2eb6050dd54d3ab033ae0,8,36,41,5,0,0,0,3,12,124,1,8,2.494600002,819,244,9,165,166,1,6677,6687,10,69,69,0,100
b530d4dc9204d42beb2197055db461b22a48d80c,1,20,16,4,0,0,0,6,27,0,1,1,0,212,7,5,40,39,1,1393,1363,30,22,22,0,100
4dd7df6be7d1f459b58885f7041e4cc073b2d975,6,243,75,168,1,0,1,1,12,70,1,4,2.357844451,464,8,6,46,35,11,5954,4962,992,26,19,7,98.48484848
72929a6e3250829fc7e0d27798a057ed05a2ec40,1,2,3,1,0,0,0,2,8,9,1,1,0,133,245,8,27,27,0,862,875,13,20,20,0,100
286addc849ba11b5333d8a04d37e085f96734116,0,0,0,0,0,0,0,0,0,0,0,0,0,0,246,4,0,0,0,0,0,0,0,0,0,100
1ad8a29cabe4947cea06e4d96de5d7e3c145046e,0,0,0,0,0,0,0,0,0,0,0,0,0,0,247,5,0,0,0,0,0,0,0,0,0,100
d9d3e15732f2a6e2ad499e412ea3739e9cf31844,1,4,4,0,0,0,0,2,6,232,1,1,0,38,248,6,6,6,0,334,325,9,2,2,0,100
cc453b494aab9adad6c0039a9ddb432a23aba86a,7,13,16,3,0,0,0,2,12,584,1,2,2.319515777,534,249,7,63,66,3,4195,4197,2,28,28,0,100
7d4e73d039940b73571ec8d9cb347b169a0aee95,0,0,0,0,0,0,0,0,0,0,0,0,0,0,250,8,0,0,0,0,0,0,0,0,0,100
8c37a844c7dc2f67c7dc88ea42604efe324aa8be,44,5294,0,5294,44,0,44,1,1,0,2,13,5.100242017,0,0,0,522,0,522,21665,0,21665,222,0,222,96.3410172
a8f9f8875ecb1fc61738cbd35357b1daf6bfc15b,15,2438,0,2438,15,0,15,1,1,0,1,6,3.71962162,0,1,1,247,0,247,9665,0,9665,138,0,138,98.27586207
287b72b3d6358a24cb725627461aa06c1fa3f0ff,30,5494,0,5494,30,0,30,1,1,0,2,6,4.793520318,0,2,2,374,0,374,27054,0,27054,175,0,175,97.24409449
8547de7acdd06df851a3445f59279ad30543822c,83,656,595,61,1,0,1,2,2,0,1,24,5.967497481,6697,251,6,1158,1120,38,54084,53904,180,544,520,24,97.68578879
5820585d1fbef5cf715236ef62a988bdcf49dc39,12,204,109,95,2,0,2,4,15,84,2,4,3.329495513,698,9,0,55,60,5,7262,6587,675,24,31,7,99.73395411
e89736f921bd11ff0128f1d58c516b3ca312ab9e,1,1,1,0,0,0,0,1,2,2,1,1,0,43,10,1,3,3,0,422,420,2,1,1,0,100
c4072b06d611145eb6a60b674e9df0db59bc3c7f,1,3,2,1,0,0,0,2,13,77,1,1,0,113,252,7,10,10,0,904,901,3,2,2,0,100
acafdc0f0fe155b3063e65fca4f935304822b437,54,195,221,26,0,0,0,2,35,35,2,29,5.206731942,6404,253,8,1186,1188,2,49452,49467,15,522,520,2,100
abe21371c50c697196798d1b3cb0c2f71375aa9e,0,0,0,0,0,0,0,0,0,0,0,0,0,0,3,3,0,0,0,0,0,0,0,0,0,100
a2d1b8050942e0213828d2bc7f1e782cbe51128b,4,159,21,138,0,0,0,1,11,157,1,2,1.688327013,228,11,2,25,19,6,3315,2055,1260,16,16,0,98.73294347
8a86b759b428f0f111a589814812088f23409521,5,38,15,23,0,0,0,2,6,140,1,4,2.269253902,189,12,3,27,26,1,1839,1637,202,12,12,0,100
1970d8829a0290533db5d03c75c40e5c84c0d269,1,60,0,60,1,0,1,1,1,0,1,1,0,0,13,4,2,0,2,350,0,350,1,0,1,99.8729352
254af094d6a7dc7fcc63a0bf4a991bd8894aa60d,51,168,184,16,0,0,0,2,29,89,3,29,4.479238101,6061,254,6,945,946,1,52609,52776,167,418,416,2,99.71509972
efcd32d0cc235897f4cf180f7743c7064b443a5f,1,1,1,0,0,0,0,3,10,1,1,1,0,154,4,4,21,21,0,1515,1513,2,14,14,0,100
c7ed48699d97618399044cea050ecb4405469194,2,146,44,102,0,0,0,4,13,53,1,2,0.945273297,222,5,5,31,25,6,3166,2058,1108,11,11,0,99.65332493
e75b077728353cc75dfcea5d5105dae876f9b1c0,2,4,4,0,0,0,0,3,9,2,1,1,1,163,255,4,12,12,0,1681,1681,0,6,6,0,100
d50182061f416656b763abcda8fb0a2e01a22bda,36,736,1105,369,2,0,2,4,22,45,2,8,4.684254881,2462,256,5,298,297,1,20052,22128,2076,101,102,1,99.08488482
9a23b72c87ae9b41aa99f3a9e177026ed585d29b,1,95,48,47,0,0,0,4,13,68,1,1,0,139,6,6,32,27,5,1403,1236,167,7,7,0,100
c145861f0e9e7585366bf6ba062251b7cfd603bc,1,0,3,3,0,0,0,1,26,103,1,1,0,157,257,6,31,32,1,1323,1343,20,4,4,0,100
3af7201cb7478913993507db6cf85e41bc94f05c,4,62,69,7,0,0,0,2,3,60,1,2,1.373792394,180,234,0,34,29,5,1646,1605,41,16,15,1,100
0b8a660387cee5bb573892efeeec2c31ff3cbfbb,17,455,129,326,0,0,0,4,19,107,2,10,3.330612122,1247,14,5,113,103,10,15936,12320,3616,60,60,0,98.86471145
11e92a3c2fba0ba9fe1ac3a8b61020a4f04567e1,2,8,8,0,0,0,0,5,11,0,1,2,0.543564443,158,15,6,11,11,0,1739,1717,22,6,6,0,100
d6b8130f2ccdb7a656a03ac066b942cbe99d1fbe,0,0,0,0,0,0,0,0,0,0,0,0,0,0,258,7,0,0,0,0,0,0,0,0,0,100
4139a9a8358fbe9cba42362d2e1d0614339ea652,6,13,17,4,0,0,0,2,7,18,1,5,2.160964047,249,259,8,30,29,1,2143,2189,46,14,13,1,100
1dc91b27b74f6a625632a6da9fde57996a5bc9ac,2,26,13,13,0,0,0,3,45,142,1,2,0.89049164,340,260,9,75,74,1,2551,2481,70,29,29,0,99.90574929
e18ba10ebe5af534d8a65f3532faed958e3b3203,0,0,0,0,0,0,0,0,0,0,0,0,0,0,261,10,0,0,0,0,0,0,0,0,0,100
1429d48ecf37c5e8427cd8872a2ef20dd82a157f,0,0,0,0,0,0,0,0,0,0,0,0,0,0,262,11,0,0,0,0,0,0,0,0,0,100
de680d0396ec6900ed8bf9d9a6cb75007016dbaa,1,11,3,8,0,0,0,1,7,0,1,1,0,36,263,12,6,5,1,379,332,47,3,2,1,100
90ba2a1ce84581b03b04678bcc0019a87b6f4bf0,1,2,1,1,0,0,0,3,11,35,1,1,0,81,7,4,10,10,0,696,680,16,5,5,0,100
d0ef5126194fbe80054cfa3833730f13c206b1f1,40,165,182,17,0,0,0,4,46,41,1,25,3.274218251,4915,264,13,755,753,2,38742,38962,220,349,348,1,99.65689333
1c87313a36d374fb4bba754b7d9ba42dce25d6f4,3,0,7,7,0,0,0,2,5,0,1,3,1.556656707,488,8,5,75,75,0,4371,4396,25,28,28,0,100
0bff77cf53372dcdcf680881ec972cf8313a0704,0,0,0,0,0,0,0,0,0,0,0,0,0,0,265,13,0,0,0,0,0,0,0,0,0,100
288156fb37e851730047230ab8a040193981b17a,27,3563,0,3563,27,0,27,1,1,0,2,8,4.224814771,0,1,0,387,0,387,18362,0,18362,160,0,160,97.98903108
7cd7e7e53537de8947446722943101816f9c12fd,0,0,0,0,0,0,0,0,0,0,0,0,0,0,2,1,0,0,0,0,0,0,0,0,0,100
cad7b5ad6baf9fbbc51e7ee32cec3c4b87dfd269,3,54,43,11,0,0,0,1,3,84,1,2,1.537220503,216,3,2,35,33,2,1738,1667,71,13,14,1,99.88009592
5651a1c97fe9dbbbbffd00a0764182ddae56cd73,3,5,5,0,0,0,0,1,2,0,1,2,1.521928095,224,4,3,41,41,0,1680,1682,2,18,18,0,100
7f8418365775dbfac768e5cf2371b00bd9976581,0,0,0,0,0,0,0,0,0,0,0,0,0,0,16,5,0,0,0,0,0,0,0,0,0,100
f3a3d400fe8d049a4dced93bcfbb0598028c802e,8,230,138,92,0,0,0,4,23,12,2,5,1.792382368,956,5,4,142,132,10,8738,8249,489,52,52,0,98.77375843
914a86d5d5966bee469f9d7dfd70f86d8c8d6f34,0,0,0,0,0,0,0,0,0,0,0,0,0,0,17,6,0,0,0,0,0,0,0,0,0,100
fe5698ba95b792237353670155207db2434d5996,17,787,792,5,0,0,0,1,3,1,1,6,2.209884435,1733,6,5,315,314,1,13361,13352,9,120,119,1,100
937e64ecdc9255b52f8d177cd15f369c48c2fab2,1,69,15,54,0,0,0,3,13,14,1,1,0,101,266,12,6,6,0,1169,1128,41,3,3,0,100
d951f3ea72af3675c1c757ae15a7d6fef285aa53,1,5,5,0,0,0,0,1,3,0,1,1,0,448,7,6,82,82,0,3437,3437,0,12,12,0,100
b5bbe2ed4004d7145c5db2934137e080915a33be,80,343,369,26,0,0,0,2,24,81,3,39,5.319324889,7944,267,13,1271,1270,1,64227,64493,266,569,567,2,100
f483d0e0f5f3fd6f1de748dcf244c867b9f69291,0,0,0,0,0,0,0,0,0,0,0,0,0,0,268,14,0,0,0,0,0,0,0,0,0,100
1073c721d41fe36c355765753e8ab4280cc1ab41,0,0,0,0,0,0,0,0,0,0,0,0,0,0,269,15,0,0,0,0,0,0,0,0,0,100
f92849f8334724e0e619bbaeeec724c07c5f2973,3,6,7,1,0,0,0,1,16,167,1,1,1.314320487,187,270,16,35,35,0,1600,1613,13,7,7,0,100
c4d5b16c52110491e8e690cc963a8d6c186be301,0,0,0,0,0,0,0,0,0,0,0,0,0,0,271,17,0,0,0,0,0,0,0,0,0,100
7bacea948155a19cdcf1eed989cacc4a97e30c6f,0,0,0,0,0,0,0,0,0,0,0,0,0,0,272,18,0,0,0,0,0,0,0,0,0,100
48eb62267e5952ced1d2c54602eb683f529cedca,0,0,0,0,0,0,0,0,0,0,0,0,0,0,273,19,0,0,0,0,0,0,0,0,0,100
4c4d94e8c43b68981b5434d011309d5c2c7a7393,0,0,0,0,0,0,0,0,0,0,0,0,0,0,274,20,0,0,0,0,0,0,0,0,0,100
5ed200f6e138050f04943c400f512694064f6ea5,0,0,0,0,0,0,0,0,0,0,0,0,0,0,275,21,0,0,0,0,0,0,0,0,0,100
d82296bf4c7085761652105ee4b42a333cf561d1,0,0,0,0,0,0,0,0,0,0,0,0,0,0,276,22,0,0,0,0,0,0,0,0,0,100
40b1c16e26349e722c818ba6151823e6e1eaafdb,1,4,2,2,0,0,0,2,5,7,1,1,0,437,8,7,81,81,0,3342,3337,5,12,12,0,100
d8e70442b4e3d9d1de331ee309a156be561a419a,0,0,0,0,0,0,0,0,0,0,0,0,0,0,235,1,0,0,0,0,0,0,0,0,0,100
a03bb1167293d98a0a0048d5e9c1545b3b82d48d,0,0,0,0,0,0,0,0,0,0,0,0,0,0,236,2,0,0,0,0,0,0,0,0,0,100
ef9062cff748a220351fb9ea7f49853d136382ba,0,0,0,0,0,0,0,0,0,0,0,0,0,0,237,3,0,0,0,0,0,0,0,0,0,100
3d8f73e6af09d93a5430494263783f6ade06a1cc,0,0,0,0,0,0,0,0,0,0,0,0,0,0,238,4,0,0,0,0,0,0,0,0,0,100
a829d8ca3acc0f96b7dc61bbbe67371b098e6117,0,0,0,0,0,0,0,0,0,0,0,0,0,0,239,5,0,0,0,0,0,0,0,0,0,100
8c3742cbd84d7cc8a78ac039c32eb87cfa2c3b6e,0,0,0,0,0,0,0,0,0,0,0,0,0,0,240,6,0,0,0,0,0,0,0,0,0,100
37cb1bea8aca0dc09dadc1a3ccb680c44fa6a872,0,0,0,0,0,0,0,0,0,0,0,0,0,0,277,20,0,0,0,0,0,0,0,0,0,100
93d60a05297c364410307d0c5b934e77140d49c0,0,0,0,0,0,0,0,0,0,0,0,0,0,0,278,21,0,0,0,0,0,0,0,0,0,100
ea615061e8605aacc2cb787d4f7c8ff272a255a8,0,0,0,0,0,0,0,0,0,0,0,0,0,0,279,22,0,0,0,0,0,0,0,0,0,100
0d511716a299e8cbd21429616f01d5a4f2c88ca4,0,0,0,0,0,0,0,0,0,0,0,0,0,0,280,23,0,0,0,0,0,0,0,0,0,100
64c19ef74360a4ebb91a58811dfd1fdcaf1a0fb3,1,6,0,6,0,0,0,2,5,323,1,1,0,35,281,24,10,9,1,203,192,11,6,5,1,100
70bfd52f198895485b9910d6123d64eb52dd1aa0,5,130,66,64,3,0,3,1,7,6,1,1,2.007078059,193,282,25,46,45,1,1290,1295,5,27,26,1,99.81214778
f1bb02fc00fa605c0c4a119536a72c70fe6df79d,0,0,0,0,0,0,0,0,0,0,0,0,0,0,283,26,0,0,0,0,0,0,0,0,0,100
b6f37a5cf89037a4aa6c0fa9f635aeb75f2e2340,0,0,0,0,0,0,0,0,0,0,0,0,0,0,241,7,0,0,0,0,0,0,0,0,0,100
79694a950f85f2f3b169e1c039a52b12fab3abc6,0,0,0,0,0,0,0,0,0,0,0,0,0,0,242,8,0,0,0,0,0,0,0,0,0,100
8d369480bad4813d97932484b6c63d61bee4519c,0,0,0,0,0,0,0,0,0,0,0,0,0,0,243,9,0,0,0,0,0,0,0,0,0,100
98946e8022476c8e83e4f4aa474fefc80e0b551a,0,0,0,0,0,0,0,0,0,0,0,0,0,0,244,10,0,0,0,0,0,0,0,0,0,100
6d5ffcd250d6ff7f552aaf999f435dff07227d46,0,0,0,0,0,0,0,0,0,0,0,0,0,0,245,11,0,0,0,0,0,0,0,0,0,100
e01672cacfa361300316a3b8bd7ef497f33a958f,0,0,0,0,0,0,0,0,0,0,0,0,0,0,246,12,0,0,0,0,0,0,0,0,0,100
bef33c44c6165c5c96c6cbae7e8d6f14bc088609,0,0,0,0,0,0,0,0,0,0,0,0,0,0,247,13,0,0,0,0,0,0,0,0,0,100
ffee40634d9e2b2fa04e3d797cfceeb2985640a9,0,0,0,0,0,0,0,0,0,0,0,0,0,0,248,14,0,0,0,0,0,0,0,0,0,100
e5202fa398606c92c3b05dc540ed2ebc4dec6f88,0,0,0,0,0,0,0,0,0,0,0,0,0,0,249,15,0,0,0,0,0,0,0,0,0,100
37e61f4344b03aab294bc7e5dfb4bbe4de8b9ba0,0,0,0,0,0,0,0,0,0,0,0,0,0,0,250,16,0,0,0,0,0,0,0,0,0,100
0336ea5f348d5f0d76223962d4f85f19dd61e594,0,0,0,0,0,0,0,0,0,0,0,0,0,0,251,17,0,0,0,0,0,0,0,0,0,100
ac9d92936130f8162cf224e21b3e4a8748be6fe2,0,0,0,0,0,0,0,0,0,0,0,0,0,0,252,18,0,0,0,0,0,0,0,0,0,100
8763f92b9fc0ed1cba20b94a194b21d3bf5d27d2,0,0,0,0,0,0,0,0,0,0,0,0,0,0,253,19,0,0,0,0,0,0,0,0,0,100
f9f7a6c62c4fc0e2439a930a2f77b3453852cbc9,0,0,0,0,0,0,0,0,0,0,0,0,0,0,254,20,0,0,0,0,0,0,0,0,0,100
94ef0871ae6f70d8304f82f1fd17d00a818363f4,0,0,0,0,0,0,0,0,0,0,0,0,0,0,255,21,0,0,0,0,0,0,0,0,0,100
7bcfb13f086d6764f980e95c4cdb7a60de607c10,1,3,0,3,0,0,0,1,10,24,1,1,0,43,284,26,8,7,1,404,369,35,2,2,0,100
0c785b2787ef089f88ffdea1823a78924df23b38,1,1,1,0,0,0,0,1,4,225,1,1,0,196,285,19,40,40,0,1388,1388,0,17,17,0,100
7f0d7748f209281a6446b85e90b55e3f2345bed6,28,147,51,96,0,0,0,2,32,90,2,15,4.609364934,2715,286,20,605,558,47,21708,21311,397,257,257,0,100
21388ac0b782811a4dcfcafaf3b1aaf470b6ad66,0,0,0,0,0,0,0,0,0,0,0,0,0,0,256,21,0,0,0,0,0,0,0,0,0,100
a9d47369e106eed077f342f638fdb5e50a2a57ab,0,0,0,0,0,0,0,0,0,0,0,0,0,0,257,22,0,0,0,0,0,0,0,0,0,100
09ddad525bfa22ab2dfe6800a56867042ad46832,0,0,0,0,0,0,0,0,0,0,0,0,0,0,258,23,0,0,0,0,0,0,0,0,0,100
a20fc52a0062d4f8cbb8760f494f26b3296ea5cf,0,0,0,0,0,0,0,0,0,0,0,0,0,0,259,24,0,0,0,0,0,0,0,0,0,100
def063ca691d74a599e7e790662a8097ab8613e0,0,0,0,0,0,0,0,0,0,0,0,0,0,0,260,25,0,0,0,0,0,0,0,0,0,100
6ebe4f4b82e23a8544e348ba1fe75255a3f011f3,37,310,139,171,0,0,0,4,13,121,2,12,4.587111697,3195,287,17,430,396,34,28764,28160,604,241,207,34,98.58091787
b19c3b95d36279476da846a738f592c027705413,8,227,60,167,0,0,0,1,19,244,1,4,2.706030841,1307,288,18,332,315,17,7552,7318,234,210,196,14,99.70777323
220c529f8db7552b2d1ee16163d686dd9fe8883d,1,22,4,18,0,0,0,1,11,231,1,1,0,76,289,19,20,17,3,632,560,72,4,4,0,100
91ca078c6e1f0f2aaea449db505c8cbc87ab8541,1,5,2,3,0,0,0,1,27,69,1,1,0,154,290,20,32,31,1,1342,1323,19,4,4,0,100
8be8b5e820eedc76b6a3bfc0ab218f429a1c5489,1,1,1,0,0,0,0,1,6,4,1,1,0,130,291,14,33,33,0,841,833,8,14,14,0,100
ae78fc3ded0f6bea3e98218fdf94b6435f81ce1d,2,10,9,1,0,0,0,1,22,246,1,2,0.485460761,274,292,15,50,51,1,2052,2065,13,13,13,0,100
d28be5211dad13db16dbdc5654f3b14b7d5f91bc,0,0,0,0,0,0,0,0,0,0,0,0,0,0,293,16,0,0,0,0,0,0,0,0,0,100
b646b177737ffb8a2cd05ff67b4d49affa14f9f9,0,0,0,0,0,0,0,0,0,0,0,0,0,0,18,0,0,0,0,0,0,0,0,0,0,100
24d6e96f23b29894d4e3441049a2f2f8a307d499,4,68,6,62,0,0,0,1,17,96,1,2,1.144305676,199,294,17,43,36,7,1852,1704,148,12,7,5,100
db58aa5f495596e9ecf9459d163e39e39b803806,1,1,0,1,0,0,0,3,47,63,1,1,0,316,295,14,70,70,0,2223,2219,4,27,27,0,100
7d214cd60fd56476b4c52192673ad926c54e1ae0,8,128,79,49,0,0,0,1,18,225,1,2,2.279219417,460,296,15,101,96,5,3330,3120,210,59,51,8,100
faccaf27eee8c9f393cdcbc1d9bc6ca8cbb22e64,1,33,10,23,0,0,0,1,8,68,1,1,0,42,297,16,6,6,0,500,379,121,5,3,2,100
df73dbca9bea7c5be04e1d6f1ba5a6cb02dbff37,23,112,0,112,0,0,0,4,11,70,1,8,4.343519262,1767,9,0,252,235,17,16006,15557,449,122,105,17,99.97076023
2e2c4aa8aa1f542d50e440f5518dc733808aa95c,3,6,4,2,0,0,0,1,23,127,1,2,1.521928095,462,298,14,86,86,0,3575,3557,18,33,33,0,100
12abbc0fee5ba28c6c622b7f618dba9ff75b2fa7,3,5,9,4,0,0,0,1,24,90,1,3,1.431560284,503,299,15,83,84,1,4092,4096,4,32,33,1,100
fc74924ecccd7cccb19f4f68961e1be55f22c41e,70,424,295,129,0,0,0,2,33,83,2,31,5.159870667,8055,300,16,1562,1530,32,59466,58716,750,810,778,32,100
db394ce9527db1a043c998e67eeb53ac35687cb8,0,0,0,0,0,0,0,0,0,0,0,0,0,0,261,18,0,0,0,0,0,0,0,0,0,100
90e6dcf339b8bf27903c79fa41b4abcdef9df6af,0,0,0,0,0,0,0,0,0,0,0,0,0,0,262,18,0,0,0,0,0,0,0,0,0,100
5f157b2e398c94d1b89f520e5d1e16a8a728e1fb,0,0,0,0,0,0,0,0,0,0,0,0,0,0,263,19,0,0,0,0,0,0,0,0,0,100
8678ef0fae80b6ed9d75488653057c63199e9c18,1,1,1,0,0,0,0,2,7,0,1,1,0,79,301,17,20,20,0,499,499,0,14,14,0,100
95503705da3ea00c99cb71088687599d0d4189d3,0,0,0,0,0,0,0,0,0,0,0,0,0,0,264,13,0,0,0,0,0,0,0,0,0,100
bb48e9d64982993e4b85d96a16b67f6631367969,0,0,0,0,0,0,0,0,0,0,0,0,0,0,265,14,0,0,0,0,0,0,0,0,0,100
0d662e03f16bc5fcd1955c4d76f538c00456240d,0,0,0,0,0,0,0,0,0,0,0,0,0,0,266,10,0,0,0,0,0,0,0,0,0,100
00ee52c04c833f2893aefc63bd734d9489454915,0,0,0,0,0,0,0,0,0,0,0,0,0,0,267,11,0,0,0,0,0,0,0,0,0,100
f6f2db83fea8cbb39a52c1cca782ed5842981eef,0,0,0,0,0,0,0,0,0,0,0,0,0,0,268,12,0,0,0,0,0,0,0,0,0,100
e1e410a02de825a00ce2d174133988106cae1cc2,0,0,0,0,0,0,0,0,0,0,0,0,0,0,269,13,0,0,0,0,0,0,0,0,0,100
37aff7c88b0647c5b51bc52f5deea7f63c812202,0,0,0,0,0,0,0,0,0,0,0,0,0,0,270,14,0,0,0,0,0,0,0,0,0,100
2d5a87a73a0b1b57b73c18aea76f082265c000e4,0,0,0,0,0,0,0,0,0,0,0,0,0,0,271,15,0,0,0,0,0,0,0,0,0,100
13aaad6b0671a5599aba98eace7f3ebe81c7a695,0,0,0,0,0,0,0,0,0,0,0,0,0,0,272,16,0,0,0,0,0,0,0,0,0,100
a5d11b9b60499ab6229ba3ae68dedab6f527fb18,0,0,0,0,0,0,0,0,0,0,0,0,0,0,273,17,0,0,0,0,0,0,0,0,0,100
252a83d0991a8dbcb7490658ba450ed230077ba2,0,0,0,0,0,0,0,0,0,0,0,0,0,0,274,18,0,0,0,0,0,0,0,0,0,100
7a44135725ad69ead8896c0d7bd7f2f1f059c112,0,0,0,0,0,0,0,0,0,0,0,0,0,0,275,19,0,0,0,0,0,0,0,0,0,100
4eb4e7593c1eb6deaa23cb5e8d762efbc98ad4a0,0,0,0,0,0,0,0,0,0,0,0,0,0,0,276,20,0,0,0,0,0,0,0,0,0,100
32d1134d09b73a573518d00af1a55a18db864722,0,0,0,0,0,0,0,0,0,0,0,0,0,0,277,21,0,0,0,0,0,0,0,0,0,100
9d2b6511351e6e7c2b94703269a0638d03905ab6,0,0,0,0,0,0,0,0,0,0,0,0,0,0,278,22,0,0,0,0,0,0,0,0,0,100
76eac2cddcfbdea532f63abd4898156e0246a164,0,0,0,0,0,0,0,0,0,0,0,0,0,0,279,23,0,0,0,0,0,0,0,0,0,100
01ee1f8bb59e9e2e910b3eea3107814f7f07384d,0,0,0,0,0,0,0,0,0,0,0,0,0,0,280,24,0,0,0,0,0,0,0,0,0,100
4928fe3b0c94e331712ab9a19ccb0d9389481820,0,0,0,0,0,0,0,0,0,0,0,0,0,0,281,25,0,0,0,0,0,0,0,0,0,100
1b8aaccf3338124f07b8644dc8e4fbdf261e8da2,0,0,0,0,0,0,0,0,0,0,0,0,0,0,282,26,0,0,0,0,0,0,0,0,0,100
9e9bcdc13fbff9b821f199f24d4f8050e0e2bde8,0,0,0,0,0,0,0,0,0,0,0,0,0,0,283,27,0,0,0,0,0,0,0,0,0,100
29830dea0f477f50390563d4480dac517323c2ba,0,0,0,0,0,0,0,0,0,0,0,0,0,0,284,28,0,0,0,0,0,0,0,0,0,100
7e632b7aad89e40ea1c007e40baac094560d7d04,0,0,0,0,0,0,0,0,0,0,0,0,0,0,285,29,0,0,0,0,0,0,0,0,0,100
3db0fde074e290415873abeed4445c60b24a6acd,0,0,0,0,0,0,0,0,0,0,0,0,0,0,286,30,0,0,0,0,0,0,0,0,0,100
b68ed1a23061177dd3bcbcf871ec71aef0829616,0,0,0,0,0,0,0,0,0,0,0,0,0,0,287,31,0,0,0,0,0,0,0,0,0,100
f5dbb8525d5d7e6012b6dea9662c5bfe649f539d,0,0,0,0,0,0,0,0,0,0,0,0,0,0,288,32,0,0,0,0,0,0,0,0,0,100
07f6b703fe11088e57de3f43a0203dd3327097ca,0,0,0,0,0,0,0,0,0,0,0,0,0,0,289,33,0,0,0,0,0,0,0,0,0,100
5934fc00ebef4f475d7b58d6153703cff7d4cbe7,0,0,0,0,0,0,0,0,0,0,0,0,0,0,290,34,0,0,0,0,0,0,0,0,0,100
9b4c1693d9ecfd00a59d83a8952dd5ce04959396,0,0,0,0,0,0,0,0,0,0,0,0,0,0,291,35,0,0,0,0,0,0,0,0,0,100
1a7841f59ba0a37212a134c6b2f3274dcbc6c454,0,0,0,0,0,0,0,0,0,0,0,0,0,0,292,36,0,0,0,0,0,0,0,0,0,100
fccd9b79234d1042eab21dca76c90ef731c46a86,0,0,0,0,0,0,0,0,0,0,0,0,0,0,293,37,0,0,0,0,0,0,0,0,0,100
dafcde0f4ff3b5feffc9ed41019b3a34895af6ee,0,0,0,0,0,0,0,0,0,0,0,0,0,0,294,38,0,0,0,0,0,0,0,0,0,100
10535a2cffa99d956cca1a9be5d29b5ddd96fefd,0,0,0,0,0,0,0,0,0,0,0,0,0,0,295,39,0,0,0,0,0,0,0,0,0,100
4cbe27e143b15104261d7f98c8380ca5a0b695e8,0,0,0,0,0,0,0,0,0,0,0,0,0,0,296,40,0,0,0,0,0,0,0,0,0,100
1a676633f7331818cbc748ac16a4415a1a815ee4,0,0,0,0,0,0,0,0,0,0,0,0,0,0,297,41,0,0,0,0,0,0,0,0,0,100
645ebf318a461256183ed68daea0a0745f8fd1c3,0,0,0,0,0,0,0,0,0,0,0,0,0,0,298,42,0,0,0,0,0,0,0,0,0,100
acb473baaacf11fd22d0b4ca346d3cc138ab0269,0,0,0,0,0,0,0,0,0,0,0,0,0,0,299,43,0,0,0,0,0,0,0,0,0,100
8f6fa7291a1ea74926c36b199e051da176c9b180,0,0,0,0,0,0,0,0,0,0,0,0,0,0,300,44,0,0,0,0,0,0,0,0,0,100
160068d2f6e7308c956c02f804ca52a0a1af7575,0,0,0,0,0,0,0,0,0,0,0,0,0,0,301,45,0,0,0,0,0,0,0,0,0,100
6faea8b79042ef00327445a62327af1a367fb356,0,0,0,0,0,0,0,0,0,0,0,0,0,0,302,46,0,0,0,0,0,0,0,0,0,100
a5f9b42aeaaa022a59a3405e7362f21101deb74b,0,0,0,0,0,0,0,0,0,0,0,0,0,0,303,47,0,0,0,0,0,0,0,0,0,100
df651b191283d1e171b3359a0ae86078e1eec23f,0,0,0,0,0,0,0,0,0,0,0,0,0,0,304,48,0,0,0,0,0,0,0,0,0,100
ff7ab7ce3d274f200e8cc664ebf9b0b2e8c59b77,0,0,0,0,0,0,0,0,0,0,0,0,0,0,305,49,0,0,0,0,0,0,0,0,0,100
edf852edb6e025c98268a147f324cd7c06ec5f94,0,0,0,0,0,0,0,0,0,0,0,0,0,0,306,50,0,0,0,0,0,0,0,0,0,100
6be329fae9a57d23f64a74dde6e9f4ff99be8c9a,0,0,0,0,0,0,0,0,0,0,0,0,0,0,307,51,0,0,0,0,0,0,0,0,0,100
a1ef3043709a8ab2d919de7656465fdcec1c84b3,0,0,0,0,0,0,0,0,0,0,0,0,0,0,308,52,0,0,0,0,0,0,0,0,0,100
11082155ed7f2967e11c43b38369fdf698eeb9a8,0,0,0,0,0,0,0,0,0,0,0,0,0,0,309,53,0,0,0,0,0,0,0,0,0,100
561d4e9470dab6b732f35c8063c7514328a7d490,0,0,0,0,0,0,0,0,0,0,0,0,0,0,310,54,0,0,0,0,0,0,0,0,0,100
244a2cf65e54dcf7da4b640e05ac9b06feeedeac,0,0,0,0,0,0,0,0,0,0,0,0,0,0,311,55,0,0,0,0,0,0,0,0,0,100
0f8c789d7ba8340101eb874c60e45234565b66a7,1,1,1,0,0,0,0,2,5,10,1,1,0,29,302,17,3,3,0,245,241,4,2,2,0,100
6df2469ecf22eba781b1deb7951b6df80962a61d,4,66,1,65,0,0,0,2,6,65,2,4,1.999512998,258,303,16,37,37,0,2171,2171,0,16,16,0,100
10c5652a498ed5f98b8e01036159cbc57373c95b,2,66,38,28,0,0,0,1,19,26,1,1,0.89049164,249,304,17,50,46,4,2108,1948,160,19,17,2,99.41037736
e24c20fca7a7e1683c384c52d6d1e4bae21e0266,0,0,0,0,0,0,0,0,0,0,0,0,0,0,305,14,0,0,0,0,0,0,0,0,0,100
7d5c17f7e91b2df7112369d69827ae1327ea7278,28,132,63,69,1,0,1,1,28,229,2,12,4.266557893,2824,306,10,524,521,3,21340,21264,76,239,235,4,97.39910314
b119249f379db1045cfaf738ac920d319851e4bc,5,150,9,141,1,0,1,4,19,209,1,2,2.199228309,1165,312,51,296,281,15,10002,9315,687,113,105,8,99.87980769
e4cbc9ad12450f293d9fc48d587b5f90baff49a3,1,117,0,117,1,0,1,1,1,0,1,1,0,0,307,9,10,0,10,515,0,515,9,0,9,99.25037481
5a2b3aef94fac986134da5bb01fa7a30e8ec2341,26,51,76,25,0,0,0,2,25,78,2,17,3.787866479,3724,308,10,656,656,0,29048,29128,80,332,332,0,97.36842105
4ce88a0181451d3c6ed5558032edf124e66f38e7,1,16,1,15,0,0,0,1,2,2,1,1,0,74,309,9,11,10,1,537,515,22,9,9,0,100
7550a10b3725cf97dcfb9206499e854473520510,266,78807,0,78807,266,0,266,1,1,0,1,19,7.357542888,0,313,49,8871,0,8871,288059,0,288059,3200,0,3200,85.46830159
bd5593f8d027fff0c8d0e4d879d35c9876dd649f,37,0,0,0,0,0,0,1,1,0,1,2,0,5390,314,50,1235,962,273,41099,111296,70197,576,629,53,96.18111137
f49424ede69e469aed8f9822e76c22142ef73852,225,1360,1292,68,0,0,0,1,2,0,1,20,6.909960084,33415,315,50,8196,8189,7,257773,257499,274,3072,3064,8,98.64068872
a857ed5cba52fc4430271297de41cf321966e2ea,11,33,22,11,0,0,0,4,21,76,2,6,3.459431619,946,310,8,69,69,0,10369,10314,55,35,35,0,100
05078f9c7ccb401c7c265bce51c881584d95f379,1,10,2,8,0,0,0,1,3,4,1,1,0,78,311,9,12,11,1,613,537,76,9,9,0,100
7a9ecf45a7ea742cab56c2bd87f29e096fb8bb9f,63,8303,8391,88,0,0,0,2,3,0,1,6,5.230212434,9299,312,10,1901,1901,0,68533,68533,0,711,711,0,100
fcbc54a719bdc7446d0150bbc69383e7aca25d52,77,10515,10581,66,0,0,0,2,3,0,1,7,5.303141667,12038,313,11,3344,3344,0,92029,92029,0,1208,1208,0,100
eb2e0a8d196e9cb40719b32d8c0cfb1fa607c935,83,14500,14526,26,0,0,0,2,3,0,1,6,5.672254153,15586,314,12,3619,3619,0,126159,126159,0,1274,1274,0,100
a597bcae1aeee70090f7b163e4f926f19342e17b,0,0,0,0,0,0,0,0,0,0,0,0,0,0,315,13,0,0,0,0,0,0,0,0,0,100
7926fcb8893243e21c4e5add781d953a18454e23,280,72711,67569,5142,0,0,0,2,4,0,1,20,7.248055504,40970,316,14,9640,9647,7,318036,314032,4004,3565,3564,1,99.23475129
e50fbd587f11650518aa304f595b20e410e8cb5a,47,129,1894,1765,0,0,0,2,5,0,1,6,3.682816246,8622,317,14,1502,1623,121,49951,56067,6116,554,617,63,99.08563782
a90e57e6faa40a74edacf8ab078174e8641c06b9,28,133,476,343,0,0,0,2,5,0,1,5,3.4813983,7218,318,15,1725,1754,29,47730,49601,1871,541,549,8,99.82448442
eba097da79dfc33502becdbd84a8070666ae0bd4,52,148,4046,3898,0,0,0,2,5,0,1,5,2.839223981,11372,319,16,1834,2057,223,59318,78027,18709,757,845,88,98.18737716
496ccd066f5e8fe5e41acc0a658ece18d0089bd9,1,1,1,0,0,0,0,2,5,3,1,1,0,910,320,17,105,105,0,6577,6577,0,34,34,0,100
2f0cdab7cedc393342998f67d02ba20be33e43a4,19,65,67,2,0,0,0,2,20,120,1,14,3.806738693,1531,321,18,329,327,2,10378,10385,7,158,156,2,100
7627de6a15c3e7bd9b674dca521e6d99ac6392ed,172,1364,3610,2246,0,0,0,2,6,0,1,18,5.81581859,35513,322,19,7592,7789,197,230493,240044,9551,2856,2936,80,99.71696059
86b25164d41a708e6bd852172e19f46ef762861b,2,1,13,12,0,0,0,2,7,2,1,2,0.591672779,452,323,19,82,83,1,3300,3390,90,18,19,1,100
a28cf138b3c6ff0f4ad5bd4d2f363f3b67241d8b,8,149,105,44,0,0,0,1,15,193,1,1,2.904161491,426,324,19,36,36,0,4570,4183,387,15,15,0,100
638c387fad9091c5f754a207eeda937326a3586c,7,49,70,21,0,0,0,3,16,57,1,1,2.395489255,509,325,19,60,59,1,4580,4600,20,30,30,0,99.95636998
0b59227b2034892e65e208ae223feef365cf27d3,5,345,16,329,1,0,1,1,48,29,1,4,0.738754545,629,326,20,182,134,48,6172,4370,1802,65,54,11,98.53679843
bccccbcbee9a924187b8305270257bac4a1e04e9,17,487,308,179,5,0,5,2,15,0,2,6,3.164458913,1017,327,21,170,159,11,8998,7937,1061,73,66,7,97.74863388
db6d401455f769fccc6d83b188206151ffa0f465,5,218,249,31,1,0,1,2,6,29,1,5,1.820609605,305,328,22,21,23,2,2297,3011,714,16,16,0,99.84719494
c9fe2f958a8d905fc39931944d80b3b48bcff6b7,3,63,5,58,0,0,0,1,3,0,1,3,0.370479202,360,329,23,58,58,0,3182,2833,349,16,16,0,99.84736154
56c4f4cde61be04df5e4b978e3b4ff3d2391fed1,1,58,0,58,1,0,1,1,1,0,1,1,0,0,330,24,7,0,7,297,0,297,3,0,3,97.65574126
f80b6ccfe48b6b25122cb42637adf48e987acbd0,1,10,0,10,0,0,0,1,21,37,1,1,0,496,331,25,129,126,3,2780,2696,84,70,70,0,100
c076e7bf93da590a04be560f4af4293cb4522a21,5,22,16,6,0,0,0,1,4,0,1,3,1.929092965,319,332,26,24,24,0,2629,2576,53,10,10,0,99.84884474
757f2a75886aadfa351fb5b0981752c0c40f9ebd,10,211,39,172,2,0,2,1,5,0,1,4,3.052581719,429,333,26,43,31,12,4561,3613,948,20,14,6,99.870606
0302c0602914b4c10232d7d9c4b0e782b0a0f330,19,80,90,10,0,0,0,4,26,70,2,14,3.715461756,2038,334,25,171,171,0,20246,20424,178,73,73,0,100
29d428a442ed968320f6fb4bac85e7ec7eb85778,8,40,44,4,0,0,0,1,6,0,1,4,2.479685872,496,335,26,36,37,1,4104,4103,1,17,17,0,99.9138488
b80c48bf44f08e3cb2b841c930a29cd9fa46e4e2,3,44,34,10,0,0,0,1,7,0,1,2,1.543022494,236,336,27,17,15,2,1983,1917,66,7,7,0,100
4a888f0ffca6e97571f36ab423099f074a3bd86f,1,3,3,0,0,0,0,4,7,106,1,1,0,248,0,0,34,34,0,2426,2417,9,7,7,0,100
cb030aa49c7bd866727ff471615f7a697fa1065f,3,17,4,13,0,0,0,2,6,193,1,2,1.409975019,162,337,28,32,29,3,1066,1027,39,19,18,1,100
0f07461185a608a9121a385346c46f0133d1f96a,8,139,49,90,1,0,1,1,8,3,1,3,2.494429521,462,338,28,63,53,10,4316,3825,491,23,20,3,99.87085665
c054f041527a82d35958c118fc8487fc40a78032,3,9,0,9,0,0,0,1,8,2,1,3,1.584962501,192,339,29,6,6,0,1600,1477,123,6,6,0,100
a240c224a1f54f8319bd1449d2b257929930fed4,4,34,8,26,0,0,0,1,4,318,1,2,1.941835529,131,340,30,16,16,0,855,864,9,10,10,0,100
26bca69231fa8be2b3e4dc4d1bd1e085196ad7a3,2,1,7,6,0,0,0,2,6,163,1,2,0.543564443,101,341,24,11,12,1,787,806,19,8,9,1,100
a73bdd42ab31a989e041f0ffe057b8bd3cfacacf,34,550,903,353,0,0,0,4,36,184,2,10,4.096351243,4333,19,0,628,676,48,36198,37223,1025,238,263,25,99.22413793
d1801d2a4585ed7e8c4a41d172b3543d5bf081a8,9,762,0,762,9,0,9,1,1,0,1,5,2.596209161,0,20,1,89,0,89,3541,0,3541,37,0,37,98.55349926
5a58194a49120e6c39bd7a8a762102eeeda68a86,20,463,72,391,5,0,5,1,14,8,1,3,3.253734101,767,342,22,207,131,76,6641,5672,969,120,90,30,98.78863826
3db2d4cda8c6047539fa1aceea145b15d69d6446,2,6,0,6,0,0,0,2,7,33,1,1,1,524,343,22,131,131,0,3017,2975,42,78,78,0,100
c1887540c284479da56777c5e5449f533306aa71,9,215,115,100,1,0,1,1,9,48,1,2,2.348474008,456,344,23,62,56,6,3840,3482,358,30,27,3,99.85440932
d224470bba06177cc4839cab1fc7a7ccabdea7f2,0,0,0,0,0,0,0,0,0,0,0,0,0,0,345,24,0,0,0,0,0,0,0,0,0,100
9167d2dd14f694e8bec6c2a11f774a4d74517d4c,1,2,12,10,0,0,0,2,2,161,1,1,0,62,346,25,2,3,1,552,604,52,2,3,1,100
5ce2e7d052931ef99affd50af7bd2bd6108f92e7,1,97,0,97,1,0,1,1,1,0,1,1,0,0,347,26,13,0,13,460,0,460,8,0,8,99.91689175
2ea6173a34ed75afddb655cfc04fa97ec4a52cdb,1,1,1,0,0,0,0,1,2,0,1,1,0,66,348,27,13,13,0,475,460,15,8,8,0,100
9a7e7927fda2bcf0a9176a2a9333e5baa4c93d40,1,1,1,0,0,0,0,1,3,0,1,1,0,66,349,28,13,13,0,495,475,20,8,8,0,100
baa0d69142727c3d778f4f800901b17095ab9b5d,1,2,2,0,0,0,0,2,2,56,1,1,0,160,350,28,44,44,0,1189,1189,0,18,18,0,100
a502b40a1d1fcdf0a702439bc16079891fa73568,1,5,2,3,0,0,0,2,8,4,1,1,0,283,351,29,67,66,1,1662,1649,13,40,40,0,100
b349fe9539e99038fad395c282b60b9d6af86e35,3,60,10,50,0,0,0,1,8,8,1,1,0.694805364,173,352,30,30,21,9,1867,1541,326,8,6,2,99.64883289
885812f604ea95399efe5f595b6958c116f2455f,1,1,5,4,0,0,0,2,4,53,1,1,0,398,353,30,111,113,2,3450,3486,36,47,47,0,100
7b04b10076761beceb95dd7e51e2a73079fe5aa0,5,82,33,49,0,0,0,1,10,9,1,4,2.060773259,444,354,31,39,30,9,4025,3777,248,19,16,3,99.64883289
c40fd0785ee56f231436610eed56c9913738b4e5,43,151,108,43,0,0,0,2,37,60,1,28,4.50193945,5092,355,32,910,914,4,37439,37801,362,383,383,0,98.94115251
5a0ee2da1b697bcdf69d8df7782b846cceba947a,3,29,3,26,0,0,0,1,11,0,1,2,1.321884787,236,356,33,19,15,4,2050,1864,186,6,6,0,97.77822662
13f56eacac037a5ec679211d9715ad4d51532b0a,2,7,3,4,0,0,0,1,12,8,1,1,1,77,357,34,5,3,2,693,665,28,3,3,0,100
fad1e48c8bffa45f2877aa4727b461c546c95991,1,1,1,0,0,0,0,1,4,15,1,1,0,39,358,35,7,7,0,261,263,2,4,4,0,100
2563b6ee1742674a54344f6a9610e88be15121c9,6,648,7,641,3,0,3,1,5,72,1,3,1.761965689,367,10,0,142,83,59,6297,2725,3572,61,33,28,99.85720114
7404f7085219149fa84ece099764b73680a8d97d,1,5,0,5,0,0,0,2,5,0,1,1,0,49,11,1,10,9,1,410,396,14,2,2,0,100
7369cd51b31a9601c434af773ebab458e0b3463d,5,51,27,24,1,0,1,1,7,38,1,4,1.744615683,186,359,35,28,30,2,1438,1458,20,17,19,2,99.9592668
aecf48587ee77971a9651220a665f9e8a81f8eb0,1,1,1,0,0,0,0,1,13,6,1,1,0,58,360,36,3,3,0,486,484,2,2,2,0,100
2bc819ef3974ed538774b506ad974ab869a36d22,44,349,277,72,0,0,0,2,33,76,1,20,3.53221716,4483,361,36,704,702,2,35963,35688,275,348,342,6,100
97033e3b1964ad1da319f72fe8874333dc487245,0,0,0,0,0,0,0,0,0,0,0,0,0,0,21,2,0,0,0,0,0,0,0,0,0,100
3955f7b2c44b15b335ca41ad57045e4457ae641c,0,0,0,0,0,0,0,0,0,0,0,0,0,0,22,3,0,0,0,0,0,0,0,0,0,100
3957076bec1e80b22750a79c3de15012bea69bc9,0,0,0,0,0,0,0,0,0,0,0,0,0,0,23,4,0,0,0,0,0,0,0,0,0,100
8ea0c13a5cc6aae0465606db7308d6620a30249c,0,0,0,0,0,0,0,0,0,0,0,0,0,0,24,5,0,0,0,0,0,0,0,0,0,100
89653f9f373aae95cf04c32b4ba343bfacce5c2c,0,0,0,0,0,0,0,0,0,0,0,0,0,0,25,6,0,0,0,0,0,0,0,0,0,100
a435efb1a63b8530bdf120ba9965f33fda9db92f,692,81487,83647,2160,290,0,290,2,37,0,5,72,8.494343908,54204,316,0,11094,18556,7462,390479,1252461,861982,4215,9094,4879,76.86100464
7360fad39479220dcb1618321fa6aac34885740b,0,0,0,0,0,0,0,0,0,0,0,0,0,0,0,0,0,0,0,0,0,0,0,0,0,100
8f767d8514a57b50eee8966b4c610ca8afdea711,1,6,7,1,0,0,0,2,6,128,1,1,0,140,12,2,7,7,0,1492,1485,7,3,3,0,100
07515446dd3ef8fe5f98e4fe3e5a430c4c5bfb23,15,0,147,147,0,0,0,2,2,0,1,2,3.80609523,3808,362,21,889,918,29,28750,29491,741,435,454,19,100
fdd8ca2a2afc84395abaaaeeea16515b58e52f5c,5,195,140,55,1,0,1,2,2,8,2,2,1.816288827,52,363,22,23,0,23,890,112,778,3,0,3,98.00164813
e73641946409e00a6680fb079b3a70904647e0e1,0,0,0,0,0,0,0,0,0,0,0,0,0,0,364,23,0,0,0,0,0,0,0,0,0,100
10c79a3d1ba65f6b99a330e36c110bbf2f2f1b98,0,0,0,0,0,0,0,0,0,0,0,0,0,0,365,24,0,0,0,0,0,0,0,0,0,100
c86ef1458a615f5598ee6807f545fca92f9c1deb,1,4,5,1,0,0,0,3,49,59,1,1,0,317,366,25,70,70,0,2232,2232,0,27,27,0,100
49bb59b3654d4e4803f966bd162d20f0f5d720ff,0,0,0,0,0,0,0,0,0,0,0,0,0,0,367,26,0,0,0,0,0,0,0,0,0,100
c00a70c1f63ee46c9680bd9253096f241dc2a6f5,6,1133,0,1133,6,0,6,1,1,0,1,1,2.564891799,0,368,26,129,0,129,6672,0,6672,66,0,66,99.70338983
c2976b2b77cc7aaa7a32ecd182598bbdb1ee231c,0,0,0,0,0,0,0,0,0,0,0,0,0,0,369,27,0,0,0,0,0,0,0,0,0,100
f3c16c2dca2431ec1ef5fc99808241501f11c801,1,1,1,0,0,0,0,3,5,26,1,1,0,67,9,0,11,11,0,483,483,0,5,5,0,100
a51dd9e2e16a6286aa894a9f5be23f5c046b60e3,58,1564,12384,10820,2,0,2,1,2,0,2,14,4.713011614,9895,10,1,1227,2514,1287,37604,70110,32506,400,917,517,96.61380197
b5b5d40367d6236e415058bcc6f4dc53003541b0,1,2231,2264,33,0,0,0,2,3,2,1,1,0,1408,317,1,462,468,6,14152,12830,1322,78,88,10,100
73e17cfc4e178c81e47b689426aaa87aebac2985,2,579,78,501,1,0,1,1,11,19,1,2,0.936823869,241,318,2,96,37,59,5222,2248,2974,31,6,25,99.76180165
2d857d59170a947427e7c353c8e57dff5492b927,1,6,3,3,0,0,0,1,2,2,1,1,0,299,319,3,44,44,0,2651,2600,51,16,16,0,100
f4596a6a9a6ec9839b99c747d00e16c26ef814bd,1,3,1,2,0,0,0,2,12,2,1,1,0,311,320,4,52,52,0,2636,2622,14,15,15,0,100
ae92fd670708da5dfab8068e4c766c4dba668cf3,1,3,2,1,0,0,0,1,3,0,1,1,0,303,321,5,44,44,0,2669,2651,18,16,16,0,100
f9d039d562a49d766b899fa989ffa27ec4057691,0,0,0,0,0,0,0,0,0,0,0,0,0,0,370,8,0,0,0,0,0,0,0,0,0,100
85d756f00159d92e570a3412fc0e195377998683,1,3,1,2,0,0,0,3,4,47,1,1,0,65,322,5,12,11,1,418,408,10,3,3,0,100
d106e8479867fef1d315e66c7e63fdc1ecbc2be0,2,124,37,87,1,0,1,1,13,3,1,2,0.937622086,313,323,6,60,52,8,2950,2636,314,18,15,3,99.76205927
4931ade7dc8ce32f02d33a876a8737175dcd1b92,1,18,4,14,0,0,0,2,8,47,1,1,0,99,324,7,13,10,3,1112,927,185,3,3,0,99.80540541
bc440feeeef9ffe7e85ef432981db1f2e8e1fedf,1,3,2,1,0,0,0,2,6,50,1,1,0,30,371,9,6,6,0,180,168,12,4,4,0,100
f17cc37c0a07a873811424a47f84c95e2555a5ed,1,3,2,1,0,0,0,2,4,50,1,1,0,28,325,8,5,5,0,225,222,3,2,2,0,100
c21e773c0c8c3b6aa46415fb8a7bcbef6c4885f3,3,139,25,114,2,0,2,1,4,4,2,3,1.480615277,304,326,9,47,44,3,2946,2669,277,18,16,2,99.74076474
cebf8bfe53fddd78e80ae24b38e468a16f576c2a,15,477,1171,694,1,0,1,2,4,35,1,8,2.729000166,5326,372,6,1127,1199,72,37474,39496,2022,282,318,36,99.54574951
2f85f29f82b9b44509ff76de96321ace572dbb7c,55,2249,1895,354,0,0,0,3,27,224,2,14,5.395156376,4129,11,2,532,532,0,35299,35393,94,207,207,0,100
b35b030a3d817675e6c5d0d445608b51ec8072c2,34,2066,729,1337,12,0,12,1,8,93,2,9,4.259096737,2174,12,3,484,342,142,25351,16951,8400,185,135,50,99.33447832
b597523c39fdc4844f7623c1b2a7ea086179e7e2,0,0,0,0,0,0,0,0,0,0,0,0,0,0,373,3,0,0,0,0,0,0,0,0,0,100
65ea79f03dc80e2c55906e1544118b4ec1c3d1a5,2,133,0,133,2,0,2,1,1,0,2,2,0.995060047,0,13,4,16,0,16,676,0,676,4,0,4,99.91471215
d63012f869c355b014b4fd9bb0866621e89b3baf,4,61,12,49,0,0,0,2,6,126,1,3,1.277504914,502,13,0,54,51,3,4748,4640,108,24,22,2,100
2308cccf783b15fe2a0f9eca94f43e3cb0e271ea,27,95,101,6,0,0,0,2,22,32,1,16,4.382213946,3902,374,4,677,678,1,29999,30024,25,295,297,2,100
cfe7f01fbccc1e6aee4ccdc5ae2b435f1a6efff9,3,8,9,1,0,0,0,2,2,69,1,1,1.253297578,197,375,5,37,37,0,1509,1513,4,24,24,0,100
2b19ed54115a1d6184eab860e5af24712fd14a0d,9,575,0,575,9,0,9,1,1,0,1,2,2.941528113,0,26,0,43,0,43,2698,0,2698,26,0,26,98.26214405
0a06799a12b30425e7c4df86cd0030785d78988c,1,25,25,0,0,0,0,2,8,209,1,1,0,174,327,10,31,31,0,1620,1620,0,10,10,0,100
fb1f1c257f924be1fb4a444dc42b5c94c8f1ab9d,1,2,1,1,0,0,0,2,9,0,1,1,0,174,328,11,31,31,0,1626,1620,6,10,10,0,100
250ed3d84da6edebf2257d8020f1230a416ab66e,1,50,50,0,0,0,0,4,9,71,1,1,0,249,329,12,34,34,0,2426,2426,0,7,7,0,100
41f1c0445cdee15b437b94742c8dbdaa7b5ecdea,1,0,23,23,0,0,0,1,2,0,1,1,0,11,27,1,0,1,1,0,90,90,0,1,1,99.95881384
166b331defd0203bbf63569918dc1b777dac6ac5,0,0,0,0,0,0,0,0,0,0,0,0,0,0,376,6,0,0,0,0,0,0,0,0,0,100
0ac661821f43a4a08a684d8b4af773c2da0ee6d7,3,0,1763,1763,0,0,0,2,2,72,1,1,1.581811679,966,14,4,0,221,221,0,5919,5919,0,71,71,99.75237309
48989a4e0740ef1a25c40e37b7716e0b505a9aea,10,1586,0,1586,10,0,10,1,1,0,2,3,3.0480972,0,377,7,111,0,111,8089,0,8089,39,0,39,98.55485447
67fbb78b3ea4845b54050d9c5eac487b6df0bb8b,1,0,1,1,0,0,0,2,2,0,1,1,0,99,15,4,14,14,0,847,862,15,2,2,0,100
135a84023a208a1c9de9bcb79da6b5ae8c3381e8,77,707,907,200,0,0,0,2,38,60,4,24,5.541093669,10417,1,0,1779,1815,36,86009,86888,879,780,802,22,98.38808406
251a4768a8f7b4480ece8f477ec4c0b8bfe4fcbe,1,0,68,68,0,0,0,2,2,79,1,1,0,41,2,1,0,5,5,0,366,366,0,2,2,99.9168572
eeaafa6217c9d763b7cc2bbd578aa040f7ed432a,7,477,0,477,7,0,7,1,1,0,2,2,2.732655664,0,3,2,67,0,67,2766,0,2766,32,0,32,99.0544232
a9cf7d817aa327399ecd3f08d6174248c3807bf5,7,182,1269,1087,0,1,1,2,3,42,1,4,2.075145814,1084,0,0,103,245,142,3630,7145,3515,38,86,48,99.15164369
66f844a404bea947abf27fbabe28643253fe8aad,3,137,37,100,0,0,0,2,7,197,2,3,1.327029984,242,14,1,44,27,17,2875,2427,448,11,9,2,99.93645414
6214879061a9dd71cf9ff6027c712edcb4c45874,2,30,2,28,0,0,0,2,2,26,1,2,0.811278124,64,28,2,11,9,2,559,436,123,6,4,2,100
b3f68574c107dffea09362cabc84e4432778f60d,60,997,686,311,3,0,3,2,39,18,4,26,4.392868338,8329,378,8,1361,1295,66,71737,70779,958,579,540,39,97.44131952
7fd0c4110ee2f415041367bfde1bcf0fb5388412,1,13,2,11,0,0,0,1,38,96,1,1,0,581,379,9,84,82,2,3678,3644,34,37,36,1,100
b19e36aaac7648c3e1a932f4ad7330317301e5ae,1,14,2,12,0,0,0,1,16,161,1,1,0,140,380,10,41,39,2,1201,1143,58,5,5,0,100
c3b4adadcd40e11b037bf8670411147d1b9edbc1,0,0,0,0,0,0,0,0,0,0,0,0,0,0,1,1,0,0,0,0,0,0,0,0,0,100
6adea873190067b9c3fae521fc2b68a2316ced97,0,0,0,0,0,0,0,0,0,0,0,0,0,0,2,2,0,0,0,0,0,0,0,0,0,100
824dc51f90da44ce6d71cab7e4012d351bbf562a,0,0,0,0,0,0,0,0,0,0,0,0,0,0,3,3,0,0,0,0,0,0,0,0,0,100
7ea6efce2294c55869d4b0441158cb5c35a855c1,2,26,17,9,0,0,0,1,2,44,1,2,0.99022469,145,4,4,31,31,0,897,881,16,22,22,0,99.91554054
44127950c4c50cd2e73050856373bb33f66b4b17,8,202,128,74,1,0,1,3,5,4,2,3,2.701608532,832,16,5,93,90,3,6829,6486,343,30,28,2,99.68327703
0935b073a7d2d2c02dccbd621369ac2960f9c091,0,0,0,0,0,0,0,0,0,0,0,0,0,0,5,5,0,0,0,0,0,0,0,0,0,100
434cdff2176906edf5d6bfd8c66980b423fa0c47,95,343,542,199,1,0,1,3,32,124,4,37,6.26437223,10133,381,9,1513,1541,28,88182,88771,589,647,675,28,96.59947058
d7351ccd19765f564a4155937024c83a99e3d23b,6,1704,0,1704,5,0,5,1,2,0,1,5,1.970065585,65,6,6,192,17,175,7895,448,7447,93,11,82,99.76484421
7a61938f2c90c0876f6d0075adf316b246c76424,8,240,304,64,0,0,0,3,5,24,1,5,2.001317494,4170,7,7,1020,1021,1,32727,32835,108,229,230,1,99.90224829
6a253e35677ae3872fbf2064db5367016025fd48,0,0,0,0,0,0,0,0,0,0,0,0,0,0,382,10,0,0,0,0,0,0,0,0,0,100
d911fcefc434638513808e298fb7562705e21b2a,43,138,148,10,0,0,0,2,33,42,1,22,4.972566156,4740,383,11,678,679,1,42659,42703,44,277,278,1,99.47017268
d673a78f9ac7423a5868f42f57bc827f6124737a,1,0,6,6,0,0,0,1,4,0,1,1,0,94,384,12,22,23,1,687,725,38,12,13,1,100
20dd0a1bcc17d08089ef132114034345796b5925,19,479,1029,550,0,0,0,2,3,74,2,5,3.280585839,2210,8,8,422,531,109,12842,15302,2460,199,232,33,99.45054945
0308bb821691c00d8cbbf4dce01e489745463a41,18,504,666,162,1,0,1,4,17,82,2,4,3.470052175,1548,48,0,185,182,3,13198,14502,1304,99,101,2,99.02610051
1d47c52246dce73f900bb91de3dacee23cb54712,2,0,104,104,0,0,0,2,8,0,1,1,0.961236605,57,49,1,0,7,7,0,461,461,0,7,7,99.90296914
4233591fad46d89f01068fddf77a013d538792b9,1,1,1,0,0,0,0,1,3,0,1,1,0,33,385,13,5,5,0,257,258,1,4,4,0,100
14a584464a1da38cb5e40e3be1106922b52e2052,4,9,6,3,0,0,0,4,18,6,2,1,1.96559623,513,386,14,67,67,0,5023,4998,25,34,34,0,100
a7e552ae4a386dc6c6331a2b907ac6f1a1747e0a,1,9,4,5,0,0,0,4,10,15,1,1,0,80,387,15,14,14,0,729,708,21,7,7,0,100
27632def50fc555e351c7c9d2efa3fcdf8c87337,23,0,7166,7166,0,0,0,3,4,40,1,3,4.15989297,2900,9,9,0,637,637,0,20669,20669,0,294,294,98.65692277
a47e23ebbd96de785fd1397931ad231c291ae948,0,0,0,0,0,0,0,0,0,0,0,0,0,0,10,10,0,0,0,0,0,0,0,0,0,100
435c42923b389bb434484c6d68c7951c98c323a6,13,66,40,26,0,0,0,2,36,13,3,4,2.836768866,1129,50,2,169,169,0,10020,9626,394,101,101,0,100
1b91a877acbd48141da6b1ec0f55039d0b9e7988,3,201,6,195,2,0,2,1,13,0,1,2,1.249427046,105,51,3,47,19,28,1917,725,1192,23,13,10,99.7212266
66174ac4f0ca1882d1c6ba2538ea32de859c25e8,5,260,148,112,2,0,2,1,14,2,1,2,1.922107918,232,52,4,58,47,11,2537,1917,620,32,23,9,99.40582294
93443ba1fb1718ddf5cd82751e14fd6732a3b896,1,16,2,14,0,0,0,1,2,0,1,1,0,70,53,5,14,14,0,443,463,20,10,10,0,100
2badc2d4df05a8f4409a23ab3e48f770ccab6941,2,221,155,66,1,0,1,1,2,0,2,1,0.97765867,120,54,6,30,34,4,1639,2126,487,11,10,1,99.92050874
ecb08e8dd4c79d51ea8a7fcf065ce2a5f978fd5a,17,1485,20,1465,12,0,12,1,5,5,1,6,3.445384536,960,4,3,427,279,148,12599,6675,5924,196,115,81,97.71176234
e98c2ec601e4ec241847c9ad6a7c73c648d53348,17,20,1485,1465,0,0,0,1,6,0,1,6,3.445384536,1845,5,4,279,427,148,6675,12599,5924,115,196,81,97.71176234
504c1677cb19a97c6a9f15526cd509bb75ab7366,5,149,20,129,0,0,0,3,7,0,1,1,1.227753898,960,6,5,297,279,18,7066,6675,391,129,115,14,98.34644081
993e608eb65378b6536b9469f13996d6fbd0a492,0,0,0,0,0,0,0,0,0,0,0,0,0,0,7,6,0,0,0,0,0,0,0,0,0,100
a258fa20ca77654baeb205864d697606cea2e267,1,1,1,0,0,0,0,2,2,10,1,1,0,395,8,7,78,78,0,2473,2481,8,31,31,0,100
08f8923c1a4ebd9b13f93e34a22af6fd0ccc6363,1,5,2,3,0,0,0,2,6,0,1,1,0,487,9,8,130,129,1,3434,3422,12,46,46,0,100
a01238bb99c948dcaeec536b546f7af4c6a37d0b,1,20,0,20,0,0,0,3,8,0,1,1,0,228,10,9,69,62,7,1411,1249,162,37,36,1,97.85269918
0821d4271ff44e18ac504a9e8859b8fe9ecbd73b,1,14,0,14,0,0,0,2,2,20,1,1,0,209,11,10,56,52,4,1300,1204,96,35,34,1,100
ab2d63e79fc379beb751bba13159842de6b771ad,1,1,1,0,0,0,0,2,7,0,1,1,0,489,12,11,130,130,0,3433,3434,1,46,46,0,100
ba1198e91f793d7a527bc3520586cb7ffa7ff781,1,33,15,18,0,0,0,3,8,0,1,1,0,116,13,12,41,35,6,934,838,96,17,15,2,100
506d84d80dbcd4eb703ec6fb0370fad06fc9d13f,12,1330,0,1330,12,0,12,1,3,0,1,5,3.143079585,0,14,13,130,0,130,5533,0,5533,67,0,67,97.28326009
6e3509bb26e2bbc7a5b3b2a78cf4ba0dfe1e921b,3,24,31,7,0,0,0,2,18,34,3,3,1.445903376,386,29,3,48,48,0,2989,3044,55,14,14,0,99.97972425
ea6519794d19f11cd2540b6e46f56f765cec74c8,150,638,1029,391,0,0,0,3,50,24,5,67,6.481067205,27546,388,14,5252,5255,3,203967,204679,712,1779,1779,0,96.61646379
885e4d7bbc76963566b6d9580e6864524f3822dc,2,25,15,10,0,0,0,1,4,517,1,1,1,117,389,15,25,25,0,1030,990,40,2,2,0,100
089dbf2633a6427852354881f75acecd8aa7cb54,1,2,1,1,0,0,0,3,9,0,1,1,0,190,15,14,22,22,0,2044,2033,11,3,3,0,100
b78c9af0fb7e57b05b7cd003a72e95a013f57b74,2,14,12,2,0,0,0,1,5,0,1,1,0.391243564,126,390,16,27,25,2,1064,1030,34,2,2,0,100
e3fd6a4d1459d7a4893945d8cdf405d97d5a4663,1,14,2,12,0,0,0,3,15,48,1,1,0,137,391,17,11,10,1,994,915,79,2,2,0,100
c184e663bfb63164ff8217f5fbdf2c0d220ab206,1,40,11,29,0,0,0,3,16,1,1,1,0,147,392,18,13,11,2,1252,994,258,2,2,0,100
af5cf6c3ed0224ca611adbd9ab20485f8cf1633d,0,0,0,0,0,0,0,0,0,0,0,0,0,0,393,19,0,0,0,0,0,0,0,0,0,100
f518dba33d7c6116a5e65be9160fc48f61b989a4,1,15,2,13,0,0,0,3,17,0,1,1,0,174,394,20,14,13,1,1305,1252,53,2,2,0,100
96e6ed2248fdcdbfa263dfd55af7ee0785b2264e,2,87,9,78,1,0,1,1,2,11,1,1,0.625262405,48,395,21,19,8,11,665,341,324,12,4,8,99.91605456
e244bcaa2ff6ddf4aced9f7645abaa88400a197a,2,74,14,60,0,0,0,4,7,38,1,1,0.860965256,2262,396,22,598,591,7,18150,17793,357,121,114,7,99.87408185
39945ad3a0c48c20b1c8d01235178329bdc04488,0,0,0,0,0,0,0,0,0,0,0,0,0,0,397,20,0,0,0,0,0,0,0,0,0,100
18bf66395622980fc4796a0506aa12af484ed7f4,26,34,48,14,0,0,0,2,17,26,1,15,4.492764085,2101,398,21,333,334,1,16830,16887,57,136,136,0,100
a576dc786efa69f44e396bd61b59fd412e5806d3,2,341,6,335,1,0,1,1,8,4,1,2,0.173585586,1925,399,22,523,518,5,18007,15530,2477,88,86,2,99.91603694
5a677d48c6ae50254ef8d72e4b9900f84e84efbe,41,169,203,34,0,0,0,2,14,17,5,27,4.514872023,9257,400,23,1806,1806,0,71911,72017,106,505,504,1,98.59613428
81702b74f959aa0699f55c2745e52ed53bf354db,1,2,2,0,0,0,0,1,4,133,1,1,0,8,401,24,0,0,0,73,73,0,0,0,0,100
e4e6d107ae7bebc26f333ddafc11edcf20cb39f2,2,66,12,54,0,0,0,1,6,189,1,1,0.9923985,639,402,24,193,183,10,3850,3616,234,76,74,2,100
4f91f4458bef5854c6af5a051c0ef788c0e0f774,71,801,682,119,2,0,2,3,37,21,4,21,5.090078189,14302,16,12,3210,3100,110,104352,100614,3738,1295,1203,92,96.94331984
fdc5ca5a41df2b95e71c2575decd84be2bcc1c77,2,5,9,4,0,0,0,3,6,0,2,2,0.749595257,512,17,13,133,134,1,3392,3426,34,50,50,0,100
ed761b730105d83a0393265dabaf46dd7dafe9c3,1,2,1,1,0,0,0,3,7,0,1,1,0,481,18,14,128,128,0,3227,3212,15,45,45,0,100
b162d9e28f2afab911cdac589b36b4931c1cca04,0,0,0,0,0,0,0,0,0,0,0,0,0,0,19,15,0,0,0,0,0,0,0,0,0,100
7f224686b57e45c5d0bb5aa63166513ef7d61c76,3,10,1,9,0,0,0,1,15,109,1,3,1.539484757,212,403,22,10,7,3,1677,1641,36,6,6,0,100
c1ee809929102246c80d39ee1fcb886c475afc89,1,1,1,0,0,0,0,7,34,41,1,1,0,374,17,0,60,60,0,3462,3462,0,12,12,0,100
bba929eb403b1de6edb2e6c45bb053bb31069e38,1,15,9,6,0,0,0,7,35,1,1,1,0,374,18,1,60,60,0,3464,3462,2,12,12,0,100
9c457637ab87bdcd31441d8c7618a0862a820f9d,0,0,0,0,0,0,0,0,0,0,0,0,0,0,19,2,0,0,0,0,0,0,0,0,0,100
bf717650b7d3abbbf65ce31423e8e019fa0ebc94,0,0,0,0,0,0,0,0,0,0,0,0,0,0,20,16,0,0,0,0,0,0,0,0,0,100
31007bced7d8f424dd69e406938f1eea617cd9f0,3,14,0,14,0,0,0,2,11,18,1,1,1.577406283,676,21,17,186,181,5,4093,3986,107,106,103,3,100
f89fd9a53ba114de0582c9a2e1b3667137273633,1,34,19,15,0,0,0,5,15,39,1,1,0,70,20,3,12,9,3,731,637,94,2,2,0,100
9a8c2331b4056bf204ec6fd6787449c6df42c5c9,5,14,15,1,0,0,0,2,13,62,1,4,1.268067353,836,404,16,150,150,0,7108,7109,1,42,42,0,100
251f0e920403f47e83764e6d6cb7816f91985afb,18,1110,371,739,6,0,6,3,15,29,3,9,3.534807479,1091,21,4,205,139,66,12783,7957,4826,73,56,17,98.51726329
1be812e19977fe5410bd39ea2a1561006c4e260f,32,1237,953,284,0,0,0,2,14,66,2,7,3.998175111,2789,22,5,467,463,4,23067,22712,355,179,179,0,99.58936676
2e38f55bff6e5b5080d57ab37ad79255cdb47346,0,0,0,0,0,0,0,0,0,0,0,0,0,0,405,9,0,0,0,0,0,0,0,0,0,100
f401530f6f32160d1d5f46b9f6642777ccf63265,0,0,0,0,0,0,0,0,0,0,0,0,0,0,23,6,0,0,0,0,0,0,0,0,0,100
ecf6999d99cfd771105ee362700590fba6ab340c,4,218,54,164,0,0,0,1,51,234,2,3,0.514625027,760,406,9,191,161,30,6288,5582,706,70,66,4,100
753f43e4ccfa6b719edca9c52cfdd333087b2613,0,0,0,0,0,0,0,0,0,0,0,0,0,0,24,7,0,0,0,0,0,0,0,0,0,100
838ad263b117205bde49096cd376e6f323be89d6,2,8,2,6,0,0,0,6,16,38,1,2,1,144,25,8,23,21,2,1073,1033,40,8,8,0,100
98aeb713ff6ecc06c4c1cfa50f5b387e03c675df,5,99,13,86,1,0,1,1,36,62,1,5,1.296530284,1137,26,9,199,188,11,10695,10263,432,45,38,7,99.76144003
54aef6529b95851faa34e5bfb236a101a326ffab,1,1,1,0,0,0,0,3,6,13,1,1,0,246,27,10,63,63,0,1513,1512,1,36,36,0,100
7eac96d5dd658a7168d0548747fbd205d3c918ca,2,24,24,0,0,0,0,1,8,6,1,2,0.979868757,257,28,11,25,25,0,2135,2151,16,8,8,0,100
595157bc194375fbc2f72a4279bfb9bc3ea34ef5,3,356,202,154,0,0,0,3,16,30,1,2,1.414019018,462,29,12,84,74,10,4641,4048,593,23,22,1,99.97823248
fa9b2b1b24568176255b9406ac17ef0708d9dd42,62,11614,14,11600,61,0,61,4,4,0,2,12,4.621752529,79,11,0,1425,22,1403,46638,429,46209,497,12,485,96.22324801
b879eb29ca15ef44c7be85685a5b399d113b5d32,0,0,0,0,0,0,0,0,0,0,0,0,0,0,12,1,0,0,0,0,0,0,0,0,0,100
ebf9a4d9c26c182c26d5fdb3ea4b1f12ed19a7bb,61,0,11531,11531,0,0,0,1,9,45,2,11,4.624776457,6676,13,2,0,1415,1415,0,45625,45625,0,498,498,96.2605042
56079f0ddc932eb8f62839da7a5245d1f953af11,0,0,0,0,0,0,0,0,0,0,0,0,0,0,30,13,0,0,0,0,0,0,0,0,0,100
1b028058317526221b1124612c7dd468b77030f7,0,0,0,0,0,0,0,0,0,0,0,0,0,0,31,14,0,0,0,0,0,0,0,0,0,100
b38e82489b33d4999113a09ff1964581565fea2c,10,50,48,2,0,0,0,1,9,4,3,7,2.378906635,1073,32,15,134,134,0,8650,8667,17,41,41,0,100
00777adafbab69e23488a867ecf61c65d1fadb34,1,2,2,0,0,0,0,1,2,9,1,1,0,81,33,16,11,11,0,737,739,2,2,2,0,100
520918395bcc10bdcdbe05e25708b353ffe21716,3,24,30,6,0,0,0,3,20,115,1,1,1.330264331,328,55,0,63,65,2,2579,2577,2,30,32,2,100
290e76ff0b67306dfa21062aad3a1c8b20e0b843,41,114,445,331,0,0,0,3,12,24,1,11,4.238674178,8264,407,6,1936,1936,0,54308,55253,945,756,756,0,100
e4ad6b16f3fa2cebf7c2c0baf36c346fb7599f17,0,0,0,0,0,0,0,0,0,0,0,0,0,0,34,17,0,0,0,0,0,0,0,0,0,100
a276c6ddc72ce12b8a78b9a50f80e36a4e1267fc,11,1473,0,1473,11,0,11,1,1,0,1,2,3.349609713,0,35,18,107,0,107,6840,0,6840,46,0,46,99.23714037
1db8ad4c4f0426fbb7973384cff41df6844abd56,0,0,0,0,0,0,0,0,0,0,0,0,0,0,408,7,0,0,0,0,0,0,0,0,0,100
8555d67ad27df9bf664eaaa87f6dd704d9fbaaff,3,0,1,1,0,0,0,2,5,4,2,2,0,517,36,19,47,33,14,4438,3246,1192,10,10,0,99.82585982
6980b95dce04af3545fb3b75c11836b0988bb98a,6,9,9,0,0,0,0,1,1,0,2,2,2.419381946,401,37,20,39,54,15,3752,2214,1538,11,12,1,99.47757945
382b4470c54285194dc9a722f88dcaf2cc2528a3,6,138,81,57,0,0,0,1,3,0,1,2,1.986887971,469,38,21,78,73,5,4059,3759,300,31,30,1,99.97823248
611c3a7753cdacef3f168a8dddd4786226445bfa,13,704,67,637,4,0,4,1,38,76,1,5,2.899810888,673,56,1,175,130,45,8819,4521,4298,137,93,44,99.39156888
2c005ed09a80889b83bbcf09972804a6c4278302,2,2,2,0,0,0,0,1,10,0,1,2,1,275,57,2,30,30,0,2675,2675,0,29,29,0,100
2e77bf8c7fcacf9ad7252b2b9e0d8a758fc60d32,47,142,158,16,0,0,0,2,41,44,3,28,5.019596629,6254,409,7,741,745,4,56083,56686,603,280,279,1,98.99585243
ed6770439adef1c609f40907acc69081c9d658e8,1,3,1,2,0,0,0,6,17,0,1,1,0,154,39,22,21,21,0,1553,1531,22,14,14,0,100
1769809395eb3383f97dd3f696290abfdbfd8208,3,5,601,596,0,0,0,4,8,21,1,1,1.021823245,976,40,23,109,193,84,3557,6322,2765,42,76,34,99.62555066
1c2d22d06acbd0a975311b36ceb8bd24bf28d952,16,703,507,196,1,0,1,3,10,2,1,5,3.407710855,1252,41,24,179,160,19,11779,10889,890,64,67,3,99.08735332
1186b5a77f952c90e763b098a2704923d1df246b,1,1,1,0,0,0,0,3,14,81,1,1,0,148,410,7,19,19,0,1286,1286,0,5,5,0,100
951224a86989e4c75b92d6ff21607a50caa8e433,1,76,3,73,0,0,0,2,7,3,1,1,0,143,42,25,19,13,6,1710,1219,491,2,2,0,99.52194698
5e41ea67c5a2233a3f085ad2ee494c06d27236be,1,0,0,0,0,0,0,1,1,0,1,1,0,205,43,26,19,19,0,1710,1710,0,2,2,0,99.91166078
a54904160693310346489178b15c8d4eacc2d9e7,9,369,57,312,2,0,2,1,11,1,1,5,2.2372028,983,44,27,106,88,18,9457,8080,1377,30,23,7,99.88969777
fd7975f809dd543c633db145e1fde3377f867f46,3,216,186,30,0,0,0,1,3,0,1,3,1.425255796,432,45,28,52,42,10,3849,3531,318,11,11,0,100
87f1d33718c3fd0e75d46d6fa22999b711863be7,1,38,33,5,0,0,0,4,6,7,1,1,0,116,46,29,38,38,0,883,912,29,15,15,0,100
4bd4d8d09b54981ef7b20d44d43f789e27f7ede8,9,349,288,61,0,0,0,3,13,99,1,6,2.614183344,804,47,30,96,96,0,7099,6740,359,40,43,3,99.93390615
da1b0acfa7ecf1027af50f622733607726bee0c0,0,0,0,0,0,0,0,0,0,0,0,0,0,0,330,0,0,0,0,0,0,0,0,0,0,100
3a39b0bb82c65e74bec2b88dbbd5d3df9132d6d2,1,158,119,39,0,0,0,1,2,8,1,1,0,150,48,31,14,13,1,1648,1613,35,3,3,0,100
49c9b9903a554830bbe8c2aacf9597d3248a37b0,32,127,133,6,0,0,0,2,42,30,1,15,4.137924286,3569,411,8,495,498,3,29783,29801,18,307,308,1,100
ed8a04fb29dd9aeadc15a5e6d89a0ae505a7c6fd,0,0,0,0,0,0,0,0,0,0,0,0,0,0,412,9,0,0,0,0,0,0,0,0,0,100
f41017d00d89068b960a1fac82eae7297c1fa6a9,1,5,4,1,0,0,0,2,16,7,1,1,0,521,49,32,90,90,0,3849,3859,10,13,13,0,100
95cc48a65eac18a3c4a91d3be9461dbe55b3880d,1,9,7,2,0,0,0,1,3,102,1,1,0,148,413,10,19,19,0,1312,1292,20,7,7,0,99.97797357
933e150126a6935bccb45da403e21c990fa0cd46,3,15,11,4,0,0,0,3,17,87,2,3,1.497863726,493,50,33,72,71,1,3924,3866,58,24,24,0,99.82363316
bbbebdac003341dae4cb23c1443a2c70eb06359b,7,75,29,46,0,0,0,3,12,7,1,5,2.370022655,776,22,2,92,90,2,6704,6431,273,28,28,0,100
9d4b21512ae6213d1381d2686b5a69ae9a6c590d,1,12,2,10,0,0,0,1,4,4,1,1,0,213,51,34,21,20,1,1798,1740,58,2,2,0,100
e26711c75d1c82d968686fa9eec84ca3822805d6,0,0,0,0,0,0,0,0,0,0,0,0,0,0,331,1,0,0,0,0,0,0,0,0,0,100
a6d8cd609dd774c37a3637fb57a7bacca8ddb57c,1,94,79,15,0,0,0,1,1,0,1,1,0,175,52,35,31,31,0,1671,1623,48,9,10,1,99.88967343
ab794986d5a4ad30b5a99c69b4c7bdc625b9d83e,1,2,1,1,0,0,0,3,7,67,1,1,0,110,53,36,13,13,0,1122,1117,5,3,3,0,100
9ebf9127b3a16ce6c6e58b4e2b0e62e2a931f3f3,1,39,23,16,0,0,0,3,5,11,1,1,0,165,332,2,20,18,2,1370,1244,126,9,9,0,100
905bee382ef7039f278df955fdb89db4af23f625,1,5,5,0,0,0,0,3,6,0,1,1,0,180,333,3,20,20,0,1370,1370,0,9,9,0,100
2939520a476e10369e035f61f0bc251aefac18a1,1,2,2,0,0,0,0,2,5,2,1,1,0,222,334,4,21,21,0,1798,1798,0,2,2,0,100
233d93d401d813ae7e5de852fe7a2b7cce14e305,58,1690,1855,165,0,0,0,3,18,95,1,21,5.174838542,5388,54,37,697,697,0,44396,43832,564,260,260,0,100
833d96f4b96739118941c0a890d07c65807d35bc,1,1,1,0,0,0,0,3,7,0,1,1,0,180,335,5,20,20,0,1370,1370,0,9,9,0,100
42ae840390ea2453e6ee53ff466cf631bbf2edb7,101,3537,3627,90,0,0,0,2,26,349,1,28,5.993753546,6933,55,38,947,945,2,59002,58189,813,459,459,0,99.82347749
d581a9e5a482283a0019bb5667dec4594c124b3b,5,32,24,8,0,0,0,2,10,0,1,1,2.044293385,132,56,39,20,20,0,1058,1058,0,12,12,0,100
b82d989933132c9807007147b1ef7239f00d6eb0,119,1935,2202,267,0,0,0,2,20,72,1,24,6.350045292,8172,57,40,1291,1287,4,63061,62364,697,599,599,0,100
ad11134046ff704007aab4f3d0ebb912b833edd3,59,2285,2135,150,0,0,0,3,9,207,1,15,5.435205525,4708,58,41,924,924,0,36058,35452,606,442,442,0,100
67b36047481fd9dcf85fbbd5ec15bc39c5f8c6b0,6,147,135,12,0,0,0,3,13,424,1,1,2.245553526,236,59,42,32,32,0,1906,1896,10,17,17,0,100
1b4e01f075d3e7d7148898c0d4127b590bc0458c,155,5864,5079,785,0,0,0,2,52,284,1,29,6.74937024,12728,60,43,2379,2379,0,89575,88456,1119,1125,1125,0,100
53de8dcfa25980a395af03309cfed029798efb99,69,2700,2403,297,0,0,0,7,43,72,1,9,5.485857086,5778,61,44,838,838,0,48681,48303,378,420,420,0,99.78026807
f254e9c08c8b6ffe832a5da389243974fe62f452,1,6,6,0,0,0,0,7,29,0,1,1,0,550,62,45,78,78,0,5505,5487,18,27,27,0,100
f64d9c4ec850d6f17c0165d0a8e81b39dfa5ec0b,1,1,1,0,0,0,0,7,30,0,1,1,0,550,63,46,78,78,0,5508,5505,3,27,27,0,100
04f2a221f69bd4beeaadc3a4963ba2bf82ffaf19,1,5,1,4,0,0,0,2,2,174,1,1,0,3,23,3,2,0,2,44,16,28,2,0,2,100
87e3a11f35eff0e0969c247345bb15b022425e0c,1,1,1,0,0,0,0,3,9,14,1,1,0,447,24,4,128,128,0,3168,3159,9,45,45,0,100
119d7bdf856443b9afacfed076d16b429c7ab1ee,2,31,15,16,0,0,0,2,7,35,1,2,0.713146749,202,25,5,46,40,6,1979,1835,144,16,14,2,99.54138458
35b33a489c92e291225f35a4f0505e1fc2946d01,4,13,8,5,0,0,0,7,31,0,1,2,1.684185737,823,64,47,117,117,0,8006,7970,36,42,42,0,100
380e609abdb94c83f81c5f12298d71b67cc196cd,1,74,52,22,0,0,0,3,19,3,1,1,0,320,65,47,56,54,2,2920,2721,199,17,15,2,100
8aacfc32f6fdd74dae8011305a0e8d3f299f350f,0,0,0,0,0,0,0,0,0,0,0,0,0,0,336,6,0,0,0,0,0,0,0,0,0,100
51c9f4c819a79fbf599e6bc10e418cdcac1b8936,0,0,0,0,0,0,0,0,0,0,0,0,0,0,337,7,0,0,0,0,0,0,0,0,0,100
a29b210b067688a03fcbebd69c91342e59355f0f,1,21,1,20,0,0,0,2,6,17,1,1,0,183,26,6,56,56,0,1158,1158,0,33,33,0,100
297bef58c48087d8ee321cf457f155cfd1b5a260,200,1227,1187,40,0,0,0,1,53,3,3,81,6.824032853,25740,66,46,3988,3987,1,211594,213232,1638,1581,1581,0,100
e4d6877dd99b667c6fda57a6f5b914a3e03912cb,3,285,5,280,2,0,2,1,11,0,1,3,1.17835771,87,67,47,31,9,22,2587,865,1722,9,3,6,99.80426272
d2ef57c1fe2213ada9433960dbc4e21bface75d8,15,166,74,92,0,0,0,2,54,0,2,7,3.625633761,2253,414,10,444,428,16,16019,15896,123,191,182,9,100
210fac329f44feaf54944b97a0848a9b8827b45c,143,458,461,3,0,0,0,3,33,0,3,66,6.544216895,15666,415,11,2555,2556,1,127826,128741,915,1113,1114,1,100
a0a39da35a85bbccd5764f99fd5a4944f3b5a974,1,3,3,0,0,0,0,2,9,2,1,1,0,397,416,12,104,104,0,2291,2285,6,46,46,0,100
2dc63b9dc2eda7825b92653a6f3b0ef80075da65,6,13,12,1,0,0,0,3,10,1,1,5,2.519079571,504,417,13,65,64,1,4425,4412,13,28,28,0,100
46e266a9bbe91e9003b1b67cef4f33d9b1411ba7,2,305,4,301,1,0,1,1,5,5,2,2,0.173341595,76,68,48,65,19,46,2792,425,2367,21,13,8,99.69664139
8b39361586ee71eb53125ba38b0dd498e2b8a7e2,1,6,5,1,0,0,0,2,6,10,1,1,0,66,418,14,15,15,0,351,339,12,8,8,0,100
1c3cf6d7eb6da71e35b5aa38970400479395fe03,1,104,23,81,0,0,0,1,2,0,1,1,0,242,69,49,62,46,16,3088,2367,721,10,8,2,100
18736b68f4de63ebf6b5716d198c9600ccf76dbd,1,1,1,0,0,0,0,1,3,0,1,1,0,318,70,50,62,62,0,3088,3088,0,10,10,0,100
f33ffab2f139011af961672c5f3ea9248be3e1ab,1,58,39,19,0,0,0,2,4,0,1,1,0,318,419,15,62,62,0,3106,3088,18,10,10,0,99.41760138
6a0a2bdaaa7a1e300a1bacdc7775c758df4858d2,2,17,10,7,0,0,0,2,55,6,2,2,0.605186577,474,420,16,106,106,0,3394,3377,17,35,35,0,100
6958a7fe17994d1435246ea1bf232fcf33dd241a,1,16,8,8,0,0,0,2,6,6,1,1,0,211,71,50,27,24,3,2196,2212,16,4,4,0,99.91390443
9bcb6affd525cb9a971091e5d33c5bc549629d73,1,12,9,3,0,0,0,2,7,0,1,1,0,219,72,51,28,27,1,2202,2196,6,4,4,0,100
2b5810e51c0241f5ba3abe0a38ccd8ced0751af0,1,2,1,1,0,0,0,2,7,9,1,1,0,201,27,5,22,22,0,1719,1704,15,6,6,0,100
1b4185175a2dbb08603c0b9e4a258dd3830c80b1,1,8,12,4,0,0,0,3,11,7,1,1,0,132,28,6,14,14,0,1128,1155,27,8,8,0,100
be17264524e2379bd960c25741336820b1bd3cbb,17,1014,22,992,13,0,13,2,15,43,2,7,3.828257041,327,421,16,152,66,86,7713,2378,5335,107,42,65,97.77152748
dad5997b7e8a04eab9183288e5e8ac948916615c,2,108,4,104,0,0,0,3,7,41,1,2,0.543564443,712,29,7,98,91,7,6352,5577,775,61,58,3,100
5a32a902bad5b56bd39193bc7dfd2b86ef11e769,19,1053,43,1010,8,0,8,2,33,17,3,12,3.224141302,1322,30,8,297,177,120,17041,10338,6703,147,79,68,98.71272259
0083108dea189e391496e21571c3cbce225a8755,11,301,535,234,0,0,0,2,8,11,1,2,2.594121982,973,0,0,115,141,26,7174,7990,816,44,49,5,99.89395546
18d25de94848b039e9e5e759b63d2e22b5362682,1,1,1,0,0,0,0,2,5,13,1,1,0,33,73,47,4,4,0,254,255,1,2,2,0,100
44b4ed70b77bdae5b6ec336a57371038d77ef87c,42,216,229,13,0,1,1,3,28,0,3,27,4.730290158,4776,422,15,593,596,3,40540,40697,157,258,257,1,100
3305f4fff3e2a0e45ab7c4b9a7750fd624ca45a2,4,18,28,10,0,0,0,3,9,23,1,1,1.574614881,183,74,40,34,37,3,1224,1328,104,20,20,0,100
ca5d17cb9a63eea4d4d975856cbf763e2e074a01,1,1,2,1,0,0,0,2,3,0,1,1,0,177,423,16,22,21,1,1391,1383,8,10,10,0,100
8c68b31cf5d346d001cffef9cf28b4b819c06e90,8,394,116,278,0,0,0,2,13,24,3,4,2.321679576,2497,75,41,602,546,56,21576,19294,2282,250,247,3,100
05f0c82f93f41122cfb14aec7f8cb8a3d05cc71d,2,16,14,2,0,0,0,8,42,19,1,2,0.918295834,219,76,42,39,39,0,1547,1481,66,31,31,0,100
ef044f501e5629fe0ac46f29b82ee4cc65b35c5b,1,1,1,0,0,0,0,3,9,0,1,1,0,211,77,43,61,62,1,1413,1417,4,34,34,0,100
9a9f6eb7574babe36103c4f743c14f0ba2d18fa4,1,2,2,0,0,0,0,4,14,0,1,1,0,245,78,44,73,73,0,1530,1528,2,38,38,0,100
43a96876a6ba242db43090fec3bbdad1ba6e5bef,1,3,2,1,0,0,0,3,10,0,1,1,0,211,79,45,61,61,0,1417,1413,4,34,34,0,100
5b965dfcfd697faa04175f312da8bf516d5e5f0f,1,2,2,0,0,0,0,3,11,0,1,1,0,212,80,46,61,61,0,1431,1417,14,34,34,0,100
4c6ba6ffe40ad41812149d1f8a1210e68532789d,1,2,2,0,0,0,0,3,5,0,1,1,0,58,81,47,11,11,0,429,429,0,6,6,0,100
d7b0b37570f64dd7ddbafbd51b72648a31afe95b,1,118,7,111,0,0,0,3,6,0,1,1,0,474,31,9,113,89,24,5306,4444,862,12,12,0,100
2152f095f4088e9996114b9f8a9acd76234a7e9e,0,0,0,0,0,0,0,0,0,0,0,0,0,0,1,1,0,0,0,0,0,0,0,0,0,100
0f033b2774fca4146484c8e134f2c3ad612e88f6,52,73,108,35,0,0,0,3,56,6,5,28,5.464250705,5122,424,15,1092,1092,0,34406,34406,0,462,462,0,100
9e64aa69ec78bfe8a32422a561de13595c57ddaf,1,0,6,6,0,0,0,2,3,3,1,1,0,116,32,10,11,11,0,891,944,53,10,10,0,100
c0a999bc4859f6c2c19f70d932cdec5fbf9156b9,1,1,2,1,0,0,0,2,4,1,1,1,0,112,33,11,11,11,0,889,891,2,10,10,0,100
07b148e26df4cc712749673344de1be4009b906f,0,0,0,0,0,0,0,0,0,0,0,0,0,0,34,12,0,0,0,0,0,0,0,0,0,100
452f13bd8a3a7adee0792067d4af8484c2d4bad9,3,24,1,23,0,0,0,4,11,31,1,2,1.320924277,1221,82,37,339,335,4,10070,9832,238,136,136,0,100
8abc960f2830891bf43a706d1dc19ab60626a382,28,1302,1315,13,1,0,1,5,43,28,2,11,3.966952863,4363,83,17,663,668,5,39010,38621,389,270,271,1,99.61823966
5d4cee37074351dae6fa9f7ec2b3357127cc8143,1,28,48,20,0,0,0,2,4,39,1,1,0,194,84,16,31,31,0,1649,1649,0,9,9,0,100
eb92397738d7c4fee90e82506c21baa151822a26,1,122,105,17,0,0,0,2,5,0,1,1,0,174,85,17,36,31,5,1785,1649,136,11,9,2,100
0f2cc3a60771f81e7f5f02ae70eb3b300874d627,2,13,14,1,0,0,0,4,13,42,1,1,0.825626526,406,86,18,56,55,1,3828,3826,2,17,17,0,100
073255d3fe33ee0bc365d595129cf612585283e5,1,14,2,12,0,0,0,4,11,1,1,1,0,153,87,19,25,22,3,1455,1390,65,11,10,1,100
43982ceb748327b4dcc2854e62478f59de720b6a,1,43,37,6,0,0,0,4,12,16,1,1,0,493,425,7,137,141,4,3497,3482,15,46,46,0,100
8ccc7fda37c8b75066a545e52e6b92b30cfcb929,1,198,0,198,1,0,1,1,1,0,1,1,0,0,35,8,37,0,37,1133,0,1133,5,0,5,99.95764507
e689607f5502b1ecb524417edd68cfe38cf4793a,0,0,0,0,0,0,0,0,0,0,0,0,0,0,36,9,0,0,0,0,0,0,0,0,0,100
36e0f3726c61835290885b19e667923e39bfb1bc,1,2,3,1,0,0,0,2,2,0,1,1,0,133,2,2,38,37,1,1142,1133,9,5,5,0,100
b697110ddacea6ac31362195a6bb3e03447c5a08,0,0,0,0,0,0,0,0,0,0,0,0,0,0,3,3,0,0,0,0,0,0,0,0,0,100
cf27d49d261cc7fd72e6666868110e305c6dc16b,1,7,7,0,0,0,0,4,12,25,1,1,0,103,4,4,15,15,0,847,847,0,7,7,0,100
e0ade2e91745dd3175b2779bb1de57f18d3e58e3,5,61,32,29,0,0,0,4,15,62,1,3,1.695141504,1225,88,17,317,310,7,8591,8386,205,185,181,4,100
1115e3b4e438702cfb75c81aa3a420e9d2524e8c,1,9,7,2,0,0,0,4,16,0,1,1,0,260,89,18,77,77,0,1655,1648,7,40,40,0,100
5854423a402d08048242f39d90fe2a8647a9773d,8,423,210,213,2,0,2,1,14,25,1,4,2.376430306,682,90,19,134,107,27,7095,5937,1158,61,42,19,99.85169492
e6569c6f9e11e2f4cdf2e12c44d1d4e6bc7b1b6e,1,3,2,1,0,0,0,2,6,7,1,1,0,191,91,20,36,36,0,1796,1785,11,11,11,0,99.91530807
6d454c927086e60257f325923a42e44a6f62cdb8,0,0,0,0,0,0,0,0,0,0,0,0,0,0,426,5,0,0,0,0,0,0,0,0,0,100
b469a98d8d29ac9762eae46ece6dfef0dcc7bc20,43,709,183,526,0,0,0,3,20,98,5,17,5.231984451,3020,427,6,447,447,0,20489,20572,83,226,226,0,100
064567e18b9a72f421a605fec6f39c86e65591f9,0,0,0,0,0,0,0,0,0,0,0,0,0,0,5,5,0,0,0,0,0,0,0,0,0,100
40d13893127859367b9be568af7a2e444f3114eb,2,108,53,55,0,0,0,2,2,2,1,2,0.52362052,238,428,6,54,48,6,1900,1753,147,36,32,4,100
25a1880085f73a8885cf637bed35199c9d39cef8,48,162,235,73,0,0,0,3,45,37,5,27,4.418361831,12034,429,7,2392,2395,3,96831,97072,241,791,791,0,100
a8ba0591a6cc12a354c6705eabc0388c151730f8,1,6,0,6,0,0,0,2,2,233,1,1,0,3,37,8,2,0,2,46,16,30,2,0,2,100
cb6f86a80e2d3a060301e880a5a20b0a917b0e88,3,3,3,0,0,0,0,3,13,27,1,1,1.584962501,1183,38,9,332,332,0,8459,8436,23,130,130,0,100
36e4fc18e027beffdb85e65a2b0e1f34e9c7e4e1,2,4,6,2,0,0,0,4,14,27,1,1,0.970950594,210,39,10,31,31,0,1957,1952,5,8,8,0,100
fb4bb1a95a4c5dc8ffac34a0c33828eabc5db538,1,67,0,67,1,0,1,1,1,0,1,1,0,0,40,10,4,0,4,499,0,499,2,0,2,99.95773457
3edb1a7ef4c6a2a9e7b7bb8cca1d5cf132a6c5a9,4,49,19,30,0,0,0,1,9,32,1,4,1.561357799,398,41,11,61,55,6,2893,2646,247,27,25,2,100
235b944133bc4c44ff168bd8659d62ba652a47f1,5,642,20,622,3,0,3,1,5,0,1,2,2.255944995,302,42,12,111,45,66,6415,2113,4302,63,25,38,99.11111111
c035a02d11ade06996f21f4d6f6231e324336ebb,3,48,57,9,0,0,0,2,11,23,1,3,1.377910032,222,43,13,27,23,4,1608,1743,135,18,17,1,97.3766396
e7ae8b7326f3a3dd8d0efd20ffcf533e5493b895,14,709,116,593,6,0,6,3,10,10,1,2,3.488468606,860,6,5,145,104,41,10082,7170,2912,66,41,25,99.67380224
2798555d67cac9fc3628e38a20b24b7740a07f99,2,73,74,1,0,0,0,2,12,69,1,2,0.871950473,184,430,5,34,33,1,1465,1472,7,14,14,0,99.93901199
cd19bd1d31acdd27b7a8de9c81d484c00999b93d,1,1,1,0,0,0,0,7,46,12,1,1,0,260,431,6,27,27,0,2224,2224,0,6,6,0,100
bf9b8e8ba7645f60fe6e4e89522e56f033bff0d9,4,11,7,4,0,0,0,3,13,67,1,2,1.877640283,170,432,7,22,22,0,1501,1456,45,18,18,0,100
f71908acc53c4988e85f03eed0556090fa11e62e,1,5,5,0,0,0,0,2,10,0,1,1,0,57,433,8,9,9,0,506,506,0,9,9,0,100
5dfbb0c5283fd2a9596e5c30e6fa49f4a5caf786,7,238,9,229,4,0,4,3,11,9,1,1,2.266786466,141,434,9,36,20,16,2196,1152,1044,28,15,13,99.81718464
12deb551775a682db0ea7cb687886d75cc31cb8b,0,0,0,0,0,0,0,0,0,0,0,0,0,0,7,5,0,0,0,0,0,0,0,0,0,100
74ab3098c996d3499e299a7adb55e81ed60a4a32,23,139,122,17,0,0,0,2,12,39,3,16,3.962471997,2584,435,10,422,424,2,20100,20140,40,216,217,1,99.89851837
5220c6f2a8b5dd0204d5c2263534eafb477fef1a,3,23,23,0,0,0,0,2,13,1,1,3,1.186392934,303,92,9,50,50,0,2566,2554,12,19,19,0,100
8e8c6e27a7cab08500df85a336033d82b5083ba8,1,3,3,0,0,0,0,1,2,2,1,1,0,56,436,11,9,9,0,485,485,0,9,9,0,99.95941558
e7f3d3e20113b337b976b43e1e28bc719749975f,0,0,0,0,0,0,0,0,0,0,0,0,0,0,14,0,0,0,0,0,0,0,0,0,0,100
e87e186a8af217058b57d81060fb8fb802911fda,0,0,0,0,0,0,0,0,0,0,0,0,0,0,15,1,0,0,0,0,0,0,0,0,0,100
a58444269456415255c83f2a13020a4c21671cf8,0,0,0,0,0,0,0,0,0,0,0,0,0,0,16,2,0,0,0,0,0,0,0,0,0,100
d8f384e5971a6f67f952ee008a9a75eaff71c4c1,0,0,0,0,0,0,0,0,0,0,0,0,0,0,17,3,0,0,0,0,0,0,0,0,0,100
c57cb54f95f58df6c7cb45144a529f414eb66b15,0,0,0,0,0,0,0,0,0,0,0,0,0,0,18,4,0,0,0,0,0,0,0,0,0,100
1a7b47aca1fdc8ce360bb96a44f6f91af33ae801,6,267,24,243,1,0,1,1,10,59,2,4,1.694100598,418,15,0,82,65,17,5234,3653,1581,39,32,7,99.2555332
12d0d2bee2f78680ff685415d0c1f5e4a13537ba,1,47,7,40,0,0,0,1,2,0,1,1,0,125,16,1,19,10,9,1499,1220,279,3,3,0,100
a1c2a058867a3fb1ae9cf0591471227f0219050d,1,9,3,6,0,0,0,1,3,0,1,1,0,155,17,2,20,19,1,1518,1499,19,3,3,0,100
d9d9948419868e9929f25132cc830936f2e2e34b,0,0,0,0,0,0,0,0,0,0,0,0,0,0,19,5,0,0,0,0,0,0,0,0,0,100
3dca4b59148654d617ad580a2ba7641a95d9d1a1,20,361,69,292,2,0,2,2,57,99,2,10,3.846429507,2864,437,10,520,486,34,22430,21380,1050,257,238,19,98.66693195
6872e91043f803099453c1f21345ef08d969f7f0,7,58,59,1,0,0,0,1,58,131,1,6,2.605830241,939,438,10,170,170,0,6928,6974,46,74,74,0,100
0b499309aa7072f7e007e1413d26a2f5b19df6d5,0,0,0,0,0,0,0,0,0,0,0,0,0,0,20,6,0,0,0,0,0,0,0,0,0,100
4226bec4d17550cb3358175b3a23059153ad700c,0,0,0,0,0,0,0,0,0,0,0,0,0,0,21,7,0,0,0,0,0,0,0,0,0,100
1b16a94949af5564cd35a530b06ded5f6234fc28,0,0,0,0,0,0,0,0,0,0,0,0,0,0,22,8,0,0,0,0,0,0,0,0,0,100
c0b74781eb165ff410e953d844da9c00dabac235,0,0,0,0,0,0,0,0,0,0,0,0,0,0,23,9,0,0,0,0,0,0,0,0,0,100
16e39847c982df48ee710dac8c620767192039c7,0,0,0,0,0,0,0,0,0,0,0,0,0,0,8,1,0,0,0,0,0,0,0,0,0,100
6eb3e85b64716c36fbba472a4e0a9b2cfd62fba1,1,1,1,0,0,0,0,2,16,113,1,1,0,54,439,9,4,4,0,508,508,0,2,2,0,100
d9d24d35952292a9fb4761676192ea7fa4a8fdc9,0,0,0,0,0,0,0,0,0,0,0,0,0,0,24,10,0,0,0,0,0,0,0,0,0,100
cd81660d4f5bdf536ababe20da0ed63272172be4,0,0,0,0,0,0,0,0,0,0,0,0,0,0,25,11,0,0,0,0,0,0,0,0,0,100
bd7d5540bf900f6d5e23e78ded0dea4a1171ad26,2,31,26,5,0,0,0,2,6,57,2,2,0.127418512,404,26,12,52,51,1,3280,3259,21,21,20,1,100
95b26428b0deb9e58991cc5efbf26b5275799706,1,1,1,0,0,0,0,2,5,115,1,1,0,27,440,3,2,2,0,251,249,2,2,2,0,100
ad32b57995762e36a26edb4ab43ef10d3df841a8,1,52,17,35,0,0,0,1,4,40,1,1,0,158,18,3,26,20,6,1742,1518,224,5,3,2,100
382f209783e3be32a6341fb6a8689b8843868fe8,4,68,0,68,0,0,0,2,9,120,1,1,1.997502546,658,441,4,172,160,12,3984,3550,434,122,118,4,100
37d97270e61ca93c0aa694789535bc893c2adf85,15,32,37,5,0,0,0,2,59,61,5,12,3.308519247,1713,442,5,289,289,0,14179,14281,102,104,104,0,100
5ec20d543d1ed8668396f4c57a152579ea997795,4,172,60,112,2,0,2,2,20,62,1,2,1.969560106,379,443,6,39,35,4,2984,2763,221,23,19,4,99.90093125
53d3cc8acccf0fea554d0a197f09207b22c1adec,1,1,1,0,0,0,0,2,6,7,1,1,0,27,444,7,2,2,0,253,251,2,2,2,0,100
2ebfee75b9e21e8819fe8782fe978dc3ad3b0539,1,3,1,2,0,0,0,4,17,133,1,1,0,70,445,8,4,3,1,740,732,8,2,2,0,100
bad696f525d524170087a01dadcdee0ff829d411,1,6,2,4,0,0,0,4,17,128,1,1,0,148,446,9,20,19,1,1304,1288,16,5,5,0,100
2bdf8e34206d8937c066bd6388d504cdc6ee8cef,3,7,4,3,0,0,0,2,18,88,1,3,1.494918848,192,447,10,28,27,1,1675,1650,25,8,8,0,100
b3a9c4f08c44f842f5efd0e2039682021889b4a3,1,9,1,8,0,0,0,2,4,129,1,1,0,54,448,11,11,11,0,445,384,61,4,4,0,100
b1376583d1bd4ec255080c4a92279a264dcbfb4b,5,26,48,22,0,0,0,2,18,70,2,5,1.304536311,360,449,12,29,32,3,3158,3284,126,15,17,2,100
f618163c42a65c18c30faf6f9cbb4801ce0da3d0,9,121,58,63,0,0,0,2,19,33,2,8,2.826614258,817,450,12,77,75,2,7206,7155,51,42,42,0,100
56a7423020a6f258afefbca5fb5cdbcbd2768ae1,2,128,101,27,0,0,0,2,20,99,1,2,0.523305613,576,451,13,93,91,2,4747,4543,204,15,14,1,100
34c48fe4f5c540153feb70c18aaf8e745e85cf00,4,13,14,1,0,0,0,2,19,27,1,3,1.912113891,246,452,14,40,38,2,2003,1988,15,15,15,0,100
a92b4ed0d24262b40beaa1c66d4fa0c4cd13d19e,5,0,346,346,0,0,0,3,11,140,1,1,2.136271582,130,453,15,0,20,20,0,1058,1058,0,12,12,99.76190476
477a95f84dac37242156a9a46c2a3e7088143916,10,13,13,0,0,0,0,2,20,6,2,8,3.085055103,960,454,15,88,88,0,8251,8296,45,48,48,0,99.92044551
3c36df26cc04affc269bb081740f81c1acd83950,3,21,8,13,0,0,0,1,21,0,1,3,1.113043276,247,455,16,22,22,0,2307,2307,0,10,10,0,100
03b916413c94c7e97e4176a278341b7b634ea554,1,6,8,2,0,0,0,2,11,142,1,1,0,73,456,17,14,16,2,465,472,7,7,7,0,100
ba43564e2f1b7bdddbd49bbba9a838b206c56860,1,3,2,1,0,0,0,2,4,142,1,1,0,24,457,18,2,1,1,240,230,10,1,1,0,100
100fc63108740d576f3fd68687955f1a422f45c2,6,129,26,103,1,0,1,3,22,46,1,2,2.321343036,353,458,19,58,45,13,3473,3028,445,26,18,8,99.96023857
3e150062d1511229a6fff47b1705498f036244d4,1,12,0,12,0,0,0,4,14,84,1,1,0,500,459,20,141,137,4,3562,3502,60,46,46,0,100
c9c9b5be0b3e24f31ba0ff950bd2746e4b65050b,2,63,41,22,0,0,0,6,20,107,2,2,0.137099479,186,58,0,16,14,2,2022,1961,61,7,6,1,100
9de8cc75b731823945df61201cf80b6387badfb6,1,0,9,9,0,0,0,2,3,89,1,1,0,75,460,21,8,8,0,752,831,79,3,3,0,100
5cef385e23a72350880c0d72d8f4cb2b9de5c20d,3,315,22,293,1,0,1,2,9,10,2,2,1.143190218,292,19,1,81,56,25,3916,2437,1479,29,18,11,99.96027016
306b4d04e304bb63b6a50cc17af229a3865a5ec6,11,22,224,202,0,0,0,2,11,158,1,8,2.716054299,2054,461,22,388,415,27,14216,15586,1370,103,107,4,100
775626f0a292f7d67313d271a1f50abb05967a67,2,50,5,45,0,0,0,2,12,0,1,2,0.756833632,291,462,23,63,57,6,2794,2372,422,21,21,0,100
4d434adfdc9c8742ce73ceee66c55b26920be4ad,16,1305,4,1301,14,0,14,1,10,0,1,4,3.58781112,67,463,24,123,14,109,6370,377,5993,84,14,70,96.54822335
60b60918451bcb914c44f5148bd38478e9fe86d2,3,3,15,12,0,0,0,1,2,0,1,1,1.392147224,86,464,25,19,21,2,462,577,115,16,16,0,100
dd8ed02c858a2195d89268addc225636426c7698,18,145,307,162,0,0,0,1,23,15,1,6,3.570654901,938,465,26,103,152,49,7381,11357,3976,55,72,17,99.5215311
a16ed788407400b1863dc5c9d9b707293a4ff133,13,89,93,4,0,0,0,1,14,11,1,5,3.236242718,687,466,27,93,80,13,5588,5366,222,60,51,9,99.79131886
1ac13fa7f87f6c81816b53f29d048df48a55bd25,18,309,390,81,2,0,2,1,24,0,1,4,3.459898012,863,467,28,105,127,22,6409,7469,1060,62,78,16,99.49832776
69f7b592116354a30de7db4fb9f979deafdfef4c,1,5,2,3,0,0,0,1,4,2,1,1,0,218,468,29,25,24,1,1811,1790,21,10,10,0,100
992f6b80321467d5114ff752b5aa31820a2d0d66,1,1,2,1,0,0,0,1,5,0,1,1,0,221,469,30,25,25,0,1808,1811,3,10,10,0,100
b148f217bbf19bf1f0d0d3d8536023d0c310aba1,10,23,11,12,0,0,0,3,22,128,2,9,3.296467165,1160,470,30,208,208,0,8474,8360,114,121,121,0,100
b7c7c42f726945eb4069887e50e1801171c6f4b3,1,1,6,5,0,0,0,2,12,12,1,1,0,71,471,31,14,14,0,421,465,44,7,7,0,100
34bf3badcffa171524cd343e81827134076b8911,0,0,0,0,0,0,0,0,0,0,0,0,0,0,27,3,0,0,0,0,0,0,0,0,0,100
7d41e5e404de9a5a8f85602be142b36c7d4fcae8,0,0,0,0,0,0,0,0,0,0,0,0,0,0,28,4,0,0,0,0,0,0,0,0,0,100
10b09ef1c72a2c5527387b2c3ef89119750c437b,0,0,0,0,0,0,0,0,0,0,0,0,0,0,29,5,0,0,0,0,0,0,0,0,0,100
71293910aea8e5ab3264c7f9b66180a5b67e75de,0,0,0,0,0,0,0,0,0,0,0,0,0,0,30,6,0,0,0,0,0,0,0,0,0,100
3bb27ad15a39f576711fe6d7f8233616b19f7650,0,0,0,0,0,0,0,0,0,0,0,0,0,0,31,7,0,0,0,0,0,0,0,0,0,100
9c61d6438182ca633bc69abd696b4ba43a0bd87b,0,0,0,0,0,0,0,0,0,0,0,0,0,0,32,8,0,0,0,0,0,0,0,0,0,100
c61b83c037090a238609a790f6b62fd6f2d8cb14,0,0,0,0,0,0,0,0,0,0,0,0,0,0,33,9,0,0,0,0,0,0,0,0,0,100
6cda6440aa16aeb4ccd66f58d2240158597c122a,0,0,0,0,0,0,0,0,0,0,0,0,0,0,34,10,0,0,0,0,0,0,0,0,0,100
d5c160bdcda99c85eec5b72f61a560cd50cfd707,0,0,0,0,0,0,0,0,0,0,0,0,0,0,35,11,0,0,0,0,0,0,0,0,0,100
6f12cb313e15eed63e5c5cb26c8c18ac726323ae,0,0,0,0,0,0,0,0,0,0,0,0,0,0,36,12,0,0,0,0,0,0,0,0,0,100
8b8b85aa0ae824b1a04e80076ae612ef27a5f1bf,6,73,47,26,1,0,1,2,21,57,1,4,2.129174851,337,472,32,59,59,0,2623,2513,110,24,23,1,99.95821145
22e5cce8c07082a3b1ef039bdd445edf5c508632,4,24,20,4,0,0,0,2,10,32,1,1,2,722,473,33,172,172,0,4008,3984,24,122,122,0,100
ca33bc32551eb20d6480cfb544092f5acd5b33cd,1,1,1,0,0,0,0,2,20,150,1,1,0,165,474,34,44,44,0,1282,1276,6,5,5,0,100
892fb11ea0ae7ef0bea23dd782410aacd59ba8f8,1,2,2,0,0,0,0,2,21,0,1,1,0,165,475,35,44,44,0,1287,1282,5,5,5,0,100
9891a79717e0463f5df8802789a7ef42bcc755e1,1,7,5,2,0,0,0,4,22,0,1,1,0,160,476,36,25,24,1,1367,1356,11,5,5,0,100
3a70a1066390b3e10c75799d915630f29a3e4126,10,363,97,266,1,0,1,1,23,77,2,5,2.702754063,1139,59,1,202,175,27,10548,9164,1384,130,112,18,96.87806794
c6ad3c2984b79faa707a80cfab14c5b81c7e30ba,1,0,0,0,0,0,0,1,1,0,1,1,0,247,60,2,24,24,0,2513,2513,0,24,24,0,99.92589848
994f73fdba06abfe7adde577d6d111fa4433356f,1,1,1,0,0,0,0,1,2,0,1,1,0,247,61,3,24,24,0,2513,2513,0,24,24,0,100
bc97f11b88e1465788cad6f9f629fcba4521557f,1,5,2,3,0,0,0,2,21,30,1,1,0,288,477,37,28,26,2,2063,2049,14,10,10,0,100
279c2bcc8015aaa1d192e01274d5066b496a39ac,0,0,0,0,0,0,0,0,0,0,0,0,0,0,37,10,0,0,0,0,0,0,0,0,0,100
3f973d6460fc0ec239d13b6ebfb1f7054f359fe2,0,0,0,0,0,0,0,0,0,0,0,0,0,0,38,11,0,0,0,0,0,0,0,0,0,100
20f2c1ec0d90d14b02f1f8c15e32667c496b8b31,0,0,0,0,0,0,0,0,0,0,0,0,0,0,39,12,0,0,0,0,0,0,0,0,0,100
6111d5ca30fbc93fa16c2198b5926777fd088921,0,0,0,0,0,0,0,0,0,0,0,0,0,0,40,13,0,0,0,0,0,0,0,0,0,100
edcbd3d58bae9c908c735eb91e19c8dfca9539a4,0,0,0,0,0,0,0,0,0,0,0,0,0,0,41,14,0,0,0,0,0,0,0,0,0,100
d2ab9478b80c36337b749754685a2137e35fef9d,0,0,0,0,0,0,0,0,0,0,0,0,0,0,42,15,0,0,0,0,0,0,0,0,0,100
b447d1cb8d116f68326f91947393b15262742005,0,0,0,0,0,0,0,0,0,0,0,0,0,0,43,16,0,0,0,0,0,0,0,0,0,100
40561f911879f3d914738ecb296d62258cb8a5fc,0,0,0,0,0,0,0,0,0,0,0,0,0,0,44,17,0,0,0,0,0,0,0,0,0,100
8438f10d3f8dd639850890ed994f86953a2d907d,0,0,0,0,0,0,0,0,0,0,0,0,0,0,45,18,0,0,0,0,0,0,0,0,0,100
005bb1e9b189f4a276e2d87ce1d255de3317a0f5,0,0,0,0,0,0,0,0,0,0,0,0,0,0,46,19,0,0,0,0,0,0,0,0,0,100
fb33e5adacee649660af6862ec06a755e17ed814,0,0,0,0,0,0,0,0,0,0,0,0,0,0,47,20,0,0,0,0,0,0,0,0,0,100
0db81653d8bb6c4775464c951ba6ce85ddbe9100,0,0,0,0,0,0,0,0,0,0,0,0,0,0,48,21,0,0,0,0,0,0,0,0,0,100
68a241f6dab3971c7c00b114307b2ffe5d3f97e3,1,0,1,1,0,0,0,2,3,113,1,1,0,194,478,33,51,51,0,1175,1175,0,27,27,0,100
2f55c85f23c6ef8829db225740f9d5f935cf500a,2,9,3,6,0,0,0,2,20,120,1,1,1,135,479,21,16,16,0,889,879,10,12,12,0,100
ae491e0cf2bde89565221b3490caba772987282b,0,0,0,0,0,0,0,0,0,0,0,0,0,0,9,0,0,0,0,0,0,0,0,0,0,100
6bed65ae0c31d50c5c7d58ac237cb6e9815ca253,0,0,0,0,0,0,0,0,0,0,0,0,0,0,10,1,0,0,0,0,0,0,0,0,0,100
ff3da8cd8522a90122b3ba833991e6f5d32717a6,45,173,156,17,0,0,0,3,44,118,6,35,5.060249263,6486,480,13,1065,1072,7,54422,54551,129,418,418,0,100
d1e33585986d4f199d06e4469fc204151c3cc091,0,0,0,0,0,0,0,0,0,0,0,0,0,0,49,22,0,0,0,0,0,0,0,0,0,100
5244107f93fd1339c3d8d3861e3028165f44eb55,1,6,3,3,0,0,0,2,6,98,1,1,0,136,481,11,34,33,1,899,891,8,17,17,0,100
b4d9cc8be1c7440bbfba8473ec1dd7feaf207daa,51,1461,1660,199,5,0,5,3,39,119,4,22,4.388276934,7776,482,10,1405,1509,104,61148,63722,2574,656,650,6,97.57199322
44ce35b3e71e795862f2ba6719fed45b2ab3e9bd,12,121,125,4,0,0,0,3,10,185,2,4,3.234797389,1763,483,11,447,459,12,14563,14302,261,204,206,2,100
9a47bc15ce60ac09df8a0470493fcb175258e9e8,44,1380,502,878,7,0,7,1,47,88,3,21,4.509812654,4951,62,3,790,701,89,49906,44436,5470,324,289,35,97.73386512
e6494ad3461266e9f7a86b1f37214a610698f621,0,0,0,0,0,0,0,0,0,0,0,0,0,0,50,13,0,0,0,0,0,0,0,0,0,100
fb7be38a0a27d5f0dfac48cbe150f1f479d1dc11,24,147,121,26,0,0,0,1,48,50,3,13,4.137867911,4004,63,1,544,542,2,36561,36380,181,240,238,2,100
680648282c980320eeb204db428a4b01e8cde68c,20,802,316,486,8,0,8,2,25,25,1,5,3.775469266,861,484,6,179,149,30,8715,6633,2082,103,76,27,96.5218896
b58c9e3473a4368e5a6dc5ac58dace0ca71feef0,2,16,27,11,0,0,0,1,8,490,1,2,0.884115122,210,485,6,22,24,2,1639,1697,58,20,20,0,100
6dd87dbab4623a4fa35f52c13ec979c791044e38,2,2,23,21,0,0,0,2,21,142,1,1,0.242292189,160,486,7,15,19,4,1220,1382,162,4,4,0,99.75664871
e9aaf30b941e696f7c0c5bf3c0b89007c4b02914,16,170,574,404,0,0,0,4,18,15,2,2,3.794390697,3519,487,8,743,783,40,24583,26531,1948,383,411,28,97.77087521
a496859f3623a36697175888f30e4af1a8e80b3b,21,407,1314,907,2,0,2,1,26,52,1,4,3.803523237,1666,488,9,147,222,75,7706,13295,5589,64,101,37,98.32391714
722355d56edd370827d15e7cfd974f76668256e3,17,708,350,358,1,0,1,1,46,15,3,9,2.697931633,2252,64,2,427,373,54,21995,19573,2422,167,153,14,99.88946205
28f38a05b24156652183f01ff9bcac5510291629,4,99,35,64,1,0,1,1,16,102,1,1,1.570725178,300,489,10,67,63,4,2307,2107,200,23,21,2,99.94473102
38a66416e9a1153f11c4e09f46c6377a387036a1,2,6,6,0,0,0,0,8,47,0,1,2,1,229,65,3,40,40,0,1602,1588,14,31,31,0,100
08a9bba83172802d3192c3a61be9705369c2fc0a,1,38,37,1,0,0,0,6,33,0,1,1,0,158,66,4,31,32,1,1037,1028,9,21,21,0,100
cba4ea758c612ebe9b4b056e82c89bb9de6091b4,3,3,3,0,0,0,0,1,10,0,1,1,1.584962501,71,490,11,16,16,0,563,563,0,9,9,0,100
2cea87aae8731be7b061c4030810b4032c491b2c,21,202,213,11,0,0,0,1,49,6,3,10,3.813139906,3361,67,5,470,466,4,30812,30592,220,142,142,0,97.70054415
124f28161b4e08867f5f7db3458675882da21ea2,2,29,16,13,0,0,0,3,5,237,1,2,0.836640742,58,491,12,14,12,2,635,564,71,8,7,1,100
1ad2373fc111098b95ea9d2717f9380628aed007,12,210,216,6,0,0,0,2,39,7,2,9,2.28434439,2310,68,6,346,345,1,20266,20174,92,135,135,0,96.57787643
2951ca4f74fcb3636baf57d5b3599f3aa1bdea61,27,686,1147,461,0,0,0,1,50,46,3,16,3.734552696,4403,69,7,549,552,3,39990,42286,2296,197,202,5,96.82290645
3aec9dc08ec9aa779de2c7058079f1c67021cb70,12,277,397,120,0,0,0,1,51,7,3,11,2.582390072,2022,70,8,228,230,2,20090,20582,492,74,77,3,99.90650711
5f29b068fe0956341b1232d11fda196b78fbead6,1,113,3,110,0,0,0,3,8,173,1,1,0,577,93,0,127,113,14,6150,5293,857,14,12,2,100
d8dbba553d3e79d5407310b11323db84a5866fb4,2,0,106,106,0,0,0,4,13,123,1,2,0.846561846,182,71,9,25,41,16,917,1362,445,10,18,8,99.86886474
4091520729308f48c95c0213dcc16942db593b03,1,23,11,12,0,0,0,3,11,19,1,1,0,80,492,10,15,13,2,710,619,91,3,3,0,100
16937e1fd3cbf15109ecc68a34e36b95df0a8d94,94,763,1055,292,1,0,1,3,52,106,4,52,5.883660972,12205,493,9,1571,1653,82,108893,110342,1449,677,693,16,99.73802395
2ea96a14bc5fc6a76f7d1db4cf9e70c4505f398c,1,7,3,4,0,0,0,4,27,25,1,1,0,133,494,10,14,13,1,1192,1166,26,3,3,0,100
cdb8e6d9c9e049ff9b16ee93e745d20f59ec3b00,15,586,166,420,6,0,6,1,6,35,1,4,3.719467838,524,495,11,103,56,47,5820,4262,1558,63,30,33,99.5526561
ae7e1a0040667767163631d012f24e986435f3fb,1,1,2,1,0,0,0,6,34,1,1,1,0,219,496,12,20,20,0,2428,2441,13,8,8,0,100
60c12f9e0fbe40e9dce58a6fa5e7c6c98d402957,10,161,195,34,0,0,0,4,27,29,1,9,2.941928587,1965,497,12,253,262,9,18071,18116,45,84,86,2,100
f4c378aa4211427ba0c1b3f7b2b861d4404b5b40,21,100,130,30,0,0,0,2,47,43,1,18,2.054966971,3078,498,13,479,480,1,27923,28195,272,173,173,0,100
355a5171cfc251b15fb6491851b52223a59fbbfb,11,47,46,1,0,0,0,4,33,78,1,9,3.123713758,1111,499,14,127,127,0,11309,11189,120,50,50,0,100
d9e9db0c32f9c89612af72095617cfcdbfaadc0b,1,6,6,0,0,0,0,3,19,1,1,1,0,189,500,15,14,14,0,1574,1570,4,5,5,0,100
059bc651196ac77a1b97ee95d001530365ba0df9,1,10,3,7,0,0,0,1,2,97,1,1,0,44,501,16,6,6,0,382,358,24,3,3,0,100
6d867a23552fd97d01263900069dd7b0cf0d3d56,4,27,0,27,0,0,0,3,19,28,1,1,1.974937501,689,502,17,166,166,0,4281,4281,0,104,104,0,100
f8516295afd8734badef7ffc1cf3049067d415a3,1,39,8,31,0,0,0,2,8,30,1,1,0,91,503,18,27,20,7,780,648,132,9,7,2,100
115bfeaa4004f065dcc531171c0d5ff810f8032e,29,157,133,24,0,0,0,1,28,46,1,7,4.607558663,1836,504,19,241,239,2,14762,14589,173,113,113,0,100
ae7df11dd9aaeccefcf0987a5bda711a89bcd972,22,949,100,849,14,0,14,1,8,0,1,4,4.228705193,530,505,20,115,72,43,7583,5257,2326,59,34,25,92.00463499
d13e2acaa45de3408231e8252820c30e958f4bab,0,0,0,0,0,0,0,0,0,0,0,0,0,0,72,8,0,0,0,0,0,0,0,0,0,100
01bdb8e60f696819e4298b3e45c0685b6e530580,0,0,0,0,0,0,0,0,0,0,0,0,0,0,73,9,0,0,0,0,0,0,0,0,0,100
ba3c70cde5315abc5c33926bfec4bbc7cea7a79b,1,1,1,0,0,0,0,2,6,13,1,1,0,45,506,20,2,2,0,403,403,0,2,2,0,100
e55e36da81c26e625ba64463d79f10a125182c8f,8,42,12,30,1,0,1,4,15,74,2,6,2.156091704,921,11,0,113,112,1,8407,8353,54,41,40,1,99.87954226
b4297270718a3f4dd3cbbafd3aca03b910016d95,3,114,76,38,0,0,0,3,13,3,1,1,1.068392036,252,507,20,41,33,8,2292,2056,236,8,7,1,99.97992774
babecbcc62a453961c7d4f305c3b8605b75ac09b,7,69,27,42,0,0,0,3,17,7,2,2,2.776974328,807,508,21,175,169,6,5776,5503,273,91,89,2,100
8b63e8fcf692af00384be5ae1aa646f105da2746,1,4,5,1,0,0,0,1,3,0,1,1,0,65,509,22,18,18,0,366,383,17,13,13,0,100
01ce805e5c923e4bfd04f5e7c41c7728d5848aab,3,423,20,403,2,0,2,1,9,3,1,2,1.444891988,111,510,23,88,27,61,3015,780,2235,27,9,18,99.89973932
c8f60cd566688992b044c4b97390543b9451e4bb,0,0,0,0,0,0,0,0,0,0,0,0,0,0,0,0,0,0,0,0,0,0,0,0,0,100
3d4bfb1e08e36491cfb04a54742131709988a659,7,116,126,10,0,0,0,6,35,14,2,7,1.919430902,932,74,9,74,71,3,10252,10201,51,32,32,0,99.34471803
06bc65709052fa88eebb07032cf3db0b2765f1d5,43,0,11262,11262,0,0,0,2,8,230,2,13,4.365979641,6765,51,0,0,1425,1425,0,46665,46665,0,476,476,90.78794902
ac6f7580a59d9a44ac8f919ffd75d1c98621aef3,1,9,8,1,0,0,0,8,53,25,1,1,0,252,12,1,29,29,0,2299,2292,7,6,6,0,100
e068ce739ad5857e15a6e65d22a1664e3ed79392,13,339,470,131,0,0,0,2,54,37,3,13,2.632269553,2167,75,3,215,217,2,21874,23031,1157,105,91,14,100
4097e10dcf621bcc12c69d209006a2add83fcd81,3,131,149,18,0,0,0,4,38,31,1,3,0.977616046,434,76,4,67,69,2,4136,4346,210,44,41,3,100
53369972e5337bf1a2dd23cd700fac87d125b37c,0,0,0,0,0,0,0,0,0,0,0,0,0,0,77,5,0,0,0,0,0,0,0,0,0,100
ed5ef48601e132b973a90168b3cdce5aac9eab0e,0,0,0,0,0,0,0,0,0,0,0,0,0,0,78,6,0,0,0,0,0,0,0,0,0,100
5b8274eb5f268798416d234e5105ba83a1675c80,2,2,8,6,0,0,0,4,28,130,1,2,0.721928095,519,79,7,91,91,0,4681,4713,32,28,28,0,100
5dde0ca5287cf6003a2948b5940119edda932012,0,0,0,0,0,0,0,0,0,0,0,0,0,0,13,2,0,0,0,0,0,0,0,0,0,100
530cfbfa496e29e3d939ede323fa4def2fe766d5,4,53,2,51,0,0,0,3,6,241,1,3,1.803409275,75,511,7,11,11,0,629,629,0,6,6,0,100
96d5647f79c723715fc1f276346a56b487268a81,9,38,27,11,0,0,0,5,37,58,3,8,2.737797862,1396,80,8,162,163,1,13377,13356,21,70,70,0,100
71ec577800d2700b46cbb7482577deb074e137e7,1,1,1,0,0,0,0,2,4,52,1,1,0,388,81,9,99,99,0,3558,3557,1,43,43,0,100
a7c50b83956774709a02ce56b023e60a73c04571,1,9,1,8,0,0,0,4,8,242,1,1,0,59,82,10,9,8,1,549,522,27,4,4,0,100
48332a4260d85693d84c07105e7dbefe835bff47,43,771,616,155,5,0,5,2,29,35,2,8,4.648242878,2426,512,5,385,358,27,18815,18218,597,215,188,27,99.375
1e7d5eec0f736d703a73228aecf3db50b9b3720e,0,0,0,0,0,0,0,0,0,0,0,0,0,0,94,0,0,0,0,0,0,0,0,0,0,100
4228fa47002df629b540b872daf0c03a88fb244e,0,0,0,0,0,0,0,0,0,0,0,0,0,0,95,1,0,0,0,0,0,0,0,0,0,100
00dc9346a4cbb936e0a6a564d5cd556e931cf4da,1,5,2,3,0,0,0,2,14,780,1,1,0,111,96,2,16,15,1,1020,1012,8,9,9,0,100
2e49d08ca4c49eda82eb68cf04563707e80d7476,0,0,0,0,0,0,0,0,0,0,0,0,0,0,97,3,0,0,0,0,0,0,0,0,0,100
7e14bc6d22fe6bf2916615b1f0722931711d68eb,0,0,0,0,0,0,0,0,0,0,0,0,0,0,98,4,0,0,0,0,0,0,0,0,0,100
0357f87ef42f892640f3c020980b34d5424f7ce8,3,4,4,0,0,0,0,3,10,274,1,2,1.5,93,99,5,9,9,0,943,891,52,4,4,0,100
de75a29fc4849dd5a700410aaa40674eaa724575,1,0,152,152,0,0,0,2,15,0,1,1,0,112,513,2,0,16,16,0,1020,1020,0,9,9,99.90533889
db9e80cf4be0694f76477736d02e6cf5b5290637,6,7,5,2,0,0,0,5,55,18,1,6,2.221251836,1100,83,8,116,116,0,10809,10819,10,37,37,0,100
0d4077c53a79a61bea50dc0bc139887fdfe672d8,0,0,0,0,0,0,0,0,0,0,0,0,0,0,100,6,0,0,0,0,0,0,0,0,0,100
95ab66ffc698968dfc7e8910e37d138f5ea2f243,42,625,782,157,0,0,0,2,30,17,2,10,4.756979597,2683,514,3,265,274,9,16760,17861,1101,101,115,14,99.82951317
c92666f3a7c0ea647fb94606f45ce9b108440a44,3,227,24,203,1,0,1,1,3,240,1,2,0.996596624,944,515,4,176,171,5,9264,6047,3217,34,31,3,99.96212121
4d270caf64e8aa53684ce637ac89824dc6efe6f4,1,1,1,0,0,0,0,1,2,5,1,1,0,68,516,5,14,14,0,260,260,0,11,11,0,100
c8fecd2f3dbbc092a8f61510ddc0204f05d9603c,1,24,21,3,0,0,0,4,6,59,1,1,0,124,338,0,38,38,0,1062,1062,0,6,6,0,100
e970c0bf3293730da363416e9251930a8bae88eb,1,0,0,0,0,0,0,1,1,0,1,1,0,154,339,1,19,19,0,1357,1357,0,9,9,0,99.92427111
891782dbb4005f0e158d1f155918c71cc14a0ec4,1,5,3,2,0,0,0,3,7,63,1,1,0,91,340,2,10,10,0,1004,1004,0,4,4,0,100
4ef4dc725dea6f8a9f1b3f72f3e82cd8254354ce,130,435,509,74,0,0,0,4,60,88,4,62,6.053401919,15357,517,6,2586,2590,4,117096,118166,1070,1051,1051,0,99.52687358
0e1fcf6cf220576c1ed87dca7663087815a76a21,0,0,0,0,0,0,0,0,0,0,0,0,0,0,518,7,0,0,0,0,0,0,0,0,0,100
48eac3d6ba656554da5274431505f60f1f796531,1,6,1,5,0,0,0,2,7,5,1,1,0,146,341,3,23,22,1,1246,1213,33,8,7,1,100
f824f90d5eb76383e5e38227958bc1b0388259ed,182,1388,1216,172,0,0,0,2,57,78,2,72,6.752435118,18626,519,8,3100,3096,4,146860,146910,50,1524,1514,10,97.09358651
aa861a5018495d48ddd16f95b4e715747db06fe4,1,1,1,0,0,0,0,5,13,22,1,1,0,179,14,1,21,21,0,1808,1816,8,2,2,0,100
3a1cc8a7de554d108f0fa5c61fcb9eeb43308d8d,2,13,16,3,0,0,0,2,8,305,1,1,0.992266639,13,520,9,0,0,0,131,131,0,0,0,0,100
7d55afa1222190ce01b893c3355e355e51b6840d,1,6,10,4,0,0,0,2,9,314,1,1,0,106,521,10,13,13,0,655,679,24,8,8,0,99.96027016
641a6993653e3f920724761ae504bd4428c9a06d,4,51,18,33,0,0,0,3,32,10,1,1,1.779878161,475,522,11,60,59,1,3608,3418,190,14,13,1,99.90065567
625ea72a7aea8e20f8f82665567a7b4d12672e4b,20,763,555,208,1,0,1,1,6,258,1,3,2.102270437,1064,0,0,121,119,2,14688,4848,9840,89,93,4,99.82103798
bf9e2556131bc8a4d00462691f716920121af9c8,16,203,52,151,0,0,0,2,25,120,1,7,3.36436671,1764,523,12,386,364,22,12360,11526,834,231,217,14,100
ad2817beb235f8f24b7e73feac2ad717346bcd6f,63,491,552,61,0,0,0,3,45,91,4,32,5.239085213,7981,524,13,1332,1336,4,62861,63240,379,533,532,1,99.80099502
db1208973c21061f2af548ec3407ff11656d9e37,6,9,0,9,0,0,0,5,15,9,3,4,2.281036113,829,15,1,92,91,1,7553,7507,46,32,32,0,100
2eb0fdea836e077efb5350d41edef797903b2ed2,0,0,0,0,0,0,0,0,0,0,0,0,0,0,525,14,0,0,0,0,0,0,0,0,0,100
69e9aa7bede6877cd792793c72c6a9b6b240eb20,5,20,23,3,0,0,0,3,5,156,3,5,2.221558853,643,1,1,146,146,0,4565,4582,17,64,64,0,100
9d5bf2d5e6bcfb4cea7eb259fbe73ca740584e31,1,2,0,2,0,0,0,4,61,32,1,1,0,423,526,14,99,99,0,2916,2908,8,30,30,0,100
5ce11fb7735a24894cc07e0c8545e98f29b90e11,14,412,301,111,0,0,0,5,33,45,2,11,2.409141808,1878,16,2,190,176,14,15357,15626,269,80,71,9,100
3a445f7fdedb0b025d1a311b22ed63e1fd1345be,2,33,66,33,0,0,0,1,2,82,1,2,0.99107606,239,527,14,42,55,13,2040,2085,45,17,18,1,100
db4c0c4a57f87671bdaccf9756cf97bf7378d209,22,366,273,93,3,0,3,4,42,121,3,9,3.716057307,1656,84,1,252,238,14,15117,14479,638,128,117,11,99.70220369
611e74f8207eec4f84f77cb9357c1b261c054885,1,13,11,2,0,0,0,1,3,1,1,1,0,64,528,15,15,15,0,506,508,2,9,9,0,100
b5707dda706b8e4be4c941f4bdc9fa06e7489116,11,315,332,17,0,0,0,6,41,37,2,5,2.934074252,1306,85,2,148,150,2,12223,12253,30,64,64,0,98.92473118
7c1f5dfc55524542aebbd9958793f36585f7380f,2,138,103,35,0,0,0,2,62,52,1,2,0.54210657,560,529,13,114,111,3,4173,3980,193,41,39,2,100
69ee3e552f9319f5fb6a8475ab55e80534146d8e,10,270,295,25,0,0,0,7,58,79,2,4,2.936175918,1326,86,2,169,171,2,11737,11664,73,53,53,0,99.85474165
964db4a8ae51fb0d896dcd03836c6056ff317898,7,260,260,0,0,0,0,6,35,52,1,2,2.704463026,1003,87,3,152,148,4,9142,8829,313,42,42,0,100
88c5af99ce20151ca2a8f4fb476db9db0f8a1708,2,15,3,12,0,0,0,3,12,8,1,2,0.650022422,222,44,0,25,23,2,1990,1940,50,17,16,1,100
fae0f2d40cbbf027c303bb130fc8b48596946890,12,244,431,187,0,0,0,5,35,132,2,3,3.259740804,1037,88,4,128,139,11,7848,8892,1044,46,51,5,96.70212766
0497f91ce4e03a7855d500cfad0dccddd2f61d21,13,74,106,32,0,0,0,3,34,14,2,10,3.385734877,1896,530,12,232,230,2,14917,15239,322,124,124,0,100
8fba6529a1a4beafe6e43bd8300f7a1594c5c14f,2,30,22,8,0,0,0,2,14,73,1,2,0.569961376,616,531,13,160,157,3,5066,4980,86,80,79,1,100
d99b6780a5c58ee7fd4c54b2a1caa763f76c28e1,4,360,26,334,2,0,2,1,20,109,1,4,1.487569436,206,532,14,53,23,30,3244,1682,1562,35,14,21,97.34929457
32f5f0940dabce67113be97b15a87cbb52e5ce5c,1,13,0,13,0,0,0,2,3,109,1,1,0,7,2,2,2,1,1,126,33,93,2,1,1,100
daa77420b2c5a83be1fca5d584c414e189f2a446,1,5,5,0,0,0,0,2,5,351,1,1,0,15,533,13,2,2,0,99,99,0,2,2,0,100
71850f26e96311afcf9d1029a62ac47d07cdf0d8,36,166,3629,3463,2,0,2,3,43,119,2,13,4.423673058,3272,534,9,174,460,286,11200,26833,15633,78,227,149,97.41156169
6cb5b69946c6ed51c53051656d78f2736aa7d8db,24,1044,734,310,2,0,2,3,23,143,1,8,4.102327259,1897,89,5,285,259,26,16421,15256,1165,115,107,8,96.09987619
a604dad3013fbce19c3f0ea63f8bbb27d945cf4f,1,12,0,12,0,0,0,1,2,1,1,1,0,58,535,10,8,7,1,452,355,97,7,6,1,100
7455cab2a8cc433836f800c25d0bc3628f87fccd,6,97,47,50,1,0,1,1,43,11,1,4,1.817123282,607,90,6,84,80,4,6022,5847,175,47,43,4,99.55735181
6be26c7f4a04d63be6d8831ca8501ed954970042,1,4,6,2,0,0,0,3,12,16,1,1,0,198,536,11,40,41,1,1566,1577,11,16,16,0,100
6ce1a40c38c7ed565093913fc64dad27af19cccd,7,577,8,569,5,0,5,1,15,11,1,2,2.625406276,444,537,12,87,36,51,5947,3413,2534,49,16,33,99.61404863
88652b9b2188d9df14c434663128d5b077617bba,2,5,2,3,0,0,0,4,63,159,1,2,0.985228136,453,538,12,105,105,0,3083,3065,18,35,35,0,100
2462a10ee707940b10a7fc602ffa2dfa958d0d7c,1,15,11,4,0,0,0,2,18,59,1,1,0,262,539,12,54,53,1,1842,1816,26,15,15,0,100
dcf2924e4f645dfc6048c48b3cdb973ee10474b4,13,293,10,283,1,0,1,1,64,129,1,5,3.036600617,2814,540,12,765,690,75,18625,17055,1570,360,345,15,99.92276501
f77d59d3d850cd43be4b5257378bd9cda747c767,3,45,30,15,0,0,0,2,29,0,1,2,1.448322687,440,541,13,90,90,0,3177,3213,36,38,38,0,100
639f2dee3e127c737f3e47c821b6238bcec9fd34,58,2710,2090,620,26,0,26,1,16,33,1,11,5.355023857,1705,542,8,239,203,36,15060,13017,2043,141,122,19,93.91673403
5d0f8fbc99042d55bd39bb5222769d51d2609565,1,2,1,1,0,0,0,4,65,18,1,1,0,429,543,9,100,100,0,2951,2947,4,30,30,0,100
f63257710f2caeb697f47522abe70b67296d4b2d,2,57,9,48,0,0,0,1,19,492,1,2,0.967294779,446,544,10,76,71,5,3555,3298,257,33,32,1,99.78844933
74735db0c1b9f01eb7fc39376e9de26278b3d5b6,1,1,1,0,0,0,0,2,10,403,1,1,0,69,101,0,9,9,0,564,556,8,3,3,0,100
1ec084c1bff93440ce33bd1460260b36373399a9,2,18,5,13,0,0,0,3,16,243,1,2,0.666578358,126,342,0,19,18,1,1056,899,157,9,9,0,99.64315701
95e5e49d678e9c9f90fb3877746bc2e93e293d57,1,8,1,7,0,0,0,3,9,133,1,1,0,157,343,1,17,16,1,1569,1533,36,8,8,0,100
45cebc427d31070ef01e9d660da10dea81f40604,95,329,596,267,0,0,0,1,59,75,1,41,5.766695777,10033,545,7,1621,1621,0,79204,79537,333,716,712,4,99.95822891
7097e25f0f864e6e708243191e2d5b78203ecbab,1,2,1,1,0,0,0,4,5,215,1,1,0,45,17,0,5,5,0,375,354,21,2,2,0,100
c40f860ad3b3526e882c84b7fa18e1752ae24ddc,2,43,9,34,0,0,0,5,35,86,1,1,0.569961376,281,546,7,34,28,6,2370,2157,213,6,6,0,99.93734336
59ce155dfe66a8611de87fdd0b035bbad40a130c,1,5,0,5,0,0,0,4,10,99,1,1,0,124,344,2,39,38,1,1106,1063,43,6,6,0,100
ecc4cc76e84a3ea80b28cbeba58e05f6e637bdab,2,17,4,13,0,0,0,3,17,14,1,2,0.791858353,143,345,3,20,19,1,1158,1056,102,9,9,0,100
5698bdd64e0c2107924d15f930497f7766682d19,1,1,1,0,0,0,0,4,17,100,1,1,0,123,346,4,14,14,0,1199,1199,0,3,3,0,100
508f7815fb67a6520bf4e4d7781d98a4b05dbc66,1,61,45,16,0,0,0,4,18,0,1,1,0,123,347,5,16,14,2,1347,1199,148,3,3,0,100
0acff21d032d4e12545b84cf2d0aa92b16500fb9,1,1,0,1,0,0,0,9,60,14,1,1,0,209,3,0,22,22,0,1744,1735,9,6,6,0,100
a7f82c97696625a5f0add0d2b22540141987ef29,32,999,1007,8,1,0,1,5,31,135,2,14,4.506547416,2948,91,0,383,378,5,25338,25525,187,117,119,2,99.36436334
44dbc4f2acb9c5ae6fc7ae481c18bddf187dc19e,2,0,0,0,0,0,0,1,1,0,1,1,0,121,92,1,19,10,9,938,516,422,8,4,4,99.83890455
97f9beb0ee587d0fa9843c3d1d79cfc5f5ad5f2b,9,289,243,46,0,0,0,3,50,41,2,8,2.598818112,1466,93,2,212,218,6,14857,15227,370,58,64,6,99.41283661
d701a675ff403aeca46f1268c7d12414ae49da92,5,103,91,12,0,0,0,4,17,19,1,2,1.644841608,456,18,1,43,44,1,4332,4450,118,17,15,2,99.93892508
cb4a14acebd7a8d0f5fb5b14b5abea4db218a47c,2,303,12,291,1,0,1,1,13,31,1,2,0.709046469,196,19,2,52,40,12,3179,1566,1613,19,16,3,99.95929996
644abbf6daecf009704964ac85c1bfa79f96331a,1,3,1,2,0,0,0,4,18,0,1,1,0,173,20,3,15,15,0,1455,1444,11,6,6,0,100
4f0ddbda9efb1b3e9dfbea9f2103cebd828e685d,14,41,56,15,0,0,0,1,45,47,1,6,2.938966141,1277,94,3,200,201,1,10689,10695,6,115,116,1,99.91863303
1a03fe87d166440650ab32cd60a2a407c42d5b8f,0,0,0,0,0,0,0,0,0,0,0,0,0,0,21,4,0,0,0,0,0,0,0,0,0,100
d3226b811fc8ce6b00fc6594e383df79251ba0eb,1,1,1,0,0,0,0,1,1,0,1,1,0,45,102,1,5,5,0,338,338,0,5,5,0,99.91863303
bedb0216ed3e4d50b247a3228d06bc4a57df0e8b,4,57,64,7,0,0,0,6,38,57,2,2,1.446171651,560,95,4,105,105,0,4680,4647,33,44,45,1,100
93a672ca0d1d7e0cb1cf53fcba9999c167830f50,21,1293,481,812,4,0,4,1,36,44,1,9,3.149195648,1517,547,5,230,183,47,15913,11326,4587,100,78,22,98.37563452
e7566a06a3d86782336eaeed7004630731b690a9,11,146,136,10,0,0,0,6,22,99,1,5,2.984771279,882,96,5,116,116,0,6706,6678,28,58,58,0,98.11545328
571a6e9a0117726b5d15f83d7bcd46ff0cc580a9,14,335,761,426,3,0,3,6,19,0,1,4,3.673729294,887,97,6,65,128,63,4232,7471,3239,31,56,25,93.61022364
c81292ec7522e829c85fed1df5ae17e4849d18f1,10,51,6,45,0,0,0,7,50,73,1,7,3.28360357,1132,98,7,214,206,8,7653,7523,130,155,147,8,100
6fa7225686f34c8f77e843e115e2bda08f70996b,1,8,2,6,0,0,0,4,12,441,1,1,0,61,4,1,7,6,1,738,689,49,2,2,0,100
f798e278b2589dea5f79c43d653beb65dfe88913,4,145,16,129,0,0,0,5,18,180,1,2,1.427554412,1175,5,2,218,205,13,9821,9080,741,114,109,5,100
1084b172cadd9f83860c8e9682af5a3703939cac,2,5,5,0,0,0,0,4,15,50,1,2,0.721928095,357,548,6,72,72,0,3238,3238,0,41,41,0,100
4799a594388ac2fd70c417b736f0f8542ee32409,4,73,28,45,1,0,1,1,18,16,1,3,1.604753895,602,549,6,55,52,3,5192,5046,146,25,23,2,99.91794872
0971a5397dd848f5ca34e9e65e6addefd2b7fd3f,1,12,12,0,0,0,0,6,22,79,1,1,0,145,22,5,11,11,0,1264,1264,0,3,3,0,100
2b4f74cd17260e67093e77047814160634a53392,7,18,9,9,0,0,0,5,61,44,2,7,1.958229169,1083,99,8,94,94,0,9457,9376,81,37,37,0,100
ab87ea2805946b5e3c5d380b10b57bf7d11e84bd,2,21,5,16,0,0,0,2,46,192,1,2,0.961236605,781,550,5,129,125,4,5044,4951,93,57,57,0,100
0ffe1b1fd3da1ba87b1c4957907ee5d3a3e2fbda,1,0,1,1,0,0,0,2,47,0,1,1,0,649,551,6,92,92,0,4091,4096,5,40,40,0,100
a14c9cb094b7b5745ecd82110fc759c6466d41c0,21,1577,1234,343,1,0,1,2,62,49,3,20,3.648872696,4221,100,9,519,507,12,41123,41168,45,200,190,10,93.52874001
808ea0425edd408293700054706052ecb6865985,5,40,24,16,0,0,0,3,39,99,3,4,0.711332331,795,101,10,98,97,1,7460,7242,218,34,33,1,100
4a734131d3b064b1821a3bb25c0346e0bc30d145,4,18,35,17,0,0,0,5,48,0,1,4,1.820295192,917,102,11,85,85,0,7210,7727,517,35,35,0,100
a3f65c88044dd3d8bbb94e84cf32ca44562d2469,8,294,35,259,3,0,3,1,7,282,1,5,2.313049057,154,552,6,41,19,22,2196,1071,1125,25,13,12,97.38015608
a69d7b38727078309a3d630def4ee2f87337a19e,22,468,534,66,0,0,0,4,63,4,3,21,3.72160204,4647,103,12,601,602,1,41052,42213,1161,227,219,8,99.98053717
cfdebc84619d3df3cf52bca79dab98269d4e8899,7,342,157,185,1,0,1,1,5,378,1,4,2.444393888,1326,6,2,252,237,15,9841,8752,1089,66,63,3,99.92219413
5a5a0c48342577696ba72d84ae41bb3d640d187f,2,292,0,292,2,0,2,1,1,0,1,2,0.98642108,0,7,3,40,0,40,1467,0,1467,16,0,16,99.9028749
f7dd64cedc905f6941bdb3bd794140d070d6d893,23,1427,618,809,0,0,0,2,64,15,3,15,3.483323526,3587,104,9,462,417,45,36365,32667,3698,209,187,22,100
f41456bf87a9852ad18a3a97d1494fe3336f31c5,1,11,10,1,0,0,0,1,2,1,1,1,0,101,8,4,14,14,0,676,750,74,7,7,0,100
d01c26a4b7e2845668bc0873aa9f95137cdd5c95,15,1233,248,985,0,0,0,2,65,12,3,11,3.135959776,2809,105,9,457,372,85,30248,24866,5382,148,121,27,96.07403253
a69d070e85313ea33c91fe9eed72e9e23bba6822,5,1267,0,1267,5,0,5,1,1,0,2,4,1.820445605,0,23,1,198,0,198,8399,0,8399,39,0,39,95.45122397
5a06fc07904e6770abc315e7640d284598f18307,8,15,3,12,0,0,0,5,39,43,3,7,2.591793226,1280,24,2,118,118,0,10743,10653,90,46,46,0,100
f7a66839cbf2b2531699d326a855a4d84564a233,1,1,0,1,0,0,0,5,16,0,1,1,0,193,25,3,19,19,0,1596,1587,9,5,5,0,100
b64eb1cc7459f94a0140304e658e6faf97191b7f,4,5,0,5,0,0,0,6,23,92,2,4,1.921928095,455,26,4,46,46,0,4249,4213,36,22,22,0,100
b7ef42cb0afc1ecc8ca280e10c6d84be4e1d42f3,1,1,0,1,0,0,0,5,34,12,1,1,0,271,27,5,50,50,0,2154,2150,4,19,19,0,100
b3ba49c381d8fb155b887d4eb89c828b8c0bd722,49,972,1197,225,3,0,3,2,66,51,3,14,4.63124168,6704,106,7,949,970,21,56893,56589,304,439,457,18,99.42677515
5a986a3cf882927eb65f59066161989c97ab5f36,1,9,1,8,0,0,0,4,13,39,1,1,0,83,9,5,10,7,3,790,738,52,2,2,0,100
91456bb2aab251b8512b41b48726fe0550d25cfa,44,5089,336,4753,42,0,42,1,5,0,3,9,4.937803861,655,10,5,523,107,416,26555,4068,22487,226,20,206,88.86722558
f4c8f73fce2f184612db3a837a180c9c2689b889,44,336,5089,4753,0,0,0,1,6,0,3,9,4.937803861,4030,11,6,107,523,416,4068,26555,22487,20,226,206,88.86722558
1d47b6f7b71812bba4ef8dd2ba09410dade0d063,8,334,175,159,2,0,2,1,7,142,1,4,2.536988718,1539,12,6,284,263,21,11685,9875,1810,65,58,7,99.88927846
622a9045889e73beaaad1d23d7e7dc63fefe7780,12,453,24,429,7,0,7,1,26,93,1,6,3.245197059,781,553,1,168,152,16,7795,5680,2115,93,80,13,99.2706054
5eb9b167bdaf83b2199e42e0b30576c6160629ec,1,6,1,5,0,0,0,2,16,177,1,1,0,89,554,2,16,16,0,751,751,0,11,11,0,100
c09306664f27c222f21c1528bb65848cc676dcd3,7,259,68,191,0,0,0,4,19,241,2,3,1.994417052,2192,13,7,563,539,24,18309,17119,1190,235,220,15,100
a6f25769c57d27be81ff030704fdff22071790f3,3,253,0,253,3,0,3,1,1,0,1,2,1.211490423,0,14,8,21,0,21,758,0,758,16,0,16,98.24686941
5deeadd52fd9d781619c96fe1d93df666f2a8109,1,21,2,19,0,0,0,3,15,166,1,1,0,232,45,0,64,60,4,1579,1450,129,37,36,1,100
4b8c14bdb7c5efe3f97aedb485233d6669da5a97,1,1,1,0,0,0,0,2,11,105,1,1,0,250,46,1,48,48,0,1515,1515,0,29,29,0,100
f30de5ca80829958171b3102f678ed831eaa46fe,13,528,13,515,4,0,4,1,15,232,1,6,2.850468639,494,28,0,108,42,66,7279,4497,2782,34,16,18,99.75164094
3fb713293baa218477bda020daa9f867f70dd4fb,5,97,106,9,0,0,0,2,37,122,1,3,2.28261494,680,29,1,87,89,2,5059,5220,161,20,19,1,97.47299029
25d94c3e7ff7c37b5ec65f476c331ce92f39988b,0,0,0,0,0,0,0,0,0,0,0,0,0,0,30,2,0,0,0,0,0,0,0,0,0,100
d9b6358bb1f0730038e3683552b2d3812cbd22ec,44,223,437,214,0,0,0,1,67,107,1,24,4.173041771,5662,555,2,887,893,6,42904,42986,82,415,421,6,100
2dbcb6df9e0ee6db81ba82e35fa2e2de6763e405,2,4,5,1,0,0,0,2,53,0,1,2,0.503258335,296,556,3,41,41,0,2025,2039,14,25,25,0,100
0a8908e73d282173a713fd2d1f81e80fe0edfc05,1,12,29,17,0,0,0,3,23,224,1,1,0,63,557,4,11,10,1,470,449,21,7,7,0,100
d07a964f1fbe4923ab2cec1775eab85a9f3437ce,3,8,6,2,0,0,0,4,11,228,1,2,1.577406283,93,31,3,9,9,0,958,943,15,4,4,0,100
0ead4c80b56f9f96c8f3f07b2dc95f2eeef98a55,3,14,8,6,0,0,0,4,12,0,1,2,1.435371391,94,32,4,9,9,0,975,958,17,4,4,0,100
aa84f9b8135fce4dc0131c01e6e04f86a496114c,2,38,5,33,0,0,0,5,20,60,1,2,0.952265625,1095,15,2,179,174,5,8937,8691,246,71,70,1,100
2b14be2eb134d16be0cf20704af38122a3f68232,4,418,3,415,2,0,2,1,5,100,1,2,1.067438375,46,16,3,49,11,38,2899,383,2516,18,4,14,98.70276368
29af4d71dcaa2d95a492d5676fb6dc7a75e4fac5,14,191,219,28,0,0,0,2,16,332,2,7,3.159030998,2878,17,4,594,593,1,22235,22240,5,165,165,0,99.90662932
8a4161be2d63acc80cacf990aadface9134a84f0,3,28,13,15,0,0,0,1,38,39,1,2,1.221104104,285,558,5,28,27,1,2278,2138,140,9,8,1,99.66279505
f5f286e074aafb513ae51bf8a06cb0398cc739e9,2,2,2,0,0,0,0,3,8,0,1,1,1,449,47,2,113,113,0,3956,3952,4,51,51,0,100
f85173cbdefb26974165b4f229006d4b35e2f739,1,1,1,0,0,0,0,4,8,0,1,1,0,78,48,3,18,18,0,533,531,2,9,9,0,100
024261a3f609d4d40f090369d80fd1cda3d5ef9e,84,456,662,206,0,0,0,5,43,166,2,39,5.5919806,8719,559,6,1155,1171,16,71252,72428,1176,427,423,4,99.83041266
bfa4da7277221d064cb00ba3af370171fef72caa,6,94,7,87,0,0,0,1,39,73,1,4,1.97972728,1228,560,7,126,118,8,11425,10811,614,46,43,3,98.63418236
6de4710d460494ed9d4ab20766f93c609373844c,14,492,239,253,0,0,0,2,66,269,2,7,2.54029951,2544,561,8,490,463,27,18004,17100,904,218,206,12,100
dda346445586dc52ea4a7f2888d2c09da7f05e5b,1,9,7,2,0,0,0,2,4,0,1,1,0,94,562,9,11,11,0,622,621,1,5,5,0,100
b0d9fb594cc3619a4644709e91baf95d569c229d,2,2,11,9,0,0,0,1,5,52,1,1,0.779349837,333,563,10,52,53,1,2405,2461,56,26,27,1,96.38356164
a492d4a7c60712e003f25752d84e7ed4a8eb4cc4,0,0,0,0,0,0,0,0,0,0,0,0,0,0,564,11,0,0,0,0,0,0,0,0,0,100
d9a3043b0459271e7bebee3ad9a0033e537acfe6,2,837,0,837,2,0,2,1,1,0,1,2,0.864470605,0,33,5,108,0,108,3980,0,3980,42,0,42,99.88913525
aec18185d718dc04d4c5e53ddb3cc3e5825db386,61,364,454,90,0,0,0,2,21,357,1,14,5.064061483,13960,565,10,3095,3099,4,101289,101825,536,913,913,0,100
719772b4d8ce5d160f12048f2f2c0382ae63d078,2,479,499,20,0,0,0,3,3,343,1,1,0.997799734,1010,18,5,108,108,0,6579,6700,121,29,29,0,100
e67810fed1958e7dd966539bdbcc9c3c6fa72bfe,1,1,1,0,0,0,0,6,40,3,1,1,0,245,0,0,19,19,0,1948,1948,0,3,3,0,100
611d287e8da9e5023a0bea99a66b50734a6d6027,1,130,127,3,0,0,0,3,7,1,1,1,0,401,19,6,74,74,0,2422,2454,32,20,20,0,100
bb9ed914abc456aba8fc14af5ab03edcc017fb9b,1,79,82,3,0,0,0,3,6,1,1,1,0,376,20,7,88,88,0,3010,3078,68,10,10,0,100
803b893527b56f5dcbe4316a3e51daf05f08de50,1,10,0,10,0,0,0,4,67,6,1,1,0,466,566,11,113,111,2,3271,3239,32,36,34,2,100
555f1f636b608d7d72ad79ad91f56f29d3c6dc43,1,318,367,49,0,0,0,5,10,5,1,1,0,723,21,8,204,205,1,5069,5258,189,42,42,0,100
dca7cbbd88b5f53ae435b6a32653898221150af5,1,130,145,15,0,0,0,3,4,5,1,1,0,341,22,9,63,63,0,2409,2423,14,8,8,0,100
078cde25dd55be6a57476ed438bb21d4f64dbfcf,1,65,67,2,0,0,0,3,10,5,1,1,0,546,23,10,95,95,0,3520,3546,26,11,11,0,100
4c96b79ae7196ba48c36c8ae59018f061b91e9ee,2,210,0,210,2,0,2,1,1,0,1,1,0.822404226,0,24,11,13,0,13,566,0,566,6,0,6,96.71825471
0c98400219fa906e1daf9e49fc35fc8d080df1e3,1,1,1,0,0,0,0,6,20,119,1,1,0,137,1,1,16,16,0,1305,1305,0,3,3,0,100
bd927c9fa965fcdca99cc0f525b3f3e439fbbe66,29,2819,0,2819,29,0,29,1,3,48,2,6,4.516142734,0,25,12,245,0,245,12705,0,12705,143,0,143,88.8574889
4f16e3cbfee813278904f38b50011b4ea4f90bc4,0,0,0,0,0,0,0,0,0,0,0,0,0,0,26,13,0,0,0,0,0,0,0,0,0,100
d17537375235e0124eeb5ce7de5d3818c39113a3,2,8,1,7,0,0,0,1,2,0,1,2,0.99107606,122,27,14,18,17,1,973,925,48,6,5,1,100
b1dd03663c549c191d2aa61b80f0af5e5978d542,23,195,135,60,0,0,0,1,4,0,1,4,2.87838294,1518,28,13,196,195,1,9142,14144,5002,116,112,4,98.82685205
a179dc4d2e98b819e992d36ae6bf2b6563d705af,4,50,6,44,0,0,0,1,5,0,1,1,1.987442359,384,29,14,83,77,6,2582,2337,245,52,49,3,99.8483864
79eb25360468283e525e6730a6f52b31008dd29f,0,0,0,0,0,0,0,0,0,0,0,0,0,0,30,15,0,0,0,0,0,0,0,0,0,100
515bac41819e209190a53c8f6b1de1db25dee575,164,1304,4011,2707,0,0,0,4,68,144,4,73,5.497529278,28463,567,12,5248,5531,283,213873,224210,10337,1960,2038,78,99.52329361
4a711cfb5c37680a6d606aec658fed1381b6180f,1,0,132,132,0,0,0,5,26,0,1,1,0,72,107,0,0,13,13,0,440,440,0,13,13,97.16961056
11b9d84cf2b148c97420ca0ca899cb1cec2ed354,6,33,35,2,0,0,0,6,69,9,1,6,2.391480833,2066,108,1,193,193,0,15546,15594,48,72,72,0,100
fedfd0cbb41f0e28cf59d10e4178bbd273be4ef8,2,5,0,5,0,0,0,1,2,0,1,1,0.970950594,136,31,16,9,9,0,1166,1126,40,6,6,0,100
f13030431a0c1ab2a9ce434a932a96104108000e,11,314,320,6,3,0,3,2,41,24,1,7,3.193079834,1121,2,2,113,118,5,9165,9191,26,42,46,4,99.66652772
f443e7f5dc9263766ae2202334437e5ef82a7d4a,2,14,8,6,0,0,0,3,42,0,1,2,1,379,3,3,27,27,0,3149,3131,18,5,5,0,100
70fa8025a59acb5fb90fb6c0195a8b94e11cf8a1,22,250,208,42,0,0,0,2,12,81,2,11,3.743189552,2521,568,13,426,423,3,22541,22232,309,149,147,2,99.85407546
13c4f5083258b848dbd74ff38b44f8f67ccd24a1,0,0,0,0,0,0,0,0,0,0,0,0,0,0,34,6,0,0,0,0,0,0,0,0,0,100
81f2e6b500fa68a3c944d19a7bdde025159f98e5,4,6,3,3,0,0,0,5,13,0,2,3,1.974937501,851,32,17,217,217,0,6335,6331,4,51,51,0,100
75613c4e6646dbaa810abd434b42b082a8306d90,1,0,1,1,0,0,0,5,14,0,1,1,0,676,33,18,204,204,0,5020,5027,7,42,42,0,100
721d1fe2b238870b85745ee5fbc0601f152f763b,1,7,0,7,0,0,0,1,3,3,1,1,0,44,34,19,8,8,0,363,363,0,4,4,0,100
292bb9dcc3cc8d4a6b0f311c6d0afb7232d4b9c8,5,439,0,439,5,0,5,1,1,0,1,2,1.971096667,0,35,20,43,0,43,1934,0,1934,25,0,25,99.77097647
adcc8ada4e2f4d028f53c3dc8210ecdede323a27,2,5,0,5,0,0,0,2,5,0,1,1,0.970950594,137,36,21,9,9,0,1149,1119,30,6,6,0,100
4af55522253a9f5d0b25923b4f72ab3e13fbb88b,1,2,2,0,0,0,0,2,6,0,1,1,0,51,37,22,2,2,0,326,328,2,2,2,0,100
4b66c38229fcb479a44bc67bd38d51f0dddef2ee,1,2,2,0,0,0,0,1,2,0,1,1,0,34,38,23,4,4,0,235,234,1,1,1,0,100
2d40bd6ebeca444f414775e4456275ad5e11044e,1,0,2,2,0,0,0,1,2,0,1,1,0,102,39,24,15,15,0,782,812,30,5,5,0,100
03424784c070b28b3e6ec3fcc1fab1163d1decf3,50,738,584,154,3,0,3,2,70,34,3,20,4.888589089,6958,109,2,949,929,20,61169,59861,1308,447,430,17,96.92854158
3bc895ff8672f6f3d00f34a5a66385fad3f7d96a,2,12,3,9,0,0,0,1,3,0,1,2,0.836640742,134,40,25,20,19,1,1054,1017,37,7,6,1,100
a351fdf2624f25acbdbde1c338551e5f74458e31,4,61,15,46,1,0,1,1,5,2,1,2,1.6100375,291,41,26,67,60,7,2116,1828,288,47,41,6,97.42839222
115fec691bb1c36047ea24e79bce5befb449c78d,2,117,5,112,1,0,1,1,2,0,1,2,0.955931264,3,42,27,14,0,14,816,14,802,5,0,5,97.41774261
4b25f31b1c616ca86438e0690c5f411c852f2156,13,556,177,379,3,0,3,1,7,0,1,5,2.977396136,694,43,28,174,128,46,6333,4613,1720,102,82,20,97.17431955
ae086da2e70abb2c89d17f9bd9f8d5343b9cbaaa,1,1,1,0,0,0,0,1,2,0,1,1,0,101,44,29,21,21,0,1019,1013,6,3,3,0,100
ec393c0090f12d8ddc93b3934efe0a5dbd754281,1,6,2,4,0,0,0,1,4,0,1,1,0,107,45,30,25,23,2,771,751,20,17,17,0,100
090e1886c7468c87796f92b4a6d021218e8dcd6d,1,1,1,0,0,0,0,1,5,0,1,1,0,111,46,31,25,25,0,771,771,0,17,17,0,100
fed7d6133df15b27c2d210a784f4a0cbea7c9dda,40,636,426,210,3,0,3,3,54,26,3,8,4.21708207,3970,110,3,551,526,25,33115,32177,938,341,325,16,99.64759536
c7435d3f96caaa1cdd857d608cbc44d50a44193b,1,82,0,82,1,0,1,1,1,0,1,1,0,0,47,32,7,0,7,312,0,312,6,0,6,99.95850622
407cfd34e013919fc5bf975fd20c1b29f18b9416,2,70,53,17,0,0,0,1,3,2,1,1,0.695136099,133,48,33,22,22,0,846,783,63,15,16,1,100
d3ace90fb457097c769ba996cb845395ff628d01,2,35,6,29,0,0,0,1,3,2,1,2,0.281193796,246,49,34,53,49,4,2048,1964,84,27,23,4,100
489a1c27f13e384b973499498902605d60ee280a,1,1,1,0,0,0,0,1,6,1,1,1,0,111,50,35,25,25,0,771,771,0,17,17,0,100
555cc737089c6d6be5d390a0928464d28bee4cef,25,571,418,153,2,0,2,3,55,0,3,9,3.709759087,3050,111,4,386,363,23,28125,25145,2980,242,222,20,97.77960526
b9469ab3e6d65575357c68cddc4e0ca889b51ccf,6,70,77,7,0,0,0,6,34,0,2,5,2.169663474,727,112,5,101,103,2,6220,6114,106,60,61,1,97.57358791
e2fa1e0b2f8736072c879c6bde722125d759d91a,1,2,0,2,0,0,0,4,68,20,1,1,0,474,569,14,113,113,0,3279,3271,8,36,36,0,100
f13833ee202321d2121f2f26cd27e7f3289046f1,1,12,8,4,0,0,0,4,11,29,1,1,0,15,35,6,3,2,1,153,119,34,1,1,0,100
20fbf4d2216b0c0dc8abd4ae7df4e4cacb3e2c25,1,1,2,1,0,0,0,4,25,170,1,1,0,187,348,0,22,22,0,1656,1661,5,9,9,0,100
34d576e43ada185f877e118663ca28cffb0991ba,0,0,0,0,0,0,0,0,0,0,0,0,0,0,51,33,0,0,0,0,0,0,0,0,0,100
7aa6232663fa2ad6d4b2ec536bed27097b3e1c6b,5,1011,0,1011,5,0,5,1,3,105,2,2,2.122844809,0,52,33,110,0,110,5124,0,5124,49,0,49,98.83040936
d84e4c0afad28a72a4d5505b8d3dc12e0454bab0,3,11,10,1,0,0,0,1,4,9,1,3,0.453716339,211,53,32,38,25,13,1836,1611,225,9,5,4,99.85326486
52bbdd2d32ee2440f7884b95a10a85ee5c9172ac,1,9,9,0,0,0,0,4,15,35,1,1,0,118,349,1,13,13,0,943,942,1,11,11,0,100
6fca24e9cfd2baef20e2c6fb3b15cc331e458056,7,56,36,20,0,0,0,5,15,30,2,5,1.887110631,1175,570,3,290,290,0,8353,8298,55,97,97,0,100
c1a418840ba418ac6691d398ab7f3f65752f6f3f,47,458,417,41,0,0,0,3,71,137,4,37,4.431170661,6908,571,4,909,916,7,59678,59853,175,387,390,3,99.8349835
5528154cb7636e474428d77639b8286ccf29ca33,1,17,10,7,0,0,0,2,4,0,1,1,0,46,54,26,7,5,2,323,243,80,6,4,2,100
d457f73f1b2fd165c574213523b0e323ee54795a,2,75,19,56,1,0,1,1,5,0,1,2,0.973385435,51,55,27,8,7,1,626,323,303,7,6,1,99.90840813
669b7ed603312b6bfafa3c7372f7c8c378f06f15,1,6,3,3,0,0,0,2,6,0,1,1,0,51,56,28,8,7,1,345,327,18,6,6,0,100
c96fa1426e231d48b8e45cc84a862920f9173784,9,157,52,105,0,0,0,1,7,23,1,2,2.777429412,442,57,29,73,56,17,3062,2340,722,56,40,16,99.92683373
7c6f529b41ad78f6a37107372a7331644cf2aedf,6,58,39,19,0,0,0,1,8,0,1,2,1.991754147,387,58,30,60,55,5,2539,2409,130,43,40,3,100
f02c4bc7ed3b8dbff4864949b3370abf54f34428,8,64,54,10,0,0,0,2,9,0,1,1,2.556128554,471,59,31,72,75,3,2565,2652,87,53,56,3,100
cce95dafcb40da1d0163a1ca1e01f8630cf3343d,2,5,5,0,0,0,0,2,6,18,1,2,0.721928095,119,60,32,8,8,0,863,856,7,8,8,0,100
a8b77cbd6b9676ed3ec21957e4c901654e54bd02,1,5,3,2,0,0,0,2,10,0,1,1,0,58,61,33,10,10,0,357,348,9,7,7,0,100
913d44d9a87032b24b33b29d443ff0d26ab4adf0,7,280,50,230,0,0,0,1,8,21,1,3,2.342464255,778,62,30,214,157,57,5961,5138,823,151,94,57,100
a704e1731bd11c63cc4de416073a97b54ccb9fa2,3,565,0,565,2,0,2,1,5,2,1,2,1.108742578,99,63,31,75,21,54,5372,1000,4372,37,3,34,99.79901334
1bc1c14590ba8cac8eb7d2f92a46f5f400e04f73,2,126,26,100,1,0,1,1,2,387,1,2,0.963600478,49,64,24,21,10,11,792,260,532,13,8,5,99.94521549
0bff67012bf4fcb83a5c47d1cc07a953d512a9f3,6,238,56,182,2,0,2,1,6,153,1,2,2.130385042,238,65,25,53,41,12,2622,1415,1207,30,28,2,99.90879241
f747b5132626acbb320b5a384485693d522e3d2b,1,1,1,0,0,0,0,1,6,3,1,1,0,115,66,26,21,21,0,1000,1000,0,3,3,0,100
22726e80d48f13e5f46ba3a0f9576e407bb7c466,40,300,308,8,0,0,0,1,8,198,3,10,4.714688936,5622,67,27,1103,1115,12,40258,39967,291,346,364,18,99.63483659
018a14c838427581ad2126e601c470ead811b984,9,40,12,28,0,0,0,1,8,12,1,2,2.886733953,859,68,28,152,148,4,5862,5792,70,50,46,4,99.87200585
d32f30aa0ca389f31b48067381061636e27cb5ea,1,1,2,1,0,0,0,1,3,0,1,1,0,66,69,29,6,6,0,486,503,17,4,4,0,99.96343693
1ead75a2ca54aae059619e9b0c033533fdda4ef2,1,1,2,1,0,0,0,1,4,0,1,1,0,84,70,30,13,13,0,667,684,17,7,7,0,99.94514536
c0c8d9f64563d092506407f49addff96846a04cb,79,458,11658,11200,0,0,0,4,47,176,4,27,5.178576396,13697,572,3,1627,2821,1194,59912,100316,40404,526,939,413,89.61216137
ff79ff48c3a7228dc7ea89f917b2e9db87048728,222,2780,2245,535,2,0,2,5,57,298,4,68,6.823665687,19793,573,4,2273,2376,103,189448,188349,1099,1219,1237,18,93.97541809
ed18cb307e2df855efc1d6c5ffcb03251f94bfc9,2,11,2,9,0,0,0,4,19,0,1,2,0.391243564,414,36,1,53,53,0,3638,3613,25,19,19,0,100
9b2c7aa28ed4e3afe1e8b74ce3f8266dc7927915,2,111,1,110,0,0,0,3,18,42,2,2,0.301378644,434,113,2,67,62,5,4252,3319,933,40,38,2,95.69087599
f84ab255d5014c9f477c1197e5a9cb35d522c79f,1,12,1,11,0,0,0,2,2,4,1,1,0,82,574,5,21,20,1,472,410,62,17,17,0,100
2b8d5e455e14cf7722846acbe89221a6cbdb166d,7,50,16,34,0,0,0,2,31,204,1,4,2.613104743,751,575,6,146,144,2,5336,5310,26,73,71,2,100
b840d2f12b7cc46c891ecbb85a7e9ca8b69f5774,1,12,1,11,0,0,0,2,6,3,1,1,0,81,71,20,15,13,2,785,639,146,8,7,1,100
c62fe141e409d107a2d2b3cbed6840117763c780,5,24,19,5,0,0,0,2,12,0,1,2,1.673411449,1511,72,21,311,311,0,13990,13974,16,164,164,0,100
235098da699bf57e013183f30447f9c0c89058e0,4,5,5,0,0,0,0,4,13,0,1,1,1.921928095,1452,73,22,305,305,0,13528,13518,10,160,160,0,100
10afd75e2db4339c3185f09cabd19887fa91e4fc,1,8,14,6,0,0,0,2,49,67,1,1,0,696,576,7,96,96,0,4287,4301,14,41,41,0,100
705828f78799f586d5539b87307d7dc4031ffef1,1,12,14,2,0,0,0,5,20,5,1,1,0,94,577,8,11,11,0,727,754,27,6,6,0,100
75845af558f3ae0607336a17ff491265e0315aec,1,114,92,22,0,0,0,5,15,303,1,1,0,197,37,2,21,22,1,2048,2038,10,3,3,0,100
7e75b29b73839c8164a4584918226c0855fa78a1,1,1,1,0,0,0,0,5,16,0,1,1,0,198,38,3,21,21,0,2048,2048,0,3,3,0,100
170284d12c82dc305df9414d839d5d8434387021,0,0,0,0,0,0,0,0,0,0,0,0,0,0,52,0,0,0,0,0,0,0,0,0,0,100
75a2a7068dcaeb14568d52f3554babb3b0289ebf,0,0,0,0,0,0,0,0,0,0,0,0,0,0,53,1,0,0,0,0,0,0,0,0,0,100
8a99d7561228883cfddcda43428053cd78611b11,99,864,875,11,0,0,0,4,72,14,4,45,5.42077486,15613,578,8,2553,2554,1,120804,121517,713,974,973,1,98.45041322
f1ca6dee7fd0ce189b250eaf01b475847c19ffda,0,0,0,0,0,0,0,0,0,0,0,0,0,0,54,2,0,0,0,0,0,0,0,0,0,100
5352ea2dbe1b21da0873c4ccf34b92e1840dd4d7,4,264,11,253,2,0,2,2,43,18,1,2,1.839124443,717,4,0,78,62,16,7827,6491,1336,33,27,6,90.09230769
758dc915161008d81183cf7b42a0e50985f517ba,3,167,2,165,2,0,2,2,3,4,1,1,1.055743984,90,74,23,34,21,13,858,472,386,20,17,3,99.91714996
d61aa504fbc7dafef58048b007d30cb081592b7d,1,2,2,0,0,0,0,2,9,23,1,1,0,180,75,24,37,37,0,1104,1104,0,22,22,0,100
6c34155d2c5f2eb4188a772215bd8f080d75e870,1,196,0,196,1,0,1,1,1,0,1,1,0,0,76,25,21,0,21,575,0,575,13,0,13,99.77272727
b60177d7e2ef6a15a23ab301d4c2ff6516baf963,1,33,6,27,0,0,0,2,7,18,1,1,0,74,77,26,14,12,2,483,441,42,9,7,2,100
2ce6410a48f54137afe140cca6b5b4007593cc4f,2,4,1,3,0,0,0,2,10,14,1,1,0.970950594,304,78,27,38,38,0,3271,3207,64,12,12,0,100
451dc8c2b9b5b348b32a64161ab111d6aa2909d2,1,4,1,3,0,0,0,2,8,3,1,1,0,177,79,28,45,45,0,1039,1027,12,32,32,0,100
2c6fc0bbebb249dd1954b428b2c1a5238f57f050,1,4,2,2,0,0,0,2,9,0,1,1,0,178,80,29,46,45,1,1056,1039,17,32,32,0,100
93ddcf8bc21ca37bc76b8bf5857a602b0bc9c0c0,1,15,4,11,0,0,0,2,5,23,1,1,0,215,81,30,50,49,1,1312,1284,28,41,41,0,100
ee62ea239c82953f563b8163b0271d6ad0233278,2,21,32,11,0,0,0,3,10,1,2,2,0.313812964,457,82,31,102,103,1,3318,3382,64,42,43,1,100
7be2356a7b44ff6a67ffa158525b41addd02a626,8,63,69,6,0,0,0,4,18,61,1,2,2.554759642,1573,83,32,413,415,2,12954,12987,33,185,188,3,100
1d54c24c1a139e9a2fd4d206a136201a1e106865,1,0,2,2,0,0,0,2,7,16,1,1,0,35,84,33,4,4,0,247,256,9,1,1,0,100
96b7f9b53dd85ff206c89011c917961b61964b77,1,4,2,2,0,0,0,2,8,0,1,1,0,33,85,34,4,4,0,232,247,15,1,1,0,100
3686970f586cff8a52e9ab73650540b2ee57e80f,1,2,0,2,0,0,0,2,6,0,1,1,0,219,86,35,50,50,0,1312,1312,0,41,41,0,100
5ce59923464550a51f4dd8f7cea50cfaba228844,34,356,849,493,0,0,0,4,44,54,4,18,3.576633579,7874,579,9,1618,1688,70,57392,59527,2135,501,514,13,98.04193038
88848aef092c49122f58e1ae898cb21db61ed8a7,2,69,3,66,1,0,1,1,6,77,1,2,0.581321499,146,87,35,36,32,4,1460,998,462,13,11,2,99.50362734
894b64695337ed467a5c7038f2b89f1e11b709f0,1,12,2,10,0,0,0,4,7,73,1,1,0,37,88,36,9,9,0,290,290,0,4,4,0,100
a1dd99275fd93488e01439fa2a1c7d75d8d5b15d,2,18,1,17,0,0,0,4,18,57,1,1,0.485460761,253,350,0,55,54,1,2199,2043,156,24,23,1,100
2ca68e8b9e154e03f6f081f1ef726760e3905b63,16,37,41,4,0,0,0,5,50,49,2,12,3.539788081,3505,114,1,531,531,0,29650,29727,77,203,203,0,100
dd2619f81b656b741a13f3d627044d3a4356fb8d,2,95,48,47,0,0,0,3,20,18,2,2,0.462309904,418,115,2,42,39,3,4296,4087,209,21,20,1,100
64301883acca71df44f307f5c281639839c62818,69,400,845,445,0,0,0,3,58,86,4,39,4.828413956,13145,580,8,2206,2262,56,94379,96554,2175,772,791,19,97.22331627
6510938993147374125229bf833dc676a5aeae84,4,274,86,188,1,0,1,3,22,12,2,3,1.687846952,584,116,3,66,55,11,6768,5233,1535,36,32,4,96.76954733
1e923edde6f7bf16d5ab177377cbf38afccaebe8,5,120,7,113,1,0,1,2,11,27,1,3,1.515967871,459,89,25,114,101,13,3448,2839,609,71,63,8,99.83270598
04a4b3d4236b3e083c5778f833a01fc3cc130803,1,75,35,40,0,0,0,1,2,0,1,1,0,69,90,26,15,8,7,651,478,173,8,4,4,99.68632371
0ada0cb8bd89217d4c995b566627df47db8b1486,1,1,1,0,0,0,0,4,12,85,1,1,0,188,91,27,43,43,0,1087,1087,0,28,28,0,100
e763bdfd3cb5077c9359536966b9b1925ae4772f,1,0,14,14,0,0,0,1,3,0,1,1,0,104,92,28,15,15,0,507,651,144,8,8,0,99.6442026
af1c02cce14cad4ad8f390e1f21272be06af8cc7,1,17,4,13,0,0,0,1,4,1,1,1,0,90,93,29,17,15,2,614,507,107,8,8,0,100
8f6bd9e072c960958f09200221888570c4ec7c2c,1,4,4,0,0,0,0,2,28,331,1,1,0,316,581,9,65,65,0,2300,2304,4,19,19,0,100
878d80f99e8d9c2c43828a1fec476026a628e766,1,31,18,13,0,0,0,2,25,334,1,1,0,239,582,10,45,45,0,1874,1792,82,15,15,0,100
6680267723a56fab773f61834ba99a84fb707d0e,1,2,1,1,0,0,0,2,12,334,1,1,0,38,583,10,5,5,0,335,319,16,4,4,0,100
7865230994fb76084e7d5db80b840c5bd308f589,2,21,21,0,0,0,0,2,29,168,1,1,0.998363673,677,584,11,148,148,0,4883,4891,8,41,43,2,100
fbf804bb0c294c9d06869a30c7baa1ebd5a77cad,16,345,87,258,3,0,3,2,12,26,1,2,3.431121261,831,94,23,141,109,32,6091,4969,1122,99,79,20,99.62350973
fa5ca4a8fca3e8aa83478763470a585b19bcf4fb,1,36,10,26,0,0,0,2,11,7,1,1,0,182,95,24,41,38,3,1180,1114,66,25,23,2,100
0687a7a26061e0965882ca694dfec1ef583d225b,1,0,1,1,0,0,0,2,8,30,1,1,0,80,96,25,12,12,0,392,392,0,11,11,0,100
ffc9d6a3fec99aedea4d710d23d56fdcaa59635f,1,3,10,7,0,0,0,2,7,20,1,1,0,148,97,26,31,32,1,1025,1038,13,10,11,1,100
013d0eb78b795ced6f6b4efe63c36f5df5a35e2a,1,90,14,76,0,0,0,2,5,0,1,1,0,37,98,27,11,2,9,678,203,475,7,2,5,96.42184557
8b9a6bf7d767b0933d6ebbde594f1f88b351e281,1,2,2,0,0,0,0,1,3,50,1,1,0,78,99,28,15,15,0,538,540,2,5,5,0,100
a5994378c57bb9a6ecc7c67810ed898a94cd47dc,1,2,1,1,0,0,0,2,6,0,1,1,0,47,100,29,7,7,0,245,232,13,5,5,0,100
b5d873b2fc1df325fefe8bd4651660d6ed322426,2,5,1,4,0,0,0,2,9,0,1,1,0.918295834,212,101,30,42,41,1,1399,1397,2,29,28,1,100
8a51eb432fbf8f7080ceec249f54ebca39c33a2b,1,5,0,5,0,0,0,2,8,0,1,1,0,88,102,31,8,7,1,853,815,38,4,4,0,100
7a57c515e4a42967d8cee6b72b82fad6ef5125d3,1,2,1,1,0,0,0,2,9,0,1,1,0,51,103,32,2,2,0,360,342,18,2,2,0,100
7ab7df7b40bbe936c9d095f50320f73292dd09f7,1,3,3,0,0,0,0,2,4,42,1,1,0,163,104,33,15,15,0,1555,1544,11,9,9,0,100
e81fe138735d132b61a647a693bf16eaa83deeb0,2,25,19,6,0,0,0,2,9,0,1,2,0.510787823,140,105,34,15,15,0,1071,1059,12,9,9,0,100
d24b3031e677324494409f114ed662f292d04cb1,2,2,3,1,0,0,0,2,9,48,1,2,0.970950594,84,106,35,7,7,0,402,402,0,5,5,0,100
66e63a120beeb61dea873e698a488ee44fb4a317,3,23,9,14,0,0,0,2,10,0,1,2,0.946686087,267,107,36,45,44,1,1766,1759,7,32,31,1,100
2b9294068a004b97dccfeb41c16a4c76e09f6afd,1,37,1,36,0,0,0,2,9,107,1,1,0,153,585,10,52,39,13,1179,985,194,19,18,1,100
bf7cb962c6aff6c6b1f8bc3190245949604ad519,3,45,14,31,0,0,0,3,11,130,2,2,0.959298443,574,108,34,106,103,3,4574,4412,162,39,38,1,100
41acc3f8ba9fae40948dfb7687dad80bea36a607,1,14,0,14,0,0,0,1,5,11,1,1,0,102,109,35,17,17,0,614,614,0,8,8,0,100
42b989b0104ff75d10a89ebe69bc8822778b611c,2,14,1,13,0,0,0,1,8,43,1,2,0.721928095,304,110,36,70,67,3,2014,1939,75,53,51,2,100
20a43c49986dd721eb23d4fbc6efb633b50b8011,1,1,1,0,0,0,0,2,7,7,1,1,0,47,111,37,7,7,0,210,215,5,5,5,0,100
68de812e21943b3a2cc34ce23e6cac65cb1c7605,1,1,1,0,0,0,0,2,10,6,1,1,0,131,112,38,28,28,0,885,881,4,20,20,0,100
e236ae93e6c025ef3d8de7f0fb6668d7337efba4,2,30,1,29,0,0,0,7,25,38,1,2,0.345117315,101,117,3,17,17,0,867,867,0,7,7,0,100
6ab620d9f672b43fcb08ab0a20447bcb495d2f52,1,1,1,0,0,0,0,1,6,2,1,1,0,98,113,39,20,20,0,713,710,3,12,12,0,100
b553e02f3bcda293d761b1f76009bc48caa3a0f3,1,23,1,22,0,0,0,2,9,2,1,1,0,218,114,40,53,50,3,1419,1304,115,42,41,1,100
a87bed8d606a707f401371558467bd54feaa0c26,2,18,4,14,0,0,0,2,12,8,1,1,0.845350937,419,115,41,104,101,3,2628,2552,76,77,75,2,100
8b6f5d72d89ed19d94cb01da1a6161451780ca98,1,276,0,276,1,0,1,1,1,0,1,1,0,0,116,42,28,0,28,1915,0,1915,5,0,5,99.7260743
23e751fc5d60385c85f1a7d410f493c43e8c9c6f,2,78,42,36,0,0,0,2,4,33,1,2,0.783776947,110,117,43,20,17,3,1159,836,323,5,6,1,99.86315429
51e2486689dc8427ed8291a6faddd5a8c755a43e,1,18,0,18,0,0,0,1,2,3,1,1,0,197,118,44,28,28,0,1922,1915,7,5,5,0,100
ef7b7682a4ae4465fc9472f0921dd96d715ee32d,1,5,0,5,0,0,0,2,11,3,1,1,0,230,119,45,54,53,1,1447,1419,28,43,42,1,100
9cfe290fe0781002a8011111cd2b644f3e796c33,2,14,6,8,0,0,0,1,12,0,2,1,0.468995594,448,120,46,84,82,2,3396,3369,27,49,48,1,100
9a5b4611d14559b1c8738cf65f5694dbebde594f,1,2,1,1,0,0,0,1,4,0,1,1,0,214,121,47,28,28,0,1925,1922,3,5,5,0,100
24a75dbf158c935ba74245adb15add4caf6c923c,1,14,5,9,0,0,0,1,5,0,1,1,0,215,122,48,28,28,0,1924,1925,1,5,5,0,100
3181b4bb3f2eab7e5bb3e5a7db2bfa61642f4d15,0,0,0,0,0,0,0,0,0,0,0,0,0,0,39,0,0,0,0,0,0,0,0,0,0,100
8267c5b6f67a263028672e5a7ac2849b0479d9eb,3,83,34,49,0,0,0,2,18,32,1,2,1.23631484,444,118,4,75,68,7,4467,3927,540,28,25,3,100
d4b792442e4be3da8acd009f90c55b761437906e,2,90,0,90,1,0,1,1,6,22,1,2,0.503258335,248,123,39,32,27,5,2457,1879,578,13,10,3,99.94873548
86306e5d6cad056c6f64b29d16d5ba655bffb9a7,2,10,4,6,0,0,0,2,5,0,1,2,0.863120569,131,124,39,21,20,1,1189,1159,30,6,5,1,100
6a4a189231a75ba32ad63cb67609a949f703934e,3,10,5,5,0,0,0,2,11,9,1,1,1.103307409,226,125,39,43,42,1,1368,1340,28,30,30,0,100
e6b4e352c4d9ce41908a5c67d325fb430b2fd44e,10,355,161,194,2,0,2,2,13,14,2,4,2.693793957,1292,126,39,251,229,22,10902,10063,839,144,131,13,99.76182375
b50007094b3b817e9a5119af83c93d73093321b1,2,46,2,44,0,0,0,2,6,0,1,2,0.968461009,488,127,40,57,54,3,4771,4495,276,36,34,2,100
48840c1fe40e8f66ecc0b23a2ed51e4f162b1915,20,733,868,135,0,0,0,2,73,47,3,18,3.61042656,4665,119,5,449,456,7,41913,42426,513,189,193,4,97.75417827
001b04d44c193533a24b868159bab20e3379692a,5,37,27,10,0,0,0,2,31,60,2,3,1.07121226,620,120,6,114,113,1,4601,4567,34,67,67,0,100
5606a0d2b3bbf8996fa6e9e36aa1ab5f60199a77,1,0,3,3,0,0,0,2,12,0,1,1,0,104,121,7,19,20,1,876,892,16,5,5,0,100
763db667457934e7b465ec661d0acb9a97133335,3,42,15,27,0,0,0,4,19,45,1,1,1.188157128,692,128,41,185,183,2,5371,5271,100,78,76,2,100
c93818ef801be7bc45e3ded82e13919cafa0643d,1,11,18,7,0,0,0,1,6,5,1,1,0,221,129,42,27,28,1,1851,1924,73,5,5,0,100
3fc2024c83a1575a8c28b82d5ec918044b86f20a,1,2,5,3,0,0,0,2,26,23,1,1,0,252,586,6,44,45,1,1863,1874,11,15,15,0,100
27d33a2f42fcb583e78699a1659644e83ca93188,12,2789,0,2789,12,0,12,1,1,0,2,2,3.260766286,0,30,0,312,0,312,14645,0,14645,87,0,87,99.64349376
20276b4ade92758323e1b798bbf2bbd134c0ee2d,0,0,0,0,0,0,0,0,0,0,0,0,0,0,587,7,0,0,0,0,0,0,0,0,0,100
61b5385aa74f5dc813129599bcf7e50f5a234169,1,3,0,3,0,0,0,4,6,36,1,1,0,42,588,8,4,4,0,405,392,13,4,4,0,100
ad53dbea31ecfb9b0c3bb02b3e3470a4c5d5c586,1,5,1,4,0,0,0,4,18,342,1,1,0,73,589,9,11,10,1,533,511,22,5,5,0,100
31d93a8ac65fb0878391d88aa2166762a28ebbf4,1,4,1,3,0,0,0,2,24,51,1,1,0,505,590,10,92,91,1,3821,3808,13,13,13,0,100
1259c968fc6f0f222b5d385c44fd8104608b10d4,2,71,12,59,0,0,0,5,18,71,1,2,0.816017297,885,591,11,119,109,10,7541,7156,385,66,64,2,100
c8270dc4e72930ae4f1e993fbcfe44ddaf61e3b8,8,875,263,612,2,0,2,2,24,0,1,4,2.267849971,1068,122,8,172,119,53,14136,8432,5704,74,48,26,96.42264429
f900e2a6e1a5a60a76757c5a61a9024a6545bcd6,9,171,209,38,0,0,0,6,60,8,2,9,2.509018979,1806,123,9,163,160,3,14620,14656,36,68,67,1,100
c4a0cb9426b7792d4365f0e419917cf85d6e5b63,7,141,194,53,0,0,0,2,50,7,3,6,1.92466236,1662,124,10,141,139,2,15188,15088,100,69,69,0,100
69ad72b64c90836a20eb600fc8acf1a00743f427,1,19,17,2,0,0,0,6,45,64,1,1,0,285,125,11,43,43,0,2783,2761,22,10,10,0,100
22d7d31c58adfc711986028ed0e03a07f740483f,10,321,72,249,2,0,2,1,25,83,1,7,2.47270442,946,40,1,126,104,22,9476,8225,1251,38,27,11,99.69325153
d53cf4a1ae2c94132ebb247a872e391d74389cf4,43,518,462,56,0,0,0,1,74,34,4,26,4.53270924,6424,592,12,1194,1192,2,50609,50499,110,429,427,2,100
d41b3609f226d921a53b69ce834a5c0a8eb1409e,3,88,93,5,0,0,0,1,51,0,2,3,0.209156095,732,126,12,67,64,3,6914,6562,352,35,33,2,100
07d3d5fe6f4c9b250c6c03a826b1cfe7d2b5f8ac,12,204,255,51,2,0,2,1,69,227,1,6,3.214767141,2166,593,13,403,420,17,14736,15056,320,142,146,4,99.84665517
2ede1c0d067dca290150c3a9be28b62743dc9130,2,36,26,10,0,0,0,4,12,157,1,1,0.981152234,336,594,14,43,42,1,3499,3461,38,8,8,0,100
b0695e95e7d66fd569d0cb80ec1ac9b80c20d21a,2,121,6,115,1,0,1,1,2,36,1,2,0.50062806,92,595,15,32,22,10,1400,714,686,19,12,7,99.73164654
3f1450a35e058c5353004affd12f3ddd7e7327e8,46,223,215,8,0,0,0,5,47,92,5,34,4.958553254,5292,596,16,780,778,2,44714,44741,27,342,340,2,98.8102204
c69893b5c99758e176525dc03c9ea724a397173a,2,24,15,9,0,0,0,2,15,17,2,2,0.477071306,163,597,17,24,24,0,1581,1631,50,7,7,0,98.92703863
1619a3f3fb5692ac36805e18a617870989cf85ce,6,12,12,0,0,0,0,2,16,0,2,5,2.522055209,1224,598,18,199,199,0,12032,12031,1,98,98,0,98.92703863
f4597a2eb0eafe379f200ace797e92fc96c73786,1,1,1,0,0,0,0,2,17,0,1,1,0,77,599,19,20,20,0,676,676,0,5,5,0,100
61ae2e77f725bbc71c2ed9899f8b91fd6f422242,30,221,180,41,0,0,0,5,61,49,4,19,4.139796404,4432,600,20,607,610,3,33746,33919,173,270,271,1,98.64944216
981b4431e6ad7f4194687ae8b758d2b1a164c101,1,1,1,0,0,0,0,6,24,196,1,1,0,40,127,11,6,6,0,348,348,0,3,3,0,100
597db6a05e4e2464d26b19109d6a4ee43cc5c363,3,118,20,98,0,0,0,2,15,4,1,2,1.182823557,718,130,41,136,122,14,6311,5690,621,83,77,6,100
f029d24a28c10915b49474e6b6d47809f446e5a4,1,29,14,15,0,0,0,2,9,2,1,1,0,225,131,42,29,28,1,2000,1872,128,5,6,1,100
b801629db0fa2a64946917561844ba38137f04c6,2,1,4,3,0,0,0,2,12,17,1,2,0.970950594,368,132,43,56,56,0,2835,2837,2,34,34,0,100
57f0c7d567fedc0828bb72cda774a1c8ace1e2a7,1,122,0,122,1,0,1,1,1,0,1,1,0,0,601,20,8,0,8,984,0,984,6,0,6,99.96138996
1ce47b660e9d4605f36e8ac41681c0991a65d78f,4,165,43,122,0,0,0,2,22,8,1,3,1.782972548,763,128,11,82,71,11,8817,7897,920,46,41,5,99.21017145
1bb9546ee479ee23138ccb29d5a452ade4199a07,2,141,86,55,0,0,0,2,23,3,1,2,0.727183044,531,129,12,66,69,3,4931,4957,26,25,26,1,100
3c9538a43c1c02567f6018cf3bafbeadb49b7b65,16,691,222,469,4,0,4,2,75,12,2,10,2.856939335,2559,130,13,330,299,31,23181,21459,1722,127,104,23,99.29064417
d0dc3886420effe3c0913aa865cae4499bc15465,3,12,9,3,0,0,0,2,16,3,1,2,1.267770216,818,133,40,126,124,2,6663,6674,11,86,86,0,100
ebc739324e931b150a73dc53f60e43105378c2ed,1,11,32,21,0,0,0,1,2,0,1,1,0,77,131,14,10,10,0,302,284,18,7,7,0,100
76059d43401ddeb8df1fb8e6e5677adcd3378b4f,2,3,3,0,0,0,0,1,3,0,1,2,1,117,132,15,19,19,0,955,912,43,13,13,0,100
237bcbdcd40b27c1bae2d191d8b7c60bd20da72e,5,17,20,3,0,0,0,2,15,0,2,3,2.079427728,413,133,16,74,74,0,3148,3186,38,31,31,0,100
28a69a00105a7f1001d4ff3f803eedbbcb8a6c2c,5,52,47,5,0,0,0,2,25,26,3,5,1.790748721,679,134,17,93,91,2,6490,6464,26,38,38,0,100
58b5f28efe24232e833d116249bde23217f4f840,7,171,135,36,1,0,1,2,17,31,2,2,1.917425012,1251,134,40,236,239,3,8668,8753,85,161,162,1,99.92359121
72583eb53f987abd605fce2de9d1cf8f1ac00cc7,9,21,8,13,0,0,0,1,48,5,2,7,2.701797374,809,135,18,75,69,6,7082,6212,870,33,28,5,99.6945399
48d069f4559da3870ee1e3b36df757b29b781885,27,2973,23,2950,24,0,24,1,18,4,1,7,4.518902502,577,136,19,264,90,174,19274,4203,15071,132,51,81,98.87048193
77c59bcdf244253cf376bac1ba7d430e46a75dd4,1,1,1,0,0,0,0,3,4,132,1,1,0,23,137,20,6,6,0,174,174,0,2,2,0,100
cf76c3f875b935b68db345ccefc1636224487905,2,132,71,61,0,0,0,1,2,0,1,2,0.909865931,230,138,21,19,15,4,2667,2365,302,9,7,2,100
71ecd11a54369ad8d98ec7a297899983b24ed7d8,1,1,2,1,0,0,0,1,3,0,1,1,0,127,139,22,13,13,0,1287,1293,6,6,6,0,100
9608f224f5f86cf786584c9c9524b30adf14dc07,9,1121,0,1121,9,0,9,1,1,0,2,3,3.028187894,0,602,17,101,0,101,6415,0,6415,44,0,44,99.63031423
049e7dc6cae23f7992aee48ec1f85d0cc133a20c,107,694,560,134,0,0,0,2,70,18,4,44,5.714024486,12761,603,18,1904,1904,0,102277,102449,172,943,938,5,99.96323529
833c65998e3cf6ac33cc7068f3d689eb99e10566,2,96,63,33,0,0,0,2,5,78,1,2,0.936018616,565,41,2,112,107,5,4226,3988,238,43,42,1,100
abb9151ccecf844fd9976158f68e2dfe89fe2f9d,1,7,2,5,0,0,0,5,13,147,1,1,0,77,42,3,14,14,0,688,674,14,5,5,0,100
21d08d20a72f22cd2a26cd66fb983bfb9ea37d70,5,191,26,165,3,0,3,1,15,1,1,1,1.98378728,236,135,27,54,44,10,1924,1360,564,34,28,6,99.81661471
4b8c8d4ae0b18e25683342d41a4950388c8bd091,10,173,31,142,0,0,0,5,27,61,2,7,2.98647348,2238,103,0,343,316,27,18092,17414,678,152,146,6,100
52f677a87a11a5d84389ad34955082776b1dcf7d,1,34,28,6,0,0,0,5,25,58,1,1,0,116,604,18,19,19,0,969,871,98,3,3,0,100
10d666390968cba134b31b78d6c3c99b0b6164cd,41,90,93,3,0,0,0,3,27,18,2,12,5.063304568,3519,104,1,422,229,193,30432,39834,9402,161,107,54,97.07538601
69ba194af61508da5e286b5690d171e01ab1635e,128,815,1168,353,0,0,0,4,71,219,3,50,6.576096211,16118,605,19,2955,3229,274,114292,114261,31,1336,1336,0,100
fff59db8997f9d0afe8216fe382c9c03fc3fb2e7,0,0,0,0,0,0,0,0,0,0,0,0,0,0,43,4,0,0,0,0,0,0,0,0,0,100
6c9a0234c234250eab869c59e27bfdcf167723ea,0,0,0,0,0,0,0,0,0,0,0,0,0,0,44,5,0,0,0,0,0,0,0,0,0,100
5a6f2711f2b1ca6be3726731cec10157357625a1,0,0,0,0,0,0,0,0,0,0,0,0,0,0,45,6,0,0,0,0,0,0,0,0,0,100
bb6c61679795d2ebc5483e706a076f4f10583225,6,82,67,15,0,0,0,2,14,340,1,2,1.832562312,562,105,2,53,55,2,5594,5417,177,23,25,2,100
5a7067b89828b28feeb5df964edca3d02746a15f,22,25,25,0,0,0,0,3,10,4,2,5,4.32385619,1673,106,3,218,199,19,11000,18872,7872,133,91,42,95.17873511
af0434f0518d9bbf53d0e22581d4591d05c9f590,1,6,6,0,0,0,0,3,8,3,1,1,0,193,107,4,26,26,0,1266,1254,12,11,11,0,96.57195234
4c864912764782e54f33c0c511d4955c62e3453d,1,1,1,0,0,0,0,6,46,29,1,1,0,259,5,0,21,21,0,2089,2089,0,3,3,0,100
d2c0b5ee8d401bdab705f859e07697c3e26e3901,1,1,1,0,0,0,0,6,21,84,1,1,0,45,140,22,8,8,0,392,392,0,2,2,0,100
515a414a4ee0bc872621fd0af360d7669e6806a1,16,1509,0,1509,16,0,16,1,1,0,1,4,3.641301298,0,108,5,145,0,145,8089,0,8089,79,0,79,99.10394265
1ab159a766ee7c0219c0bd9a5b3ee914c280fdff,1,6,9,3,0,0,0,3,6,709,1,1,0,37,606,19,4,3,1,347,343,4,2,2,0,100
4a31f91b01b79b741611a300262e2eeb2fd12378,1,2,1,1,0,0,0,6,30,14,1,1,0,197,607,18,24,24,0,1772,1754,18,8,8,0,100
f50b9a69bb2f072d0dced7c747cbf8f9a408f25c,7,104,102,2,0,0,0,6,76,40,1,6,2.02844176,2006,141,16,208,199,9,16313,16080,233,75,75,0,100
9b6984319d93ecf5e0ea3f1b827055ad20005a8b,4,6,4,2,0,0,0,1,2,4,1,1,1.570950594,278,109,6,27,26,1,2442,2423,19,12,12,0,100
595fd5ae02b98a6637f55f9b0850e995f3e34544,3,46,24,22,0,0,0,2,47,77,1,3,1.355700916,652,6,1,59,59,0,5219,5219,0,16,16,0,100
f201912ac6e4f36fd6d286fc12e905f2cc4cc822,2,5,3,2,0,0,0,3,19,21,2,1,0.811278124,530,608,12,96,95,1,3877,3863,14,55,55,0,100
e20c007f190de6acdae723b192290b60aeb10fb4,1,1,1,0,0,0,0,2,12,174,1,1,0,73,609,9,7,7,0,512,512,0,5,5,0,100
903575e1bbd5f13d6674b872b96a3fe5dd28ba44,4,106,30,76,1,0,1,1,17,21,2,4,1.498695887,472,142,15,51,47,4,4749,4284,465,24,21,3,99.91092108
48a678cc7ee0ce43532e916e51a4c30d121e2162,1,2,2,0,0,0,0,4,28,23,1,1,0,315,143,15,23,23,0,3269,3269,0,13,13,0,100
16d172e920ea94ca73aa5aeaae47067cdec52be1,1,1,1,0,0,0,0,4,18,4,1,1,0,195,144,16,26,26,0,1620,1620,0,12,12,0,100
d4997623f55762409880a2a94bfb211c998d64d0,0,0,0,0,0,0,0,0,0,0,0,0,0,0,46,5,0,0,0,0,0,0,0,0,0,100
fa4822bf80aeb21a5a8099e9396d661e6d3d89f7,1,1,1,0,0,0,0,3,4,48,1,1,0,72,47,6,3,3,0,540,533,7,1,1,0,100
de4e1df4da6345ae766c86da63871490cd113cfb,0,0,0,0,0,0,0,0,0,0,0,0,0,0,48,7,0,0,0,0,0,0,0,0,0,100
319fd82531c3bc5b8b0751fdf83b8d1d68dc4114,4,92,20,72,0,0,0,3,12,35,2,1,1.197626955,716,136,1,102,93,9,6186,5840,346,45,40,5,100
38c0cb46cc4f0cf551325fec5def4de1e187bd33,1,3,3,0,0,0,0,3,10,56,1,1,0,229,137,2,30,30,0,2237,2237,0,4,4,0,100
8ce9787b69ef4cba6409502b71496acd4ee838d6,1,10,1,9,0,0,0,4,12,198,1,1,0,121,351,0,40,39,1,1131,1090,41,6,6,0,100
94089d639ecd312a3bb340dc06e06cb46160c753,0,0,0,0,0,0,0,0,0,0,0,0,0,0,49,8,0,0,0,0,0,0,0,0,0,100
4560cd81722872c9bbcafb63c56178954a9ce0b7,0,0,0,0,0,0,0,0,0,0,0,0,0,0,7,2,0,0,0,0,0,0,0,0,0,100
be0683b90b3a316d7082261821dc4f8e5095e25e,0,0,0,0,0,0,0,0,0,0,0,0,0,0,8,3,0,0,0,0,0,0,0,0,0,100
fbf5509aa30f7f569608aac8e5635bde8338b645,0,0,0,0,0,0,0,0,0,0,0,0,0,0,145,5,0,0,0,0,0,0,0,0,0,100
d6cd587272e8870530cdc57f58ed7d0a7ba2b212,2,4,4,0,0,0,0,3,48,18,1,2,0.811278124,408,9,4,30,30,0,3339,3339,0,5,5,0,100
efb835bd259eae59ce91307ff328f12b84dbac9e,1,2,2,0,0,0,0,6,26,117,1,1,0,94,146,6,15,14,1,839,824,15,3,3,0,100
4bb80404696edb20723ab8b770a3b82a6ac66abc,1,2,1,1,0,0,0,5,42,60,1,1,0,273,147,7,49,49,0,2154,2153,1,18,18,0,100
88193f062d488f8d9a2bf046961affc8cea0104b,1,2,1,1,0,0,0,2,2,367,1,1,0,9,148,8,1,1,0,66,66,0,1,1,0,100
42f7417ab4bc5ec9914b044dae2c35cbc29f4330,1,7,6,1,0,0,0,4,20,69,1,1,0,534,138,2,150,149,1,4012,4027,15,62,61,1,100
38a69607daa70d532dfa915c01f7d70fd84be00b,3,35,17,18,0,0,0,4,16,118,1,2,1.196731843,699,139,3,145,140,5,6680,6590,90,74,74,0,100
9b7802a753deb776492d1370a821fc50829ae6f6,2,315,0,315,2,0,2,1,1,0,1,2,0.443320237,0,140,4,38,0,38,1315,0,1315,22,0,22,99.91104786
d94fda18195a8f78202e473d5ac174fed1a73b46,0,0,0,0,0,0,0,0,0,0,0,0,0,0,20,0,0,0,0,0,0,0,0,0,0,100
b0cb378466ddeb172eff9b44ad65badc122431bb,9,16,21,5,0,0,0,2,77,33,2,9,3.047989353,2248,149,9,227,227,0,18764,18708,56,85,85,0,100
cab04b8bc6859662717cacdef5f48899788341f8,1,1,1,0,0,0,0,3,7,51,1,1,0,22,110,5,6,6,0,138,138,0,6,6,0,100
59143ea6e416eb0555eed568571f0398967285dd,0,0,0,0,0,0,0,0,0,0,0,0,0,0,610,4,0,0,0,0,0,0,0,0,0,100
0e3e6c509f2b1b7807d7918bb09bce886cfa1940,0,0,0,0,0,0,0,0,0,0,0,0,0,0,611,5,0,0,0,0,0,0,0,0,0,100
60314413d24ab8e34130ae565dd2e17fc44f7f8a,0,0,0,0,0,0,0,0,0,0,0,0,0,0,612,6,0,0,0,0,0,0,0,0,0,100
868e831312979b00db2ef70f4d2956ff1244c380,0,0,0,0,0,0,0,0,0,0,0,0,0,0,613,7,0,0,0,0,0,0,0,0,0,100
4dee1c3c540f091905a62c6d25d7961fc7785e2e,0,0,0,0,0,0,0,0,0,0,0,0,0,0,55,0,0,0,0,0,0,0,0,0,0,100
b5e646be274b11c4a8cd0f4092995907236fdded,0,0,0,0,0,0,0,0,0,0,0,0,0,0,50,4,0,0,0,0,0,0,0,0,0,100
e1136b9f97ad5dabf3c0251a06487d0e84eebb74,0,0,0,0,0,0,0,0,0,0,0,0,0,0,56,1,0,0,0,0,0,0,0,0,0,100
270ab0b0a7b3dfab91ea51e70324baffee98e7db,0,0,0,0,0,0,0,0,0,0,0,0,0,0,57,2,0,0,0,0,0,0,0,0,0,100
e149a1afd6c74b265cb64c3558adeb501716f336,0,0,0,0,0,0,0,0,0,0,0,0,0,0,58,3,0,0,0,0,0,0,0,0,0,100
89c5404ac5f1ab7a7aaea10c9701d1e829a6346a,0,0,0,0,0,0,0,0,0,0,0,0,0,0,59,4,0,0,0,0,0,0,0,0,0,100
834433b4982990a8eea5dc16c87e9f4cb1df2953,0,0,0,0,0,0,0,0,0,0,0,0,0,0,60,5,0,0,0,0,0,0,0,0,0,100
a9e5c04062e77579f3bba7fd902266bb3b34f00e,0,0,0,0,0,0,0,0,0,0,0,0,0,0,61,6,0,0,0,0,0,0,0,0,0,100
fe5c88e8885d63f9cf5794a6c2ef279ac452b37d,0,0,0,0,0,0,0,0,0,0,0,0,0,0,62,7,0,0,0,0,0,0,0,0,0,100
01b48600034873ccabcdfc7a9ccbc0ca9a10d100,0,0,0,0,0,0,0,0,0,0,0,0,0,0,63,8,0,0,0,0,0,0,0,0,0,100
24472b1ab9f2db976c153ef140757a57c14f1978,0,0,0,0,0,0,0,0,0,0,0,0,0,0,64,9,0,0,0,0,0,0,0,0,0,100
a5c0e6ba0b76f475e6604f4114ef883dfbee879f,0,0,0,0,0,0,0,0,0,0,0,0,0,0,65,10,0,0,0,0,0,0,0,0,0,100
47a4094224730dee474efb03a6f45c0c605b6fbe,0,0,0,0,0,0,0,0,0,0,0,0,0,0,66,11,0,0,0,0,0,0,0,0,0,100
df53a47dda7543542384286f98b3fc36bea22ed9,0,0,0,0,0,0,0,0,0,0,0,0,0,0,51,5,0,0,0,0,0,0,0,0,0,100
767b996c1e222e2c5790fe7a9ddc4bf30e86b75b,0,0,0,0,0,0,0,0,0,0,0,0,0,0,67,12,0,0,0,0,0,0,0,0,0,100
9ba70fa29876a94d2fc55c746fcb7c7ba2f8154e,0,0,0,0,0,0,0,0,0,0,0,0,0,0,68,13,0,0,0,0,0,0,0,0,0,100
410d9e199e224480e5fc46df16bf2aa3e807708e,0,0,0,0,0,0,0,0,0,0,0,0,0,0,69,14,0,0,0,0,0,0,0,0,0,100
6e53a4d652acc3e7ffc8a1978bac8090217af68d,0,0,0,0,0,0,0,0,0,0,0,0,0,0,70,15,0,0,0,0,0,0,0,0,0,100
1626b4cbe0991c15147fd8796ac0b41111642ae1,0,0,0,0,0,0,0,0,0,0,0,0,0,0,71,16,0,0,0,0,0,0,0,0,0,100
b4aa90e336466d3d48f2a36cd3d58d25a3f35e58,0,0,0,0,0,0,0,0,0,0,0,0,0,0,72,17,0,0,0,0,0,0,0,0,0,100
ea1c577e65d7c9d5000aa3ec3d5a2f445f43e807,0,0,0,0,0,0,0,0,0,0,0,0,0,0,73,18,0,0,0,0,0,0,0,0,0,100
03eb0c2a1b804363b1fa430b6dfd8336f66c602e,0,0,0,0,0,0,0,0,0,0,0,0,0,0,74,19,0,0,0,0,0,0,0,0,0,100
e5f5a3bd82dcfccc0e0a8646392840db642ce65d,0,0,0,0,0,0,0,0,0,0,0,0,0,0,75,20,0,0,0,0,0,0,0,0,0,100
f4f40ac9d6ab2c1f055cd7e44111297448a21ec7,0,0,0,0,0,0,0,0,0,0,0,0,0,0,76,21,0,0,0,0,0,0,0,0,0,100
e66a7bd0ed9d7a6186f1ba7feca5de817d7a58b7,0,0,0,0,0,0,0,0,0,0,0,0,0,0,77,22,0,0,0,0,0,0,0,0,0,100
58f38346052516cc11eae436ee027d4a09d6f8b4,0,0,0,0,0,0,0,0,0,0,0,0,0,0,78,23,0,0,0,0,0,0,0,0,0,100
02bd351e922fe054c0b723c44fae8b0a9455135f,0,0,0,0,0,0,0,0,0,0,0,0,0,0,79,24,0,0,0,0,0,0,0,0,0,100
8622138425f4ebb0a1c2a03a81b31e27faf7cc9a,0,0,0,0,0,0,0,0,0,0,0,0,0,0,80,25,0,0,0,0,0,0,0,0,0,100
6073bb29dfca8d40bdd65cbb833ff8ff2795af82,1,19,32,13,0,0,0,2,23,83,1,1,0,164,614,4,28,30,2,1136,1150,14,18,21,3,100
ad1416331ecd86960610cc6774caa5e1bcf109bb,3,75,31,44,0,0,0,1,7,576,1,2,1.538861509,121,615,5,23,19,4,1143,842,301,18,17,1,100
6cc884c4c6fbf0921424d4f895556d5d8957a337,3,108,11,97,1,0,1,3,15,231,2,3,1.208596212,306,21,0,50,43,7,3225,2651,574,12,10,2,99.9644634
bb54d455599d0ccd320673380e6186bed67e8f6a,4,309,16,293,2,0,2,1,2,46,2,2,1.0663627,94,141,0,54,14,40,2035,447,1588,26,10,16,99.71595952
86b3d6161c14fb63724323a1ee6802308bc6751d,1,14,3,11,0,0,0,1,2,0,1,1,0,201,142,1,36,36,0,1492,1473,19,14,14,0,100
697a8d7493be7f6f7d2dc670ce66a1a3db641900,5,101,2,99,1,0,1,2,3,18,1,2,1.388517398,196,143,2,26,21,5,1631,1039,592,18,14,4,99.80461812
5ea5a26a5da1fcd4436ff2cfa4d634602114269e,1,1,1,0,0,0,0,1,1,0,1,1,0,202,144,3,36,36,0,1492,1492,0,14,14,0,99.92887624
9e7dbb0a8a8127331f8c3342ad3be4b56ca0ba16,3,31,8,23,0,0,0,1,17,290,1,2,1.361250403,492,616,2,117,111,6,3155,3065,90,71,71,0,100
c242e523dcb20dc9585580bfc5d8b459217160fd,0,0,0,0,0,0,0,0,0,0,0,0,0,0,81,21,0,0,0,0,0,0,0,0,0,100
d77c389712f1ae0d4cc082faf55699d052e52d0a,0,0,0,0,0,0,0,0,0,0,0,0,0,0,617,3,0,0,0,0,0,0,0,0,0,100
939ac30b4b482bb3ae24dcf73c730dd1f9021615,68,279,241,38,0,0,0,2,78,149,1,31,4.996806226,8456,618,4,1474,1470,4,64125,64032,93,623,622,1,100
8974838b108b09e45ad9d738d54b6bc6f12e0346,6,454,10,444,2,0,2,2,51,201,1,2,1.41990079,899,619,5,140,122,18,6929,5504,1425,71,59,12,99.66329966
1f5c571a14f012acb0c2ba5d44f01f4b91b68ae4,1,15,12,3,0,0,0,4,72,132,1,1,0,447,620,4,108,107,1,3234,3186,48,35,35,0,100
5d90b588af177e3b468ec6b8e84dca981773858d,1,63,0,63,1,0,1,1,1,0,1,1,0,0,621,5,6,0,6,214,0,214,3,0,3,98.16214359
7cf21394342f2c491605204b2c23c4c8ec6ea4da,2,9,1,8,0,0,0,3,18,529,1,2,0.721928095,142,352,0,29,27,2,1121,1094,27,16,14,2,100
a59f6f8c5144f9d94b183c16ecfb72ebbf9491d8,2,24,1,23,0,0,0,5,18,140,1,2,0.634309555,793,353,1,58,57,1,6777,6628,149,31,30,1,100
54085a14150ff205860af7400628981475a7e52d,1,3,0,3,0,0,0,3,8,836,1,1,0,32,354,2,6,6,0,180,180,0,4,4,0,100
a2bb4115d2d234e90ec3be9192f8b57d5a580213,1,2,0,2,0,0,0,4,10,836,1,1,0,38,355,3,9,9,0,229,229,0,5,5,0,100
15c61ee24bcd381f3d34650f61a95dbe59c1a417,1,2,0,2,0,0,0,3,9,807,1,1,0,8,356,4,0,0,0,70,70,0,0,0,0,100
706ffc2e9b66b7856c37cd7cefefe90c22cdf56a,1,1,1,0,0,0,0,5,20,140,1,1,0,198,357,5,21,21,0,2042,2042,0,3,3,0,100
ae8259169fc77e5a04c38935e2ae2a9561f77de4,1,1,1,0,0,0,0,2,10,124,1,1,0,244,10,0,29,29,0,1880,1880,0,11,11,0,100
1c761e024dcf32ec25c6296b6c52f51d87773742,1,1,3,2,0,0,0,2,9,151,1,1,0,216,150,0,47,47,0,1413,1425,12,28,28,0,100
58fd277b2a697fe09cc092c0f180576de15f0aa3,57,223,197,26,0,0,0,2,79,149,4,42,5.239614676,10448,622,2,1394,1392,2,88977,88984,7,616,614,2,99.96656637
07d604f2c4fdcd67dd0463e5867d01abaf420090,2,26,22,4,0,0,0,2,19,87,1,2,0.842657877,765,11,1,80,88,8,6622,6703,81,34,33,1,100
58d9bf0fdb63bfc40f13a651814e46024544b502,1,54,0,54,1,0,1,1,1,0,1,1,0,0,12,2,1,0,1,439,0,439,1,0,1,99.67986521
bade960ad6b0b51335cab2ffef9702ef9affe46b,2,207,0,207,2,0,2,1,1,0,1,2,0.781281209,0,623,3,25,0,25,807,0,807,22,0,22,98.14429414
5e4edb71a094cbf969f5629915c2ed3b8716b6ec,1,7,0,7,0,0,0,2,16,163,1,1,0,225,624,4,45,44,1,1504,1489,15,22,21,1,100
e767bb623ab4c841918ce6590f09b534f3d1ba0b,1,1,1,0,0,0,0,3,12,553,1,1,0,22,13,3,1,1,0,32,32,0,1,1,0,100
a12e609eb50890998d0ecc48e57916d7fdb92ed6,1,1,1,0,0,0,0,5,20,166,1,1,0,223,14,4,49,49,0,1794,1794,0,20,20,0,100
e92c694e8d2cca1dcaaddb36f0200f27d21e28df,0,0,0,0,0,0,0,0,0,0,0,0,0,0,15,5,0,0,0,0,0,0,0,0,0,100
9bd4f80752eeb7f4a5853499229b29a6fb24ee32,8,167,18,149,1,0,1,1,28,119,1,5,2.843847478,848,625,5,159,143,16,7203,6532,671,101,94,7,99.92926614
49aca6b9fe5c1c4ee8005cd8e1370b9d1817dec5,3,95,7,88,0,0,0,2,29,289,1,3,1.562564004,437,16,5,64,57,7,4502,4046,456,38,34,4,100
cf12948b2c48dab276264c3a3667bc2088bfc677,4,17,2,15,0,0,0,1,12,343,1,4,1.739954647,380,626,4,115,113,2,2407,2338,69,40,38,2,99.20536818
c31a625a813efe311f4c345f364db91db365daae,2,25,4,21,0,0,0,1,10,244,1,2,0.735508582,196,145,0,34,32,2,1609,1446,163,13,12,1,100
614fc76a6c650a617662f06450b52c2de30d35f0,1,24,4,20,0,0,0,3,3,587,1,1,0,155,31,0,21,19,2,1546,1364,182,9,9,0,100
f77c2559b8fefc40c06a7090d20af00afd1e41a0,4,82,78,4,0,0,0,1,4,198,1,2,1.229477667,348,627,1,50,50,0,3030,2986,44,21,20,1,100
bbb43bda144803b5c8a306324aaee7a1a27d7822,17,35,34,1,0,0,0,2,32,173,3,11,3.856581298,3076,628,1,603,603,0,23293,23335,42,240,240,0,99.42989489
d8a7b9163f7176aa7185319b6917eae1c87e8383,1,2,1,1,0,0,0,2,20,0,1,1,0,77,629,2,20,20,0,676,676,0,5,5,0,100
04a0324f309e8a30aa1d0a1f11489d9a4c93cfb8,25,77,90,13,0,0,0,4,80,367,2,16,4.277475357,3392,630,3,430,429,1,28217,28281,64,194,193,1,100
d7a490a9fd59b47679e6d3d0248f4e79d639e1ff,4,44,39,5,0,0,0,3,15,32,1,1,1.42517004,682,631,4,94,94,0,5109,5078,31,55,55,0,100
02f8694d044b85938a56f48444743f367987ad37,26,874,255,619,1,0,1,5,20,260,3,6,4.175382446,2699,146,0,584,488,96,23073,18849,4224,334,284,50,99.96409336
c1471da87a12878970eea447df9eb8bb32f2491a,1,3,2,1,0,0,0,5,14,152,1,1,0,127,151,0,39,40,1,1131,1131,0,6,6,0,100
0ac86361e072ce60b5294f73f2825fca8b313752,8,120,48,72,2,0,2,1,31,137,1,3,2.747578165,506,17,0,85,84,1,4291,4070,221,43,40,3,99.67753493
7892be34c11990b514b3e24237b04b5116efc2d3,11,919,260,659,9,0,9,1,18,83,2,4,3.309396917,217,18,1,82,35,47,5898,1765,4133,47,20,27,98.33094042
d29a980d71402b3e9b7e3f408cc19a59a6037689,1,66,58,8,0,0,0,4,4,55,1,1,0,172,152,1,22,21,1,1602,1546,56,10,9,1,99.94603346
50a76b61a210c1b409d01c0b2b02a03856da940d,1,8,1,7,0,0,0,2,34,169,1,1,0,230,632,2,49,48,1,1699,1684,15,22,21,1,100
85ec3a32bfd7b337c8cd45aecac7494c429c462f,119,444,10161,9717,0,0,0,4,25,339,4,36,5.353039043,19958,633,1,2652,3826,1174,108525,147998,39473,982,1362,380,96.71652682
5bde30b43928038e36386f77e39acb63b9005b2b,1,432,0,432,1,0,1,1,1,0,1,1,0,0,634,2,83,0,83,2609,0,2609,18,0,18,99.96297668
5a5765179fb8e97990f6a5b04bc018b7a9cee389,3,60,31,29,0,0,0,7,61,170,1,2,1.340170503,611,635,3,89,89,0,5861,5658,203,25,25,0,100
0c4bba06474f7d7b4d5e93ced45ea665b296fa75,1,3,1,2,0,0,0,4,73,165,1,1,0,450,636,4,108,108,0,3236,3234,2,35,35,0,100
1bed5fbdb46dc89a86e9b9d05dabde47517c3461,2,12,0,12,0,0,0,2,74,194,1,2,0.41381685,598,637,5,122,120,2,4423,4357,66,46,45,1,100
c0f3d944047ad6c32a129b02a28822e34cc781a4,25,105,68,37,0,0,0,2,25,385,2,11,3.796750187,2116,638,6,301,292,9,19060,18971,89,103,94,9,99.5601173
6bc7b7f3452fd717ced096e87e75fa7adaf16d36,1,21,12,9,0,0,0,2,9,145,1,1,0,582,19,2,51,51,0,5450,5341,109,28,28,0,100
234b35200c18e8a143a8f4005fc3ccfe66a48e30,7,383,78,305,0,0,0,1,30,475,1,5,2.375924973,1041,639,7,175,146,29,9875,7987,1888,60,51,9,100
237ace3aa6113adcfa4e8a8049157da4818611f4,3,24,58,34,0,0,0,4,22,471,2,1,1.183193825,380,640,8,105,105,0,2496,2562,66,56,56,0,99.92733878
af8ebde30992f66d7978a8f5278f9e895d39451a,1,61,4,57,0,0,0,7,49,321,1,1,0,109,641,9,13,11,2,1157,923,234,6,5,1,100
cfec62fa98be0545c3a01c8fd34b2744385e1786,1,3,3,0,0,0,0,3,13,15,1,1,0,229,642,10,30,30,0,2221,2221,0,4,4,0,100
da457338777808ee9c5b09d893f6bc76c79b6906,1,1,3,2,0,0,0,2,7,315,1,1,0,203,643,11,34,34,0,1237,1263,26,24,24,0,99.85517741
1eb917262f980798586c3cb9c54152dbb59485f9,1,1,3,2,0,0,0,2,8,0,1,1,0,201,147,0,34,34,0,1215,1237,22,24,24,0,100
711ab6074b5e4ccf8092e9204abe640901ea0411,2,199,6,193,0,0,0,4,8,394,1,2,0.958385815,70,148,1,35,14,21,1936,640,1296,13,8,5,99.90982867
ebaa95d2ab70eab6a9587afabe554e4fe7b84426,3,114,30,84,0,0,0,3,8,317,1,2,1.059047139,455,149,2,49,46,3,4040,3425,615,20,17,3,100
5baba6ec444157370bc9c999d3b8f374d9d7aea1,1,3,3,0,0,0,0,3,6,0,1,1,0,123,150,3,6,6,0,1151,1151,0,4,4,0,100
76da194b25659aab6bc5ac1ae0787376132c950e,1,18,22,4,0,0,0,3,19,316,1,1,0,128,644,12,29,29,0,1088,1059,29,15,15,0,100
41b0a8bc33964f7a1e5e186fd125cc53f1de2b52,1,27,18,9,0,0,0,5,15,54,1,1,0,128,645,13,43,39,4,1170,1131,39,7,6,1,100
347aaedee6f7ec1e7f7f115d08d060f1d436d1e1,1,1,1,0,0,0,0,2,3,161,1,1,0,72,153,1,6,6,0,480,480,0,3,3,0,100
0d4cb371d24fe83f3d52f5ea60269938c4d0ab70,2,36,5,31,1,0,1,1,16,0,1,2,0.759275785,137,646,14,44,43,1,1216,1170,46,8,7,1,99.92788895
b588af39baa033efac8eba809cc899d71b5a9280,5,143,69,74,0,0,0,2,20,277,2,3,1.597942921,412,647,15,81,74,7,3918,3097,821,34,31,3,99.92792793
de48f9f96207215bf0f7962d04d2a88da2717a14,1,11,7,4,0,0,0,2,7,81,1,1,0,133,648,16,13,13,0,1310,1275,35,6,6,0,100
f9406683539f5a3ecefa132ae7cb7c83e700d94f,2,17,18,1,0,0,0,5,15,97,2,2,0.775512658,265,649,16,67,66,1,1722,1623,99,56,56,0,100
ca920b35069f7433cc67353415de2b3780da15d1,1,3,3,0,0,0,0,5,43,283,1,1,0,274,650,17,49,49,0,2154,2154,0,18,18,0,100
e8b1acf8dc45ba764d6cd91c8b5e5d0a714faa1c,2,238,133,105,1,0,1,1,5,25,1,2,0.934428623,171,651,18,27,22,5,2106,1602,504,14,10,4,99.65716348
a9234ce16d6ba605747fc641302ce68aba303495,1,27,14,13,0,0,0,5,17,11,1,1,0,136,652,19,43,43,0,1170,1168,2,7,7,0,100
ba6e77f733659cec32d39c1f63cdeb69f3ee6ff6,0,0,0,0,0,0,0,0,0,0,0,0,0,0,52,0,0,0,0,0,0,0,0,0,0,100
495f736df90968b6f03ae2b050cd05ea8602fd5f,2,44,9,35,1,0,1,1,10,113,2,2,0.803715924,132,151,4,24,25,1,1031,848,183,14,13,1,99.90977986
d2915a0b38562de5b27f06e7a6ec5f6c35c9c06f,8,56,35,21,0,0,0,2,3,258,1,5,2.565571253,1055,653,16,100,99,1,8940,8810,130,32,31,1,100
f3723040d134b5a8d2739f1d7c9ffb6245679e79,11,4,1538,1534,0,0,0,4,20,55,3,5,2.097279502,2652,152,5,360,555,195,14446,20970,6524,79,121,42,99.72821163
d9ccec463c7f9ffc3c99f1e2e4eeaeee4bbb11bf,0,0,0,0,0,0,0,0,0,0,0,0,0,0,654,16,0,0,0,0,0,0,0,0,0,100
ad8b61d809b5fd15dea9ef031d14ec8055ab9a03,18,161,86,75,0,0,0,5,44,236,3,12,3.743299975,3406,655,16,452,452,0,29444,29004,440,175,175,0,100
b1d63885954bff8d804fce8ccdeef88b20a59ecd,2,24,7,17,0,0,0,2,24,34,1,1,0.938315352,511,656,17,46,44,2,3803,3735,68,17,17,0,100
977cc3995690858f7714fb587947ce9231dca06b,2,13,11,2,0,0,0,3,10,19,1,1,0.994984828,389,20,0,43,43,0,2987,2929,58,16,16,0,100
8bf7ac422adcbc74d6d8ebd87edc39caf4eac879,1,10,10,0,0,0,0,4,23,62,1,1,0,533,153,6,150,150,0,3997,4007,10,62,62,0,100
0b78318b2fbc0a8c6503cb4bca6cda581c8876a9,0,0,0,0,0,0,0,0,0,0,0,0,0,0,21,1,0,0,0,0,0,0,0,0,0,100
e04d6f329b74538370cf2656d532aee41fb9527c,2,24,19,5,0,0,0,5,21,66,1,2,0.271389588,810,154,3,60,58,2,6837,6774,63,32,31,1,100
84d667d8aec89664a2fe69532f30de3e0e44835a,1,4,4,0,0,0,0,5,22,0,1,1,0,741,155,4,60,60,0,6454,6454,0,32,32,0,100
3a0509f60a1cf5fb6dbd35911e51d2dad6214b68,1,1,1,0,0,0,0,5,21,193,1,1,0,223,154,0,49,49,0,1794,1794,0,20,20,0,100
75f8f0eb54fb2dcf3d6e2d3160b47a1089cdee80,1,7,0,7,0,0,0,6,23,252,1,1,0,45,358,0,8,8,0,392,392,0,2,2,0,100
9703584d0d86d8576bb02738fa31736d8bf3d8a6,6,95,81,14,0,0,0,4,17,371,2,6,2.438335186,388,657,6,62,66,4,3664,3656,8,31,34,3,99.2527793
672b6f9cf5e46175c78b277d8c07ac88de7308d8,1,4,4,0,0,0,0,3,14,370,1,1,0,168,22,0,34,35,1,1155,1176,21,22,22,0,100
306b285816c6d200e29ddc94bd13ade411978249,1,2,10,8,0,0,0,3,15,0,1,1,0,164,23,1,34,34,0,1143,1155,12,22,22,0,100
3c7136379aa22f900c7111175479be3c1d60b95b,4,293,0,293,4,0,4,1,1,0,1,2,1.96161236,0,658,5,29,0,29,1457,0,1457,16,0,16,99.70887918
8efcdac10686a5776a920a9d3cc3e184f847f147,2,30,3,27,0,0,0,2,3,446,1,2,0.884963636,119,22,2,15,15,0,1445,1177,268,5,5,0,100
a06f96c8a011bd2c9c0e572e3d965dc6f9325bd4,0,0,0,0,0,0,0,0,0,0,0,0,0,0,659,6,0,0,0,0,0,0,0,0,0,100
3a1adb7b5b84f5ea4ce2aee7ca99e55b459266d0,26,252,203,49,0,0,0,5,62,234,4,23,3.652254124,5152,660,7,964,952,12,38674,38341,333,415,411,4,99.90923943
7d656ca9ad1f5fab7d66fac8b3b11776135704c2,2,0,0,0,2,0,2,2,5,532,1,1,0,0,23,2,0,0,0,0,0,0,0,0,0,99.92737836
5a2a2562e8231d1c7e159023bb658d3f675612df,0,0,0,0,0,0,0,0,0,0,0,0,0,0,661,4,0,0,0,0,0,0,0,0,0,100
37d9cca5df12c5d6104038179f20e6d34aa58a74,2,129,62,67,0,0,0,1,2,126,1,2,0.317809429,205,24,2,35,26,9,2391,2029,362,19,12,7,100
75d18373ebd5ebf291ffcd58f2d51fc1ca2fe358,1,4,4,0,0,0,0,4,19,543,1,1,0,206,25,3,51,51,0,1297,1297,0,33,33,0,100
0b04779565a30f0e1e6debb6c2ce846fb1df1447,1,8,8,0,0,0,0,3,21,28,1,1,0,126,662,5,25,29,4,1075,1081,6,15,15,0,100
4ee6a1fbc4ffcf701582d75e5509f407ea371a8f,2,51,9,42,0,0,0,2,12,374,1,2,0.783776947,464,26,4,47,45,2,4792,4322,470,23,22,1,100
c181b9f5f0d9b8933f1b3bce9efd9ecabaa6a362,4,7,5,2,0,0,0,1,7,238,2,4,1.918295834,255,27,4,50,50,0,1730,1720,10,34,34,0,100
d2fe1ac3708c6aecf61858692f5b0f61789e3464,0,0,0,0,0,0,0,0,0,0,0,0,0,0,663,2,0,0,0,0,0,0,0,0,0,100
d61a0ee216389fcac1d3e56f531aa4cc8f597c59,104,568,617,49,1,0,1,4,81,240,5,56,5.70036175,16474,664,3,2791,2778,13,128186,128216,30,1045,1036,9,99.16500272
aadc0984ea019fcc79867386406d0c3bf1037ac7,2,14,57,43,0,0,0,2,4,432,1,1,0.838007851,117,665,4,16,19,3,746,891,145,7,8,1,100
43c059c7dec4d67a7cebac94356d7ee068c9e00c,1,9,2,7,0,0,0,2,24,347,1,1,0,156,666,5,28,28,0,1180,1136,44,18,18,0,100
530253de47fb45ec813f45109bb1036ff3f87cb7,1,44,0,44,1,0,1,5,5,1150,1,1,0,0,667,6,0,0,0,23,0,23,0,0,0,99.1085755
14bfc076eaa8a8af2484c95b0c8945f836256587,0,0,0,0,0,0,0,0,0,0,0,0,0,0,0,0,0,0,0,0,0,0,0,0,0,100
7a9e99ec4ac53d32d598b63412ee470fc8a03c2e,21,943,54,889,9,0,9,1,76,327,2,9,3.513346771,2183,668,5,508,410,98,19181,14758,4423,233,179,54,99.35382466
151de0d737501af5dcfee8a21bc7d18ff6edddc8,17,3594,0,3594,16,0,16,1,8,2,2,4,3.728809447,58,1,1,411,15,396,19336,325,19011,152,6,146,99.3947778
13bd3085ad83d08efe45ab4cb20f296ee9f8c7a5,1,30,27,3,0,0,0,1,2,0,1,1,0,19,2,2,4,4,0,186,186,0,3,3,0,100
75ea223e804ad6936976ef9ffd7947f45a690c75,4,123,58,65,0,0,0,1,35,657,1,3,0.67744751,229,669,4,46,39,7,2185,1947,238,14,12,2,100
f696d3635f390a514bd708ffa762486850f55ed1,34,404,22,382,0,0,0,4,27,299,3,12,4.132794182,5168,670,5,1188,1188,0,35334,34500,834,577,577,0,100
2f4ac68921f348abbebbb9e6434c9531972539a8,2,108,58,50,1,0,1,1,3,22,1,1,0.816017297,112,671,6,26,19,7,1323,939,384,11,8,3,99.93127148
3bfdd3a08ea71973c5f475ceec147079b8430890,1,10,6,4,0,0,0,2,4,3,1,1,0,131,672,6,23,23,0,1221,1177,44,8,8,0,100
07bfa59e5a3a359136e0c565564dfe769f3f84db,1,70,0,70,0,0,0,2,11,573,1,1,0,77,111,0,4,2,2,1504,870,634,4,2,2,100
d25dd2069df700169753952a2dec44879a5178c2,13,509,108,401,5,0,5,1,2,12,1,2,3.251532048,445,673,4,127,61,66,5506,2574,2932,67,30,37,98.46860643
17988ce5e65cf9668c68e2704620c82d5bd84817,7,167,14,153,2,0,2,1,2,0,1,2,1.92843889,314,674,5,68,53,15,3080,2331,749,32,26,6,98.93437077
f5bb6b7eadaf63e07a79e5c13a1cbbe59576538d,14,338,18,320,0,0,0,5,66,463,1,5,2.813669399,1903,675,6,309,275,34,16996,14610,2386,194,173,21,99.77936185
c4550a1812cbb5a8f6db8250c604635527bfd538,4,31,15,16,0,0,0,2,2,40,1,2,1.418892573,574,676,7,72,69,3,4886,4842,44,25,23,2,100
9ceb0970e01ca74cd0ea2bf030d60291cd603d52,1,2,3,1,0,0,0,1,2,41,1,1,0,18,677,5,3,3,0,126,146,20,3,3,0,100
a25bab20fbd704726013b64d93a965763ffb04ad,6,7,8,1,0,0,0,2,54,271,1,3,2.523231429,1058,678,6,131,131,0,6771,6785,14,73,73,0,100
c4597cb82df23157764baed7f8944f713316e75f,3,172,3,169,2,0,2,1,8,169,1,2,1.181138723,61,679,7,24,13,11,1263,332,931,19,11,8,97.28889656
baa399cd2361dd4c6b5ca5a0357f9b18376d35af,3,283,0,283,2,0,2,1,27,14,1,2,1.029430921,504,112,1,111,92,19,5539,3833,1706,16,13,3,99.92975061
58fb7c5df98097318453db2cb7e7b413a4749719,1,3,7,4,0,0,0,3,3,5,1,1,0,102,28,0,9,9,0,971,1007,36,3,3,0,100
6aa2bdbd288919f6ac2c97feae8a066b921c0150,6,126,34,92,1,0,1,1,49,401,1,4,2.134722119,698,29,1,52,48,4,6080,5532,548,17,14,3,99.78906662
466f319cead11e9733dbfd0d25a343627e102aad,6,393,133,260,4,0,4,2,8,45,1,2,2.445036186,249,32,0,45,27,18,3578,2102,1476,28,14,14,99.82422218
af775ba7dd35ba27f836de39a2610c1c1e82afde,9,1415,0,1415,9,0,9,1,1,0,1,2,2.981217797,0,30,2,157,0,157,8571,0,8571,87,0,87,99.09675178
763433cd756da7fda62e1fe6ee60a52f2c8d5221,2,130,0,130,2,0,2,1,1,0,1,2,0.997266543,0,156,0,9,0,9,540,0,540,6,0,6,99.91410411
bdacb9a41ec7c5acc53b606ff63d2e2bea47dc5a,1,16,0,16,0,0,0,2,2,6,1,1,0,67,359,0,8,8,0,598,598,0,6,6,0,100
747dfa4eda826821c2df5c99cd1d587ccb4011b4,9,401,24,377,4,0,4,1,25,165,1,5,2.870049189,309,360,1,85,48,37,4264,2591,1673,36,17,19,99.82864976
c36923f525ef9be0f6e11e71bc892c52734b7b99,4,741,0,741,4,0,4,1,1,0,1,2,1.831237721,0,361,2,60,0,60,4646,0,4646,22,0,22,99.82923497
f29a874f803f76c090c55db9ef02a85113773964,8,17,278,261,0,0,0,1,31,429,1,4,2.505118558,754,680,7,90,121,31,5001,5881,880,33,55,22,96.78435273
dec61dee27807815b9308b75213f067a53c81f32,0,0,0,0,0,0,0,0,0,0,0,0,0,0,3,0,0,0,0,0,0,0,0,0,0,100
b0ac9f5178fe52ed4b7e82feb610ffcb1417da48,2,23,8,15,0,0,0,1,2,64,1,1,0.554778163,265,4,1,44,39,5,2318,2188,130,11,11,0,99.95165968
39386b2bbfb0b6f0e0d360d262be714f86337009,12,25,587,562,0,0,0,2,26,365,1,8,2.656596115,1304,681,8,100,187,87,8195,11702,3507,25,54,29,99.79066023
00e3d8f9f8141d438edc817b64c8bc4ee667245b,2,3,3,0,0,0,0,2,18,164,1,2,0.918295834,106,31,3,15,15,0,827,827,0,10,10,0,100
a13b4b7fae76062d7db63aebbde750fce6daed70,182,3072,3334,262,14,0,14,4,82,244,3,94,6.734134078,23539,682,9,3060,3111,51,197574,200860,3286,1255,1230,25,94.9955973
a116dc7085f78ae025a7d13c0ff078a1c71f3f4e,3,149,1,148,2,0,2,1,2,261,1,3,1.066686925,29,683,10,15,3,12,946,262,684,12,3,9,99.93273241
be09d7347223baab6bc217502661e4caa69de3a4,5,194,18,176,0,0,0,2,19,167,1,2,1.788551895,774,684,11,114,100,14,6980,6047,933,70,60,10,93.9361863
2feae277d324ec985d93624a4f34f66813e53007,1,105,10,95,0,0,0,3,14,1,1,1,0,654,685,12,137,123,14,6600,5986,614,16,15,1,99.77547496
62b237759d5f37a0b1400655248ff4c7428e3d3e,2,3,3,0,0,0,0,2,5,0,1,2,0.918295834,264,686,13,26,26,0,2247,2243,4,8,8,0,100
b16c26072da5828e6b9a05a882da838463a8f2a6,48,263,248,15,0,0,0,2,40,140,4,28,4.836331225,6031,687,13,790,791,1,52976,52977,1,397,398,1,99.94828478
d023fad1ab0f9443a4d67f8924a42907d1616940,4,196,116,80,1,0,1,3,20,300,1,2,1.619306511,202,688,14,32,26,6,1874,1469,405,18,15,3,99.96555288
e23728debd770f4710d9455c5bb6117b3d864ff9,38,753,117,636,5,0,5,2,32,342,2,15,4.282965851,2874,32,4,532,479,53,26220,22426,3794,269,236,33,99.55303421
2d2e58631ae92e4e989f3114c3e37a033c003983,4,2,281,279,0,0,0,4,26,278,2,1,1.183016375,251,689,12,11,28,17,1292,2083,791,3,11,8,99.87966306
281156e2c3a5a768f5fe70db3dd1e6bcd9edf152,3,14,53,39,0,0,0,2,3,7,2,2,0.85721853,262,690,13,10,20,10,1517,1662,145,4,7,3,99.93114133
3d4e6f287302a1d1e6371688829a2c007f971592,13,230,89,141,0,0,0,5,34,266,3,9,3.138458863,2931,49,0,644,617,27,24468,23476,992,185,174,11,99.16036944
4b30ce3d047911e9f6a9924a2ad6ea625f2c99b8,0,0,0,0,0,0,0,0,0,0,0,0,0,0,5,2,0,0,0,0,0,0,0,0,0,100
0681eb11afbe12e512e0c475ef3e76018500c6a9,12,37,26,11,0,0,0,7,83,81,2,6,2.941854008,1481,691,12,151,150,1,11558,11536,22,56,56,0,100
35032b8b4e08e8873ac02d96cb2a63f5b19daae3,57,458,1970,1512,1,0,1,2,68,224,4,24,4.837100238,11346,692,12,1657,1768,111,82034,93443,11409,926,1003,77,96.77814743
375e080d1f9b53631b55a40cdb88850d859677f9,1,2,0,2,0,0,0,3,18,16,1,1,0,182,24,0,32,31,1,1416,1410,6,20,19,1,100
75d76fdf94a30adbf43c0ab97261891abe7e8db8,0,0,0,0,0,0,0,0,0,0,0,0,0,0,693,13,0,0,0,0,0,0,0,0,0,100
05a29c3f08b8f938e98c00703588db145d09f6f4,0,0,0,0,0,0,0,0,0,0,0,0,0,0,362,3,0,0,0,0,0,0,0,0,0,100
4641c87ebc5e8cd9d2764b6a17445d6ce7dc3997,9,39,134,95,0,0,0,4,23,6,2,8,2.85561083,861,694,14,88,105,17,6998,7645,647,49,56,7,99.49085423
208aa074f35c0c0143f9ad00b7f0056299b80eba,40,134,130,4,0,0,0,2,69,79,4,26,4.807278111,5906,695,15,912,919,7,47582,47865,283,483,485,2,96.56786271
ad17b0d1f00bea5f1932ce3d8f2170120e29d4f2,9,209,220,11,2,0,2,2,55,142,1,5,2.400910687,1076,696,16,138,148,10,6923,7131,208,75,76,1,96.55291279
c8e77d84ea952b1e0d17164e8aa0ddd5fbed039f,1,4,0,4,0,0,0,3,9,22,1,1,0,57,82,0,8,8,0,495,495,0,4,4,0,100
abff05e2a13cb88d4d4628062d2bbf02df058b08,0,0,0,0,0,0,0,0,0,0,0,0,0,0,83,1,0,0,0,0,0,0,0,0,0,100
c439f53c74d6c8589ced4c89c1a312bbf70d8d62,7,731,13,718,6,0,6,1,3,7,1,2,2.419020016,50,33,2,89,8,81,4142,399,3743,46,2,44,99.6645546
105be3e11b0bc426879dd3ea1f9bcb30adbfdd4f,0,0,0,0,0,0,0,0,0,0,0,0,0,0,84,2,0,0,0,0,0,0,0,0,0,100
6063d3f5927847c6200793beb798a7d30df5b811,0,0,0,0,0,0,0,0,0,0,0,0,0,0,85,3,0,0,0,0,0,0,0,0,0,100
554f434158d7adffdb8d41b88166a5d15ddee724,1,1,0,1,0,0,0,5,25,456,1,1,0,57,155,0,11,11,0,485,479,6,4,4,0,100
328a543e60954f3e7c83a58af55d15d76804991d,4,26,2,24,0,0,0,6,58,158,1,2,1.574417427,727,156,1,103,101,2,6413,6279,134,39,38,1,100
80366ee59bc003a5cf18910340bd3d2a08d87de5,101,1107,2366,1259,4,0,4,1,48,190,4,49,6.010813251,11349,697,16,1750,1932,182,82518,87054,4536,744,875,131,91.14983769
9af07ed974ec639518d6980448ab892c6c120908,11,1030,636,394,0,0,0,7,54,318,2,6,2.746318315,1357,157,2,171,159,12,13740,12662,1078,88,82,6,100
ce284d8f2cd8e9ad9901c8ee9f8e277e2dc17858,2,93,6,87,0,0,0,2,21,19,1,2,0.872475205,435,50,1,67,61,6,3777,3205,572,40,37,3,100
fb7dd583e70de55c491b5582ea843faa0e89dfdb,10,16,433,417,0,0,0,2,17,529,1,4,2.60366704,858,698,17,60,104,44,5791,7356,1565,28,56,28,99.77834072
bd5d2f30a93f7accbf019c34e88ed47cfea0fa64,4,547,0,547,4,0,4,1,1,0,1,2,1.94458705,0,34,3,31,0,31,3590,0,3590,16,0,16,91.42647329
f3a9cc138cf2e4e64436d24eda06d32d335aff85,51,352,319,33,1,0,1,5,49,199,5,36,5.082420236,7067,699,18,1122,1129,7,57393,57939,546,436,437,1,99.67355822
11afe576b256b9b44229348cddfadaddbb359f0f,4,66,19,47,0,0,0,3,21,113,1,1,1.647496671,242,700,19,42,37,5,2413,2164,249,23,20,3,100
471cb81754b3f377abd077efd57f9ae9e1978f68,1,8,0,8,0,0,0,2,2,14,1,1,0,192,701,20,30,29,1,1764,1728,36,12,11,1,100
f147e17328f402f6a6580878a3a772ed298f2dae,0,0,0,0,0,0,0,0,0,0,0,0,0,0,702,17,0,0,0,0,0,0,0,0,0,100
82f941298bad7760b61485d029590efd6994b43d,3,37,50,13,0,0,0,4,23,332,1,2,1.18151931,152,703,16,17,19,2,1244,1280,36,10,12,2,100
d8ac693133622ba28da15d54bf0d5400697242dc,3,26,14,12,0,0,0,2,22,20,1,2,1.141153528,745,704,17,95,95,0,5603,5469,134,57,57,0,100
4e75f777e8ecebf0fc36cdebc5b62e1ca9d68413,5,8,8,0,0,0,0,4,26,473,1,2,2.155639062,468,705,18,78,78,0,3757,3779,22,43,43,0,100
84f17ae48ddeaf6de637d839e4625aa32484fd00,6,387,6,381,4,0,4,1,22,24,1,2,2.38798882,111,35,2,50,14,36,2612,903,1709,29,11,18,100
bd368539913733904e9ca74c19c726258f2c3bbe,1,125,121,4,0,0,0,7,55,20,1,1,0,291,706,17,26,28,2,2388,2649,261,12,12,0,100
3218e951e55dea4d2cb984be697f39bb70e82a36,102,835,742,93,0,0,0,2,84,92,3,59,4.735099934,15668,707,18,2416,2413,3,128880,129086,206,862,857,5,99.89128071
172bb3bd8c83c45ba50a255621ddade9c8e8d1af,24,578,147,431,5,0,5,3,51,233,3,7,3.474834769,1782,158,3,328,287,41,15362,13559,1803,197,178,19,90.22633745
8049eff6dd48dc2621219c51e1eef97dd62165c8,1,254,0,254,1,0,1,1,1,0,1,1,0,0,159,4,20,0,20,2077,0,2077,17,0,17,99.95756719
ff31f377268456d212763b9c60d9205acd3ab1ba,1,1,1,0,0,0,0,3,14,24,1,1,0,257,708,17,28,28,0,1950,1946,4,11,11,0,100
c03322867930e5a9a40f19035eaf4d3cd26dafe2,1,13,15,2,0,0,0,3,19,39,1,1,0,183,709,18,31,32,1,1401,1416,15,20,20,0,100
6ad3e135004f695f0a795cadf09d39f4a1b74bbb,1,6,1,5,0,0,0,1,3,24,1,1,0,70,710,19,9,9,0,526,483,43,2,2,0,100
a581a13a5f3dc5688e231392dad652af1bcd6376,1,23,1,22,0,0,0,1,4,1,1,1,0,74,711,20,12,9,3,643,526,117,3,2,1,100
b479bd27035f0222df7176816afde0b14cfe4418,6,240,239,1,0,0,0,1,5,0,1,2,1.279893178,859,6,0,109,99,10,7134,6127,1007,39,33,6,97.1050698
3e276bb4a8855734fa440845e75c9376b7a5cdcb,1,1,3,2,0,0,0,2,6,0,1,1,0,73,7,1,13,13,0,525,529,4,5,5,0,100
afc8abbd70f2a3c5df25ef06d4b7e52572eee280,1,2,1,1,0,0,0,2,8,23,1,1,0,224,712,18,38,38,0,1619,1609,10,16,16,0,100
933e22a2afa9bfe6a38f1f33d6adb0cee6cc38aa,16,278,152,126,1,0,1,2,41,45,2,5,2.995558566,1220,160,5,226,210,16,8506,7836,670,154,146,8,99.90821478
a3b93795bb530d9be3f7b3c2dfac8e89a6a980e2,3,97,11,86,0,0,0,4,21,40,1,2,1.215690382,206,157,0,34,23,11,2125,1618,507,13,10,3,100
0e23821df0e1b0e17d1ed7b196ed5185f6d2db33,1,53,10,43,0,0,0,2,7,7,1,1,0,71,8,2,16,13,3,619,525,94,6,5,1,100
3ffddc56c4d954ae8c03fb41f8cf8290467266b0,2,68,0,68,2,0,2,1,1,0,1,2,0.923119984,0,158,1,8,0,8,418,0,418,4,0,4,97.26734477
9c5a1f8e7a296438291a55ca58441045d1e75b0d,1,25,15,10,0,0,0,5,37,46,1,1,0,339,161,6,23,23,0,3286,3242,44,13,13,0,100
a4fc290a53eb512487388ff87d52569aa8adacc7,1,6,1,5,0,0,0,6,50,29,1,1,0,241,159,2,43,42,1,1868,1851,17,18,18,0,100
691bf8e65a6fe348019acc637a648b1976ceef99,1,0,9,9,0,0,0,6,38,0,1,1,0,346,160,3,23,23,0,3241,3286,45,13,13,0,100
57472918a320e2c4b2c011a875ecc5ad8591a620,0,0,0,0,0,0,0,0,0,0,0,0,0,0,713,16,0,0,0,0,0,0,0,0,0,100
15712a6eda44b04cb52e61ac04a779848f9485c1,11,92,44,48,0,0,0,4,22,0,3,6,2.928639807,725,714,17,97,97,0,5328,5357,29,43,43,0,100
642d48ff0be783668753fbc0e06a32a6f03aea09,1,2,2,0,0,0,0,2,9,154,1,1,0,65,715,18,9,9,0,387,387,0,9,9,0,100
ece4db69918406abb86c65cd422d3f9edf71be24,16,19,1175,1156,0,0,0,3,71,60,3,5,3.465284957,2570,716,18,157,283,126,15610,21638,6028,82,183,101,96.8373494
8205dae408407f764e8f7bdfaa66feae7c94b32c,0,0,0,0,0,0,0,0,0,0,0,0,0,0,86,0,0,0,0,0,0,0,0,0,0,100
0e3f35da37442d6dd451d355290aafb651805995,0,0,0,0,0,0,0,0,0,0,0,0,0,0,87,1,0,0,0,0,0,0,0,0,0,100
fcd0f0ed5659e4946289e8f34f38f06d9333614c,0,0,0,0,0,0,0,0,0,0,0,0,0,0,88,2,0,0,0,0,0,0,0,0,0,100
3cf3f3056efc271af60e83107212115eeae52f68,0,0,0,0,0,0,0,0,0,0,0,0,0,0,89,3,0,0,0,0,0,0,0,0,0,100
f879fca57d41cb16830f8ad5a5202e38536238ad,0,0,0,0,0,0,0,0,0,0,0,0,0,0,90,4,0,0,0,0,0,0,0,0,0,100
1d21076b4a67367f912de6762b4b4723b76cc4c4,0,0,0,0,0,0,0,0,0,0,0,0,0,0,91,5,0,0,0,0,0,0,0,0,0,100
d78e18637e66d1e5d25a036653a2ecaa92363fb5,0,0,0,0,0,0,0,0,0,0,0,0,0,0,92,6,0,0,0,0,0,0,0,0,0,100
dafeaaa6406c0f2b1ac6d5ca61ebc20ae114fcc1,0,0,0,0,0,0,0,0,0,0,0,0,0,0,93,7,0,0,0,0,0,0,0,0,0,100
a6f66312ac183a70a84c8867dc6c967d215cdfaa,5,63,14,49,0,0,0,3,30,405,2,3,1.181886083,1070,51,0,256,249,7,7407,7138,269,105,102,3,100
5d14fc9bbf18cf7ef645f4a397aef18410f02c70,2,6,7,1,0,0,0,4,25,36,1,2,0.961236605,449,52,1,54,56,2,3288,3302,14,29,29,0,100
39fe22402990d06f23a39cec18e74887ea5eb262,209,1023,1065,42,16,0,16,3,85,208,5,90,6.810743894,27724,717,9,5263,5287,24,204270,206637,2367,1984,1995,11,98.94419306
9ae4c2622ef2554bcce37353e48e511c16bf5df9,2,6,2,4,0,0,0,7,55,22,1,2,1,529,718,7,51,50,1,5074,5061,13,24,23,1,100
8f2373a4af29e51bba97def52f29ba56fce3f06b,1,3,4,1,0,0,0,4,16,0,1,1,0,91,719,8,14,14,0,658,664,6,5,5,0,100
8aecd6c6692856f92dc83119b2d2a0ebba36a0f6,0,0,0,0,0,0,0,0,0,0,0,0,0,0,720,7,0,0,0,0,0,0,0,0,0,100
a4778a48c6f21ab6a65189c737530c5e41ec75c8,14,150,150,0,1,0,1,2,26,226,3,12,3.520850562,1122,363,0,136,138,2,9000,8961,39,40,42,2,99.83378664
bb62dab20ac28605492d778e1642e6e4bc50f6ab,1,1,1,0,0,0,0,4,8,9,1,1,0,45,364,1,4,4,0,384,384,0,4,4,0,100
522ee0b5dbf30156745e9d66abb70149c4ec4cfb,14,817,242,575,2,0,2,6,40,71,3,10,3.402732591,1750,53,2,303,200,103,18820,15058,3762,149,105,44,95.8145137
f3609730fc992b310afe36f0fd08e4183bd53188,8,389,97,292,1,0,1,4,37,231,2,3,1.971413112,888,54,3,167,127,40,9674,7675,1999,63,49,14,98.54493581
4dd8881bff84519df3b90d8da3d4d53dea1f4b9b,6,308,111,197,0,0,0,2,13,58,2,3,2.487539831,746,162,0,102,82,20,7649,6260,1389,61,47,14,97.39923747
a6bdcbba056612ad4057e68c405527992e8a958b,10,166,169,3,0,0,0,2,38,4,2,5,3.155058897,1566,721,4,183,185,2,13064,13161,97,86,86,0,100
ec7c14065938798598bbb514fc5228156d8ae533,0,0,0,0,0,0,0,0,0,0,0,0,0,0,722,5,0,0,0,0,0,0,0,0,0,100
77fa3161a89df6a2bb8688b1c4a5f1b97a474adf,1,4,2,2,0,0,0,2,5,89,1,1,0,60,723,3,10,10,0,476,472,4,7,7,0,100
b50c396cbafc60bdaf98de9d2f3d409d4e75d376,0,0,0,0,0,0,0,0,0,0,0,0,0,0,94,0,0,0,0,0,0,0,0,0,0,100
804b46e093f9c0104a00f16f9a5305c8d7732125,0,0,0,0,0,0,0,0,0,0,0,0,0,0,724,4,0,0,0,0,0,0,0,0,0,100
a14fd1c1e44f7e330809887a1e2f6e1b69f1137b,0,0,0,0,0,0,0,0,0,0,0,0,0,0,725,5,0,0,0,0,0,0,0,0,0,100
99b0f5429c482ba1af411d1a6c0e24567346143c,0,0,0,0,0,0,0,0,0,0,0,0,0,0,726,6,0,0,0,0,0,0,0,0,0,100
4cb42512b71cc1d410c0b438d4b0ca80864daa5e,0,0,0,0,0,0,0,0,0,0,0,0,0,0,727,7,0,0,0,0,0,0,0,0,0,100
7ecf707b3e27fd665d74419957dade54755b57b4,0,0,0,0,0,0,0,0,0,0,0,0,0,0,728,8,0,0,0,0,0,0,0,0,0,100
cbb1ad8c8a205ee543c6874aeaf7773d33f41fd2,0,0,0,0,0,0,0,0,0,0,0,0,0,0,729,9,0,0,0,0,0,0,0,0,0,100
1bbc6a96210a8edbcc396268cd5d924dffdcb109,0,0,0,0,0,0,0,0,0,0,0,0,0,0,730,10,0,0,0,0,0,0,0,0,0,100
1deba16f7d1309e0981b3400ad96f46d77e08dbe,0,0,0,0,0,0,0,0,0,0,0,0,0,0,731,11,0,0,0,0,0,0,0,0,0,100
737249b0db7fafd150ac56ddc2bc1b465b12abb7,0,0,0,0,0,0,0,0,0,0,0,0,0,0,365,0,0,0,0,0,0,0,0,0,0,100
4510a3ce147f6947231ac19f384fe554a8a8f52b,0,0,0,0,0,0,0,0,0,0,0,0,0,0,366,1,0,0,0,0,0,0,0,0,0,100
fa42f721cdc0b0a5115ab38256378729b5760317,0,0,0,0,0,0,0,0,0,0,0,0,0,0,367,2,0,0,0,0,0,0,0,0,0,100
cef6f88628be1d93ac1cc307464d8329204710c9,0,0,0,0,0,0,0,0,0,0,0,0,0,0,368,3,0,0,0,0,0,0,0,0,0,100
fb171d41f9e36856285a0e8bde7c683a2c899a4f,1,14,8,6,0,0,0,3,3,153,1,1,0,32,369,4,5,5,0,327,299,28,2,2,0,100
fc0ecc2dfc137f0aa6c000064144ff98f447db25,0,0,0,0,0,0,0,0,0,0,0,0,0,0,53,0,0,0,0,0,0,0,0,0,0,100
691ed8e5eda676ec39dcb3ba12a956f50245ba65,0,0,0,0,0,0,0,0,0,0,0,0,0,0,732,11,0,0,0,0,0,0,0,0,0,100
b1f46d50240b2601e401939404bdbc7197572006,0,0,0,0,0,0,0,0,0,0,0,0,0,0,733,12,0,0,0,0,0,0,0,0,0,100
175b269dc6bd5243f3d6529132fbcc24af584da0,0,0,0,0,0,0,0,0,0,0,0,0,0,0,734,13,0,0,0,0,0,0,0,0,0,100
c02e98f2eeff25bce854133dbbe9de8579bbc634,5,5,5,0,0,0,0,2,15,104,1,1,2.321928095,410,163,0,39,39,0,3234,3230,4,20,20,0,100
55439df8c2b595c9cbe3f452d330dcd77e982ea4,0,0,0,0,0,0,0,0,0,0,0,0,0,0,735,13,0,0,0,0,0,0,0,0,0,100
a500c977d047d0955bf5dd830f558241c918e3c2,0,0,0,0,0,0,0,0,0,0,0,0,0,0,736,14,0,0,0,0,0,0,0,0,0,100
93b66b11b89965957970fce64e2d6cb12dbbc966,0,0,0,0,0,0,0,0,0,0,0,0,0,0,737,15,0,0,0,0,0,0,0,0,0,100
bebbd10e4276bd01256b75bbac262d5305264b2a,0,0,0,0,0,0,0,0,0,0,0,0,0,0,738,16,0,0,0,0,0,0,0,0,0,100
1292145799e70890d4898353e4f5279d0484c5b7,0,0,0,0,0,0,0,0,0,0,0,0,0,0,739,17,0,0,0,0,0,0,0,0,0,100
5d64fbce6cd194a90e26ca35f90f61c88e75135b,0,0,0,0,0,0,0,0,0,0,0,0,0,0,740,18,0,0,0,0,0,0,0,0,0,100
ac28cf4841459c785e4beee061cc350ce97c9838,2,3,2,1,0,0,0,3,16,175,2,1,0.970950594,364,741,9,88,86,2,2026,2011,15,62,62,0,100
a26d3b136f0c8b24904f062bfbc1d2b14448eac1,5,14,14,0,0,0,0,2,35,325,2,5,2.182005815,729,742,10,129,130,1,5556,5550,6,63,63,0,100
e37620bc847b7942384016749d43077c6a250caa,0,0,0,0,0,0,0,0,0,0,0,0,0,0,743,11,0,0,0,0,0,0,0,0,0,100
96d93d4325208fa4fe253d294e52e983dd798beb,4,11,9,2,0,0,0,2,26,99,1,3,1.638758681,654,744,12,86,86,0,5240,5212,28,39,39,0,100
efa6a1770ec807050c269c580bb08a6a7a5b481d,0,0,0,0,0,0,0,0,0,0,0,0,0,0,745,13,0,0,0,0,0,0,0,0,0,100
740db0320ad8fc1af0f3a79953aa74f175bd6fd7,0,0,0,0,0,0,0,0,0,0,0,0,0,0,746,14,0,0,0,0,0,0,0,0,0,100
96024a77ce7b2d271e4c84e185912189ec53bd4e,42,528,253,275,5,0,5,1,80,217,1,20,4.485334106,4372,36,0,731,720,11,34707,33438,1269,332,306,26,97.76430976
fad58fee36a45d473c6f919c9476f9f17e9c471c,2,161,87,74,0,0,0,5,25,135,1,1,0.037878947,219,747,15,35,24,11,2540,2148,392,19,7,12,100
6d38de26f5ac36fb07c2c3640d722f03620e23c5,1,0,214,214,0,0,0,3,13,878,1,1,0,158,748,16,0,11,11,0,1472,1472,0,4,4,99.87982374
0793ce4513a5f3f8b64da9d4d3ed6355edec46d5,1,55,62,7,0,0,0,2,5,92,1,1,0,171,749,17,43,43,0,1133,1139,6,21,21,0,100
304d6b3456cb983c441624f430186f47e1da5062,0,0,0,0,0,0,0,0,0,0,0,0,0,0,750,18,0,0,0,0,0,0,0,0,0,100
50fd693770212294b1c14eb9ec10324c7d99a303,84,1,2,1,0,0,0,1,1,0,1,31,0,9335,751,19,1175,1260,85,77302,94668,17366,530,504,26,93.39584729
466f8fe8672a32afd5174d29fef56e3c66f22dc1,1,6,0,6,0,0,0,4,17,7,1,1,0,140,752,20,36,35,1,1019,1003,16,12,11,1,100
e2620d31bab2ef08518d0fa0963de6ee87f6506e,1,852,0,852,1,0,1,1,1,0,1,1,0,0,753,21,105,0,105,4104,0,4104,37,0,37,99.97324773
c3fe242df3a9bd14a12014671cac30aad7c39dfe,6,30,1,29,0,0,0,1,24,838,1,3,2.554824039,532,754,22,110,103,7,3362,3230,132,78,72,6,100
5c9f8fb6e5c8330540c0c424d7fe122daa608c79,1,0,3,3,0,0,0,2,6,193,1,1,0,179,755,23,14,15,1,1461,1467,6,5,6,1,100
d608a88d95b4a7bfd5f32a24f0c0a5d5cf6f25cf,111,1125,816,309,0,0,0,2,86,106,3,71,6.029471596,18047,37,1,2380,2382,2,152770,151112,1658,919,919,0,99.95992519
e7b1934536bb9dc014a744406a7122e088f2a435,2,21,4,17,0,0,0,3,24,6,1,1,0.989587521,270,756,24,44,42,2,1976,1887,89,11,11,0,100
f5e773225fffa34ee6f1040c283fd81ef54b557e,5,26,20,6,0,0,0,1,3,0,1,1,2.085346679,302,757,25,33,33,0,2480,2461,19,21,21,0,100
623be86e5837ae0f5f9f84d9409eda4550c2308d,2,218,0,218,2,0,2,1,1,0,1,2,0.940840309,0,758,26,19,0,19,1212,0,1212,10,0,10,99.94660972
4ef41c7748e23e3dfc3c90d52092b92dcb088653,10,22,18,4,0,0,0,2,31,161,3,9,2.945461844,1625,759,27,180,180,0,14515,14474,41,63,63,0,99.81353223
96117d39eed51f10ee1300917f80abc32908d373,53,167,181,14,0,0,0,2,58,81,4,39,4.712629709,7607,760,28,1054,1060,6,61529,61835,306,515,519,4,100
4f85c156b15fa44ed1e7d3b62e0b5e0ac25058a2,1,1,1,0,0,0,0,2,6,764,1,1,0,112,761,29,27,27,0,664,667,3,9,9,0,100
9d93d27e94fe0a4753a35d27c9acd1429c1f45f8,1,2,0,2,0,0,0,1,2,1,1,1,0,558,762,30,105,105,0,4135,4104,31,37,37,0,100
d3ccbe045f29d260ad27bf364047b59b939b1805,8,48,40,8,0,0,0,1,32,44,3,8,2.412432816,874,763,31,111,109,2,7501,7405,96,38,37,1,100
1f672cb7befb8f6bf553fde8c87c7e6238c2ddd7,4,403,131,272,3,0,3,1,9,39,1,2,1.812713693,192,764,32,39,17,22,3469,2272,1197,26,9,17,97.74636058
b4c54009ee19014149b18941b4341297ccdab562,3,461,0,461,2,0,2,4,13,33,2,3,0.638433671,471,765,33,134,83,51,4714,2424,2290,94,68,26,99.92617747
0de31cb5d92f79abdf1f82b4b0a0847b5f8e757f,14,1368,906,462,3,0,3,2,62,132,3,8,3.325221691,2051,164,1,230,220,10,20369,19444,925,126,120,6,99.86733491
e4e7947ccb3b5260732ce044b7d0334b7547bef3,0,0,0,0,0,0,0,0,0,0,0,0,0,0,766,34,0,0,0,0,0,0,0,0,0,100
793a170399de40ec7da6bffa15e8aeb9368fbead,1,5,2,3,0,0,0,7,63,3,1,1,0,387,767,35,36,36,0,2788,2793,5,12,12,0,100
4ac06616432df2d08ba924d278c6c739dc3437c2,1,41,58,17,0,0,0,2,3,3,1,1,0,198,768,36,30,36,6,1922,1810,112,6,10,4,100
194986dc255b7486444a15867be9c736945b0dd8,1,0,80,80,0,0,0,2,5,825,1,1,0,47,769,37,0,10,10,0,367,367,0,7,7,99.97053624
055f4abec06d90e7fcc1c707768480a6902db877,19,20,20,0,0,0,0,1,18,331,3,14,4.221928095,2553,770,38,237,237,0,25040,25078,38,124,124,0,100
3f3cc8a2fff90017c16a26209556238b73cfeb0b,18,119,230,111,0,0,0,5,50,389,3,10,3.804076392,2254,771,39,219,236,17,18249,18408,159,156,147,9,100
5681bb0f11e29897635456c43603605169010ecf,0,0,0,0,0,0,0,0,0,0,0,0,0,0,772,40,0,0,0,0,0,0,0,0,0,100
6634dc9a3f6e9962457d4aa7843689d7ab218bc7,2,25,25,0,0,0,0,3,10,6,1,1,0.634309555,252,773,38,27,27,0,2078,2078,0,9,9,0,100
74f849b10c4d76281f31741a9cef48ceddcde123,268,914,1047,133,2,0,2,3,87,178,4,116,7.60311858,36839,38,2,5374,5674,300,304913,317375,12462,2196,2270,74,99.04115651
346c98c319c0fd978f8a0959d85452848e0e0bda,22,46,27,19,1,0,1,2,23,0,3,17,2.490045792,2400,39,3,333,330,3,18566,18649,83,139,138,1,96.94512813
fd730ff6025009ed25a50dc74f7bae2283ce5fd0,0,0,0,0,0,0,0,0,0,0,0,0,0,0,40,4,0,0,0,0,0,0,0,0,0,100
38616e010567870d39b9fd5ef7211ef348fdb29b,5,20,10,10,0,0,0,2,20,17,2,5,2.027877968,508,41,5,61,61,0,3965,3870,95,28,28,0,100
d497b6871e219622bff3a6d5b503b6d203e1861d,1,4,1,3,0,0,0,3,15,10,1,1,0,281,42,6,25,25,0,2469,2459,10,16,16,0,100
95743219fd99d1bed8241b9206293af6fa8fe7b2,1,2,1,1,0,0,0,6,23,14,1,1,0,120,774,28,11,11,0,992,981,11,2,2,0,100
507af7a6975bb795b7e3d60f67a7e75e4e247352,4,498,146,352,2,0,2,1,2,18,1,1,1.849827426,187,775,28,32,15,17,2378,1374,1004,23,10,13,99.45683248
70fb5a121258d375005b5c3c3d96786c363f708a,2,8,6,2,0,0,0,2,31,652,1,1,0.591672779,105,776,6,5,6,1,652,648,4,3,3,0,100
b51662be15e5fbce55e4c323c54fc064c0a65a50,0,0,0,0,0,0,0,0,0,0,0,0,0,0,777,7,0,0,0,0,0,0,0,0,0,100
a8df4a23aa6eaefea26d72a822b4710da991ea94,19,1534,11,1523,17,0,17,1,17,43,1,8,3.826249889,146,43,5,178,29,149,9611,1131,8480,119,13,106,99.4416607
a8fb97ebd61ff4a67fa32e063e0779bdc2d46396,11,26,360,334,0,0,0,2,53,182,1,5,3.051353086,1543,44,6,101,127,26,11073,12415,1342,45,63,18,99.92876478
fe9baebb217b04ca5764d5dc0eb927240c25f8e8,4,0,0,0,4,0,4,2,10,0,1,1,0,0,45,7,0,0,0,0,0,0,0,0,0,99.88587732
b79bc621ce888770c67e6e1facb8880976e2c5ec,1,0,1,1,0,0,0,1,2,0,1,1,0,82,46,8,8,8,0,752,763,11,5,5,0,100
b4f8b6b0a85ce825ba29a83539dbfc1f5b761d43,3,231,0,231,3,0,3,1,1,0,1,3,1.462639734,0,47,9,9,0,9,1388,0,1388,6,0,6,99.90012841
f9af45c30cbdac92f95e62b06d53334beef1b4e2,16,57,62,5,0,0,0,4,21,600,3,7,2.983798265,1142,778,4,136,137,1,10269,10334,65,63,63,0,100
ce3ca5ec278fc55b79491e3e3805957707e16b5d,6,135,119,16,0,0,0,3,21,66,1,2,1.177435342,615,779,5,68,59,9,6318,6099,219,23,23,0,100
a2c5df682f143a82fb726c1a556cfca35f0b1b47,4,351,2,349,2,0,2,1,2,2,1,2,1.160597612,115,48,10,43,13,30,3352,1140,2212,27,9,18,99.87175834
9101588c917614dc5ff9c589a7bb935042236d0b,11,30,22,8,0,0,0,2,26,150,1,6,3.144480768,976,780,6,120,120,0,7927,7778,149,71,71,0,99.95725887
d4d72203893ecada27dce2594b290f00462ca3cf,2,6,42,36,0,0,0,1,2,6,1,2,0.811278124,73,49,11,5,7,2,540,667,127,4,5,1,99.92872416
cb143232cecdeb309609edca7d073da8855bf0c2,4,120,33,87,2,0,2,1,2,32,1,1,1.85960203,64,781,7,18,10,8,585,371,214,18,10,8,99.87183139
b185cd5b34e9bddf5f7deac7c6af2032a1b37eb4,2,28,10,18,0,0,0,1,6,151,1,2,0.981940787,158,782,8,29,28,1,1265,1153,112,24,23,1,100
3d44c1ee288700b0a5ffd8aaf2f734cf4315de99,49,206,436,230,0,0,0,1,30,129,4,33,4.254135222,4260,783,9,648,671,23,32150,32921,771,305,311,6,98.57142857
a8689591e32c8c27d74f3b0caad34e42eea1af70,3,37,43,6,0,0,0,5,28,130,2,2,1.550999017,997,784,10,213,211,2,7563,7504,59,92,91,1,100
d0dbdfb7bb33326e6157cc69c0292a40dee1d10a,6,476,18,458,4,0,4,1,7,16,1,1,2.129714435,470,785,11,134,109,25,6709,3861,2848,39,30,9,98.60073144
5626e10584e3c29614aea84985f2d07daf9ce899,1,27,10,17,0,0,0,3,37,50,1,1,0,233,786,12,54,49,5,1749,1704,45,22,22,0,100
c3dfffa3f5b9d7cc060289aeaf4e980d5e1d6e42,0,0,0,0,0,0,0,0,0,0,0,0,0,0,787,13,0,0,0,0,0,0,0,0,0,100
e4cf2c733d38e11277c933701e7cb496e419cb14,1,5,0,5,0,0,0,2,8,547,1,1,0,58,788,12,7,6,1,276,263,13,6,5,1,100
e3fb0c4f3162fda964b6ad8658fb09702bc279d2,28,1055,819,236,13,0,13,1,18,155,1,6,4.325903724,913,50,3,136,136,0,9061,7800,1261,87,74,13,95.70515678
a5ec598b63138a5243e4a5895b53614d12de3400,1,0,0,0,0,0,0,1,1,0,1,1,0,151,51,4,25,25,0,1208,1208,0,14,14,0,99.91772933
91ff58708329ef6112e218458a7a36746fa91cdf,1,1,1,0,0,0,0,6,54,43,1,1,0,233,52,5,20,20,0,1853,1853,0,3,3,0,100
e43db6158f5cb97b2c67081144cece74153ab79f,6,43,51,8,0,0,0,1,28,25,1,3,2.375677881,700,53,6,110,109,1,5940,6012,72,57,56,1,100
e4dfc93f53c1fa923803e0dac96274f0351bcd6d,14,80,68,12,0,0,0,5,29,191,2,7,3.380264019,3349,789,11,683,675,8,27565,27411,154,294,288,6,99.89038093
82fb4016fa0c002a8753dc6f72b010da7122939d,6,17,16,1,0,0,0,3,24,66,2,5,2.484872048,791,790,12,110,110,0,5733,5722,11,47,47,0,100
b04eb0ed363ea438b498325bf0799f3fcc21dcd7,3,12,12,0,0,0,0,1,34,54,2,3,1.384431504,409,791,13,45,45,0,3541,3541,0,19,19,0,100
b722041e31c83db3935256bec94ed4c8120e7f1a,18,1179,0,1179,18,0,18,1,1,0,1,2,4.022130603,0,792,14,57,0,57,5068,0,5068,45,0,45,92.80418666
183fa8faea7b4011ab93025a2696aa1a380f1bf5,1,2,2,0,0,0,0,1,2,97,1,1,0,156,793,14,25,25,0,1149,1149,0,9,9,0,100
a515335bbe063f612c9c09b1e0360cc5848ad396,10,1187,74,1113,4,0,4,4,16,77,2,3,2.614575422,1017,794,14,250,126,124,13444,7071,6373,117,62,55,99.26401503
23722bcc7103b2253c1216aed934fa78271d3c64,14,44,40,4,0,0,0,2,24,31,3,9,3.371184769,1935,795,14,214,214,0,14978,14932,46,82,82,0,100
69e3a649a0580f0c02536fdb9a6a79a82821475f,7,618,2,616,5,0,5,6,32,42,2,7,2.087703267,684,54,4,208,165,43,8540,4550,3990,87,59,28,93.15717122
856f9dfc4804fde5aaccd125e82cd3bb596a3380,2,0,310,310,0,0,0,2,8,546,1,2,0.448204261,221,796,8,0,33,33,0,1097,1097,0,19,19,94.91830518
ccafd1a85c81a7fda05582f7149fda5d67c653ba,1,1,1,0,0,0,0,2,3,120,1,1,0,159,797,8,22,22,0,1477,1472,5,3,3,0,100
7c72dc4fe3d80a30d6daa9dc8b20973a176580b4,5,62,37,25,0,0,0,3,88,262,2,3,1.195863804,833,370,0,128,126,2,6250,6018,232,49,49,0,100
f580dbfeaab498faad78ac0314089d511caf9b28,1,97,0,97,1,0,1,1,1,0,1,1,0,0,371,1,17,0,17,505,0,505,8,0,8,99.97390397
63ccd5ab86f1b53b0ac780c678c7567a1471d95e,1,35,27,8,0,0,0,3,3,123,1,1,0,105,372,2,18,16,2,1186,1071,115,3,3,0,100
d10f7096b9decc15cad55f4d7fd46b4feb7bb88c,0,0,0,0,0,0,0,0,0,0,0,0,0,0,373,3,0,0,0,0,0,0,0,0,0,100
136942055bacc2a3d1db40f8654ec96391937080,2,26,5,21,0,0,0,4,10,66,2,2,0.770629069,384,374,4,78,75,3,2717,2500,217,55,54,1,100
efa490c12b86034a26c9534dd6c9459550da2e5e,3,388,0,388,3,0,3,1,1,0,1,2,1.578216141,0,375,5,35,0,35,2741,0,2741,9,0,9,99.83070712
e55ec3c0157b794e9d9058b974db50b19c8843e0,5,328,89,239,2,0,2,1,2,0,1,2,2.230903686,300,376,6,52,35,17,4248,2741,1507,15,9,6,95.97133973
d54c89bbfba59792741d052b7ea94cd2e93ae1d8,4,55,36,19,0,0,0,4,83,243,2,4,1.333860854,711,798,9,155,148,7,5880,5750,130,56,53,3,100
68f00b01edd76acb20a8bb0fbb1e43070c1bfab4,11,112,79,33,0,0,0,2,84,233,3,7,3.224976122,2872,799,10,571,559,12,19927,19741,186,269,259,10,100
b59e46855e589f31a5a6e831a90beeed34e03c89,25,181,242,61,0,0,0,3,44,36,3,14,3.44093857,2364,800,11,343,349,6,18832,19395,563,158,158,0,95.74413537
42fab8a4b13e8bbc3c675741d846eebd44900149,1,7,4,3,0,0,0,4,22,305,1,1,0,207,801,6,47,47,0,1262,1264,2,29,29,0,100
032d3ac2a35c77b5eb29e76a3cbbde6d85cc1707,7,328,199,129,0,0,0,2,64,127,2,3,2.206170872,1001,165,0,146,140,6,9079,8231,848,57,55,2,100
7da117daf6873ce275cf9b6bba58e45ecc33733b,1,12,3,9,0,0,0,2,3,147,1,1,0,60,802,6,3,3,0,491,512,21,2,2,0,100
3e720bc9cbafc163018f92695c374ca004cc13f7,0,0,0,0,0,0,0,0,0,0,0,0,0,0,803,7,0,0,0,0,0,0,0,0,0,100
ce3ac7947f5425437f449ee57205c124391cbded,1,458,0,458,1,0,1,1,1,0,1,1,0,0,804,8,55,0,55,2887,0,2887,29,0,29,99.97647612
3894b57af0239b00c82284d9d268acefa81c0461,2,1,5,4,0,0,0,2,6,227,1,2,0.650022422,248,805,9,30,30,0,2376,2382,6,6,6,0,100
62fdbb9e6323c4688fdbcc240a26beaa7c7d9736,0,0,0,0,0,0,0,0,0,0,0,0,0,0,806,10,0,0,0,0,0,0,0,0,0,100
a36831c085d42aedc28553106fa52082fe0adf32,0,0,0,0,0,0,0,0,0,0,0,0,0,0,807,11,0,0,0,0,0,0,0,0,0,100
7cd73f5662f19c4b2f007d6c6ebe51d51d97158b,0,0,0,0,0,0,0,0,0,0,0,0,0,0,808,7,0,0,0,0,0,0,0,0,0,100
ac6bab2209fd5cd203a29dd8be19c1097305e841,1,12,3,9,0,0,0,1,3,86,1,1,0,172,809,7,20,20,0,1327,1260,67,6,6,0,100
bbe149d4a79b85222f4a88cabb487dd99e0affb2,0,0,0,0,0,0,0,0,0,0,0,0,0,0,377,0,0,0,0,0,0,0,0,0,0,100
3088f5893b228dbbcccf0a8bfad7f2d06c6153c6,1,3,0,3,0,0,0,2,10,210,1,1,0,94,810,2,11,12,1,761,796,35,6,7,1,100
df391cadef65a655268873822bb32fdb8be93951,1,5,0,5,0,0,0,1,2,65,1,1,0,336,811,3,55,55,0,2919,2887,32,29,29,0,100
e10506d9cba0e4676a901836f0931ee0c7846c8e,1,4,6,2,0,0,0,2,5,359,1,1,0,106,812,4,16,16,0,893,886,7,6,6,0,100
ec1110272a81664a92cdd3d7916551a2565e3b43,1,3,0,3,0,0,0,3,5,100,1,1,0,260,813,5,45,45,0,2005,1999,6,18,18,0,100
5f76b2ae7567970adac579e34168cb18561aa847,0,0,0,0,0,0,0,0,0,0,0,0,0,0,814,5,0,0,0,0,0,0,0,0,0,100
48612cb8a4081a4c70e78fb84a255a59041f021e,2,18,2,16,0,0,0,3,6,95,1,2,1,286,815,6,44,42,2,2881,2835,46,6,6,0,100
cc8070905f4a9556fdd54cb7e9cf9ecc2c898d95,1,13,4,9,0,0,0,2,3,966,1,1,0,41,816,6,5,3,2,231,195,36,2,2,0,100
3a16b20f8ea42778d4203e789329c178f51432a6,5,17,13,4,0,0,0,1,6,313,2,4,1.238826429,435,161,0,73,73,0,2874,2974,100,46,46,0,99.88240828
318a0e8861b658726e4a4dba114a84e7a26a41c6,1,52,42,10,0,0,0,4,11,434,1,1,0,116,55,0,14,10,4,1079,962,117,9,7,2,100
c864d1f3ddce6ed42bc0b6871398462b77e9d58b,0,0,0,0,0,0,0,0,0,0,0,0,0,0,378,0,0,0,0,0,0,0,0,0,0,100
05abdd6a1e0bd90ed1c13d055ac228dfc8a59969,2,197,0,197,2,0,2,1,1,0,1,1,0.999089039,0,817,7,20,0,20,930,0,930,15,0,15,99.80004705
0b12c1c7c783aa74c37cc568686d3a126a3fb479,0,0,0,0,0,0,0,0,0,0,0,0,0,0,818,8,0,0,0,0,0,0,0,0,0,100
12659e1be565572466d20780a0f91c6b791cc7ea,2,47,4,43,0,0,0,1,4,206,1,1,0.999722648,106,819,3,16,14,2,1095,871,224,6,4,2,95.13039179
b7b518c5a85841b8019de3cd0b99804abfd6508b,2,10,0,10,0,0,0,4,30,440,1,1,0.721928095,623,162,1,149,148,1,4439,4410,29,61,60,1,100
21779d890a7c11002493849f62760e73287b5c9e,6,863,0,863,6,0,6,1,1,0,1,2,2.416751086,0,163,2,91,0,91,3245,0,3245,71,0,71,96.66962138
1593176db998dc5c62017c61c4d5c8f86de24cd3,1,2,2,0,0,0,0,5,21,175,1,1,0,557,164,3,109,109,0,5304,5302,2,58,58,0,100
9bdd41d9bdc60ad1f6d48671b1a341c33f02b8a7,1,1,1,0,0,0,0,3,8,1018,1,1,0,225,165,4,31,31,0,2412,2412,0,14,14,0,100
5212d25bd0b371bd2fab261d8bcf722b3eb0b50e,2,28,15,13,0,0,0,3,8,535,1,1,0.952265625,617,166,5,154,154,0,5139,5139,0,16,16,0,100
528ffcd080419a6fd5edcaa49490bb5c2260a1aa,50,193,304,111,0,0,0,4,33,332,4,23,4.838155552,9057,167,6,1625,1650,25,70078,70506,428,800,812,12,91.47077714
15a7014e889513e9c4e6470a227b97dfc90559d5,4,40,39,1,0,0,0,1,32,88,2,2,1.546694865,924,168,7,225,228,3,6585,6657,72,113,116,3,92.3318503
95f836bfb22663dee1ee109512fb202b7932ecbd,33,592,542,50,1,0,1,4,33,190,2,14,3.461316379,5484,169,8,1151,1145,6,43542,44125,583,564,559,5,99.97445069
b35c86bf5ee4b773e7cfb5a57de449fa4a828660,1,4,0,4,0,0,0,3,6,1,1,1,0,13,170,9,4,3,1,119,110,9,2,1,1,100
33414e645ee7135176fd2dd66af19b90f0df8716,5,108,26,82,1,0,1,1,7,108,1,3,1.582980423,706,171,10,166,152,14,6511,5802,709,72,70,2,99.97446374
ffc7fabb57ecb08220e53ceaafc6ac8b4d665860,22,2523,576,1947,9,0,9,1,16,79,1,4,3.826415663,2208,9,0,547,384,163,26265,18250,8015,214,139,75,97.71232877
80cfd1c4a99eaa250d52655daed9dd856f139e1e,2,28,1,27,0,0,0,4,55,246,1,2,0.79732651,277,379,0,32,29,3,2372,2202,170,9,8,1,99.98522022
020e3bede9efc69833fb01402bc97870420bf85a,1,1,1,0,0,0,0,3,4,197,1,1,0,225,380,1,29,29,0,1864,1860,4,11,11,0,100
845cbcdd860ee1aa8817259b9b6a5415a5196275,64,1798,2679,881,18,0,18,6,56,258,3,23,5.329888098,4499,56,0,557,611,54,35840,40069,4229,261,301,40,90.95464135
4e64e04a1c742f9499710e5877218b79cb5194ba,7,10,10,0,0,0,0,1,2,0,1,1,2.721928095,113,57,1,20,20,0,833,833,0,18,18,0,100
b70621d756f234598f69deb9bef1c029ad770938,6,118,161,43,0,0,0,2,57,98,1,4,2.040437309,846,58,2,82,79,3,7516,7540,24,30,30,0,99.89276778
3a38fb9d8c58bb5be7e2a9899788085812441b8e,1,6,1,5,0,0,0,4,25,292,1,1,0,166,381,2,32,30,2,1205,1180,25,7,7,0,100
798b6a5cc23fa33ac166b8993361e674b3620124,0,0,0,0,0,0,0,0,0,0,0,0,0,0,382,3,0,0,0,0,0,0,0,0,0,100
89720ce9c41fa68367826b482832cec7570579bc,1,7,5,2,0,0,0,2,5,171,1,1,0,564,820,1,108,106,2,4175,4148,27,38,38,0,100
7fa228fcaa75178c75c819436abd6e4c1dd55a1a,1,0,3,3,0,0,0,2,7,149,1,1,0,208,821,2,24,25,1,2011,2017,6,2,3,1,100
b58213b267ed7efaf9c148df68cf953d423a973a,0,0,0,0,0,0,0,0,0,0,0,0,0,0,822,3,0,0,0,0,0,0,0,0,0,100
250edf36cd6bc9c3cb3e6332b42ae451a9251f48,0,0,0,0,0,0,0,0,0,0,0,0,0,0,823,4,0,0,0,0,0,0,0,0,0,100
c3496d1b4a5a3012d546e73079a07a137788a5c6,34,1264,776,488,8,0,8,1,30,85,1,12,4.094214691,2004,59,3,336,258,78,19122,19698,576,225,173,52,94.49509916
adab9e7a3f8267410330c1e9f43d6606fdcb8c07,3,46,2,44,1,0,1,2,8,244,1,2,0.74299334,229,824,5,22,20,2,1957,1818,139,8,7,1,99.97818023
4a8d35ee89f9ead3854fd2c79af7b299b57cf2d4,1,2,3,1,0,0,0,2,6,214,1,1,0,44,825,6,5,5,0,386,367,19,2,2,0,100
434b9936259ff00ac6772cbd0970e7dd1e24e24f,1,2,1,1,0,0,0,2,5,237,1,1,0,47,826,7,6,6,0,365,363,2,4,4,0,100
e498621f5a46872ffd60bf757b96a616e73ffffc,0,0,0,0,0,0,0,0,0,0,0,0,0,0,827,8,0,0,0,0,0,0,0,0,0,100
5a76e5354e70ee63b7b3b92862155ced2ae7030c,1,11,8,3,0,0,0,5,34,42,1,1,0,565,828,8,150,149,1,3788,3766,22,61,61,0,100
149941141dcc05cd92c154139ad04c2d4529bc2a,111,536,346,190,0,0,0,2,58,194,4,61,5.936307559,16533,829,9,2742,2734,8,127343,127589,246,1242,1238,4,99.96728106
0d4e2bc1901f7ee67254dc562695ff8a6e2e3b87,0,0,0,0,0,0,0,0,0,0,0,0,0,0,830,10,0,0,0,0,0,0,0,0,0,100
7773abc1f63d878327ffcfb306081eb051e1f647,0,0,0,0,0,0,0,0,0,0,0,0,0,0,831,11,0,0,0,0,0,0,0,0,0,100
307a198b9cf7262d06fda40045980a7155a69ca7,2,5,3,2,0,0,0,1,2,314,1,1,0.811278124,526,832,12,46,46,0,3823,3803,20,17,17,0,100
6d94195a79b36e1ec0968a28a93c6c0e3462f13f,1,2,1,1,0,0,0,6,59,8,1,1,0,205,833,13,18,18,0,1725,1718,7,3,3,0,100
1dd5ff1cc735f41369df6208dd55fe38670f4b1f,1,2,0,2,0,0,0,2,6,220,1,1,0,189,60,4,30,30,0,1931,1922,9,6,6,0,100
765834c377d7283cc4243dc91d682dc2aab98040,6,18,1,17,0,0,0,2,6,435,1,1,2.31345975,327,834,14,35,35,0,3053,2954,99,22,22,0,100
7be37c082b016c9477955e14462ac4c335f50d2b,2,7,2,5,0,0,0,4,10,16,1,2,0.764204507,502,10,0,63,62,1,3224,3208,16,25,24,1,100
a8be9be983ec747145ca34aa094dd4594c8ab6b7,2,7,8,1,0,0,0,4,7,11,1,2,0.996791632,327,11,1,37,37,0,2374,2372,2,19,19,0,100
db304a20982e8665a365226b7e007867444cab6d,0,0,0,0,0,0,0,0,0,0,0,0,0,0,835,15,0,0,0,0,0,0,0,0,0,100
b8a553b5a1e7e58dc27a47d4860b7f8106a566d7,1,1,1,0,0,0,0,3,10,24,1,1,0,316,12,2,33,33,0,2270,2270,0,12,12,0,100
c06c89ae80b6279ffe78156ddc650e329bcb6441,1,3,1,2,0,0,0,4,25,78,1,1,0,244,61,2,27,26,1,1669,1661,8,17,17,0,100
f4009bfed0f76c9674bccfa06bdff8cd65a41c36,0,0,0,0,0,0,0,0,0,0,0,0,0,0,836,12,0,0,0,0,0,0,0,0,0,100
bd654ca4fa9311d3a4b9db83642cbb11318c7c1e,8,208,129,79,0,0,0,3,60,343,2,4,1.652676734,1256,166,0,127,119,8,11204,10468,736,72,69,3,100
7c0da9029832e3e1f2e5313cdd7e42cbff541e04,5,53,216,163,0,0,0,2,7,138,1,2,1.954965711,396,837,9,29,42,13,2261,3255,994,18,27,9,99.97818499
4cad7a0d9da8f4626a15f895db1e2e27ef68e2dd,9,21,17,4,0,0,0,2,4,50,1,2,3.109549067,462,62,2,65,64,1,4085,4062,23,38,39,1,100
ff23ffd05bc364ca91e84a9390a53673775c8299,1,25,5,20,0,0,0,8,42,334,1,1,0,409,838,8,56,53,3,3520,3419,101,16,15,1,100
b0ccf74e0596e678c5d13cb065b3169d206edb36,10,122,22,100,1,0,1,3,89,312,3,9,2.410109021,2572,839,7,238,234,4,21563,20762,801,97,94,3,99.97818499
971a56d1d6ea40cbc1505594baeb0685c63cb659,21,34,30,4,0,0,0,2,26,448,3,15,4.246268266,2507,840,7,442,442,0,20665,20705,40,155,155,0,100
790e703706c7f0e9776bf40c76b1810fd565d669,5,36,131,95,0,0,0,4,35,76,1,1,2.201397732,1428,841,8,326,350,24,8270,8878,608,161,167,6,97.64581869
437d9189078a12efee99d52e51b5018e1786c7ca,6,342,25,317,1,0,1,1,9,746,1,3,1.913692364,242,842,9,53,27,26,4443,2057,2386,43,20,23,99.82403218
94f64e6128ae3ba6bf3a76987b43e48e738141f7,5,305,4,301,2,0,2,3,24,196,1,4,2.012748075,285,843,9,88,53,35,4437,2205,2232,43,30,13,99.800025
aa4cabef42a30a3e8965e7519dde93fc977256a6,0,0,0,0,0,0,0,0,0,0,0,0,0,0,172,0,0,0,0,0,0,0,0,0,0,100
e3f0b7ddf09cdd53d5dc4fdc5785cf852dc52cb5,0,0,0,0,0,0,0,0,0,0,0,0,0,0,173,1,0,0,0,0,0,0,0,0,0,100
f76674786c4b7a31bfa5e8743a15056220c919c5,0,0,0,0,0,0,0,0,0,0,0,0,0,0,174,2,0,0,0,0,0,0,0,0,0,100
07513b859baff21f3ff5a4ad309e4bdaa8fe25c8,0,0,0,0,0,0,0,0,0,0,0,0,0,0,383,0,0,0,0,0,0,0,0,0,0,100
7809d0489a2b342f718ef62317f04ae03c1e8399,0,0,0,0,0,0,0,0,0,0,0,0,0,0,384,1,0,0,0,0,0,0,0,0,0,100
ea9726767b108495f49448bdd6be05297f10fce5,0,0,0,0,0,0,0,0,0,0,0,0,0,0,385,2,0,0,0,0,0,0,0,0,0,100
29a7f38810270fa45a17bdf2418c896c1594d43c,45,2685,966,1719,24,0,24,1,31,57,3,21,4.301135855,2638,386,3,552,401,151,30808,20932,9876,227,175,52,91.1387632
819cc97c0b37cb4855a6f40b9a9fedbe8b4375b4,4,18,13,5,0,0,0,3,20,933,2,3,1.593613552,311,25,0,32,31,1,3021,2985,36,14,14,0,100
8ca83b1fd2fb101f21e5af7d471ba334420e84cd,1,22,16,6,0,0,0,3,16,479,1,1,0,123,26,1,24,23,1,1120,1100,20,8,8,0,100
8193b05cccacabbcbd2a90fa5730ac7086261a2e,1,1,1,0,0,0,0,1,2,6,1,1,0,96,387,4,15,15,0,952,952,0,3,3,0,100
5c5a93d7795a802f6baf7ac2793a6734ed79e640,1,1,1,0,0,0,0,6,23,9,1,1,0,138,388,5,42,42,0,1176,1174,2,7,7,0,100
c70f4c1990c94bc42c4630f4bcb91dec68912d2c,0,0,0,0,0,0,0,0,0,0,0,0,0,0,389,6,0,0,0,0,0,0,0,0,0,100
ac83cf3753a1948364de2d1639aa8aeb2c5c76dc,27,52,2221,2169,0,0,0,3,22,727,2,7,4.120994075,2480,27,2,165,335,170,10810,21012,10202,90,166,76,97.81387396
3b9f63579a691838d8e8eec7af33f6f255f4dbdf,5,37,11,26,0,0,0,1,6,20,2,3,2.071577939,499,390,7,60,59,1,4741,4487,254,14,14,0,100
5e191d93a23eb403d7bdee731d51be352957a6d9,1,8,1,7,0,0,0,3,7,23,1,1,0,207,844,3,36,35,1,1508,1439,69,17,17,0,100
4194a28a7fd44438f0277c55deff67509bb9fcc4,131,743,590,153,0,0,0,2,90,196,4,75,6.106886538,17964,845,3,2988,2972,16,137002,137074,72,1314,1288,26,92.38500193
763c94cac94ada5120cee0cd76fae21ebbff0a14,20,83,134,51,0,0,0,2,60,293,3,14,3.621282836,3412,846,4,373,374,1,31306,32225,919,118,118,0,97.28573339
f56404ad6131bd06e10b57064a1795bedce39ee0,1,1,1,0,0,0,0,6,61,6,1,1,0,205,847,3,18,18,0,1727,1725,2,3,3,0,100
189ac5985d1e01e6c24fdab1bd4dd607003ccbd1,1,4,1,3,0,0,0,6,62,1,1,1,0,205,848,4,19,18,1,1744,1727,17,3,3,0,100
8b71fc0e7b98e5f885ef1d9b7b403b3caa586210,2,2,2,0,0,0,0,3,18,225,1,1,1,231,167,0,27,27,0,1706,1704,2,12,12,0,100
4199e60a704c5f3b615ca3e04a02ae57f9242384,0,0,0,0,0,0,0,0,0,0,0,0,0,0,168,1,0,0,0,0,0,0,0,0,0,100
45a3cc11f74c55367151878f702cda504d9794e1,1,9,4,5,0,0,0,2,5,601,1,1,0,43,169,2,10,9,1,369,320,49,7,7,0,99.83600353
08734219ddb27516e4cefcf79f213d66e86dd046,2,10,9,1,0,0,0,3,8,489,1,2,0.949452015,318,170,3,39,39,0,2812,2812,0,30,30,0,100
31f5a5f46c56ff29796302014b71ae2f11c4ad71,0,0,0,0,0,0,0,0,0,0,0,0,0,0,849,5,0,0,0,0,0,0,0,0,0,100
f5ac4584c8600b8c02bf6d632ea9471436137816,0,0,0,0,0,0,0,0,0,0,0,0,0,0,850,6,0,0,0,0,0,0,0,0,0,100
4bfa8ebab936c8f524394bda3fcb738a7a1f5858,1,1,1,0,0,0,0,4,34,544,1,1,0,119,171,4,27,27,0,675,668,7,24,24,0,100
dbf9bd37c7917dbfe4c594d6ea46179386d13141,4,27,18,9,0,0,0,2,12,637,1,4,1.429228244,347,851,7,40,40,0,2862,2859,3,34,34,0,100
93c7800834e57506bcfb5372a50764ff846cbb1c,1,55,48,7,0,0,0,5,35,110,1,1,0,570,852,8,150,150,0,3780,3788,8,61,61,0,100
e107bfa88bca9b7a39e440b59382ab0396b4f368,24,164,196,32,0,0,0,4,19,532,2,11,3.960129046,2628,28,1,439,440,1,21998,21808,190,171,174,3,99.48068398
760aec883d24d08f633ba4d2c5525372290c6fc6,1,8,1,7,0,0,0,2,4,278,1,1,0,66,853,9,4,3,1,523,491,32,2,2,0,100
083eb988e4bd6426e6aedc5b60d11a199300c715,11,25,41,16,0,0,0,4,18,3,2,5,2.720322838,1394,29,2,224,226,2,11190,11288,98,88,89,1,100
5fc5b6505fe3b8aab755eb8225f73ba6a73b45ef,9,1436,0,1436,9,0,9,1,1,0,2,4,2.556817754,0,55,0,120,0,120,7633,0,7633,62,0,62,92
5a5c3247ea619f3b83204ff3120f2532b1023e29,0,0,0,0,0,0,0,0,0,0,0,0,0,0,391,1,0,0,0,0,0,0,0,0,0,100
ac89aa3c0417e92e0e970141fee14e3d2113ee18,2,42,2,40,0,0,0,2,6,810,1,2,0.773226674,134,392,1,17,14,3,1040,728,312,11,10,1,99.98884924
202d376d2845c7bc05f78f5f4683b2123b9545d8,0,0,0,0,0,0,0,0,0,0,0,0,0,0,393,2,0,0,0,0,0,0,0,0,0,100
95736dde4a5285f53dcfdae41dbcb9e00996d417,3,256,93,163,2,0,2,5,27,31,1,1,1.559220542,258,394,3,45,34,11,3180,2196,984,12,6,6,99.76622509
f533aefdc3562f578f16a6dd27bbe6a08a77d130,2,21,10,11,0,0,0,1,2,0,1,1,0.637387499,187,395,4,25,25,0,1664,1706,42,8,8,0,99.96665555
6c86257f784d8e142039d5d8ff3da260c739b662,4,34,3,31,0,0,0,5,28,261,2,2,1.564990805,371,396,5,52,47,5,3178,2964,214,26,23,3,99.98888395
fb65e8a329848d63886074e541395093a7a39eec,2,4,4,0,0,0,0,8,28,104,1,1,1,78,397,6,11,11,0,559,559,0,6,6,0,100
230b8c5bc9afa9055db49b09692ac8dd076ea37f,0,0,0,0,0,0,0,0,0,0,0,0,0,0,398,7,0,0,0,0,0,0,0,0,0,100
6fc9667f092addd03c9e5a98b5eabb6561e1c395,2,17,1,16,0,0,0,1,4,252,1,2,0.503258335,334,854,5,30,29,1,2409,2273,136,12,11,1,100
215570df00da2a682f2109d85c5eab12b78b485e,1,2,1,1,0,0,0,2,9,433,1,1,0,135,63,0,23,23,0,1220,1215,5,8,8,0,100
b2866979dfb1d9fc7bcf72905ccb29d5011612eb,1,9,8,1,0,0,0,2,6,596,1,1,0,81,399,8,11,11,0,702,702,0,2,2,0,100
52ce4129a013933836b4bc6ba1bde282810f1959,64,230,230,0,0,0,0,1,1,0,2,17,5.66239905,4985,400,9,845,1856,1011,40471,110144,69673,399,448,49,97.12854758
eecf9dbb97e691fada0c9f81f4a99e1949fce0cc,1,2,3,1,0,0,0,2,7,0,1,1,0,81,401,10,11,11,0,694,702,8,2,2,0,100
dff4ef1a7c9420a664c441f49aa39652213a213c,1,1,0,1,0,0,0,2,8,0,1,1,0,80,402,11,11,11,0,694,694,0,2,2,0,100
3a50c882374e89a285707600d1f9a17dfec5b327,3,109,1,108,1,0,1,1,9,119,2,3,1.073525684,226,403,12,43,33,10,2505,1975,530,21,17,4,99.95544168
de69de1d385b4c64d1d710c869f79315944e45f5,2,21,7,14,0,0,0,4,15,80,1,1,0.940285959,294,404,13,39,37,2,2714,2601,113,24,23,1,100
12379ec7bfc25014ce2bb46888e9617899e67cc5,3,3,6,3,0,0,0,3,10,541,1,3,1.435520504,323,405,14,32,32,0,2828,2867,39,21,21,0,100
b2e119a79c3a8ce26de523982e9a0b168fc88bc7,1,32,0,32,1,0,1,1,1,0,1,1,0,0,406,15,4,0,4,332,0,332,1,0,1,99.96659987
7ad6f1375acf47e7fdbcd812802081c11bb2645f,1,2,1,1,0,0,0,4,16,0,1,1,0,246,407,16,31,31,0,2200,2191,9,20,20,0,100
e0ec7c1be9cf1141123b00841c9502e85f5ae426,167,8582,640,7942,61,0,61,2,91,137,4,86,6.201221739,14320,855,6,2740,2003,737,153904,119693,34211,1135,750,385,96.19863766
90d175e5a930b0081332ea1d2f079815fe846112,1,48,49,1,0,0,0,4,11,0,1,1,0,148,408,17,21,21,0,1140,1129,11,11,11,0,100
bee7405746e85665cabb64201d6bb3547f633189,2,43,3,40,0,0,0,3,9,27,1,2,0.495969072,386,409,18,54,53,1,3515,3042,473,25,25,0,100
d491f69bc2a6e2d0d369d84c03b46338fe886b42,61,0,8080,8080,0,0,0,3,23,0,1,17,5.601415886,4499,410,19,0,801,801,0,35540,35540,0,385,385,97.20201455
3988abddbc7abbf4c36b759cd88240fc8f553d2b,5,10,13,3,0,0,0,7,57,29,1,5,2.261996198,565,411,20,45,45,0,4646,4694,48,23,23,0,100
807ad49c4b3fa4a4f558283cd4fa2d7d3cd9117d,1,15,16,1,0,0,0,2,5,3,1,1,0,96,412,21,19,19,0,842,842,0,6,6,0,100
e410e34ddc9066e0a1b22f199c54b662fe9494e9,1,13,13,0,0,0,0,3,3,146,1,1,0,72,413,22,5,5,0,798,798,0,2,2,0,100
509b443752e5099b7080abca9344f4ca98df55f4,1,64,62,2,0,0,0,6,63,49,1,1,0,208,414,23,19,19,0,1744,1744,0,3,3,0,100
1b0d9ee637273bdd884c544b3694e4a6a073b7dc,1,10,18,8,0,0,0,6,16,437,1,1,0,46,415,24,1,2,1,343,409,66,1,2,1,100
3ba87c8695c8c8b00a7ebc5fdb916e62c541ad7c,1,23,20,3,0,0,0,3,4,58,1,1,0,99,416,25,8,8,0,1060,1060,0,3,3,0,100
b4e428cfe2f47566ffffd62824dfbdfdd4e0918e,1,8,7,1,0,0,0,3,22,190,1,1,0,201,417,26,40,40,0,1253,1253,0,27,27,0,100
81d64c0977a896c40e582d80724501bfd9c694dc,23,600,1462,862,5,0,5,3,33,122,3,9,4.024071215,2070,64,1,219,330,111,12402,17668,5266,93,157,64,99.4696795
ca18680aa892900773be3440a58f2cd63aaf7b44,6,594,79,515,1,0,1,1,26,180,2,5,1.583635651,675,856,4,177,110,67,8870,5946,2924,71,39,32,99.94253534
8ad8d96cb41120e5278ade09437d91f5120291e0,1,4,3,1,0,0,0,3,22,638,1,1,0,376,418,27,76,76,0,2481,2481,0,56,56,0,100
8bee08594605e6ddb4bb8d3a658463f534533950,0,0,0,0,0,0,0,0,0,0,0,0,0,0,419,28,0,0,0,0,0,0,0,0,0,100
f23eb85caa05801f978f54799abfffc0047a385a,1,149,0,149,1,0,1,1,1,0,1,1,0,0,857,5,21,0,21,859,0,859,8,0,8,99.9540494
fd0d1951e1b6737f249b27070966c917ca4309c5,2,0,231,231,0,0,0,2,13,330,1,2,0.863120569,144,858,6,0,37,37,0,1118,1118,0,7,7,99.80488925
faa82ce3719898058da06a1d7b0948bf326968eb,11,630,91,539,6,0,6,1,34,21,1,3,3.107256033,814,420,29,163,131,32,9577,6911,2666,65,48,17,96.206101
4688b73ba9d99e0dc77367a62f5d7e4b36c8cc72,1,104,146,42,0,0,0,4,14,61,1,1,0,160,421,30,14,14,0,1084,1642,558,4,3,1,100
070cf44cb72d3034e4098db6fd8a22d17de28260,0,0,0,0,0,0,0,0,0,0,0,0,0,0,422,31,0,0,0,0,0,0,0,0,0,100
f1a7de436bb6098e8c51991f00f84802b17b6527,1,11,8,3,0,0,0,5,14,156,1,1,0,114,423,32,10,10,0,992,992,0,8,8,0,100
2e4d30660950bea4610036917d108079c0bcb887,16,740,9,731,13,0,13,1,35,7,2,5,3.690875607,540,424,33,142,81,61,7404,4069,3335,79,50,29,99.53717096
baa3a8c60a51a8d41ab20ebf04f3cc86636a0be7,5,182,156,26,0,0,0,1,6,278,1,2,1.031571822,559,859,6,58,57,1,4637,4275,362,22,21,1,100
2736bc5c58f71c2fa863ff64bf61b3960c122b86,10,78,56,22,0,0,0,3,92,15,3,8,3.231604206,2571,860,6,333,322,11,20896,20786,110,118,118,0,100
1dc03a53897010623429fd5b63b4af8f7368db22,1,1,1,0,0,0,0,7,68,1,1,1,0,335,861,7,37,37,0,2920,2920,0,13,13,0,100
3631151aa02e5df237b4f20be673d6fc5d299cef,6,342,76,266,1,0,1,1,11,79,2,5,1.82920249,584,65,2,94,70,24,7242,5468,1774,50,36,14,99.87037304
d317c1cbd78b0d0b06464010f52a057f29eff554,4,156,5,151,1,0,1,1,11,6,3,3,0.552212625,382,66,3,52,41,11,4647,3656,991,25,24,1,99.97119816
cdafd91b26b2049b69717085074dc4ee6fb61a30,1,6,6,0,0,0,0,5,15,212,1,1,0,127,425,33,13,13,0,1145,1133,12,7,7,0,100
467fe17a305c5347fdd9c5c0ac7823043a9ac3d9,0,0,0,0,0,0,0,0,0,0,0,0,0,0,426,34,0,0,0,0,0,0,0,0,0,100
8771d8921483ba202cd44f58b33f770f489c0f1c,1,4,4,0,0,0,0,2,3,82,1,1,0,70,427,35,8,8,0,451,446,5,5,5,0,100
efb7b638eb4329ba86a8bdfb6a1b73b5d1ebeb14,2,161,1,160,1,0,1,1,26,231,1,2,0.095970403,166,428,36,63,42,21,2469,1304,1165,12,5,7,99.97121474
8a2c0f3e24424e533b253b7110615c2ce75b043e,5,464,124,340,4,0,4,5,30,5,1,1,2.185647041,185,429,37,37,20,17,3487,1516,1971,11,4,7,99.23399335
4b2c5d37e9c6fb4636d3c931da168b6e143c88d8,3,16,3,13,0,0,0,1,27,627,1,2,0.953013885,324,862,8,65,63,2,2812,2770,42,20,20,0,100
9f6eb59b2669888d4dd65b6d512701add7ebb9b5,1,19,21,2,0,0,0,2,2,0,1,1,0,124,863,9,21,21,0,1079,1165,86,7,7,0,100
c8143391050e7137a405691c59e3848e3086ff3b,1,41,0,41,1,0,1,1,1,0,1,1,0,0,430,38,3,0,3,337,0,337,1,0,1,99.97097242
d2dd88487f4bcc1972f25d71e74afd4940b7398b,2,23,9,14,0,0,0,4,18,368,1,1,0.997180399,580,431,39,64,62,2,4380,4311,69,24,24,0,100
1ead5ae9809a2048c27a6af02dd59e12fce03f87,3,22,6,16,0,0,0,4,19,254,1,1,1.185616163,572,432,40,62,60,2,4320,4249,71,24,24,0,100
128e3bed08b5b34d82f1154d101863fc57d30e04,1,2,3,1,0,0,0,1,2,2,1,1,0,103,433,41,8,8,0,1001,1009,8,4,4,0,100
08e65f66279f03caaa46f789f20d17d1db36c78f,35,480,2691,2211,1,0,1,2,64,125,1,17,4.735988655,3155,67,4,206,421,215,15104,27293,12189,105,256,151,94.50506625
5ee07e316a372e81bae135153c1157c2ef276562,3,92,4,88,1,0,1,2,17,0,1,2,0.621944646,384,68,5,80,79,1,3150,2634,516,49,48,1,99.97648719
aad970c9d687fe802709380583b76cf9bf1d19d9,2,0,185,185,0,0,0,1,2,180,1,1,0.967700682,118,69,6,0,24,24,0,661,661,0,20,20,99.95296331
d8629d6c29daf985e5b0c4c8aa179355a90be9b2,1,2,1,1,0,0,0,2,4,0,1,1,0,143,70,7,13,13,0,1384,1380,4,8,8,0,100
2f7f0dc0cfd8c31e4cfa54f397866b66c6dc2d21,3,22,4,18,0,0,0,3,22,309,1,2,1.300194643,461,864,10,59,54,5,4308,4187,121,27,26,1,100
bea695ddeee7f54b7128bc916442385bb02f0a5e,2,44,6,38,0,0,0,2,32,659,1,1,0.981453895,821,865,11,168,158,10,6295,5972,323,53,51,2,100
330250d36b0308c6b49975cf0f9065466e07aef9,2,2,2,0,0,0,0,3,39,366,1,1,1,463,866,11,99,99,0,3212,3216,4,46,46,0,100
2bccb1d2f845cb2ef385acebfde0773a21bdc925,0,0,0,0,0,0,0,0,0,0,0,0,0,0,56,0,0,0,0,0,0,0,0,0,0,100
eecce949023711e3ed55833ca84e1a0d3887f301,0,0,0,0,0,0,0,0,0,0,0,0,0,0,33,0,0,0,0,0,0,0,0,0,0,100
d98241a04d24dd46eb549a493f835abe6c68a4e9,0,0,0,0,0,0,0,0,0,0,0,0,0,0,434,9,0,0,0,0,0,0,0,0,0,100
4fbab15638e53ce494796260f6c291bb2926ad19,7,215,89,126,3,0,3,2,31,172,2,3,2.611377047,378,867,5,57,52,5,3431,3048,383,29,25,4,97.17860648
05cf6342b2699ecba05a44abfc5e47e680a425fe,4,55,6,49,1,0,1,2,5,58,2,2,1.451789465,366,435,10,55,50,5,3420,3103,317,14,12,2,99.93595491
1eb8e4f612e251b02c6921d59f6e23a7a5ab5189,1,18,1,17,0,0,0,3,7,293,1,1,0,179,436,11,29,25,4,1818,1672,146,3,3,0,100
6b4c192d420cb9bb8596eeefcb2c280d3eed0b15,0,0,0,0,0,0,0,0,0,0,0,0,0,0,868,6,0,0,0,0,0,0,0,0,0,100
846ef86fa1e40ccdec01445c5c29703107d564d3,1,25,25,0,0,0,0,3,32,10,1,1,0,213,869,7,35,35,0,1613,1613,0,13,13,0,100
5389d76eed9ce58aefd9b08e0827ce48ca6fea39,4,22,9,13,0,0,0,2,5,92,2,2,1.676465973,228,437,10,41,39,2,1956,1833,123,14,14,0,99.9871959
d04071c12abc80df189041eb168ac007f8cd7f99,1,1,1,0,0,0,0,3,10,73,1,1,0,250,438,4,37,37,0,1945,1945,0,17,17,0,100
69febd5a32829837e8267ad3d804154f8f3d03b7,0,0,0,0,0,0,0,0,0,0,0,0,0,0,439,5,0,0,0,0,0,0,0,0,0,100
a2346aebab853c08f6076e6cac573a3499d48b27,1,3,3,0,0,0,0,1,2,46,1,1,0,109,440,6,12,12,0,1031,1031,0,3,3,0,100
2c1c3ad1057f9e36227549064fa555a37d307a7a,1,1,1,0,0,0,0,2,4,47,1,1,0,70,441,7,8,8,0,451,451,0,5,5,0,100
4bb34a8b88cf399b58b0ff279613b7c1473c8fbd,0,0,0,0,0,0,0,0,0,0,0,0,0,0,442,8,0,0,0,0,0,0,0,0,0,100
e75074d1349574cc6c19579aadf826d831866995,2,4,4,0,0,0,0,6,31,76,1,1,1,257,870,6,25,25,0,2101,2101,0,6,6,0,100
220e11992cc33c088c360be948c0ee5aa365e4f3,1,2,2,0,0,0,0,4,20,71,1,1,0,216,871,7,28,28,0,2117,2117,0,4,4,0,100
1c9c61798fc66195dbd015df2244f90c92a1094a,1,7,1,6,0,0,0,8,44,76,1,1,0,421,872,8,56,56,0,3535,3516,19,16,16,0,100
4c2d7deb2fe77db40b5f01ac3de09bf1283ac77c,1,2,2,0,0,0,0,7,32,512,1,1,0,85,873,8,10,10,0,725,721,4,2,2,0,100
38b644235d854331d59f27d3461ead8c72334508,1,104,105,1,0,0,0,3,6,157,1,1,0,119,443,9,24,19,5,1082,1214,132,4,3,1,100
2ead329cb23df8561510b4e3ca191cc77a6605cf,1,115,31,84,0,0,0,3,14,677,1,1,0,122,874,8,42,19,23,1498,969,529,5,5,0,100
408e57bb224d5fbf276eba7ca5056e681623d219,1,10,8,2,0,0,0,3,7,1,1,1,0,120,444,10,25,24,1,1090,1082,8,4,4,0,100
c9d49ee0b1b63f4503cbb3457a6c96c67e3df799,6,4,9,5,0,0,0,2,11,1,1,1,2.469670487,527,445,11,75,45,30,3989,2720,1269,34,22,12,99.79513444
c1d2cd13539c1e4c58cb013da6c63ed362720386,15,170,37,133,1,0,1,2,33,1151,1,4,2.921523866,991,875,8,192,176,16,7045,6531,514,102,87,15,99.84633116
3292d07fa38bd482a27eb757f3cfad5fd4e2ba1d,3,4,4,0,0,0,0,5,17,706,1,2,1.5,97,446,12,8,8,0,951,951,0,3,3,0,100
cf4cfaa245fecd522d678e207f1861ae99774f80,0,0,0,0,0,0,0,0,0,0,0,0,0,0,447,13,0,0,0,0,0,0,0,0,0,100
7bfa45c6e870935af96622d96d622be242bb4c96,3,14,7,7,0,0,0,1,21,362,2,3,1.339664264,621,876,9,117,114,3,5010,4951,59,60,60,0,100
131eb4a1f8d2865e62c97779ac59dedc365d2988,24,3069,71,2998,16,0,16,5,45,97,3,11,3.753977703,1668,57,0,699,335,364,31785,12137,19648,284,139,145,94.60883664
e5ad03222a60e7fc11f43fc04d600b26b6cc5678,2,5,2,3,0,0,0,1,2,0,1,1,0.863120569,462,58,1,94,94,0,4006,3990,16,41,41,0,100
07f8c0afbcdda2839164919857406066e2cdfe12,1,2,1,1,0,0,0,2,2,3,1,1,0,421,71,0,60,60,0,4039,4018,21,22,22,0,94.47906101
4fbfbc694a956c6e4923af27fbd42eb26467bb9f,110,824,696,128,0,0,0,2,86,80,4,61,5.929497767,12833,877,10,1811,1789,22,105191,106758,1567,749,717,32,92.8653478
2e2ef2cadb6d5c047e3f45356d689e8977a99dcc,3,33,1,32,0,0,0,1,18,525,1,3,0.745217654,146,878,11,28,24,4,1389,1130,259,18,16,2,100
ce91968a54263986f45f74dac55f8987ec6941ed,1,2,1,1,0,0,0,2,5,0,1,1,0,13,879,12,3,4,1,91,99,8,2,2,0,100
2b5dabe1817fff5db738dce15446d2693d1084b7,0,0,0,0,0,0,0,0,0,0,0,0,0,0,448,13,0,0,0,0,0,0,0,0,0,100
d8e91f904e3306651743e1ad2a2c48e4f3745248,17,1086,83,1003,8,0,8,5,18,161,2,8,3.562910835,1301,449,14,232,149,83,15298,9699,5599,114,72,42,92.49735822
f81face912ea2d911cba2514b13e9ae022dc5458,4,23,225,202,0,0,0,1,25,454,2,2,1.73229508,307,880,12,14,34,20,1347,2288,941,2,17,15,96.48987676
4be0a0821ae7e3a4b61ce42d5c31ddc5395392de,2,71,35,36,0,0,0,2,7,325,1,2,0.185803079,78,881,13,12,6,6,1125,827,298,5,4,1,100
c586b3e013fa57feebea59b6e1cf4aab615b9b04,1,46,11,35,0,0,0,2,8,0,1,1,0,89,882,14,14,11,3,700,643,57,5,4,1,100
9d448811aa05a14758390f1c4f19f67b4f267559,16,1117,16,1101,10,0,10,3,68,68,2,9,3.222953261,2206,172,0,267,186,81,26419,21348,5071,142,91,51,92.80856283
bcde5878421f8721402c1f435658af737f5b4eda,0,0,0,0,0,0,0,0,0,0,0,0,0,0,450,13,0,0,0,0,0,0,0,0,0,100
8150e795c22e43ab7cbb5f265684bcaccc4f2cb6,1,13,4,9,0,0,0,3,12,5,1,1,0,235,451,14,32,31,1,2352,2259,93,2,2,0,100
96ea50161aa164271e335061f7730844865b8c62,1,10,7,3,0,0,0,1,2,5,1,1,0,105,452,15,15,15,0,951,934,17,7,7,0,100
05f9475a731cbbd00ef871263436410e7998b1de,2,3,3,0,0,0,0,1,10,403,1,2,0.918295834,117,883,14,16,16,0,981,983,2,14,14,0,100
f22d03cb408c1cc05304f9c1633620f0dff49b67,0,0,0,0,0,0,0,0,0,0,0,0,0,0,173,1,0,0,0,0,0,0,0,0,0,100
e9cc3238826c6c248b6ba69eceba6807ac9defeb,42,1216,443,773,3,0,3,3,9,66,2,14,4.058888671,3904,30,0,772,684,88,36120,31232,4888,312,302,10,99.11956106
d6aba1afc80cbeb3c6945c69b6e5ee13d4699496,37,477,477,0,0,0,0,3,4,18,2,10,4.192507241,3825,31,1,689,689,0,30547,30607,60,295,295,0,100
3a14a77f222e7a276d3719eb9af005926bd61e39,2,87,12,75,0,0,0,1,2,43,1,2,0.999926399,160,72,1,13,8,5,2025,1497,528,7,5,2,99.90957241
319649691808de0aab899cf11820691f3944abc6,1,2,4,2,0,0,0,1,1,0,1,1,0,205,453,8,20,20,0,1252,1276,24,15,15,0,99.94833376
5a2250c6e82880eb68b6f0a3953403c476486dfe,20,828,444,384,1,0,1,2,11,186,1,3,3.082661336,3123,13,0,499,466,33,25422,23675,1747,191,181,10,99.84488108
7942746edc830e88cd4ee8f55ea1a2b54d0169ea,3,31,3,28,0,0,0,2,38,747,1,2,1.436990524,228,884,9,48,45,3,1977,1882,95,14,13,1,100
5214b1d7a44e3f82d7011fadbfc748520c8c07de,7,185,58,127,0,0,0,3,12,62,1,3,1.900183262,1583,14,1,183,167,16,11005,10427,578,65,63,2,100
ebeade909b952e203f30416486ee45b7848d1741,7,58,185,127,0,0,0,3,13,0,1,3,1.900183262,1682,15,2,167,183,16,10427,11005,578,63,65,2,100
8bac9143bda95a13b992e074a090df24be91019f,9,442,128,314,0,0,0,3,14,39,1,3,2.712666254,1991,16,3,237,208,29,14337,13219,1118,84,78,6,100
c590f1b006f6c186ea1e98e9aaea27df66f83f98,2,26,9,17,0,0,0,2,20,474,1,2,0.315997133,171,174,1,37,34,3,1498,1362,136,19,17,2,100
4432e3194bc54dcbfe8fd7267c01bddd26762e3a,1,4,6,2,0,0,0,2,9,0,1,1,0,49,175,2,10,10,0,387,390,3,8,8,0,100
faf0b6e325b52e0f25f7e8b657981441ac6f8608,2,350,0,350,2,0,2,1,1,0,1,2,0.969254718,0,175,0,42,0,42,2569,0,2569,16,0,16,99.9354172
86352e3decdf7b1caffdbb03e11cbb3c640db8fe,1,17,0,17,0,0,0,2,4,1426,1,1,0,146,176,1,11,10,1,1725,1523,202,8,7,1,99.94841372
c898d272120b6d63a8b81175fad2f1e72a711310,6,554,0,554,4,0,4,1,2,0,2,4,2.15137162,245,177,2,78,42,36,5506,2569,2937,37,16,21,96.10237755
f5cce9b0b12dbfaae57dd753e8ffe2729d300dc4,3,36,26,10,0,0,0,1,2,0,2,2,1.077256715,221,178,3,21,18,3,1947,1836,111,15,15,0,96.27507163
11763fb82ee9f90de3a8114333a9ecf405add48b,2,25,11,14,0,0,0,1,3,0,2,2,0.852405179,274,179,4,53,52,1,2508,2453,55,18,17,1,100
60fae60a240bfc3880717f96ee884cdccaa1c5d4,1,35,15,20,0,0,0,2,10,0,1,1,0,48,176,3,12,10,2,412,387,25,9,8,1,100
7ad345d3331db7a38ef100d2512f3145232ceedd,2,86,48,38,0,0,0,3,5,92,2,2,0.4094994,202,32,2,18,13,5,2235,2008,227,5,5,0,99.89674755
6290deb496f0974fc9a776463b810a3bb5fd947a,1,78,0,78,1,0,1,1,1,0,1,1,0,0,33,3,5,0,5,353,0,353,1,0,1,95.70520966
4eac2cb442d62f12e532621cbcd666a0237635f4,1,2,2,0,0,0,0,2,8,152,1,1,0,178,885,1,14,14,0,1477,1477,0,5,5,0,100
dc637e81642ddf1171bfaa171c15c28bc0594565,13,372,118,254,2,0,2,3,36,264,2,5,2.836500843,1235,177,3,202,180,22,10349,9093,1256,131,118,13,99.51054217
8642b98ebd1de6e1b2286ef80d44adf959b34140,3,514,0,514,3,0,3,1,1,0,1,2,1.5251133,0,34,2,46,0,46,3444,0,3444,18,0,18,99.64947421
564c3e13a9eaf84fc76335b4a415937a747c974f,60,518,646,128,1,0,1,2,57,93,3,36,5.254651289,8157,886,1,1137,1143,6,65777,66282,505,469,470,1,98.48020591
15925a5bb0bed57dde21c071997d79c411068162,8,9,52,43,0,0,0,2,19,200,3,8,2.540454453,1740,887,2,321,321,0,12948,12948,0,128,128,0,100
eae542027e78732bff9a553e238683dcca08f94c,1,8,19,11,0,0,0,2,3,70,1,1,0,21,888,3,2,3,1,122,179,57,1,3,2,100
78545ff1d97693d51a718eb2992c104b025ab79c,6,109,26,83,0,0,0,4,23,324,3,4,1.77393064,747,178,4,96,91,5,6634,6130,504,58,54,4,100
71bf817489d4f23b85d1d2ee048093e8353a3f12,3,166,50,116,2,0,2,1,39,15,1,2,1.574700051,181,889,4,35,33,2,1912,1531,381,7,5,2,99.93992551
1540cecb889e1204a7fef826e92e30f60486af5c,1,8,21,13,0,0,0,2,4,5,1,1,0,134,890,5,9,11,2,1014,1091,77,4,5,1,100
8bc64151162118158ebc4b362be7d0f9709a065c,1,37,0,37,1,0,1,1,1,0,1,1,0,0,180,5,3,0,3,124,0,124,3,0,3,99.9759904
e6a308bebe5ee5b4c45fed6c08cc7aa83bce85f6,6,657,143,514,1,0,1,1,37,82,3,4,1.866722143,1062,454,0,234,180,54,10306,8275,2031,100,76,24,99.97600192
822a5e17c3c1e07c711821b3c19c7641b19c55a5,7,36,73,37,0,0,0,2,13,4,3,5,2.175406008,1320,891,6,188,186,2,9298,9557,259,80,78,2,99.96401583
69f324d9ed6a70e4eb7f6190b2e1751ce9dfca10,7,145,22,123,0,0,0,2,38,156,3,5,2.542134141,1137,455,1,213,201,12,9338,8648,690,127,119,8,100
b7b432c7f958b3feed1fd181f9bda08aa6c1865d,7,217,28,189,0,0,0,2,13,329,2,3,1.800020542,563,456,2,114,84,30,5489,4216,1273,49,41,8,100
051cbcf86e5dd61a198803256781c058120938d0,30,140,123,17,0,0,0,2,39,129,4,25,4.383670847,4606,892,6,776,774,2,36848,36893,45,341,339,2,99.30177515
bc9aa53c3fa0409c98801bbc2a58af6d48dd4c94,1,6,0,6,0,0,0,3,4,213,1,1,0,90,457,3,7,6,1,827,768,59,3,3,0,100
f57e759a33a9edbcb7bfb4424a04f4889250706f,1,378,0,378,1,0,1,1,1,0,1,1,0,0,458,4,42,0,42,2085,0,2085,16,0,16,96.32804355
33592c1a38c48efd2b9cbb042a31f94236e0b89b,26,2983,399,2584,11,0,11,3,23,382,1,4,4.149191358,1559,113,0,513,240,273,29769,13151,16618,148,81,67,99.56491871
3be3d239e82b2f977778f3d7163c642980e34474,2,110,67,43,0,0,0,2,6,38,1,2,0.968245218,247,181,0,30,27,3,2534,2150,384,14,10,4,100
5995c32d6ea481dd5dbf494c8f92af8463386816,0,0,0,0,0,0,0,0,0,0,0,0,0,0,893,0,0,0,0,0,0,0,0,0,0,100
f9a9f39b05ba380e56901b78234a801b86c6e719,1,2,1,1,0,0,0,3,5,286,1,1,0,71,459,0,4,4,0,542,523,19,2,2,0,100
356bfd15aeee5e14010f0af8436f261e12f1f907,2,52,9,43,0,0,0,4,14,94,1,2,0.349184374,372,460,1,48,45,3,3616,3287,329,10,9,1,100
1ce7d01775bd547c570fafa808111e4456a185f2,0,0,0,0,0,0,0,0,0,0,0,0,0,0,461,2,0,0,0,0,0,0,0,0,0,100
3d22cb24b2822b6740b555455625431340663bed,0,0,0,0,0,0,0,0,0,0,0,0,0,0,0,0,0,0,0,0,0,0,0,0,0,100
d29dd6cd3a32ddbb22d2fabaec3b42078b217c51,0,0,0,0,0,0,0,0,0,0,0,0,0,0,1,1,0,0,0,0,0,0,0,0,0,100
d5af57b38606e96772bcd0344d489b37c8419077,0,0,0,0,0,0,0,0,0,0,0,0,0,0,2,2,0,0,0,0,0,0,0,0,0,100
deb1c161ccec42d78f692932e5bef19331695954,0,0,0,0,0,0,0,0,0,0,0,0,0,0,3,3,0,0,0,0,0,0,0,0,0,100
63e58164dac143488300b9ce9bf3038a27a81623,0,0,0,0,0,0,0,0,0,0,0,0,0,0,4,4,0,0,0,0,0,0,0,0,0,100
118c25493d2073057b0617a9efb8aa42d52da97d,2,41,51,10,0,0,0,2,20,908,1,1,0.996929708,452,894,1,104,108,4,2606,2662,56,64,64,0,100
d2b08cdb1d6864bf5bb5228b6fd0a592d9dc19f2,0,0,0,0,0,0,0,0,0,0,0,0,0,0,895,2,0,0,0,0,0,0,0,0,0,100
e881d555d40fbbe03ab25051c283715fce537fb5,0,0,0,0,0,0,0,0,0,0,0,0,0,0,896,3,0,0,0,0,0,0,0,0,0,100
b5c65a5441eed37d532bdcd007957ed7c2e80db0,1,17,5,12,0,0,0,2,10,122,1,1,0,569,897,4,109,108,1,4211,4178,33,39,38,1,100
da7c5b68f0777b70ed305df3f8adb0ad107dfe76,2,2,2,0,0,0,0,2,21,0,1,1,1,442,898,5,104,104,0,2606,2606,0,64,64,0,100
1de8cec0ace0a8026f8c7b4e9fd8961d7496b2ca,44,86,88,2,0,0,0,4,93,266,1,22,5.092436333,8217,899,6,881,881,0,64681,64247,434,388,388,0,100
3f2d65a4708c3d457cbdd9c4974afb90c2f2abbf,1,25,21,4,0,0,0,1,2,745,1,1,0,105,900,7,15,14,1,738,728,10,3,3,0,100
7c2b66444177812e26572e6d66a70e29a2855fa9,46,264,86,178,0,0,0,2,66,348,3,34,5.311692165,5390,901,8,575,502,73,48189,47153,1036,244,244,0,100
c94a7d005e938476736f96e652be2b536fa61e5f,1,4,1,3,0,0,0,2,4,348,1,1,0,82,902,9,11,10,1,826,812,14,3,3,0,100
22dc9fe1e12db6e672e00fc885fae24309938423,1,114,115,1,0,0,0,1,3,198,1,1,0,355,903,10,49,48,1,2374,2171,203,26,26,0,100
522dfbb7699cecc24babcad3394935cfb21f3a15,1,1,1,0,0,0,0,6,33,5,1,1,0,212,904,11,28,28,0,1626,1637,11,12,12,0,100
2343aee681db7e70e5b7568dc809eaf39e820889,1,3,0,3,0,0,0,2,5,351,1,1,0,172,905,12,35,34,1,1087,1070,17,24,24,0,100
b9a9f9415a02bd2bb2aa5ca6aa1d4aead4290f89,2,2,2,0,0,0,0,2,2,76,1,1,1,311,179,0,43,43,0,3113,3113,0,6,6,0,100
2153bb95b1dcd1ada274c99bdf1a5a049f7aa3f8,5,253,253,0,1,0,1,3,10,84,1,2,1.833344237,499,180,1,60,52,8,4464,4102,362,34,31,3,98.92522824
529b114bde729951ffe22bd3845dbe19dfdd45df,5,101,81,20,0,0,0,3,11,0,1,2,1.921226295,487,181,2,60,60,0,4464,4464,0,34,34,0,100
a28cf1dc0d4191ccd4b4798a2cdb27348a3d96dd,7,161,4,157,1,0,1,1,12,506,1,1,2.382494496,280,182,3,49,34,15,2754,2102,652,32,17,15,98.09490001
1ac30a4af120f511c04461f5fbef6984d4cfa806,35,599,627,28,0,0,0,3,94,265,3,13,3.410574359,6028,183,4,778,777,1,50635,50718,83,382,380,2,99.07146215
f4fbdbbc5040f0f5802a093fa7662b2e9bd95c16,7,38,38,0,0,0,0,7,33,431,1,1,2.133135218,458,184,5,66,66,0,3414,3414,0,23,23,0,99.10672308
6db7f6287a5720ea3dca07c1c89da4568bb4e84e,30,596,465,131,0,0,0,3,67,77,2,23,3.576315643,4391,462,0,547,514,33,38434,38125,309,221,215,6,99.64501242
03a94924b8c788f1b3e97114fa4d5b1167157bae,15,69,62,7,0,0,0,4,58,129,3,13,3.206709581,2338,463,1,349,350,1,18373,18355,18,132,133,1,100
6a3f566d3d7661d6a78e92996d0d58f45d12eda6,7,632,12,620,4,0,4,1,27,200,1,5,2.099254562,323,185,6,92,36,56,5353,2098,3255,63,31,32,98.17173862
8843678330bf7f80c8ef11344fdeb2b25d37a71c,0,0,0,0,0,0,0,0,0,0,0,0,0,0,464,2,0,0,0,0,0,0,0,0,0,100
dd2b1986a41c8d4423bba93064c47739be1f96b5,3,662,1,661,2,0,2,1,15,215,1,2,1.06378399,196,906,12,128,57,71,4169,1282,2887,56,20,36,99.92873263
175701cb6261ef2f5eab9878d92ba10baec32496,20,1600,1009,591,3,0,3,2,28,132,1,4,3.750535719,3294,17,0,413,387,26,25740,23591,2149,162,150,12,95.3145917
76e80dceb487cc9105b3e993bc9fadd65701fbb8,16,469,203,266,2,0,2,3,33,23,2,5,3.44786579,1502,186,7,222,202,20,13182,12027,1155,130,112,18,98.99715241
457db943e6833e90db1d800fc7ed51f59d479e58,6,266,263,3,0,0,0,1,15,4,1,3,1.437809901,723,187,8,105,104,1,5860,5744,116,62,61,1,100
8d102ea2cea0e43c91e867362ec842fbc286fb26,41,87,56,31,0,0,0,3,70,105,3,16,5.113807131,5381,188,8,721,990,269,46232,77645,31413,341,529,188,97.87656774
8953d93be40143d0ff51481231ce087564086eff,16,18,18,0,0,0,0,1,95,200,1,6,3.947702779,2767,189,9,365,365,0,21841,21805,36,151,151,0,99.50949566
98f66f4f1c2e2b994613177fe05fa130a09423aa,2,138,64,74,0,0,0,2,5,2,1,2,0.858401835,293,0,0,52,46,6,2803,2563,240,30,27,3,100
1371326369e3ca9b019251a19a1e91a97dcb5411,4,125,47,78,0,0,0,2,6,13,1,2,1.630913371,443,1,1,68,61,7,3989,3493,496,38,34,4,100
1627c7d181b83855271d88fcff520f02e5ebf7e2,1,15,2,13,0,0,0,4,26,63,1,1,0,241,0,0,29,26,3,2354,2265,89,11,11,0,100
61bfaaa9a96f3f4512d0bce375b1219b6b3de91e,15,0,112,112,0,0,0,4,27,116,1,2,2.939624942,1814,1,1,221,242,21,15421,16184,763,67,70,3,100
eeaf4a83a056a5dd5fddf5d3ca0745e2be1155ba,1,1,1,0,0,0,0,2,22,70,1,1,0,221,907,1,52,52,0,1303,1303,0,32,32,0,100
63f3118f8aa2e21bb030d209e706f03046ed9a1e,6,21,33,12,0,0,0,2,28,232,1,3,2.128025351,1335,2,2,232,231,1,10938,11080,142,79,79,0,95.09189189
cff65e7cb900ddb5bdf6a88b304020f086da7ee8,12,85,124,39,0,0,0,2,33,61,1,4,2.461008222,2446,3,3,412,411,1,19843,20102,259,114,110,4,100
a93745846d1fb5b41af5f1e33810cefb9f0806f7,4,17,297,280,0,0,0,9,66,32,1,2,1.89562783,990,2,2,86,118,32,7055,9027,1972,43,53,10,99.98104984
d364748c74d1dda33c413cc7f3f3f86943d77696,1,3,3,0,0,0,0,9,67,0,1,1,0,202,3,3,22,22,0,1903,1903,0,10,10,0,100
3eba6f26486dcb9e2ec03702b60a38de399e738f,18,287,242,45,1,0,1,2,23,50,2,6,3.879242604,1664,190,2,199,197,2,13110,12956,154,128,129,1,99.84872837
f99a18f07f743bdde96cc08140715b6bc3312abf,13,123,41,82,0,0,0,4,71,94,3,11,2.40144614,3056,4,4,284,280,4,28732,28102,630,162,160,2,100
90987ff6c7efd130938266d8beb8fed7c61cdc6b,13,334,350,16,0,0,0,6,72,362,2,9,3.203516625,2636,4,4,303,283,20,24823,24001,822,133,135,2,99.85850391
26a6b243d0eb79680521536746687801efdc6628,1,3,1,2,0,0,0,5,21,2,1,1,0,307,5,5,29,29,0,2837,2820,17,18,18,0,100
ba81a9322c8006217df919e89e212e7723cbb9a2,16,175,549,374,0,0,0,4,96,39,2,10,3.298051688,3836,5,3,360,408,48,32176,34130,1954,175,190,15,92.68292683
dfbcfb18efe7f9371bb754dfcc12917f191e88b7,2,14,10,4,0,0,0,6,74,6,2,2,0.738284866,778,6,4,82,82,0,7893,7849,44,24,24,0,100
2cfaf19221b07b57b0b42d9e843a2e464c0ead21,9,53,30,23,0,0,0,4,97,16,3,8,1.598973941,2199,7,5,186,185,1,20555,20476,79,86,86,0,100
73ff886ec2fdb7598d69a930f1308ed5321e6ce5,1,3,3,0,0,0,0,2,7,4,1,1,0,118,8,6,16,16,0,955,953,2,7,7,0,100
68826d977fb5bd94cd93382019c149030e696360,1,8,6,2,0,0,0,6,14,11,1,1,0,349,9,7,22,22,0,3231,3209,22,12,12,0,100
51f58b8b5a066d0afabc850c19fae21b9f24ca95,35,333,217,116,0,0,0,6,98,191,2,15,4.672363924,6382,10,6,752,750,2,56753,55646,1107,269,269,0,92.0404632
bf2df6e86e2ed7efdd631adc8d347ff409a411a4,1,46,77,31,0,0,0,2,9,23,1,1,0,209,11,3,27,27,0,1687,1687,0,14,14,0,100
fd355fe7b249b552160eba3ce72aee3a09ee08e8,6,30,293,263,0,0,0,4,73,39,2,5,1.905885337,1835,12,4,144,171,27,14572,16402,1830,68,74,6,94.26268944
1b7d47acd8392ca5ac632a8ff6d331ac27301160,14,68,1839,1771,0,0,0,10,99,139,1,4,3.357130473,2216,13,5,89,288,199,7327,18597,11270,31,92,61,92.9746444
d6b1b5f518b55c045258e36bfbeeaeaf079eb456,1,1,1,0,0,0,0,3,7,365,1,1,0,85,908,0,12,12,0,789,781,8,2,2,0,100
eccd384b0ed93fe51ba4d52b70f6a701c4bad50a,1,3,2,1,0,0,0,3,15,206,1,1,0,259,909,1,30,30,0,2362,2344,18,2,2,0,100
4df72fbac47d88ce3d66bf9a67f7e88276500a1a,3,74,51,23,0,0,0,2,29,1017,1,1,1.552061072,1326,910,2,369,364,5,7724,7551,173,158,153,5,100
9ebd317942cdfd90395785a3cad7b2f571f9bf63,2,20,11,9,0,0,0,11,100,28,1,2,0.907165768,391,14,3,34,31,3,2585,2582,3,12,12,0,100
3f1b344c77fec2124ca7eb32748f4da7fa32f9ff,0,0,0,0,0,0,0,0,0,0,0,0,0,0,191,0,0,0,0,0,0,0,0,0,0,100
6b390e785eacbd91dd53ca71a10fafd410c93e93,1,10,13,3,0,0,0,1,3,122,1,1,0,125,192,1,17,17,0,1182,1182,0,4,4,0,100
9d08db8b658fef04eadf3eae6669d9b45269640b,1,3,1,2,0,0,0,3,7,216,1,1,0,344,911,0,44,44,0,3215,3200,15,18,18,0,100
e1b128959e1109a067399cc5670d75393f858ecc,1,395,0,395,1,0,1,1,1,0,1,1,0,0,73,0,56,0,56,2760,0,2760,24,0,24,99.89946862
21cdb526fae3897af5fb74f5d1af2b2af5ca3be2,1,9,0,9,0,0,0,1,3,929,1,1,0,70,912,1,12,11,1,475,444,31,12,11,1,100
137423f4e5f0d822cd44615125a87f836429923c,0,0,0,0,0,0,0,0,0,0,0,0,0,0,6,0,0,0,0,0,0,0,0,0,0,100
9c7a9e7488555d27bd7f6a0bebb4021671b1842f,5,1010,1025,15,2,0,2,1,24,303,1,5,1.327049769,960,182,0,163,194,31,9241,8736,505,28,29,1,99.7848537
2fd2aed8702c9bd4490978f9c0eee2f27ba66958,2,18,3,15,0,0,0,1,2,6,1,2,0.702466551,728,183,1,132,131,1,7763,7437,326,16,15,1,100
f514c8294e6a61d8b1a345738d3870919f888e78,1,34,30,4,0,0,0,1,3,1,1,1,0,639,184,2,127,126,1,6749,6745,4,12,12,0,100
298eef9ddff628a9ce6b4d2c77644f7166cec9cd,1,11,0,11,0,0,0,3,8,35,1,1,0,345,74,1,45,44,1,3289,3215,74,18,18,0,100
3bf7a1c54816fb5c055d897389ba0c37a66404ed,3,68,2,66,0,0,0,1,42,328,1,3,1.51248501,772,75,2,127,124,3,7638,7252,386,59,57,2,96.23409669
f60ceca58810052e30842d25305941c1bb9c9dc1,2,0,4,4,0,0,0,3,43,0,1,2,1,685,76,3,123,123,0,5977,6017,40,55,55,0,100
590ffede5cf8cac72c6c278b09a270bf99c13c25,29,409,1728,1319,0,0,0,3,101,210,3,13,3.798735041,4635,193,0,389,516,127,33292,39503,6211,212,292,80,94.02072151
4aa9091ce6f5e06b4a9c21af682ab82579d203b2,1,2,2,0,0,0,0,6,68,261,1,1,0,218,913,1,24,24,0,1773,1775,2,3,3,0,100
d994ab807a6a08965be959d17b9ae3157fb75971,7,0,915,915,0,0,0,2,7,385,1,4,2.684239758,591,77,4,0,39,39,0,5565,5565,0,23,23,99.72463169
b06077a7217548e3c3a7c5748dc03bf9e52015b6,59,0,6466,6466,0,0,0,5,37,989,2,7,5.675601574,4037,78,5,0,462,462,0,34895,34895,0,164,164,97.75249333
9bbc7a0c10f43a77e0b7459f1c15c4ce7addc184,5,10,6,4,0,0,0,2,3,410,1,2,2.186278124,249,79,6,23,23,0,2349,2285,64,16,16,0,100
0a80b544349320c89b495fc2f78588297359d929,65,13,6886,6873,0,0,0,3,32,1155,2,12,5.776020074,3981,80,6,20,564,544,727,32569,31842,10,298,288,96.65121842
26cee84a0b90ce98b7b9a540018c3ba017289595,0,0,0,0,0,0,0,0,0,0,0,0,0,0,81,7,0,0,0,0,0,0,0,0,0,100
5257bc9d294a28c83e6b50e70d1ef2026976e43f,4,39,33,6,0,0,0,5,32,360,1,2,1.986053575,389,114,0,48,48,0,3385,3349,36,15,15,0,96.20684316
9a15cb8d2e13b44f88b45428c37bbd6bb14eabcc,7,1111,0,1111,7,0,7,1,1,0,1,2,2.688638903,0,115,1,96,0,96,6297,0,6297,27,0,27,99.66417341
39b8c2d006a2df6c1e919d883a4d220148908cec,3,4,6,2,0,0,0,1,2,0,1,1,1.485475297,304,116,2,29,29,0,2337,2357,20,9,9,0,99.90859232
8dd6dba6dfac61d8e74859827cdfd564bdb0b27a,0,0,0,0,0,0,0,0,0,0,0,0,0,0,117,3,0,0,0,0,0,0,0,0,0,100
1526c5b9e465aaae38b90eae7e208cf41e5bd2b4,8,329,139,190,2,0,2,1,7,509,2,4,2.431585179,312,118,4,35,26,9,3829,2864,965,19,16,3,99.95429616
e64dd36ec79d1c22a6161078f5363cfb5f89ff91,87,420,420,0,0,0,0,3,77,489,4,54,5.297558365,14285,7,1,2459,2459,0,111115,111115,0,906,906,0,100
44459bda14b550d8929728294bc9af412aa41852,42,573,577,4,0,0,0,5,69,196,4,33,2.811790724,7779,8,2,1395,1395,0,60166,60226,60,405,405,0,100
d8d721acc0b4616b688bbe56b5fe5ae96dda407d,17,242,364,122,0,0,0,1,13,371,2,5,3.195827579,835,119,5,85,87,2,6963,7382,419,55,55,0,99.92385014
0d7555556bcc4a9a5aef16340e09df54bd1e8658,1,2,2,0,0,0,0,2,9,463,1,1,0,57,914,1,15,15,0,391,391,0,9,9,0,100
35fa73f05fa65905e4b9e26f8fdbea51d2e945f4,40,6853,6583,270,19,0,19,3,26,1369,1,9,4.509935107,3721,185,3,1011,871,140,31256,22836,8420,341,361,20,92.52292865
8fa659d3db512a0f0db1af065d9445f093c8ec85,0,0,0,0,0,0,0,0,0,0,0,0,0,0,186,4,0,0,0,0,0,0,0,0,0,100
d63c631e347e63afc8a19c88f912e0b094b3b7af,2,15,3,12,0,0,0,1,10,671,1,2,0.964078765,86,915,2,17,16,1,831,692,139,11,10,1,100
ff886ecec5048a030708c5b3a99b2a4401e8b8d2,1,1,1,0,0,0,0,3,23,41,1,1,0,113,194,1,12,12,0,886,886,0,6,6,0,100
3f09bcd423a4216f6a7e6ee8ff478028864530d6,1,15,33,18,0,0,0,3,8,41,1,1,0,259,195,2,36,43,7,2195,2272,77,12,13,1,100
bd7f364c9ad10bdec910aff5c8bb7865e45c3676,1,18,0,18,0,0,0,6,46,49,1,1,0,324,465,0,79,77,2,2721,2663,58,38,37,1,100
50b4637a387f54729144bb38699df672aa76e8f1,1,117,175,58,0,0,0,4,10,68,1,1,0,348,196,2,21,18,3,3622,3384,238,17,16,1,100
73c5336bc755373b6edc51d41abd2b6453b3da11,1,96,159,63,0,0,0,4,11,68,1,1,0,339,197,3,22,21,1,3289,3267,22,18,17,1,100
2e681c461c685c23e13ad7ada0eba5a9136c29a2,3,32,18,14,0,0,0,7,78,51,1,2,0.987785743,275,198,4,28,28,0,1961,1959,2,10,10,0,100
e69bcbd022f59e1ec0fb6cec5fea0a742c761cf3,3,81,114,33,0,0,0,4,12,70,1,3,1.2293036,755,199,5,59,62,3,8261,8532,271,42,43,1,100
03fca8714727e38b8efa2ea8e5320c170e11bfcf,1,1,1,0,0,0,0,8,57,190,1,1,0,184,466,1,10,10,0,1316,1319,3,6,6,0,100
a344c6be5962fae2f762b6a487065fbd06673e25,9,9,9,0,0,0,0,3,9,54,1,3,3.086048612,557,120,0,74,74,0,5288,5262,26,34,34,0,100
bb10835b8e092fbf709ccd8c55edbd078cbd5491,11,41,1504,1463,0,0,0,6,49,767,1,3,2.927347156,1101,82,0,19,162,143,896,9139,8243,8,70,62,99.64962574
cd02e8bd4ed8d7425eedfe37f42fa23a605f6dbd,1,11,0,11,0,0,0,7,26,641,1,1,0,138,121,1,47,42,5,1259,1173,86,8,7,1,100
1bdf3ab8af012cb3248384073f99c1dc69f7e97f,5,8,9,1,0,0,0,2,8,369,1,2,2.027489311,145,122,2,26,26,0,1013,1027,14,22,22,0,100
9a0617dd700bc428746d9ac447f6dacfea0074dd,0,0,0,0,0,0,0,0,0,0,0,0,0,0,123,3,0,0,0,0,0,0,0,0,0,100
2ab5e922cf165b77a8304d9c86feb16a32baa9ac,1,3,3,0,0,0,0,3,8,0,1,1,0,124,124,4,15,15,0,1196,1203,7,4,4,0,100
d94eb39fa85641da388646a5d9e8d340910f7b8d,10,76,53,23,0,0,0,3,14,20,1,4,3.040050296,614,125,5,74,75,1,5358,5360,2,48,46,2,99.82408444
cfd85f859c73b3c7899a9337bd4aeab5e1281eb7,1,1,1,0,0,0,0,6,16,237,1,1,0,120,83,1,5,5,0,1111,1111,0,3,3,0,100
69ea83dade036e74d5d0c40e3f060ba3ac4ad9bd,0,0,0,0,0,0,0,0,0,0,0,0,0,0,126,6,0,0,0,0,0,0,0,0,0,100
b758f8d8f3c9d7db89add438eff1a5f599cf826d,0,0,0,0,0,0,0,0,0,0,0,0,0,0,127,7,0,0,0,0,0,0,0,0,0,100
79b654d49d19ef3463152864e0485b9f500e8ed4,0,0,0,0,0,0,0,0,0,0,0,0,0,0,84,2,0,0,0,0,0,0,0,0,0,100
3beecc0e8e48909ab17f70022adf7ee878bbe696,4,13,13,0,0,0,0,2,5,565,3,3,1.290120853,305,128,8,38,38,0,3070,3067,3,14,14,0,100
f4d9a5b22e7fac290b74717a1f78c908f211d0c4,1,1,2,1,0,0,0,3,9,4,1,1,0,18,129,9,3,3,0,153,153,0,3,3,0,100
5b94d3fbb16d73a0e88dfd7ab04b79ff33bbba24,1,32,12,20,0,0,0,2,16,327,1,1,0,199,916,0,62,58,4,1377,1291,86,22,21,1,100
36e198142d8e876b622f0563c8176066185b8ecf,6,0,686,686,0,0,0,4,20,1700,1,1,2.319927608,502,917,1,0,84,84,0,3417,3417,0,61,61,96.77313138
6d0a451f7068cfacd9384d6e50908b4c01dad7e3,0,0,0,0,0,0,0,0,0,0,0,0,0,0,130,10,0,0,0,0,0,0,0,0,0,100
7c8c27eeb83e065740a49b4551c01d7100b90344,0,0,0,0,0,0,0,0,0,0,0,0,0,0,131,11,0,0,0,0,0,0,0,0,0,100
d521b72eec4964d547922e357ad77f2b4fc1f06e,2,27,12,15,0,0,0,1,8,1134,1,2,0.779349837,298,200,4,44,40,4,3272,3130,142,27,25,2,100
d0b12880eb7e7dc965e5cb174f8311a2de4a54f1,0,0,0,0,0,0,0,0,0,0,0,0,0,0,15,0,0,0,0,0,0,0,0,0,0,100
f467a7b4e23c950e1f60a10eb122bce170c44aec,1,10,0,10,0,0,0,4,9,0,1,1,0,61,201,5,17,13,4,485,455,30,6,6,0,100
eec57e4ff74eff067b2ac4093a93c008b5287af9,0,0,0,0,0,0,0,0,0,0,0,0,0,0,132,12,0,0,0,0,0,0,0,0,0,100
9e154d923ee0f8801edac9e8a9df6f6f824958a0,0,0,0,0,0,0,0,0,0,0,0,0,0,0,133,13,0,0,0,0,0,0,0,0,0,100
86b1196bb540df26fcb03ae5c03904779924face,2,154,141,13,0,0,0,5,10,40,2,2,0.058592302,254,134,14,26,26,0,2254,2495,241,8,7,1,100
ee910dfbfbeee2bcff9afd83f0bdcf4c9356e08b,0,0,0,0,0,0,0,0,0,0,0,0,0,0,16,1,0,0,0,0,0,0,0,0,0,100
1f59d8ea289ffb8290e39f5b3fe2fec42e0a2591,0,0,0,0,0,0,0,0,0,0,0,0,0,0,135,15,0,0,0,0,0,0,0,0,0,100
caacd5c28d435d5ed45617ad3fc18623d3e2a318,0,0,0,0,0,0,0,0,0,0,0,0,0,0,17,2,0,0,0,0,0,0,0,0,0,100
abb4fe4c8c949fc310f086f4397fe0645d67ba29,0,0,0,0,0,0,0,0,0,0,0,0,0,0,18,3,0,0,0,0,0,0,0,0,0,100
159174ebfbeede79b9bcef3e1c3ade5aac24d6c1,0,0,0,0,0,0,0,0,0,0,0,0,0,0,19,4,0,0,0,0,0,0,0,0,0,100
a320da91873e98640378fd0afbf811d820526087,0,0,0,0,0,0,0,0,0,0,0,0,0,0,20,5,0,0,0,0,0,0,0,0,0,100
f692f7d69577ce6bb2e7e045c0ce9c3d72c76dd8,0,0,0,0,0,0,0,0,0,0,0,0,0,0,21,6,0,0,0,0,0,0,0,0,0,100
256c7a70a19243c6304c972a8a0c81463d798a56,0,0,0,0,0,0,0,0,0,0,0,0,0,0,22,7,0,0,0,0,0,0,0,0,0,100
cb7e6cd5b4581c26a93edaa71fba54b35f11e79d,0,0,0,0,0,0,0,0,0,0,0,0,0,0,23,8,0,0,0,0,0,0,0,0,0,100
b8c11c6c9ce4777ace544427ef9685ce9c56864d,0,0,0,0,0,0,0,0,0,0,0,0,0,0,24,9,0,0,0,0,0,0,0,0,0,100
0596971048899c0243370e20104d12d24675a39f,0,0,0,0,0,0,0,0,0,0,0,0,0,0,25,10,0,0,0,0,0,0,0,0,0,100
9d083f17b6a4fa099dac6783c5de500539ccaa85,1,16,18,2,0,0,0,3,5,234,1,1,0,74,202,6,11,10,1,622,614,8,2,2,0,100
44bf39a9f02ac39589f4cdf542117336da43b03d,1,8,7,1,0,0,0,3,6,0,1,1,0,71,203,7,11,11,0,622,622,0,2,2,0,100
214b3292a9975c7a1bf635e99e84c00290c47c47,1,2,2,0,0,0,0,3,7,0,1,1,0,72,204,8,11,11,0,622,622,0,2,2,0,100
90cd33ae5be980c60ffd7b37b108c238f4397e98,3,19,17,2,0,0,0,8,102,116,1,1,0.803071727,280,205,9,33,33,0,2396,2354,42,10,10,0,100
87eed5bd06efdac96fa99883d37985e2dae1779f,1,2,2,0,0,0,0,7,33,0,1,1,0,37,206,10,6,6,0,360,360,0,2,2,0,100
a4740550cbfe6d1ceac08c011f095ade423800fc,0,0,0,0,0,0,0,0,0,0,0,0,0,0,136,16,0,0,0,0,0,0,0,0,0,100
e5cbfb226d808dc51ebe419524c494171c42e34a,0,0,0,0,0,0,0,0,0,0,0,0,0,0,54,0,0,0,0,0,0,0,0,0,0,100
a99ce3c8370e029bd5df4b6d2a7bbe9e2f01a607,8,151,233,82,0,0,0,3,79,288,3,7,1.947841839,870,207,11,65,71,6,6766,6915,149,31,33,2,90.84217093
25c5e7aae291e5463178ec5a6d76e29a8859bc39,0,0,0,0,0,0,0,0,0,0,0,0,0,0,26,11,0,0,0,0,0,0,0,0,0,100
1ac5f1af46bfd48b29d97f3663d0328f6d890b5d,0,0,0,0,0,0,0,0,0,0,0,0,0,0,27,12,0,0,0,0,0,0,0,0,0,100
4c112817b845cdae6a1967a0680d5f7aa4c3b75e,0,0,0,0,0,0,0,0,0,0,0,0,0,0,28,13,0,0,0,0,0,0,0,0,0,100
010f8ebf35a322604d6497e175a1fe20924a991d,0,0,0,0,0,0,0,0,0,0,0,0,0,0,29,14,0,0,0,0,0,0,0,0,0,100
9be3b158c5341d4cca33ada6ce1155e7ca5b25f3,0,0,0,0,0,0,0,0,0,0,0,0,0,0,30,15,0,0,0,0,0,0,0,0,0,100
c4bd519bb4daacd73d6a856ed8588d98a39363e3,0,0,0,0,0,0,0,0,0,0,0,0,0,0,31,16,0,0,0,0,0,0,0,0,0,100
229aeff334882293c915b27e40a4864878a644b9,214,1905,2078,173,0,0,0,2,103,270,4,96,6.377428888,35551,918,0,5580,5606,26,283257,284315,1058,2136,2142,6,96.43942683
0f5531490c8c05de53788acf1a527d461b0484f7,1,16,6,10,0,0,0,2,4,5,1,1,0,88,85,0,18,15,3,843,771,72,8,8,0,100
c6df97ba6352e56bb1d5a431c1eafb64366ed634,2,4,19,15,0,0,0,6,16,4,2,2,0.426228657,261,919,1,46,46,0,1922,2017,95,7,7,0,100
b285e2d2b39b64b7f5e4c43a919ffad398af0b29,2,56,1,55,1,0,1,1,7,2,1,2,0.297472249,195,86,1,54,51,3,1401,1177,224,30,27,3,99.93972999
1608f61a2092a021a28b37b1d06fbaedf8049a5a,9,413,47,366,2,0,2,3,5,323,2,8,2.118922689,1031,920,2,251,206,45,10845,7997,2848,86,75,11,99.81892805
2cd3ea39e3dc70f1ffcffae92cb0901894bed63b,1,1,1,0,0,0,0,6,48,5,1,1,0,335,921,3,80,79,1,2723,2719,4,38,38,0,100
c9a79471aa9b1c9ff8ce5f8695357e6dab91cd5b,3,40,18,22,0,0,0,1,6,812,1,2,0.886934313,336,922,4,24,21,3,2698,2499,199,8,8,0,100
35e02588b398447ac1b70077ce529c55e53a2108,1,3,1,2,0,0,0,3,5,22,1,1,0,94,87,2,12,12,0,762,746,16,6,6,0,100
7d90a581ef2c1a6059ff06403c98069211b89cee,2,6,5,1,0,0,0,2,12,28,1,1,0.994030211,529,88,3,74,74,0,4618,4583,35,34,34,0,100
a793d3a64edc544ffe5edcf3f7c164814c4f9a22,1,1,1,0,0,0,0,2,5,788,1,1,0,608,923,5,78,78,0,3898,3898,0,38,38,0,100
09ab62452c81d0423e957bc9e8ac9acb10651ac7,1,1,1,0,0,0,0,4,34,425,1,1,0,71,924,6,5,5,0,477,477,0,2,2,0,100
0a0551eb06149e2919707237f678e4e9953c836e,0,0,0,0,0,0,0,0,0,0,0,0,0,0,925,2,0,0,0,0,0,0,0,0,0,100
c395a3b7e68748f88068e8c86ed81d71f77a650a,4,26,17,9,0,0,0,6,71,423,2,3,0.972197183,1569,89,2,253,253,0,12302,12247,55,84,84,0,95.82893347
49a8268ded2d0b9da8866b7aa3676d7acbeae061,0,0,0,0,0,0,0,0,0,0,0,0,0,0,926,3,0,0,0,0,0,0,0,0,0,100
f543a10d285c7cf97b5d845a938ec24e6feae88b,2,61,0,61,0,0,0,1,19,534,1,2,0.995148096,85,927,4,18,11,7,1420,881,539,8,5,3,99.95641435
1029bc039fa6b13e000efe9dbdff7800e04be2fc,2,14,5,9,0,0,0,6,26,567,1,2,0.998000884,631,187,0,136,135,1,5874,5817,57,71,70,1,100
c4b3169a8de7716d9a2d48ddd0902eee3248dd2d,1,1,1,0,0,0,0,1,2,456,1,1,0,210,928,3,53,53,0,1407,1407,0,18,18,0,100
39a3539b81ad86b488f408eb5441e3328981a07f,1,2,2,0,0,0,0,6,17,110,1,1,0,213,59,0,42,42,0,1586,1586,0,3,3,0,100
22b0c3d3ca7fb07f5abf34aab6ad3449d5b69c7b,5,385,285,100,1,0,1,4,14,237,1,4,1.71467881,872,208,0,109,100,9,10025,9184,841,56,51,5,99.88358556
4300ff31500eab95d54fc6fff2eb5441b4585825,1,25,7,18,0,0,0,4,7,150,1,1,0,424,60,1,50,47,3,3622,3486,136,18,18,0,100
c831d30bee3604202f24bf7ba8ec31925a740304,3,0,159,159,0,0,0,8,59,428,1,2,1.031878781,522,209,1,62,80,18,2794,3572,778,38,52,14,99.94166545
74f9303eeaaf278c507bbabc306c6341af5fc03a,2,155,16,139,0,0,0,2,8,160,1,2,0.98909344,264,90,0,53,35,18,3451,2368,1083,25,19,6,100
62eeeae391554793dac788c062588deb89ba7ed4,5,14,2,12,0,0,0,1,36,1495,1,3,2.052421284,420,91,1,67,66,1,3373,3282,91,41,40,1,99.71077368
ba4bd06db2d753d75b00613ade842f5c90f543e1,1,0,41,41,0,0,0,1,2,30,1,1,0,36,210,2,0,2,2,0,310,310,0,2,2,98.81878421
e73d67ff0b96170fb61a66779a34142f6463d199,1,1,1,0,0,0,0,2,4,1490,1,1,0,65,92,2,17,16,1,506,498,8,10,10,0,100
b293384f8641db47ce9103f492f5115fe15867f4,1,11,2,9,0,0,0,2,9,48,1,1,0,223,93,1,40,39,1,1857,1801,56,19,18,1,100
0e291d4e8ad48763447c2cf3826b331392864a41,1,24,0,24,0,0,0,2,5,10,1,1,0,65,94,2,23,17,6,612,506,106,14,10,4,100
7dc7e095943c1e916da88b3f5d58e8b99d3d187a,3,10,1,9,0,0,0,3,7,804,1,1,1.309296668,289,188,0,61,57,4,2120,2034,86,33,33,0,100
0fe5282a038e5e5c960912fb32569cd77c77bd75,1,24,1,23,0,0,0,2,6,214,1,1,0,265,189,1,12,11,1,2169,1989,180,7,6,1,100
a07bfc3abfca6b81b4de537d921828e8728a3a77,26,2560,0,2560,26,0,26,1,1,0,1,4,4.426953384,0,190,2,286,0,286,12408,0,12408,168,0,168,99.12444381
0b8db82fb99bdd664a1aabed17dc338e8bc3ebc6,4,151,152,1,0,0,0,1,18,84,2,2,1.714141687,189,191,3,14,14,0,1379,1379,0,8,8,0,100
3d4e6e2e0e2e2a1f8f73f7d83305ce738c5fb477,4,143,28,115,1,0,1,1,3,0,1,2,1.406384598,297,192,4,56,52,4,2678,1500,1178,54,51,3,100
0e847ae12d1bc62c9f8bdd16aa3a7ba942c622ac,1,184,184,0,0,0,0,1,3,0,1,1,0,229,193,5,50,50,0,1003,1003,0,49,49,0,100
aebdfaf6f87a8b89449ba0eb5020a60ee92ab22a,6,250,45,205,2,0,2,1,38,211,1,2,2.05718853,982,194,6,239,223,16,7920,6502,1418,114,108,6,99.90046922
be028c7a1ba0e9af8c4a761ad9d89075efbad814,1,38,0,38,0,0,0,1,4,0,1,1,0,33,195,7,4,2,2,660,183,477,4,2,2,100
ba3d406896bcb927bf9c5e05b4563d90444833c8,0,0,0,0,0,0,0,0,0,0,0,0,0,0,196,8,0,0,0,0,0,0,0,0,0,100
5fc1b502dfd649c4c4112252309ef68f453c397a,1,484,0,484,1,0,1,1,1,0,1,1,0,0,197,9,42,0,42,1692,0,1692,27,0,27,99.94320602
500d981c93dddbb5b9e28cdce02e47c120372273,1,1,1,0,0,0,0,1,2,8,1,1,0,82,198,10,9,9,0,617,619,2,3,3,0,100
fab8d87d14361db02e37ea756e9b1640b2f74ba0,1,8,1,7,0,0,0,5,87,861,1,1,0,459,929,0,111,111,0,3319,3282,37,36,36,0,100
e9787eff04cfcfd6192b2412b7053efdc7f120bd,1,3,1,2,0,0,0,3,41,278,1,1,0,154,930,1,26,25,1,1338,1328,10,5,5,0,100
478cad97b77c6bee4c9a53685a8d7a41b5d99f3c,5,200,34,166,0,0,0,3,20,366,1,1,1.62898398,1162,18,0,140,123,17,8427,7706,721,50,44,6,100
2424717bdb4309d9d6f84c264feecee09b8c52ef,3,13,10,3,0,0,0,9,61,416,1,2,1.264672679,510,211,0,58,57,1,4299,4292,7,20,18,2,100
a8f16b8bf83b1bb049f5bd7a83c2d4e0c8b04925,1,199,0,199,1,0,1,1,1,0,1,1,0,0,95,0,28,0,28,1283,0,1283,10,0,10,99.92904782
a89b08167ae581eb2907f19224ab265856cef8e9,2,176,179,3,1,0,1,1,10,500,1,1,0.999948485,136,96,1,23,46,23,1239,2440,1201,8,16,8,99.94324631
7a01e245feaa8eb1f9cf6f2d7897b7153f829a1d,1,506,0,506,1,0,1,1,1,0,1,1,0,0,931,1,58,0,58,3008,0,3008,28,0,28,99.97163925
8b6a26a153cd87720b6f323da1317ea6177a998f,38,230,207,23,0,0,0,2,72,119,3,16,4.65121511,5384,932,1,754,754,0,38870,38892,22,300,300,0,97.9847858
0bce4cd90a7b8fca3da894e4abff30edd78b1804,1,1,1,0,0,0,0,9,81,329,1,1,0,198,32,0,15,15,0,1252,1252,0,6,6,0,100
0ab9b15356197e7387714484da9c1cd39a555c84,1,4,7,3,0,0,0,3,11,329,1,1,0,105,33,1,15,15,0,887,889,2,7,7,0,100
1e3f7aedc67c6c7c7e55afc282447387c7952f91,17,826,614,212,0,0,0,2,62,597,2,3,2.598484274,3386,199,0,621,587,34,27090,25863,1227,319,307,12,98.23610936
f181ccef73aa77493f846fc27ca34bb58590ddcf,0,0,0,0,0,0,0,0,0,0,0,0,0,0,200,1,0,0,0,0,0,0,0,0,0,100
1b50c196538a1cc9223f67ac4e41927790b98638,2,63,7,56,0,0,0,2,28,0,1,2,0.881290899,734,201,2,161,149,12,7214,6795,419,82,80,2,100
f8125269795412cdc1b8602adfb24ea2754a368c,0,0,0,0,0,0,0,0,0,0,0,0,0,0,202,3,0,0,0,0,0,0,0,0,0,100
308d034c4fb0ca62239c1dd63335ebc981f8e981,1,4,8,4,0,0,0,4,6,443,1,1,0,382,203,4,78,78,0,2474,2482,8,31,31,0,100
c4714d8fe38a5d44d8cdd2385942bdb773e83754,1,21,19,2,0,0,0,4,17,41,1,1,0,155,19,1,19,14,5,1126,1071,55,2,2,0,100
ca9b6d0c814bffc8551debcf2317a60c0ab58df3,3,123,1,122,2,0,2,1,6,113,1,2,1.346276162,317,204,5,92,69,23,2685,1958,727,39,27,12,99.87422966
03e68753602be563af8d19c9e62659ecc9cca67f,4,36,16,20,0,0,0,3,22,93,1,2,1.655067348,1181,20,1,143,139,4,7507,7434,73,50,50,0,100
b20785fc9d11868bc1c9551ce1db71ef795f9b8e,2,149,1,148,1,0,1,1,34,734,1,2,0.102158036,337,933,2,84,76,8,3642,2479,1163,28,23,5,99.93720959
5a76df996586396ac28c54474668b207c9274900,1,7,1,6,0,0,0,1,4,1033,1,1,0,152,934,3,25,24,1,1157,1132,25,9,9,0,100
570202f378e10e4027758e816b82f1e24b64b78e,1,3,1,2,0,0,0,2,5,1113,1,1,0,33,935,0,6,6,0,221,212,9,5,5,0,100
48daaac77adfa6fc2e3eb4d6ddc0f757e28b6b14,1,1,1,0,0,0,0,3,42,105,1,1,0,156,936,1,25,26,1,1332,1338,6,5,5,0,100
d688be00c27311031db14a7644a248f9e4cb1881,1,1,2,1,0,0,0,2,3,71,1,1,0,275,937,2,42,42,0,1686,1695,9,27,27,0,100
9e1ffa407672020df5485c1373a7adcc2d03c1d1,1,224,0,224,1,0,1,1,1,0,1,1,0,0,97,0,25,0,25,1310,0,1310,11,0,11,99.96235885
d51e8b7358ae605e0770f6cf8ba8323503964585,1,186,0,186,1,0,1,1,1,0,1,1,0,0,98,1,25,0,25,1193,0,1193,6,0,6,99.93728835
6413ec447742fbb8a86030a7ce9cccdcc9e32ef2,1,1,0,1,0,0,0,6,19,402,1,1,0,255,34,0,39,39,0,1953,1946,7,17,17,0,100
c98080785a6ffd1b60a3b86862be86b61c9b8dee,1,1,0,1,0,0,0,5,88,167,1,1,0,466,938,0,111,111,0,3336,3319,17,36,36,0,100
e7011776a60d81073f21306158f3e9ed8cfc1582,1,80,9,71,0,0,0,2,10,1588,1,1,0,108,205,0,14,6,8,1994,1479,515,5,4,1,100
acda70bccad1a506f13053e216a22c9ecfc5997c,4,58,52,6,0,0,0,2,6,104,1,2,0.750671704,885,206,1,165,165,0,7460,7421,39,109,109,0,100
df130cb98c8d8f4accddbcd793a11677b6e2aa36,1,75,46,29,0,0,0,1,2,216,1,1,0,74,207,2,11,10,1,387,368,19,8,8,0,100
a2375a39c11c09fcd10bbdfee7d5cffda64e2baa,2,19,3,16,0,0,0,5,14,1007,1,2,0.902393283,221,208,3,42,42,0,2364,2102,262,18,18,0,100
0600c3786af720f261f51f916ae6624dd2193c7b,1,93,0,93,0,0,0,2,17,444,1,1,0,451,939,1,137,119,18,2978,2640,338,65,50,15,100
5c13640d05309e1a4b7fb99142546cd9bb89ee4e,3,60,31,29,1,0,1,2,7,72,1,2,1.342789207,157,940,2,24,24,0,1213,1154,59,18,18,0,99.97492477
6529d6340eae2123297d0857d9fbb81f3e8c8176,3,75,57,18,0,0,0,2,31,302,1,1,1.509530689,1417,941,3,403,384,19,8211,8007,204,174,173,1,100
606139dff68790be49816f8857fb22f5edb17020,0,0,0,0,0,0,0,0,0,0,0,0,0,0,467,0,0,0,0,0,0,0,0,0,0,100
4884cc4f94b93fb461e2416a89c2cf5207d9213e,2,38,34,4,0,0,0,2,10,1634,1,2,0.997772472,108,942,3,24,23,1,635,591,44,10,10,0,100
04c337423690a1ba25f9eb1f602dd4caeb472aaf,4,76,37,39,0,0,0,1,11,853,1,4,0.991414536,196,943,4,46,35,11,1592,1399,193,23,18,5,99.93727261
0c1cb71aa95e4ec789159bf80174fe5ee00c2fb9,2,12,14,2,0,0,0,2,43,350,1,1,0.961236605,214,944,2,45,40,5,1762,1730,32,14,14,0,100
f96f852a9c77b72c2a521fa89801b202df41624a,12,12,0,12,0,0,0,3,38,1478,1,4,3.584962501,1540,99,0,304,304,0,12275,12251,24,90,90,0,100
e527616c988f96e3cf60fac7c1229769a8f12935,1,60,19,41,0,0,0,2,11,89,1,1,0,161,209,0,15,14,1,2139,1994,145,5,5,0,100
dde8b34fdbfb0634a51824ed45ae419eff313212,1,1,1,0,0,0,0,2,12,0,1,1,0,169,210,1,15,15,0,2141,2139,2,5,5,0,100
127d4503c4408f44695ca0e67302e7f67ecdd417,8,108,126,18,0,0,0,2,12,616,2,7,2.679503926,452,945,0,67,70,3,2769,2919,150,32,32,0,100
2deba3678e74cf3a59dcc670e9116e50795d590e,27,231,416,185,0,0,0,5,21,1040,4,19,3.412197195,2574,946,1,347,363,16,21080,21714,634,151,158,7,99.9120603
7dac77913f714143ea76e1c130a2af55ac2374c1,0,0,0,0,0,0,0,0,0,0,0,0,0,0,211,0,0,0,0,0,0,0,0,0,0,100
63546f99df425b9601511925e785fec619bce110,4,5,13,8,0,0,0,2,10,1433,1,4,1.925126559,385,212,1,88,89,1,2134,2174,40,58,59,1,100
ac0abc69d9bcbab4e7e3c2b8afddfeb2fbb2fbe6,2,23,1,22,0,0,0,3,5,798,1,2,0.41381685,395,213,2,63,62,1,2683,2459,224,25,24,1,100
441c8b32dddb80bbdb7844016c9bfda2eabe577d,1,1,14,13,0,0,0,3,6,2,1,1,0,332,214,3,56,58,2,1910,1979,69,22,22,0,100
69653557a82d62ce18ac2b2f3292ee422ed939f8,1,7,0,7,0,0,0,4,6,633,1,1,0,99,100,0,13,12,1,966,924,42,6,6,0,100
034f21a11b57b65945d017d1c6d74c3589a1f469,1,4,6,2,0,0,0,4,10,683,1,1,0,49,101,1,10,10,0,300,307,7,8,8,0,100
b90e8466bc9a4042a648f7f73173e58e012ee8d5,1,1,1,0,0,0,0,6,18,635,1,1,0,119,102,2,5,5,0,1107,1107,0,3,3,0,100
2b8b2a7d5b9cc726e436e28ad6ff8a5555a36a50,1,1,0,1,0,0,0,4,12,635,1,1,0,140,103,3,10,10,0,1135,1122,13,3,3,0,100
44f8d0adc2c4b3d7b4b5ce6b2eefedada51e6b9a,3,49,7,42,0,0,0,2,73,507,1,3,1.367535462,972,104,4,92,89,3,9184,8674,510,37,36,1,100
f4d8201a5f6090d5cb76bd3fddc1ee4f325a911c,1,5,1,4,0,0,0,4,30,647,1,1,0,275,947,0,51,50,1,1761,1732,29,30,30,0,100
c81abd5dd6d7efe5970e7cf19edc55e3286eac67,0,0,0,0,0,0,0,0,0,0,0,0,0,0,948,1,0,0,0,0,0,0,0,0,0,100
8396a27bb2881b59c4aa9bb49427f0e7c27ae095,53,159,191,32,0,0,0,3,104,753,4,41,4.996501548,11405,949,2,1701,1705,4,96560,97085,525,606,606,0,99.23076923
6a4942cd0fb2dfce2766ce070341242ea8cb9086,36,596,402,194,2,0,2,3,49,1027,3,22,4.516583276,4197,468,0,527,521,6,35830,34586,1244,228,227,1,98.00870368
f862e2b821ffc202008cb5359350194368d5ac35,2,15,1,14,0,0,0,2,9,583,1,2,1,217,61,0,35,35,0,1924,1792,132,17,17,0,100
0c99a40783c5f7e66f5759fd1d04be245c4783f2,1,0,2,2,0,0,0,4,17,14,1,1,0,72,62,1,6,6,0,680,698,18,4,4,0,100
fc6c6f3777bb05cd5e2bbebf2565bcaadcd2bd74,12,26,39,13,0,0,0,3,50,0,2,10,2.78738847,1654,469,1,209,209,0,13343,13541,198,76,76,0,97.39231967
ace4c35cbe87ed4e485e68173dc97b9a50700a69,4,574,154,420,2,0,2,2,8,675,1,2,1.965836194,301,215,0,71,36,35,5777,2681,3096,30,14,16,99.9620157
86d269b3104c940ed8ff0d065332e0af347ac523,4,102,38,64,1,0,1,2,9,0,1,2,1.569658147,446,216,1,62,60,2,4275,4050,225,23,22,1,99.88624874
0afb32c6d15435f37711655b3099569ee4673774,1,1,1,0,0,0,0,2,8,2,1,1,0,228,217,2,18,18,0,2614,2614,0,11,11,0,100
e200147652165bb457f4b14de4ce96e96f98866d,7,77,23,54,0,0,0,5,23,1631,1,6,2.145365351,630,105,0,104,99,5,5456,5305,151,50,48,2,100
87a2503b48a4638a82f9b7473e9165600d04cfdc,1,1,1,0,0,0,0,3,6,0,1,1,0,118,106,1,13,13,0,1102,1106,4,5,5,0,100
c3154b86dce55f8ca318c35f97751d3aeee415aa,5,101,25,76,1,1,2,3,16,0,1,3,1.522148201,421,107,2,58,50,8,4012,3715,297,32,26,6,99.92438563
49bf055acf29dcc1aa69bd37e97b5dfe3015e7ba,1,0,2,2,0,0,0,3,8,0,1,1,0,128,108,3,13,13,0,1149,1181,32,5,5,0,100
8a8e10dec709e9869ab8fe411c7fc07c7a7b265c,5,179,55,124,2,0,2,1,19,381,1,3,1.969251515,245,109,4,46,34,12,2373,1819,554,27,19,8,99.88684938
1d3131815cb929a7f1e580bce825c29a6848b41c,1,26,33,7,0,0,0,4,20,640,1,1,0,255,110,5,54,54,0,1698,1737,39,34,34,0,100
9dba3cc0501f096ef2e569829d9f18e275334907,3,114,49,65,0,0,0,3,5,1530,1,2,1.349094431,309,111,6,32,25,7,3325,2897,428,13,11,2,100
bfd82145bfc1d94b7dfabae2bc04737929c41747,2,38,10,28,1,0,1,1,7,282,1,2,0.776555785,123,112,7,22,23,1,756,697,59,14,13,1,99.97488699
a1e5c7bfc0e48f289e7de4f062a901d625f3e00c,2,19,3,16,0,0,0,6,31,659,1,1,0.994030211,407,113,8,66,64,2,2956,2900,56,38,37,1,100
1250c232a8ae93c76b28b0fa8b5267362e692d1b,1,1,0,1,0,0,0,3,5,792,1,1,0,147,114,9,18,18,0,1129,1120,9,9,9,0,100
dbaadb1c8c720a41296fb8a3e215c38aa53ed5ca,0,0,0,0,0,0,0,0,0,0,0,0,0,0,115,10,0,0,0,0,0,0,0,0,0,100
750a1a0243456b25f259dd55cd71c4a827875ab4,1,6,3,3,0,0,0,3,3,1671,1,1,0,52,116,11,8,7,1,418,406,12,2,2,0,100
6a8de49a78333bbafddc9877685065d911604942,1,1,1,0,0,0,0,3,10,1539,1,1,0,87,117,12,7,7,0,756,754,2,4,4,0,100
f2eccdccf8066a8d140949afbaf7162e898140a3,1,2,5,3,0,0,0,2,3,131,1,1,0,127,950,0,24,24,0,1161,1180,19,6,6,0,100
e7a90d186e1940ce817413eff04a6946db0238d1,1,6,1,5,0,0,0,3,20,2082,1,1,0,248,118,13,60,58,2,1607,1574,33,39,38,1,100
7b10d65ade075c00a5930437542aa87692c42c15,5,108,4,104,1,0,1,3,8,456,1,2,1.776312527,586,119,14,82,73,9,4911,4289,622,43,40,3,99.83662184
25b51464a991fa26f566e9c4d79be8a332a81181,2,186,131,55,0,0,0,4,19,735,2,2,0.097689506,194,5,0,12,11,1,1804,1649,155,6,6,0,100
f2dc2fd6602fcec6d812aeec0eb36f4b2c3a6ff6,1,2,13,11,0,0,0,7,20,0,1,1,0,145,6,1,6,6,0,1241,1241,0,3,3,0,100
733f4b64b700e80d2f5649306b1daf5ab13d6351,1,38,10,28,0,0,0,7,21,0,1,1,0,145,7,2,8,6,2,1471,1241,230,4,3,1,100
8511167483774c09fd6620b749991b5493b2213d,1,16,9,7,0,0,0,8,36,826,1,1,0,90,120,15,10,10,0,781,768,13,2,2,0,100
418f643b2ace74ce0cadc0e5e2d7808cd65674e3,2,138,66,72,0,0,0,4,11,871,1,2,0.282217634,109,121,16,23,23,0,853,854,1,15,15,0,100
a3baa242603d82f1cc34aec3d08562f76b9ecb03,1,1,1,0,0,0,0,5,20,1115,1,1,0,155,122,17,16,16,0,1301,1299,2,4,4,0,100
95cf05f1aacee2195e802b515deb2af0a6b8606f,1,17,9,8,0,0,0,7,22,2,1,1,0,177,8,3,8,8,0,1515,1471,44,4,4,0,100
7071580d31460d854b5f1d7148c37c0c8c42c3f7,1,4,2,2,0,0,0,6,20,393,1,1,0,256,123,18,39,39,0,1957,1953,4,17,17,0,100
553252f9dd3b744006a1fe755f9ab1785ab47e62,1,5,5,0,0,0,0,4,9,475,1,1,0,439,124,19,50,50,0,3608,3600,8,18,18,0,100
dce96b20c9b2f5341f37d36cf22130fb8cd2d995,1,0,5,5,0,0,0,5,10,120,1,1,0,183,125,20,33,34,1,1599,1639,40,15,16,1,100
10c535c16ea567a2105a6cbcbeb2af3321028417,48,561,175,386,2,0,2,2,21,370,4,36,3.528855485,6790,951,1,935,947,12,53905,55424,1519,357,363,6,99.94968553
d5b6b74306fac6cbcab2498e0e14b3c53b4f7a23,2,164,80,84,1,0,1,1,5,398,1,2,0.939788396,110,952,2,27,16,11,1738,967,771,7,6,1,99.89940903
21a9c51552b0f7ef94882effa90b072de3ff6a54,1,27,14,13,0,0,0,5,21,1,1,1,0,155,126,21,16,16,0,1364,1301,63,4,4,0,100
e5cc83df010f7857b3b18284ab5fa963eb3e78c5,4,85,26,59,0,0,0,2,28,935,1,2,1.921826195,464,127,22,119,109,10,3806,3460,346,60,57,3,94.35125448
c5edfe9ac7f34203ed2f26ab266e5331bc3efa8e,2,5,6,1,0,0,0,3,4,475,1,2,0.945660305,264,128,23,39,39,0,2642,2644,2,13,13,0,100
63c81f15995fa6dfcd1c11cdd97c9b0d791ee13a,13,458,106,352,6,0,6,2,51,82,2,4,3.20277779,1090,129,24,185,162,23,11545,10018,1527,90,76,14,99.65087282
1e898e791b0df150485a715542793623e01e860d,8,536,11,525,6,0,6,1,41,19,2,4,2.458472746,172,130,23,60,20,40,3769,1531,2238,32,9,23,98.33082958
f9baeba30c31ad6f9d2f9b7172589d7c45998c25,2,11,8,3,0,0,0,1,42,0,2,2,0.74248757,178,131,24,17,17,0,1718,1722,4,6,6,0,99.98318763
50349a6053bdc71cae1ab6ccab3ec281b22456dc,1,2,1,1,0,0,0,1,3,0,1,1,0,29,132,25,3,3,0,335,320,15,1,1,0,100
70eecdb341e017a308813712471539f831144d6a,1,1,1,0,0,0,0,5,43,0,1,1,0,149,133,26,14,14,0,1398,1398,0,5,5,0,100
10740e3b38433f9e0be0f3edba605cbfd50f8972,2,163,99,64,1,0,1,3,6,12,1,1,0.994907878,130,95,0,19,17,2,1082,841,241,5,3,2,94.38434617
df39ce464b8383c05f70d46e11e6adfb2adc1ded,7,150,246,96,1,0,1,1,19,12,1,1,2.31485852,436,134,25,42,50,8,3481,4014,533,18,22,4,99.72875226
5d667589f9f7d775448389c69bf6c6776ef54269,28,44,243,199,0,0,0,2,30,871,2,9,3.548303091,2149,135,26,277,295,18,16223,16399,176,144,164,20,96.93126664
210b26585d87b7096286b162b733b18f18d9c785,88,236,236,0,2,0,2,6,105,913,4,54,6.005258699,14721,136,26,2217,2229,12,121319,121256,63,809,816,7,99.93468321
402e296c5efe03d91a8ca8e962705bc79b2b6f23,74,6,101,95,0,0,0,6,106,0,4,49,5.849877356,12420,218,0,1776,1776,0,102549,103259,710,615,615,0,90.65724382
4841efbcd36c2d7bd160fe673824578f3adc5a23,137,678,642,36,0,0,0,7,107,1147,2,60,5.179445583,14095,137,27,2246,2239,7,106976,106719,257,1079,1074,5,100
d95bddae46e6b9210a4c4b89d71202e7881a08db,18,240,343,103,3,0,3,2,44,337,1,10,3.676505318,1963,138,27,238,238,0,16246,17417,1171,114,115,1,96.60357791
3c22856e8f2163301aa0ea870622c142427b4b40,59,241,181,60,0,0,0,5,22,1076,2,28,5.102530449,7429,139,25,1122,1121,1,59980,59968,12,431,430,1,99.98648283
de76182341022df3819c1cf29ca0593ecbf34917,22,24,421,397,0,0,0,4,75,918,3,13,3.023515215,2888,140,25,254,315,61,23317,25589,2272,135,180,45,98.1041313
67e09b3ee3ada13ae709c18d010f56bfa4555d74,2,16,0,16,0,0,0,5,33,834,2,2,0.954434003,341,219,1,49,49,0,2661,2636,25,23,23,0,100
1036a80ac81a092574a84b129e936dea37af5907,2,2,2,0,0,0,0,5,34,0,2,2,1,344,220,2,49,49,0,2661,2661,0,23,23,0,100
6d16230d5548b1acd9762dee1f76b98f2727e2a2,150,1273,1273,0,2,0,2,3,108,450,4,71,5.65169776,23902,141,19,4086,4083,3,179609,179558,51,1646,1643,3,99.94059994
d1ba46ece920edad9fd87f6306436c3e949c577a,0,0,0,0,0,0,0,0,0,0,0,0,0,0,142,15,0,0,0,0,0,0,0,0,0,100
5f8070b989f5f6f87fc41053ad91d640dbe8712f,1,1,1,0,0,0,0,5,10,17,1,1,0,121,221,3,24,24,0,974,979,5,7,7,0,100
e8b1f807ac6ac4dafb3b307769f6af4067f535c0,1,2,1,1,0,0,0,5,10,892,1,1,0,67,222,4,17,17,0,485,485,0,6,6,0,100
2359f98e7af58e46f2b1b4a87bd5a690ce859fc8,0,0,0,0,0,0,0,0,0,0,0,0,0,0,143,13,0,0,0,0,0,0,0,0,0,100
bdb1c48561578dc496d05c263b28b68d0c97e2d2,43,637,653,16,3,0,3,5,36,378,4,27,2.877829566,8441,144,14,1531,1531,0,64158,63968,190,488,485,3,99.82166741
4d1f06290348faa37ce17d2739b94e47923375d0,1,1,1,0,0,0,0,2,35,1451,1,1,0,314,953,0,58,58,0,2272,2274,2,15,15,0,100
17270d846a337f4b8e5cfa2b19175aa8f07c58c7,0,0,0,0,0,0,0,0,0,0,0,0,0,0,63,0,0,0,0,0,0,0,0,0,0,100
46ed1c07f3606df8e3d47ca3531c07b03911659d,2,4,65,61,0,0,0,1,6,282,1,2,0.955758991,150,954,1,17,27,10,841,1175,334,11,15,4,100
67a531e942f10611477f9ffd4424f957d41cbb7c,32,34,33,1,0,0,0,7,36,706,3,21,4.961611579,6013,0,0,951,951,0,47443,47443,0,302,302,0,100
c79dde5a9b847c58b888d0745fd4fa86af781f90,1,6,17,11,0,0,0,3,5,46,1,1,0,49,145,4,6,6,0,207,256,49,5,5,0,100
8ba23091ee0eafe5f303058621cb7b86758b1629,1,38,0,38,1,0,1,1,1,0,1,1,0,0,146,5,2,0,2,113,0,113,2,0,2,99.97028232
2eaae3646498b74c37ce53604b6129f1697092f3,0,0,0,0,0,0,0,0,0,0,0,0,0,0,147,6,0,0,0,0,0,0,0,0,0,100
c36dc719028351db110d0acaf1fe65b846c5c258,11,20,20,0,0,0,0,4,19,122,3,10,3.141446071,1378,1,1,133,133,0,10643,10643,0,65,65,0,100
be945338d4cb09ecd3e165f6b322cf132fc027c0,18,615,265,350,0,0,0,3,42,463,2,6,3.245820645,4830,137,0,990,930,60,38673,36857,1816,522,492,30,100
be8e8a05152595c3b31e81cb2b3fcf54d951f4d3,3,3,3,0,0,0,0,3,14,0,1,1,1.584962501,145,138,1,13,13,0,1282,1282,0,13,13,0,100
abd58a8fcd8edf1a6925229864efe0e13cd0bbfb,0,0,0,0,0,0,0,0,0,0,0,0,0,0,139,2,0,0,0,0,0,0,0,0,0,100
812d0ba2ae098ad86fa66c92f30eb264be78debb,11,1167,650,517,9,0,9,5,10,268,2,2,2.708019221,817,140,3,138,156,18,11288,7010,4278,66,29,37,92.58623157
0a0fddf469f3f58f74c12dc2fe47ba8d8141c161,13,182,97,85,0,0,0,5,43,450,2,4,2.76512889,2936,141,4,663,653,10,18120,17921,199,387,374,13,100
3cadef96006421dc7f169bf10de2d0ed4b78bebc,4,58,21,37,0,0,0,1,13,328,2,3,1.790800538,427,142,5,41,39,2,4216,3950,266,20,18,2,100
1519d015d3b1cb112788e94e7de5ac2466229026,1,24,1,23,0,0,0,5,11,5,1,1,0,390,143,6,59,55,4,3691,3486,205,16,15,1,100
a95412337722e1cfecf23f8fa29ead6438f55daa,1,3,0,3,0,0,0,5,12,0,1,1,0,411,144,7,60,59,1,3703,3691,12,16,16,0,100
fc209b78248d6ee12189763df5e8a22118f06e3b,1,4,1,3,0,0,0,6,44,23,1,1,0,730,64,0,190,190,0,4679,4653,26,53,53,0,100
c9684aae817642fba89483a1d96893e21710011d,1,16,14,2,0,0,0,5,13,27,1,1,0,414,145,5,61,60,1,3704,3703,1,16,16,0,100
87faa135f14d66f052ed89a5e987d0ccb54c2a1a,1,20,14,6,0,0,0,5,14,0,1,1,0,415,146,6,64,61,3,3728,3704,24,16,16,0,100
802464db19ab8ea041ba35f26335ba376d61c51d,2,46,10,36,0,0,0,3,4,371,1,2,0.999079718,349,0,0,62,56,6,3028,2828,200,23,21,2,100
e5ee197bb70a5d0458f45dc93a1f4c8366690109,3,8,5,3,0,0,0,3,11,1321,1,3,1.460484681,345,1,1,51,51,0,3696,3661,35,28,28,0,100
c233f90323d2aa6413035c694154c67faf4848c2,1,10,7,3,0,0,0,3,3,3538,1,1,0,11,2,2,3,3,0,64,67,3,3,3,0,100
f95d551355130df5fd3d147caa6f978ca98c1de4,14,1130,49,1081,1,0,1,1,30,1700,2,8,1.540647638,1020,3,3,227,168,59,7706,5220,2486,166,132,34,98.34628975
a23d87a0b20b54ffb3a1a64f92e4296c13c45453,2,115,15,100,0,0,0,3,8,1481,1,2,0.817317416,198,4,4,60,42,18,2150,1483,667,26,22,4,100
a8d3dbd11adf6bb1255cc8c949ef004a78bddee2,28,2454,613,1841,6,0,6,7,45,559,2,4,3.531967282,5251,5,5,1271,1024,247,45683,35253,10430,716,563,153,96.27199523
8649ac2655c4b6dbd0a6065e3a42cea6d6e741b5,10,1467,0,1467,9,0,9,4,5,10,2,3,3.017907142,52,6,6,173,9,164,8278,227,8051,69,7,62,99.67806224
7b7cfef8a9288fb901505fff1b8f9c7e6374d869,0,0,0,0,0,0,0,0,0,0,0,0,0,0,148,0,0,0,0,0,0,0,0,0,0,100
97f6db225444438e51cbd132b572168ecd8a01e8,6,164,27,137,0,0,0,4,23,126,1,2,1.759767014,524,149,1,68,54,14,5979,5071,908,35,29,6,100
2d3fed22c5b5aa7200b74b581c8e574dab8afc7b,0,0,0,0,0,0,0,0,0,0,0,0,0,0,150,2,0,0,0,0,0,0,0,0,0,100
fd242548372aba9051f7676ac56b8c8e5e0317ec,6,1516,0,1516,6,0,6,1,1,0,1,3,2.400368488,0,7,7,130,0,130,7268,0,7268,40,0,40,94.71237653
d54c59b406def0d478e2c005e49fcfaa803f6b2d,10,92,5,87,0,0,0,6,13,1168,1,3,2.637270476,577,2,0,101,101,0,4308,4308,0,62,62,0,100
672364de57c8ba570fd6944e1ee29d319339f792,0,0,0,0,0,0,0,0,0,0,0,0,0,0,3,1,0,0,0,0,0,0,0,0,0,100
69ce85fa6e2f6e1ba3a430057c6f790db60b596e,0,0,0,0,0,0,0,0,0,0,0,0,0,0,4,2,0,0,0,0,0,0,0,0,0,100
b7ebff7fd747e8986dc41839a1b194c742eb1c78,0,0,0,0,0,0,0,0,0,0,0,0,0,0,5,3,0,0,0,0,0,0,0,0,0,100
1d6dc496f13d049caf6b2b5fab50cc9a3561bffd,7,1166,0,1166,7,0,7,1,1,0,1,2,2.350392715,0,8,8,81,0,81,6550,0,6550,41,0,41,92.64767784
ec9035c60d8133286de3a7a123d299e25d2a1991,8,533,0,533,3,0,3,1,2,10,1,5,1.799152543,749,9,7,140,75,65,9941,7086,2855,62,32,30,99.90048337
4edc814197dcae1c4c085b326aba5c4ba5c73600,2,33,3,30,0,0,0,1,3,18,1,2,0.918295834,382,10,7,73,66,7,3515,3345,170,20,19,1,100
5b29d0367ff99d215d30a45355f9257df36f24d8,1,0,3,3,0,0,0,1,3,0,1,1,0,136,11,7,14,14,0,1374,1410,36,7,7,0,91.91836735
a400cb8acb5ad65c28ac646a1b1208451e0b0c50,2,14,0,14,0,0,0,4,15,1880,1,2,0.371232327,148,6,4,38,37,1,1192,1108,84,15,14,1,100
cb80ec66ec9e2b4acbc94182a3c64c9c429ae043,1,0,3,3,0,0,0,1,3,9,1,1,0,144,12,5,12,12,0,1173,1216,43,4,4,0,100
9899396f574ec686b4cd12e9d786ef98a7414775,1,24,41,17,0,0,0,1,3,11,1,1,0,216,13,6,50,52,2,1682,1727,45,10,11,1,100
bc5ca9400f45de703aa82ff051c238f75fdcc3a2,1,8,4,4,0,0,0,1,2,33,1,1,0,157,14,7,23,22,1,975,958,17,11,11,0,100
bad258a7ad3d5240538e2dc6566a35f62fe04f40,1,0,3,3,0,0,0,3,7,153,1,1,0,396,955,0,57,58,1,2960,2987,27,28,28,0,100
dc62944247cc3dbc212aad50fd9d7243ce3fd446,84,308,556,248,0,0,0,3,46,601,4,48,5.75961551,14270,65,0,2328,2333,5,108932,110951,2019,1115,1114,1,99.96084062
a6f16219a25291db451a3ff20d0a604089c5991b,1,17,10,7,0,0,0,5,19,678,1,1,0,168,7,4,21,21,0,1192,1162,30,2,2,0,100
754fd18bd52d198518ce0ac3882581427593ece1,0,0,0,0,0,0,0,0,0,0,0,0,0,0,8,3,0,0,0,0,0,0,0,0,0,100
cfc31552094358301ab5d31d932620d599d29723,3,27,1,26,0,0,0,3,25,178,1,2,1.151565379,438,9,3,78,76,2,3672,3452,220,20,19,1,100
b04eba0733e756fb367109613e61cd18a3a62d81,6,50,21,29,0,0,0,4,28,363,1,4,2.211447357,1207,10,4,243,241,2,10322,10117,205,124,123,1,100
096d686486fb30a2dbce9c4e33ecc9875a2c0fa8,1,0,2,2,0,0,0,4,8,0,1,1,0,14,11,5,3,3,0,110,117,7,1,1,0,100
aeb8c72aec0ad5be73d94eb21ad4b90517e7b00b,1,14,0,14,0,0,0,3,5,1,1,1,0,64,12,6,3,2,1,590,466,124,3,2,1,100
8c539d2b051ce7f9ac6a9b13256708935b6ad44a,2,11,7,4,0,0,0,3,16,3,1,2,0.918295834,256,13,7,37,37,0,2213,2215,2,18,18,0,100
d40bf86a1084c778b6125db83f125cfd596036ab,1,3,3,0,0,0,0,4,25,23,1,1,0,269,151,0,28,28,0,2428,2420,8,13,13,0,100
dca3aab6fc8bb26513e226eb77600322d5b0e9e8,1,8,9,1,0,0,0,5,25,1038,1,1,0,94,147,0,8,8,0,697,692,5,5,5,0,100
67d149037c651cbe2a341e2548bde70fb5fdb4dc,2,29,14,15,0,0,0,6,14,112,1,1,0.782444129,614,14,8,132,129,3,5040,4944,96,55,55,0,100
ed9e993d7eb23de48c2d7133d760b1fb085d5f08,1,2,0,2,0,0,0,3,9,1827,1,1,0,49,148,1,6,6,0,237,221,16,6,6,0,100
740a9c958330d665987808a6f04813c217322c55,3,119,13,106,0,0,0,4,31,179,1,2,1.273550527,334,149,2,78,62,16,3821,2992,829,34,30,4,99.96082528
f5b2ef2651945b120c301bbcaea773f75ef3c3fe,1,337,0,337,1,0,1,1,1,0,1,1,0,0,150,3,46,0,46,2092,0,2092,8,0,8,99.93470027
dda8a7814ef8ccbaf5056e76663d81dc946cd48f,3,7,3,4,0,0,0,4,19,1268,1,2,1.370950594,220,470,0,16,16,0,2023,1966,57,8,8,0,100
4ce12cc008e64d4c301123c13c8ce1fe007497a0,10,68,30,38,0,0,0,2,109,537,1,9,2.814549337,1910,34,0,265,260,5,15952,15784,168,128,125,3,100
e3ec9d80c23269e3160494575dfa283459da5e02,39,180,148,32,0,0,0,4,79,811,3,26,4.892158067,6941,35,1,710,707,3,62406,62105,301,341,339,2,100
ab0c8f3dac1e88724fe5bb01a4141b9db98f8168,0,0,0,0,0,0,0,0,0,0,0,0,0,0,36,2,0,0,0,0,0,0,0,0,0,100
da4f5c94abdc1adc6a95a38ca645a07832888a22,0,0,0,0,0,0,0,0,0,0,0,0,0,0,152,1,0,0,0,0,0,0,0,0,0,100
0c43ada4a6d5690538a326148ff643647ddde44d,0,0,0,0,0,0,0,0,0,0,0,0,0,0,151,4,0,0,0,0,0,0,0,0,0,100
092f374530822d6cbd2d4bcea5d5902b8a673f1a,1,9,11,2,0,0,0,9,26,13,1,1,0,214,152,5,42,42,0,1565,1581,16,3,3,0,100
d1e5295b786f159731c348671d63520ffaf7167c,3,26,16,10,0,0,0,4,22,147,1,2,1.409975019,467,153,6,52,48,4,3880,3783,97,9,9,0,100
6657591cb459b058643f2d31c7ee96df1d01fc95,0,0,0,0,0,0,0,0,0,0,0,0,0,0,471,1,0,0,0,0,0,0,0,0,0,100
8dc2719a33efaa35492e3147b987583e7ffa5a3f,0,0,0,0,0,0,0,0,0,0,0,0,0,0,472,2,0,0,0,0,0,0,0,0,0,100
f2ad4e16e7778d6652d3383d402e7819d7629dd6,0,0,0,0,0,0,0,0,0,0,0,0,0,0,473,3,0,0,0,0,0,0,0,0,0,100
454557b65eaf7deca7bf5e35a644ce57f2a44ab3,1,4,3,1,0,0,0,5,12,2,1,1,0,62,474,4,14,14,0,391,389,2,7,7,0,100
a3306645e446d00237e41d722e0ee74f89dcec84,3,54,5,49,0,0,0,1,3,52,1,2,1.231263763,529,15,3,52,50,2,5000,4754,246,22,21,1,96.3367883
ee8e393ee7a4f245861b1648966ca05adef5096f,2,53,7,46,1,0,1,2,14,2610,1,2,0.85995305,190,153,2,35,34,1,1252,1094,158,25,24,1,99.51456311
f09ea540f2e8fc0d87d110018194745c030fb482,1,1,2,1,0,0,0,1,2,70,1,1,0,186,16,4,35,35,0,1473,1485,12,10,10,0,100
6d87badaaf89bdf2e76ea87aed0b1c549576ace8,2,10,1,9,0,0,0,3,25,927,1,2,0.684038436,244,154,7,53,52,1,1784,1720,64,24,23,1,99.98424204
77cbd83e5504480667a57d06354421e2ed29cd65,2,5,5,0,0,0,0,5,16,332,1,2,0.721928095,228,956,1,42,42,0,2320,2326,6,18,18,0,100
89a2ba02042fa9aa4eced6801bbd566a25e3c392,4,117,96,21,0,0,0,7,18,114,1,2,1.497411509,402,15,8,52,44,8,3913,3533,380,27,23,4,100
26e532fd792ed08203c94ef02c480708a9e92d33,2,82,62,20,0,0,0,3,26,2,1,2,0.870864469,252,155,8,59,53,6,1947,1784,163,25,24,1,100
fa5336eba62537b237df358338bc723c1398a7ea,1,2,5,3,0,0,0,3,9,0,1,1,0,97,156,9,12,12,0,650,681,31,8,8,0,100
9ced02fb64732b1b664c01bacdd54fc28760d631,0,0,0,0,0,0,0,0,0,0,0,0,0,0,16,9,0,0,0,0,0,0,0,0,0,100
4ca6b866a4b2cdacec85be5f1828594a1ef76754,97,266,257,9,0,0,0,2,110,407,4,59,6.024502753,18301,957,2,2769,2765,4,153016,153189,173,1135,1132,3,100
2282122dcd1e27747f44da7ba08e5c63a6627b0c,2,138,95,43,0,0,0,5,7,197,1,2,0.962347605,269,475,5,43,39,4,2886,2664,222,15,13,2,99.82619687
5c200426dd8f29d0b073caea4b85b1f49223117f,0,0,0,0,0,0,0,0,0,0,0,0,0,0,958,3,0,0,0,0,0,0,0,0,0,100
10093c97f3dc09660f839da83aabfc97e20fef93,0,0,0,0,0,0,0,0,0,0,0,0,0,0,157,10,0,0,0,0,0,0,0,0,0,100
554bcb9a2d7dfe1bc7c4ef2e2e9a562437c62082,18,2050,0,2050,18,0,18,1,1,0,1,2,3.876381346,0,476,6,200,0,200,11446,0,11446,120,0,120,99.32336743
cbab3380c963f42f261ee63d10d1659344f19e3b,0,0,0,0,0,0,0,0,0,0,0,0,0,0,17,10,0,0,0,0,0,0,0,0,0,100
42b4d33be64a2d00d2a1665697d6d2d0efee19fe,16,380,356,24,0,0,0,1,2,0,1,2,3.656514102,1380,477,7,200,187,13,11232,10846,386,113,109,4,99.82828598
6e333b9dab6f2be809a73b31f492cf8bb3269b99,1,42,0,42,1,0,1,1,1,0,1,1,0,0,478,8,6,0,6,217,0,217,2,0,2,99.89093175
e48eb4cb394c8dfe5ed395dd77d769792c1eaa43,11,20,20,0,0,0,0,4,22,135,3,10,3.141446071,1372,479,9,132,132,0,10606,10606,0,65,65,0,100
b5c8c04927b8b59e64e065ff5e1422d27c2d8f71,4,151,0,151,4,0,4,1,1,0,1,1,1.977067143,0,480,10,13,0,13,722,0,722,13,0,13,99.64163291
4a6453cdefac463d15c02371b0042c0b3be7e556,11,77,44,33,0,0,0,2,28,648,2,10,2.465542213,1296,481,11,195,187,8,10556,10421,135,85,85,0,100
54a66572dfce70f67851b672da0662d7b1916442,21,202,31,171,0,0,0,2,12,96,1,3,4.00315553,1377,18,11,168,168,0,11088,11272,184,108,108,0,99.87538941
72c68828a0018a736caa596dd7fa1f92e19d7335,1,15,12,3,0,0,0,5,14,219,1,1,0,173,482,12,23,22,1,1784,1759,25,9,9,0,100
e66f94b8ea6e4a3feac3aa0d92a50b593d17c647,2,17,2,15,0,0,0,2,4,0,1,2,0.831474388,191,483,13,15,14,1,1578,1420,158,13,13,0,96.05493863
bbd2b7ea35a36804a2f813cebfdd66061adaabcc,10,320,69,251,0,0,0,3,47,192,1,6,2.63463867,1256,154,3,177,163,14,12689,10938,1751,77,70,7,99.45712695
dd56a290f592281f80f0146139a2c954b98aa352,3,183,4,179,1,0,1,1,19,76,1,3,0.902463468,497,155,4,58,49,9,6457,5347,1110,37,32,5,99.9718706
01b6488536a3102b20e5e4d109afff3d02c77684,1,7,4,3,0,0,0,9,63,226,1,1,0,107,484,14,10,10,0,1097,1076,21,5,5,0,100
81419837bb4a88540e126f20009419c644236f09,0,0,0,0,0,0,0,0,0,0,0,0,0,0,19,12,0,0,0,0,0,0,0,0,0,100
e6370c079379b5640dadb7e8f3a62068bfeac432,1,3,3,0,0,0,0,5,9,0,1,1,0,274,20,13,34,34,0,2604,2598,6,16,16,0,100
6b7f601ad34d484b7c63a7711d7964c0beaf132c,7,206,173,33,0,0,0,5,8,838,1,4,1.989594031,940,156,5,176,171,5,8465,8092,373,72,72,0,99.87345332
d0bed6dbb08a76ff018e0b248e2be60bccf2431c,4,240,161,79,2,0,2,1,8,480,1,2,1.749499457,474,157,6,41,28,13,4600,3932,668,20,13,7,99.88764045
06ce99241a610b15a556104e8f5ccf75ffd6cfb0,0,0,0,0,0,0,0,0,0,0,0,0,0,0,485,15,0,0,0,0,0,0,0,0,0,100
bbf536942a6044048b6f909dfe346268f5370df9,9,367,269,98,0,0,0,4,24,532,1,4,2.414614675,941,486,16,123,111,12,8686,7854,832,35,32,3,94.06278734
8bd9487ae9ed9e8e136e95d1ac7fb839895242d6,0,0,0,0,0,0,0,0,0,0,0,0,0,0,487,17,0,0,0,0,0,0,0,0,0,100
31cb292293bd539e29458896e78bad5d72b2b895,123,240,208,32,0,0,0,4,89,506,3,79,6.613503289,17693,488,18,2349,2340,9,143733,143247,486,950,950,0,92.82458653
035cd73153fa6ca2c5e521a7c16193986ba1639f,2,62,1,61,0,0,0,4,59,0,1,2,0.817507288,588,489,19,110,103,7,5126,4660,466,52,46,6,100
87d4b2e03012ca44f5c0f6629b0546785d9058ee,93,360,364,4,0,0,0,5,81,12,3,61,6.052300696,12845,17,2,1455,1455,0,107209,107244,35,594,594,0,92.81156401
7678af4d27230234c07767c40fb9ff2bf3e8e203,5,87,206,119,0,0,0,7,20,56,1,2,1.829632567,470,158,7,50,58,8,3760,4280,520,21,29,8,99.97529034
f58960dca071c6c0d4ab46e3bb19b428ce8f0734,2,9,4,5,0,0,0,4,18,0,1,2,0.619382195,387,490,20,41,40,1,3246,3203,43,10,10,0,100
25d59aa146c7edc802832cbcd5ef076ba4d92bd2,8,36,14,22,0,0,0,2,34,8,2,8,2.575616305,1452,491,21,187,183,4,11423,11135,288,64,64,0,100
6d9179e1497f89a3fb1703c31918f9cdf46b60a2,19,84,146,62,0,0,0,3,35,59,3,16,3.576478532,3486,159,8,439,461,22,26601,27325,724,170,169,1,91.33417332
17f63629727bc2b67fb6d0ac1b0df0f15eb6c257,127,127,0,127,0,0,0,5,81,993,1,30,6.988684687,11719,160,9,1633,1633,0,99147,98893,254,647,647,0,100
b5d68c5a09af34dc79f54f81a32a36302885f127,3,323,0,323,3,0,3,1,1,0,1,2,1.574755245,0,21,13,28,0,28,1688,0,1688,9,0,9,99.88711498
3aa430961e0bd0cd3de24c7f600eb210749ab11e,0,0,0,0,0,0,0,0,0,0,0,0,0,0,22,14,0,0,0,0,0,0,0,0,0,100
4da4468986b9dd2b4837ac1fa6796681a4c37392,1,3,3,0,0,0,0,5,8,1,1,1,0,84,23,15,13,13,0,676,682,6,8,8,0,100
1c16298cd7c72738519f8e5018ba16210a0f2f5b,1,1,0,1,0,0,0,4,10,235,1,1,0,430,66,0,64,64,0,3726,3719,7,17,17,0,100
fab9d376a2b17d4487a75250bdf1c96908cfadf6,3,456,0,456,3,0,3,1,1,0,1,1,1.352478686,0,18,3,39,0,39,3193,0,3193,12,0,12,90.953125
58cc1ae19757e09389196dff605359be72f797fe,114,515,496,19,0,0,0,3,111,163,4,60,5.943516619,19845,161,10,3160,3174,14,152689,152612,77,1390,1393,3,100
8b194c80a6645b9dc7f0851fb33e224b553a6a37,23,31,31,0,0,0,0,5,35,0,3,14,4.349199939,4462,162,11,865,865,0,33960,33960,0,407,407,0,100
bf555a67db57bd27e28728cef1eeb078d592d03f,4,16,4,12,0,0,0,3,5,0,1,3,1.021928095,333,24,11,40,40,0,2456,2484,28,27,27,0,100
2c2b52d9173be7b1b3284554a590fa04fa6a3d14,1,2,1,1,0,0,0,2,4,16,1,1,0,58,25,12,6,6,0,567,560,7,3,3,0,100
33af892642740f01291ea88ed30bebe2626270d6,1,1,3,2,0,0,0,6,36,0,1,1,0,254,158,11,61,62,1,1434,1454,20,44,44,0,100
727ddf6a52b5341d79f364ef6a4fed9772b67fbf,2,2,0,2,0,0,0,3,9,1269,1,2,1,175,163,12,27,27,0,1524,1520,4,13,13,0,100
11321f7cccac0e32c90d0fecb132351aca69a1bc,6,6,0,6,0,0,0,3,21,2382,1,2,2.584962501,195,164,13,31,31,0,1636,1624,12,20,20,0,100
4cd0064939fb84bf343e3cff9401f37d8870df9f,2,64,1,63,0,0,0,3,15,1342,1,2,0.198234964,291,26,12,31,30,1,3281,2849,432,19,18,1,99.95449719
8460c0cbcf029beaa64f082e73d2a45f0b05f342,1,22,10,12,0,0,0,3,16,1,1,1,0,211,27,13,16,16,0,2617,2556,61,6,6,0,100
6b6b8a0211bb1cf6ba201e05e687ac8c1f97666f,7,92,49,43,0,0,0,3,6,16,1,3,2.656533935,874,19,3,122,111,11,6922,6735,187,48,46,2,94.6460177
eb78d61e6f74fd1ae3102729667d605ee2b63ee9,1,6,6,0,0,0,0,2,3,11,1,1,0,248,20,4,41,41,0,1961,1952,9,9,9,0,100
7f431a0494c6ab1c7f3ded7f45f3b3890c38ef28,2,10,6,4,0,0,0,2,5,0,1,1,1,108,21,4,13,12,1,990,969,21,7,6,1,100
16e1e41ef34631e96d911b4a2081da6525204e5a,1,17,0,17,0,0,0,3,5,0,1,1,0,47,28,13,7,7,0,411,411,0,3,3,0,100
4aed7cce0f7ff2c34348ac8d101e706838199598,5,88,103,15,0,0,0,5,61,112,1,3,0.739462369,1010,165,11,173,175,2,8318,8491,173,70,72,2,100
9152a13729be2c43f6d275c5cc7f2c845777e14b,15,98,58,40,0,0,0,6,75,1092,1,3,3.320747706,1172,166,12,151,151,0,7972,7762,210,52,50,2,100
157bca3ba477b0f1480958b11f9d8950e7c841aa,1,78,17,61,0,0,0,3,3,15,1,1,0,53,159,4,12,6,6,1005,448,557,4,3,1,99.94258648
335a993715963616980d746f9d80d28f0c22fabe,46,98,91,7,0,0,0,5,79,116,1,27,4.949375565,6904,959,0,1042,1042,0,55183,55229,46,409,409,0,100
d711ac12007394a990e0dbc7c5cb8426a20eacdd,11,1169,219,950,4,0,4,5,63,39,2,4,3.07153925,977,29,8,245,150,95,14097,7655,6442,105,76,29,99.87100473
f656195b54f0ebddbd4c1aa65c8db22ce30a0f49,1,0,1,1,0,0,0,2,5,33,1,1,0,59,30,6,6,6,0,560,567,7,3,3,0,100
22533ae66540ba3d86167b20f859095fd640f995,8,70,67,3,0,0,0,5,64,5,2,4,2.372132768,1523,31,7,247,247,0,12847,12838,9,101,101,0,96.40184226
53fe357aba3194ae1cf3a28e056e948a629d640f,2,2,2,0,0,0,0,8,21,0,1,1,1,400,32,8,46,46,0,3412,3422,10,14,14,0,100
d49d4c8a2d8f19c84f5f7b5543d2aa427390f0c6,3,2,7,5,0,0,0,3,5,33,1,1,0.986426729,320,33,9,51,52,1,2182,2187,5,22,22,0,100
7ee9154fa43f2550ce64bb81f3e2bcbaec04feda,1,1,1,0,0,0,0,4,12,24,1,1,0,409,167,6,63,63,0,3575,3575,0,16,16,0,100
13aa5273ea661af61f19096067ec1fefa97a790e,0,0,0,0,0,0,0,0,0,0,0,0,0,0,34,10,0,0,0,0,0,0,0,0,0,100
3ea5a17fb5218699ae361c52a67318480d1d12be,4,16,18,2,0,0,0,2,5,44,1,2,1.943854923,124,35,11,15,15,0,937,948,11,13,13,0,100
c533e9376d40736c1cd95f4ed58b4c28ed3da697,0,0,0,0,0,0,0,0,0,0,0,0,0,0,36,12,0,0,0,0,0,0,0,0,0,100
656537eb4a62a5d4afe0f35597883105aa05b490,0,0,0,0,0,0,0,0,0,0,0,0,0,0,0,0,0,0,0,0,0,0,0,0,0,100
b44256efca249c6b3b7b16dc3106db1c82e068a1,1,1,1,0,0,0,0,5,12,256,1,1,0,203,1,1,50,50,0,1249,1249,0,33,33,0,100
74078b68af6456a19db6ae8f7c49f52adffeae2d,6,206,211,5,0,0,0,5,22,4,1,2,1.582779476,1011,37,13,102,103,1,9485,9169,316,33,33,0,96.40184226
efe408bafef6edd3076d35ea85117a032d136879,1,28,28,0,0,0,0,7,28,6,1,1,0,266,38,14,48,51,3,2063,2062,1,20,20,0,100
b35e54fb71bfcbd5563d06eea5145fab5ec9ad1d,4,422,156,266,2,0,2,1,39,30,1,4,1.963280049,386,160,1,59,35,24,5174,3104,2070,20,15,5,99.92847947
99a5ce8c56a168084a5f4f0ae26ae1032bcefa79,3,3,9,6,0,0,0,2,27,0,1,3,1.040852083,330,39,13,28,28,0,3287,3344,57,9,9,0,100
cb9a9eab9ff7dacd3efc7df149f2d1db6ba6dbeb,2,21,28,7,0,0,0,10,40,0,1,2,0.803090976,292,40,14,40,42,2,2565,2584,19,13,13,0,100
9d7d6151ccc387fde6bbe092d2cedffafcc7c77e,0,0,0,0,0,0,0,0,0,0,0,0,0,0,41,15,0,0,0,0,0,0,0,0,0,100
eae8c6c84b8a6481d1c16feb9c6627ef6dc03ee0,0,0,0,0,0,0,0,0,0,0,0,0,0,0,42,16,0,0,0,0,0,0,0,0,0,100
4a8ffdc594c84eefcdd03d087403f231e37fffea,0,0,0,0,0,0,0,0,0,0,0,0,0,0,2,2,0,0,0,0,0,0,0,0,0,100
3173c6a2ffd19df9a732a0dbb976293fe25ed457,0,0,0,0,0,0,0,0,0,0,0,0,0,0,3,3,0,0,0,0,0,0,0,0,0,100
2880d6a27b31dd52f175222a8da02395f4e00552,0,0,0,0,0,0,0,0,0,0,0,0,0,0,4,4,0,0,0,0,0,0,0,0,0,100
5febdc5554ad0479ae8a9125b887fe192452116e,0,0,0,0,0,0,0,0,0,0,0,0,0,0,5,5,0,0,0,0,0,0,0,0,0,100
371bef607ac191a6f90ef366a42d912325f7f0f5,0,0,0,0,0,0,0,0,0,0,0,0,0,0,6,6,0,0,0,0,0,0,0,0,0,100
f9c7de41950c5ed764831207acf96be2ecc3f8c1,0,0,0,0,0,0,0,0,0,0,0,0,0,0,7,7,0,0,0,0,0,0,0,0,0,100
2f9697f89c61f77e8474f647812f11aed46c46dc,0,0,0,0,0,0,0,0,0,0,0,0,0,0,8,8,0,0,0,0,0,0,0,0,0,100
a362bb5876ede0c14352297cee46dd763b3dc555,0,0,0,0,0,0,0,0,0,0,0,0,0,0,9,9,0,0,0,0,0,0,0,0,0,100
54025dfac4d3edfc28dc63b9d58bcb1924edb817,0,0,0,0,0,0,0,0,0,0,0,0,0,0,10,10,0,0,0,0,0,0,0,0,0,100
47576b7da37c68bd32e9e9144ee5b6220da20570,0,0,0,0,0,0,0,0,0,0,0,0,0,0,11,11,0,0,0,0,0,0,0,0,0,100
cd13dfd89072713c491edd0b61e9461f04396f32,0,0,0,0,0,0,0,0,0,0,0,0,0,0,12,12,0,0,0,0,0,0,0,0,0,100
f7feb2328f49af2f136d3af6c969fc5fc8d916d4,0,0,0,0,0,0,0,0,0,0,0,0,0,0,13,13,0,0,0,0,0,0,0,0,0,100
ff32b1adca4dcf123924c1b538ee83cda21f8fdd,0,0,0,0,0,0,0,0,0,0,0,0,0,0,14,14,0,0,0,0,0,0,0,0,0,100
4e71b72cc609ee245a8da19d85e68810221b4c55,0,0,0,0,0,0,0,0,0,0,0,0,0,0,15,15,0,0,0,0,0,0,0,0,0,100
bf1e899d328df636b8bd3ef5f726ff955b2626a6,0,0,0,0,0,0,0,0,0,0,0,0,0,0,16,16,0,0,0,0,0,0,0,0,0,100
8e68ee590688fef4ac214906f191ded0ff827f57,0,0,0,0,0,0,0,0,0,0,0,0,0,0,17,17,0,0,0,0,0,0,0,0,0,100
60a602d00536dbd3c828261c8f21d24e9eda0689,0,0,0,0,0,0,0,0,0,0,0,0,0,0,18,18,0,0,0,0,0,0,0,0,0,100
0c9478ece1a4161c8c0ef0a75ad42cec5c560e2c,1,0,2,2,0,0,0,3,8,37,1,1,0,48,43,14,9,9,0,329,329,0,8,8,0,100
097ec69706778c041aa3d9d949b7cf003b2bebf6,0,0,0,0,0,0,0,0,0,0,0,0,0,0,19,19,0,0,0,0,0,0,0,0,0,100
81f7dfa09091102911e1707082a30b9962a60034,2,692,0,692,2,0,2,1,1,0,1,2,0.999783071,0,168,1,67,0,67,4279,0,4279,28,0,28,99.94285714
27a4d3f97549e222b07edcd9f2e5bac099bebbbe,0,0,0,0,0,0,0,0,0,0,0,0,0,0,492,0,0,0,0,0,0,0,0,0,0,100
060e6cf4091a4bcc7e9d30d12211d74eb02d45b6,0,0,0,0,0,0,0,0,0,0,0,0,0,0,493,1,0,0,0,0,0,0,0,0,0,100
eb465f42c91eaedb50030ae19c24315c621b8833,0,0,0,0,0,0,0,0,0,0,0,0,0,0,20,20,0,0,0,0,0,0,0,0,0,100
7619995a0ab5a5faf95c7c61dd66bb3180721c37,0,0,0,0,0,0,0,0,0,0,0,0,0,0,21,21,0,0,0,0,0,0,0,0,0,100
f43adfea425fe2a34f4c845df6fe7dbea5f68261,11,163,54,109,2,0,2,1,24,120,2,4,2.572350403,2222,21,0,357,325,32,15628,14744,884,153,131,22,99.65816835
bc8eafdd518b121fc79377b67537f7b0b08d38c7,6,86,175,89,0,0,0,6,31,257,2,5,1.313829684,1489,22,1,240,246,6,11836,12157,321,62,65,3,97.51445087
5b56a529b9ed4e17b68283aeb1f139fa5869a4a6,0,0,0,0,0,0,0,0,0,0,0,0,0,0,22,0,0,0,0,0,0,0,0,0,0,100
9676d7a5a55b1efc6ad64ce6e93c94e2e3cc38de,0,0,0,0,0,0,0,0,0,0,0,0,0,0,23,1,0,0,0,0,0,0,0,0,0,100
00d3d83ced62377a356a478bfe115c6430f4b2b3,1,1,0,1,0,0,0,7,31,102,1,1,0,149,960,0,47,47,0,1263,1261,2,8,8,0,100
9e9ffd32f64e02ddb1a114e7df21108fba2f873e,0,0,0,0,0,0,0,0,0,0,0,0,0,0,44,0,0,0,0,0,0,0,0,0,0,100
824b430f40bfb770c0782471f7c1cc86322808e7,0,0,0,0,0,0,0,0,0,0,0,0,0,0,45,1,0,0,0,0,0,0,0,0,0,100
e21ebcb20115462c7d8d6b513769f11b22f631b6,0,0,0,0,0,0,0,0,0,0,0,0,0,0,46,2,0,0,0,0,0,0,0,0,0,100
771b3138b033eb28315c9a9d7f94fe6f124e856f,0,0,0,0,0,0,0,0,0,0,0,0,0,0,24,2,0,0,0,0,0,0,0,0,0,100
dc88c8d37bd735280f01b7ec24934f3c7f8cc67d,0,0,0,0,0,0,0,0,0,0,0,0,0,0,25,3,0,0,0,0,0,0,0,0,0,100
9dbb1a04e29b222f4dd9bbad8ab21a42e36e7e75,0,0,0,0,0,0,0,0,0,0,0,0,0,0,26,4,0,0,0,0,0,0,0,0,0,100
c3e0b8c5bee2314e3c4799f7fac411f6f38a3f70,1,32,11,21,0,0,0,6,16,373,1,1,0,236,47,3,42,39,3,1575,1551,24,19,17,2,100
125d2e386b7fc07e1b34c3d79670767f6c129fb1,2,120,36,84,1,0,1,1,8,605,1,1,0.866725613,153,48,4,25,19,6,1640,1161,479,14,12,2,99.97060553
1e8951f6a806b4d2fb1b317b84db9be95d3050f6,3,59,59,0,0,0,0,5,71,98,1,3,1.162234474,741,169,0,73,72,1,6728,6755,27,43,41,2,100
b60c9090cf6823b04b8608b4b21b003e3d5367d6,219,189,23968,23779,1,0,1,3,82,225,4,67,7.113177352,21646,170,1,669,2920,2251,51968,184783,132815,328,1234,906,83.48426046
7d4faa844189899eaccf69aa58c86dcf437e1a56,0,0,0,0,0,0,0,0,0,0,0,0,0,0,171,2,0,0,0,0,0,0,0,0,0,100
7820b672466e2c6ba55b8c8d6c12ebe0eafb287f,0,0,0,0,0,0,0,0,0,0,0,0,0,0,49,5,0,0,0,0,0,0,0,0,0,100
e90d90134e9b2d32ab61a6ab31a05f84d0b816d7,10,170,91,79,0,0,0,3,76,422,1,7,2.540499212,1584,172,3,183,177,6,15258,14480,778,75,73,2,92.9746554
ed2321df8ada6e1c1d219186da99301073846810,1,38,0,38,1,0,1,1,1,0,1,1,0,0,173,4,1,0,1,146,0,146,1,0,1,99.9686913
0116ebdc0d12b4ff941dc13568e99503f1878b35,0,0,0,0,0,0,0,0,0,0,0,0,0,0,174,5,0,0,0,0,0,0,0,0,0,100
cd829a2c43a6866179abe58ce12a4133b932c65c,3,111,1,110,2,0,2,1,5,684,1,2,1.546179692,81,23,2,24,16,8,996,367,629,18,14,4,93.07608101
f494f8f34cf589fe6dff8d48f5a5886452297727,2,28,3,25,0,0,0,5,18,1634,1,1,0.938315352,219,24,3,73,67,6,1875,1743,132,29,27,2,99.98784342
8269b08176ec734c875141656b05a7b99c88c465,1,1,1,0,0,0,0,3,3,145,1,1,0,112,961,1,11,11,0,989,989,0,5,5,0,100
3241531314b2e388f84ccce2f1b3c6b0311a2323,0,0,0,0,0,0,0,0,0,0,0,0,0,0,50,6,0,0,0,0,0,0,0,0,0,100
0833411f3286b20ce1d6c936d16ab43cfa711aee,8,72,36,36,0,0,0,4,49,356,1,2,2.790881807,1823,51,7,416,413,3,13270,13162,108,231,226,5,100
faefa0c2a634afbe59e65a3e3e504efa6a9b02d1,0,0,0,0,0,0,0,0,0,0,0,0,0,0,52,8,0,0,0,0,0,0,0,0,0,100
a1e815eced1a1455c3462dd9ae860570d0262c68,0,0,0,0,0,0,0,0,0,0,0,0,0,0,962,2,0,0,0,0,0,0,0,0,0,100
b717cfc0d9720607517e0380eb6cb8e8ee13bde4,9,398,280,118,1,0,1,5,26,113,1,2,2.089513858,1457,25,4,147,138,9,10625,9774,851,66,62,4,93.11287237
841b783a043a5b122d5eb72d9b8c3195e6331001,1,2,2,0,0,0,0,5,19,43,1,1,0,442,27,0,56,56,0,4123,4111,12,22,22,0,100
b89d1c35301bd6032a388b429c7e699d615dd6ac,1,1,1,0,0,0,0,3,9,1862,1,1,0,55,28,1,13,13,0,273,273,0,9,9,0,100
e70534f7a4ec2b54ec768ac7ab901471c449283f,1,17,0,17,0,0,0,4,6,189,1,1,0,189,29,2,38,38,0,1486,1486,0,12,12,0,100
f868a68b7eb416a6eab16c1bc5111a9304abda78,1,3,1,2,0,0,0,2,5,212,1,1,0,15,175,0,1,1,0,137,136,1,1,1,0,100
5741b1e318b22e438ca1eeb91925bc4baee70b64,0,0,0,0,0,0,0,0,0,0,0,0,0,0,30,3,0,0,0,0,0,0,0,0,0,100
fcc3260b5a1e83ef05302f2eb6b7d4fd40fad1ef,1,20,2,18,0,0,0,9,23,186,1,1,0,257,31,2,36,34,2,2419,2282,137,8,8,0,100
31f58654d63d42bbda1d7e912b6f95efb6120627,1,64,40,24,0,0,0,9,24,2,1,1,0,273,32,3,39,36,3,2586,2419,167,12,8,4,100
09127f56c636ee637eb1f07d0eba3440b6712f10,1,1,1,0,0,0,0,9,25,4,1,1,0,289,33,4,39,39,0,2587,2586,1,12,12,0,100
6cd9cc6a8d1e532428172d8c54f492780cbf5b7a,0,0,0,0,0,0,0,0,0,0,0,0,0,0,34,5,0,0,0,0,0,0,0,0,0,100
c8f9f08756d150c5a46f445a17304919b9e41f95,0,0,0,0,0,0,0,0,0,0,0,0,0,0,35,6,0,0,0,0,0,0,0,0,0,100
c029e29adc9db2f7a2471358b2b5a061093cfb02,0,0,0,0,0,0,0,0,0,0,0,0,0,0,36,7,0,0,0,0,0,0,0,0,0,100
ff27b1223d4d5453fd2906adcf72b9a747680e10,1,2,2,0,0,0,0,9,19,245,1,1,0,105,37,8,21,21,0,721,721,0,11,11,0,100
b381afd170e9cc4163736bfa71ddae77701a0816,17,29,45,16,0,0,0,6,12,521,1,8,3.341002448,1713,38,9,135,135,0,14074,14087,13,88,88,0,99.90627929
3828ebf93ec969d4a7f819383025bfb91ad9a741,1,3,3,0,0,0,0,4,27,121,1,1,0,242,39,9,46,46,0,1627,1627,0,10,10,0,100
de46e0eae6d0ea4a38224707e901ecd295446493,1,1,1,0,0,0,0,4,28,0,1,1,0,242,40,10,46,46,0,1627,1627,0,10,10,0,100
6b4f770852690e1d34fe43e0db37628137d6c82d,1,1,1,0,0,0,0,3,10,74,1,1,0,55,41,11,13,13,0,273,273,0,9,9,0,100
ae0d0d872fed2966ef12a5cf71ac9f5960f5828c,0,0,0,0,0,0,0,0,0,0,0,0,0,0,42,10,0,0,0,0,0,0,0,0,0,100
2a2bf0b031c4469027045b22ec4f31aa3de55a4b,1,3,3,0,0,0,0,3,11,551,1,1,0,110,43,10,19,19,0,672,672,0,6,6,0,100
2d5c5a18b7dd46479303dbacc73f6352f595f0b1,1,1,1,0,0,0,0,4,11,518,1,1,0,18,44,6,0,0,0,101,101,0,0,0,0,100
34795fc34ca1a67262c0c8a8e76002b370c74ef1,1,1,1,0,0,0,0,2,2,1871,1,1,0,33,45,7,0,0,0,139,139,0,0,0,0,100
c91c0a525b17efd583e2db9587ed1636f4a8d6b8,1,1,1,0,0,0,0,5,12,288,1,1,0,112,46,8,11,11,0,1098,1098,0,5,5,0,100
411a86eb6e47ca9ac5c33af87d59e2380475a4db,1,1,1,0,0,0,0,3,18,2367,1,1,0,24,47,9,0,0,0,235,235,0,0,0,0,100
131c84c923edbb949e2066761c88e8ea79763e99,19,43,44,1,0,0,0,2,90,1807,2,10,4.004497331,3076,48,10,741,741,0,19543,19543,0,315,315,0,100
ca3300f23f47bc44b20a0ae55815ad003756463e,1,1,1,0,0,0,0,4,6,519,1,1,0,216,49,10,54,54,0,1457,1457,0,18,18,0,100
82bbf156a58baa2b45a3f76ff6c886ee3fdf395b,1,13,6,7,0,0,0,1,3,538,1,1,0,17,176,0,4,5,1,271,200,71,1,1,0,100
bf1d130e3e221512b764f7a321ba608dd7efbcb2,1,2,3,1,0,0,0,4,8,149,1,1,0,111,177,1,15,15,0,992,998,6,7,7,0,100
00566b139ec2bf0355864b333a8331b6fac1add9,0,0,0,0,0,0,0,0,0,0,0,0,0,0,50,11,0,0,0,0,0,0,0,0,0,100
9abf7557ca81150d98dec2ac44543ef39af4f31c,4,45,5,40,0,0,0,4,6,308,1,2,1.760964047,558,51,12,58,53,5,5326,5126,200,23,20,3,100
b3d25547b6232ece8e77ee034b1248aaff52f108,1,3,0,3,0,0,0,3,5,313,1,1,0,188,52,13,21,21,0,1827,1810,17,9,9,0,100
ce272b232d75d13b3812ad1f06a65b8ff8156cc7,1,0,4,4,0,0,0,4,5,292,1,1,0,154,53,14,11,11,0,1410,1430,20,8,8,0,100
3231e8b074c810b013e301d3c060ed03e86706ce,1,1,1,0,0,0,0,8,26,297,1,1,0,79,54,15,0,0,0,404,404,0,0,0,0,100
d45c030478b733f37f32c6cc770ddfe4ce8b1c2b,1,1,1,0,0,0,0,4,5,532,1,1,0,86,55,16,14,14,0,631,631,0,6,6,0,100
7923646ecb3359aa81d905ac2ad98ecf6f71a605,0,0,0,0,0,0,0,0,0,0,0,0,0,0,963,0,0,0,0,0,0,0,0,0,0,100
1cdd0956f8e82c9ffea5058b3b017bfe3fde55cc,32,504,8,496,2,0,2,2,13,445,4,15,4.901616728,4029,964,1,670,670,0,35770,35770,0,259,259,0,99.87480438
f7d1c10588df3e31be6b88f18752b443d5102261,2,2,2,0,0,0,0,2,5,0,1,2,1,193,965,2,25,25,0,1467,1467,0,8,8,0,99.93736298
13a20a5a3ab25cbdcd7129866f612136fc7f73a0,1,1,1,0,0,0,0,7,17,173,1,1,0,249,56,14,42,42,0,1575,1575,0,19,19,0,100
4fc5ff5924ecf1ec07c9727b0b1825185ad0e19e,1,4,4,0,0,0,0,7,18,0,1,1,0,249,57,15,42,42,0,1575,1575,0,19,19,0,100
a5bc1b248b3bceee85278bb06348a165a2f300b8,1,1,1,0,0,0,0,4,6,1378,1,1,0,51,58,16,8,8,0,238,238,0,5,5,0,100
b2d204fcac71a6e76cfb249b27c25f0f5d961451,1,1,1,0,0,0,0,4,5,2288,1,1,0,133,59,17,29,29,0,921,921,0,20,20,0,100
2f22cc7a8e4a80b37fedb4b7b7f39b561da90845,1,1,1,0,0,0,0,4,6,0,1,1,0,133,60,18,29,29,0,921,921,0,20,20,0,100
f7ddce5bedabc1a5dd548f47a64306e5b9fd63b6,1,1,1,0,0,0,0,4,7,0,1,1,0,133,61,19,29,29,0,921,921,0,20,20,0,100
cbae1e8b5de643277439ebe67a6d15288514057e,0,0,0,0,0,0,0,0,0,0,0,0,0,0,62,20,0,0,0,0,0,0,0,0,0,100
5592426ee15d7b81dcc3d8213704be47fe113227,2,35,3,32,0,0,0,3,4,326,1,1,0.998000884,86,966,3,13,9,4,970,786,184,8,6,2,100
a2afabff4602fc08d0b67876e0daacab36d156da,0,0,0,0,0,0,0,0,0,0,0,0,0,0,63,20,0,0,0,0,0,0,0,0,0,100
5a5acf0697de2bf4d44e3f28e8cba69210855a67,1,16,1,15,0,0,0,2,9,3982,1,1,0,45,967,4,16,13,3,384,311,73,10,8,2,100
e0a4f02fe67abe9d836984366433f58b48d3e5ae,1,1,1,0,0,0,0,5,10,1803,1,1,0,182,64,8,5,5,0,1492,1492,0,3,3,0,100
9d58fc8500a3a48a806ae2ebdb41d9d64dc22572,1,0,1,1,0,0,0,2,2,178,1,1,0,207,65,9,15,15,0,1723,1734,11,5,5,0,100
e8f1e701d25144d81cd0195a9f5fbc9458dd6f9a,0,0,0,0,0,0,0,0,0,0,0,0,0,0,66,10,0,0,0,0,0,0,0,0,0,100
3032e7b893d56adc630134652c2377ab65920ee0,6,439,14,425,4,0,4,1,41,617,1,3,2.235169219,1461,26,0,291,257,34,9507,7898,1609,167,143,24,97.66805815
7f7ff5e8ba17c6c8d625c33b8f05e606fc9f71e3,1,8,8,0,0,0,0,11,26,211,1,1,0,294,67,5,13,13,0,1408,1408,0,6,6,0,100
1a38c2339ab6749dfcc6810d94e1793beb82f6ef,0,0,0,0,0,0,0,0,0,0,0,0,0,0,68,0,0,0,0,0,0,0,0,0,0,100
921e2015ef96bc9655c9d821e051d6c0d2e99045,41,81,72,9,0,0,0,3,27,442,3,22,5.173557696,5158,69,1,470,470,0,46206,46194,12,248,248,0,93.96025458
e56c7ff17a2385076e8a05f36d9a63adf4f078ec,3,208,1,207,1,0,1,11,28,152,1,2,0.766772905,556,70,2,67,52,15,4490,3376,1114,30,23,7,99.9746643
5c9a671d5f511bc01eae6f950023583f3be90182,1,4,4,0,0,0,0,2,2,0,1,1,0,109,53,0,12,12,0,917,925,8,5,5,0,100
abbf629a5d31dc5151bb3c394284f4773c816560,2,8,9,1,0,0,0,11,29,0,1,2,0.787126586,578,54,1,55,55,0,3551,3565,14,25,25,0,100
e8cd2306709625bd0f2ed3e4e768f510a4343b96,3,11,3,8,0,0,0,6,22,18,2,2,1.287054028,688,71,3,43,43,0,6575,6510,65,22,22,0,100
072f1ae98e47b54aa751499832f60961ebe9677a,1,2,1,1,0,0,0,7,77,301,1,1,0,233,178,0,24,24,0,1940,1932,8,3,3,0,100
9e6098a25b1968d239502651d634f92836eed1bb,1,7,1,6,0,0,0,7,78,2,1,1,0,234,179,1,25,24,1,1977,1940,37,3,3,0,100
02ecad17bac6be42eb946fcc029d10dda283b57c,0,0,0,0,0,0,0,0,0,0,0,0,0,0,27,0,0,0,0,0,0,0,0,0,0,100
91095865ff06c3b77efcb3d9514df10f70f95912,2,31,3,28,0,0,0,3,3,2530,1,2,0.787126586,137,55,2,17,16,1,1176,996,180,13,12,1,100
3cc95f4fc8e167417e12def3948b13bd7e1f57f6,8,81,27,54,0,0,0,4,8,245,1,2,2.494846291,705,56,3,74,71,3,6090,5626,464,50,48,2,99.92402178
f739dca9e8d666e52d7388ad53dae1293d934ae5,1,40,0,40,1,0,1,1,1,0,1,1,0,0,57,4,3,0,3,97,0,97,2,0,2,99.88607595
770b5af25e1fbeaf5b273f1c74433dacddd0104a,1,12,4,8,0,0,0,11,30,40,1,1,0,309,58,5,14,14,0,1614,1558,56,7,7,0,100
e1bb0027ba261e3822d379914ab3ab4bcf7b8aeb,2,68,1,67,0,0,0,12,82,504,1,2,0.189278431,477,59,6,88,82,6,4727,4140,587,42,40,2,100
0c1b4a1e07fa6be269615c08a3813af04a71d46e,1,14,4,10,0,0,0,3,7,446,1,1,0,64,60,5,7,6,1,636,580,56,4,4,0,100
40907b1f5cbf02a6eb64cce11e1fcaa27f6c4f18,1,26,12,14,0,0,0,4,7,447,1,1,0,47,61,6,8,7,1,507,413,94,3,3,0,100
17ab609eac44fd5f539f10604c664a2cbfee98fe,0,0,0,0,0,0,0,0,0,0,0,0,0,0,62,7,0,0,0,0,0,0,0,0,0,100
f75ea67e61cfbd25c2bf1dc094ae6c739831bb43,1,2,3,1,0,0,0,5,32,341,1,1,0,312,180,2,32,32,0,2889,2904,15,16,16,0,100
f1c99aa6a03880f80f483d24ac46a0d097a130b5,1,1,1,0,0,0,0,4,6,75,1,1,0,56,63,8,5,5,0,435,437,2,4,4,0,100
209714387177f289273d64d48ed6141b9d5aa1e2,1,1,3,2,0,0,0,4,7,15,1,1,0,79,64,9,10,10,0,771,774,3,6,6,0,100
682feb495ad2a18716afc11eff5d9138984e5b8d,1,1,1,0,0,0,0,3,5,1395,1,1,0,25,65,10,3,3,0,226,225,1,3,3,0,100
2e7c3198e4d9e5e3fce876da83c3ef0d2ce6423a,1,1,1,0,0,0,0,2,2,2893,1,1,0,22,66,11,3,3,0,182,181,1,2,2,0,100
d72ba280d8ed202f60872e3b2cc9d167c7b6699d,0,0,0,0,0,0,0,0,0,0,0,0,0,0,67,12,0,0,0,0,0,0,0,0,0,100
cd167f96b31eec1c4e7affc0f188d06c753cd39c,36,125,134,9,0,0,0,4,49,791,4,23,3.786478201,5559,68,13,1013,1015,2,43095,42997,98,392,392,0,100
018ec691f0f734aca79ba7353d6e8a2b731054e3,4,1525,0,1525,4,0,4,1,1,0,1,2,1.939240033,0,69,14,226,0,226,9310,0,9310,78,0,78,99.87362568
b96e7ba8fab03745257d5feb6ab97247d6abcee8,1,2,1,1,0,0,0,4,9,22,1,1,0,132,70,15,7,7,0,1168,1164,4,7,7,0,100
cf8fec97f253a2e60db4d853231311320f612422,1,4,2,2,0,0,0,4,10,0,1,1,0,133,71,16,7,7,0,1182,1168,14,7,7,0,100
b4e41ba3e745dabf6024a4a6f3f44c22a01cf1b7,4,214,133,81,0,0,0,1,2,0,1,2,1.916430577,1156,72,17,247,198,49,10275,9701,574,83,57,26,99.8990154
ba4e9d9c999177f6a5fa85cc6461a982a34059a7,0,0,0,0,0,0,0,0,0,0,0,0,0,0,28,1,0,0,0,0,0,0,0,0,0,100
9c167fc0c2face25e6e8b90f0c065f9bf681b21f,0,0,0,0,0,0,0,0,0,0,0,0,0,0,72,0,0,0,0,0,0,0,0,0,0,100
8e0495d48a7ba1eec21fa4e0d0afc2efa3ef8073,0,0,0,0,0,0,0,0,0,0,0,0,0,0,73,1,0,0,0,0,0,0,0,0,0,100
beb2ff38a86224f7855f526dbbdaee3727db779e,0,0,0,0,0,0,0,0,0,0,0,0,0,0,73,18,0,0,0,0,0,0,0,0,0,100
fbf614367dafbe3229054d81b2c3817c50e94519,0,0,0,0,0,0,0,0,0,0,0,0,0,0,74,19,0,0,0,0,0,0,0,0,0,100
211edf2178cd44d027ab1ec9def58d0895725c88,4,60,34,26,0,0,0,6,31,350,1,3,1.513765038,599,75,20,41,41,0,3860,3761,99,20,20,0,100
6d8fbe246b46a1a935767bb4d2c8be7e27ec15a3,2,42,2,40,1,0,1,1,22,238,1,2,0.439496987,41,76,21,8,7,1,522,357,165,6,5,1,99.94953318
f2eb7e1b759bada8130cfc00b1d72d8f3b83febb,3,83,52,31,0,0,0,3,9,616,1,2,1.083510103,313,77,21,63,59,4,2394,2178,216,34,31,3,100
7016ff63856c8deffcf11b8f932b845e04160147,2,2,2,0,0,0,0,3,9,0,1,2,1,239,78,22,42,42,0,1483,1482,1,28,28,0,100
84326249883a55eb502c114a3149c52cf4297425,0,0,0,0,0,0,0,0,0,0,0,0,0,0,79,23,0,0,0,0,0,0,0,0,0,100
25efc4357261656d5edcbe0e2ae3852d5ebe6100,2,18,2,16,0,0,0,3,6,215,1,2,0.934068055,360,74,2,56,54,2,3101,3000,101,25,24,1,100
62766057cc02d6550f854f13d77dc0a6629a7ac7,1,3,1,2,0,0,0,4,7,0,1,1,0,200,80,23,23,23,0,1915,1905,10,10,10,0,100
09b4ef12001f21f55089baf36a8a4281641cdd27,1,26,19,7,0,0,0,5,5,524,1,1,0,167,81,21,15,14,1,1371,1349,22,2,2,0,100
37201275a452d3f906eac6e10e5e6cd740b5ec0a,0,0,0,0,0,0,0,0,0,0,0,0,0,0,82,22,0,0,0,0,0,0,0,0,0,100
c88c240fc6bb33a8206ede54d4bb81c25e67066c,30,113,66,47,0,0,0,4,35,619,4,22,4.420721138,4174,83,23,570,566,4,32660,32387,273,290,290,0,99.38231888
343bd9b3a4935cad9c178b34639f1060938ef33a,0,0,0,0,0,0,0,0,0,0,0,0,0,0,84,24,0,0,0,0,0,0,0,0,0,100
fcaf1f5e6998ca1363a30582926488ef736148e3,0,0,0,0,0,0,0,0,0,0,0,0,0,0,85,25,0,0,0,0,0,0,0,0,0,100
802233b7a22a09a81a1bc9e6f1d68d7c5814da46,1,11,0,11,0,0,0,6,14,0,1,1,0,63,86,26,14,14,0,512,393,119,7,7,0,100
1e1175531c9c27f5f60e9e3ae06db387dfa79c3c,1,0,1,1,0,0,0,9,19,3,1,1,0,168,0,0,26,26,0,1586,1586,0,14,14,0,100
69178eb38fbb9cad0e32ff2cf36304f183dfb62c,1,0,1,1,0,0,0,10,17,108,1,1,0,197,87,24,27,27,0,1561,1572,11,16,16,0,100
fa2e343dd464293d7ff74d33f2997a079111c95a,0,0,0,0,0,0,0,0,0,0,0,0,0,0,75,3,0,0,0,0,0,0,0,0,0,100
edd0725252f00c7ed89c8718967a9edc20916d55,0,0,0,0,0,0,0,0,0,0,0,0,0,0,76,4,0,0,0,0,0,0,0,0,0,100
7a5ffcb875367369a4270e3ed638daed60fc0b4d,0,0,0,0,0,0,0,0,0,0,0,0,0,0,77,5,0,0,0,0,0,0,0,0,0,100
44200432b98a9e889858c818ffa4e8beaeb2c52a,1,2,0,2,0,0,0,10,28,531,1,1,0,212,88,25,42,42,0,1581,1565,16,3,3,0,100
9ecac13b6221f4cce0326aee2dcff1b90e5896e8,0,0,0,0,0,0,0,0,0,0,0,0,0,0,89,26,0,0,0,0,0,0,0,0,0,100
d0976522fc36999bbd1df82bdcbbb2c174539c09,0,0,0,0,0,0,0,0,0,0,0,0,0,0,90,27,0,0,0,0,0,0,0,0,0,100
59dbea77e73ca8ea49d7ed346c1e6b7e06f89930,0,0,0,0,0,0,0,0,0,0,0,0,0,0,91,28,0,0,0,0,0,0,0,0,0,100
58546105b5680bae0993fd9167fb97b1b65e2ae0,0,0,0,0,0,0,0,0,0,0,0,0,0,0,92,29,0,0,0,0,0,0,0,0,0,100
a851ddc46955ae1fb35c621edbaed4daae7bdbd8,2,28,14,14,0,0,0,3,6,460,1,2,0.993447238,76,93,30,16,15,1,551,334,217,12,12,0,100
3186b37fb0e8a711bf07029db45fe9fc940f0079,3,60,116,56,0,0,0,3,10,1680,2,3,1.485749237,435,94,31,49,65,16,2856,3097,241,21,20,1,98.49710983
82534918c3cdebf610c8c49c4c4ad3112703eb64,10,82,90,8,0,0,0,7,83,482,2,5,2.788220734,1656,95,22,225,226,1,14254,14185,69,84,84,0,94.30825243
c20d04cde96a1c09fa9819c870d22acb8918d906,1,9,5,4,0,0,0,9,20,17,1,1,0,168,96,23,26,26,0,1631,1586,45,14,14,0,100
95c68de3eb275c9333bd067b1ed1cf00e7fcb40a,2,66,1,65,0,0,0,4,18,430,1,2,0.527642326,263,97,24,43,37,6,2690,2232,458,20,18,2,100
055fbeda80e0f9227aa67d5c3ef87785a1cf1a88,0,0,0,0,0,0,0,0,0,0,0,0,0,0,98,25,0,0,0,0,0,0,0,0,0,100
24c4921f1a3c305656229bea2ee8f21521f2a9b8,1,17,19,2,0,0,0,4,5,31,1,1,0,241,99,18,22,26,4,1857,1878,21,5,5,0,100
06205a6cd43d9d2fac4b59184e03d52725fde536,1,2,1,1,0,0,0,4,7,67,1,1,0,267,100,19,24,24,0,2096,2075,21,8,8,0,100
44cc7b3e9102a05aa5c963a8d0a2aba241553b6d,2,38,17,21,0,0,0,4,12,317,1,2,0.945660305,296,101,18,68,67,1,2466,2233,233,30,29,1,100
59cd40a4b32eec1d5eb4539781b4e59e6486787c,0,0,0,0,0,0,0,0,0,0,0,0,0,0,102,19,0,0,0,0,0,0,0,0,0,100
304fb0f05af390ae3e34778f42aeedf84de270f8,3,89,41,48,0,0,0,5,10,310,1,2,1.167465733,400,103,17,62,50,12,3818,3602,216,19,18,1,100
05e5398c029ef8a470ba1b3fe53e3e74fe636f26,0,0,0,0,0,0,0,0,0,0,0,0,0,0,104,18,0,0,0,0,0,0,0,0,0,100
c371b4e399d3ca1ceaf76b4200a6db5657ad7513,1,10,19,9,0,0,0,6,15,48,1,1,0,152,105,17,12,15,3,1197,1191,6,6,6,0,100
80e4928bc2a2ff168ad9cd2bab60c8896b6dd38d,0,0,0,0,0,0,0,0,0,0,0,0,0,0,106,15,0,0,0,0,0,0,0,0,0,100
2e5449f24d06c2e9f1006ae82c86b883d4cdf7ef,29,70,49,21,0,0,0,7,33,211,3,13,4.415526642,3125,1,0,351,348,3,23408,23335,73,192,189,3,100
d520c597df9caf412ee59cff8d44a1dbd255038c,0,0,0,0,0,0,0,0,0,0,0,0,0,0,107,16,0,0,0,0,0,0,0,0,0,100
6413575104c174922ccbaa4a63f3e815c8bb90f5,5,1411,0,1411,5,0,5,1,1,0,1,2,1.828263308,0,108,13,145,0,145,6984,0,6984,56,0,56,99.87114912
e62e64a1032b74e18e4dd4c1f9ee54826ca8e5ca,0,0,0,0,0,0,0,0,0,0,0,0,0,0,109,14,0,0,0,0,0,0,0,0,0,100
c87196e4e24a758d652b5ba36e26701c35726654,5,148,40,108,1,0,1,7,29,320,2,3,2.252800635,709,110,15,109,91,18,6620,6054,566,43,42,1,99.95324918
2e5e8a573b2074526104847b26707d131f6c35ba,1,2,2,0,0,0,0,1,2,4,1,1,0,33,111,16,7,7,0,217,217,0,6,6,0,100
2b054b6bfd4c9d6a53d0a4a3d0a5b72c455d4d56,1,3,2,1,0,0,0,1,2,5,1,1,0,275,112,17,40,40,0,2639,2628,11,6,6,0,100
16e952d6cbaecda90cd16de87cb51da384a6ca22,1,12,14,2,0,0,0,3,6,86,1,1,0,37,113,18,6,6,0,289,290,1,2,2,0,100
6a8cfcde4d862689b0b2db3a48328de4884f2776,3,12,11,1,0,0,0,4,8,233,1,1,0.840491401,405,114,15,43,42,1,3031,3059,28,15,15,0,100
ede812b2b7c6519cd2a4eebfca0538a65b7d7a8d,2,5,3,2,0,0,0,5,14,709,1,2,1,265,115,10,25,25,0,2335,2342,7,7,7,0,100
d15537b19c6b6d221c20567dcaefddeb39eed7f5,2,78,6,72,0,0,0,4,12,1317,1,2,0.67694187,719,223,0,168,160,8,7217,6599,618,27,24,3,100
f6c9f3d475b23da31c6af20b597dc6b313dfecc4,0,0,0,0,0,0,0,0,0,0,0,0,0,0,116,8,0,0,0,0,0,0,0,0,0,100
0b0f254897e5e98fdb683083d6bc52b847f80178,0,0,0,0,0,0,0,0,0,0,0,0,0,0,117,2,0,0,0,0,0,0,0,0,0,100
b0dc01b24aae9e583dd873541ab9f3eafe0b7d9a,1,1,1,0,0,0,0,4,9,50,1,1,0,266,118,3,24,24,0,2092,2086,6,8,8,0,100
7bb6320b1fbd446ec416afed1f322f4ab04dcc5a,0,0,0,0,0,0,0,0,0,0,0,0,0,0,119,4,0,0,0,0,0,0,0,0,0,100
1c06e9db4fb2623af8953fe14ddf2a8002e4c015,1,33,55,22,0,0,0,8,13,96,1,1,0,122,120,5,18,21,3,854,1009,155,10,9,1,100
dcc8b38f31b3ee59b7da55b82a5c63038e43edad,0,0,0,0,0,0,0,0,0,0,0,0,0,0,121,6,0,0,0,0,0,0,0,0,0,100
d32fa5f95e4e351b36423b77bb32367a546ad0ca,0,0,0,0,0,0,0,0,0,0,0,0,0,0,122,7,0,0,0,0,0,0,0,0,0,100
8fd8964def87d065b2e648a26f996247e5f5db1f,0,0,0,0,0,0,0,0,0,0,0,0,0,0,123,8,0,0,0,0,0,0,0,0,0,100
dfa1ded57519a1f790f268e6b5c7a4e157a5f4b6,0,0,0,0,0,0,0,0,0,0,0,0,0,0,124,8,0,0,0,0,0,0,0,0,0,100
0fbb722b80251907a7842ee84e7e2e368dbeb4eb,1,1,1,0,0,0,0,3,9,2511,1,1,0,49,125,9,6,6,0,241,241,0,5,5,0,100
26a338e3f01717afaa11a6fd2aaf764bb21bd2c9,1,0,1,1,0,0,0,10,38,659,1,1,0,207,126,10,23,23,0,1536,1538,2,14,14,0,100
4aaf42a07dfe1990420ab6f28b18b5476421a443,1,1,0,1,0,0,0,10,39,0,1,1,0,206,127,11,23,23,0,1538,1536,2,14,14,0,100
82d51ea3287b5a34931bbfe36f4c39b95a00d858,0,0,0,0,0,0,0,0,0,0,0,0,0,0,128,12,0,0,0,0,0,0,0,0,0,100
b49a45a152050f92c140bea73b47043ff545cff3,0,0,0,0,0,0,0,0,0,0,0,0,0,0,129,13,0,0,0,0,0,0,0,0,0,100
377131e745ef87fbf1c18f269e13301f48471d23,0,0,0,0,0,0,0,0,0,0,0,0,0,0,130,14,0,0,0,0,0,0,0,0,0,100
e9fbbc0459389f1ccccb304043ec85acef6e70e7,0,0,0,0,0,0,0,0,0,0,0,0,0,0,131,15,0,0,0,0,0,0,0,0,0,100
1fbd7b7bd7c509073e0ea4af63a997694e742d55,1,2,2,0,0,0,0,6,26,651,1,1,0,296,132,16,32,32,0,2442,2442,0,2,2,0,100
f88d7dc297f7b72127105605cf46ecc6334620e5,3,1,4,3,0,0,0,6,41,422,1,1,1.370950594,629,181,0,95,95,0,4838,4852,14,38,38,0,100
89c7f4c4a29a153945d68ad085896a627328ce37,0,0,0,0,0,0,0,0,0,0,0,0,0,0,133,16,0,0,0,0,0,0,0,0,0,100
770bcbadeaab566bf0c831a84d96491fc0e08139,0,0,0,0,0,0,0,0,0,0,0,0,0,0,134,17,0,0,0,0,0,0,0,0,0,100
31354daeb589b4af9e6a0b5795a500c2d012ae3d,0,0,0,0,0,0,0,0,0,0,0,0,0,0,135,18,0,0,0,0,0,0,0,0,0,100
dbe5d501b911f66770791e96640c0578226f956b,0,0,0,0,0,0,0,0,0,0,0,0,0,0,136,19,0,0,0,0,0,0,0,0,0,100
750043ebe07efce9ae9a5d159655ab3e3089c9a2,0,0,0,0,0,0,0,0,0,0,0,0,0,0,137,20,0,0,0,0,0,0,0,0,0,100
02faa512a7a7b9b04ab8dcc70d2e9770894b2d46,1,2,2,0,0,0,0,9,65,619,1,1,0,364,138,21,87,87,0,2897,2897,0,43,43,0,100
23adfe36515e771433712d23eb900681c421e63c,0,0,0,0,0,0,0,0,0,0,0,0,0,0,139,22,0,0,0,0,0,0,0,0,0,100
4eb085d55237404ae61a17a8712e6b64de239a41,0,0,0,0,0,0,0,0,0,0,0,0,0,0,140,23,0,0,0,0,0,0,0,0,0,100
a096f35cae260d68f63ced51634c920ca4cbfc92,0,0,0,0,0,0,0,0,0,0,0,0,0,0,141,23,0,0,0,0,0,0,0,0,0,100
5a41f8fb35fdec453f5874a143f854101bc9785e,0,0,0,0,0,0,0,0,0,0,0,0,0,0,182,1,0,0,0,0,0,0,0,0,0,100
4f368b8efd9e040a3b982321fe2eb207b49b48b1,0,0,0,0,0,0,0,0,0,0,0,0,0,0,183,2,0,0,0,0,0,0,0,0,0,100
67f146c86e4961a693becc49f270b1850d90ab19,2,62,13,49,0,0,0,4,91,628,1,2,0.984426898,617,184,3,127,123,4,4691,4486,205,49,47,2,100
78996cb6b215662402dcdaa29fc1454ce84c52f6,0,0,0,0,0,0,0,0,0,0,0,0,0,0,142,24,0,0,0,0,0,0,0,0,0,100
700224140ffb5cda4517f2d32261612b3d29bace,51,7496,0,7496,51,0,51,5,40,510,2,9,5.231161303,0,143,25,782,0,782,42965,0,42965,254,0,254,96.40130862
7b9c6c5cab87bc86267e398b067a9c9e506833b6,0,0,0,0,0,0,0,0,0,0,0,0,0,0,144,26,0,0,0,0,0,0,0,0,0,100
81838f2d8f77cee2e6869aa8372f51401d8759a4,0,0,0,0,0,0,0,0,0,0,0,0,0,0,145,27,0,0,0,0,0,0,0,0,0,100
a46d104d37a1b8125fc35b80d2890e4b8c646f10,0,0,0,0,0,0,0,0,0,0,0,0,0,0,146,28,0,0,0,0,0,0,0,0,0,100
2396246c13ac844d6a9b7d9d02c7fcd779d11804,1,6,28,22,0,0,0,4,11,65,1,1,0,289,224,0,35,39,4,2843,2996,153,16,17,1,100
bef1e8e81b69c968afaebd747efe07a956e2211d,2,23,2,21,0,0,0,2,10,826,1,2,0.634309555,153,225,1,30,27,3,987,873,114,19,18,1,100
b29f6631d993c0f5fd8f067bc85c34f3a8d7740d,0,0,0,0,0,0,0,0,0,0,0,0,0,0,147,23,0,0,0,0,0,0,0,0,0,100
18b2c440c8a7e4c389f6d548f696e81cedf21056,0,0,0,0,0,0,0,0,0,0,0,0,0,0,148,24,0,0,0,0,0,0,0,0,0,100
e93f05d642aa759cbc0a69c9e275d39167e34f8f,3,53,17,36,0,0,0,10,21,144,1,2,1.440174665,474,149,25,76,68,8,4538,4146,392,37,37,0,100
6b1be46477855d652fef9a18b7eec86e50b9cf6f,1,1,10,9,0,0,0,5,12,6,1,1,0,268,150,26,35,35,0,2757,2843,86,16,16,0,100
3b4f783171afb64be082f442171ee48ef60cf180,0,0,0,0,0,0,0,0,0,0,0,0,0,0,78,0,0,0,0,0,0,0,0,0,0,100
632a45d5ad962bb03ef2e571d5f91cd191b5fc73,0,0,0,0,0,0,0,0,0,0,0,0,0,0,79,1,0,0,0,0,0,0,0,0,0,100
d1c79edf5596437dd5980fffee26c0da5f1da432,0,0,0,0,0,0,0,0,0,0,0,0,0,0,80,2,0,0,0,0,0,0,0,0,0,100
29c3f055950ed8fc038c9cbf8cee67a07f6dc2ef,0,0,0,0,0,0,0,0,0,0,0,0,0,0,81,3,0,0,0,0,0,0,0,0,0,100
08da3686124f67a529bfc8b00a829b7dc72a9a4e,2,4,0,4,0,0,0,7,22,2,1,1,1,303,151,27,47,47,0,2862,2862,0,21,21,0,100
0080be59ee880a3007a612f43fe6fdca86556aa6,0,0,0,0,0,0,0,0,0,0,0,0,0,0,152,28,0,0,0,0,0,0,0,0,0,100
ab6216f1e57a95454e39233f406ffbd7c7fe7cfb,3,12,11,1,0,0,0,10,23,4,1,2,1.450908284,506,153,29,76,76,0,4617,4538,79,37,37,0,100
4d4efb0cb3ce1ba12009179b38a848460cb076a8,2,16,4,12,0,0,0,7,24,0,1,1,1,304,154,30,47,47,0,3003,2923,80,21,21,0,100
84059288d0fc2b645c449e04fb030872137091eb,12,72,94,22,0,0,0,6,112,501,3,10,2.376377383,2047,155,31,165,165,0,18647,18734,87,84,84,0,100
a2339d02b15c2e56b74ededc143e74f2606b880d,1,2,2,0,0,0,0,1,2,196,1,1,0,383,156,32,65,65,0,3690,3690,0,17,17,0,100
8552cff1d923d91c479bf0ce40fdc96543655529,1,17,8,9,0,0,0,4,5,124,1,1,0,248,157,33,53,53,0,1535,1446,89,30,30,0,100
9a7458f2bb5b882d239c5751b6c4945dafc7e2fa,0,0,0,0,0,0,0,0,0,0,0,0,0,0,158,34,0,0,0,0,0,0,0,0,0,100
fab3d2f6ae5aa92cdbefcf3ba5e110e7a71fd991,1,0,14,14,0,0,0,5,7,279,1,1,0,138,159,35,16,16,0,1164,1164,0,3,3,0,100
d74edf431d3a5678d51d4fd89b415c67ea9a76d6,1,1,1,0,0,0,0,5,28,174,1,1,0,390,160,36,77,77,0,2599,2599,0,57,57,0,100
fdded755a7ba0ccd467aa52e9c4e0d524ded5219,0,0,0,0,0,0,0,0,0,0,0,0,0,0,161,37,0,0,0,0,0,0,0,0,0,100
28de0d8e7e31c3f5c38dc8bfe4e0df71ce2437b8,0,0,0,0,0,0,0,0,0,0,0,0,0,0,162,38,0,0,0,0,0,0,0,0,0,100
6130da0bbdb7e382615c499dc8e1b1c68f9812d1,0,0,0,0,0,0,0,0,0,0,0,0,0,0,2,0,0,0,0,0,0,0,0,0,0,100
256fe2714e949798a1aeae1329de0b6d5fc7c8ff,0,0,0,0,0,0,0,0,0,0,0,0,0,0,163,22,0,0,0,0,0,0,0,0,0,100
29ff0a8b71de50e333b5bc9701c67baaa684e7a5,0,0,0,0,0,0,0,0,0,0,0,0,0,0,3,1,0,0,0,0,0,0,0,0,0,100
a0ce86226101a06dacb82d08bc2156736862c6c2,0,0,0,0,0,0,0,0,0,0,0,0,0,0,164,23,0,0,0,0,0,0,0,0,0,100
3e9cd90fa55c6300d60b36d1d02bc9f632625412,2,42,4,38,0,0,0,5,17,774,1,2,0.615253891,152,185,0,42,38,4,1357,1155,202,16,14,2,100
678525a86e75741ee6426efdd8b163b6004efee7,1,7,1,6,0,0,0,4,6,744,1,1,0,156,165,2,37,37,0,1054,1054,0,14,14,0,100
4e1b7a6ebf54a444e01ffa613fe44a1f11f06e31,2,24,8,16,0,0,0,5,7,1322,1,1,0.997180399,170,166,3,28,26,2,1614,1499,115,11,11,0,100
f322cbc13a5f2914d8429850673612cddc23b08a,1,2,3,1,0,0,0,4,6,1156,1,1,0,94,167,4,10,10,0,818,823,5,6,6,0,100
5e25fddbaedf0a9ca2daa54021570b03d1a74251,0,0,0,0,0,0,0,0,0,0,0,0,0,0,168,3,0,0,0,0,0,0,0,0,0,100
adbf34c1c54625e9bea9e8d6b5f6d9e21298847e,0,0,0,0,0,0,0,0,0,0,0,0,0,0,169,4,0,0,0,0,0,0,0,0,0,100
d257e955295583f5de4775159f9c3488ceb9248d,0,0,0,0,0,0,0,0,0,0,0,0,0,0,0,0,0,0,0,0,0,0,0,0,0,100
8128b9bae0814e7d82c42b25f76154036efbe383,0,0,0,0,0,0,0,0,0,0,0,0,0,0,1,1,0,0,0,0,0,0,0,0,0,100
d4e58278d0f406049d156c730cda6683c3529f93,4,237,235,2,0,0,0,5,11,1326,2,4,0.663373952,428,968,0,50,43,7,3924,3914,10,17,18,1,99.9244713
dde5e3f7cf414b0d6eb88f5f3e337d1bcc55b4ae,0,0,0,0,0,0,0,0,0,0,0,0,0,0,170,4,0,0,0,0,0,0,0,0,0,100
f6fd0ce109f425fd56237b92a21dec09cd0388f0,3,54,21,33,0,0,0,4,12,726,2,3,0.576315347,352,186,0,61,60,1,3168,2963,205,29,29,0,100
7dbe24a0d35518d330173c82bb437bfbd011fcc4,0,0,0,0,0,0,0,0,0,0,0,0,0,0,4,0,0,0,0,0,0,0,0,0,0,100
7120506af5e5eb97235b69a42795c9309e6c0404,3,4,3,1,0,0,0,1,30,36,1,2,1.448815636,324,5,1,28,22,6,3294,3176,118,9,10,1,99.87402368
cb901b410349875178345e378e51c6749c245ca1,2,0,56,56,0,0,0,5,6,1038,1,2,0.99631652,10,6,2,0,2,2,0,62,62,0,2,2,99.94955864
0dc7b5cdebe24b9dd309d0c08a2049245d30d0a3,4,41,51,10,0,0,0,10,36,1559,1,1,1.206041569,225,7,3,41,41,0,1558,1559,1,21,21,0,95.77562327
ee41571393261942e86191b4f0200680def23885,1,1,1,0,0,0,0,5,8,808,1,1,0,121,8,4,18,18,0,1114,1114,0,5,5,0,100
235b6cad6eff26bc6251a76f17308961c3997096,1,2,1,1,0,0,0,3,25,1707,1,1,0,107,187,1,15,15,0,849,831,18,11,11,0,100
13b793cccf3662c7f5289bc383dccbede0e12aed,1,1,1,0,0,0,0,5,9,313,1,1,0,158,29,0,34,34,0,1367,1365,2,11,11,0,100
dce39e6255de28e7c5b9ab534635ec50c80c26da,0,0,0,0,0,0,0,0,0,0,0,0,0,0,188,2,0,0,0,0,0,0,0,0,0,100
38bcfb522c7b6a33f55d9d7472b5610754714f53,0,0,0,0,0,0,0,0,0,0,0,0,0,0,171,1,0,0,0,0,0,0,0,0,0,100
31fed42cb8afee148da17eeeb0a2e858ac9af142,0,0,0,0,0,0,0,0,0,0,0,0,0,0,172,2,0,0,0,0,0,0,0,0,0,100
62b94a582e9c2c52b6ba512304dd36df9897da6a,3,82,9,73,0,0,0,2,10,986,2,3,1.12900232,261,189,3,60,48,12,2784,2212,572,31,26,5,100
2ace5ccff9ee43ab8c23665cf7d713afc3ab9331,1,18,6,12,0,0,0,5,8,328,1,1,0,138,190,4,35,32,3,1186,1092,94,7,6,1,100
2a6b55e1cde25285623af1dd925b3d0b669585aa,0,0,0,0,0,0,0,0,0,0,0,0,0,0,191,5,0,0,0,0,0,0,0,0,0,100
dc3638afacc5b7c9e0f4e3aec775daa064a71a88,0,0,0,0,0,0,0,0,0,0,0,0,0,0,192,6,0,0,0,0,0,0,0,0,0,100
4e532ba536e0af2c5edd3fbe2584c52545afcf96,0,0,0,0,0,0,0,0,0,0,0,0,0,0,9,5,0,0,0,0,0,0,0,0,0,100
f95fda217838bae7d40eb7be62cb20b35db64a0d,6,50,1677,1627,0,0,0,1,11,293,1,2,2.162434849,1404,173,2,19,270,251,814,11253,10439,14,99,85,99.8309253
744d7e373498b5dc83655304c5e0bfe66b8c6585,0,0,0,0,0,0,0,0,0,0,0,0,0,0,0,0,0,0,0,0,0,0,0,0,0,100
f53cfe112513cd4ff37d2d5dbefa6c95973bafde,0,0,0,0,0,0,0,0,0,0,0,0,0,0,30,1,0,0,0,0,0,0,0,0,0,100
f85becc6809858818e074b881f49c5f7f91ac62e,0,0,0,0,0,0,0,0,0,0,0,0,0,0,193,6,0,0,0,0,0,0,0,0,0,100
d3db3eea1e667b144eaf40e8d506ce088a306534,0,0,0,0,0,0,0,0,0,0,0,0,0,0,31,2,0,0,0,0,0,0,0,0,0,100
52d824f3ea1f1de9e371b3d7db89ae1c7f688ae2,1,4,3,1,0,0,0,4,6,843,1,1,0,174,174,3,24,24,0,1329,1317,12,19,19,0,100
048b6899f4cbe1226981fd030cf6890510754406,0,0,0,0,0,0,0,0,0,0,0,0,0,0,32,3,0,0,0,0,0,0,0,0,0,100
f4a9c597f3e254a4a19e663ef2ee47a78a3048bd,0,0,0,0,0,0,0,0,0,0,0,0,0,0,33,4,0,0,0,0,0,0,0,0,0,100
82ceb2ab34bb3a88bbd92b01892019700cf67b80,1,1,1,0,0,0,0,10,41,190,1,1,0,206,175,4,23,23,0,1536,1536,0,14,14,0,100
f689fadc747825d0ffa6d77350cd31e4fe74dd53,2,3,3,0,0,0,0,5,7,1304,1,1,0.918295834,150,1,1,12,12,0,842,830,12,4,4,0,100
abea22627dc67d6dedd513c9000b64e5728aca5e,0,0,0,0,0,0,0,0,0,0,0,0,0,0,176,5,0,0,0,0,0,0,0,0,0,100
2b4fa028bb8621e04b84f411e14b2345877ca73b,0,0,0,0,0,0,0,0,0,0,0,0,0,0,177,6,0,0,0,0,0,0,0,0,0,100
101a9a60f200aef4401fc748adbfef3af8bdd080,0,0,0,0,0,0,0,0,0,0,0,0,0,0,34,4,0,0,0,0,0,0,0,0,0,100
d0261e801739c6bb767176a4d643ab065e4d9996,0,0,0,0,0,0,0,0,0,0,0,0,0,0,35,5,0,0,0,0,0,0,0,0,0,100
2b8bfc2453b9b061d23b710241b041c4571c182c,0,0,0,0,0,0,0,0,0,0,0,0,0,0,36,6,0,0,0,0,0,0,0,0,0,100
2ab6e297ef4f7a4d2d480152424d2670d10395d0,0,0,0,0,0,0,0,0,0,0,0,0,0,0,37,7,0,0,0,0,0,0,0,0,0,100
ebffa7a88cf46103a144baefdd7027b31f4df432,0,0,0,0,0,0,0,0,0,0,0,0,0,0,178,5,0,0,0,0,0,0,0,0,0,100
e58f704e276f6dd736a16a2db74a8fe6a80db1c4,1,1,1,0,0,0,0,7,16,870,1,1,0,79,179,6,6,6,0,573,567,6,3,3,0,100
ebec1e32185bdcc10f48972f791487fe376d4c7b,1,3,1,2,0,0,0,11,31,63,1,1,0,175,2,2,12,12,0,1877,1855,22,4,4,0,100
056dc18c4dfc6e52026dc88a09a6aeb451f003d0,0,0,0,0,0,0,0,0,0,0,0,0,0,0,226,0,0,0,0,0,0,0,0,0,0,100
d8ceebe302ccaafa877d092e5d125e4bdb59b966,1,1,1,0,0,0,0,8,32,734,1,1,0,138,227,1,26,26,0,1123,1123,0,9,9,0,100
5b3171d81667a2ef9431c05e1e4ef56982490bd4,0,0,0,0,0,0,0,0,0,0,0,0,0,0,3,3,0,0,0,0,0,0,0,0,0,100
2e2114f312fbf4d3856c0c4fcdec3ca81de72f07,0,0,0,0,0,0,0,0,0,0,0,0,0,0,194,1,0,0,0,0,0,0,0,0,0,100
4080fe4ce74a7adef18330d4dc49667e5219c2b8,0,0,0,0,0,0,0,0,0,0,0,0,0,0,195,1,0,0,0,0,0,0,0,0,0,100
c1086aa319a1b0fdbe8412cf88c8d67c55cee492,1,0,6,6,0,0,0,4,6,889,1,1,0,105,196,2,13,14,1,905,911,6,7,8,1,100
76d3f74d071a1a3e6b7228edf9b76bf8e448b0cf,5,364,44,320,2,0,2,1,79,438,1,2,1.641346353,520,197,3,116,66,50,5143,3847,1296,32,12,20,99.92311241
5477173c071f3e70493cf36bd85de741998eb17b,1,8,162,154,0,0,0,13,35,214,1,1,0,316,4,2,14,14,0,1608,1608,0,7,7,0,100
0fe6a49d76c237bd831a27f8526c62cf1c7f5cc8,6,222,103,119,0,0,0,5,38,908,2,2,1.770967989,845,198,4,205,188,17,6483,5584,899,117,113,4,99.93852774
d51639d615a0a19575f45188642c6b7a946bb44d,0,0,0,0,0,0,0,0,0,0,0,0,0,0,5,1,0,0,0,0,0,0,0,0,0,100
4538d8f33f01ad7a4541cf2b8bc265049363c644,0,0,0,0,0,0,0,0,0,0,0,0,0,0,6,2,0,0,0,0,0,0,0,0,0,100
ff3b13e5a7d19678260220e18da291a5bd6c311c,0,0,0,0,0,0,0,0,0,0,0,0,0,0,199,5,0,0,0,0,0,0,0,0,0,100
e431289d450baba0f73811335959834b11362a72,0,0,0,0,0,0,0,0,0,0,0,0,0,0,7,3,0,0,0,0,0,0,0,0,0,100
deafc5cc6db3a6c10d21d13a2fa99b6db4e11b83,0,0,0,0,0,0,0,0,0,0,0,0,0,0,180,0,0,0,0,0,0,0,0,0,0,100
678957e64fb937be688c471622877103edb8592a,1,37,32,5,0,0,0,6,13,316,1,1,0,124,181,1,16,15,1,1229,1205,24,5,4,1,100
fa2972607a4ba589a4db42cfafd5293b350f671a,9,45,33,12,0,0,0,5,19,1243,1,3,2.847699038,593,182,2,78,74,4,5101,4843,258,48,47,1,100
28a9e82edfe31cce0300f8ff7be4dd96262ef0a9,1,4,4,0,0,0,0,8,16,0,1,1,0,123,183,3,21,21,0,1286,1286,0,7,7,0,100
0be8a407b1ada018e2f35e93dc7561f1683fe6e2,0,0,0,0,0,0,0,0,0,0,0,0,0,0,200,5,0,0,0,0,0,0,0,0,0,100
94b08db7c444d5a00929e8a52e4359cc029bf237,4,16,26,10,0,0,0,5,20,0,1,2,1.801463832,299,201,6,32,32,0,2332,2332,0,22,22,0,100
28fe00310d0f74a8e5c2350dc7c17bdbcb388fa1,1,2,1,1,0,0,0,5,17,0,1,1,0,141,184,4,11,11,0,1164,1164,0,3,3,0,100
6ed413c9b194a02ccce770922c99a1e9edd41a30,0,0,0,0,0,0,0,0,0,0,0,0,0,0,202,7,0,0,0,0,0,0,0,0,0,100
0c7c65e673848f856aefb22336af8605120c5ae7,5,112,14,98,0,0,0,9,113,443,1,4,1.855098427,756,203,8,81,71,10,6127,5474,653,45,41,4,100
d6a08331597861de59819b0f5b10e68c6dd57113,9,9,5,4,0,0,0,5,80,960,2,4,2.69951385,1051,204,9,122,122,0,9503,9485,18,65,65,0,100
497ac820ac0652031ae62b1ddef3e85f30972072,1,1,0,1,0,0,0,9,48,1168,1,1,0,70,205,10,7,7,0,637,635,2,4,4,0,100
37f28bd6472cd1700ffc16015096a53749e0a09b,2,80,0,80,1,0,1,1,1,0,1,2,0,128,206,11,14,11,3,1571,989,582,7,5,2,98.60601614
7afd9f4cf51c6ebde450d57ad756d7fd7e13b326,5,179,297,118,0,0,0,7,34,869,1,3,1.870259839,988,207,12,119,122,3,7088,7569,481,73,77,4,95.45083084
9f036af1028a8456ef50102222765efabad69f01,5,33,65,32,0,0,0,6,29,682,2,4,1.222255235,959,208,13,144,143,1,7170,7254,84,44,44,0,99.98677249
657803cdb7e8361bf02208ee435d8fbf900b2903,1,7,7,0,0,0,0,5,18,2838,1,1,0,97,185,5,24,24,0,522,521,1,10,10,0,100
fb6408bd207a2a3053aadf1a189dff2310204b27,1,7,7,0,0,0,0,5,19,0,1,1,0,98,186,6,24,24,0,521,522,1,10,10,0,100
69eb75e334907b230edf6d2c7ef12b79c5216de2,1,5,5,0,0,0,0,3,3,3970,1,1,0,25,187,7,5,5,0,124,107,17,5,5,0,100
1a9d87432110ab40723e3e21691a2f8d66a776bf,1,5,5,0,0,0,0,3,4,0,1,1,0,26,188,8,5,5,0,107,124,17,5,5,0,100
1a42d852daa75cf9b6a78013544647be2ec2a8e3,800,0,0,0,0,0,0,1,1,0,1,164,0,70090,10,0,10605,6400,4205,548472,678400,129928,5115,3200,1915,57.14468958
a64100d443edabe608668d4cac9f9fa0221d03af,3,224,0,224,3,0,3,1,1,0,1,1,1.574773933,0,11,1,34,0,34,1223,0,1223,6,0,6,99.90048513
f789bd0de54514e614334b7766f07d4ab5d21129,2,34,32,2,0,0,0,2,2,0,1,1,0.32984607,126,209,11,28,28,0,858,858,0,5,5,0,100
5f070b4312060a04e857386fbaea9a189a5a3727,1,6,4,2,0,0,0,2,2,0,1,1,0,232,210,12,40,40,0,1871,1861,10,19,19,0,100
9a46c29d010c36c090a14aca84d488079eb19247,0,0,0,0,0,0,0,0,0,0,0,0,0,0,211,13,0,0,0,0,0,0,0,0,0,100
b0036a958479599ed15b9f29752d47c33e31b613,0,0,0,0,0,0,0,0,0,0,0,0,0,0,212,14,0,0,0,0,0,0,0,0,0,100
9a5bab5ef9328ec5e527f8dcfe08439d11971058,14,173,206,33,0,0,0,2,2,0,1,5,3.33040107,842,213,15,106,102,4,7441,7528,87,58,59,1,98.90548545
bae0d6e11bc4ac19beebba85b1670dcb4be3e3df,0,0,0,0,0,0,0,0,0,0,0,0,0,0,38,0,0,0,0,0,0,0,0,0,0,100
6731710c30ae09092b058935b416d42b9ce77b11,0,0,0,0,0,0,0,0,0,0,0,0,0,0,214,16,0,0,0,0,0,0,0,0,0,100
b962375718a597b3177217c74f2305f480f3230c,0,0,0,0,0,0,0,0,0,0,0,0,0,0,8,3,0,0,0,0,0,0,0,0,0,100
92fbb7149134b685891965fb5cc5982505d1457e,1,0,3,3,0,0,0,2,2,604,1,1,0,75,215,16,10,10,0,576,576,0,9,9,0,100
19383c24e23ba6a0721e832702255f99610e4ae9,0,0,0,0,0,0,0,0,0,0,0,0,0,0,189,9,0,0,0,0,0,0,0,0,0,100
c383f0b6308d5d11e297eb64be1eb0fc875bea23,1,6,0,6,0,0,0,2,2,23,1,1,0,131,190,10,14,14,0,1158,1158,0,7,7,0,100
3a284f5eb89cf09b61b73cf6ff2711741bbacc7a,6,32,14,18,0,0,0,2,34,702,4,5,2.018870212,893,216,16,85,81,4,8080,7926,154,28,28,0,100
1fb3f6aeed780f0362d63bed0b52a44efcb320bb,9,88,30,58,1,0,1,1,11,467,1,3,2.688755829,680,12,2,67,65,2,5737,5488,249,49,48,1,99.87980769
1570b44019662548936df3d3ac282d6753046f55,0,0,0,0,0,0,0,0,0,0,0,0,0,0,217,17,0,0,0,0,0,0,0,0,0,100
1132b48a540150a251d0d18471c010813e929cb4,0,0,0,0,0,0,0,0,0,0,0,0,0,0,218,18,0,0,0,0,0,0,0,0,0,100
25c9cee1ac3f2d4c3d2c839ddad2caf386b07770,0,0,0,0,0,0,0,0,0,0,0,0,0,0,219,17,0,0,0,0,0,0,0,0,0,100
a47466fbc31df0335b37de2f4d190ea1c9b22fa9,0,0,0,0,0,0,0,0,0,0,0,0,0,0,220,18,0,0,0,0,0,0,0,0,0,100
524fc62e706bc71230860ff52688b2a15f01949b,46,0,7121,7121,0,0,0,2,2,0,1,8,5.08550644,4856,221,19,0,755,755,0,40858,40858,0,245,245,98.59116771
c43287f816aeea6d3aef21046d420a7c0c37e57b,0,0,0,0,0,0,0,0,0,0,0,0,0,0,39,1,0,0,0,0,0,0,0,0,0,100
d141c8e887904122a2b3cb4bf94851e7401d807d,27,276,67,209,0,0,0,2,15,203,2,7,4.307979695,2276,222,8,324,299,25,20368,19035,1333,211,193,18,100
58e6581424438243c5bf670b26d505a9d8175f98,0,0,0,0,0,0,0,0,0,0,0,0,0,0,223,9,0,0,0,0,0,0,0,0,0,100
575f8c2bd491122e777523bde284eeb6def74796,0,0,0,0,0,0,0,0,0,0,0,0,0,0,224,10,0,0,0,0,0,0,0,0,0,100
29e3f2820746f53ceaab2c173c6e48434d59d2c6,0,0,0,0,0,0,0,0,0,0,0,0,0,0,40,1,0,0,0,0,0,0,0,0,0,100
464e8de1f0854e0d84e2b3a4a1320be128f720c9,0,0,0,0,0,0,0,0,0,0,0,0,0,0,225,3,0,0,0,0,0,0,0,0,0,100
d3c09ba44bdaba2fe63a3bf8badd2ea4b9f567b8,2,31,27,4,0,0,0,5,6,1129,1,2,0.992266639,264,226,4,30,31,1,1951,1926,25,8,8,0,100
4f668dba945e2d61d62d37276a1d4a03f3b14276,3,70,20,50,1,0,1,1,2,58,1,2,1.456564762,106,227,5,16,14,2,753,570,183,12,10,2,99.97251237
5b0b559cb9985a10f3a206f4dc557d817bd0d085,6,87,30,57,1,0,1,1,2,70,1,5,2.352694817,945,228,6,124,118,6,7884,7596,288,42,39,3,93.28217977
c1adfe003ce0f50ecf5b429fcbc38277e3b426a1,9,1803,195,1608,5,0,5,1,2,36,1,2,2.336660761,758,229,7,160,125,35,12152,6511,5641,61,48,13,99.81831395
6634aaaf2222de25f855a70963c03f39410ba90a,0,0,0,0,0,0,0,0,0,0,0,0,0,0,82,0,0,0,0,0,0,0,0,0,0,100
bf40156eacda79253142c96ebb856cb68f0d3ca0,0,0,0,0,0,0,0,0,0,0,0,0,0,0,83,1,0,0,0,0,0,0,0,0,0,100
6bda4d73ff5d2b3b4ad4288fb22cde44a2898fe3,0,0,0,0,0,0,0,0,0,0,0,0,0,0,41,0,0,0,0,0,0,0,0,0,0,100
360613f1d6c6b4694d2ac5a229950010ff4eab04,0,0,0,0,0,0,0,0,0,0,0,0,0,0,0,0,0,0,0,0,0,0,0,0,0,100
d850a091d3240f7863c92380fc01624c27f783c4,0,0,0,0,0,0,0,0,0,0,0,0,0,0,2,0,0,0,0,0,0,0,0,0,0,100
299fe6cc217f3d62057a55140a44ada0ce6ea145,3,155,33,122,0,0,0,2,2,102,1,2,1.259960357,413,0,0,98,78,20,4630,3785,845,43,34,9,100
84a4bce9e4a4964d396a4ada3da35df4d842a9fe,2,94,8,86,1,0,1,1,2,52,1,2,0.752212173,153,1,1,28,24,4,1802,1177,625,11,9,2,95.69747899
b59276e9271d4b865331cd192d7a19871847fbb8,0,0,0,0,0,0,0,0,0,0,0,0,0,0,2,2,0,0,0,0,0,0,0,0,0,100
aa0f0f461f6b9ca0186a7e054ec61eee76f396f7,0,0,0,0,0,0,0,0,0,0,0,0,0,0,3,3,0,0,0,0,0,0,0,0,0,100
cb6abe1f9b54e35be1b3189422b91d395f732031,0,0,0,0,0,0,0,0,0,0,0,0,0,0,4,4,0,0,0,0,0,0,0,0,0,100
e8d2617d36d54371701707531756135147aed1b7,0,0,0,0,0,0,0,0,0,0,0,0,0,0,5,5,0,0,0,0,0,0,0,0,0,100
0be2ea46aa3a700e9e863d0c5f75f256ff56641b,1,11,2,9,0,0,0,3,3,8,1,1,0,341,0,0,87,85,2,2766,2722,44,33,33,0,100
5a1c2ccba645ee38bbc3a7c251a470a42194f41e,0,0,0,0,0,0,0,0,0,0,0,0,0,0,1,1,0,0,0,0,0,0,0,0,0,100
8714a0f722663ea5cb16c14c5b8a01e57574cd93,0,0,0,0,0,0,0,0,0,0,0,0,0,0,42,1,0,0,0,0,0,0,0,0,0,100
7423629056bf709be07d0c7bb7d42e0e250f3ad9,0,0,0,0,0,0,0,0,0,0,0,0,0,0,43,2,0,0,0,0,0,0,0,0,0,100
d5c94bdde1ca02bf84fe6a2c5fb28bce5c07309e,0,0,0,0,0,0,0,0,0,0,0,0,0,0,44,3,0,0,0,0,0,0,0,0,0,100
e0751eaaca4bb06adcf80108d85ad0dc6cc67074,6,146,63,83,0,0,0,2,36,191,2,4,2.120249972,865,1,1,124,115,9,7728,7389,339,74,71,3,99.03225806
9d6be1cd3b0a1f6a846e985ece0365b0ba218cdf,0,0,0,0,0,0,0,0,0,0,0,0,0,0,2,2,0,0,0,0,0,0,0,0,0,100
1d1134ee941c6a06804fdb5fef536e3ed95ed36e,0,0,0,0,0,0,0,0,0,0,0,0,0,0,3,3,0,0,0,0,0,0,0,0,0,100
88bddb08ab014df9d1d14b75fc96f6a8380b4545,6,33,122,89,0,0,0,2,37,61,2,3,1.994529249,1028,4,4,120,128,8,8790,9402,612,77,84,7,96.11666667
127bd01344532f2f666335b80450279bb96c45eb,0,0,0,0,0,0,0,0,0,0,0,0,0,0,5,5,0,0,0,0,0,0,0,0,0,100
656878ea69adf7663015156b55ad5c9ea3ec7e4f,0,0,0,0,0,0,0,0,0,0,0,0,0,0,45,4,0,0,0,0,0,0,0,0,0,100
26d3db6ba1f12870af996ef9eaea17dfc4a8b8fb,0,0,0,0,0,0,0,0,0,0,0,0,0,0,46,5,0,0,0,0,0,0,0,0,0,100
9cf90546dfa8bf11c99089a12d70b0272e7da211,0,0,0,0,0,0,0,0,0,0,0,0,0,0,47,6,0,0,0,0,0,0,0,0,0,100
dd78ed9479559cd222f24fa0be57655cf2e3075b,2,244,5,239,0,0,0,2,6,932,1,2,0.663823245,142,228,0,53,24,29,2055,968,1087,36,18,18,99.98329435
0f4f5dec7f3a7de7161d1fabf3e02418099f4446,1,43,0,43,0,0,0,5,19,932,1,1,0,122,229,1,47,38,9,1323,964,359,16,15,1,100
5083f58359dd103ac6d8e72a50c53bb20a5df14e,1,127,0,127,0,0,0,3,6,3028,1,1,0,13,230,2,29,3,26,1231,110,1121,4,1,3,99.93316625
63b765abb305cca6d726f54549a92018754a6348,1,21,14,7,0,0,0,5,20,0,1,1,0,159,231,3,48,47,1,1365,1323,42,16,16,0,100
cc9a70ebbdaceb8d5c2fcecd1a8cd9bee67e323e,0,0,0,0,0,0,0,0,0,0,0,0,0,0,0,0,0,0,0,0,0,0,0,0,0,100
99fd9ba4f9673b2b2d30c2b403aaa294503cc2a2,2,7,6,1,0,0,0,2,6,465,2,2,0.619382195,224,232,4,30,30,0,1583,1577,6,17,17,0,100
a12135b94002367046ef6edc977527d586026689,0,0,0,0,0,0,0,0,0,0,0,0,0,0,1,1,0,0,0,0,0,0,0,0,0,100
0844e69d6cbdc7bbfd54ba01dc9c829764eaeb6d,10,126,45,81,0,0,0,2,21,247,3,9,2.067436753,2442,233,5,514,480,34,18867,18160,707,235,234,1,100
8bcaa77340ac377a20237af4efbe891dc5a4790d,3,36,33,3,0,0,0,6,11,1562,2,3,0.377308401,373,234,6,50,50,0,2646,2639,7,29,29,0,100
fcb436d2a7ed399dd8006b3254e655634000f4a1,1,2,2,0,0,0,0,4,12,0,1,1,0,121,235,7,21,21,0,1041,1041,0,8,8,0,100
d319b325066620a82d079379564188912e8b0b92,0,0,0,0,0,0,0,0,0,0,0,0,0,0,2,2,0,0,0,0,0,0,0,0,0,100
11046fb5273b559298111b201470d80cd6af43d9,0,0,0,0,0,0,0,0,0,0,0,0,0,0,48,6,0,0,0,0,0,0,0,0,0,100
907781bb856b47cb7b180484c6d4b9f55a6df038,2,25,0,25,0,0,0,1,2,736,1,2,0.904381458,104,49,5,21,18,3,1047,858,189,16,13,3,99.94985793
8c529ccff23d419c4cb5191b0435de40d6a9831c,0,0,0,0,0,0,0,0,0,0,0,0,0,0,50,6,0,0,0,0,0,0,0,0,0,100
b044a07797a8fef23d10f10126615c9b7db659bb,0,0,0,0,0,0,0,0,0,0,0,0,0,0,51,6,0,0,0,0,0,0,0,0,0,100
fd7a0bf969e19f069dc97c7d908f9c120c58acdd,0,0,0,0,0,0,0,0,0,0,0,0,0,0,3,3,0,0,0,0,0,0,0,0,0,100
a8e09cd3aa1c9d6fdda2eaf84f86a06a33963658,2,58,21,37,0,0,0,2,3,86,1,1,0.973835482,335,6,0,89,85,4,2673,2395,278,33,28,5,100
b77caec6f1c2b9bb48a619a7680c5a5e351579f8,0,0,0,0,0,0,0,0,0,0,0,0,0,0,4,4,0,0,0,0,0,0,0,0,0,100
c1ca30872c622e513e49fc1bb111bc4b8a527d3b,1,12,1,11,0,0,0,2,2,3077,1,1,0,87,5,5,12,11,1,581,539,42,8,7,1,100
c20eee89c6cc669494cf7edbb80255a83e194a15,1,13,2,11,0,0,0,8,20,749,1,1,0,860,6,6,101,99,2,3988,3949,39,79,78,1,100
6fbf3663b55def1f75fa3bed4690bf9562146921,1,4,5,1,0,0,0,3,8,17,1,1,0,135,236,8,30,30,0,1441,1458,17,5,5,0,100
45d88031c8e782a624eaf6cefea9700600805647,5,78,5,73,0,0,0,8,39,733,1,2,2.187471366,1700,7,1,285,272,13,12107,11711,396,185,178,7,100
3dd18344a47fb86b5127bcf3e051a2eb4e7ca996,0,0,0,0,0,0,0,0,0,0,0,0,0,0,52,4,0,0,0,0,0,0,0,0,0,100
37b85253981770b455bd9936cef23de460662483,0,0,0,0,0,0,0,0,0,0,0,0,0,0,0,0,0,0,0,0,0,0,0,0,0,100
2b65475c3ab682ebd47cffdc6b502698799cd2c8,0,0,0,0,0,0,0,0,0,0,0,0,0,0,7,0,0,0,0,0,0,0,0,0,0,100
638ac8c7f783d30f5a52c62ca50c28cabde454f8,0,0,0,0,0,0,0,0,0,0,0,0,0,0,8,1,0,0,0,0,0,0,0,0,0,100
32badb1d360ddf514e6b253f2dea9ae7e5df078a,0,0,0,0,0,0,0,0,0,0,0,0,0,0,8,1,0,0,0,0,0,0,0,0,0,100
8b2bec7f5e3a0d3500e38bbecbc3db6d08e7435c,0,0,0,0,0,0,0,0,0,0,0,0,0,0,10,3,0,0,0,0,0,0,0,0,0,100
24cb5576f720737b73906ebb15be486d540ac629,0,0,0,0,0,0,0,0,0,0,0,0,0,0,11,4,0,0,0,0,0,0,0,0,0,100
9bfb767323833586873272af4db446f68f357f1f,0,0,0,0,0,0,0,0,0,0,0,0,0,0,12,5,0,0,0,0,0,0,0,0,0,100
63cebf76e9c7746a1851841e37f5873704e086e8,0,0,0,0,0,0,0,0,0,0,0,0,0,0,53,0,0,0,0,0,0,0,0,0,0,100
e4ba7887fc6dbf17c3d73f8d4aa1045eeb48d53e,0,0,0,0,0,0,0,0,0,0,0,0,0,0,54,1,0,0,0,0,0,0,0,0,0,100
25a6fc0967357e6ba4aafcaf11bf3f7faec752fd,0,0,0,0,0,0,0,0,0,0,0,0,0,0,55,2,0,0,0,0,0,0,0,0,0,100
272b1615311c551def0a686a75cc64591b01007e,0,0,0,0,0,0,0,0,0,0,0,0,0,0,56,3,0,0,0,0,0,0,0,0,0,100
dec441fb895c96d1e756619d15d75bba00b10fa3,0,0,0,0,0,0,0,0,0,0,0,0,0,0,57,2,0,0,0,0,0,0,0,0,0,100
c9d978a460203736732af546f8b88120795c5d33,1,62,1,61,0,0,0,5,11,536,1,1,0,141,58,3,31,26,5,993,780,213,17,17,0,100
ccaec1b267d768e890695dd36c49a34d621e1e73,2,66,12,54,0,0,0,2,3,246,1,2,0.73206669,220,0,0,30,25,5,2087,1728,359,11,9,2,100
377dcace16fe4fd77baaab91ad575e9da5c49ac0,2,12,66,54,0,0,0,1,2,43,1,2,0.73206669,263,59,4,25,30,5,1728,2087,359,9,11,2,100
2715ed201b7e6d583ee40e6d262a29a400fd16fb,0,0,0,0,0,0,0,0,0,0,0,0,0,0,60,4,0,0,0,0,0,0,0,0,0,100
846307d5b03ef7df6d3c890f2a291b4c11581e80,0,0,0,0,0,0,0,0,0,0,0,0,0,0,61,5,0,0,0,0,0,0,0,0,0,100
e7f247d8ee25cf59ca0d58dc426edfee62e3613f,0,0,0,0,0,0,0,0,0,0,0,0,0,0,62,5,0,0,0,0,0,0,0,0,0,100
56a2305ed14a3f4706b10c394a27d3429c2103b4,0,0,0,0,0,0,0,0,0,0,0,0,0,0,63,6,0,0,0,0,0,0,0,0,0,100
66f164057e322d2e63ea02c35c9e30c3969e80b1,0,0,0,0,0,0,0,0,0,0,0,0,0,0,64,7,0,0,0,0,0,0,0,0,0,100
e5bc885fdb4492a6d54232cea6c7e8e0abd4080d,0,0,0,0,0,0,0,0,0,0,0,0,0,0,65,6,0,0,0,0,0,0,0,0,0,100
7a50a291b4598e9809f9acf609b92175ce7f953b,0,0,0,0,0,0,0,0,0,0,0,0,0,0,66,7,0,0,0,0,0,0,0,0,0,100
00c0149b95d3621ed5991578ac534ba5fdf5ac02,0,0,0,0,0,0,0,0,0,0,0,0,0,0,67,8,0,0,0,0,0,0,0,0,0,100
a80974037853c5227f9e5ef1c384a1fca134746e,0,0,0,0,0,0,0,0,0,0,0,0,0,0,13,0,0,0,0,0,0,0,0,0,0,100
ee6359f621b508ab7f21df0316941e68c75eb3e5,0,0,0,0,0,0,0,0,0,0,0,0,0,0,68,9,0,0,0,0,0,0,0,0,0,100
b447f3fd07eafa36440dc4347e8514a15501e3c2,0,0,0,0,0,0,0,0,0,0,0,0,0,0,14,1,0,0,0,0,0,0,0,0,0,100
a70f48537524bdaa92178bf539bf84aad501c80d,0,0,0,0,0,0,0,0,0,0,0,0,0,0,15,2,0,0,0,0,0,0,0,0,0,100
a6c8346ddb82390e2f5b5bd8c5968c436264e8a6,0,0,0,0,0,0,0,0,0,0,0,0,0,0,69,4,0,0,0,0,0,0,0,0,0,100
4bac5c295b3b820a6e7f25e4dcf5a843b7d1983e,0,0,0,0,0,0,0,0,0,0,0,0,0,0,70,5,0,0,0,0,0,0,0,0,0,100
25c9ed0ebeb34a3ef43a48fa47ea0340a049aac0,0,0,0,0,0,0,0,0,0,0,0,0,0,0,71,6,0,0,0,0,0,0,0,0,0,100
8d6ac39fc08d11d84a0c37bf81d8af5d6d7fe234,0,0,0,0,0,0,0,0,0,0,0,0,0,0,72,7,0,0,0,0,0,0,0,0,0,100
445c1e3f743e687e874353b054c98253475d3413,0,0,0,0,0,0,0,0,0,0,0,0,0,0,73,8,0,0,0,0,0,0,0,0,0,100
c6ee8cbcdb6ae205624b908bc16ae462515c98e6,0,0,0,0,0,0,0,0,0,0,0,0,0,0,74,9,0,0,0,0,0,0,0,0,0,100
85a098a364d467616394cd76d186d44f5f49a227,0,0,0,0,0,0,0,0,0,0,0,0,0,0,75,10,0,0,0,0,0,0,0,0,0,100
656225c67fb5cc5d232ac77a4201ecd2f1136805,0,0,0,0,0,0,0,0,0,0,0,0,0,0,76,8,0,0,0,0,0,0,0,0,0,100
336f0e7dba88253838397dc2c579d5a6a472870f,0,0,0,0,0,0,0,0,0,0,0,0,0,0,77,8,0,0,0,0,0,0,0,0,0,100
74c10743dfaa3d00b7cea1b89a0432173187866c,0,0,0,0,0,0,0,0,0,0,0,0,0,0,78,9,0,0,0,0,0,0,0,0,0,100
f870a630291bd9d623b32c21f087ba19e69eb1fc,20,1902,0,1902,20,0,20,1,1,0,1,3,4.081148906,0,0,0,192,0,192,9556,0,9556,49,0,49,99.28630705
c96498680df551f2cbd2a4735d9408044a0c7bc3,13,29,44,15,0,0,0,1,2,0,1,2,2.664733923,1191,1,1,144,144,0,7262,7387,125,31,31,0,99.86818257
91f15ecfe5d26de36d8e9bcd6cf109b307882a32,8,115,55,60,0,0,0,2,5,585,3,8,2.283076611,836,0,0,122,116,6,7775,7400,375,48,48,0,100
149c98592fe447c98dfb5afc67b5809725cc3056,0,0,0,0,0,0,0,0,0,0,0,0,0,0,16,0,0,0,0,0,0,0,0,0,0,100
03a5bb61ed56daccd207d7a255956e21612cf995,12,16,16,0,0,0,0,1,3,0,1,1,3.27439747,773,2,2,75,75,0,4329,4329,0,16,16,0,100
6dd0c92ddb9dad2627e9ca5e28118865d6fba159,2,58,11,47,0,0,0,6,7,306,1,2,0.918295834,265,3,3,39,30,9,2172,1951,221,9,8,1,100
d9e26c64d620d723c94386e1a5ef9e70588c31a3,0,0,0,0,0,0,0,0,0,0,0,0,0,0,1,1,0,0,0,0,0,0,0,0,0,100
e24c4afb699c2930d372c701fe2de874a2a2f6c0,0,0,0,0,0,0,0,0,0,0,0,0,0,0,17,1,0,0,0,0,0,0,0,0,0,100
2d1b0bf632724ceb091035582274201269cfe3e3,20,607,306,301,0,0,0,1,4,20,1,3,3.878488962,1629,4,4,192,192,0,9465,9431,34,49,49,0,100
034afd61126660b6f44b232fdf3e1dd9d1a79708,0,0,0,0,0,0,0,0,0,0,0,0,0,0,5,0,0,0,0,0,0,0,0,0,0,100
3c88f50432dc8dd70ab7eb03e1bbf419f3f7ab81,0,0,0,0,0,0,0,0,0,0,0,0,0,0,79,0,0,0,0,0,0,0,0,0,0,100
c34e8a84c39b7bd2175cdbcb8583d487548a34b4,0,0,0,0,0,0,0,0,0,0,0,0,0,0,6,1,0,0,0,0,0,0,0,0,0,100
61c9e1a92975de5891f082068fb708dc30cfafa1,0,0,0,0,0,0,0,0,0,0,0,0,0,0,7,2,0,0,0,0,0,0,0,0,0,100
4e6577d140c203eae0b634764971bf2444438f41,0,0,0,0,0,0,0,0,0,0,0,0,0,0,8,3,0,0,0,0,0,0,0,0,0,100
666d314fb8d9f466a5496a143d73d55036aea619,0,0,0,0,0,0,0,0,0,0,0,0,0,0,18,0,0,0,0,0,0,0,0,0,0,100
6651a328679742ce6c14ce8a4e6ab0bc0a05f7e9,0,0,0,0,0,0,0,0,0,0,0,0,0,0,19,1,0,0,0,0,0,0,0,0,0,100
c1a10d9b5a62036cbfc93a775a3817f69a85bf6e,0,0,0,0,0,0,0,0,0,0,0,0,0,0,20,1,0,0,0,0,0,0,0,0,0,100
f1095d8c30d33e0e86e691f797d13c6f7bc11c4c,0,0,0,0,0,0,0,0,0,0,0,0,0,0,0,0,0,0,0,0,0,0,0,0,0,100
379863d8f9dff8c0a42c341c68044c9c52b597e0,1,2,2,0,0,0,0,3,4,1544,1,1,0,82,2,0,6,6,0,633,628,5,4,4,0,100
6530e8144f9638932092d65bbdc72faf0fc840cd,1,1,1,0,0,0,0,3,5,28,1,1,0,82,3,1,6,6,0,628,633,5,4,4,0,100
ae1808be0e76c15544e75ec54aae3fc720f65364,0,0,0,0,0,0,0,0,0,0,0,0,0,0,21,0,0,0,0,0,0,0,0,0,0,100
310534319ae8df4cd95c3ff044afb6afdaee2605,2,3,4,1,0,0,0,3,4,472,2,2,0.863120569,312,9,0,49,49,0,2710,2710,0,18,18,0,100
0f037cb03e77c09627c36962600e4fb00c4013c8,0,0,0,0,0,0,0,0,0,0,0,0,0,0,10,1,0,0,0,0,0,0,0,0,0,100
d0f64205a116853aa471dd1361a635167da15fcc,0,0,0,0,0,0,0,0,0,0,0,0,0,0,22,0,0,0,0,0,0,0,0,0,0,100
c3936fd3820fe4fb6cdd1cba7944f016dc0d5e13,1,4,5,1,0,0,0,1,5,39,1,1,0,229,11,2,42,43,1,1754,1769,15,12,12,0,100
1ca1ef32483f35014cdd96596c454cafe83c34f3,0,0,0,0,0,0,0,0,0,0,0,0,0,0,12,0,0,0,0,0,0,0,0,0,0,100
e005b28b263ce5eeab6f105ead660a3fe89cb756,0,0,0,0,0,0,0,0,0,0,0,0,0,0,23,0,0,0,0,0,0,0,0,0,0,100
0c672bbcd95b8f757d7faccc09d980c62576f41c,0,0,0,0,0,0,0,0,0,0,0,0,0,0,80,0,0,0,0,0,0,0,0,0,0,100
901ef03b4c7f7da96452fbd08018b32ef2341fe0,0,0,0,0,0,0,0,0,0,0,0,0,0,0,81,1,0,0,0,0,0,0,0,0,0,100
463989272b4219716ca692cb4f9b757076d5c690,0,0,0,0,0,0,0,0,0,0,0,0,0,0,24,1,0,0,0,0,0,0,0,0,0,100
fde08a9a57af94511fddc501dcff09fbd7825d48,0,0,0,0,0,0,0,0,0,0,0,0,0,0,82,2,0,0,0,0,0,0,0,0,0,100
43bea68f363143d87f567eedff147460db5bd146,0,0,0,0,0,0,0,0,0,0,0,0,0,0,25,1,0,0,0,0,0,0,0,0,0,100
15ee1951d1ba8d8ee7d24e2510af187fd984c8cf,0,0,0,0,0,0,0,0,0,0,0,0,0,0,26,2,0,0,0,0,0,0,0,0,0,100
b0ee8e2657a900315140d21205416338cc955864,0,0,0,0,0,0,0,0,0,0,0,0,0,0,27,3,0,0,0,0,0,0,0,0,0,100
d5ea1f1be4d8ee6e3ceb7863322921c331a6c0a2,0,0,0,0,0,0,0,0,0,0,0,0,0,0,13,0,0,0,0,0,0,0,0,0,0,100
9b169e7e710f1a4883a15b652ad8ece86a88960f,0,0,0,0,0,0,0,0,0,0,0,0,0,0,14,1,0,0,0,0,0,0,0,0,0,100
ec8a5a006385c0ecf25f1d982ace83bb3c41e052,1,1,1,0,0,0,0,2,2,1018,1,1,0,266,4,0,24,24,0,2099,2092,7,8,8,0,100
87c15bea46081baab98db9a0dbd480c5dac5ceb4,131,322,431,109,0,0,0,3,30,1123,3,65,6.319077755,20005,5,1,3193,3219,26,152024,152860,836,1246,1246,0,100
7476e35535b062e5ce883dfb1125001c2cf58a16,0,0,0,0,0,0,0,0,0,0,0,0,0,0,6,2,0,0,0,0,0,0,0,0,0,100
4d3a3863552e23c4aaafd82545222b0e6a3cd1fd,0,0,0,0,0,0,0,0,0,0,0,0,0,0,7,3,0,0,0,0,0,0,0,0,0,100
47790146ab93f742eb987f751e40645dfd530b37,0,0,0,0,0,0,0,0,0,0,0,0,0,0,0,0,0,0,0,0,0,0,0,0,0,100
c7241d5875a933a0b58cab0ceecb8962625040b7,2,15,27,12,0,0,0,2,17,1205,2,2,0.998363673,366,1,1,28,28,0,3731,3814,83,12,12,0,100
b58df10f4c822ae989bb436734880940e9063fde,0,0,0,0,0,0,0,0,0,0,0,0,0,0,2,2,0,0,0,0,0,0,0,0,0,100
9f4abbd96bc03ec5b76ed6a67a661904051cea50,0,0,0,0,0,0,0,0,0,0,0,0,0,0,3,3,0,0,0,0,0,0,0,0,0,100
f5f54a1560c708913c30d460bec361eb71ab0bd7,15,22,23,1,0,0,0,2,6,576,1,2,3.797082818,1055,4,4,138,138,0,6993,7004,11,37,37,0,100
eeca175c3a838a8aaa821cbbcd8d0376bd17939d,1,27,19,8,0,0,0,4,5,906,1,1,0,112,8,4,15,13,2,994,932,62,5,5,0,100
4de8c58624556983a6745a8841c50fb2a380e0b5,1,0,1,1,0,0,0,4,6,0,1,1,0,120,9,5,15,15,0,994,994,0,5,5,0,100
af0db6ed86dc50ac428d3b60b828f585aed7ca9c,0,0,0,0,0,0,0,0,0,0,0,0,0,0,6,0,0,0,0,0,0,0,0,0,0,100
cc361cb7b6588601b63ce23b5e6a984d997e8453,0,0,0,0,0,0,0,0,0,0,0,0,0,0,10,6,0,0,0,0,0,0,0,0,0,100
6cf991c60ac73dbd32b26d8ea0b773ac07d16193,0,0,0,0,0,0,0,0,0,0,0,0,0,0,5,5,0,0,0,0,0,0,0,0,0,100
205896fde04baa774f77703c5867f09b20895e6b,0,0,0,0,0,0,0,0,0,0,0,0,0,0,6,6,0,0,0,0,0,0,0,0,0,100
089275713f5f49499d939569fd9929f2f50ce1f3,0,0,0,0,0,0,0,0,0,0,0,0,0,0,7,7,0,0,0,0,0,0,0,0,0,100
e5dca85992d32133c54f2f9dca668abce2eb923f,0,0,0,0,0,0,0,0,0,0,0,0,0,0,15,0,0,0,0,0,0,0,0,0,0,100
4b1c133325da0119e693b69811a54a16cd77aa55,3,49,98,49,0,0,0,2,29,1320,2,2,1.258776696,509,11,7,47,49,2,4467,4867,400,26,26,0,95.58612783
1f17d23f6095e67a2f8d188f4817e286cf916e98,2,66,12,54,0,0,0,2,5,153,1,2,0.73206669,220,7,1,30,25,5,2086,1727,359,11,9,2,100
91c1626df337900051ead7019f70bd15fe93f6a7,0,0,0,0,0,0,0,0,0,0,0,0,0,0,8,2,0,0,0,0,0,0,0,0,0,100
d5d8de1857d60b7b53b9baf0af6e7aea26bbde19,0,0,0,0,0,0,0,0,0,0,0,0,0,0,16,1,0,0,0,0,0,0,0,0,0,100
edec611f07d4e7a352a3332af271207652caab02,0,0,0,0,0,0,0,0,0,0,0,0,0,0,17,2,0,0,0,0,0,0,0,0,0,100
5624a96c6da94ad1c95077dbbdab71409d85770c,2,5,11,6,0,0,0,2,3,526,1,2,1,222,12,8,19,19,0,1721,1759,38,7,7,0,100
57429b176a94514acce5f6985a1299fccb8d115f,1,1,1,0,0,0,0,2,2,1036,1,1,0,18,13,9,3,3,0,180,180,0,3,3,0,100
c0f44b79ff735d8e9e95af46bbd6afcdb97cfe65,3,12,6,6,0,0,0,2,2,339,1,3,1.392147224,234,9,3,22,22,0,1939,1901,38,10,10,0,100
312c714329135573bf83db00db58d8c8b84133e1,3,6,12,6,0,0,0,2,3,695,1,3,1.392147224,240,10,4,22,22,0,1901,1939,38,10,10,0,100
0853c069f87e7e93a74edd79487c51b945187c73,0,0,0,0,0,0,0,0,0,0,0,0,0,0,11,5,0,0,0,0,0,0,0,0,0,100
b988c493b562ceeaa5f82027f108c67d06c1fc19,771,62,62,0,0,0,0,1,31,0,4,162,2.982677092,68909,28,0,10283,6374,3909,531081,656315,125234,5023,3128,1895,55.28705331
34800682e119975183b3f24c20366acf692d128d,0,0,0,0,0,0,0,0,0,0,0,0,0,0,29,1,0,0,0,0,0,0,0,0,0,100
3eb9fdf923e60c9df4a87b7f691d9a468692beb8,0,0,0,0,0,0,0,0,0,0,0,0,0,0,18,3,0,0,0,0,0,0,0,0,0,100
441460e77cd38acc684cb2351dad5f0e6156c1f0,0,0,0,0,0,0,0,0,0,0,0,0,0,0,19,4,0,0,0,0,0,0,0,0,0,100
adb0955f549dfa8f427ddb8273dd2f9d1f23a6c2,0,0,0,0,0,0,0,0,0,0,0,0,0,0,8,8,0,0,0,0,0,0,0,0,0,100
6604f1d9f636bf331ac70077be557e75d3b035d9,0,0,0,0,0,0,0,0,0,0,0,0,0,0,9,9,0,0,0,0,0,0,0,0,0,100
a4f24dda8f30745e1989da7f0e1cb6baaf82cc80,2,3,3,0,0,0,0,2,16,0,2,2,0.918295834,638,10,10,128,128,0,4366,4362,4,46,46,0,100
5e07c8646f46ce55400094c3ab817a87fbf3d5b5,0,0,0,0,0,0,0,0,0,0,0,0,0,0,11,11,0,0,0,0,0,0,0,0,0,100
260753fdb9cc2b17a3e4dbf373e79c3de4887654,0,0,0,0,0,0,0,0,0,0,0,0,0,0,20,5,0,0,0,0,0,0,0,0,0,100
5197ac9e8393763dd4ed58f5f1e9f167e75d3078,2,37,2,35,0,0,0,2,7,326,1,1,0.291818257,424,21,6,82,76,6,3472,3201,271,18,16,2,100
16aeaba993556767c95a4cd59540f1d3b6992772,4,4,0,4,0,0,0,2,33,504,2,2,2,635,22,7,93,93,0,4887,4879,8,49,49,0,100
3aefb18d73e2df241f38a06d69b001f1669c1d8e,0,0,0,0,0,0,0,0,0,0,0,0,0,0,12,6,0,0,0,0,0,0,0,0,0,100
6874995394596eb192c37a066dd750d87e602c0a,0,0,0,0,0,0,0,0,0,0,0,0,0,0,13,7,0,0,0,0,0,0,0,0,0,100
896a6ed07b3be65c8a59bfa7a2dff11bbdd2f909,0,0,0,0,0,0,0,0,0,0,0,0,0,0,23,8,0,0,0,0,0,0,0,0,0,100
2b5584bbcfa95094421b637786e1885a716f07f6,0,0,0,0,0,0,0,0,0,0,0,0,0,0,24,9,0,0,0,0,0,0,0,0,0,100
736721e0eb655c0af8c836475a6f7cc9c36a80fe,0,0,0,0,0,0,0,0,0,0,0,0,0,0,25,10,0,0,0,0,0,0,0,0,0,100
d1583664215742083099465c51e877fcb8369e46,0,0,0,0,0,0,0,0,0,0,0,0,0,0,14,10,0,0,0,0,0,0,0,0,0,100
1748916497e805f7fce21b9aee70e31760b50a27,0,0,0,0,0,0,0,0,0,0,0,0,0,0,15,11,0,0,0,0,0,0,0,0,0,100
94f5464b3f42be3164061030d352ffcfc78be711,1,1,2,1,0,0,0,4,10,1149,1,1,0,57,16,12,9,9,0,223,231,8,9,9,0,100
2ff34a0ed3a1d35d5fdeef6cdc1f576931104b8a,1,1,1,0,0,0,0,2,2,7,1,1,0,63,17,13,9,9,0,445,451,6,4,4,0,100
d19ee0d47a2ba44a7ff0f60998e0e0c42c4224a6,0,0,0,0,0,0,0,0,0,0,0,0,0,0,18,14,0,0,0,0,0,0,0,0,0,100
eb77ce6e6dd546d9389fd105e47c4883bd943879,0,0,0,0,0,0,0,0,0,0,0,0,0,0,19,15,0,0,0,0,0,0,0,0,0,100
1bcda32146713144eac4889c3065c448417c36f6,0,0,0,0,0,0,0,0,0,0,0,0,0,0,26,11,0,0,0,0,0,0,0,0,0,100
88520fb1b54953967f4d7e299cfd772f4357c768,2,9,18,9,0,0,0,2,2,8,1,2,0.605186577,249,27,12,15,17,2,2006,2110,104,7,7,0,100
4ef9d31ff253aeed9795379d440f8f1439651acc,38,357,456,99,0,0,0,2,35,1329,3,18,4.738277655,5018,20,16,660,661,1,37850,38471,621,231,231,0,100
3a476e44f73f02ec986bee373c7632c109f2bc69,0,0,0,0,0,0,0,0,0,0,0,0,0,0,21,17,0,0,0,0,0,0,0,0,0,100
d8e0568e7ff45e5fcbccf4a5aaa2df6059c4aade,1,47,47,0,0,0,0,2,2,11,1,1,0,156,22,18,12,12,0,1156,1083,73,6,6,0,100
cd366d17e1d9b4c001b0ffa08864e1ad5d21034d,2,32,16,16,0,0,0,2,2,10,1,2,0.69621226,205,23,19,29,28,1,1955,1795,160,12,11,1,100
9b6b2361ec0a4eacfb3700d123e02ccb6291f796,2,16,14,2,0,0,0,2,3,0,1,2,0.468995594,216,24,20,29,29,0,1983,1955,28,12,12,0,100
1be5a00c809fe0c7d26fcad24536428b5f0b564e,0,0,0,0,0,0,0,0,0,0,0,0,0,0,28,13,0,0,0,0,0,0,0,0,0,100
355418e32e737fe66b18e81759461cceaff5392c,0,0,0,0,0,0,0,0,0,0,0,0,0,0,25,21,0,0,0,0,0,0,0,0,0,100
53e5adac2f24da4ff9f3276c73e89c2b14e03916,7,23,6,17,0,0,0,2,6,346,2,2,2.685783807,1061,29,14,143,143,0,8122,8108,14,64,64,0,100
85f9ece660407fe68ad61560ebd723a57ec761e6,172,1055,1487,432,0,0,0,2,38,579,3,75,6.828759562,26448,26,22,4219,4222,3,207095,209038,1943,1717,1717,0,100
8a1978a753192a82f602f3d791ed9946cc7bcf08,1,1,1,0,0,0,0,4,11,5,1,1,0,56,27,23,9,9,0,223,223,0,9,9,0,100
30fe6cc83f83578c922d8c01742ae7a6939280e8,0,0,0,0,0,0,0,0,0,0,0,0,0,0,30,15,0,0,0,0,0,0,0,0,0,100
ebb39fe4ae917188b7a1ac235fd8d04e30c92cba,0,0,0,0,0,0,0,0,0,0,0,0,0,0,31,16,0,0,0,0,0,0,0,0,0,100
97a920f72c6655a615522272b752e6d0cbc1d429,0,0,0,0,0,0,0,0,0,0,0,0,0,0,30,2,0,0,0,0,0,0,0,0,0,100
d67a1d034fca4b70299c4bbc1ed77e38c7d00841,0,0,0,0,0,0,0,0,0,0,0,0,0,0,32,17,0,0,0,0,0,0,0,0,0,100
4cff54295d9e494eaff46a190b73bcb8d491f7e5,25,102,483,381,0,0,0,2,16,97,3,11,2.614192164,2552,28,24,316,370,54,16364,18101,1737,151,182,31,99.93063985
44a9849c075f42f5d1029d604a64a72b7415a0b4,0,0,0,0,0,0,0,0,0,0,0,0,0,0,31,3,0,0,0,0,0,0,0,0,0,100
c70d708f2c11ff9fd5974d0c124a9f56790df428,0,0,0,0,0,0,0,0,0,0,0,0,0,0,14,8,0,0,0,0,0,0,0,0,0,100
db624ef35c8174e9bd5a9f63f9e2957e8bd594b8,25,482,101,381,1,0,1,3,17,0,3,11,2.605033292,2278,15,9,370,316,54,18101,16364,1737,182,151,31,99.93063985
a551b15e2b88b32e12860f8c01e59a8999700d14,0,0,0,0,0,0,0,0,0,0,0,0,0,0,15,9,0,0,0,0,0,0,0,0,0,100
92bdcf8e0f74cf8e4da858156602e658bfbe0c70,0,0,0,0,0,0,0,0,0,0,0,0,0,0,17,11,0,0,0,0,0,0,0,0,0,100
670a7d219e4eab8c7735083d52cefa13e81197fb,21,63,446,383,0,0,0,3,18,92,3,13,2.02586362,2522,29,25,327,381,54,18955,20631,1676,128,159,31,99.93063985
f63ee5fdde0f35ecd5a851c9122f5195befc9348,0,0,0,0,0,0,0,0,0,0,0,0,0,0,18,12,0,0,0,0,0,0,0,0,0,100
33263f68c8157a63734f445669f34c326edec2d3,0,0,0,0,0,0,0,0,0,0,0,0,0,0,30,26,0,0,0,0,0,0,0,0,0,100
2b6c17fa0b067299eccc1365512465edcbf5f155,0,0,0,0,0,0,0,0,0,0,0,0,0,0,31,27,0,0,0,0,0,0,0,0,0,100
c203c97b498a0add45ed0f213e76dddb20e33652,0,0,0,0,0,0,0,0,0,0,0,0,0,0,32,28,0,0,0,0,0,0,0,0,0,100
f66ce94a9f809f910eae65347a7d25f6e6fd4241,0,0,0,0,0,0,0,0,0,0,0,0,0,0,32,4,0,0,0,0,0,0,0,0,0,100
5e41bc096444fb4d04a88e47200e4d50c406621d,0,0,0,0,0,0,0,0,0,0,0,0,0,0,33,29,0,0,0,0,0,0,0,0,0,100
27ff9df077fd498edcb5e92946be0d5041f755dd,0,0,0,0,0,0,0,0,0,0,0,0,0,0,19,13,0,0,0,0,0,0,0,0,0,100
daad3a4ce618cbd05be468c4ce6e451618f3a028,0,0,0,0,0,0,0,0,0,0,0,0,0,0,20,14,0,0,0,0,0,0,0,0,0,100
37b82124faf98dda5ef9f350f64477570a3bc804,0,0,0,0,0,0,0,0,0,0,0,0,0,0,21,15,0,0,0,0,0,0,0,0,0,100
be5a05d126e5bf275c4bd1766962493f1c8ac342,1,10,0,10,0,0,0,6,19,6,1,1,0,117,34,27,37,35,2,991,911,80,15,14,1,100
628b1302f273accf53b2d91e6f7ac90e20c4102f,0,0,0,0,0,0,0,0,0,0,0,0,0,0,35,27,0,0,0,0,0,0,0,0,0,100
c58d65d78ff349968fe9b8d8e758659fcfc001c5,0,0,0,0,0,0,0,0,0,0,0,0,0,0,33,18,0,0,0,0,0,0,0,0,0,100
77ed7bb54982d2a81e085c0689a95d4902b03960,0,0,0,0,0,0,0,0,0,0,0,0,0,0,34,19,0,0,0,0,0,0,0,0,0,100
b5c63caf99934b1a602e64e0906a2c97b033b025,0,0,0,0,0,0,0,0,0,0,0,0,0,0,22,16,0,0,0,0,0,0,0,0,0,100
864ba1aea23ece6491acff38adab0cd1b0d29354,21,446,63,383,1,0,1,3,19,0,3,13,2.02586362,2247,23,17,381,327,54,20631,18955,1676,159,128,31,99.93063985
4325123cc97770e242e10061478834bf5474ccf8,0,0,0,0,0,0,0,0,0,0,0,0,0,0,35,20,0,0,0,0,0,0,0,0,0,100
3ecf5f825ca0255cdedaf085326c602e3b404b5e,0,0,0,0,0,0,0,0,0,0,0,0,0,0,36,21,0,0,0,0,0,0,0,0,0,100
c7867d52248ffe0fc4aac073dbb03dbc214d0fae,0,0,0,0,0,0,0,0,0,0,0,0,0,0,36,28,0,0,0,0,0,0,0,0,0,100
f7921f4fb50030f2a84913b080e335a2d7eb30a5,0,0,0,0,0,0,0,0,0,0,0,0,0,0,33,5,0,0,0,0,0,0,0,0,0,100
ac021efa45e4706ceb309f6cb578c1d6910daea2,0,0,0,0,0,0,0,0,0,0,0,0,0,0,12,7,0,0,0,0,0,0,0,0,0,100
cb9be1dae4352c2cfacf9b4732e8065c062a9230,0,0,0,0,0,0,0,0,0,0,0,0,0,0,37,29,0,0,0,0,0,0,0,0,0,100
f208b8a4a899fbf5ca8646cddf8960f8d5ee3c88,0,0,0,0,0,0,0,0,0,0,0,0,0,0,38,30,0,0,0,0,0,0,0,0,0,100
94cb88cad4ef7f0d06895ed8e85db3fcaf1c8656,0,0,0,0,0,0,0,0,0,0,0,0,0,0,39,31,0,0,0,0,0,0,0,0,0,100
50357a4f48a8307bd1b84858dda5765f70940b94,0,0,0,0,0,0,0,0,0,0,0,0,0,0,37,22,0,0,0,0,0,0,0,0,0,100
8f46ac3e7d664219e8a3cf1e7a2cbf833aec7f47,0,0,0,0,0,0,0,0,0,0,0,0,0,0,40,32,0,0,0,0,0,0,0,0,0,100
b7dc3a53af3250123f8ef82e3f259657991dfaa9,0,0,0,0,0,0,0,0,0,0,0,0,0,0,38,23,0,0,0,0,0,0,0,0,0,100
fa758ce77db00b3518a680516fe07afb58a3979e,0,0,0,0,0,0,0,0,0,0,0,0,0,0,41,33,0,0,0,0,0,0,0,0,0,100
dc6bf103f583bf8ab78f73aa5b6183042aa73022,0,0,0,0,0,0,0,0,0,0,0,0,0,0,42,34,0,0,0,0,0,0,0,0,0,100
05fea2a13d0291917ed9605d563c899bc2ce04a9,0,0,0,0,0,0,0,0,0,0,0,0,0,0,43,35,0,0,0,0,0,0,0,0,0,100
5fdd30c3cd448fe23affcf0466d5761f146573e0,0,0,0,0,0,0,0,0,0,0,0,0,0,0,44,36,0,0,0,0,0,0,0,0,0,100
fb9a7c3d0ed9b4c348d2945766e8546f560eacdd,0,0,0,0,0,0,0,0,0,0,0,0,0,0,13,8,0,0,0,0,0,0,0,0,0,100
f96a86130094ba0813a1b1037481ca021f7ec17e,0,0,0,0,0,0,0,0,0,0,0,0,0,0,39,24,0,0,0,0,0,0,0,0,0,100
fb30375e40062ff9b85357857d0e09dc38da25fc,0,0,0,0,0,0,0,0,0,0,0,0,0,0,14,9,0,0,0,0,0,0,0,0,0,100
ec0f0163d472fdaeee99088fcbb3e0b967655bec,0,0,0,0,0,0,0,0,0,0,0,0,0,0,24,18,0,0,0,0,0,0,0,0,0,100
8439846c99c2c81dde6a03eb40105ea908555943,0,0,0,0,0,0,0,0,0,0,0,0,0,0,39,24,0,0,0,0,0,0,0,0,0,100
832b08c40752b58a98e1a89891a1e0ff54094910,0,0,0,0,0,0,0,0,0,0,0,0,0,0,45,37,0,0,0,0,0,0,0,0,0,100
d8661ff23ce941ee601eaf206a7f3818df62bb73,0,0,0,0,0,0,0,0,0,0,0,0,0,0,46,38,0,0,0,0,0,0,0,0,0,100
dfb444682350572379fea26535e44b12e6df5d68,0,0,0,0,0,0,0,0,0,0,0,0,0,0,25,19,0,0,0,0,0,0,0,0,0,100
62bff72905aa040c27eb5d021a245acd3d87d89d,0,0,0,0,0,0,0,0,0,0,0,0,0,0,47,37,0,0,0,0,0,0,0,0,0,100
9cb1756c6672ba7ae2cbf0ae31b66c30bb03e898,0,0,0,0,0,0,0,0,0,0,0,0,0,0,15,7,0,0,0,0,0,0,0,0,0,100
4a02b701e246590a09ac1428b0fed717187815a6,0,0,0,0,0,0,0,0,0,0,0,0,0,0,16,8,0,0,0,0,0,0,0,0,0,100
f758919621902a4f6622e9dc8b70f2db0c74679e,0,0,0,0,0,0,0,0,0,0,0,0,0,0,17,9,0,0,0,0,0,0,0,0,0,100
f635f6a7665bd25f61f0b2d02e8d0c55683ddd85,0,0,0,0,0,0,0,0,0,0,0,0,0,0,18,10,0,0,0,0,0,0,0,0,0,100
ad6885bebc7f75765e45906cfc058d7caa675d64,0,0,0,0,0,0,0,0,0,0,0,0,0,0,26,17,0,0,0,0,0,0,0,0,0,100
63e82ea2705b15f3de3e98936ca7581278f6353e,0,0,0,0,0,0,0,0,0,0,0,0,0,0,19,11,0,0,0,0,0,0,0,0,0,100
f7b69fabf1253b5e735e269c9410459d91816cdd,0,0,0,0,0,0,0,0,0,0,0,0,0,0,20,12,0,0,0,0,0,0,0,0,0,100
ef6d93a34035c848335af57289c2c0acb58a2e4a,0,0,0,0,0,0,0,0,0,0,0,0,0,0,21,13,0,0,0,0,0,0,0,0,0,100
3e392104be322217b37502670f75e7adbd68e093,0,0,0,0,0,0,0,0,0,0,0,0,0,0,48,34,0,0,0,0,0,0,0,0,0,100
435dd49eb2ff7f02461987e4e69dcbddecf9da9a,0,0,0,0,0,0,0,0,0,0,0,0,0,0,40,17,0,0,0,0,0,0,0,0,0,100
8be44ab3bb5e92c664203d0974bbfc2379496281,1,5,0,5,0,0,0,2,3,943,1,1,0,49,41,8,12,11,1,309,297,12,11,10,1,100
6a3f93e6f695d12f63ef48c5e33f0d24658bd596,3,53,11,42,0,0,0,7,42,574,1,1,1.274038524,800,42,9,220,213,7,5576,5398,178,92,93,1,100
a3f78bde9bf87d3d37931f878015b490761e75ce,1,58,56,2,0,0,0,12,33,51,1,1,0,213,49,12,42,42,0,1571,1576,5,3,3,0,100
ec43b57605a6c2b8a7d1c7912246915f192e5582,0,0,0,0,0,0,0,0,0,0,0,0,0,0,50,13,0,0,0,0,0,0,0,0,0,100
1f9188d0789640a6514e1120bf4b44061a886165,1,3,1,2,0,0,0,5,13,56,1,1,0,110,43,3,19,19,0,688,672,16,6,6,0,100
9abb526120810661fdc6495438107408cc4dd16d,0,0,0,0,0,0,0,0,0,0,0,0,0,0,22,7,0,0,0,0,0,0,0,0,0,100
244295a743554ecd2a7b5154788336735e47d694,0,0,0,0,0,0,0,0,0,0,0,0,0,0,44,1,0,0,0,0,0,0,0,0,0,100
3d78096bdb61b4ba20336f3fc51d42a5af77cc3c,1,2,2,0,0,0,0,8,21,85,1,1,0,147,34,0,41,41,0,1085,1085,0,15,15,0,100
72865b431fcfbca8148301cd02fe91c31ae497bd,0,0,0,0,0,0,0,0,0,0,0,0,0,0,35,1,0,0,0,0,0,0,0,0,0,100
fb54de3ff2c270d2387b3764445de1a1a02dda58,0,0,0,0,0,0,0,0,0,0,0,0,0,0,23,0,0,0,0,0,0,0,0,0,0,100
0b564c71e1a7d555efb5c9696275ecc69a0df026,32,480,50,430,2,0,2,2,43,1411,3,6,3.967371775,5068,83,0,1159,1103,56,33248,31607,1641,697,651,46,99.704502
bbf4e5a34e9dcdd802b353b01eeabf5794aa2942,1,12,0,12,0,0,0,3,4,265,1,1,0,87,0,0,18,15,3,552,488,64,9,8,1,100
2c143fcc06f0e9cac2e8d62bc1adfde26058b1b8,1,89,0,89,1,0,1,1,1,0,1,1,0,0,1,1,8,0,8,408,0,408,1,0,1,99.96514465
856a681092b7f9c6977102ce2b83a86adc1d7387,1,2,2,0,0,0,0,1,2,0,1,1,0,64,2,2,8,8,0,408,408,0,1,1,0,100
5d02c708a37f547258e40bd687898bae9e6fc13e,1,55,0,55,1,0,1,1,1,0,1,1,0,0,3,3,4,0,4,175,0,175,1,0,1,99.96516893
5924e160823905f2e6c711cdd367c78109bf3d0e,1,32,0,32,0,0,0,4,9,240,1,1,0,252,4,4,49,48,1,2203,1991,212,15,14,1,100
c0463c0e4508a1abe254a9f8cbc7dfa3c2a3798a,0,0,0,0,0,0,0,0,0,0,0,0,0,0,84,1,0,0,0,0,0,0,0,0,0,100
05a97bb4e2ce57cb62262526360f28b2939aca1c,0,0,0,0,0,0,0,0,0,0,0,0,0,0,85,2,0,0,0,0,0,0,0,0,0,100
bbb90c21de046d7368c985570f7bab325485f327,0,0,0,0,0,0,0,0,0,0,0,0,0,0,45,0,0,0,0,0,0,0,0,0,0,100
c943c37e0cc9695700774031c43d4421ba210c3b,0,0,0,0,0,0,0,0,0,0,0,0,0,0,36,0,0,0,0,0,0,0,0,0,0,100
a5a5b5144fd5b68e0ec14ffedd8c0a8b3a1b044f,0,0,0,0,0,0,0,0,0,0,0,0,0,0,191,0,0,0,0,0,0,0,0,0,0,100
7587f40cfeb36a713f7618e496aac203567c3c72,0,0,0,0,0,0,0,0,0,0,0,0,0,0,192,1,0,0,0,0,0,0,0,0,0,100
e75a36c569e86c272781653cf863796a2ae51f8c,0,0,0,0,0,0,0,0,0,0,0,0,0,0,193,2,0,0,0,0,0,0,0,0,0,100
95bb303200ed1dac7bb097ded3d10199556e90c2,0,0,0,0,0,0,0,0,0,0,0,0,0,0,194,3,0,0,0,0,0,0,0,0,0,100
3930aafb3100f860e60f9cf48ec122f54eaabf2e,2,5,0,5,0,0,0,7,13,352,1,2,0.721928095,241,46,0,17,17,0,1828,1824,4,10,10,0,100
0b3b4911b52c779ca1749673ab65c97c6014e0ab,22,22,7,15,0,0,0,2,14,906,1,3,4.375222374,1684,195,4,254,254,0,12326,12282,44,135,135,0,100
4e19a530e15189a7c6ee6342e566f6d1e32aff03,6,6,2,4,0,0,0,2,5,361,2,2,2.5,1341,51,0,65,65,0,6199,6187,12,14,14,0,100
a04e2c3662084adea7dedeb1b023c37ee28fd6d4,0,0,0,0,0,0,0,0,0,0,0,0,0,0,52,1,0,0,0,0,0,0,0,0,0,100
d11a2d7a012931794bfae34a2a6b85f60c956ba3,0,0,0,0,0,0,0,0,0,0,0,0,0,0,196,5,0,0,0,0,0,0,0,0,0,100
3c8c8e216bf9c86f88a1c4990fa8118a55194c13,0,0,0,0,0,0,0,0,0,0,0,0,0,0,197,6,0,0,0,0,0,0,0,0,0,100
77a780ab4edb46c46772ce9582da746712f36d03,0,0,0,0,0,0,0,0,0,0,0,0,0,0,198,7,0,0,0,0,0,0,0,0,0,100
bdad547ca0d96d457f714527faecd0ba0b9e8df1,0,0,0,0,0,0,0,0,0,0,0,0,0,0,53,2,0,0,0,0,0,0,0,0,0,100
2ddda854d41d251fee40e6e51046d0f086161ce6,0,0,0,0,0,0,0,0,0,0,0,0,0,0,199,8,0,0,0,0,0,0,0,0,0,100
9885c64d04c84bb5c808cfcf43d7c5b8e0561f6c,0,0,0,0,0,0,0,0,0,0,0,0,0,0,200,9,0,0,0,0,0,0,0,0,0,100
0fecda4a30fdbb8e51124924e6b48fdda39910d2,0,0,0,0,0,0,0,0,0,0,0,0,0,0,201,10,0,0,0,0,0,0,0,0,0,100
dbd9f75c8c4153c823501b20be3a1fbb80aaafe8,0,0,0,0,0,0,0,0,0,0,0,0,0,0,202,11,0,0,0,0,0,0,0,0,0,100
3d6285b7ab0ba56a5f79342b002eb8160447f8b3,0,0,0,0,0,0,0,0,0,0,0,0,0,0,203,12,0,0,0,0,0,0,0,0,0,100
00c670b04a5918f2e986d2d417c2cb7693f34536,0,0,0,0,0,0,0,0,0,0,0,0,0,0,204,13,0,0,0,0,0,0,0,0,0,100
d98e33f6ce9cd7f03614311c0e990833d8aa90d4,0,0,0,0,0,0,0,0,0,0,0,0,0,0,24,0,0,0,0,0,0,0,0,0,0,100
31114b4e314f8ea15cc4a0170db0aae8eb0ebb39,0,0,0,0,0,0,0,0,0,0,0,0,0,0,24,0,0,0,0,0,0,0,0,0,0,100
1b3f34534980d2b5e664e2d355cc81c465249084,0,0,0,0,0,0,0,0,0,0,0,0,0,0,25,1,0,0,0,0,0,0,0,0,0,100
7b55d387f54bc7ca85081aac4d9bf47472867d47,0,0,0,0,0,0,0,0,0,0,0,0,0,0,26,2,0,0,0,0,0,0,0,0,0,100
459e9acba620fa59540cf755cb927f7a0843631b,0,0,0,0,0,0,0,0,0,0,0,0,0,0,27,3,0,0,0,0,0,0,0,0,0,100
b3a44a4ab274266a0a0808f8c401e80059db48ac,0,0,0,0,0,0,0,0,0,0,0,0,0,0,205,14,0,0,0,0,0,0,0,0,0,100
261aa47c5c120c3961465d6d84e11a78a9bf983d,0,0,0,0,0,0,0,0,0,0,0,0,0,0,206,15,0,0,0,0,0,0,0,0,0,100
20be890bcce6c852def5855dd7d8bc69b249fe8f,0,0,0,0,0,0,0,0,0,0,0,0,0,0,207,16,0,0,0,0,0,0,0,0,0,100
002943be77e9da8e7d6c0d41e55fffe8bf4ea817,10,0,2996,2996,0,0,0,3,5,190,1,2,2.814277645,2169,208,17,0,180,180,0,12551,12551,0,69,69,99.61551905
785668906b5e69db6c9352ffba961b49bda450d2,2,51,1,50,1,0,1,1,2,193,1,2,0.235193382,50,209,18,11,8,3,562,318,244,7,6,1,99.78925184
d177b0a4852df8c2172c7f218131a9d250c5a1dd,1,27,9,18,0,0,0,3,3,374,1,1,0,100,210,19,13,10,3,1092,1016,76,9,6,3,100
1cfa8eab6b2aaa8e01e7ac162926ed3fbc6fe44d,0,0,0,0,0,0,0,0,0,0,0,0,0,0,31,0,0,0,0,0,0,0,0,0,0,100
77be783e845dec2f7bf0f90cc693a86bb9ab001a,1,1,1,0,0,0,0,3,3,467,1,1,0,270,211,0,59,60,1,1853,1860,7,36,36,0,100
9d14053c80a1244bdf7157ab02748a492ae9868a,0,0,0,0,0,0,0,0,0,0,0,0,0,0,212,1,0,0,0,0,0,0,0,0,0,100
bb4c4bcaf452d67b75b3c8d7c500cca6aeb31036,0,0,0,0,0,0,0,0,0,0,0,0,0,0,0,0,0,0,0,0,0,0,0,0,0,100
98d4ff0312e6228c7f34d6030a493d2aec794e03,0,0,0,0,0,0,0,0,0,0,0,0,0,0,1,1,0,0,0,0,0,0,0,0,0,100
f836481b823a1aaaa70d9ab87c030f60c459de0d,0,0,0,0,0,0,0,0,0,0,0,0,0,0,2,2,0,0,0,0,0,0,0,0,0,100
92f48afbb6da34e58ce738eef44f2dec80a60bf1,0,0,0,0,0,0,0,0,0,0,0,0,0,0,3,3,0,0,0,0,0,0,0,0,0,100
a5f0f755fac4a39475b91da8c5977899faa5df77,0,0,0,0,0,0,0,0,0,0,0,0,0,0,4,4,0,0,0,0,0,0,0,0,0,100
de7a75fb3e8bdc2c4768c024a041bb9f11949760,0,0,0,0,0,0,0,0,0,0,0,0,0,0,5,5,0,0,0,0,0,0,0,0,0,100
522f3d516cefd44272cdbf5b4b4f52574200dd6c,0,0,0,0,0,0,0,0,0,0,0,0,0,0,6,6,0,0,0,0,0,0,0,0,0,100
df1db7cc775ed5e10c6416e033e25e430ffdd171,0,0,0,0,0,0,0,0,0,0,0,0,0,0,7,7,0,0,0,0,0,0,0,0,0,100
de732d4bc7fae9d4719ecba54decd14376551344,0,0,0,0,0,0,0,0,0,0,0,0,0,0,8,8,0,0,0,0,0,0,0,0,0,100
b3bda195ad72cdbab0c31a80acc409a8a415d11e,0,0,0,0,0,0,0,0,0,0,0,0,0,0,9,9,0,0,0,0,0,0,0,0,0,100
1806ca809beb2312c62e83b3dbab314b90172118,0,0,0,0,0,0,0,0,0,0,0,0,0,0,10,10,0,0,0,0,0,0,0,0,0,100
0e7b0b4623ff802323027a5e6cd4568e60b2a793,0,0,0,0,0,0,0,0,0,0,0,0,0,0,11,11,0,0,0,0,0,0,0,0,0,100
58f79489129c73b9a4bd7cd5a503cfaf723ccaef,0,0,0,0,0,0,0,0,0,0,0,0,0,0,12,12,0,0,0,0,0,0,0,0,0,100
08ad113f732adfe844cb5fb68ab5897f75aa2456,0,0,0,0,0,0,0,0,0,0,0,0,0,0,13,13,0,0,0,0,0,0,0,0,0,100
8de8b798f0ffa374c2b18e00b8130ac0a0d8e918,0,0,0,0,0,0,0,0,0,0,0,0,0,0,14,14,0,0,0,0,0,0,0,0,0,100
f66477fc53581796035e1dfef06d57e12719f1c5,0,0,0,0,0,0,0,0,0,0,0,0,0,0,15,15,0,0,0,0,0,0,0,0,0,100
851eebcb648752f1a3bff08191d19ce3d6f66ab5,0,0,0,0,0,0,0,0,0,0,0,0,0,0,16,16,0,0,0,0,0,0,0,0,0,100
be815fb25f4c008bf3809bb444e3d8562dea96fa,0,0,0,0,0,0,0,0,0,0,0,0,0,0,17,17,0,0,0,0,0,0,0,0,0,100
4bafc76276ff3d6a3eb1687d4d1c3f834671a482,0,0,0,0,0,0,0,0,0,0,0,0,0,0,18,18,0,0,0,0,0,0,0,0,0,100
ceb1f050cfaf50548bcad83f661d0ad01fe96122,0,0,0,0,0,0,0,0,0,0,0,0,0,0,19,19,0,0,0,0,0,0,0,0,0,100
9d48487cf2a7060193b305c152b8ce191f7d15be,0,0,0,0,0,0,0,0,0,0,0,0,0,0,20,20,0,0,0,0,0,0,0,0,0,100
f26245b8f06d2c05a818f47c9162df6f4d7f7b67,0,0,0,0,0,0,0,0,0,0,0,0,0,0,21,21,0,0,0,0,0,0,0,0,0,100
2a4e9690c82fa341741f52fa7ccb64cab8ea66df,0,0,0,0,0,0,0,0,0,0,0,0,0,0,22,22,0,0,0,0,0,0,0,0,0,100
fcc6cf17a7820de9d0edd6bbca023086c84913ee,0,0,0,0,0,0,0,0,0,0,0,0,0,0,23,23,0,0,0,0,0,0,0,0,0,100
d13f48849ad5658cc03acea57f7c5d9d14bad137,0,0,0,0,0,0,0,0,0,0,0,0,0,0,24,24,0,0,0,0,0,0,0,0,0,100
35426a96b98bb74538466318c5347d2f90415e97,0,0,0,0,0,0,0,0,0,0,0,0,0,0,25,25,0,0,0,0,0,0,0,0,0,100
3112f3c67abbf0368cb5729c8561201e65dc674b,0,0,0,0,0,0,0,0,0,0,0,0,0,0,26,26,0,0,0,0,0,0,0,0,0,100
19708f46a41d0bc437f904a383876858a3fef35d,0,0,0,0,0,0,0,0,0,0,0,0,0,0,27,27,0,0,0,0,0,0,0,0,0,100
137b3b840eff74f0833d5678a55af2dde4a316a7,0,0,0,0,0,0,0,0,0,0,0,0,0,0,28,28,0,0,0,0,0,0,0,0,0,100
78c9ac2ea3b14cdf20d38fbc3f7bbee1b059d610,0,0,0,0,0,0,0,0,0,0,0,0,0,0,29,29,0,0,0,0,0,0,0,0,0,100
c72698aca16368c4f16d5181fbdd3db6314c04e3,0,0,0,0,0,0,0,0,0,0,0,0,0,0,30,30,0,0,0,0,0,0,0,0,0,100
0df6e08f27c76c6eeb4a714e0087722bef166970,0,0,0,0,0,0,0,0,0,0,0,0,0,0,86,0,0,0,0,0,0,0,0,0,0,100
7039f4c5f1fb86edc02e56f8a159a1a8bd4c51db,0,0,0,0,0,0,0,0,0,0,0,0,0,0,213,0,0,0,0,0,0,0,0,0,0,100
f5a4a976288a3ec10942f1b28ea793bacac33955,0,0,0,0,0,0,0,0,0,0,0,0,0,0,214,1,0,0,0,0,0,0,0,0,0,100
9f6f62acfaa501f183bdfd29c42de815db24201d,0,0,0,0,0,0,0,0,0,0,0,0,0,0,87,1,0,0,0,0,0,0,0,0,0,100
edc0c69ac5456c13d74ab1d5c656d6a3ee17f246,0,0,0,0,0,0,0,0,0,0,0,0,0,0,86,0,0,0,0,0,0,0,0,0,0,100
9831771b868e254413d0c52c6fc1ad1e1c664d04,0,0,0,0,0,0,0,0,0,0,0,0,0,0,89,3,0,0,0,0,0,0,0,0,0,100
9e9ec79d6ceac7928e78be1dcf48c421c851b4bb,0,0,0,0,0,0,0,0,0,0,0,0,0,0,90,4,0,0,0,0,0,0,0,0,0,100
41dcb4253af7fdccee81b2f2acf22e6a904c2b9d,0,0,0,0,0,0,0,0,0,0,0,0,0,0,215,2,0,0,0,0,0,0,0,0,0,100
1d9b6322e4db2cfd0b681e27591fe81206a915f5,0,0,0,0,0,0,0,0,0,0,0,0,0,0,216,3,0,0,0,0,0,0,0,0,0,100
e943b0a0df28b20cf93aba8778a02eb68fead6c4,0,0,0,0,0,0,0,0,0,0,0,0,0,0,217,4,0,0,0,0,0,0,0,0,0,100
7552c55e2c0705ebc5fd43cbb2026b4dbf46f1ec,0,0,0,0,0,0,0,0,0,0,0,0,0,0,213,0,0,0,0,0,0,0,0,0,0,100
37dccb87ea86ca54e56409df62474be8fe56761c,0,0,0,0,0,0,0,0,0,0,0,0,0,0,214,1,0,0,0,0,0,0,0,0,0,100
0753d422ba74aa20079075215c01684bbdce7d43,0,0,0,0,0,0,0,0,0,0,0,0,0,0,215,2,0,0,0,0,0,0,0,0,0,100
d53f0a5d78000045bb12e90e3a6808cc2c369450,0,0,0,0,0,0,0,0,0,0,0,0,0,0,218,5,0,0,0,0,0,0,0,0,0,100
0c6351fa5459920ccfd752f54f8fd41176b0afe8,0,0,0,0,0,0,0,0,0,0,0,0,0,0,219,6,0,0,0,0,0,0,0,0,0,100
dc890d99a26f64dd04f0458e0d1dc58299483095,0,0,0,0,0,0,0,0,0,0,0,0,0,0,216,3,0,0,0,0,0,0,0,0,0,100
1d42df192fb7f941da4ca9ed4aa5c667bfa79e93,0,0,0,0,0,0,0,0,0,0,0,0,0,0,217,4,0,0,0,0,0,0,0,0,0,100
38d0808523800a4369b18251e58b04d61771baf5,0,0,0,0,0,0,0,0,0,0,0,0,0,0,220,7,0,0,0,0,0,0,0,0,0,100
854a2893c9b30fea78f9f93d59848f0eb62b175b,0,0,0,0,0,0,0,0,0,0,0,0,0,0,221,8,0,0,0,0,0,0,0,0,0,100
509c966f1b0f8fcd9a63cac1bc16f089b0b615df,4,104,6,98,0,0,0,7,37,856,1,1,0.62625796,912,218,5,236,223,13,6601,6059,542,115,112,3,100
5a6d140599024cd8a6bb2a4b2187376fbad40a7d,0,0,0,0,0,0,0,0,0,0,0,0,0,0,222,9,0,0,0,0,0,0,0,0,0,100
708cc4f2b6c16ca76005d0a06b4dc8e3f0bacd3a,3,0,319,319,0,0,0,3,8,516,1,2,1.580592645,213,219,6,0,28,28,0,1636,1636,0,9,9,99.87678226
82e78a8c9a1beee637ad381baf3ff9d4bb4297cc,20,0,2518,2518,0,0,0,7,15,278,1,2,4.043722024,1867,220,7,0,262,262,0,13492,13492,0,134,134,99.09349449
e0b8b90e91c2ea72e2562d504ad16051cf759787,0,0,0,0,0,0,0,0,0,0,0,0,0,0,221,8,0,0,0,0,0,0,0,0,0,100
c113a8c9314a7f21ffb282d043565006a9d5c9c7,1,1,1,0,0,0,0,3,3,639,1,1,0,479,222,9,114,114,0,3417,3416,1,37,37,0,100
126c165ca09cf3b0f85f6a83fb080e8283c1fed0,0,0,0,0,0,0,0,0,0,0,0,0,0,0,223,10,0,0,0,0,0,0,0,0,0,100
347c2f2ec61f6a83e06c00c19d069acaf3a938b7,0,0,0,0,0,0,0,0,0,0,0,0,0,0,47,0,0,0,0,0,0,0,0,0,0,100
48bfb64f1b57844d37a693f5aaafd10699b355df,0,0,0,0,0,0,0,0,0,0,0,0,0,0,224,11,0,0,0,0,0,0,0,0,0,100
1ffa3a4609f58f9144a69422b202ae53cd8ef6c9,66,63,814,751,0,0,0,3,13,651,2,19,2.42350255,6044,225,12,967,1027,60,45372,50551,5179,403,417,14,99.1766601
ebdd44fc8ce6c0275dd76570814ce9e549706bcc,0,0,0,0,0,0,0,0,0,0,0,0,0,0,226,13,0,0,0,0,0,0,0,0,0,100
6f9a8125f5aa54ab6f58da0640b982a2dae41170,0,0,0,0,0,0,0,0,0,0,0,0,0,0,227,14,0,0,0,0,0,0,0,0,0,100
0c4b464335f4d663471f289a0794efcc651c519d,0,0,0,0,0,0,0,0,0,0,0,0,0,0,228,15,0,0,0,0,0,0,0,0,0,100
884f2d317f2e2a4e1321a5febddc8499e7715209,0,0,0,0,0,0,0,0,0,0,0,0,0,0,229,16,0,0,0,0,0,0,0,0,0,100
390faac19c957f60e44c6daf40ee9534c13dd5a4,0,0,0,0,0,0,0,0,0,0,0,0,0,0,230,17,0,0,0,0,0,0,0,0,0,100
0db570698ddc749a02062a5818f5ef313a49bbf2,0,0,0,0,0,0,0,0,0,0,0,0,0,0,231,18,0,0,0,0,0,0,0,0,0,100
6785ba1a0c28fd530464144ac2731f2b977af1f1,0,0,0,0,0,0,0,0,0,0,0,0,0,0,232,19,0,0,0,0,0,0,0,0,0,100
242c1e23b457d2fa99e1a8e8eabcc2b39c86d723,0,0,0,0,0,0,0,0,0,0,0,0,0,0,48,1,0,0,0,0,0,0,0,0,0,100
afeff1e39a74de08d6a25cbdb80d2b08e5b345b5,0,0,0,0,0,0,0,0,0,0,0,0,0,0,233,20,0,0,0,0,0,0,0,0,0,100
a6d6bf503b528d2180f85224c7df9a84925cd633,0,0,0,0,0,0,0,0,0,0,0,0,0,0,234,21,0,0,0,0,0,0,0,0,0,100
115ae609aca1737007b2b44f8a3d8eafc53d0271,0,0,0,0,0,0,0,0,0,0,0,0,0,0,235,22,0,0,0,0,0,0,0,0,0,100
cc710b0d4e699f1683b042020b2cd9d5b682a466,90,3652,64,3588,26,0,26,2,14,184,3,24,4.6297191,6002,223,8,1431,1081,350,69095,48789,20306,597,440,157,98.22757887
c2b077f0a22ffbf1ca6c74d694bfadda06d6db44,91,64,3653,3589,0,0,0,3,20,588,4,25,4.632052354,8793,236,21,1128,1478,350,50190,70509,20319,458,615,157,97.54859044
bf1cdd428c02552cb27c87de89c63a896d1cb0e6,90,3652,64,3588,26,0,26,2,14,184,3,24,4.6297191,6002,224,6,1431,1081,350,69095,48789,20306,597,440,157,98.26989619
ec10963a436fea7d5775482fb22acb16bb970f1d,90,64,3652,3588,0,0,0,3,15,590,3,24,4.6297191,8603,237,21,1081,1431,350,48789,69095,20306,440,597,157,98.26989619
3e5491535695048d0f7ada9bd741cf76379eb643,90,3652,64,3588,26,0,26,2,14,184,3,24,4.6297191,6002,225,2,1431,1081,350,69095,48789,20306,597,440,157,98.26989619
54f51de82cd8281c1ea27a9b9b8d8703191da504,0,0,0,0,0,0,0,0,0,0,0,0,0,0,226,3,0,0,0,0,0,0,0,0,0,100
e2ab67f2629a6c49c4d8e911274b409c2b57101c,0,0,0,0,0,0,0,0,0,0,0,0,0,0,227,4,0,0,0,0,0,0,0,0,0,100
67c78209b68955a9bef219e3b1ed69c92e8e68a4,90,64,3652,3588,0,0,0,3,15,590,3,24,4.6297191,8603,238,19,1081,1431,350,48789,69095,20306,440,597,157,98.26989619
af015ece73400d7a215bc109835800ec1b480f0e,90,3652,64,3588,26,0,26,2,14,184,3,24,4.6297191,6002,228,5,1431,1081,350,69095,48789,20306,597,440,157,98.26989619
99d8ce24b3ae3e4ea413bee2e09da72ff3faf723,90,64,3652,3588,0,0,0,3,15,590,3,24,4.6297191,8603,239,20,1081,1431,350,48789,69095,20306,440,597,157,98.26989619
89e19c75e80fd9523af5eb208cc13674db7a847f,0,0,0,0,0,0,0,0,0,0,0,0,0,0,0,0,0,0,0,0,0,0,0,0,0,100
599101083ab7d31600b8c93b2efd8cea4c0a30bf,0,0,0,0,0,0,0,0,0,0,0,0,0,0,1,1,0,0,0,0,0,0,0,0,0,100
57317a51a8da516d6e25000eae7db8b4102cbda3,0,0,0,0,0,0,0,0,0,0,0,0,0,0,28,0,0,0,0,0,0,0,0,0,0,100
6919fd9febe1585d15e78e51aabcad8fa29235f3,0,0,0,0,0,0,0,0,0,0,0,0,0,0,49,0,0,0,0,0,0,0,0,0,0,100
e3935bbad97eeb55cbe9f2cd60b8a7ec969a6c62,90,3652,64,3588,26,0,26,2,14,184,3,24,4.6297191,6002,229,0,1431,1081,350,69095,48789,20306,597,440,157,98.26989619
f66e022c631c134e8b7e138e25d8fd94011d1b4c,0,0,0,0,0,0,0,0,0,0,0,0,0,0,28,0,0,0,0,0,0,0,0,0,0,100
97a3f2e022bd2c5fbefb4b53d670b3f313a39cc9,0,0,0,0,0,0,0,0,0,0,0,0,0,0,47,0,0,0,0,0,0,0,0,0,0,100
fcd6b9e01aea5f92fd947c0964ef7884314f33db,90,64,3652,3588,0,0,0,3,15,590,3,24,4.6297191,8603,50,1,1081,1431,350,48789,69095,20306,440,597,157,98.26989619
e8b9c8003b15143a7dd64af074be8b06c9eb35a2,0,0,0,0,0,0,0,0,0,0,0,0,0,0,51,2,0,0,0,0,0,0,0,0,0,100
f6224fcf7e3dc2cfdf086c553e6b7f3e872263aa,0,0,0,0,0,0,0,0,0,0,0,0,0,0,240,0,0,0,0,0,0,0,0,0,0,100
2b023cf88e09efc301e9d970fd834cb05d96287c,0,0,0,0,0,0,0,0,0,0,0,0,0,0,52,3,0,0,0,0,0,0,0,0,0,100
a3cdff6d6f5a10457bb7c17a3f976f9b67c39b6a,0,0,0,0,0,0,0,0,0,0,0,0,0,0,53,4,0,0,0,0,0,0,0,0,0,100
284651dc05c0c57ba094ba738a20db6cbe3bbcd7,3,85,86,1,0,0,0,9,37,1713,1,2,0.478504781,1155,241,1,146,145,1,9076,8955,121,86,87,1,100
b21381b92ef9a0e92d8360273a1dcbf368f2a9a1,1,6,1,5,0,0,0,9,38,0,1,1,0,213,242,2,51,50,1,1215,1200,15,39,38,1,100
5926df8f1130106ff6ff525a3d670f6fff567f0b,1,31,31,0,0,0,0,8,21,366,1,1,0,189,243,3,48,47,1,1452,1401,51,18,18,0,100
85e543c9af73b1fa560c11124361772e7cf59e9e,0,0,0,0,0,0,0,0,0,0,0,0,0,0,244,4,0,0,0,0,0,0,0,0,0,100
a4bba8261f848ea7833bd5723a515ee3bd10989c,0,0,0,0,0,0,0,0,0,0,0,0,0,0,54,5,0,0,0,0,0,0,0,0,0,100
d9b376e37e2b9613baf6fb774f6cb9d3b88560b8,0,0,0,0,0,0,0,0,0,0,0,0,0,0,55,6,0,0,0,0,0,0,0,0,0,100
c401eb9ae18e67b3d504e0db7aace47e194e53d5,94,3769,185,3584,26,0,26,2,36,206,4,26,4.749921992,7351,230,1,1623,1276,347,79451,59332,20119,702,545,157,98.26989619
05f1b8ff0486e648a29eccaff00c48a0b1fc3f03,0,0,0,0,0,0,0,0,0,0,0,0,0,0,48,1,0,0,0,0,0,0,0,0,0,100
6ca09989dbd32f319372444595265faa2d5606ea,3,99,95,4,0,0,0,9,37,1716,1,2,0.436465726,1155,231,2,147,145,2,9091,8955,136,87,87,0,100
c238b3fd80cae020bae4cb8be1838e6104a22d43,1,31,31,0,0,0,0,8,21,368,1,1,0,189,232,3,48,47,1,1452,1401,51,18,18,0,100
f1018ed184f741a78cce3ba887442e8786662b54,0,0,0,0,0,0,0,0,0,0,0,0,0,0,233,4,0,0,0,0,0,0,0,0,0,100
46071e6f3eb9ed53895222a54657326c83c62a53,0,0,0,0,0,0,0,0,0,0,0,0,0,0,49,2,0,0,0,0,0,0,0,0,0,100
73649fa84493c11c82ac6f568b344776b4ab81a9,0,0,0,0,0,0,0,0,0,0,0,0,0,0,50,3,0,0,0,0,0,0,0,0,0,100
d6cd142d4e977567f46a47beb0541e67d6485ddc,90,64,3652,3588,0,0,0,3,15,590,3,24,4.6297191,8603,245,5,1081,1431,350,48789,69095,20306,440,597,157,98.26989619
a168d238d13fabfe11afe6870b38e09534dc65d6,90,3652,64,3588,26,0,26,2,14,184,3,24,4.6297191,6002,234,5,1431,1081,350,69095,48789,20306,597,440,157,98.26989619
928599a2dea15fcf187bd5fd0d166cfa20aa715f,90,64,3652,3588,0,0,0,3,15,590,3,24,4.6297191,8603,246,6,1081,1431,350,48789,69095,20306,440,597,157,98.26989619
abdfa2e57aac4c68ad2307bd718b14263a9d68e1,0,0,0,0,0,0,0,0,0,0,0,0,0,0,247,7,0,0,0,0,0,0,0,0,0,100
92a2f6c8ffa02478e7cc8a4b79ff270bf4d08c8a,90,3652,64,3588,26,0,26,2,14,184,3,24,4.6297191,6002,91,0,1431,1081,350,69095,48789,20306,597,440,157,98.26989619
5d56be7f31592c73a3363ec6f582fece5ff27be4,90,64,3652,3588,0,0,0,3,15,590,3,24,4.6297191,8603,56,7,1081,1431,350,48789,69095,20306,440,597,157,98.26989619
401c8e8b4a40accc0d41fe8f3c4ee55dfba0040d,0,0,0,0,0,0,0,0,0,0,0,0,0,0,57,8,0,0,0,0,0,0,0,0,0,100
7d71ad00a5a3f3e8f2b176194259e9f2044484ac,0,0,0,0,0,0,0,0,0,0,0,0,0,0,58,9,0,0,0,0,0,0,0,0,0,100
072289a46c9bd4b7297a17b621f7da30b94df1a7,90,3652,64,3588,26,0,26,2,14,184,3,24,4.6297191,6002,235,6,1431,1081,350,69095,48789,20306,597,440,157,98.26989619
cd4e3cec34aac50a6110839be47f9a1be5550e23,0,0,0,0,0,0,0,0,0,0,0,0,0,0,236,7,0,0,0,0,0,0,0,0,0,100
e75c5f6064b162e1f0469ea3e86997d1e37f9057,0,0,0,0,0,0,0,0,0,0,0,0,0,0,51,4,0,0,0,0,0,0,0,0,0,100
93ebed620ae7d7da1a6ac2dbe944a8fd517de1c0,0,0,0,0,0,0,0,0,0,0,0,0,0,0,237,8,0,0,0,0,0,0,0,0,0,100
b692cbfcc56871c85ea1c483e8d78eed21b514b8,0,0,0,0,0,0,0,0,0,0,0,0,0,0,52,5,0,0,0,0,0,0,0,0,0,100
eda8a38e40d3aa938ea525183ff484957f2c8597,0,0,0,0,0,0,0,0,0,0,0,0,0,0,53,6,0,0,0,0,0,0,0,0,0,100
fd0112dcf3ac8219b169aa03bed1de3e3333c1a8,0,0,0,0,0,0,0,0,0,0,0,0,0,0,238,9,0,0,0,0,0,0,0,0,0,100
f2aef44cd592904a1baba5e798b3b0d84c089930,0,0,0,0,0,0,0,0,0,0,0,0,0,0,54,7,0,0,0,0,0,0,0,0,0,100
1e6c547e0814393413ed5c67ba149294e1229d49,0,0,0,0,0,0,0,0,0,0,0,0,0,0,55,8,0,0,0,0,0,0,0,0,0,100
b52036cc9e35dcd6031ebd9e4fc8a63856b3f34f,0,0,0,0,0,0,0,0,0,0,0,0,0,0,56,9,0,0,0,0,0,0,0,0,0,100
d9deb68ff1d744d7994a60181f302f714543dff5,0,0,0,0,0,0,0,0,0,0,0,0,0,0,239,10,0,0,0,0,0,0,0,0,0,100
ff51ab448b07c5b218d1a08ed5c1194ad5b24179,90,64,3652,3588,0,0,0,3,15,590,3,24,4.6297191,8603,59,10,1081,1431,350,48789,69095,20306,440,597,157,98.26989619
812ae398c257b6e2ec87bcc8ef986d50c28e6025,90,3652,64,3588,26,0,26,2,14,184,3,24,4.6297191,6002,57,10,1431,1081,350,69095,48789,20306,597,440,157,98.26989619
7b862781cfcd854335600f2ad85ad577817ba43e,0,0,0,0,0,0,0,0,0,0,0,0,0,0,240,11,0,0,0,0,0,0,0,0,0,100
2e8790d5c6e0f337abe55906e052d7236f046207,0,0,0,0,0,0,0,0,0,0,0,0,0,0,58,11,0,0,0,0,0,0,0,0,0,100
23267a0bef064f3351fd879274724bcb02333c4a,90,64,3652,3588,0,0,0,3,15,590,3,24,4.6297191,8603,29,0,1081,1431,350,48789,69095,20306,440,597,157,98.26989619
da65cbe2b745da98a39ef51723154ef4a450e832,90,3652,64,3588,26,0,26,2,14,184,3,24,4.6297191,6002,29,1,1431,1081,350,69095,48789,20306,597,440,157,98.26989619
67f00930a8412be39de2c7b2abc9936f634f13d6,90,64,3652,3588,0,0,0,3,15,590,3,24,4.6297191,8603,30,1,1081,1431,350,48789,69095,20306,440,597,157,98.26989619
b25a70a1bc6b9f8cb6c89947e0eaba5588463652,0,0,0,0,0,0,0,0,0,0,0,0,0,0,31,2,0,0,0,0,0,0,0,0,0,100
1c1abbf3d946c6a8082f089b3f49900450553578,90,3652,64,3588,26,0,26,2,14,184,3,24,4.6297191,6002,30,2,1431,1081,350,69095,48789,20306,597,440,157,98.26989619
c00b96ecc909fe6bcd4dce5e365a7fcea8a2bfdf,0,0,0,0,0,0,0,0,0,0,0,0,0,0,31,3,0,0,0,0,0,0,0,0,0,100
d1d6fc0a4bcab5fe51aa1775074571174b671b3a,0,0,0,0,0,0,0,0,0,0,0,0,0,0,32,4,0,0,0,0,0,0,0,0,0,100
f4f42ae4c4c7555659edcc43669fec82f9537219,0,0,0,0,0,0,0,0,0,0,0,0,0,0,59,12,0,0,0,0,0,0,0,0,0,100
9bf5292fd7ae8bacf027378d4b692f4e70aa46e2,0,0,0,0,0,0,0,0,0,0,0,0,0,0,241,11,0,0,0,0,0,0,0,0,0,100
e06fb119dc3a719651fd48f0d2aa3ee8adee9a1b,0,0,0,0,0,0,0,0,0,0,0,0,0,0,60,12,0,0,0,0,0,0,0,0,0,100
202b94f840286d4d0970f0427122697ba27fc1fb,0,0,0,0,0,0,0,0,0,0,0,0,0,0,61,13,0,0,0,0,0,0,0,0,0,100
e3c8db502b5e7cf926c2628f413bd5aaa69b2765,0,0,0,0,0,0,0,0,0,0,0,0,0,0,242,7,0,0,0,0,0,0,0,0,0,100
a1cf7cf56e036ce12d616f8aea0af1e9dcdf2cb6,0,0,0,0,0,0,0,0,0,0,0,0,0,0,62,11,0,0,0,0,0,0,0,0,0,100
9c5ee59214a454f7ae25c762bf04bb30bd7982c8,0,0,0,0,0,0,0,0,0,0,0,0,0,0,63,12,0,0,0,0,0,0,0,0,0,100
ad4c32ce871df686267df1f1dbff76a883b8d3fc,0,0,0,0,0,0,0,0,0,0,0,0,0,0,64,13,0,0,0,0,0,0,0,0,0,100
ad22252ca2ab39e22d4df7cc22464af2c6179830,0,0,0,0,0,0,0,0,0,0,0,0,0,0,65,14,0,0,0,0,0,0,0,0,0,100
100d343e4b6e66b1a7c581455cd1faab7bbdb538,0,0,0,0,0,0,0,0,0,0,0,0,0,0,66,15,0,0,0,0,0,0,0,0,0,100
b96918bba9855fba5cefc11e1c4153b9419509cb,0,0,0,0,0,0,0,0,0,0,0,0,0,0,67,16,0,0,0,0,0,0,0,0,0,100
b45f982581b2a2bed75b771672b4f2d66ef32840,0,0,0,0,0,0,0,0,0,0,0,0,0,0,68,17,0,0,0,0,0,0,0,0,0,100
a77f1c13de58d462eed7ff224ec333b22ac22bf3,0,0,0,0,0,0,0,0,0,0,0,0,0,0,62,11,0,0,0,0,0,0,0,0,0,100
f0ee522c69a1f47f0d4da263e9f1669404155b5e,0,0,0,0,0,0,0,0,0,0,0,0,0,0,70,19,0,0,0,0,0,0,0,0,0,100
e420485e0b82908919985a892f85c7d6dff9d24b,0,0,0,0,0,0,0,0,0,0,0,0,0,0,71,20,0,0,0,0,0,0,0,0,0,100
48a8a8208322ed690d5356a4e0cac7667b080bab,0,0,0,0,0,0,0,0,0,0,0,0,0,0,72,21,0,0,0,0,0,0,0,0,0,100
f9111ac27334659b2fb55849319dcd8e113b3c25,0,0,0,0,0,0,0,0,0,0,0,0,0,0,73,22,0,0,0,0,0,0,0,0,0,100
b67398f933d50d3e4f00ebd7ccd57f17b96604c7,0,0,0,0,0,0,0,0,0,0,0,0,0,0,74,23,0,0,0,0,0,0,0,0,0,100
99c32f2d9008e1a48c52183c638792bdbd4766f4,1,1,1,0,0,0,0,3,6,1101,1,1,0,56,243,8,3,3,0,371,372,1,1,1,0,100
f0e22e28c8da53a0c26233afd4d363dcc035ee7d,0,0,0,0,0,0,0,0,0,0,0,0,0,0,244,9,0,0,0,0,0,0,0,0,0,100
5863bbf1587cabef68f470fc8cd4812a2c1f8f79,0,0,0,0,0,0,0,0,0,0,0,0,0,0,245,5,0,0,0,0,0,0,0,0,0,100
c75f3e2de00ffb2014d765e904a3c754169039c7,0,0,0,0,0,0,0,0,0,0,0,0,0,0,246,5,0,0,0,0,0,0,0,0,0,100
c1d79ff4c2e38325736f09a8a35eb7ba2625509d,0,0,0,0,0,0,0,0,0,0,0,0,0,0,247,5,0,0,0,0,0,0,0,0,0,100
209b9460050695cdf42cb75dfcff5482792c342d,0,0,0,0,0,0,0,0,0,0,0,0,0,0,248,6,0,0,0,0,0,0,0,0,0,100
2861732da34a87c48f7da77576ca2a75837a54e4,0,0,0,0,0,0,0,0,0,0,0,0,0,0,249,7,0,0,0,0,0,0,0,0,0,100
4fc65d4e26957cfef68eb30e0bf712758e21a5a1,0,0,0,0,0,0,0,0,0,0,0,0,0,0,75,13,0,0,0,0,0,0,0,0,0,100
a2101110e9a932ac547c025c7267ffa88ecbe271,0,0,0,0,0,0,0,0,0,0,0,0,0,0,250,7,0,0,0,0,0,0,0,0,0,100
c9c89627b29156525d1cae714629c59bd011ba53,0,0,0,0,0,0,0,0,0,0,0,0,0,0,251,8,0,0,0,0,0,0,0,0,0,100
1aae3321b554adaf18f6c56abe1d7e4835c13cab,0,0,0,0,0,0,0,0,0,0,0,0,0,0,33,0,0,0,0,0,0,0,0,0,0,100
2edb274d56a257dabf9d7f559e71d5b22ff021f0,0,0,0,0,0,0,0,0,0,0,0,0,0,0,34,1,0,0,0,0,0,0,0,0,0,100
eccbc4e1eefb89d198633f4138870e1a64eacfea,91,65,3653,3588,0,0,0,3,15,590,4,25,4.633846533,8659,32,0,1084,1434,350,49161,69466,20305,441,598,157,98.26989619
00a09dc7243bddf89d5dd22888397c94f4b7ca77,91,3653,65,3588,26,0,26,2,14,194,4,25,4.633846533,6058,35,2,1434,1084,350,69466,49161,20305,598,441,157,98.26989619
7c275f06e618624ac5bdc269b19d328a6c2b6983,0,0,0,0,0,0,0,0,0,0,0,0,0,0,252,9,0,0,0,0,0,0,0,0,0,100
430310dbf7870e263ea0340df9b226655ce82a72,0,0,0,0,0,0,0,0,0,0,0,0,0,0,253,10,0,0,0,0,0,0,0,0,0,100
681d30e54f1f90a75733990056f864ab6c7c9cc6,0,0,0,0,0,0,0,0,0,0,0,0,0,0,254,11,0,0,0,0,0,0,0,0,0,100
4856d5fdf8010127e2e7951a0045b8cc2cae9ce3,0,0,0,0,0,0,0,0,0,0,0,0,0,0,255,12,0,0,0,0,0,0,0,0,0,100
472438bc83a51bcc08518e44daff4ec5f3bf81e9,0,0,0,0,0,0,0,0,0,0,0,0,0,0,76,1,0,0,0,0,0,0,0,0,0,100
71609ad61ce02feeaa641c0cedb75e707d6c9b7d,0,0,0,0,0,0,0,0,0,0,0,0,0,0,77,2,0,0,0,0,0,0,0,0,0,100
0987e9949879ff1e595f39eeb08cf5aa505ad2b4,0,0,0,0,0,0,0,0,0,0,0,0,0,0,78,3,0,0,0,0,0,0,0,0,0,100
abfc756373ba8277b72477cd9a2c4ac4e6fdf833,0,0,0,0,0,0,0,0,0,0,0,0,0,0,256,12,0,0,0,0,0,0,0,0,0,100
837448483c0eb18fee62176e22b9053b0670a3bb,0,0,0,0,0,0,0,0,0,0,0,0,0,0,257,13,0,0,0,0,0,0,0,0,0,100
6fc0100827268d1dcac473980d79707683914880,0,0,0,0,0,0,0,0,0,0,0,0,0,0,258,14,0,0,0,0,0,0,0,0,0,100
6667bb0adf206ef5cc86520c8e211b8553ed98b3,0,0,0,0,0,0,0,0,0,0,0,0,0,0,79,4,0,0,0,0,0,0,0,0,0,100
1f5fc5243053b933a65b8277bc9743cd8e94b5a7,0,0,0,0,0,0,0,0,0,0,0,0,0,0,259,15,0,0,0,0,0,0,0,0,0,100
4e7d106a6b958fa11f849262a4359e937c4bb882,0,0,0,0,0,0,0,0,0,0,0,0,0,0,260,16,0,0,0,0,0,0,0,0,0,100
612380e1d38c3920a66611dc0d614d9e50472671,0,0,0,0,0,0,0,0,0,0,0,0,0,0,261,17,0,0,0,0,0,0,0,0,0,100
c5659b5fe841afc8df70c39645db268cc2c85c30,0,0,0,0,0,0,0,0,0,0,0,0,0,0,262,18,0,0,0,0,0,0,0,0,0,100
165460e4b6f2f2febc85c56db765a2f91028d31b,90,64,3652,3588,0,0,0,3,15,590,3,24,4.6297191,8603,93,5,1081,1431,350,48789,69095,20306,440,597,157,98.26989619
f115633fd4de83afd1be1cc8ced61580cc426604,0,0,0,0,0,0,0,0,0,0,0,0,0,0,298,19,0,0,0,0,0,0,0,0,0,100
eabf90d73e7aa664eb4f9f8b3166f748e547b506,0,0,0,0,0,0,0,0,0,0,0,0,0,0,299,20,0,0,0,0,0,0,0,0,0,100
fcdeef6d70042c5433e70f827df11fe79dd274f4,0,0,0,0,0,0,0,0,0,0,0,0,0,0,94,6,0,0,0,0,0,0,0,0,0,100
4a917824f7b8366fcb19b222f80fd210c37707ec,0,0,0,0,0,0,0,0,0,0,0,0,0,0,95,7,0,0,0,0,0,0,0,0,0,100
b725255ad6414fc89b6a7276c86995fa7183f14c,0,0,0,0,0,0,0,0,0,0,0,0,0,0,96,8,0,0,0,0,0,0,0,0,0,100
94b4fa1433c7a5e1950fb3f66cdba3c649445df8,0,0,0,0,0,0,0,0,0,0,0,0,0,0,97,9,0,0,0,0,0,0,0,0,0,100
e7086e7021803148a6cd00aee6b4cd785e1e2fba,0,0,0,0,0,0,0,0,0,0,0,0,0,0,300,21,0,0,0,0,0,0,0,0,0,100
75c382f2129544a26d35889df7c15ab9d5ee9104,0,0,0,0,0,0,0,0,0,0,0,0,0,0,301,22,0,0,0,0,0,0,0,0,0,100
cefd0d3d3c62b756f4ebc90bf828e635d674cada,0,0,0,0,0,0,0,0,0,0,0,0,0,0,302,23,0,0,0,0,0,0,0,0,0,100
0db81f693c510f456ec99ff1bf339f817b448ed2,0,0,0,0,0,0,0,0,0,0,0,0,0,0,303,22,0,0,0,0,0,0,0,0,0,100
f344f642b2f195e2e83ffe84eacfd8e7851bd2cc,0,0,0,0,0,0,0,0,0,0,0,0,0,0,304,23,0,0,0,0,0,0,0,0,0,100
2985b7cc463035cf991b5fa94cb6c9abd1592466,0,0,0,0,0,0,0,0,0,0,0,0,0,0,305,23,0,0,0,0,0,0,0,0,0,100
f26698dc7d8ce928229e39d152da35ac25e226e3,0,0,0,0,0,0,0,0,0,0,0,0,0,0,306,24,0,0,0,0,0,0,0,0,0,100
8e605339896ae8e295f4e4029c92e5fddc96d427,0,0,0,0,0,0,0,0,0,0,0,0,0,0,307,25,0,0,0,0,0,0,0,0,0,100
91df36918221dcf6f553c8d51c4dbf4d14180fee,0,0,0,0,0,0,0,0,0,0,0,0,0,0,308,26,0,0,0,0,0,0,0,0,0,100
9c064b32b01af5192587b4da2d0ad259b4335e83,0,0,0,0,0,0,0,0,0,0,0,0,0,0,309,27,0,0,0,0,0,0,0,0,0,100
9fcebb0efcea1f04e4c1cf4a40f12e907a79e80a,0,0,0,0,0,0,0,0,0,0,0,0,0,0,98,10,0,0,0,0,0,0,0,0,0,100
3fe00616bf3c41befbd3dd70427451891bac742b,0,0,0,0,0,0,0,0,0,0,0,0,0,0,99,11,0,0,0,0,0,0,0,0,0,100
48f05d6c0cc7790810225e138239b4b8418c2979,0,0,0,0,0,0,0,0,0,0,0,0,0,0,100,12,0,0,0,0,0,0,0,0,0,100
df1f064a08ffeef1f413c807d97664d3e6de8118,0,0,0,0,0,0,0,0,0,0,0,0,0,0,101,13,0,0,0,0,0,0,0,0,0,100
79539f1269dfb3e654a89e77d598908481073471,0,0,0,0,0,0,0,0,0,0,0,0,0,0,102,14,0,0,0,0,0,0,0,0,0,100
ea12bb60e2ae509f9ba5f98c5688eda2a8ff4813,0,0,0,0,0,0,0,0,0,0,0,0,0,0,103,15,0,0,0,0,0,0,0,0,0,100
a8379ad36898b971f4f3f8ddc6bf01b6de67f64d,0,0,0,0,0,0,0,0,0,0,0,0,0,0,104,16,0,0,0,0,0,0,0,0,0,100
53e1c8db96a60ddd1f28516778ec6e2230ad437e,0,0,0,0,0,0,0,0,0,0,0,0,0,0,105,17,0,0,0,0,0,0,0,0,0,100
e75b1e0dd8e1ab764dc469b683307fe9b91eed6e,0,0,0,0,0,0,0,0,0,0,0,0,0,0,106,18,0,0,0,0,0,0,0,0,0,100
ce54875d14cd7ca18753dfdf954389b4dccc606e,0,0,0,0,0,0,0,0,0,0,0,0,0,0,107,19,0,0,0,0,0,0,0,0,0,100
f7476a4b7c19947aecc61d56dc2783d19a06292a,0,0,0,0,0,0,0,0,0,0,0,0,0,0,108,20,0,0,0,0,0,0,0,0,0,100
af73bd743c7020dd4ae3fde8f0aa803d54147d84,0,0,0,0,0,0,0,0,0,0,0,0,0,0,109,21,0,0,0,0,0,0,0,0,0,100
536abe76b9a15f7e6482a82adf963b41905148fa,0,0,0,0,0,0,0,0,0,0,0,0,0,0,110,22,0,0,0,0,0,0,0,0,0,100
c14a4d705272c0b5c22b1f88f4cbd286266e5dfe,0,0,0,0,0,0,0,0,0,0,0,0,0,0,111,23,0,0,0,0,0,0,0,0,0,100
bedcc3fbec6fcd3b7dcca83569040a2fb6cb851e,0,0,0,0,0,0,0,0,0,0,0,0,0,0,310,25,0,0,0,0,0,0,0,0,0,100
add081015e9b7c9c4a3a47f084a21680f7c2be7d,0,0,0,0,0,0,0,0,0,0,0,0,0,0,0,0,0,0,0,0,0,0,0,0,0,100
0c39c29998c8b6f93174bf7458f1b4732405c3e4,0,0,0,0,0,0,0,0,0,0,0,0,0,0,311,23,0,0,0,0,0,0,0,0,0,100
383493d6c2d4f7b011030c3f00324f11042f381f,1,10,4,6,0,0,0,4,4,1156,1,1,0,277,0,0,22,22,0,2178,2178,0,8,8,0,100
d7a87936ef386476db88db323d19345b1064eae2,1,4,10,6,0,0,0,5,5,4,1,1,0,277,112,14,22,22,0,2178,2178,0,8,8,0,100
9df093c98c985dce06841e31b40de4f7b9233069,1,10,4,6,0,0,0,5,6,0,1,1,0,277,1,1,22,22,0,2178,2178,0,8,8,0,100
4105063d87178c93fd216c8eaeac85b83f506e73,0,0,0,0,0,0,0,0,0,0,0,0,0,0,113,15,0,0,0,0,0,0,0,0,0,100
1127661fd96cac6d7584ba50b717bc67bda4aa43,1,14,16,2,0,0,0,3,4,938,1,1,0,76,312,7,11,11,0,559,586,27,9,9,0,97.99554566
0d6c4e02409a6f8da776d00dc661fd178a7630b2,1,16,14,2,0,0,0,4,5,2,1,1,0,74,114,16,11,11,0,586,559,27,9,9,0,97.99554566
b0cede1e2725c16b039c18c4eb0ee4aa324d7389,0,0,0,0,0,0,0,0,0,0,0,0,0,0,115,17,0,0,0,0,0,0,0,0,0,100
aa327719837e3996e0018c0d1d221e9561d47152,1,13,15,2,0,0,0,4,6,0,1,1,0,76,313,7,11,11,0,559,586,27,9,9,0,97.99554566
616b87c07e3889609f10f08423c0e8992f8d6a43,0,0,0,0,0,0,0,0,0,0,0,0,0,0,116,18,0,0,0,0,0,0,0,0,0,100
4c85d6a48bcdd5c161f50f85ec1e7d278d1dbae0,0,0,0,0,0,0,0,0,0,0,0,0,0,0,314,8,0,0,0,0,0,0,0,0,0,100
6ac833bdc78713effd3f94b97117a5f6cd6ffb7e,4,24,23,1,0,0,0,2,28,1002,3,3,1.971009378,354,315,9,47,47,0,2315,2342,27,17,17,0,100
6ab5a8d6456dfc52d7a951ae71618a6417516a07,0,0,0,0,0,0,0,0,0,0,0,0,0,0,316,10,0,0,0,0,0,0,0,0,0,100
79a70dff924d30e634672e58ecc6cfac3265f82e,1,5,5,0,0,0,0,2,2,973,1,1,0,48,317,5,4,4,0,180,189,9,4,4,0,100
8554714235ace8f44c6ac81f6edfe1343bacee4c,0,0,0,0,0,0,0,0,0,0,0,0,0,0,117,0,0,0,0,0,0,0,0,0,0,100
92ef9e599e64e2aad1e04f5e866a922af4ac71ce,0,0,0,0,0,0,0,0,0,0,0,0,0,0,318,1,0,0,0,0,0,0,0,0,0,100
d38edb1cd4f0d4eed2e61b22f20f4a405e2cb13f,0,0,0,0,0,0,0,0,0,0,0,0,0,0,319,2,0,0,0,0,0,0,0,0,0,100
bd1f7bdabceeaaaffd3e7d9c372d40b3b714afc8,0,0,0,0,0,0,0,0,0,0,0,0,0,0,320,3,0,0,0,0,0,0,0,0,0,100
1f3566d358d94a6e6a868cd74a83a553facea355,0,0,0,0,0,0,0,0,0,0,0,0,0,0,2,0,0,0,0,0,0,0,0,0,0,100
8f4ee88fb40710d983ea3fb6ad008317f6c00936,0,0,0,0,0,0,0,0,0,0,0,0,0,0,321,3,0,0,0,0,0,0,0,0,0,100
0381deb707d206a7ad9c09381306a55ba143f648,0,0,0,0,0,0,0,0,0,0,0,0,0,0,322,4,0,0,0,0,0,0,0,0,0,100
1fca0743aa7ba9642a1cadfefb149fcba15770ac,0,0,0,0,0,0,0,0,0,0,0,0,0,0,118,1,0,0,0,0,0,0,0,0,0,100
f7c1f8026296bae1eab9768564a871ea1dd6583b,0,0,0,0,0,0,0,0,0,0,0,0,0,0,119,1,0,0,0,0,0,0,0,0,0,100
7ae549fa8e93bace810bf1c41df7cf45a72dcaa2,0,0,0,0,0,0,0,0,0,0,0,0,0,0,120,2,0,0,0,0,0,0,0,0,0,100
2831ae40364b9b4eb74807198dce1a4be005e5e3,0,0,0,0,0,0,0,0,0,0,0,0,0,0,121,3,0,0,0,0,0,0,0,0,0,100
acd515542f16eb6a570bd0796cf56256fd4df7f9,0,0,0,0,0,0,0,0,0,0,0,0,0,0,323,2,0,0,0,0,0,0,0,0,0,100
c4c39880d96b218e960258bf11488dd021ccb996,0,0,0,0,0,0,0,0,0,0,0,0,0,0,324,3,0,0,0,0,0,0,0,0,0,100
9810ba3148cfbbacdae7d92a14d9debcf1b73759,0,0,0,0,0,0,0,0,0,0,0,0,0,0,325,4,0,0,0,0,0,0,0,0,0,100
34ecba4c109b9590eea048eca09c790d298f30ce,0,0,0,0,0,0,0,0,0,0,0,0,0,0,326,5,0,0,0,0,0,0,0,0,0,100
a799cc460c93f21fe7f9a3f725f6e3cb40080300,0,0,0,0,0,0,0,0,0,0,0,0,0,0,327,6,0,0,0,0,0,0,0,0,0,100
d2ee18a7352b2b88812ec32873f11f5c02742892,0,0,0,0,0,0,0,0,0,0,0,0,0,0,328,7,0,0,0,0,0,0,0,0,0,100
cc151e654aa2b0b9d2f9d054d48f39b7d44e6c3c,0,0,0,0,0,0,0,0,0,0,0,0,0,0,329,8,0,0,0,0,0,0,0,0,0,100
38f5c58a20b534102e355ed696d5703ac1832db2,0,0,0,0,0,0,0,0,0,0,0,0,0,0,330,9,0,0,0,0,0,0,0,0,0,100
de9aab2c63142b12448dc6512a598d6d8bca1cdf,0,0,0,0,0,0,0,0,0,0,0,0,0,0,331,10,0,0,0,0,0,0,0,0,0,100
0b88c1fe977b40dcc10b7e81330cb7bf8d7bba2e,0,0,0,0,0,0,0,0,0,0,0,0,0,0,332,11,0,0,0,0,0,0,0,0,0,100
e19f0a5c094a25e221adba54f4628943a0dd551a,0,0,0,0,0,0,0,0,0,0,0,0,0,0,333,12,0,0,0,0,0,0,0,0,0,100
9c901d74e2444e59eeae2d2a975959d8804bd8fd,0,0,0,0,0,0,0,0,0,0,0,0,0,0,334,13,0,0,0,0,0,0,0,0,0,100
131f922bd3ec45ab3dc11111bcf54f6e87d6e3a6,0,0,0,0,0,0,0,0,0,0,0,0,0,0,335,14,0,0,0,0,0,0,0,0,0,100
c756eb54536499799472eabe8641404bc232d8e6,0,0,0,0,0,0,0,0,0,0,0,0,0,0,336,15,0,0,0,0,0,0,0,0,0,100
b635e05c031876e24c951b7c711ab517a6708774,0,0,0,0,0,0,0,0,0,0,0,0,0,0,337,16,0,0,0,0,0,0,0,0,0,100
5ffae27612ce148783e8c8c511700e7c0edf2590,0,0,0,0,0,0,0,0,0,0,0,0,0,0,338,17,0,0,0,0,0,0,0,0,0,100
ebf883edbf9bdcd65d1091e773dd0b544c5ab83b,0,0,0,0,0,0,0,0,0,0,0,0,0,0,339,18,0,0,0,0,0,0,0,0,0,100
96cbc068fc5c434fab148246b94a5552d3f9a7b9,0,0,0,0,0,0,0,0,0,0,0,0,0,0,340,19,0,0,0,0,0,0,0,0,0,100
0955d82f35ac54f4427e73e33a01dad455efeb76,0,0,0,0,0,0,0,0,0,0,0,0,0,0,341,20,0,0,0,0,0,0,0,0,0,100
a12ff86ca2997945666f09605d9f9af3098aa904,0,0,0,0,0,0,0,0,0,0,0,0,0,0,342,21,0,0,0,0,0,0,0,0,0,100
3324055a677e9ef238e37c11049216180f96f546,0,0,0,0,0,0,0,0,0,0,0,0,0,0,343,22,0,0,0,0,0,0,0,0,0,100
5f5e12493d01862e9b8c964f8412abcd10b5c370,0,0,0,0,0,0,0,0,0,0,0,0,0,0,344,23,0,0,0,0,0,0,0,0,0,100
fbc1c450b4cf759e7220f083e27c6cfb26020ab2,0,0,0,0,0,0,0,0,0,0,0,0,0,0,345,24,0,0,0,0,0,0,0,0,0,100
ed4c9392044f09ebc87e87df31136558d377f5a4,0,0,0,0,0,0,0,0,0,0,0,0,0,0,346,25,0,0,0,0,0,0,0,0,0,100
cab542cc7eb6618ae6ec9e0d140d621af95d9102,0,0,0,0,0,0,0,0,0,0,0,0,0,0,347,26,0,0,0,0,0,0,0,0,0,100
e8e6a6a7b4d0e015b6e120a34ef1ded964d59bd5,0,0,0,0,0,0,0,0,0,0,0,0,0,0,348,27,0,0,0,0,0,0,0,0,0,100
dbefde439b37f3bf9729db1754019f2de34a6205,0,0,0,0,0,0,0,0,0,0,0,0,0,0,349,28,0,0,0,0,0,0,0,0,0,100
73a006da344c8b7811c55d5cc5abd7b1d85a8de4,0,0,0,0,0,0,0,0,0,0,0,0,0,0,350,29,0,0,0,0,0,0,0,0,0,100
41506c889a75edcc5f4669328d566406af77d619,0,0,0,0,0,0,0,0,0,0,0,0,0,0,351,30,0,0,0,0,0,0,0,0,0,100
4160fe62fbcc6d2ec4649773f84309097c0ba6d2,0,0,0,0,0,0,0,0,0,0,0,0,0,0,352,31,0,0,0,0,0,0,0,0,0,100
8b581727461af9f30e820d7a437aa0ee2c91898c,0,0,0,0,0,0,0,0,0,0,0,0,0,0,353,32,0,0,0,0,0,0,0,0,0,100
0e79265c54d355ce12743022c9c610aa64445cae,0,0,0,0,0,0,0,0,0,0,0,0,0,0,354,33,0,0,0,0,0,0,0,0,0,100
a414673a0f435d8ad7885bf19a9b0bc7a018fea6,0,0,0,0,0,0,0,0,0,0,0,0,0,0,355,34,0,0,0,0,0,0,0,0,0,100
f22a48358f82a14ba40724f30e486fc74fac0188,0,0,0,0,0,0,0,0,0,0,0,0,0,0,356,35,0,0,0,0,0,0,0,0,0,100
124f1eaa5e8a82fd1b2084e10dcd5d7a5a4e6a1a,0,0,0,0,0,0,0,0,0,0,0,0,0,0,357,36,0,0,0,0,0,0,0,0,0,100
6576b95c02602f0526eedfde05504b0b748409d4,0,0,0,0,0,0,0,0,0,0,0,0,0,0,358,37,0,0,0,0,0,0,0,0,0,100
abe1933390fbec6b9c2273373a5683fa688a739b,0,0,0,0,0,0,0,0,0,0,0,0,0,0,359,38,0,0,0,0,0,0,0,0,0,100
2f8586bf0b56ca3be63376b89fe9ee0abd664bc7,0,0,0,0,0,0,0,0,0,0,0,0,0,0,360,39,0,0,0,0,0,0,0,0,0,100
d53000f755920887add869f29f2b80eb311a58e6,0,0,0,0,0,0,0,0,0,0,0,0,0,0,361,40,0,0,0,0,0,0,0,0,0,100
700e691940b39cca6b1a475646e6471046c96712,0,0,0,0,0,0,0,0,0,0,0,0,0,0,362,41,0,0,0,0,0,0,0,0,0,100
6a1d871807ea198a5df68f20c7337f6bae5d76f7,0,0,0,0,0,0,0,0,0,0,0,0,0,0,363,42,0,0,0,0,0,0,0,0,0,100
6654308f5beb7e22b123a5080d301543435dee7a,0,0,0,0,0,0,0,0,0,0,0,0,0,0,364,43,0,0,0,0,0,0,0,0,0,100
5ca7632212eabc01d174519eca0ddf89a54ae2b9,0,0,0,0,0,0,0,0,0,0,0,0,0,0,365,44,0,0,0,0,0,0,0,0,0,100
05476170196d20841578017de8511882f6522c7d,0,0,0,0,0,0,0,0,0,0,0,0,0,0,366,45,0,0,0,0,0,0,0,0,0,100
d5a1ea4129206783c6eb83db370497c513931ecc,0,0,0,0,0,0,0,0,0,0,0,0,0,0,367,46,0,0,0,0,0,0,0,0,0,100
c082ad6629a786bd72e800ab89d6189a1037a4c7,0,0,0,0,0,0,0,0,0,0,0,0,0,0,368,47,0,0,0,0,0,0,0,0,0,100
a3f75765dad462ebc3115f777857e25da4fe3225,0,0,0,0,0,0,0,0,0,0,0,0,0,0,369,48,0,0,0,0,0,0,0,0,0,100
fdc4d9adf39f84bcf1bfcda402cb22a8f1096d26,0,0,0,0,0,0,0,0,0,0,0,0,0,0,370,49,0,0,0,0,0,0,0,0,0,100
7d3cdcdcf948aa1f59986e540b608f6a4ef7182e,0,0,0,0,0,0,0,0,0,0,0,0,0,0,371,50,0,0,0,0,0,0,0,0,0,100
9de72fb018bb138d962b5fdd5e6e487b74c0fead,0,0,0,0,0,0,0,0,0,0,0,0,0,0,372,51,0,0,0,0,0,0,0,0,0,100
d30b725042a8d19f75216aab2a9a7e1c95b6b95e,0,0,0,0,0,0,0,0,0,0,0,0,0,0,373,52,0,0,0,0,0,0,0,0,0,100
99779be8c465c48bbcf4dc18f7bfce51179390e2,0,0,0,0,0,0,0,0,0,0,0,0,0,0,374,53,0,0,0,0,0,0,0,0,0,100
0a05af48bf9dd7b33a18aff5ef96e013720b27b9,0,0,0,0,0,0,0,0,0,0,0,0,0,0,375,54,0,0,0,0,0,0,0,0,0,100
151676d658f2b855ce740f80ccf5e64de8d4e2f1,0,0,0,0,0,0,0,0,0,0,0,0,0,0,376,55,0,0,0,0,0,0,0,0,0,100
4aae8df897d16eba9e7a309a5d2369cd099bc01d,0,0,0,0,0,0,0,0,0,0,0,0,0,0,377,56,0,0,0,0,0,0,0,0,0,100
56b9dfbded0918e166bfce3503c8c2441849ac3b,0,0,0,0,0,0,0,0,0,0,0,0,0,0,378,57,0,0,0,0,0,0,0,0,0,100
5a4ac4c30526e78e6cc9a5392f8903563a67dc7a,0,0,0,0,0,0,0,0,0,0,0,0,0,0,379,58,0,0,0,0,0,0,0,0,0,100
b2d995b2b36f6f7af060a2996e9310995973e41d,0,0,0,0,0,0,0,0,0,0,0,0,0,0,380,59,0,0,0,0,0,0,0,0,0,100
93264ada89d6217651e7f86221e5fe218a346421,0,0,0,0,0,0,0,0,0,0,0,0,0,0,381,60,0,0,0,0,0,0,0,0,0,100
cc669ecd1af30fce77cf3dc00b56a1dec879dda8,0,0,0,0,0,0,0,0,0,0,0,0,0,0,382,61,0,0,0,0,0,0,0,0,0,100
9fcb25d16a8b7d2dfd7e9f50e0d21f40e14c7f28,0,0,0,0,0,0,0,0,0,0,0,0,0,0,383,62,0,0,0,0,0,0,0,0,0,100
45f022981b5d7d9a40d0862dc1ebdae6fdef4456,0,0,0,0,0,0,0,0,0,0,0,0,0,0,384,63,0,0,0,0,0,0,0,0,0,100
a5513d893f21a0e5a32d509e5ce5e6725705e06f,0,0,0,0,0,0,0,0,0,0,0,0,0,0,385,64,0,0,0,0,0,0,0,0,0,100
fe8e39acb1335e2caf24748424aa85c4085c57af,0,0,0,0,0,0,0,0,0,0,0,0,0,0,386,65,0,0,0,0,0,0,0,0,0,100
f81a909d0f5fdb10e7100b808e01ef4bf2096394,0,0,0,0,0,0,0,0,0,0,0,0,0,0,387,66,0,0,0,0,0,0,0,0,0,100
5c7491544eb69f60d4800a7a1544d0f725439197,0,0,0,0,0,0,0,0,0,0,0,0,0,0,388,67,0,0,0,0,0,0,0,0,0,100
2803873c35b0ddc9c92c86d295edee60f52d8af1,0,0,0,0,0,0,0,0,0,0,0,0,0,0,389,68,0,0,0,0,0,0,0,0,0,100
1141a8d3cb47f6c1e3f4a44d9397e2aba7ab43a1,0,0,0,0,0,0,0,0,0,0,0,0,0,0,390,69,0,0,0,0,0,0,0,0,0,100
ae5fc27584e478da52d16f85ef7d634a3726aec5,0,0,0,0,0,0,0,0,0,0,0,0,0,0,391,70,0,0,0,0,0,0,0,0,0,100
b50582f2ac39b4f2f2e09670428448466f6257fb,0,0,0,0,0,0,0,0,0,0,0,0,0,0,392,71,0,0,0,0,0,0,0,0,0,100
fc0697224e6f9e120b7ef237b6e8fe447c39b22d,0,0,0,0,0,0,0,0,0,0,0,0,0,0,393,72,0,0,0,0,0,0,0,0,0,100
cbdac4f0b38e4afe87a9307cd0dd2a8fb0b1d3da,0,0,0,0,0,0,0,0,0,0,0,0,0,0,394,73,0,0,0,0,0,0,0,0,0,100
8028859c46a7f65503ea5bb0682957d69355d83f,0,0,0,0,0,0,0,0,0,0,0,0,0,0,395,74,0,0,0,0,0,0,0,0,0,100
a7212d8a417b9d549cd5b5a7be13bc8831d5e9e0,0,0,0,0,0,0,0,0,0,0,0,0,0,0,396,75,0,0,0,0,0,0,0,0,0,100
26bd91275eff3aefb5200025409750aa0f250e59,0,0,0,0,0,0,0,0,0,0,0,0,0,0,397,75,0,0,0,0,0,0,0,0,0,100
627900ac8d5ac7f17361bfa4dafcdef0682664ea,0,0,0,0,0,0,0,0,0,0,0,0,0,0,398,76,0,0,0,0,0,0,0,0,0,100
1a2b69384c9c3401b51c0127ff6d063518290d76,0,0,0,0,0,0,0,0,0,0,0,0,0,0,399,77,0,0,0,0,0,0,0,0,0,100
b8ce2493d365dd72a426ebba48310995fe22468c,0,0,0,0,0,0,0,0,0,0,0,0,0,0,400,77,0,0,0,0,0,0,0,0,0,100
cfe52f2fa178e0ac4bbb7b761551af88fd658ed0,0,0,0,0,0,0,0,0,0,0,0,0,0,0,401,78,0,0,0,0,0,0,0,0,0,100
d9940489d2f849d36af396d603f6170ab560e505,0,0,0,0,0,0,0,0,0,0,0,0,0,0,122,3,0,0,0,0,0,0,0,0,0,100
727e5be85c0326d9c009d9cdc361fe47ffa201ad,0,0,0,0,0,0,0,0,0,0,0,0,0,0,123,1,0,0,0,0,0,0,0,0,0,100
45ee3cf097f35735d49b6861c7b9fe04a3d7b562,0,0,0,0,0,0,0,0,0,0,0,0,0,0,402,0,0,0,0,0,0,0,0,0,0,100
0ecb6685c2bb8fd2e8857967954d616a59cc2389,0,0,0,0,0,0,0,0,0,0,0,0,0,0,403,1,0,0,0,0,0,0,0,0,0,100
33c1eab1133d8f286fb3fd18a105789e7ebee44a,0,0,0,0,0,0,0,0,0,0,0,0,0,0,404,2,0,0,0,0,0,0,0,0,0,100
4d0cd66a6269eb02fceaabdb11d70fd38d433474,17,66,81,15,0,0,0,4,39,1769,3,12,3.600678121,1875,405,3,198,199,1,15556,15719,163,95,95,0,100
476972d2e3c4b297ac66e711c121ce80fc621d50,0,0,0,0,0,0,0,0,0,0,0,0,0,0,406,4,0,0,0,0,0,0,0,0,0,100
eb70eb820cbccb5d82750cd2f6541444bbb2e0dd,0,0,0,0,0,0,0,0,0,0,0,0,0,0,407,5,0,0,0,0,0,0,0,0,0,100
b391c76502a5294284fe761de86f952fd91434a5,0,0,0,0,0,0,0,0,0,0,0,0,0,0,45,0,0,0,0,0,0,0,0,0,0,100
f4a71d084958f2e1865efc8ac8115cd51e1e57d9,0,0,0,0,0,0,0,0,0,0,0,0,0,0,124,0,0,0,0,0,0,0,0,0,0,100
a5e820c95c4f420d8f44dfc827fb2128c9f0750d,0,0,0,0,0,0,0,0,0,0,0,0,0,0,408,0,0,0,0,0,0,0,0,0,0,100
c5934c2f73cc0b07ca686f76330e085893283390,0,0,0,0,0,0,0,0,0,0,0,0,0,0,409,1,0,0,0,0,0,0,0,0,0,100
e73fdb8694e80e1e95a1213097434749726fd8af,6,13,11,2,0,0,0,2,3,1566,1,5,2.182321322,632,410,2,84,84,0,5846,5793,53,29,29,0,100
2f6399f3fd36f5074c2f4892407ed9d4f889fa07,0,0,0,0,0,0,0,0,0,0,0,0,0,0,411,3,0,0,0,0,0,0,0,0,0,100
25d0ac866edd4ff496950835746fce2519d379bf,0,0,0,0,0,0,0,0,0,0,0,0,0,0,41,0,0,0,0,0,0,0,0,0,0,100
edaddde9422a142ce07570b74278b42effd1853c,0,0,0,0,0,0,0,0,0,0,0,0,0,0,47,1,0,0,0,0,0,0,0,0,0,100
3351b75b3fbae173a2919c8c61268707ed193ec8,0,0,0,0,0,0,0,0,0,0,0,0,0,0,48,2,0,0,0,0,0,0,0,0,0,100
b5fe4aab22e7867ae057a6cdb1610cfa17555311,0,0,0,0,0,0,0,0,0,0,0,0,0,0,37,0,0,0,0,0,0,0,0,0,0,100
220c47493d30c0928e116af9210ab1786068ab13,0,0,0,0,0,0,0,0,0,0,0,0,0,0,38,0,0,0,0,0,0,0,0,0,0,100
e87567af05884506a37e8751df0fa7f41a9d94d0,0,0,0,0,0,0,0,0,0,0,0,0,0,0,412,0,0,0,0,0,0,0,0,0,0,100
02ff22f0bbf35c3c25094433cf66261985b3ce4d,63,155,156,1,0,0,0,2,38,1892,5,45,5.39935871,9611,0,0,1282,1282,0,80898,81249,351,584,584,0,100
b5c28791a001af4c4da4f3cd31979f58173cf0ec,25,207,150,57,0,0,0,7,50,2334,1,10,3.515118136,5546,1,1,985,985,0,33141,33141,0,464,464,0,100
20fdf9b9fb25dcae9e8b83242d777c373605576f,0,0,0,0,0,0,0,0,0,0,0,0,0,0,413,1,0,0,0,0,0,0,0,0,0,100
c9ee7282d0c695a6eb76dda9590a5386309c758a,0,0,0,0,0,0,0,0,0,0,0,0,0,0,39,1,0,0,0,0,0,0,0,0,0,100
1f5e36f249aabc68495ec15f64f5ed6754d9f1e2,0,0,0,0,0,0,0,0,0,0,0,0,0,0,40,2,0,0,0,0,0,0,0,0,0,100
292b718a633efae5ff1b47772b9dd7bf9f1ca6da,1,1,1,0,0,0,0,2,2,1436,1,1,0,121,414,2,22,22,0,580,579,1,16,16,0,100
a511d6f45e88a133c16469fefb8087fa2dab7d94,0,0,0,0,0,0,0,0,0,0,0,0,0,0,41,2,0,0,0,0,0,0,0,0,0,100
00a2883ec69b0807a5486c61dfcc7ef27f35ddc6,0,0,0,0,0,0,0,0,0,0,0,0,0,0,42,1,0,0,0,0,0,0,0,0,0,100
8c614a1661f58b42e84acf2b65de9e11703db7c2,0,0,0,0,0,0,0,0,0,0,0,0,0,0,415,0,0,0,0,0,0,0,0,0,0,100
8a0a074898c345b73b17a058301acb01352db12b,0,0,0,0,0,0,0,0,0,0,0,0,0,0,416,1,0,0,0,0,0,0,0,0,0,100
1e081287671b186915148bedc05aae4384230c8f,0,0,0,0,0,0,0,0,0,0,0,0,0,0,417,2,0,0,0,0,0,0,0,0,0,100
b3b72cb658ed6ad59a092eb554b06898163a1375,0,0,0,0,0,0,0,0,0,0,0,0,0,0,0,0,0,0,0,0,0,0,0,0,0,100
3e2d63c10b66a2e24ae65a575a7c2215f72e61cb,0,0,0,0,0,0,0,0,0,0,0,0,0,0,1,1,0,0,0,0,0,0,0,0,0,100
b289f4657fb8fe16f60f806ef2b2dee86f666e74,8,62,37,25,0,0,0,2,45,2395,2,6,2.901098086,1674,418,1,352,348,4,13422,13265,157,170,168,2,97.40791269
8e0e8b5572e0d24c1930ed60fec6d02693b41575,0,0,0,0,0,0,0,0,0,0,0,0,0,0,126,0,0,0,0,0,0,0,0,0,0,100
19182a81dcb76a3b7df55aad1d8d1086e2df7c0f,0,0,0,0,0,0,0,0,0,0,0,0,0,0,127,1,0,0,0,0,0,0,0,0,0,100
84e90ed23327355f92abeb4aede8f3a9ee5b5867,0,0,0,0,0,0,0,0,0,0,0,0,0,0,2,2,0,0,0,0,0,0,0,0,0,100
034790cce40fcee2b7a875c482345d35f7c0fa8d,4,379,0,379,4,0,4,1,1,0,2,2,1.993830231,0,128,2,4,0,4,1339,0,1339,4,0,4,99.86197378
f8596b8668ca5104a28efd54d0ceaab51a619c89,0,0,0,0,0,0,0,0,0,0,0,0,0,0,129,3,0,0,0,0,0,0,0,0,0,100
9a31923eae3727d9d91bd2c2ed8df12a616a577e,0,0,0,0,0,0,0,0,0,0,0,0,0,0,3,0,0,0,0,0,0,0,0,0,0,100
b67034e22b04124c3ec449ef5e6f3cb0b7224e0b,0,0,0,0,0,0,0,0,0,0,0,0,0,0,4,1,0,0,0,0,0,0,0,0,0,100
991583abf6534a0a7118bfea3af60bf3170397d3,0,0,0,0,0,0,0,0,0,0,0,0,0,0,130,2,0,0,0,0,0,0,0,0,0,100
fa89753707d3ad8eba4f4328e164b832d4f699b6,0,0,0,0,0,0,0,0,0,0,0,0,0,0,131,3,0,0,0,0,0,0,0,0,0,100
22c5e86480c124c95b2a4698e23a0d98cd7a474b,0,0,0,0,0,0,0,0,0,0,0,0,0,0,132,4,0,0,0,0,0,0,0,0,0,100
fa9aeacccc11e50a166d290521030305d51fa787,0,0,0,0,0,0,0,0,0,0,0,0,0,0,5,2,0,0,0,0,0,0,0,0,0,100
771339c82c36929d5b331215fbe792626de373af,0,0,0,0,0,0,0,0,0,0,0,0,0,0,6,3,0,0,0,0,0,0,0,0,0,100
7a3617b33eb397b0d2f44e3a1456f266196c1282,0,0,0,0,0,0,0,0,0,0,0,0,0,0,7,4,0,0,0,0,0,0,0,0,0,100
f4631528b6d017d974ed46d191651e1f7edbe6a7,0,0,0,0,0,0,0,0,0,0,0,0,0,0,8,5,0,0,0,0,0,0,0,0,0,100
60bb751926524b62be52f9b4c9d1c70d735a0afc,0,0,0,0,0,0,0,0,0,0,0,0,0,0,9,6,0,0,0,0,0,0,0,0,0,100
a70a8733c6db0e5dcf02384f8dd474469c42e7c5,0,0,0,0,0,0,0,0,0,0,0,0,0,0,10,5,0,0,0,0,0,0,0,0,0,100
52aceaf68cc198f6d5c3fb77ac16e21abce6e6dc,0,0,0,0,0,0,0,0,0,0,0,0,0,0,11,1,0,0,0,0,0,0,0,0,0,100
5afdc68e0a25e9f66a0d707a7f76d46d9603b614,0,0,0,0,0,0,0,0,0,0,0,0,0,0,12,2,0,0,0,0,0,0,0,0,0,100
ba37a8aa20d0969d2db5d810ecd6d68f7ea57978,0,0,0,0,0,0,0,0,0,0,0,0,0,0,13,3,0,0,0,0,0,0,0,0,0,100
a2cbd15709e8f5789711d171afc5206fa6ec63ed,0,0,0,0,0,0,0,0,0,0,0,0,0,0,49,0,0,0,0,0,0,0,0,0,0,100
67f3a65cf6b68a2c6ac34130ab16d1a118006f45,0,0,0,0,0,0,0,0,0,0,0,0,0,0,133,0,0,0,0,0,0,0,0,0,0,100
189dfe577236c009c3f66b611728395108c69801,0,0,0,0,0,0,0,0,0,0,0,0,0,0,134,1,0,0,0,0,0,0,0,0,0,100
bd0579d4c69e4c38955e82f12d7fcef5e537fdb5,0,0,0,0,0,0,0,0,0,0,0,0,0,0,135,2,0,0,0,0,0,0,0,0,0,100
d36db1d2d775d9b6ade59a451d4746f39b1a354a,0,0,0,0,0,0,0,0,0,0,0,0,0,0,50,1,0,0,0,0,0,0,0,0,0,100
1eacd7f9d6e34b681e8f789ce83b06a45dc92d55,0,0,0,0,0,0,0,0,0,0,0,0,0,0,136,3,0,0,0,0,0,0,0,0,0,100
0f4b3d97cfc651a4bc052515b260648cd0093ac2,0,0,0,0,0,0,0,0,0,0,0,0,0,0,137,4,0,0,0,0,0,0,0,0,0,100
b8f9d26db736268ec1b268cebaec1bed2e860523,0,0,0,0,0,0,0,0,0,0,0,0,0,0,51,2,0,0,0,0,0,0,0,0,0,100
51b1ab99a86311078aa205f32ad178acdb824fc9,0,0,0,0,0,0,0,0,0,0,0,0,0,0,138,5,0,0,0,0,0,0,0,0,0,100
4d1464ef4d7a1d278c828d29a906e8f431a2fcb5,0,0,0,0,0,0,0,0,0,0,0,0,0,0,139,6,0,0,0,0,0,0,0,0,0,100
eb278dc3d3789e3e945af77d48551aecc15ab33b,0,0,0,0,0,0,0,0,0,0,0,0,0,0,140,7,0,0,0,0,0,0,0,0,0,100
d848625df7144ef14dd90300adcf253f08aa28e4,0,0,0,0,0,0,0,0,0,0,0,0,0,0,14,4,0,0,0,0,0,0,0,0,0,100
4e0106ae5edafbef7b1411d66bc5f9e9bf44045a,0,0,0,0,0,0,0,0,0,0,0,0,0,0,15,5,0,0,0,0,0,0,0,0,0,100
5bccac1193a071d9406283969ff395990a8495c5,0,0,0,0,0,0,0,0,0,0,0,0,0,0,16,6,0,0,0,0,0,0,0,0,0,100
7883ebc26ea40e62d8c73797e15a4ba801ae6348,0,0,0,0,0,0,0,0,0,0,0,0,0,0,52,3,0,0,0,0,0,0,0,0,0,100
9ed9b4af4153fd3fed42d928c505d05335b29b92,0,0,0,0,0,0,0,0,0,0,0,0,0,0,53,4,0,0,0,0,0,0,0,0,0,100
c842ddf556f6efe12942d2f44778091b2567d145,0,0,0,0,0,0,0,0,0,0,0,0,0,0,54,5,0,0,0,0,0,0,0,0,0,100
3f2e1512f597ae416c265284d6b7817e9adfad5c,0,0,0,0,0,0,0,0,0,0,0,0,0,0,55,6,0,0,0,0,0,0,0,0,0,100
aa95461e567f9981a6b886856d49b46acd366e9c,0,0,0,0,0,0,0,0,0,0,0,0,0,0,56,7,0,0,0,0,0,0,0,0,0,100
58244008986b7ab35c1bd5c87bd6065c2e61bdec,0,0,0,0,0,0,0,0,0,0,0,0,0,0,57,8,0,0,0,0,0,0,0,0,0,100
a89500f33ff35f08f9d15e73eccf6ae0e1c69f81,0,0,0,0,0,0,0,0,0,0,0,0,0,0,58,9,0,0,0,0,0,0,0,0,0,100
e1cdfa75448b501c49c46767f866fc8e263c2030,0,0,0,0,0,0,0,0,0,0,0,0,0,0,59,10,0,0,0,0,0,0,0,0,0,100
565af6c11ca7b97b3a0b317c09cd964978ec8b6e,0,0,0,0,0,0,0,0,0,0,0,0,0,0,60,11,0,0,0,0,0,0,0,0,0,100
8bc43395cff7a0060eaf33f6b282a673b4e35051,0,0,0,0,0,0,0,0,0,0,0,0,0,0,61,12,0,0,0,0,0,0,0,0,0,100
3a8a64b6a9e8159855d1f4fcfc681cae00489a17,0,0,0,0,0,0,0,0,0,0,0,0,0,0,62,13,0,0,0,0,0,0,0,0,0,100
dc7b6f493df093aa30e418224950c467d02725ab,0,0,0,0,0,0,0,0,0,0,0,0,0,0,63,14,0,0,0,0,0,0,0,0,0,100
7d0e6225cbc8a6f186af40a94098fbf91e9f81df,0,0,0,0,0,0,0,0,0,0,0,0,0,0,64,15,0,0,0,0,0,0,0,0,0,100
a8ff16f2788f584b806721a479edb16ea9810897,0,0,0,0,0,0,0,0,0,0,0,0,0,0,65,16,0,0,0,0,0,0,0,0,0,100
f4f3bfa31ddcd9cffdccd5bc7c60cb22d41ba48e,0,0,0,0,0,0,0,0,0,0,0,0,0,0,66,17,0,0,0,0,0,0,0,0,0,100
67e0ccf7a0841481a8b3dcb3b814a356dbccce0b,0,0,0,0,0,0,0,0,0,0,0,0,0,0,67,18,0,0,0,0,0,0,0,0,0,100
74d2f886116ed5284e67751a62598fd9dc3ba6b7,0,0,0,0,0,0,0,0,0,0,0,0,0,0,68,19,0,0,0,0,0,0,0,0,0,100
857c96d2cd5a120791f5303ad0fdf45f48d2d5dc,0,0,0,0,0,0,0,0,0,0,0,0,0,0,69,20,0,0,0,0,0,0,0,0,0,100
a6b007b65d7d90fac2f88ba857551d2c5872277b,0,0,0,0,0,0,0,0,0,0,0,0,0,0,70,21,0,0,0,0,0,0,0,0,0,100
08248ada165e8c3ebc96e4917129486490eb05f2,0,0,0,0,0,0,0,0,0,0,0,0,0,0,71,22,0,0,0,0,0,0,0,0,0,100
ca24f0c44931aaf6ea57ef97384e12e39ccc561d,0,0,0,0,0,0,0,0,0,0,0,0,0,0,17,7,0,0,0,0,0,0,0,0,0,100
e42e26c5d93e42cb340d744325af219f3d4354f9,0,0,0,0,0,0,0,0,0,0,0,0,0,0,72,23,0,0,0,0,0,0,0,0,0,100
d9bc8c5241252fc7a9b8415d38e4896eb8db8bc7,0,0,0,0,0,0,0,0,0,0,0,0,0,0,73,24,0,0,0,0,0,0,0,0,0,100
b32b6d9731481f00ea3b96e3129b9bc96e34eff5,0,0,0,0,0,0,0,0,0,0,0,0,0,0,141,8,0,0,0,0,0,0,0,0,0,100
f8f8f127231781bca0b981c26e2387bfad3958c2,0,0,0,0,0,0,0,0,0,0,0,0,0,0,43,0,0,0,0,0,0,0,0,0,0,100
2418038df19060c6efffff5f93909210ea68e699,0,0,0,0,0,0,0,0,0,0,0,0,0,0,74,23,0,0,0,0,0,0,0,0,0,100
07c56f2a9ea1deb98885198d80cd6359d6b4e5a5,0,0,0,0,0,0,0,0,0,0,0,0,0,0,75,24,0,0,0,0,0,0,0,0,0,100
66bfc6dcf84701eda4f4bbfd326cf1325f44dc2b,0,0,0,0,0,0,0,0,0,0,0,0,0,0,76,24,0,0,0,0,0,0,0,0,0,100
d18fcead78568f18615e2c1e43d50b41ef444df1,0,0,0,0,0,0,0,0,0,0,0,0,0,0,77,11,0,0,0,0,0,0,0,0,0,100
6b5ae4d443465cd720e86d51b1bd2d377c0c4929,0,0,0,0,0,0,0,0,0,0,0,0,0,0,78,12,0,0,0,0,0,0,0,0,0,100
1f3156309f797fe7021383e534ffe5c2a94079f8,0,0,0,0,0,0,0,0,0,0,0,0,0,0,79,7,0,0,0,0,0,0,0,0,0,100
049619464145feb44805877cea337a4d84179083,0,0,0,0,0,0,0,0,0,0,0,0,0,0,142,1,0,0,0,0,0,0,0,0,0,100
9eb68e5319ad6f7692779e566206a159f98be8b9,0,0,0,0,0,0,0,0,0,0,0,0,0,0,143,2,0,0,0,0,0,0,0,0,0,100
0ba81db1234e7603fa0ae4a9fd0fb0881a0b523c,0,0,0,0,0,0,0,0,0,0,0,0,0,0,80,8,0,0,0,0,0,0,0,0,0,100
d337d994263b9c268e8131b14dda989d0dd211b8,0,0,0,0,0,0,0,0,0,0,0,0,0,0,81,9,0,0,0,0,0,0,0,0,0,100
2367fde821d5f6b052038322a60b0146ac3b3a08,0,0,0,0,0,0,0,0,0,0,0,0,0,0,82,10,0,0,0,0,0,0,0,0,0,100
1199e51179bf858ccc3c809b332a0cc9cd950adb,0,0,0,0,0,0,0,0,0,0,0,0,0,0,83,11,0,0,0,0,0,0,0,0,0,100
d7cdbb009015475c91f8ada27b9834c1473bc91b,0,0,0,0,0,0,0,0,0,0,0,0,0,0,84,12,0,0,0,0,0,0,0,0,0,100
bb781665d9055121a8fc33257a47f5cbad4ed538,0,0,0,0,0,0,0,0,0,0,0,0,0,0,85,13,0,0,0,0,0,0,0,0,0,100
7a7930e856d0119b3650a34e7007cdfc96bb35a0,0,0,0,0,0,0,0,0,0,0,0,0,0,0,86,14,0,0,0,0,0,0,0,0,0,100
717b1939a8e9d5d66a8746d03a178f4987e8399b,0,0,0,0,0,0,0,0,0,0,0,0,0,0,87,10,0,0,0,0,0,0,0,0,0,100
28c1d20e21dcb97235a0c4dd5a0e22bf1783f6cc,0,0,0,0,0,0,0,0,0,0,0,0,0,0,88,11,0,0,0,0,0,0,0,0,0,100
3b36ba28288ab08900fad23bfdf8a55057f63658,0,0,0,0,0,0,0,0,0,0,0,0,0,0,89,12,0,0,0,0,0,0,0,0,0,100
c0f58903b7aa29442814e1f7080858bb6ab9e96e,0,0,0,0,0,0,0,0,0,0,0,0,0,0,90,13,0,0,0,0,0,0,0,0,0,100
999851e2a805e4c706dba8718c00e0458e2446d2,0,0,0,0,0,0,0,0,0,0,0,0,0,0,91,14,0,0,0,0,0,0,0,0,0,100
700c270ea554ef33e31a74874199a1be13ee4ae0,0,0,0,0,0,0,0,0,0,0,0,0,0,0,92,15,0,0,0,0,0,0,0,0,0,100
7b71b3160e105e7cd7ceac8b50028b5c2a945689,0,0,0,0,0,0,0,0,0,0,0,0,0,0,93,16,0,0,0,0,0,0,0,0,0,100
75b8cbba3e1364d9d1d8af3c91e5dd8bc00a005e,0,0,0,0,0,0,0,0,0,0,0,0,0,0,94,17,0,0,0,0,0,0,0,0,0,100
683990bfdeabb4ce6e0de00844d598204bc30cd8,0,0,0,0,0,0,0,0,0,0,0,0,0,0,95,18,0,0,0,0,0,0,0,0,0,100
267b34edd472b0329e0d5e8a9122d799779bdb08,0,0,0,0,0,0,0,0,0,0,0,0,0,0,96,19,0,0,0,0,0,0,0,0,0,100
aa63105983037819b70fabc84fa576cc8c761634,0,0,0,0,0,0,0,0,0,0,0,0,0,0,97,20,0,0,0,0,0,0,0,0,0,100
2d41ae3daddd77265c86a231d4f9a2ddadab4b5c,0,0,0,0,0,0,0,0,0,0,0,0,0,0,98,21,0,0,0,0,0,0,0,0,0,100
6b2e312599c2ae285d682dced977eb82db9c2d4c,0,0,0,0,0,0,0,0,0,0,0,0,0,0,99,20,0,0,0,0,0,0,0,0,0,100
b77f89f5da98142eb021e0c5ab3fbdccd5a8bcb9,0,0,0,0,0,0,0,0,0,0,0,0,0,0,100,21,0,0,0,0,0,0,0,0,0,100
3d0c271df2713f125a435f30f399a6865f87636b,0,0,0,0,0,0,0,0,0,0,0,0,0,0,144,1,0,0,0,0,0,0,0,0,0,100
c408c74ba0e96e738dfe1ab62190014030c88ebd,0,0,0,0,0,0,0,0,0,0,0,0,0,0,101,9,0,0,0,0,0,0,0,0,0,100
e2d0e14a3490904d74ab2dbac16ee955c3bc09d4,0,0,0,0,0,0,0,0,0,0,0,0,0,0,102,10,0,0,0,0,0,0,0,0,0,100
a69fa9d4d7e442975882bec6ead383474c4ef003,0,0,0,0,0,0,0,0,0,0,0,0,0,0,103,2,0,0,0,0,0,0,0,0,0,100
54ba6c706d36d0e0c100dce05804486efb8a5cc0,0,0,0,0,0,0,0,0,0,0,0,0,0,0,104,3,0,0,0,0,0,0,0,0,0,100
059226746276a263f85d5c81d8173123ce81d45d,0,0,0,0,0,0,0,0,0,0,0,0,0,0,105,4,0,0,0,0,0,0,0,0,0,100
2333d08acc1fe476775b4ffa471cf6a1a8a10a43,0,0,0,0,0,0,0,0,0,0,0,0,0,0,106,5,0,0,0,0,0,0,0,0,0,100
13019f7e4e0a192ffd9dae430fa83a9d6cff84c7,0,0,0,0,0,0,0,0,0,0,0,0,0,0,107,6,0,0,0,0,0,0,0,0,0,100
84d43790f97988d034b33c55f76ce966949c3168,0,0,0,0,0,0,0,0,0,0,0,0,0,0,419,0,0,0,0,0,0,0,0,0,0,100
98ca93ed31ea9d84f925ef89886ecd52584da6c7,0,0,0,0,0,0,0,0,0,0,0,0,0,0,108,7,0,0,0,0,0,0,0,0,0,100
eef02000ad748d5a28f418c2da5fcff877de542f,0,0,0,0,0,0,0,0,0,0,0,0,0,0,109,8,0,0,0,0,0,0,0,0,0,100
31b611f6f4a773e944fabf827d9ff747bc9624dc,0,0,0,0,0,0,0,0,0,0,0,0,0,0,110,9,0,0,0,0,0,0,0,0,0,100
cca62c5a600703b99a6291440193dd233103d4e4,0,0,0,0,0,0,0,0,0,0,0,0,0,0,111,10,0,0,0,0,0,0,0,0,0,100
2e5093ea269b2d0e6a57e16db24f261bbf39b1ce,0,0,0,0,0,0,0,0,0,0,0,0,0,0,112,11,0,0,0,0,0,0,0,0,0,100
724b9070cbde160d237f58a5a178125f00dcfc84,0,0,0,0,0,0,0,0,0,0,0,0,0,0,0,0,0,0,0,0,0,0,0,0,0,100
54ef150e8f31ce2292ea02902674d86c9c35ffd7,0,0,0,0,0,0,0,0,0,0,0,0,0,0,1,1,0,0,0,0,0,0,0,0,0,100
98be68ac7fde5d22b502a8cab98069e13f363abb,0,0,0,0,0,0,0,0,0,0,0,0,0,0,0,0,0,0,0,0,0,0,0,0,0,100
eae79da4c2642a195a63462f8781e56600c1295e,0,0,0,0,0,0,0,0,0,0,0,0,0,0,18,0,0,0,0,0,0,0,0,0,0,100
4d059f85f7341130193a74d18a951fe3110f884b,0,0,0,0,0,0,0,0,0,0,0,0,0,0,19,1,0,0,0,0,0,0,0,0,0,100
db5a1d5ce5a6e4a3999cf2b943e29e9b64bbed5d,0,0,0,0,0,0,0,0,0,0,0,0,0,0,52,0,0,0,0,0,0,0,0,0,0,100
f2f8cba4279b86b3a902fcac27e6f5db1d1e49ba,0,0,0,0,0,0,0,0,0,0,0,0,0,0,114,13,0,0,0,0,0,0,0,0,0,100
a5c7cec9fbe24112c71cef5bc428b342a4a78ac3,0,0,0,0,0,0,0,0,0,0,0,0,0,0,115,14,0,0,0,0,0,0,0,0,0,100
e16bcc3d152eb6cf9f512f75bbf5e009b00fe992,0,0,0,0,0,0,0,0,0,0,0,0,0,0,116,15,0,0,0,0,0,0,0,0,0,100
c397ef7f7b104a56980d928466022ad2b59ac297,0,0,0,0,0,0,0,0,0,0,0,0,0,0,115,14,0,0,0,0,0,0,0,0,0,100
2a8139dcfb3ad523aeaced225c162ceabde7dcff,0,0,0,0,0,0,0,0,0,0,0,0,0,0,118,17,0,0,0,0,0,0,0,0,0,100
08e02602e947ff945b9bd73ab5f0b45863df3e53,0,0,0,0,0,0,0,0,0,0,0,0,0,0,20,2,0,0,0,0,0,0,0,0,0,100
a60c79e7a2f32aa3e3c78d184e4219360f24869e,0,0,0,0,0,0,0,0,0,0,0,0,0,0,20,2,0,0,0,0,0,0,0,0,0,100
bcdad32ac3d250d7c42195d9bfa5e48fcbd4fe1f,0,0,0,0,0,0,0,0,0,0,0,0,0,0,21,3,0,0,0,0,0,0,0,0,0,100
4c05501b6c10074149b93500beae9fa5f0d421ca,0,0,0,0,0,0,0,0,0,0,0,0,0,0,22,4,0,0,0,0,0,0,0,0,0,100
64108c94d9918f031bb17b78403db3866eaf5dc6,0,0,0,0,0,0,0,0,0,0,0,0,0,0,23,5,0,0,0,0,0,0,0,0,0,100
8f879548a3e310b960b6b555bd8def40cf60130f,0,0,0,0,0,0,0,0,0,0,0,0,0,0,22,4,0,0,0,0,0,0,0,0,0,100
660036ebba42b739162ec4456ca4da4cea64af2a,0,0,0,0,0,0,0,0,0,0,0,0,0,0,24,6,0,0,0,0,0,0,0,0,0,100
cd830b69bbc31addbf2375d92fcd70ce09c6543e,0,0,0,0,0,0,0,0,0,0,0,0,0,0,25,7,0,0,0,0,0,0,0,0,0,100
0b2d3a15f0adfd5b847dce8e6e33c82797a1f906,0,0,0,0,0,0,0,0,0,0,0,0,0,0,26,8,0,0,0,0,0,0,0,0,0,100
a98bd9db539416484c89cf49d7433179d5bc9a43,0,0,0,0,0,0,0,0,0,0,0,0,0,0,27,9,0,0,0,0,0,0,0,0,0,100
c89e3126c4d85fcdfcdee657b87fd48b6671ba38,0,0,0,0,0,0,0,0,0,0,0,0,0,0,28,10,0,0,0,0,0,0,0,0,0,100
3958af3df16fd7d8546a8d7eaba2e3c692644f70,0,0,0,0,0,0,0,0,0,0,0,0,0,0,30,12,0,0,0,0,0,0,0,0,0,100
00ef278cd05d11120faf6305b773564b9b0ef671,0,0,0,0,0,0,0,0,0,0,0,0,0,0,23,5,0,0,0,0,0,0,0,0,0,100
7fcf655aa45d49a549a537f4449d2431883ce5b6,0,0,0,0,0,0,0,0,0,0,0,0,0,0,0,0,0,0,0,0,0,0,0,0,0,100
506212ba1b991b8681b35b73abe89537643158c4,0,0,0,0,0,0,0,0,0,0,0,0,0,0,1,1,0,0,0,0,0,0,0,0,0,100
e2549b78cd17ecdaeaec5ca67bad2474a7cb2d60,0,0,0,0,0,0,0,0,0,0,0,0,0,0,2,2,0,0,0,0,0,0,0,0,0,100
ae8e3bbe62acb5473ea59e78e15982ad465b9334,0,0,0,0,0,0,0,0,0,0,0,0,0,0,21,3,0,0,0,0,0,0,0,0,0,100
a04a32fd12430d3460690ef057e98ecf628bc198,0,0,0,0,0,0,0,0,0,0,0,0,0,0,32,14,0,0,0,0,0,0,0,0,0,100
ac56b5512356ed4a2c590808ee0f68bb512afa10,0,0,0,0,0,0,0,0,0,0,0,0,0,0,33,15,0,0,0,0,0,0,0,0,0,100
0e718ec99681319487c2b7eade17bb58beb1ff3d,0,0,0,0,0,0,0,0,0,0,0,0,0,0,34,16,0,0,0,0,0,0,0,0,0,100
3a724debcff6c26765a77300d79b28b32b7e3398,0,0,0,0,0,0,0,0,0,0,0,0,0,0,3,3,0,0,0,0,0,0,0,0,0,100
9c0314528b4fec247ec92654bfcc1471a880e578,0,0,0,0,0,0,0,0,0,0,0,0,0,0,4,4,0,0,0,0,0,0,0,0,0,100
c81fc8b72b2fa36469b839423fddab13feba869d,0,0,0,0,0,0,0,0,0,0,0,0,0,0,5,5,0,0,0,0,0,0,0,0,0,100
9759e024ee93bbcbef142ab15b92e71207096798,0,0,0,0,0,0,0,0,0,0,0,0,0,0,6,6,0,0,0,0,0,0,0,0,0,100
2346425bdb4c11133bda8759f106c7637007d702,0,0,0,0,0,0,0,0,0,0,0,0,0,0,7,7,0,0,0,0,0,0,0,0,0,100
747d94b1da72c7e3b909087b8f04e03d760df346,0,0,0,0,0,0,0,0,0,0,0,0,0,0,8,8,0,0,0,0,0,0,0,0,0,100
b582dc5291512ace348540491db8671d7d41c0a2,0,0,0,0,0,0,0,0,0,0,0,0,0,0,35,17,0,0,0,0,0,0,0,0,0,100
516e3fb9ab340a2e641770e32d6511c8c7b365b6,0,0,0,0,0,0,0,0,0,0,0,0,0,0,36,18,0,0,0,0,0,0,0,0,0,100
c8bdf2efc66d9dbba07d0c50d8369fb721581149,0,0,0,0,0,0,0,0,0,0,0,0,0,0,37,19,0,0,0,0,0,0,0,0,0,100
0b38f5167297b3654f1f5fa5e79ce6e8d086ae53,0,0,0,0,0,0,0,0,0,0,0,0,0,0,38,20,0,0,0,0,0,0,0,0,0,100
6f135ee6deeb8f70f33bde17c2353dd2db9dedb1,0,0,0,0,0,0,0,0,0,0,0,0,0,0,39,21,0,0,0,0,0,0,0,0,0,100
bd360a2b34432f01cfa53bb7854c5f49854b73ca,0,0,0,0,0,0,0,0,0,0,0,0,0,0,40,22,0,0,0,0,0,0,0,0,0,100
38cc9e2706e07612cac9b400aac19001253e2fee,0,0,0,0,0,0,0,0,0,0,0,0,0,0,22,4,0,0,0,0,0,0,0,0,0,100
a84294211d9f426e7bc8709f6f876ce23b21ba6d,0,0,0,0,0,0,0,0,0,0,0,0,0,0,41,23,0,0,0,0,0,0,0,0,0,100
6e5359d59ac02f9df18176ce465de6afe7b2078f,0,0,0,0,0,0,0,0,0,0,0,0,0,0,42,24,0,0,0,0,0,0,0,0,0,100
fc433408f4f2c9b6065598fa27fe7f9e1a3533a0,0,0,0,0,0,0,0,0,0,0,0,0,0,0,43,25,0,0,0,0,0,0,0,0,0,100
c4feca039d93cfa10c074d732511ec3dfa86b69e,0,0,0,0,0,0,0,0,0,0,0,0,0,0,44,26,0,0,0,0,0,0,0,0,0,100
3c53a6dcfb0cc8e25d7da4b62e8ed056a7629b98,0,0,0,0,0,0,0,0,0,0,0,0,0,0,45,27,0,0,0,0,0,0,0,0,0,100
f463a5c4cc832932663afe5331cc5ad379abc599,0,0,0,0,0,0,0,0,0,0,0,0,0,0,46,28,0,0,0,0,0,0,0,0,0,100
9c69c28af0494875d7e9417b82a11b79a063c146,0,0,0,0,0,0,0,0,0,0,0,0,0,0,48,30,0,0,0,0,0,0,0,0,0,100
a8a719efaedd453059241b15fbbd99a9e9ceb4c8,0,0,0,0,0,0,0,0,0,0,0,0,0,0,119,6,0,0,0,0,0,0,0,0,0,100
a2b60567ac55f38f942f9fabd3981c1f8b784723,0,0,0,0,0,0,0,0,0,0,0,0,0,0,120,7,0,0,0,0,0,0,0,0,0,100
f71020f41107fd4ac621c9814313e5e2cd0b014b,0,0,0,0,0,0,0,0,0,0,0,0,0,0,51,28,0,0,0,0,0,0,0,0,0,100
d5072a082bf702d5a6f275dd058f7fefa5cb2a5d,0,0,0,0,0,0,0,0,0,0,0,0,0,0,52,29,0,0,0,0,0,0,0,0,0,100
be2ad1c75b756ca7a797596ab70356308360a509,0,0,0,0,0,0,0,0,0,0,0,0,0,0,53,30,0,0,0,0,0,0,0,0,0,100
b45178e2832cc30bace75ec29be8dfaa943444c2,0,0,0,0,0,0,0,0,0,0,0,0,0,0,54,31,0,0,0,0,0,0,0,0,0,100
534c2f8d9a5788db0d671d9623109791dcd579c8,0,0,0,0,0,0,0,0,0,0,0,0,0,0,55,18,0,0,0,0,0,0,0,0,0,100
7c0babd79bf352c98d46a4d7dab38d11ef9b6669,0,0,0,0,0,0,0,0,0,0,0,0,0,0,56,19,0,0,0,0,0,0,0,0,0,100
cf5a33d565f6602f6624bc4d34c62c048379140f,0,0,0,0,0,0,0,0,0,0,0,0,0,0,2,0,0,0,0,0,0,0,0,0,0,100
2f2ca3c987745c51fcaa10d056dbd9d6503a9fd6,0,0,0,0,0,0,0,0,0,0,0,0,0,0,57,6,0,0,0,0,0,0,0,0,0,100
9b4eabb9cfc27eb4f8d062b33114e32a590dc791,0,0,0,0,0,0,0,0,0,0,0,0,0,0,58,7,0,0,0,0,0,0,0,0,0,100
c29496cb11372baddbb76acdee51530347525645,0,0,0,0,0,0,0,0,0,0,0,0,0,0,59,8,0,0,0,0,0,0,0,0,0,100
31833fa6827729155934be77bdde7c546ebd47f3,0,0,0,0,0,0,0,0,0,0,0,0,0,0,0,0,0,0,0,0,0,0,0,0,0,100
e74c478d223c9f2ec90478dd2236c1b886bc5050,0,0,0,0,0,0,0,0,0,0,0,0,0,0,0,0,0,0,0,0,0,0,0,0,0,100
c17bee3c2705495b638d81ae2ad374bf7494c3f3,0,0,0,0,0,0,0,0,0,0,0,0,0,0,60,0,0,0,0,0,0,0,0,0,0,100
48d6ca51738f9560aced6e15e1201025243a0d90,0,0,0,0,0,0,0,0,0,0,0,0,0,0,1,0,0,0,0,0,0,0,0,0,0,100
a799ead59aa77cab0596f72bbe40872b59367e35,0,0,0,0,0,0,0,0,0,0,0,0,0,0,0,0,0,0,0,0,0,0,0,0,0,100
36c15d8a633f6836b35578e9915c96f4ca71ac55,0,0,0,0,0,0,0,0,0,0,0,0,0,0,145,0,0,0,0,0,0,0,0,0,0,100
fed8c472084b976965b59cdc3129d20e7fde7735,0,0,0,0,0,0,0,0,0,0,0,0,0,0,61,1,0,0,0,0,0,0,0,0,0,100
5a3b4f509cfca5ab7ce5fe85a4fd006e89e460c8,0,0,0,0,0,0,0,0,0,0,0,0,0,0,0,0,0,0,0,0,0,0,0,0,0,100
b41e140cc01a58a233eb91e632ed5e1780607406,0,0,0,0,0,0,0,0,0,0,0,0,0,0,62,2,0,0,0,0,0,0,0,0,0,100
182ef0229842054ba1bbad4352791d493546ade1,0,0,0,0,0,0,0,0,0,0,0,0,0,0,63,3,0,0,0,0,0,0,0,0,0,100
2be27b3784412beb907374026cd5e5c787a55eec,0,0,0,0,0,0,0,0,0,0,0,0,0,0,121,0,0,0,0,0,0,0,0,0,0,100
6081793d063381c3e6c7ef121ee66660ec789ce6,0,0,0,0,0,0,0,0,0,0,0,0,0,0,64,4,0,0,0,0,0,0,0,0,0,100
3f8d181ca519982c95e7d2f83f8d0701748406f2,0,0,0,0,0,0,0,0,0,0,0,0,0,0,65,5,0,0,0,0,0,0,0,0,0,100
d3fb367b31cfe7932e2c1c5607838158b8df0e73,0,0,0,0,0,0,0,0,0,0,0,0,0,0,66,6,0,0,0,0,0,0,0,0,0,100
f04fa9afe83ce9e147909c9956b62f05f6257aba,0,0,0,0,0,0,0,0,0,0,0,0,0,0,67,7,0,0,0,0,0,0,0,0,0,100
d264c1b6a3dd5451ff002f86bd241098a4b6f5f6,0,0,0,0,0,0,0,0,0,0,0,0,0,0,68,8,0,0,0,0,0,0,0,0,0,100
c806504cd9b85705659a27c12116b9ef04a22dad,0,0,0,0,0,0,0,0,0,0,0,0,0,0,69,9,0,0,0,0,0,0,0,0,0,100
ef5820f22f6a3e7acfdcde278bc28e8c8f0c41d1,0,0,0,0,0,0,0,0,0,0,0,0,0,0,70,10,0,0,0,0,0,0,0,0,0,100
74766e309cb371059ce73fe2f7a585d6757662a4,0,0,0,0,0,0,0,0,0,0,0,0,0,0,64,3,0,0,0,0,0,0,0,0,0,100
d043db4035f641b92be392bdb09320e896a93c0a,0,0,0,0,0,0,0,0,0,0,0,0,0,0,0,0,0,0,0,0,0,0,0,0,0,100
9595d30ad1db5d77920d887c8676082c1375bce5,0,0,0,0,0,0,0,0,0,0,0,0,0,0,1,1,0,0,0,0,0,0,0,0,0,100
8c14b309cb4319cb304b68328bc646a3ec48f55d,0,0,0,0,0,0,0,0,0,0,0,0,0,0,65,1,0,0,0,0,0,0,0,0,0,100
47a9362255fed1e1f8a21c1bf93549b308987d52,0,0,0,0,0,0,0,0,0,0,0,0,0,0,73,2,0,0,0,0,0,0,0,0,0,100
4149843c13c8eb5c54deaad3fd77a22968c5f966,0,0,0,0,0,0,0,0,0,0,0,0,0,0,74,3,0,0,0,0,0,0,0,0,0,100
e3530b24132b39ee7ada7d5ec9a9edf388984fb1,0,0,0,0,0,0,0,0,0,0,0,0,0,0,75,4,0,0,0,0,0,0,0,0,0,100
72dfcee8c15594c7d3cc9daee13de0752451a48b,0,0,0,0,0,0,0,0,0,0,0,0,0,0,76,4,0,0,0,0,0,0,0,0,0,100
9a4f9d36298259274dac94665eda7ce9e482cdbd,8,0,0,0,0,0,0,1,1,0,2,4,0,414,77,5,8,4,4,2678,980,1698,8,4,4,99.58706125
b3c6708bab882e2637a854b1a00ec21dbe268b2d,0,0,0,0,0,0,0,0,0,0,0,0,0,0,78,6,0,0,0,0,0,0,0,0,0,100
9f83099af8c9e788da00cdb422f9e97ac8492961,0,0,0,0,0,0,0,0,0,0,0,0,0,0,79,7,0,0,0,0,0,0,0,0,0,100
89484d8791bbeba6ccd42271de67d76541529100,0,0,0,0,0,0,0,0,0,0,0,0,0,0,80,8,0,0,0,0,0,0,0,0,0,100
ecf642f7de1fd56435282e7db6734e6abe359d7b,0,0,0,0,0,0,0,0,0,0,0,0,0,0,81,9,0,0,0,0,0,0,0,0,0,100
e2dde2272fe5956faaf1da2b34bc9119d7f33a5d,0,0,0,0,0,0,0,0,0,0,0,0,0,0,82,10,0,0,0,0,0,0,0,0,0,100
50f605a0d5c484a5b0d4028fb09d15aba57a290a,0,0,0,0,0,0,0,0,0,0,0,0,0,0,83,11,0,0,0,0,0,0,0,0,0,100
0f82e09527150753901ea0deeb2fcec8d45de781,0,0,0,0,0,0,0,0,0,0,0,0,0,0,84,12,0,0,0,0,0,0,0,0,0,100
2670242f0d065bf2deb521f337d7a2d8b705b0b2,0,0,0,0,0,0,0,0,0,0,0,0,0,0,85,13,0,0,0,0,0,0,0,0,0,100
cbdec6e059a07f2f33a3e67a5f3ce1febf963651,0,0,0,0,0,0,0,0,0,0,0,0,0,0,86,14,0,0,0,0,0,0,0,0,0,100
aedb0243715058c5e32a7026b7350e221b3fc788,0,0,0,0,0,0,0,0,0,0,0,0,0,0,0,0,0,0,0,0,0,0,0,0,0,100
d108041d92faa0327339e478305222022b858329,0,0,0,0,0,0,0,0,0,0,0,0,0,0,1,1,0,0,0,0,0,0,0,0,0,100
e56378cf7191fefa56eab6c17266a956d01f709e,8,0,379,379,0,0,0,1,1,0,2,4,1.993830231,414,146,0,4,8,4,1339,2319,980,4,8,4,99.58706125
b99e71c32c9fece5acf4485e7f3073d50240336a,0,0,0,0,0,0,0,0,0,0,0,0,0,0,0,0,0,0,0,0,0,0,0,0,0,100
be254cdf3d7d24826e52a0f3db66902e485fad43,0,0,0,0,0,0,0,0,0,0,0,0,0,0,1,1,0,0,0,0,0,0,0,0,0,100
fe4cb1a0919eebd8262ad8f0ff142a53de9eba42,0,0,0,0,0,0,0,0,0,0,0,0,0,0,147,0,0,0,0,0,0,0,0,0,0,100
d9b32f308804859b382e855d5a323a62ba7153e1,0,0,0,0,0,0,0,0,0,0,0,0,0,0,2,0,0,0,0,0,0,0,0,0,0,100
800a9ed6d7e015aa82b9eb7624bb441b71a8f397,1,53,0,53,0,0,0,6,23,2639,1,1,0,169,44,0,58,49,9,1743,1394,349,18,17,1,100
6188fa578acdfb275119a4f85ba128fc0506b4f8,0,0,0,0,0,0,0,0,0,0,0,0,0,0,0,0,0,0,0,0,0,0,0,0,0,100
a128b768e62a229be845855ecee235240efec8f7,0,0,0,0,0,0,0,0,0,0,0,0,0,0,3,1,0,0,0,0,0,0,0,0,0,100
1d198100aa02005e8e5e0319ca2a08113bf58468,0,0,0,0,0,0,0,0,0,0,0,0,0,0,4,2,0,0,0,0,0,0,0,0,0,100
defbbd20f78c7b9e0bcc3a81d3d79d76be32cf23,0,0,0,0,0,0,0,0,0,0,0,0,0,0,5,3,0,0,0,0,0,0,0,0,0,100
5f3133c337ca89893b0accb2e7edae9a4e756166,0,0,0,0,0,0,0,0,0,0,0,0,0,0,6,4,0,0,0,0,0,0,0,0,0,100
54f01bce24a946b2f93f6606f6c970e62c3c57ee,0,0,0,0,0,0,0,0,0,0,0,0,0,0,7,5,0,0,0,0,0,0,0,0,0,100
b213213a302caa91fc4b5a64247a4a1862244b38,0,0,0,0,0,0,0,0,0,0,0,0,0,0,8,6,0,0,0,0,0,0,0,0,0,100
e591012439c04e98d669ef9732fde865a9ef76fa,0,0,0,0,0,0,0,0,0,0,0,0,0,0,9,7,0,0,0,0,0,0,0,0,0,100
fe77fc19fc0c4d0c05c55a30a473acc71e30f1de,0,0,0,0,0,0,0,0,0,0,0,0,0,0,10,8,0,0,0,0,0,0,0,0,0,100
d5014fc543343b08a0c876c2b76d09f86092e86c,0,0,0,0,0,0,0,0,0,0,0,0,0,0,11,9,0,0,0,0,0,0,0,0,0,100
bb33d9a5a09a8b77c0853c41cd85228cecc40675,0,0,0,0,0,0,0,0,0,0,0,0,0,0,12,10,0,0,0,0,0,0,0,0,0,100
2872a3082549731314e4426774978da86698aa3a,0,0,0,0,0,0,0,0,0,0,0,0,0,0,13,11,0,0,0,0,0,0,0,0,0,100
f0a246a341cdf66e1ff727a469ed268c00b7ebfe,0,0,0,0,0,0,0,0,0,0,0,0,0,0,14,12,0,0,0,0,0,0,0,0,0,100
2613883f2f6af05e69cdcc5945a456480747566e,0,0,0,0,0,0,0,0,0,0,0,0,0,0,15,13,0,0,0,0,0,0,0,0,0,100
c80e00f894779b9c937eea280b3b7c39d07ed610,0,0,0,0,0,0,0,0,0,0,0,0,0,0,16,14,0,0,0,0,0,0,0,0,0,100
52154565410a7ebb9f9cdfe13ad9f039c1f8abb7,0,0,0,0,0,0,0,0,0,0,0,0,0,0,17,15,0,0,0,0,0,0,0,0,0,100
2483037dc65fd69a508759f241e62709ea780af3,0,0,0,0,0,0,0,0,0,0,0,0,0,0,18,16,0,0,0,0,0,0,0,0,0,100
697eae12c513f15e97a18b8a4e143fdc53064b7f,0,0,0,0,0,0,0,0,0,0,0,0,0,0,19,17,0,0,0,0,0,0,0,0,0,100
1e6584d78e8dc83c04fd1c29a8b01d7e63b6005d,0,0,0,0,0,0,0,0,0,0,0,0,0,0,20,18,0,0,0,0,0,0,0,0,0,100
9fe4aadc731ffecf3996992b51b8044c880b0e94,0,0,0,0,0,0,0,0,0,0,0,0,0,0,21,19,0,0,0,0,0,0,0,0,0,100
8a7bd9156880f3f12509c64cda62ac389cbb4f7d,0,0,0,0,0,0,0,0,0,0,0,0,0,0,22,20,0,0,0,0,0,0,0,0,0,100
4f2108c576daaa3198671568eaa619266e787b1a,0,0,0,0,0,0,0,0,0,0,0,0,0,0,23,21,0,0,0,0,0,0,0,0,0,100
ec5eb314fa4c9c30282c78ee1d1e033148674015,0,0,0,0,0,0,0,0,0,0,0,0,0,0,0,0,0,0,0,0,0,0,0,0,0,100
9beddd3108ae453091a21a881c6693016f5f2012,0,0,0,0,0,0,0,0,0,0,0,0,0,0,24,21,0,0,0,0,0,0,0,0,0,100
03918713563bf6aac55299d7239c4e042795faf0,0,0,0,0,0,0,0,0,0,0,0,0,0,0,25,22,0,0,0,0,0,0,0,0,0,100
fc36bef157dc47d9572c4cfd460067e1916910a0,0,0,0,0,0,0,0,0,0,0,0,0,0,0,26,23,0,0,0,0,0,0,0,0,0,100
5a07b51b4f85ea54ee234bd8e2bc320f49f8968c,0,0,0,0,0,0,0,0,0,0,0,0,0,0,27,24,0,0,0,0,0,0,0,0,0,100
9a2055e7b7bd1788b0b7523367772650ffdb6b53,0,0,0,0,0,0,0,0,0,0,0,0,0,0,122,0,0,0,0,0,0,0,0,0,0,100
ca8b4935c4014397ee4ffc7cd7964dce0979cdf6,0,0,0,0,0,0,0,0,0,0,0,0,0,0,24,21,0,0,0,0,0,0,0,0,0,100
df08a37c4112cbe1161f5c20f985e9c1c9abff42,8,0,0,0,0,0,0,1,1,0,2,4,0,414,122,0,8,4,4,2678,980,1698,8,4,4,99.58706125
2f55adeffebef2fdd1295deb1c44489d33b0b495,8,0,379,379,0,0,0,3,3,424,2,4,1.993830231,414,123,1,4,8,4,1339,2319,980,4,8,4,99.58706125
b887ab3653590c854f2b118162114f1133b9534d,0,0,0,0,0,0,0,0,0,0,0,0,0,0,125,2,0,0,0,0,0,0,0,0,0,100
1c528a194ebad97f24934685e7bfd9872ebe3019,0,0,0,0,0,0,0,0,0,0,0,0,0,0,29,0,0,0,0,0,0,0,0,0,0,100
6141be782e271748c9839de1e2b837eabb25033c,0,0,0,0,0,0,0,0,0,0,0,0,0,0,30,1,0,0,0,0,0,0,0,0,0,100
b9895898d799ae913ad2b37e10b4ae75467b5e37,0,0,0,0,0,0,0,0,0,0,0,0,0,0,31,2,0,0,0,0,0,0,0,0,0,100
4c1d12e39801ca7e2fa1170190d77e150ff11d66,0,0,0,0,0,0,0,0,0,0,0,0,0,0,32,3,0,0,0,0,0,0,0,0,0,100
d53d444374c874a89abd87042a4bdd6a57915258,0,0,0,0,0,0,0,0,0,0,0,0,0,0,33,4,0,0,0,0,0,0,0,0,0,100
36da4cf3d4982e246191a3ec7eac2495a25f8a86,0,0,0,0,0,0,0,0,0,0,0,0,0,0,34,5,0,0,0,0,0,0,0,0,0,100
5c51c60180b05f5ea70ef7b86daf62c7e250ef08,0,0,0,0,0,0,0,0,0,0,0,0,0,0,35,6,0,0,0,0,0,0,0,0,0,100
71ce4bf599f7abe8508724d124fa4554153055c6,0,0,0,0,0,0,0,0,0,0,0,0,0,0,36,7,0,0,0,0,0,0,0,0,0,100
84f389140c3781ace210ad9fc977f0d464666644,0,0,0,0,0,0,0,0,0,0,0,0,0,0,37,8,0,0,0,0,0,0,0,0,0,100
7dff35bc3c61c3e0b95e8e59406742be15203a69,0,0,0,0,0,0,0,0,0,0,0,0,0,0,38,9,0,0,0,0,0,0,0,0,0,100
33d1a6e699c688191fe079bfa427f89dbbe532e4,198,37106,0,37106,176,0,176,1,10,127,3,28,6.699384917,1611,39,0,4036,198,3838,162664,11484,151180,1862,66,1796,85.22190746
5eda9e1fdd390a94fe7740ff196b5de155d9e3d6,774,2559,0,2559,25,0,25,1,1,0,2,162,4.331233877,64297,40,1,9892,749,9143,510866,183505,327361,4939,749,4190,56.28400056
65c8aae283540df0a9ba68bbacb15e09d757a526,0,0,0,0,0,0,0,0,0,0,0,0,0,0,41,2,0,0,0,0,0,0,0,0,0,100
4f18f402a289de7fb41f067c411bd059d3b0138d,0,0,0,0,0,0,0,0,0,0,0,0,0,0,42,3,0,0,0,0,0,0,0,0,0,100
020a187523266dad14da2dc36ca87d7cc186de82,3,456,0,456,3,0,3,1,1,0,1,1,1.491713086,0,43,4,22,0,22,3353,0,3353,15,0,15,99.71804511
3ee84f9c1dec2c559050e371362aeaf8f02ebbba,0,0,0,0,0,0,0,0,0,0,0,0,0,0,44,5,0,0,0,0,0,0,0,0,0,100
5ca36a458dbafee65244514fc0b46f4672ddfc49,0,0,0,0,0,0,0,0,0,0,0,0,0,0,45,6,0,0,0,0,0,0,0,0,0,100
a39ccda97cb02b2c9445ad2dd68e203d511f32bc,0,0,0,0,0,0,0,0,0,0,0,0,0,0,46,7,0,0,0,0,0,0,0,0,0,100
505f08553970471edfeb251f2f54396e4793704e,0,0,0,0,0,0,0,0,0,0,0,0,0,0,47,8,0,0,0,0,0,0,0,0,0,100
2d53a5c6b08c1fb16bef048443f718c1bad39c10,0,0,0,0,0,0,0,0,0,0,0,0,0,0,48,9,0,0,0,0,0,0,0,0,0,100
ed37c220cbd86b11dde67e6290151ac13f227772,0,0,0,0,0,0,0,0,0,0,0,0,0,0,49,10,0,0,0,0,0,0,0,0,0,100
c23a9f696f33994b8f733aa09ce4540f9e0bc4a4,0,0,0,0,0,0,0,0,0,0,0,0,0,0,50,11,0,0,0,0,0,0,0,0,0,100
7b9eea4673e8325f49d184ed5275afacfd851026,0,0,0,0,0,0,0,0,0,0,0,0,0,0,51,12,0,0,0,0,0,0,0,0,0,100
9f9b518b79f6950879f8141500ebc12149caa442,0,0,0,0,0,0,0,0,0,0,0,0,0,0,52,13,0,0,0,0,0,0,0,0,0,100
5aacd5bede9fbf78fc1347cc85a42a498408b1ce,0,0,0,0,0,0,0,0,0,0,0,0,0,0,53,14,0,0,0,0,0,0,0,0,0,100
03432eaa383ad10a95b1c7d3d1db590ffa0678b7,0,0,0,0,0,0,0,0,0,0,0,0,0,0,54,15,0,0,0,0,0,0,0,0,0,100
6867631269e1de85b3965473219c01b3d9f1aee9,0,0,0,0,0,0,0,0,0,0,0,0,0,0,55,16,0,0,0,0,0,0,0,0,0,100
f7719650ddccb313c68483eb7dd1cd855b425014,0,0,0,0,0,0,0,0,0,0,0,0,0,0,56,17,0,0,0,0,0,0,0,0,0,100
f8e728ab7724d02a800b31fa4007fb9725c417d1,0,0,0,0,0,0,0,0,0,0,0,0,0,0,57,18,0,0,0,0,0,0,0,0,0,100
01aec6b39e8a5cc72675be5b2641ddca4f38adab,0,0,0,0,0,0,0,0,0,0,0,0,0,0,58,19,0,0,0,0,0,0,0,0,0,100
8d407a161f15f194a4af2452a3cbe12947971f67,0,0,0,0,0,0,0,0,0,0,0,0,0,0,59,20,0,0,0,0,0,0,0,0,0,100
9e2f710041445b63b87a3ae021354721e55d91ff,0,0,0,0,0,0,0,0,0,0,0,0,0,0,60,21,0,0,0,0,0,0,0,0,0,100
d076ab6bee986a26b336459c449afe2af0547dae,0,0,0,0,0,0,0,0,0,0,0,0,0,0,61,22,0,0,0,0,0,0,0,0,0,100
5acdd99d30eb79b6d7996e82099a2ecd7e50fa34,0,0,0,0,0,0,0,0,0,0,0,0,0,0,62,23,0,0,0,0,0,0,0,0,0,100
98d345cbca531ab8906a447b3c949d9871462cf1,0,0,0,0,0,0,0,0,0,0,0,0,0,0,63,24,0,0,0,0,0,0,0,0,0,100
c317393277c56ed789246b17fabbcea18679ba9a,0,0,0,0,0,0,0,0,0,0,0,0,0,0,64,25,0,0,0,0,0,0,0,0,0,100
ff658853dc7d6a588b60957119c4183a8e00bd9b,0,0,0,0,0,0,0,0,0,0,0,0,0,0,65,26,0,0,0,0,0,0,0,0,0,100
0fca1c0f6f2e9f45905171ac80550e33e72c477e,0,0,0,0,0,0,0,0,0,0,0,0,0,0,66,27,0,0,0,0,0,0,0,0,0,100
abcc6456756b45f2ed14ff6c8ffecf893d679cc7,1,2,0,2,0,0,0,1,2,53,1,1,0,383,67,23,78,78,0,2463,2454,9,31,31,0,100
edb29e5f2e7b4acf288cf106b7a58d0b3b80c965,975,0,40123,40123,0,0,0,1,9,63,7,189,6.920010064,88907,39,0,9826,4895,4931,510467,355320,155147,4837,2750,2087,44.95703302
6990bd5adca7a83308301cec0fa5fb27849d47dc,0,0,0,0,0,0,0,0,0,0,0,0,0,0,40,1,0,0,0,0,0,0,0,0,0,100
209d09e12c33b04cc0dd35c267e5be2017ace755,0,0,0,0,0,0,0,0,0,0,0,0,0,0,41,2,0,0,0,0,0,0,0,0,0,100
d4def830db4570ca06b65e67decaa7dcfa64f7b8,0,0,0,0,0,0,0,0,0,0,0,0,0,0,42,3,0,0,0,0,0,0,0,0,0,100
574ccc990673afdd34cb47f2b50f4379c5823212,0,0,0,0,0,0,0,0,0,0,0,0,0,0,43,4,0,0,0,0,0,0,0,0,0,100
eff8b1fd6a5c871331345d40bc1c9061b7ea2a40,975,39934,0,39934,203,0,203,1,10,24,4,191,6.909365118,66061,68,4,13950,771,13179,676892,188895,487997,6816,771,6045,44.95703302
aa57e2f171ee8836f2645c1cdd087faf2ee1f934,0,0,0,0,0,0,0,0,0,0,0,0,0,0,69,2,0,0,0,0,0,0,0,0,0,100
5a1d85f59f3503102298b410a0b81c2acb458a76,975,0,40123,40123,0,0,0,1,9,63,7,189,6.920010064,88907,45,0,9826,4895,4931,510467,355320,155147,4837,2750,2087,44.95703302
0a51eb0f5bf3e70575b8b5527de23d05650d8bdd,0,0,0,0,0,0,0,0,0,0,0,0,0,0,46,1,0,0,0,0,0,0,0,0,0,100
eec16428d2d9ce1158867b8ebf6f68e194058ec0,0,0,0,0,0,0,0,0,0,0,0,0,0,0,47,2,0,0,0,0,0,0,0,0,0,100
a6db60ddd0a02d1f16bd4b95ac1d243a4d3c7102,0,0,0,0,0,0,0,0,0,0,0,0,0,0,48,3,0,0,0,0,0,0,0,0,0,100
62297da7ea5dc72e73e6d2c749ac73664c283c15,0,0,0,0,0,0,0,0,0,0,0,0,0,0,49,4,0,0,0,0,0,0,0,0,0,100
02f75f997bbc01083a345287072e821bfe4f1558,1062,39934,0,39934,203,0,203,1,10,22,4,214,6.909365118,73043,70,3,14846,858,13988,731347,210210,521137,7237,858,6379,39.49953945
0908c521a5c35a2cd107404334db7a89accbb523,0,0,0,0,0,0,0,0,0,0,0,0,0,0,71,4,0,0,0,0,0,0,0,0,0,100
e0573de33887e9d0909f1a5c34313680916b5aee,362,0,42823,42823,0,0,0,4,51,2820,3,76,7.043379143,43830,72,5,2035,6731,4696,121514,383324,261810,932,3115,2183,78.170347
410ed16af1fc587999868dd4990cebfa7d14633e,857,0,0,0,0,0,0,1,1,0,1,183,0,72794,73,6,10784,6856,3928,563982,726736,162754,5356,3428,1928,45.45454545
49ad8cb457079301a87b02e71ba1273c62585bed,164,2269,28402,26133,0,0,0,1,11,0,2,25,6.317786313,20182,74,7,1075,3909,2834,69408,150430,81022,506,1822,1316,85.72798466
7b0b27b903c415e13ad7de7ea379553cddcafa79,1221,29565,259,29306,117,0,117,1,64,313,9,245,6.261247392,98291,0,0,17748,1125,16623,899820,270558,629262,8435,1106,7329,21.33898604
545648f6a8f69139757f0328e924c6b16a839441,1245,276,8,268,2,0,2,1,12,0,4,267,1.342269636,118265,75,0,18021,1220,16801,910517,298900,611617,8588,1220,7368,23.87809779
0bf221ee9f24adfc9054db059be2899ffdbadc0f,0,0,0,0,0,0,0,0,0,0,0,0,0,0,76,1,0,0,0,0,0,0,0,0,0,100
a29bbd794849e8ad7c179135f199135978c6ad97,0,0,0,0,0,0,0,0,0,0,0,0,0,0,77,0,0,0,0,0,0,0,0,0,0,100
025efffcf1c733bb8fcc83266dcfe56bbfbe961f,0,0,0,0,0,0,0,0,0,0,0,0,0,0,126,0,0,0,0,0,0,0,0,0,0,100
758cfada62556d679c445416dff9d9fb2a3c4e59,0,0,0,0,0,0,0,0,0,0,0,0,0,0,127,1,0,0,0,0,0,0,0,0,0,100
70f8c9024fedf94ce6902e94dfaad7990f1b2542,0,0,0,0,0,0,0,0,0,0,0,0,0,0,128,2,0,0,0,0,0,0,0,0,0,100
b4ddcd082589b3a452b5ffc5824e2befd01b4994,0,0,0,0,0,0,0,0,0,0,0,0,0,0,129,3,0,0,0,0,0,0,0,0,0,100
a615067cab51de15d1f8d09a666527792081ad07,0,0,0,0,0,0,0,0,0,0,0,0,0,0,2,0,0,0,0,0,0,0,0,0,0,100
264974ddad5f97e6a6f9348982505d6ae5f064c8,0,0,0,0,0,0,0,0,0,0,0,0,0,0,3,1,0,0,0,0,0,0,0,0,0,100
5122dbe38fee2ee6e3ac617c8b447f38fcfca9a0,0,0,0,0,0,0,0,0,0,0,0,0,0,0,4,2,0,0,0,0,0,0,0,0,0,100
6c1f8a11b4ba45cbd6f3074925e7a4f0d7e07ceb,0,0,0,0,0,0,0,0,0,0,0,0,0,0,5,3,0,0,0,0,0,0,0,0,0,100
aa26f695a6ef1923b710ddf8b7c48aafef618796,0,0,0,0,0,0,0,0,0,0,0,0,0,0,6,4,0,0,0,0,0,0,0,0,0,100
af6066f4b0fd2e932dd2352ac58da880a053e4d3,0,0,0,0,0,0,0,0,0,0,0,0,0,0,7,5,0,0,0,0,0,0,0,0,0,100
d5f84c94fbf6a63971b55e0051fcf81d1be3f120,0,0,0,0,0,0,0,0,0,0,0,0,0,0,130,4,0,0,0,0,0,0,0,0,0,100
1e265c982937ee227921335bc6342cafb7dcd512,0,0,0,0,0,0,0,0,0,0,0,0,0,0,131,5,0,0,0,0,0,0,0,0,0,100
70120d398df0f1f8f1e88972efe37f2cb938c394,0,0,0,0,0,0,0,0,0,0,0,0,0,0,132,6,0,0,0,0,0,0,0,0,0,100
5aed83e35b54bba7cfd012e72b907f82eacbbbaf,0,0,0,0,0,0,0,0,0,0,0,0,0,0,133,7,0,0,0,0,0,0,0,0,0,100
fdea0d79a8e8c2e96e5a3ceb2011093827961476,0,0,0,0,0,0,0,0,0,0,0,0,0,0,134,8,0,0,0,0,0,0,0,0,0,100
f537d80609736e0a5f88ec514d289173b29ae8b5,0,0,0,0,0,0,0,0,0,0,0,0,0,0,135,9,0,0,0,0,0,0,0,0,0,100
bb3cb83ca4419d830b69be923d1327d78d17b4e0,0,0,0,0,0,0,0,0,0,0,0,0,0,0,136,10,0,0,0,0,0,0,0,0,0,100
981147db7ede56d94f38c99a429320cf76ca5bdd,0,0,0,0,0,0,0,0,0,0,0,0,0,0,137,11,0,0,0,0,0,0,0,0,0,100
5d8b94ecbe0e0be50bcf8e8aa1746c447bb3b497,0,0,0,0,0,0,0,0,0,0,0,0,0,0,138,12,0,0,0,0,0,0,0,0,0,100
e72eb918b75716e4aa5cdfaba594699943a8aaa4,0,0,0,0,0,0,0,0,0,0,0,0,0,0,139,13,0,0,0,0,0,0,0,0,0,100
0064cde029f1681dd4d81a7ff893a54f24e381d1,0,0,0,0,0,0,0,0,0,0,0,0,0,0,140,14,0,0,0,0,0,0,0,0,0,100
878310443e47816d7e75d3ea424d00480186a584,0,0,0,0,0,0,0,0,0,0,0,0,0,0,141,15,0,0,0,0,0,0,0,0,0,100
d885cf02b51507e6fb98045bb63ec81d67814b22,0,0,0,0,0,0,0,0,0,0,0,0,0,0,142,16,0,0,0,0,0,0,0,0,0,100
3543c9dd49931dfc8fbb7347148d765729e418aa,0,0,0,0,0,0,0,0,0,0,0,0,0,0,143,17,0,0,0,0,0,0,0,0,0,100
be1ec41ae35d2f08b0af5221398755091f34751a,0,0,0,0,0,0,0,0,0,0,0,0,0,0,144,18,0,0,0,0,0,0,0,0,0,100
02cde581157ab3a21dbc17f1533d362aa2b88db5,0,0,0,0,0,0,0,0,0,0,0,0,0,0,145,19,0,0,0,0,0,0,0,0,0,100
33ee492fd61ed983d07beae0ba17c275e9940b3f,0,0,0,0,0,0,0,0,0,0,0,0,0,0,146,20,0,0,0,0,0,0,0,0,0,100
2878b98765a7fcc10d7f2c05bcf10eb9bb6b026f,0,0,0,0,0,0,0,0,0,0,0,0,0,0,147,21,0,0,0,0,0,0,0,0,0,100
3d8aa9f084066c12114527e7620586ad21d8945b,0,0,0,0,0,0,0,0,0,0,0,0,0,0,148,22,0,0,0,0,0,0,0,0,0,100
3d54d12b150ffca7e2d5fa50781d4f27140b953d,0,0,0,0,0,0,0,0,0,0,0,0,0,0,83,0,0,0,0,0,0,0,0,0,0,100
a901c2659031461395781ad6767bae859a01f13b,0,0,0,0,0,0,0,0,0,0,0,0,0,0,8,6,0,0,0,0,0,0,0,0,0,100
a194c35b7b4cc9967dd55f2f004fdc14bc7a7467,0,0,0,0,0,0,0,0,0,0,0,0,0,0,9,7,0,0,0,0,0,0,0,0,0,100
58b6cd361c9aa954876f7f1b96180cc63aa27eeb,0,0,0,0,0,0,0,0,0,0,0,0,0,0,84,1,0,0,0,0,0,0,0,0,0,100
eb90d8805ac6a4526b857a8a2a58113b42d3ef53,0,0,0,0,0,0,0,0,0,0,0,0,0,0,10,8,0,0,0,0,0,0,0,0,0,100
42bb10c89777daf5e1e8ae443da50c5a54fde98b,0,0,0,0,0,0,0,0,0,0,0,0,0,0,149,23,0,0,0,0,0,0,0,0,0,100
b7a99b44553faa9147b4813342bb78ba1c5e11d3,0,0,0,0,0,0,0,0,0,0,0,0,0,0,150,24,0,0,0,0,0,0,0,0,0,100
357f674d8db2c8d9fd2824726ded4784206dd3b0,0,0,0,0,0,0,0,0,0,0,0,0,0,0,85,0,0,0,0,0,0,0,0,0,0,100
0e97d216288cb529948d3a95b54985a8993d8530,0,0,0,0,0,0,0,0,0,0,0,0,0,0,86,1,0,0,0,0,0,0,0,0,0,100
fdbed4e45b0a97cae5fc5899e1b628ff48202e2f,0,0,0,0,0,0,0,0,0,0,0,0,0,0,87,2,0,0,0,0,0,0,0,0,0,100
51e59419ef6db8d4d3a8685375d9ce49bc140ef4,0,0,0,0,0,0,0,0,0,0,0,0,0,0,88,3,0,0,0,0,0,0,0,0,0,100
f7fe2c250f1e06c165692734e034a7c048cbb774,0,0,0,0,0,0,0,0,0,0,0,0,0,0,89,4,0,0,0,0,0,0,0,0,0,100
0db4ff4542a1147edc0c9926b5cb38ee3b717d1f,0,0,0,0,0,0,0,0,0,0,0,0,0,0,151,0,0,0,0,0,0,0,0,0,0,100
fae32653c70a2ef311f97aabe71be8349324c792,0,0,0,0,0,0,0,0,0,0,0,0,0,0,152,1,0,0,0,0,0,0,0,0,0,100
c51f2d8258ec0537c12e915b7220e8c49c67669f,0,0,0,0,0,0,0,0,0,0,0,0,0,0,153,2,0,0,0,0,0,0,0,0,0,100
0542e4034f55b113e40ffc3c80d4c05ab6622077,0,0,0,0,0,0,0,0,0,0,0,0,0,0,154,3,0,0,0,0,0,0,0,0,0,100
7ccda509fc328f394a744315738e0d0cac4681eb,0,0,0,0,0,0,0,0,0,0,0,0,0,0,155,4,0,0,0,0,0,0,0,0,0,100
c6afcf033c340493143031b91dc706ac2e7ea122,0,0,0,0,0,0,0,0,0,0,0,0,0,0,156,5,0,0,0,0,0,0,0,0,0,100
bfa829c146aeef367ac8d45124561307d73a9069,0,0,0,0,0,0,0,0,0,0,0,0,0,0,157,6,0,0,0,0,0,0,0,0,0,100
63c4eda7a481d0f9296e3cdae23ba22d86514a79,0,0,0,0,0,0,0,0,0,0,0,0,0,0,158,7,0,0,0,0,0,0,0,0,0,100
a42847b801842748c0da03ed13f7ded0879acef9,0,0,0,0,0,0,0,0,0,0,0,0,0,0,159,8,0,0,0,0,0,0,0,0,0,100
a206853e76fd1f2e10c2112da3bb2e7b1ad2001a,0,0,0,0,0,0,0,0,0,0,0,0,0,0,160,9,0,0,0,0,0,0,0,0,0,100
3af776fca6bff7d0075c90cc2bf5560cb5a64b72,0,0,0,0,0,0,0,0,0,0,0,0,0,0,161,10,0,0,0,0,0,0,0,0,0,100
ee9c8f2e7539d251eff517a3dfdba7f1c2d3092d,0,0,0,0,0,0,0,0,0,0,0,0,0,0,162,11,0,0,0,0,0,0,0,0,0,100
48d76dbb8bb3455a7aba5ceceab0a0304bd53cbb,0,0,0,0,0,0,0,0,0,0,0,0,0,0,163,12,0,0,0,0,0,0,0,0,0,100
b0cf1694e60f643e352182ea03744c34e96dbac4,0,0,0,0,0,0,0,0,0,0,0,0,0,0,164,13,0,0,0,0,0,0,0,0,0,100
14864c91f68228e3aa8b038292c27aa3234b1967,0,0,0,0,0,0,0,0,0,0,0,0,0,0,0,0,0,0,0,0,0,0,0,0,0,100
5350e6bc139f92a7eb5d14728a2bfa0b585ac685,0,0,0,0,0,0,0,0,0,0,0,0,0,0,165,0,0,0,0,0,0,0,0,0,0,100
53ae6bd3c2e407c04c23effd7d0442ed78a6bb55,0,0,0,0,0,0,0,0,0,0,0,0,0,0,166,0,0,0,0,0,0,0,0,0,0,100
9b0ce1f3d74529c7965be52b11688ade497d497e,0,0,0,0,0,0,0,0,0,0,0,0,0,0,167,1,0,0,0,0,0,0,0,0,0,100
847d35957e8f99564497fbe8a8a92bb9dd68754c,0,0,0,0,0,0,0,0,0,0,0,0,0,0,168,2,0,0,0,0,0,0,0,0,0,100
5ca4b6a70b9066c5b9b5b79bb0544bd61f071f67,0,0,0,0,0,0,0,0,0,0,0,0,0,0,148,0,0,0,0,0,0,0,0,0,0,100
6ef04ceefdeee70e32bb0a8d66bea2f485331cca,0,0,0,0,0,0,0,0,0,0,0,0,0,0,149,1,0,0,0,0,0,0,0,0,0,100
f52fd5ce0c0bf0fd98501297088b6deebe4c88e8,0,0,0,0,0,0,0,0,0,0,0,0,0,0,150,2,0,0,0,0,0,0,0,0,0,100
35d0b1fa535977887598a018ec996a54acb4cda5,0,0,0,0,0,0,0,0,0,0,0,0,0,0,0,0,0,0,0,0,0,0,0,0,0,100
046b97df55db6564d83898ee2ea0574daedd4dfb,0,0,0,0,0,0,0,0,0,0,0,0,0,0,151,3,0,0,0,0,0,0,0,0,0,100
985dd202da49dc463c0ea021181642a45832ca71,0,0,0,0,0,0,0,0,0,0,0,0,0,0,152,4,0,0,0,0,0,0,0,0,0,100
00694e08edbc79a88fe1743acea010c1dde876d8,0,0,0,0,0,0,0,0,0,0,0,0,0,0,153,5,0,0,0,0,0,0,0,0,0,100
d507a08ef6479b9503d356be3f4c11421973c1c5,0,0,0,0,0,0,0,0,0,0,0,0,0,0,154,6,0,0,0,0,0,0,0,0,0,100
fc9d7d8c85e2f25aa9fd9246785bd98199261ec1,0,0,0,0,0,0,0,0,0,0,0,0,0,0,155,7,0,0,0,0,0,0,0,0,0,100
e9a54ba104183b94b78ea316768333e5fc14ce18,0,0,0,0,0,0,0,0,0,0,0,0,0,0,156,8,0,0,0,0,0,0,0,0,0,100
2274f7d824747912c58d98879889654b44606bf1,0,0,0,0,0,0,0,0,0,0,0,0,0,0,157,9,0,0,0,0,0,0,0,0,0,100
9493b980df6b6bc2454ee3c816705ce552fc9f41,0,0,0,0,0,0,0,0,0,0,0,0,0,0,158,10,0,0,0,0,0,0,0,0,0,100
7fb14fba8b32a8515c8c287e1e65b6ca71174dd6,0,0,0,0,0,0,0,0,0,0,0,0,0,0,169,0,0,0,0,0,0,0,0,0,0,100
e0676091ed9bda0c5539ea76d813c0cacf87c035,0,0,0,0,0,0,0,0,0,0,0,0,0,0,170,1,0,0,0,0,0,0,0,0,0,100
8e5d4b42e3440ce7909d739d62d5bf61c49e9181,0,0,0,0,0,0,0,0,0,0,0,0,0,0,171,2,0,0,0,0,0,0,0,0,0,100
60c5fd7338a1bb9b90b10dc1725521e4aabda9b1,0,0,0,0,0,0,0,0,0,0,0,0,0,0,172,3,0,0,0,0,0,0,0,0,0,100
2b452235dcc667dcdeccb7a22b9e9481bc36c84e,0,0,0,0,0,0,0,0,0,0,0,0,0,0,173,4,0,0,0,0,0,0,0,0,0,100
290c995078072f598e2600ac56d2d1518f9b0d1f,0,0,0,0,0,0,0,0,0,0,0,0,0,0,159,11,0,0,0,0,0,0,0,0,0,100
708b95ff215e01493b7d7d224df01affd832778b,0,0,0,0,0,0,0,0,0,0,0,0,0,0,174,5,0,0,0,0,0,0,0,0,0,100
a3865591ca17711e1482d4dccffe0c795ec9381d,0,0,0,0,0,0,0,0,0,0,0,0,0,0,160,12,0,0,0,0,0,0,0,0,0,100
a2de6541e35f7f2caa9e8994f47b060affa393e9,0,0,0,0,0,0,0,0,0,0,0,0,0,0,175,6,0,0,0,0,0,0,0,0,0,100
625b4bef8de18491222a87cdc285d01d9ebb1135,0,0,0,0,0,0,0,0,0,0,0,0,0,0,176,7,0,0,0,0,0,0,0,0,0,100
e9d6aa21be72bf56afd556bd6d65655def27d801,0,0,0,0,0,0,0,0,0,0,0,0,0,0,177,8,0,0,0,0,0,0,0,0,0,100
c9914c394e2180de3f78fb181ffed3abc5c58177,0,0,0,0,0,0,0,0,0,0,0,0,0,0,178,9,0,0,0,0,0,0,0,0,0,100
de6ad662ff375aa4a0bedc30a662dd6d4c8c800d,0,0,0,0,0,0,0,0,0,0,0,0,0,0,179,10,0,0,0,0,0,0,0,0,0,100
7c7aca770e1cb612c542b553f94bc7b406176e30,0,0,0,0,0,0,0,0,0,0,0,0,0,0,180,11,0,0,0,0,0,0,0,0,0,100
bcb93cf94d04a4e4484d052f4df4d9e28b2a9988,0,0,0,0,0,0,0,0,0,0,0,0,0,0,181,12,0,0,0,0,0,0,0,0,0,100
550ba50925bfa78b4ca9782099bb2bc39c4352a5,0,0,0,0,0,0,0,0,0,0,0,0,0,0,182,13,0,0,0,0,0,0,0,0,0,100
faba9daf18298ab18692c8b915974598efe2e67e,0,0,0,0,0,0,0,0,0,0,0,0,0,0,183,14,0,0,0,0,0,0,0,0,0,100
d84b96486f7c1cfb4e31eeab788719bf82ba5e7c,0,0,0,0,0,0,0,0,0,0,0,0,0,0,161,12,0,0,0,0,0,0,0,0,0,100
395e8c715897b88f183d9364f3e0808c86398f32,0,0,0,0,0,0,0,0,0,0,0,0,0,0,162,13,0,0,0,0,0,0,0,0,0,100
1882239aaad460a5ab71007b136281ee828fd5ee,0,0,0,0,0,0,0,0,0,0,0,0,0,0,163,14,0,0,0,0,0,0,0,0,0,100
54eee3b84d4f21300f359fe298305b23924b7edf,0,0,0,0,0,0,0,0,0,0,0,0,0,0,164,15,0,0,0,0,0,0,0,0,0,100
045e132f0e4d3bea31652fda61c721d2da212c01,0,0,0,0,0,0,0,0,0,0,0,0,0,0,165,16,0,0,0,0,0,0,0,0,0,100
fbcdf6a4c5a4df8dd6ab5f8a88d8d76914626f89,0,0,0,0,0,0,0,0,0,0,0,0,0,0,1,1,0,0,0,0,0,0,0,0,0,100
c4c7a6f29399157dacc616c0cb138696ef022906,0,0,0,0,0,0,0,0,0,0,0,0,0,0,166,17,0,0,0,0,0,0,0,0,0,100
8338ccf1aa91c14d3aa41bb24cc727b824d6ff6e,0,0,0,0,0,0,0,0,0,0,0,0,0,0,167,7,0,0,0,0,0,0,0,0,0,100
6b02826d5ccbba4c1d1ff45e2f148b7529973d12,0,0,0,0,0,0,0,0,0,0,0,0,0,0,168,8,0,0,0,0,0,0,0,0,0,100
c7b92eed76c44b2a2bc3555e8229976455c60511,0,0,0,0,0,0,0,0,0,0,0,0,0,0,169,9,0,0,0,0,0,0,0,0,0,100
2ea278e8efc21a645138276b66eef65c6d1cca56,0,0,0,0,0,0,0,0,0,0,0,0,0,0,170,9,0,0,0,0,0,0,0,0,0,100
a8301c72ae2b60f4a9500ea52283da173a47f5d4,0,0,0,0,0,0,0,0,0,0,0,0,0,0,171,9,0,0,0,0,0,0,0,0,0,100
b3e6bf842532c5223a254c42e308348c258b064e,0,0,0,0,0,0,0,0,0,0,0,0,0,0,172,10,0,0,0,0,0,0,0,0,0,100
4c4a3fa2d0b07ee8c8f67f32c8bd7a289e6b4b9c,0,0,0,0,0,0,0,0,0,0,0,0,0,0,184,0,0,0,0,0,0,0,0,0,0,100
587c713dcc244a7a6c2582f02929636178aed4a0,0,0,0,0,0,0,0,0,0,0,0,0,0,0,173,11,0,0,0,0,0,0,0,0,0,100
369c430696fc8f1f493990ed3d9a0870b7b5a7f8,0,0,0,0,0,0,0,0,0,0,0,0,0,0,174,12,0,0,0,0,0,0,0,0,0,100
2a374a6b41e241627d3c2e247da7ee251df62805,0,0,0,0,0,0,0,0,0,0,0,0,0,0,175,13,0,0,0,0,0,0,0,0,0,100
d8f96273f70d3f5c23df9437fdcc8d078bdaf168,0,0,0,0,0,0,0,0,0,0,0,0,0,0,176,13,0,0,0,0,0,0,0,0,0,100
db22e978e39c0a7dc0e5111971bd5159ac9f7aa3,0,0,0,0,0,0,0,0,0,0,0,0,0,0,177,11,0,0,0,0,0,0,0,0,0,100
01b7be917efe4a689fefe97ef187bb997c49f2ce,0,0,0,0,0,0,0,0,0,0,0,0,0,0,178,12,0,0,0,0,0,0,0,0,0,100
3a06eef433c1f522099720503a1ffd0a9b2f6ac7,0,0,0,0,0,0,0,0,0,0,0,0,0,0,179,13,0,0,0,0,0,0,0,0,0,100
8ae70946109a014df05351f41fd2989fd90ad278,0,0,0,0,0,0,0,0,0,0,0,0,0,0,180,14,0,0,0,0,0,0,0,0,0,100
c1066bad1a7e62c1c9f17cffb71f42669ea2c5b1,0,0,0,0,0,0,0,0,0,0,0,0,0,0,181,10,0,0,0,0,0,0,0,0,0,100
38d69005acbbba0cb62124d268d4ea53ec7a0b7b,0,0,0,0,0,0,0,0,0,0,0,0,0,0,182,11,0,0,0,0,0,0,0,0,0,100
687ac4b0a676783bfec06a9ab013e29bd23353c0,0,0,0,0,0,0,0,0,0,0,0,0,0,0,183,12,0,0,0,0,0,0,0,0,0,100
1a5cbff0d9ae521eac61d7e409abc31473a4714b,0,0,0,0,0,0,0,0,0,0,0,0,0,0,184,13,0,0,0,0,0,0,0,0,0,100
3b9bc03faca7fec8635598aa0d4765bdefc4ebcd,0,0,0,0,0,0,0,0,0,0,0,0,0,0,185,14,0,0,0,0,0,0,0,0,0,100
0dd9c755b271e0c4164589c2314b395bbf5cb4c5,0,0,0,0,0,0,0,0,0,0,0,0,0,0,186,15,0,0,0,0,0,0,0,0,0,100
a406fc716d06e3635f44231c1679ac8b4bf7ebe4,0,0,0,0,0,0,0,0,0,0,0,0,0,0,187,16,0,0,0,0,0,0,0,0,0,100
fa1a0e6ea7634e9241387e8ecce576fbcf30a975,0,0,0,0,0,0,0,0,0,0,0,0,0,0,188,17,0,0,0,0,0,0,0,0,0,100
7b5726efe0799ea88488fea235c34e3bd5951cc8,0,0,0,0,0,0,0,0,0,0,0,0,0,0,189,18,0,0,0,0,0,0,0,0,0,100
d93fa8a09f1481b361b2382f64ea81237cdc33ac,0,0,0,0,0,0,0,0,0,0,0,0,0,0,190,19,0,0,0,0,0,0,0,0,0,100
a3ea1cabc4deefb564160b9c91a535d9ee7b65e2,0,0,0,0,0,0,0,0,0,0,0,0,0,0,191,20,0,0,0,0,0,0,0,0,0,100
839ba1a4e9ff7ec49673b8a0de6cd52d2d44e1ac,0,0,0,0,0,0,0,0,0,0,0,0,0,0,192,21,0,0,0,0,0,0,0,0,0,100
f80db6309fd7b891aeeeaf8210ac0ad88f44f35d,0,0,0,0,0,0,0,0,0,0,0,0,0,0,193,22,0,0,0,0,0,0,0,0,0,100
80b18835e9e1b0348f494199d07df06d1bceca9b,0,0,0,0,0,0,0,0,0,0,0,0,0,0,194,23,0,0,0,0,0,0,0,0,0,100
f6c75a810e54084f7e5367267cc4514a77c526aa,0,0,0,0,0,0,0,0,0,0,0,0,0,0,195,24,0,0,0,0,0,0,0,0,0,100
f708a56044a119636c9f52dba77ae5f7cf010d7a,0,0,0,0,0,0,0,0,0,0,0,0,0,0,196,25,0,0,0,0,0,0,0,0,0,100
9829ccf5e7fac5689c69c8d2c12e143186977281,0,0,0,0,0,0,0,0,0,0,0,0,0,0,197,26,0,0,0,0,0,0,0,0,0,100
33fa57a52d0441db47cae78fcbbc61ac53e8469f,0,0,0,0,0,0,0,0,0,0,0,0,0,0,198,27,0,0,0,0,0,0,0,0,0,100
0a038d5a8765fdbdbc1c0f8389941cee9bcdab38,0,0,0,0,0,0,0,0,0,0,0,0,0,0,199,28,0,0,0,0,0,0,0,0,0,100
c564ad6cb04d477a9c52cd89b5d2bb4dff0779a5,0,0,0,0,0,0,0,0,0,0,0,0,0,0,200,29,0,0,0,0,0,0,0,0,0,100
0adc9e783f365cd8eea5366186d45ca8f3d2b61e,0,0,0,0,0,0,0,0,0,0,0,0,0,0,201,30,0,0,0,0,0,0,0,0,0,100
647ce0712d9cef15311b7469a629571b3f69e8ef,0,0,0,0,0,0,0,0,0,0,0,0,0,0,202,31,0,0,0,0,0,0,0,0,0,100
11ee0f280ad882a0907c0b6aee6f4d5e944ee5cf,0,0,0,0,0,0,0,0,0,0,0,0,0,0,203,32,0,0,0,0,0,0,0,0,0,100
070e7ed17a9006e56704dae51ca0c4ccb6298ab5,0,0,0,0,0,0,0,0,0,0,0,0,0,0,204,33,0,0,0,0,0,0,0,0,0,100
5dd5313fd8cd28698a9211a8079d6360cc583a2e,0,0,0,0,0,0,0,0,0,0,0,0,0,0,205,34,0,0,0,0,0,0,0,0,0,100
5ce3f9fdc494741fb7a32c28af0e9d98e2b3e8c8,0,0,0,0,0,0,0,0,0,0,0,0,0,0,206,35,0,0,0,0,0,0,0,0,0,100
ac87bdc8456f0a67fc808b76d78bdb2df865e468,0,0,0,0,0,0,0,0,0,0,0,0,0,0,207,36,0,0,0,0,0,0,0,0,0,100
3559fc5ab69bef85534a27e2c7fbf278106272ca,0,0,0,0,0,0,0,0,0,0,0,0,0,0,208,27,0,0,0,0,0,0,0,0,0,100
0ed68978d45bc7659bb8f962b76773f71042934e,0,0,0,0,0,0,0,0,0,0,0,0,0,0,209,28,0,0,0,0,0,0,0,0,0,100
a66568c584a41705dd10d7bc00714a8e45138a5b,0,0,0,0,0,0,0,0,0,0,0,0,0,0,210,29,0,0,0,0,0,0,0,0,0,100
0abfb934ce3c33b6db7558919bb8f2575cebe5c2,0,0,0,0,0,0,0,0,0,0,0,0,0,0,211,30,0,0,0,0,0,0,0,0,0,100
af0411cd96552b5bfcf8d1d1f52d170ca9007286,0,0,0,0,0,0,0,0,0,0,0,0,0,0,212,31,0,0,0,0,0,0,0,0,0,100
b268bde8a3f693ac94b5f3857c28b3197194a476,0,0,0,0,0,0,0,0,0,0,0,0,0,0,213,32,0,0,0,0,0,0,0,0,0,100
8260e755012c30518ee541bf9c812522c4ae4dac,0,0,0,0,0,0,0,0,0,0,0,0,0,0,214,33,0,0,0,0,0,0,0,0,0,100
b77c7562972f2b3fbf59f9dfb9a361db5f115db8,0,0,0,0,0,0,0,0,0,0,0,0,0,0,215,34,0,0,0,0,0,0,0,0,0,100
c67a6c82d68b45d41e7a9eb937579ce9abe9f8e1,0,0,0,0,0,0,0,0,0,0,0,0,0,0,216,35,0,0,0,0,0,0,0,0,0,100
421ca7ba7fb3404ff95d6341879d4e647f2bd593,0,0,0,0,0,0,0,0,0,0,0,0,0,0,217,36,0,0,0,0,0,0,0,0,0,100
a68e397b467f5be41c11f978eba4d3a1f39e5c0e,0,0,0,0,0,0,0,0,0,0,0,0,0,0,218,0,0,0,0,0,0,0,0,0,0,100
0927858edcc15b011fcbf08ec6208ee28ffb06c9,0,0,0,0,0,0,0,0,0,0,0,0,0,0,219,1,0,0,0,0,0,0,0,0,0,100
80e13d63ff596e8b53d525648986ae8340f7c8fa,0,0,0,0,0,0,0,0,0,0,0,0,0,0,220,0,0,0,0,0,0,0,0,0,0,100
4d074ee67bcbfc9dc9195387afd78da29e8afa16,0,0,0,0,0,0,0,0,0,0,0,0,0,0,221,1,0,0,0,0,0,0,0,0,0,100
f91e320520c59b3764c18b4358a9e4ce17b0ebea,0,0,0,0,0,0,0,0,0,0,0,0,0,0,222,2,0,0,0,0,0,0,0,0,0,100
10a8294f2c39dd90da4d870d94230b9fc90ce034,0,0,0,0,0,0,0,0,0,0,0,0,0,0,223,3,0,0,0,0,0,0,0,0,0,100
cca3a47351b70a0fcbafc37eff3fb49fec8341df,0,0,0,0,0,0,0,0,0,0,0,0,0,0,224,0,0,0,0,0,0,0,0,0,0,100
adc42ab684c97df21d3b1f8a525a49937a92609c,0,0,0,0,0,0,0,0,0,0,0,0,0,0,225,1,0,0,0,0,0,0,0,0,0,100
c53871e0f24eacf8395b9e9f4381727435582966,0,0,0,0,0,0,0,0,0,0,0,0,0,0,226,2,0,0,0,0,0,0,0,0,0,100
b002713c69613e5331a1b2fd9bce4be57a58d6e1,0,0,0,0,0,0,0,0,0,0,0,0,0,0,227,3,0,0,0,0,0,0,0,0,0,100
fbe3b28c4223ceeee248eb27f9aecde6b18a774f,0,0,0,0,0,0,0,0,0,0,0,0,0,0,228,4,0,0,0,0,0,0,0,0,0,100
f5e999dc6cc8f94d0a50d6516e8e04f61ddb1381,0,0,0,0,0,0,0,0,0,0,0,0,0,0,229,5,0,0,0,0,0,0,0,0,0,100
df3d13154be6181266e3aa004e4ea50122998f23,0,0,0,0,0,0,0,0,0,0,0,0,0,0,230,6,0,0,0,0,0,0,0,0,0,100
259ed9ad4a7188b5eb6256c81e47b8df08ee29c9,0,0,0,0,0,0,0,0,0,0,0,0,0,0,231,7,0,0,0,0,0,0,0,0,0,100
4ba7c839d579a708a4400cbaa7c4d2e61167668e,0,0,0,0,0,0,0,0,0,0,0,0,0,0,232,8,0,0,0,0,0,0,0,0,0,100
b2439ae3242e256805ea361db9a4f9d5cb6e18bd,0,0,0,0,0,0,0,0,0,0,0,0,0,0,233,9,0,0,0,0,0,0,0,0,0,100
f0b33a909fb4ea9e7353b5e54bbbfa573d0f73f4,0,0,0,0,0,0,0,0,0,0,0,0,0,0,234,10,0,0,0,0,0,0,0,0,0,100
84bf82069c3146c03f3acd833949b92a97bf04d2,0,0,0,0,0,0,0,0,0,0,0,0,0,0,235,11,0,0,0,0,0,0,0,0,0,100
ab4e686e99a6738a45407a60e3beef0da7291e5e,0,0,0,0,0,0,0,0,0,0,0,0,0,0,236,12,0,0,0,0,0,0,0,0,0,100
3bb049be556e8b95f02784d39e54d92ef70ee6ec,0,0,0,0,0,0,0,0,0,0,0,0,0,0,237,13,0,0,0,0,0,0,0,0,0,100
455851dddad9d48e0ce2ee8d40be2f1c57a64613,0,0,0,0,0,0,0,0,0,0,0,0,0,0,238,14,0,0,0,0,0,0,0,0,0,100
92ab261f48b18d79c9695c0b802b46143e971042,0,0,0,0,0,0,0,0,0,0,0,0,0,0,239,15,0,0,0,0,0,0,0,0,0,100
213736b0c116ca3ebe50c84f879d6a457cb760f5,0,0,0,0,0,0,0,0,0,0,0,0,0,0,240,16,0,0,0,0,0,0,0,0,0,100
e1454376a8c6649ab85e54db0a1617c08fe78598,0,0,0,0,0,0,0,0,0,0,0,0,0,0,241,17,0,0,0,0,0,0,0,0,0,100
875e05829fe7593d0af43dd41a5086a365a7de43,0,0,0,0,0,0,0,0,0,0,0,0,0,0,242,18,0,0,0,0,0,0,0,0,0,100
24370fd887c0062f10ddf6063ad24d2a24a431aa,0,0,0,0,0,0,0,0,0,0,0,0,0,0,90,0,0,0,0,0,0,0,0,0,0,100
a1fad8b0b436a9b060c97b804d2f8b1499361cb2,0,0,0,0,0,0,0,0,0,0,0,0,0,0,91,1,0,0,0,0,0,0,0,0,0,100
8e48983a66571ab6ac331c1cb2043df58ed1213b,0,0,0,0,0,0,0,0,0,0,0,0,0,0,243,0,0,0,0,0,0,0,0,0,0,100
e0015b85026ba96d8cb7f787ae196c4584ce1639,0,0,0,0,0,0,0,0,0,0,0,0,0,0,243,0,0,0,0,0,0,0,0,0,0,100
57c1e601257ca9aa843769eaf709248c1ce8b5ae,0,0,0,0,0,0,0,0,0,0,0,0,0,0,244,1,0,0,0,0,0,0,0,0,0,100
c9f1245eca595ad3e3991adbbca8e5b3c0a78496,0,0,0,0,0,0,0,0,0,0,0,0,0,0,244,1,0,0,0,0,0,0,0,0,0,100
a96c4bbfdd249571e3e80077c69884e1219700b6,0,0,0,0,0,0,0,0,0,0,0,0,0,0,245,2,0,0,0,0,0,0,0,0,0,100
56b0e1138b14f78be90745bfb89ab4125fbbe39d,0,0,0,0,0,0,0,0,0,0,0,0,0,0,246,3,0,0,0,0,0,0,0,0,0,100
6aa947ff44cf79408997d953f0a6bb32ba2e0aa7,0,0,0,0,0,0,0,0,0,0,0,0,0,0,249,6,0,0,0,0,0,0,0,0,0,100
b041fb3156ae954352611738a14dca7ecec10905,0,0,0,0,0,0,0,0,0,0,0,0,0,0,245,2,0,0,0,0,0,0,0,0,0,100
cb74cf6da4a722100923a93aeae8a05f6c4181b4,0,0,0,0,0,0,0,0,0,0,0,0,0,0,247,4,0,0,0,0,0,0,0,0,0,100
7cac67317d97a4938a024ae4fd421a9297a28818,0,0,0,0,0,0,0,0,0,0,0,0,0,0,248,5,0,0,0,0,0,0,0,0,0,100
54fc1b43421ceb6b70617f44cea73c55c840bc68,0,0,0,0,0,0,0,0,0,0,0,0,0,0,252,9,0,0,0,0,0,0,0,0,0,100
0ac7d9b5ff14e60280e7b01d08aec190587a4a02,0,0,0,0,0,0,0,0,0,0,0,0,0,0,253,10,0,0,0,0,0,0,0,0,0,100
a7fc999546901ae815fe3604fec46749b045d717,0,0,0,0,0,0,0,0,0,0,0,0,0,0,254,11,0,0,0,0,0,0,0,0,0,100
82b95dcd044df983e04e515f5db64be0fceec199,0,0,0,0,0,0,0,0,0,0,0,0,0,0,255,12,0,0,0,0,0,0,0,0,0,100
5caae55f3ca0a34c37c037fc44aaa3fda9f307b4,0,0,0,0,0,0,0,0,0,0,0,0,0,0,256,13,0,0,0,0,0,0,0,0,0,100
52f527f4f297eab25a6d8d0d4d1d5c80a0c17982,0,0,0,0,0,0,0,0,0,0,0,0,0,0,257,14,0,0,0,0,0,0,0,0,0,100
bf40aafadc2622b848d864aabbd7c385163301c4,0,0,0,0,0,0,0,0,0,0,0,0,0,0,258,15,0,0,0,0,0,0,0,0,0,100
ff2c23da1ca6b4d5cfde64d64ea9eb2105a72f9a,0,0,0,0,0,0,0,0,0,0,0,0,0,0,259,16,0,0,0,0,0,0,0,0,0,100
3073fa7c0ff2e6d947a41deccb37cc0bfd60b2ed,0,0,0,0,0,0,0,0,0,0,0,0,0,0,260,17,0,0,0,0,0,0,0,0,0,100
3009d6500fd98d4e05f72cb027818c25f41253ca,0,0,0,0,0,0,0,0,0,0,0,0,0,0,246,3,0,0,0,0,0,0,0,0,0,100
15a476fe39dcae713fe4d04d719e73a88324bb8e,0,0,0,0,0,0,0,0,0,0,0,0,0,0,261,18,0,0,0,0,0,0,0,0,0,100
6e990183c4517d0b0c561f4b8829f809b4152a1a,0,0,0,0,0,0,0,0,0,0,0,0,0,0,262,19,0,0,0,0,0,0,0,0,0,100
f181080e4141fe91b14d82b7532519f333488752,0,0,0,0,0,0,0,0,0,0,0,0,0,0,263,20,0,0,0,0,0,0,0,0,0,100
22eead7f32376b79336b469a261b7a8a1c94786d,0,0,0,0,0,0,0,0,0,0,0,0,0,0,264,21,0,0,0,0,0,0,0,0,0,100
e81eae95ac3dee3f11900ba842b7f17a31522c76,0,0,0,0,0,0,0,0,0,0,0,0,0,0,265,22,0,0,0,0,0,0,0,0,0,100
97aa2420ad636be75d9dc2bf85b45401f8df5516,0,0,0,0,0,0,0,0,0,0,0,0,0,0,266,23,0,0,0,0,0,0,0,0,0,100
53fe38bc1142b26ce947fd7351a2e183746f7b60,0,0,0,0,0,0,0,0,0,0,0,0,0,0,247,4,0,0,0,0,0,0,0,0,0,100
879defb9f9505953faf2a7fa693d2923cb3c4c3d,0,0,0,0,0,0,0,0,0,0,0,0,0,0,270,27,0,0,0,0,0,0,0,0,0,100
26c4f1b918288f95a0d2102002a697c20c97dc77,0,0,0,0,0,0,0,0,0,0,0,0,0,0,271,28,0,0,0,0,0,0,0,0,0,100
acaf3675fd77703204baec8044836fd27712080e,0,0,0,0,0,0,0,0,0,0,0,0,0,0,272,29,0,0,0,0,0,0,0,0,0,100
0d570328c4cfe05c8544648b08c4c824ac6aafd1,0,0,0,0,0,0,0,0,0,0,0,0,0,0,273,30,0,0,0,0,0,0,0,0,0,100
dc2e4eb3c0eab69a63127237b77f0f9c919f50fe,0,0,0,0,0,0,0,0,0,0,0,0,0,0,274,31,0,0,0,0,0,0,0,0,0,100
82cb521eccb93bbcc201d925ea0d804c7349ee74,0,0,0,0,0,0,0,0,0,0,0,0,0,0,275,32,0,0,0,0,0,0,0,0,0,100
575939307d69921c59f9f26c14a335b3c8fca033,0,0,0,0,0,0,0,0,0,0,0,0,0,0,276,33,0,0,0,0,0,0,0,0,0,100
f6bfc4740c0f43c4c0e35a28888299aed0b29fc7,0,0,0,0,0,0,0,0,0,0,0,0,0,0,277,34,0,0,0,0,0,0,0,0,0,100
5aaa6be5a3f209977d854705ae0405b9d83381e7,0,0,0,0,0,0,0,0,0,0,0,0,0,0,278,35,0,0,0,0,0,0,0,0,0,100
c26286270c8a1d68862f320493bb048241fda781,0,0,0,0,0,0,0,0,0,0,0,0,0,0,279,36,0,0,0,0,0,0,0,0,0,100
28c3ce0b2f1787a25a46fc9ad9734cbc6cd42d87,0,0,0,0,0,0,0,0,0,0,0,0,0,0,280,37,0,0,0,0,0,0,0,0,0,100
e375e5d9023f2392e6f3581c6d7e89978d237af9,0,0,0,0,0,0,0,0,0,0,0,0,0,0,281,38,0,0,0,0,0,0,0,0,0,100
4c034d0f8613d2d273645a999290f40dd2622845,0,0,0,0,0,0,0,0,0,0,0,0,0,0,282,39,0,0,0,0,0,0,0,0,0,100
9b3a056f93f424bedbb4e725a8c7fb4900bd0332,0,0,0,0,0,0,0,0,0,0,0,0,0,0,283,40,0,0,0,0,0,0,0,0,0,100
6366f61be8f38560902f97f1c413cdc95f3c4013,0,0,0,0,0,0,0,0,0,0,0,0,0,0,284,41,0,0,0,0,0,0,0,0,0,100
3b992bd76ccd2282be70885c2398543635f3f71b,0,0,0,0,0,0,0,0,0,0,0,0,0,0,285,42,0,0,0,0,0,0,0,0,0,100
d91d623ee03cb353197f48f1acbabc210bf300cc,0,0,0,0,0,0,0,0,0,0,0,0,0,0,286,43,0,0,0,0,0,0,0,0,0,100
88fbbaa2d19376578bed665748a20161f48e77d7,0,0,0,0,0,0,0,0,0,0,0,0,0,0,287,44,0,0,0,0,0,0,0,0,0,100
5ccfa8bc1b0dea0064204196e5522c8538d95507,0,0,0,0,0,0,0,0,0,0,0,0,0,0,288,45,0,0,0,0,0,0,0,0,0,100
91a8865b34599d31a71d83e17672aa71ca726486,0,0,0,0,0,0,0,0,0,0,0,0,0,0,289,46,0,0,0,0,0,0,0,0,0,100
429d0192dabd55cffeda59c70a7afe111f37a81b,0,0,0,0,0,0,0,0,0,0,0,0,0,0,290,47,0,0,0,0,0,0,0,0,0,100
a4a8325fc84937612509125704c0e912625d1c75,0,0,0,0,0,0,0,0,0,0,0,0,0,0,291,48,0,0,0,0,0,0,0,0,0,100
1a200e6193d0108d5f5fc503581b501897f8aeef,0,0,0,0,0,0,0,0,0,0,0,0,0,0,292,49,0,0,0,0,0,0,0,0,0,100
a468d8effd709a70198ba5567418e05b9d71111c,0,0,0,0,0,0,0,0,0,0,0,0,0,0,293,13,0,0,0,0,0,0,0,0,0,100
941d7b41f13482cf07ce6a908f2dfa6dacaf0ff3,0,0,0,0,0,0,0,0,0,0,0,0,0,0,294,14,0,0,0,0,0,0,0,0,0,100
378b2a0ad71337b8983afb47e6a4157906bb345b,0,0,0,0,0,0,0,0,0,0,0,0,0,0,295,15,0,0,0,0,0,0,0,0,0,100
cb485311b9bb67bce79ae48dc21ba2767ffa320e,0,0,0,0,0,0,0,0,0,0,0,0,0,0,296,16,0,0,0,0,0,0,0,0,0,100
9d070afbd7ebd95132012d088cc905cf6579a223,0,0,0,0,0,0,0,0,0,0,0,0,0,0,297,17,0,0,0,0,0,0,0,0,0,100
4d88d5e4866bbfcec558c33cb59e538c55acc433,0,0,0,0,0,0,0,0,0,0,0,0,0,0,298,18,0,0,0,0,0,0,0,0,0,100
359b8524c4df4c7ec8038524cc7267dac35a0037,0,0,0,0,0,0,0,0,0,0,0,0,0,0,299,19,0,0,0,0,0,0,0,0,0,100
c0f685af740d4db853578c9fa6f5a2d18c9a0b37,0,0,0,0,0,0,0,0,0,0,0,0,0,0,300,20,0,0,0,0,0,0,0,0,0,100
936c4af656f5f2ad4539ef67b84ac43a0809366e,0,0,0,0,0,0,0,0,0,0,0,0,0,0,301,21,0,0,0,0,0,0,0,0,0,100
1dd6d33e9641b6bc05ca909c2609ba04e7eda003,0,0,0,0,0,0,0,0,0,0,0,0,0,0,302,22,0,0,0,0,0,0,0,0,0,100
66023490e8499dd25a107dcdfcf80f6cd39d8686,0,0,0,0,0,0,0,0,0,0,0,0,0,0,303,23,0,0,0,0,0,0,0,0,0,100
50f2a284205e2bc3670e6fc1bd76a2e9a4aa80b0,0,0,0,0,0,0,0,0,0,0,0,0,0,0,304,24,0,0,0,0,0,0,0,0,0,100
25ae289e53332681104126128f75701317555c23,0,0,0,0,0,0,0,0,0,0,0,0,0,0,305,25,0,0,0,0,0,0,0,0,0,100
299b50bc89d998724f7918340a78331cfdf799aa,0,0,0,0,0,0,0,0,0,0,0,0,0,0,306,26,0,0,0,0,0,0,0,0,0,100
c9956de67aec92bf45d0a00b93e261ac5b572d4c,0,0,0,0,0,0,0,0,0,0,0,0,0,0,307,27,0,0,0,0,0,0,0,0,0,100
27effc6f4c795391af0df1da02634bd2b128d26f,0,0,0,0,0,0,0,0,0,0,0,0,0,0,308,28,0,0,0,0,0,0,0,0,0,100
f14e831679a70ea8e199935e4038d4f4beaa8148,0,0,0,0,0,0,0,0,0,0,0,0,0,0,309,29,0,0,0,0,0,0,0,0,0,100
6db68f9691a994015e53182ecd2ec6eb8936e7aa,0,0,0,0,0,0,0,0,0,0,0,0,0,0,310,30,0,0,0,0,0,0,0,0,0,100
144179f0ecff09815ed0e6c6931b2d78e3c7fbd1,0,0,0,0,0,0,0,0,0,0,0,0,0,0,311,31,0,0,0,0,0,0,0,0,0,100
7c28ca99bef3d21fca20665147104d79c8a2e133,0,0,0,0,0,0,0,0,0,0,0,0,0,0,312,32,0,0,0,0,0,0,0,0,0,100
025aafeecac4be5512dab83e44f40bd5e9432628,0,0,0,0,0,0,0,0,0,0,0,0,0,0,313,33,0,0,0,0,0,0,0,0,0,100
ed5282eeb6ae7cafc03d51388b009eb6a61286a2,0,0,0,0,0,0,0,0,0,0,0,0,0,0,314,34,0,0,0,0,0,0,0,0,0,100
765135f1f8fab7b05b5097110d481d0ff906de88,0,0,0,0,0,0,0,0,0,0,0,0,0,0,315,35,0,0,0,0,0,0,0,0,0,100
7d4c6113bd048abd1a903393d5416bfbd34bba00,0,0,0,0,0,0,0,0,0,0,0,0,0,0,316,36,0,0,0,0,0,0,0,0,0,100
98e52ff1c70b021eddb962ac4c8b9af3e9922c27,0,0,0,0,0,0,0,0,0,0,0,0,0,0,317,37,0,0,0,0,0,0,0,0,0,100
81e1dc60f16b50469f3cd640adf8c5a3849a906f,0,0,0,0,0,0,0,0,0,0,0,0,0,0,318,38,0,0,0,0,0,0,0,0,0,100
1793f6296f7b20cc17f4933207f5d96c9bc780c1,0,0,0,0,0,0,0,0,0,0,0,0,0,0,319,39,0,0,0,0,0,0,0,0,0,100
da26b64a0784a1881d8e6ca8e3eb1ecf4ac8d680,0,0,0,0,0,0,0,0,0,0,0,0,0,0,320,40,0,0,0,0,0,0,0,0,0,100
b84097c7e5c3c2c5ec8a8c85ca226706ba880a9c,0,0,0,0,0,0,0,0,0,0,0,0,0,0,321,41,0,0,0,0,0,0,0,0,0,100
f2e9b99f31daa735c7547ce9d43410a36e33f577,0,0,0,0,0,0,0,0,0,0,0,0,0,0,322,42,0,0,0,0,0,0,0,0,0,100
5c5aadf7601629631410ebea807ceca6b9bc0387,0,0,0,0,0,0,0,0,0,0,0,0,0,0,323,43,0,0,0,0,0,0,0,0,0,100
4ce01cb8bca805f19b2b84caa6e56b51a80e0a33,0,0,0,0,0,0,0,0,0,0,0,0,0,0,324,44,0,0,0,0,0,0,0,0,0,100
729d622c6af2855a9d5c99008099f6c6d34feb84,0,0,0,0,0,0,0,0,0,0,0,0,0,0,325,45,0,0,0,0,0,0,0,0,0,100
7269a58c7dfda9311d7b6b078583b862bdd32c22,0,0,0,0,0,0,0,0,0,0,0,0,0,0,326,46,0,0,0,0,0,0,0,0,0,100
48e336d0d3e4e04c3114983e2a37ac0bd3a61f1f,0,0,0,0,0,0,0,0,0,0,0,0,0,0,327,47,0,0,0,0,0,0,0,0,0,100
43b693505a8d8768db9251fe427ceccee8ff6bb1,0,0,0,0,0,0,0,0,0,0,0,0,0,0,328,48,0,0,0,0,0,0,0,0,0,100
701b02ecc9af533ed6e588cd8f140ab7393db1c2,0,0,0,0,0,0,0,0,0,0,0,0,0,0,329,49,0,0,0,0,0,0,0,0,0,100
41c2083c8a5237a47228f1e89bb3e06862d40a04,0,0,0,0,0,0,0,0,0,0,0,0,0,0,330,50,0,0,0,0,0,0,0,0,0,100
339dfb1f0238373066e9ec669540b10c7fb41d3b,0,0,0,0,0,0,0,0,0,0,0,0,0,0,331,51,0,0,0,0,0,0,0,0,0,100
40e8a7e5b42fcd3fc46d5777e528a36bec86f843,0,0,0,0,0,0,0,0,0,0,0,0,0,0,332,52,0,0,0,0,0,0,0,0,0,100
af28a672db544cccdb4888036f02030ba8a5103c,0,0,0,0,0,0,0,0,0,0,0,0,0,0,333,53,0,0,0,0,0,0,0,0,0,100
032b0332ad0e6e105429cc7bb3038ef459efce96,0,0,0,0,0,0,0,0,0,0,0,0,0,0,334,54,0,0,0,0,0,0,0,0,0,100
25f4a3b7da9dfea043b8a7522f7ff10d49cc73a2,0,0,0,0,0,0,0,0,0,0,0,0,0,0,335,55,0,0,0,0,0,0,0,0,0,100
a515dd05685a6a996b5f13c2cd7dd3fd537fbc57,0,0,0,0,0,0,0,0,0,0,0,0,0,0,336,56,0,0,0,0,0,0,0,0,0,100
9c81e28ae1933fd0285ca773f81d501732f0f3c8,0,0,0,0,0,0,0,0,0,0,0,0,0,0,337,57,0,0,0,0,0,0,0,0,0,100
70112f4bc813ce797cd54b770ab9e6fbf9ec0aa6,0,0,0,0,0,0,0,0,0,0,0,0,0,0,338,58,0,0,0,0,0,0,0,0,0,100
7fbaae4b820691ff60dc0774e53c2525c27f64db,0,0,0,0,0,0,0,0,0,0,0,0,0,0,339,59,0,0,0,0,0,0,0,0,0,100
9c936635cb4e78143c708577860a736489837b2a,0,0,0,0,0,0,0,0,0,0,0,0,0,0,340,60,0,0,0,0,0,0,0,0,0,100
daf2df23c901750d7450ec81c2594ceceb0174db,0,0,0,0,0,0,0,0,0,0,0,0,0,0,341,61,0,0,0,0,0,0,0,0,0,100
cfe6d824777af1bd825a5f0d67c9f18dcdd368df,0,0,0,0,0,0,0,0,0,0,0,0,0,0,342,62,0,0,0,0,0,0,0,0,0,100
ff691720ba9b6a825860ec88b177c5f282b5dfd4,0,0,0,0,0,0,0,0,0,0,0,0,0,0,343,63,0,0,0,0,0,0,0,0,0,100
c80c3e5d3cae573df470e740200bc457d54147ab,0,0,0,0,0,0,0,0,0,0,0,0,0,0,344,64,0,0,0,0,0,0,0,0,0,100
402fa0d7fa1c1effacab9297b185931f7e8dd85d,0,0,0,0,0,0,0,0,0,0,0,0,0,0,345,65,0,0,0,0,0,0,0,0,0,100
70287115c2be807bc9f47e4637ea37f1b885a94d,0,0,0,0,0,0,0,0,0,0,0,0,0,0,346,66,0,0,0,0,0,0,0,0,0,100
979802b5f73d439fd0f09c0e1f0f28d453d70e3f,0,0,0,0,0,0,0,0,0,0,0,0,0,0,347,67,0,0,0,0,0,0,0,0,0,100
b013d7e673d69b9377428731f1c5221569c09e06,0,0,0,0,0,0,0,0,0,0,0,0,0,0,348,68,0,0,0,0,0,0,0,0,0,100
87acf8b4b35febb7254a7ffd91c56c681b9e60f5,0,0,0,0,0,0,0,0,0,0,0,0,0,0,349,69,0,0,0,0,0,0,0,0,0,100
39c30cb801e6aeea573428f0bfe931826daa960a,0,0,0,0,0,0,0,0,0,0,0,0,0,0,185,0,0,0,0,0,0,0,0,0,0,100
4458ef7a6bc006d2a17c7cc1b41e96ab40c70915,0,0,0,0,0,0,0,0,0,0,0,0,0,0,186,1,0,0,0,0,0,0,0,0,0,100
67646078840c019805d80b05559b2bcab001a3e9,0,0,0,0,0,0,0,0,0,0,0,0,0,0,187,2,0,0,0,0,0,0,0,0,0,100
5250dee6fad895c33958a12b2e107eee3e102ef6,0,0,0,0,0,0,0,0,0,0,0,0,0,0,188,3,0,0,0,0,0,0,0,0,0,100
50abf94b2b4206f68d35636250eadcbb25487c27,0,0,0,0,0,0,0,0,0,0,0,0,0,0,189,4,0,0,0,0,0,0,0,0,0,100
1ff489a36cec5465a305ee3487b939cf97111328,0,0,0,0,0,0,0,0,0,0,0,0,0,0,190,5,0,0,0,0,0,0,0,0,0,100
3b1bc874f15835cd4dbf3f25e9a51b3b269a1612,0,0,0,0,0,0,0,0,0,0,0,0,0,0,191,6,0,0,0,0,0,0,0,0,0,100
67140ac7be42eea68d16d170a35831b6d3acdb7f,0,0,0,0,0,0,0,0,0,0,0,0,0,0,192,7,0,0,0,0,0,0,0,0,0,100
a6938529052ba75c9841a4ea07a0dac1276375da,0,0,0,0,0,0,0,0,0,0,0,0,0,0,193,8,0,0,0,0,0,0,0,0,0,100
838ecf7a521e06ab03366f129c880bdd953adc87,0,0,0,0,0,0,0,0,0,0,0,0,0,0,194,9,0,0,0,0,0,0,0,0,0,100
8aec9226eb903b60e74c0b5a07144bac949b4c39,0,0,0,0,0,0,0,0,0,0,0,0,0,0,195,10,0,0,0,0,0,0,0,0,0,100
5eda1b98f8ff1b86c8ca24faca5672f602f50721,0,0,0,0,0,0,0,0,0,0,0,0,0,0,196,11,0,0,0,0,0,0,0,0,0,100
3fbfef895d004dfa3a8561d54076aff8061c0b63,0,0,0,0,0,0,0,0,0,0,0,0,0,0,197,12,0,0,0,0,0,0,0,0,0,100
2814553f061d7f63dd9ba52203dcb0522850c059,0,0,0,0,0,0,0,0,0,0,0,0,0,0,198,13,0,0,0,0,0,0,0,0,0,100
57d76991b0b5f4cae5c208e574abf27431ab2f36,0,0,0,0,0,0,0,0,0,0,0,0,0,0,199,14,0,0,0,0,0,0,0,0,0,100
d2fa55348780d9168e3d524f926b5f4a3fce7f27,0,0,0,0,0,0,0,0,0,0,0,0,0,0,200,15,0,0,0,0,0,0,0,0,0,100
60c7706dbba2cf6a7b04651b5bc7d1684d40e6b1,0,0,0,0,0,0,0,0,0,0,0,0,0,0,201,16,0,0,0,0,0,0,0,0,0,100
aa6948ac3dc7102bef8373575a8f0c7e9090fca3,0,0,0,0,0,0,0,0,0,0,0,0,0,0,202,17,0,0,0,0,0,0,0,0,0,100
ae64e017bb4722d13f2e4fe98796ae9eed3b2415,0,0,0,0,0,0,0,0,0,0,0,0,0,0,203,18,0,0,0,0,0,0,0,0,0,100
bf7dabd009a2d6773faa96c05e708533a1c1a3b1,0,0,0,0,0,0,0,0,0,0,0,0,0,0,204,19,0,0,0,0,0,0,0,0,0,100
