CommitID,NMF,TotalAddLines,TotalDeleteLines,LC,FileAdd,FileDelete,NAD,NDEV,NUC,AGE,NS,ND,Entropy,LT,EXP,REXP,CommitComplexity,LastCommitComplexity,CFC,CommitTokenCount,LastCommitTokenCount,NCC,CommitMethodNum,LastCommitMethodNum,NMC,a2a
b7cc991c6906efc1e48a4fc2d7a5707561fbd06b,0,0,0,0,0,0,0,0,0,0,0,0,0,0,1,1,0,0,0,0,0,0,0,0,0,100
daa1640cc17acfcbc0145f7f568d568a7cb599a0,12,29,29,0,0,0,0,1,1,0,2,4,2.870889516,615,1,1,39,36,3,3468,8820,5352,26,36,10,11.11111111
e9f9cdba27d3f17ca719f0c9a51dd434ebd2a79e,11,111,476,365,0,0,0,1,2,11,2,4,2.699970233,595,2,2,30,39,9,1215,3450,2235,20,26,6,66.66666667
ca4326eb97d65115e9edbf3de290aad1b46e5bfc,11,708,0,708,11,0,11,1,1,0,2,3,3.151520251,0,0,0,43,0,43,3507,0,3507,25,0,25,50.90909091
1f2b9a78357a1183416c5300aa9a3908dc309eae,8,1050,0,1050,8,0,8,1,1,0,1,4,2.779247559,0,1,1,79,0,79,5057,0,5057,52,0,52,77.47747748
f8aa965760fcdac84a46d9f4272fef1c25455d9c,2,35,1,34,0,0,0,1,2,4,1,2,0.997772472,50,2,2,5,5,0,344,344,0,4,4,0,100
77526056556f5785ab9b15206e7d3152b5d46189,1,128,0,128,1,0,1,1,1,0,1,1,0,0,0,0,8,0,8,403,0,403,7,0,7,98.61111111
6694f1e89426da5bb784cf239441e8ccfa10db39,9,222,28,194,4,0,4,2,3,2,3,5,2.490590749,672,3,3,78,67,11,5328,4726,602,46,41,5,87.07482993
2f67f176c3c62b4aff3e083c86155772afefdffb,8,173,3,170,2,0,2,1,4,8,2,3,2.670082445,365,4,4,43,29,14,2871,2226,645,28,19,9,96.62162162
c1919b9671767a038d77af22643d18b64493a54d,1,78,96,18,0,0,0,2,3,3,1,1,0,96,1,1,7,8,1,417,450,33,6,7,1,100
ae9bbac92bbe75873162c6c439e112e9ad414eff,15,224,228,4,0,0,0,3,5,12,4,8,2.663470469,1321,3,1,125,125,0,8435,8455,20,76,76,0,100
e69f31826f9738320642eadfb51354751350c16f,1,14,19,5,0,0,0,2,3,2,1,1,0,69,4,2,8,9,1,315,312,3,5,6,1,100
ceb2353fa980962d71221fe36a58a1392d2ce038,0,0,0,0,0,0,0,0,0,0,0,0,0,0,5,3,0,0,0,0,0,0,0,0,0,100
f3b65d5128c0f30cb5dfe55746af62d0daa5ebaf,2,598,6,592,1,0,1,1,5,1,1,1,0.581805524,88,0,0,51,7,44,3077,427,2650,23,6,17,97.35099338
fa5834196717e062265d67c6221023b4d315b43d,14,417,21,396,3,0,3,1,6,0,3,6,2.255252369,1312,6,4,198,152,46,10392,8223,2169,104,84,20,95.0310559
cfe94023cd54e308abeb142739517a65aa68a5cc,1,5,5,0,0,0,0,2,4,0,1,1,0,91,5,5,10,10,0,606,599,7,5,5,0,100
316b504681e6d74bfa0af47cfb69f1c1ba7ab5c3,5,751,706,45,2,0,2,1,7,1,1,1,1.616714744,494,1,1,55,56,1,3167,3262,95,24,26,2,94.64285714
5e5a7d6dd7f93c6d1172e99d3631c4fbce33f719,1,1,1,0,0,0,0,2,3,18,1,1,0,36,7,4,1,1,0,172,164,8,1,1,0,100
556b10d6ce7dc8969b54a5225199c903c8c0d552,0,0,0,0,0,0,0,0,0,0,0,0,0,0,2,2,0,0,0,0,0,0,0,0,0,100
0bd75199d95efd253c1df20e84c16681aa096e04,2,726,1,725,1,0,1,1,2,6,1,1,0.222518367,128,3,3,53,17,36,4697,869,3828,19,6,13,94.28571429
cc0f0266342873950e8b76f4f64d8e0fe0556278,5,624,32,592,1,0,1,2,3,5,1,1,1.1586737,1198,6,3,168,108,60,10760,8094,2666,64,46,18,97.83783784
6e4c34faa58652d2626420900394793015bc2a35,6,71,51,20,0,0,0,1,5,9,2,3,1.85089892,1087,7,3,135,131,4,7118,7014,104,54,54,0,100
f528e312658baa05b945cef868425aefc56233e0,0,0,0,0,0,0,0,0,0,0,0,0,0,0,2,0,0,0,0,0,0,0,0,0,0,100
033aba8988c71d03185b21dcc81bc21eac17d6f4,7,747,342,405,0,0,0,2,4,3,2,3,1.328189316,1462,2,2,177,173,4,11895,9639,2256,73,72,1,98.39572193
a0e3cda67ef2ffae27f2da6522dc3d1838f700de,6,71,51,20,0,0,0,2,5,9,2,3,1.85089892,1417,3,3,139,135,4,9242,9138,104,58,58,0,100
2d1f50b2e9b72276fd06ff48079510959d57d7fd,3,216,58,158,1,0,1,3,5,0,1,1,1.121210191,931,8,5,98,85,13,6559,5810,749,42,32,10,98.93617021
e60518753cfbfd9381b44fc83a538eedb3307649,1,4,4,0,0,0,0,2,5,18,1,1,0,150,8,4,15,15,0,1154,1138,16,15,15,0,100
6a7e9ac49ceea0e8f69f868deca22ab1d7d1f25b,1,26,10,16,0,0,0,2,3,4,1,1,0,550,9,5,32,32,0,3683,3669,14,10,9,1,100
cb615d36a1d3d960986e24383def5d47758348a8,1,573,0,573,1,0,1,1,1,0,1,1,0,0,10,5,30,0,30,2702,0,2702,9,0,9,94.55445545
ec8678dad02f8951a5c04cba16118bf0135895ca,3,401,30,371,1,0,1,2,6,3,1,1,0.632893054,842,4,2,96,80,16,7461,5575,1886,36,30,6,99.07407407
8e6383b73db275d2cb421f308ae07e1a50d6b430,1,239,0,239,1,0,1,1,1,0,1,1,0,0,4,4,5,0,5,1297,0,1297,4,0,4,99.09090909
db81fae90cc214c52ab4fc1095a3e51c9d7ddad6,1,298,0,298,1,0,1,1,1,0,1,1,0,0,5,5,13,0,13,1387,0,1387,5,0,5,99.10714286
79f98dcf38e4ff922d030387ccd1cec523e7923b,28,1257,252,1005,13,0,13,1,7,17,3,6,4.118974336,1213,9,3,221,120,101,13103,7932,5171,107,59,48,86.4
6946c60f80f4cd1b51702cb18a2ed6d8a39dbf46,9,99,99,0,0,0,0,2,6,9,2,3,2.657574108,2655,11,6,184,184,0,17199,17201,2,76,76,0,100
78312c206dd8ff2dea38a124cdf803bdad08ca91,4,1312,302,1010,1,0,1,2,7,1,1,1,1.560027357,1292,6,4,225,94,131,13555,8113,5442,46,33,13,99.27536232
b52393f7bf6734257d0880784894b77079bdf149,1,205,0,205,1,0,1,1,1,0,1,1,0,0,10,2,11,0,11,943,0,943,4,0,4,98.57142857
d76e796c9caf642ae0f5553119f76cf0afce45f6,8,156,4,152,3,0,3,2,4,23,2,3,1.879880802,376,11,3,61,46,15,2778,2225,553,32,18,14,96.88581315
6090039bfd8c7e32eb483936e4e565b242f31a4a,8,647,38,609,2,0,2,1,7,25,3,4,2.116643066,816,12,6,145,106,39,8726,5350,3376,67,49,18,95.34883721
5daca5f66ea741ad83ce8a4930e6d2296ab7a878,16,393,59,334,3,0,3,2,7,19,3,4,3.444030211,964,12,4,131,93,38,7953,6124,1829,75,52,23,96.22641509
bc621faf896ab727008698653489376cc6af0426,5,36,14,22,0,0,0,2,8,15,1,1,2.101202511,2162,13,6,195,195,0,14119,13921,198,47,47,0,100
f0a0ae3a9840a92da2143fccef3861132328bd7b,4,60,43,17,0,0,0,2,9,0,1,1,1.776616519,1899,14,7,183,180,3,12293,12220,73,41,41,0,100
5784633986f5fac3f48015a818dc7f04cf24285f,1,1609,130,1479,0,0,0,1,2,17,1,1,0,568,7,3,213,53,160,13919,3811,10108,24,13,11,100
c06332b0a05dff16d1e57bf620bc871b443b7342,6,68,13,55,0,0,0,1,8,13,1,2,2.093301132,506,13,4,60,56,4,3785,3363,422,28,26,2,99.38461538
a3ed2ee50e0ff87cbd9af3965c3f3a786cec92f7,3,18,8,10,0,0,0,2,8,7,2,2,1.072737286,460,14,5,55,54,1,3553,3433,120,29,28,1,100
e3424238945d539dd8de7e49b956d93a8db5cbd0,6,430,239,191,1,0,1,1,9,4,2,4,2.467102597,738,15,4,101,80,21,6212,5395,817,51,42,9,91.09195402
28b4443fb23812347c88c5afccd5c7c7dc3de397,1,196,0,196,1,0,1,1,1,0,1,1,0,0,8,4,8,0,8,858,0,858,4,0,4,98.41688654
1877d4b2a69521ae9a8793d10b442514155ae34e,10,82,22,60,1,0,1,2,10,9,3,4,2.539767518,790,15,6,90,84,6,5682,5337,345,45,42,3,98.49246231
4d0f7f5d419d59346fc115f25508f4ce1ba380b0,2,0,156,156,0,0,0,2,4,16,1,2,0.985605737,130,16,7,0,9,9,0,705,705,0,6,6,99.01960784
a5245cc28bf1686083bb64d7c4acf077a0f2efaf,3,19,111,92,0,0,0,2,8,25,1,1,1.122642645,513,17,8,70,79,9,2799,3222,423,33,37,4,91.03641457
ebb1f96059c7f691ed43b871b2eb952a657bed08,9,74,87,13,0,0,0,3,9,20,1,1,2.278945196,2367,18,9,197,198,1,15518,15549,31,87,84,3,100
b55efeada9e8ce3a42c370e59b3cce512b3a34c0,0,0,0,0,0,0,0,0,0,0,0,0,0,0,19,9,0,0,0,0,0,0,0,0,0,100
0bdf304da2a46b515d2d0d33033f266a64775a92,1,159,0,159,1,0,1,1,1,0,1,1,0,0,9,3,5,0,5,855,0,855,4,0,4,90.73033708
9e418e9094bd91baadfbd107b352150b312dc655,0,0,0,0,0,0,0,0,0,0,0,0,0,0,10,4,0,0,0,0,0,0,0,0,0,100
e7ce555cddbd2b3b141854a3a761146236e46b5e,27,1255,432,823,12,0,12,1,10,4,1,2,4.108534123,6016,20,10,627,547,80,43634,40060,3574,168,129,39,92.48291572
f8fe47366970e1e6b1af04adf12f81d4901b07b4,2,0,515,515,0,0,0,2,10,10,1,1,0.867841728,440,21,11,0,70,70,0,2799,2799,0,33,33,99.15611814
46e090e373565545846bfa15d03ad1f08b799eef,1,3,2,1,0,0,0,2,6,20,1,1,0,148,16,4,1,1,0,1319,1303,16,1,1,0,100
c2741a77cd27240c187fc0d0bee4a2dc093b2001,8,344,273,71,0,0,0,3,9,21,3,5,1.721899338,1311,17,5,143,145,2,9006,8386,620,51,49,2,99.12663755
dd49e3d127c758807b40033d5c125c6d3ebe5955,7,174,46,128,1,0,1,3,11,1,2,3,2.20916511,919,18,6,113,100,13,6794,6150,644,50,43,7,94.87804878
d3d095ffb12971ac54251fb8ba6849a7d86dea8d,2,106,112,6,0,0,0,1,6,0,1,1,0.042236538,560,22,12,42,38,4,3296,3523,227,10,10,0,99.73262032
c384da0743952031ef8513e784132a16d1278736,4,177,162,15,0,0,0,3,8,11,1,1,1.373601445,1153,23,12,82,80,2,7680,7648,32,36,35,1,100
1c4002ba78dd7ad901a5562f893b9dd1546aa2f9,1,30,32,2,0,0,0,2,3,9,1,1,0,111,24,13,4,4,0,706,796,90,3,3,0,100
70af3d83f97177f30ab3b64c2f89fee5852d2547,2,81,89,8,0,0,0,3,6,4,1,1,0.368115005,335,25,14,31,28,3,2130,2196,66,21,20,1,100
fefb4bdda29c76079ca40236790aea5d551e4ab2,4,188,119,69,0,0,0,2,11,6,2,3,1.193211103,878,19,7,107,88,19,6477,6094,383,23,21,2,100
020ffe48f8bf89d68d647aabdb648861312909c7,4,22,24,2,0,0,0,1,9,22,1,2,1.614946721,585,26,15,60,59,1,4501,4487,14,40,40,0,100
4bb8ec16a0380501f143afbe7ad97b20872c5781,4,92,21,71,0,0,0,1,2,8,1,2,1.426704267,345,27,15,53,43,10,2710,2145,565,19,17,2,100
312405a594d9af8371480a85cb65f3c350f53031,5,1162,1429,267,1,0,1,1,12,2,2,3,0.772203612,2349,20,7,185,285,100,15486,17687,2201,46,37,9,99.46808511
f1723fa83ab0f1d3af87890e6f7e97b708322803,1,2,2,0,0,0,0,1,2,12,1,1,0,101,28,16,11,11,0,552,552,0,6,6,0,100
2a0772eb218b91b848737db96298d7207d9fc911,1,45,69,24,0,0,0,1,4,11,1,1,0,149,29,17,6,9,3,767,867,100,3,2,1,100
52842646797589afdcd223bdff12fdde45229ce3,1,3,7,4,0,0,0,2,13,0,1,1,0,299,21,8,67,68,1,2072,2103,31,9,9,0,100
6427f700776b0b70bc55dc91562abbc591aa14d6,5,524,230,294,0,0,0,3,14,0,2,2,1.623444121,1484,5,0,186,166,20,11247,9606,1641,52,48,4,100
aeec120b2a8eed99cf261e0607533b3148920eb3,1,112,90,22,0,0,0,2,2,3,1,1,0,286,6,1,18,18,0,2507,2210,297,13,13,0,100
c5b8c59967c738d74e1090197525fa4bd99173f5,6,30,90,60,0,0,0,1,8,12,1,2,1.430090511,787,30,16,62,62,0,4566,4923,357,27,28,1,100
2e13de0e7ca13e6e8487916d1ef3620748e75365,3,179,0,179,1,0,1,1,4,2,1,2,0.440319293,251,31,17,58,30,28,2810,1575,1235,25,10,15,98.68766404
deb79e769d7521bf882dba74b9ba6b0639936ac9,6,78,9,69,1,0,1,2,12,25,3,4,1.913879947,552,32,18,85,79,6,4031,3715,316,32,29,3,99.22279793
548b7ccb4525613912b7e840adda7a2cd2bdf546,6,150,99,51,0,0,0,2,15,4,3,4,1.902973181,1328,33,19,179,175,4,9848,9476,372,55,55,0,100
b6880b15764161c3d7c79bdc210396f616c16128,2,12,3,9,0,0,0,2,9,19,1,2,0.353359335,273,34,20,37,34,3,1898,1847,51,25,24,1,100
ae06ad63e48305522a185b9c9eb462b79356f9b2,2,327,158,169,0,0,0,3,16,3,2,2,0.692105325,954,7,2,133,124,9,7663,6551,1112,25,24,1,100
6b766603afccfbe9589c700dcff7739738ac6f16,3,39,79,40,0,0,0,3,7,12,2,2,0.655835404,345,35,20,37,37,0,1936,2022,86,22,21,1,99.74226804
151863ab29bb2651cc9df83fef59819182e5d7e0,1,155,436,281,0,0,0,3,10,21,1,1,0,416,36,21,25,46,21,2022,2906,884,17,15,2,100
74561498b90fde9083fd4a919bafb995cc3afe08,1,34,4,30,0,0,0,3,17,11,1,1,0,423,22,6,89,82,7,3211,3099,112,15,14,1,100
6e15fa61d3ccf913a10a00b5d6acb020b783bc5d,5,280,850,570,0,0,0,1,11,22,1,2,0.240602715,1337,37,18,62,138,76,5910,8021,2111,31,27,4,99.2248062
61c46bb4989836c8fe7f9705f41f552a77d0797b,3,23,8,15,0,0,0,3,18,8,2,3,1.091003405,956,8,3,131,130,1,6884,6773,111,30,30,0,100
326600960603b3deee63e6227933b8970715c737,1,7,3,4,0,0,0,4,7,23,1,1,0,164,9,4,7,6,1,1232,1211,21,4,4,0,100
43a1e92e44ae33dd4bb6535a41194b73bd95c353,1,6,13,7,0,0,0,3,4,23,1,1,0,108,23,7,4,4,0,684,706,22,3,3,0,100
96467835b2adff4b4cfe4c6c8637e9ddfba44f76,1,2,0,2,0,0,0,4,8,0,1,1,0,168,10,5,7,7,0,1249,1232,17,4,4,0,100
9eb4a295141c20685aba41c1dd132278687e3b16,1,33,50,17,0,0,0,2,5,33,1,1,0,119,38,19,9,11,2,568,697,129,8,9,1,99.74093264
97b137509ca8f202cd8d5598ca330e55a4fbb4e7,15,182,37,145,2,0,2,3,19,14,3,6,2.966723833,3176,39,20,298,269,29,22449,21708,741,112,99,13,85.38681948
c91736f95da9094f9c9854e17920294f9119dff1,1,16,16,0,0,0,0,2,10,17,1,1,0,183,40,21,20,20,0,1362,1362,0,17,17,0,100
4eb80ccd35af6562072784387091c257410cdcc7,3,266,434,168,0,0,0,3,13,5,1,1,1.018178652,1136,41,22,60,82,22,7499,8007,508,30,30,0,99.67948718
712fb2f6a2f7d77c1ee13297d23c178d2e9d60bf,2,142,160,18,1,0,1,1,3,19,1,1,0.997435911,124,42,23,12,34,22,642,1398,756,6,12,6,98.71794872
7fb53646d8138426085c3b8e212a51513edd73d6,3,81,1,80,0,0,0,3,20,8,2,3,1.5559812,697,24,8,132,124,8,5201,4770,431,31,28,3,100
96cb7ade3e7a7235028dccea00a16f04485c2c0e,2,45,4,41,0,0,0,1,14,1,1,1,0.475431646,450,11,6,28,27,1,3612,3343,269,18,17,1,98.71794872
1edc7520c6c941288c73c71da02229b20c3ee9fa,1,9,1,8,0,0,0,2,12,21,1,1,0,170,25,9,2,2,0,1604,1528,76,2,2,0,100
05a96573693d762e24a76bbedbcf8a1622b856fd,0,0,0,0,0,0,0,0,0,0,0,0,0,0,12,7,0,0,0,0,0,0,0,0,0,100
043ce5b7bfea45ddf9e08612816ece58a6de28f4,19,219,39,180,1,0,1,2,15,11,2,3,2.792845422,2585,43,21,245,151,94,19549,14096,5453,132,89,43,76.74418605
841a95fd8c0a9a089163a7560b858444b692376f,19,162,160,2,1,0,1,1,16,4,1,2,2.415742601,4911,44,22,316,316,0,34170,34139,31,138,138,0,98.41269841
314ed21fb26863690614e6086662f23b61be9ee9,6,402,1454,1052,0,0,0,3,6,13,3,3,0.275822036,1640,45,23,54,133,79,4680,11521,6841,41,45,4,99.73684211
9f67c6921cd5b1e221f3fb685fb9359557ce98c7,0,0,0,0,0,0,0,0,0,0,0,0,0,0,26,8,0,0,0,0,0,0,0,0,0,100
0b3f99b9fc74ef935d15a456b553064f65e4c3fe,2,7,11,4,0,0,0,3,13,1,2,2,1,306,13,8,7,7,0,2313,2369,56,6,6,0,100
4a582eb5c18c6644fe154ca5b105c17f2261a02a,12,114,82,32,0,0,0,2,21,10,2,6,2.800600849,1650,27,8,241,242,1,11253,11095,158,82,82,0,100
e0f11af3b9dbe64bcf4e699ff0bdb154f046a598,1,17,1,16,0,0,0,2,8,2,1,1,0,178,46,16,23,20,3,1395,1272,123,4,4,0,100
c807e3835deeb8dd8bd783e8d412a6b1abbd426a,2,8,2,6,0,0,0,2,22,1,2,2,0.468995594,709,47,17,136,134,2,5187,5158,29,23,23,0,100
0ac559b39769e5b80653845ebae5ea3490907ef7,1,34,13,21,0,0,0,2,12,3,1,1,0,186,48,18,22,20,2,1654,1403,251,19,17,2,100
52c5aed421b3828e35342214874da7c21d4a65aa,0,0,0,0,0,0,0,0,0,0,0,0,0,0,28,6,0,0,0,0,0,0,0,0,0,100
b48d2c554430329f6462b606725e6485b76888a9,1,8,2,6,0,0,0,3,14,13,1,1,0,171,29,7,2,2,0,1604,1544,60,2,2,0,100
29486529949074649727a89c13a70ef9045cc933,6,50,7,43,0,0,0,2,7,27,1,2,1.66269512,696,49,19,109,106,3,5116,4778,338,43,42,1,93.42105263
d8cff663f32f85fd07773da1ee5323cd0a79c833,6,156,7,149,1,0,1,2,23,9,2,3,1.796574404,1365,30,8,199,191,8,10640,9798,842,64,59,5,98.95561358
d02b8ce1b2cc62b9c7c1c01689852049094acc3d,5,50,24,26,0,0,0,2,8,9,2,3,1.969335299,701,50,20,88,84,4,4892,4573,319,40,36,4,100
daaf53e607d98419edf7434b5a881d4eca06dd97,4,13,3,10,0,0,0,3,24,8,2,4,1.882856064,934,51,17,158,157,1,6485,6401,84,39,39,0,100
44c45716a50150982a26430f9700b9632dc29114,2,19,17,2,0,0,0,3,4,6,2,2,0.997772472,242,31,9,19,19,0,1586,1616,30,11,11,0,100
ec16e2b2c0d9a9e4e70cfa56a4a2b1e667c3716d,2,5,0,5,0,0,0,3,5,8,2,2,0.721928095,238,32,9,19,19,0,1626,1586,40,11,11,0,100
a145775a949295ab8dc261f756eb28406ae6873d,0,0,0,0,0,0,0,0,0,0,0,0,0,0,33,3,0,0,0,0,0,0,0,0,0,100
c4bddd673d2c8069c873fcdebbcf9377a18247c2,0,0,0,0,0,0,0,0,0,0,0,0,0,0,34,3,0,0,0,0,0,0,0,0,0,100
6a969559e202d059308af1730cb25a5521dfe7fb,0,0,0,0,0,0,0,0,0,0,0,0,0,0,35,4,0,0,0,0,0,0,0,0,0,100
bdf3f2715b89d9882e9f6ca30d647f010a45f15d,0,0,0,0,0,0,0,0,0,0,0,0,0,0,36,5,0,0,0,0,0,0,0,0,0,100
6cccc92eaebec970d650a6462dd4b7366b74f7f2,3,19,10,9,0,0,0,3,11,34,2,3,0.999699949,350,37,6,34,34,0,2210,2133,77,19,19,0,100
7d6bf5ec585af1eac33d4a4f8e9118220bcd6408,1,13,8,5,0,0,0,2,8,59,1,1,0,240,52,0,7,8,1,1466,1414,52,6,6,0,100
d4f7e6bd169488ae8e0e18f4313da3240033e23f,3,46,5,41,0,0,0,2,18,131,1,3,0.918684253,486,38,0,63,60,3,3612,3371,241,37,35,2,100
0dbde2831c3383630e0cdf6faff05afb68d2f2c5,96,1473,496,977,8,0,8,1,6,3,6,13,4.838968103,9739,39,1,945,267,678,67684,8084,59600,485,264,221,15.4589372
d32d891ea15d95b3f01821b86f8451f740be9c93,0,0,0,0,0,0,0,0,0,0,0,0,0,0,40,2,0,0,0,0,0,0,0,0,0,100
8e1753de1d0a8c9155d072d26d1bbe592f3154df,0,0,0,0,0,0,0,0,0,0,0,0,0,0,41,2,0,0,0,0,0,0,0,0,0,100
bf2cc60f155cef0876b231d9ee419b18a05eab33,2,12,8,4,0,0,0,2,2,12,2,2,0.721928095,936,14,0,145,144,1,6694,6650,44,29,29,0,100
27feebca20b9cbbbd019d24d44025f47dc0c1065,3,37,8,29,0,0,0,2,3,26,1,1,1.422609657,715,0,0,139,137,2,5011,4882,129,35,33,2,100
0ce0f220542f0ec28416ecdd30d8daea8401191e,2,8,3,5,0,0,0,1,2,74,2,2,0.945660305,534,42,0,19,19,0,4532,4489,43,14,14,0,100
5a7f87a59d92fdcc30662ce1a2f60e7e529524e9,2,3,0,3,0,0,0,1,3,0,2,2,0.918295834,538,43,1,19,19,0,4559,4532,27,14,14,0,100
e08d75b8ef9a4624297013f4a38e97058cb70b6a,4,144,3,141,0,0,0,1,4,73,2,3,1.404314158,737,44,2,76,72,4,6451,5575,876,30,27,3,98.85057471
12200196b07d366fa2ddcbec8cf7969113eab7d8,5,36,10,26,0,0,0,1,4,84,3,4,1.98995201,1258,45,3,209,206,3,9071,8893,178,66,65,1,100
8fddf0610e3a1dc953bc86dd16e6064f39274111,1,23,8,15,0,0,0,3,5,0,1,1,0,587,46,4,131,128,3,4405,4345,60,23,22,1,100
4d9b6a5503122f0705ebd44d6e59aac1cfabcaef,1,2,0,2,0,0,0,2,2,107,1,1,0,198,15,0,24,24,0,1447,1430,17,4,4,0,100
7539491cc7f67c31faf32f8801768433eec2b3b9,1,11,10,1,0,0,0,2,2,113,1,1,0,317,16,1,15,15,0,2573,2533,40,14,14,0,100
4bfd2dc89b7c7947a6456e4e01710681b21c1093,7,119,119,0,0,0,0,2,5,138,1,1,2.529375031,2649,17,0,134,134,0,18672,18672,0,61,61,0,100
a5262c6e960798de30b5b3278daa0a9e0590217a,0,0,0,0,0,0,0,0,0,0,0,0,0,0,0,0,0,0,0,0,0,0,0,0,0,100
2f037b5d5395bb4a04f3bdb1d80c3f91423bb949,0,0,0,0,0,0,0,0,0,0,0,0,0,0,1,1,0,0,0,0,0,0,0,0,0,100
c98ac0c37032b90b2452f16571435d72a570094e,0,0,0,0,0,0,0,0,0,0,0,0,0,0,2,2,0,0,0,0,0,0,0,0,0,100
ecc85161f73e11da54dba35822f284083a1c57de,3,207,4,203,0,0,0,2,3,108,2,3,0.857126776,515,18,1,47,38,9,4407,3302,1105,26,22,4,98.34123223
902302c96ee6f5dc25661dfe542f03fc3253f7e9,0,0,0,0,0,0,0,0,0,0,0,0,0,0,19,2,0,0,0,0,0,0,0,0,0,100
b632d94e53c34dde24bfae1c7c897c22f8a7ef55,0,0,0,0,0,0,0,0,0,0,0,0,0,0,20,3,0,0,0,0,0,0,0,0,0,100
08a7ab6429a403c1207c74d6779c39fb2516467c,0,0,0,0,0,0,0,0,0,0,0,0,0,0,21,4,0,0,0,0,0,0,0,0,0,100
629904ff59127e23d13332b4a3b822224950cb3a,0,0,0,0,0,0,0,0,0,0,0,0,0,0,22,5,0,0,0,0,0,0,0,0,0,100
fc9e8839191fab3f7b38aa47755eeea8e71b734a,15,681,995,314,0,0,0,2,6,111,1,1,3.51626139,4158,23,6,214,220,6,27195,28687,1492,117,116,1,97.10144928
58efee39e04b998078da587e686d3cae1fd41254,0,0,0,0,0,0,0,0,0,0,0,0,0,0,24,7,0,0,0,0,0,0,0,0,0,100
2dbf28a498ed9038a8b7a2141a5a4d4321df9a1f,0,0,0,0,0,0,0,0,0,0,0,0,0,0,25,7,0,0,0,0,0,0,0,0,0,100
3c232e191ab0f18d00b503febc409da920382acc,6,85,7,78,0,0,0,2,3,165,1,2,1.385067818,534,26,7,78,69,9,3575,3063,512,41,36,5,97.39952719
aef404c6091785cd1e8879e7279b9eb45678c5d5,32,42,42,0,0,0,0,1,1,0,1,2,4.880179923,5558,27,8,377,320,57,37745,15904,21841,213,192,21,72.64957265
3ce50d56cea406e77c879043d893421b1c6a925e,0,0,0,0,0,0,0,0,0,0,0,0,0,0,28,9,0,0,0,0,0,0,0,0,0,100
055e0146f83522a4668c2d20a04e7ba67dad085a,5,41,10,31,1,0,1,2,2,127,2,4,1.986086435,743,47,0,92,89,3,5503,5371,132,44,41,3,98.79518072
7649aad99655c306948d2b1b520d2d151e604b5c,4,71,49,22,0,0,0,2,3,62,1,3,1.193984278,604,29,10,73,70,3,4356,4288,68,42,42,0,100
fa43b28c8b2379c165caa120b481cc9a1d372658,1,16,0,16,0,0,0,2,2,22,1,1,0,10,30,7,2,2,0,47,47,0,2,2,0,100
6396ccb1feeb100b5ae9af2e0ad42bddd94d2e36,24,513,501,12,1,0,1,1,3,44,2,3,4.217432197,5080,31,6,317,314,3,35805,35663,142,189,187,2,96.7462039
fb21cc305f08210b2c69c6355dd67397d58c5ba3,1,16,0,16,0,0,0,1,2,0,1,1,0,30,32,7,1,1,0,176,176,0,1,1,0,100
172631be950a794ae86f22952e70065fcb906bbd,27,351,231,120,2,0,2,3,4,10,3,6,3.901439044,2712,53,0,273,141,132,19362,10535,8827,132,79,53,78.58719647
6407c6a2449bd73a6708c8d99d29857f3a1e2b0c,1,1,1,0,0,0,0,3,6,149,1,1,0,599,33,7,131,131,0,4413,4405,8,23,23,0,100
9c7cd3731b8341d79b00d2c68a1bdf9bbe1e0b27,1,50,2,48,0,0,0,2,3,3,1,1,0,163,34,8,39,33,6,1555,1212,343,20,19,1,100
d7cbc64b539a69897d84d877460ac4e52cc2a4a5,1,3,1,2,0,0,0,2,4,18,1,1,0,142,48,1,17,17,0,836,832,4,8,8,0,100
ef54e13273574119974aeb3533d0bbc2dcf32b9d,44,319,337,18,1,0,1,1,7,32,3,11,4.883737899,3959,54,1,474,579,105,25978,30863,4885,221,337,116,80.90349076
5950ba8b1ff79c0baa2cdf883d4b3005117dc01b,26,295,193,102,4,0,4,3,4,2,1,3,3.667348511,4787,35,6,298,301,3,33822,34273,451,166,168,2,96.40718563
1b2bbeb6734b0536499a6236a71cd5606a5aade9,5,83,149,66,0,0,0,1,4,17,1,2,2.054177823,422,55,2,63,63,0,2727,2930,203,16,16,0,99.20318725
d1b14ba295f888156c3c2b07d28d10101e8184b1,5,192,0,192,5,0,5,1,1,0,1,2,2.265965085,0,56,3,10,0,10,470,0,470,10,0,10,97.45098039
224aa8c8b631fa049d9ed6f1162f8ed8af9bd6e7,4,10,10,0,0,0,0,1,2,0,1,1,1.570950594,117,57,4,7,5,2,286,251,35,7,5,2,97.70114943
ed7b7539f1fc8f18784a4a5b6222e73253f57769,7,622,0,622,7,0,7,1,1,0,1,2,2.529703731,0,58,5,63,0,63,3194,0,3194,35,0,35,96.09665428
fe5fb70f65c8400a2bba82e8c7399085246e81ef,30,209,101,108,1,0,1,3,6,40,3,10,4.058961928,2694,59,6,305,409,104,18665,24022,5357,139,264,125,86.89883914
1824f780837c9e616af5b9e0ae4f1f82c46df6fa,8,768,0,768,8,0,8,1,1,0,1,2,2.822356084,0,36,5,57,0,57,4233,0,4233,42,0,42,97.01492537
44f44e1b1131ae11ca93587b77f8c7851b02899a,5,474,1,473,4,0,4,2,5,1,2,4,1.630140315,101,60,6,45,10,35,3014,689,2325,27,4,23,98.27338129
77ac2593fd70fe232ee23eb7208f0595c5ad4cdc,48,79,70,9,0,0,0,2,6,0,4,12,5.414511789,4219,61,6,412,152,260,27588,10412,17176,220,86,134,75.18796992
2a946005c31df81e4b8489bd0e0741ec8ed6913c,15,215,87,128,1,0,1,1,6,40,2,4,3.143901231,3053,37,1,232,210,22,23303,22563,740,133,123,10,99.68253968
af0d6e7e6db9bc8e903248d5c6d366d1983830ff,1,4,2,2,0,0,0,2,4,68,1,1,0,144,62,2,7,7,0,934,894,40,4,4,0,100
fbcf8bdf731245ea9ed79c1891b58c04e3f11d6e,1,9,9,0,0,0,0,2,3,93,1,1,0,26,38,1,2,2,0,47,47,0,2,2,0,100
1001b70e11940d103ca5b38be9962abcbd3dda79,1,1,1,0,0,0,0,2,2,84,1,1,0,41,0,0,5,5,0,148,146,2,5,5,0,100
626149e913eafefb0fe82f8094c96a8a1dd2ac53,1,11,13,2,0,0,0,1,2,38,1,1,0,66,39,2,5,6,1,370,370,0,4,5,1,100
14f10a14c10f94de18c9fc90161d7c04d8a58ce6,1,1,1,0,0,0,0,2,2,58,1,1,0,198,40,3,21,21,0,1439,1443,4,13,13,0,100
a41617c814ced681d4feafa78ab748f520999bf8,1,1,10,9,0,0,0,1,5,42,1,1,0,223,41,3,7,7,0,1562,1620,58,6,6,0,100
7d1f14b326b057fecc2260953d08843d0b1a5413,2,24,3,21,0,0,0,1,3,50,2,2,0.764204507,293,63,1,45,42,3,2365,2221,144,13,11,2,100
dc3a62145a251f53df47e4901fba79751590ed11,1,2,2,0,0,0,0,1,3,17,1,1,0,64,42,4,5,5,0,394,370,24,4,4,0,100
68998d011b58c089a419e047962f8fc2a7ca361c,2,10,2,8,0,0,0,2,8,83,2,2,0.650022422,747,43,5,140,138,2,5436,5386,50,28,27,1,100
45cf5fb4fb6a01d3035d370cdcdb0ee00c2669d9,1,21,8,13,0,0,0,2,4,20,1,1,0,94,44,5,13,7,6,795,685,110,4,4,0,100
b00ccf5871c74cbc405a2be9b3b7d8b809c438d0,2,3,0,3,0,0,0,2,2,176,1,1,0.918295834,123,3,0,16,16,0,627,606,21,12,12,0,100
f9adb0b26b497de3eb16264ec3b22950c1308d5c,1,44,0,44,0,0,0,2,5,59,1,1,0,107,64,0,21,13,8,1081,795,286,5,4,1,100
c5dd7da9f313f974d1dfa43518aee4e0d7eebd33,4,345,0,345,4,0,4,1,1,0,1,1,1.837209134,0,45,0,20,0,20,1635,0,1635,18,0,18,90.45307443
b9aa0b7a0ea944493e5b681d3fa2cfa9e5a1a1d2,20,194,194,0,0,0,0,2,7,178,1,1,3.988213513,4709,65,1,293,293,0,32567,32969,402,171,171,0,100
5601cdd18c4a89b468c1c0cdde3b68fbabf28ceb,4,422,57,365,1,0,1,1,2,14,1,1,1.303802249,205,0,0,49,15,34,2616,1174,1442,31,15,16,98.67549669
4baffe9b4182d54a69a7ff7c3765212bb92becd8,2,13,0,13,0,0,0,2,9,76,2,2,0.89049164,898,46,1,152,150,2,6425,6378,47,30,30,0,100
319d64a4a31182dd73a7368d69fd1924f07bb968,2,0,13,13,0,0,0,2,10,0,2,2,0.89049164,906,47,2,150,152,2,6378,6425,47,30,30,0,100
72b437564759e552e33f806de939c4b300180915,0,0,0,0,0,0,0,0,0,0,0,0,0,0,48,3,0,0,0,0,0,0,0,0,0,100
c8c170324c06709e74e282b6117c0f9313a35bdb,2,13,0,13,0,0,0,2,11,10,2,2,0.89049164,898,66,1,152,150,2,6425,6378,47,30,30,0,100
09f0e580e7a957ddedcbc6fd03abb908a0f97c33,1,3,0,3,0,0,0,1,2,20,1,1,0,49,1,1,4,4,0,230,210,20,4,4,0,100
ee9565f046c967fb379e293b4f85da2a0161f997,4,287,110,177,1,0,1,1,3,19,1,1,0.827597688,430,2,2,65,49,16,3393,2636,757,36,31,5,99.669967
c5ff1c3faa61344c89bea15b6babf9574637a434,1,1,1,0,0,0,0,2,3,155,1,1,0,79,49,0,11,11,0,447,447,0,7,7,0,100
1a4a7b49820c3aa3ebcb52d2d3d4881473ea7d09,2,16,6,10,0,0,0,1,3,18,1,1,1,127,3,2,14,14,0,779,699,80,2,2,0,100
27c8293eda947638f7073f073826499342211ec8,0,0,0,0,0,0,0,0,0,0,0,0,0,0,50,1,0,0,0,0,0,0,0,0,0,100
07b8010c3febaf1bd49e132ed7e98605287bc50f,0,0,0,0,0,0,0,0,0,0,0,0,0,0,51,2,0,0,0,0,0,0,0,0,0,100
a93fb4161972a7ab75cb9b36de6f043c177f2461,4,295,9,286,1,0,1,1,4,17,1,1,1.175276416,531,4,2,92,60,32,4571,3232,1339,36,31,5,99.67213115
8fc91c54f6d412dd404825f35b77805784d51d5d,2,20,3,17,0,0,0,2,2,256,1,2,0.755375413,394,52,3,51,49,2,3028,2985,43,23,22,1,100
a9f9790ba1f0a606e286e3ab813b2b2f319b70a8,4,237,87,150,2,0,2,2,12,18,3,4,1.909129433,776,53,4,184,172,12,6269,5633,636,40,33,7,98.53181077
2a5fb34b8df0c9e4a6d911fc5d8c8913ea41da30,0,0,0,0,0,0,0,0,0,0,0,0,0,0,67,0,0,0,0,0,0,0,0,0,0,100
a39b2325e4460faa9187d68b875f4342f8768256,6,11,16,5,0,0,0,2,13,253,2,4,2.417131373,1850,54,1,226,227,1,12990,13011,21,75,75,0,100
3409c16703aeffde9122beca089ed72fc98d8a93,0,0,0,0,0,0,0,0,0,0,0,0,0,0,55,1,0,0,0,0,0,0,0,0,0,100
c6e23e9e5b8c9f6d4e5eae2fc60df0196c4c66c2,0,0,0,0,0,0,0,0,0,0,0,0,0,0,56,2,0,0,0,0,0,0,0,0,0,100
55ca6c7c27b42c1cfcdf54ed0175adc7f4eab855,0,0,0,0,0,0,0,0,0,0,0,0,0,0,57,3,0,0,0,0,0,0,0,0,0,100
7e1ce212fb851b8233f0f5af9d23c9a82257b6cb,0,0,0,0,0,0,0,0,0,0,0,0,0,0,5,0,0,0,0,0,0,0,0,0,0,100
796b4cb567e9c9d8616d94a284ef2bae69e0a668,8,183,0,183,3,0,3,1,7,189,2,6,2.571435753,497,68,1,61,53,8,4106,3387,719,31,23,8,95.6937799
87f476cecee50701d31aff02aec3afe01326ea9d,1,1,1,0,0,0,0,4,7,360,1,1,0,146,4,0,17,17,0,850,850,0,8,8,0,100
06d2b34915a86fb4dcf6b312056a8e7c8475aa48,0,0,0,0,0,0,0,0,0,0,0,0,0,0,6,1,0,0,0,0,0,0,0,0,0,100
cf798ac71a5e0b2d9839fac9c08538bad4f05307,0,0,0,0,0,0,0,0,0,0,0,0,0,0,49,0,0,0,0,0,0,0,0,0,0,100
a4819f5b7b8ce5fb9f3c9b94c6dbb1e2dfbe1f78,16,1221,30,1191,3,0,3,1,14,140,5,11,2.752482995,1771,69,1,420,278,142,17984,12022,5962,159,85,74,96.10778443
77554a09be7cc6fe9851106aa58c50182a8503da,5,17,3,14,0,0,0,2,5,132,1,1,2.242737649,807,70,1,97,97,0,4820,4812,8,41,41,0,100
3db29d19f850e3dcced09b6c3cac594d03ee9386,0,0,0,0,0,0,0,0,0,0,0,0,0,0,50,1,0,0,0,0,0,0,0,0,0,100
0341d51b9f6f128b80b47678f7f1c5087b645a77,3,102,5,97,1,0,1,3,15,89,2,3,0.894614442,807,5,0,139,131,8,6516,5971,545,35,29,6,99.71346705
644e8be346a152e43fa435b9adbb47ce6b3e3e91,150,22572,1058,21514,56,0,56,3,16,123,5,33,4.894522092,9775,58,0,5298,1113,4185,184925,70551,114374,2327,620,1707,74.12177986
90cdbefd57b46281a593894b3a9fbf4686669228,50,4652,1530,3122,6,0,6,2,10,15,4,23,4.292982752,13887,59,1,3764,3182,582,118083,98035,20048,1640,1366,274,92.5682032
fbf042e664aee35296a0280ba0223bf43749a1cf,2,29,3,26,0,0,0,1,3,8,1,2,0.997180399,523,60,2,65,62,3,3935,3710,225,24,24,0,100
63c134f360760a17434b33c26a612a846271523a,28,1752,146,1606,7,0,7,3,17,12,4,17,3.289025522,3382,61,3,699,482,217,34531,24111,10420,242,168,74,94.5389436
4247d21fa036685a098baac84262aa08693d1d82,3,63,22,41,0,0,0,2,5,21,1,2,1.381487218,722,71,0,101,92,9,5963,5687,276,35,35,0,100
04c4041bf470a8657ce25b8e8759ee1823e25141,3,154,95,59,0,0,0,2,5,21,1,3,1.372408726,1055,51,0,151,145,6,8668,8310,358,48,47,1,100
369e241fb3fdb866491f205de11c143b6e91fc05,0,0,0,0,0,0,0,0,0,0,0,0,0,0,52,1,0,0,0,0,0,0,0,0,0,100
a6821a611c0a9a99ad92b4bee362c1402264c9f7,8,115,21,94,0,0,0,2,18,87,3,7,2.562724442,2119,53,2,383,371,12,16701,15998,703,114,109,5,100
97e91887d33a2bf1f4e5b89d15ef661098317da4,1,3,2,1,0,0,0,3,5,14,1,1,0,565,72,1,94,94,0,4076,4076,0,26,26,0,100
b8cd5b1690603993393cf6046bf36adb4abe0f9a,1,7,0,7,0,0,0,3,3,18,1,1,0,332,1,0,69,68,1,2825,2789,36,17,16,1,100
d40e5c4fb9a50e2d4f58cde82636c993ff468348,1,43,14,29,0,0,0,2,2,80,1,1,0,51,54,3,12,7,5,501,371,130,5,5,0,100
e0e70e2cd36daeac6fb2982728100d1d40def841,0,0,0,0,0,0,0,0,0,0,0,0,0,0,2,1,0,0,0,0,0,0,0,0,0,100
197164e0624e3add1f1a7dd96c614d03f6df87c6,2,181,1,180,1,0,1,1,19,22,2,2,0.087280589,602,55,1,140,127,13,5845,4532,1313,27,23,4,99.82142857
a337480eb2cbf7f61716aaed6c31b4e11b63bb4a,2,43,18,25,0,0,0,3,4,47,1,2,0.999806133,599,3,2,106,104,2,5308,5131,177,45,43,2,100
0e07e9bf90a6101d13135d94d82a3dfc55b63151,2,63,38,25,0,0,0,2,6,71,1,2,0.994264609,780,56,2,106,105,1,6333,6072,261,35,34,1,100
574a6855dbfdce3ab7934ffc0b1d8a3138def674,4,125,76,49,0,0,0,4,7,140,1,1,1.33190721,760,0,0,105,92,13,5043,4578,465,34,36,2,100
b4c39a1e89bd1f640d01e31d83d4833602e17a25,2,305,4,301,1,0,1,1,8,0,1,1,0.345922303,547,1,1,97,74,23,5238,3546,1692,39,31,8,99.82238011
1d6f38c081e862d9c2d59638aaf22a3bb27858e5,3,109,53,56,0,0,0,4,9,0,1,1,1.456037929,858,2,2,110,104,6,6044,5669,375,41,40,1,100
071861d30a638dbd4cef05ab0d8bf4bd59c376e5,5,83,1,82,0,0,0,3,8,149,2,5,2.052755916,776,3,3,117,108,9,6128,5706,422,42,38,4,100
8f1ef00bec397ecd83979e0fdbccc04a4829d3f1,1,28,28,0,0,0,0,1,3,20,1,1,0,180,4,4,18,18,0,1293,1293,0,5,5,0,100
0fea11ab366eb0e4d3aa090d470e4523ec987fd7,19,2104,619,1485,2,0,2,2,7,117,1,6,3.341959633,13078,57,0,3563,3253,310,104576,95888,8688,1513,1401,112,96.19205298
1a72f619712ee24e0bfb3e5c97856024f3c82a2c,4,57,50,7,0,0,0,3,6,151,3,3,1.841436852,815,58,1,125,122,3,5702,5665,37,47,47,0,100
4adf59a691e83fa625fb7b1d24b7934c323a5a02,14,171,191,20,0,0,0,4,11,220,3,5,3.448698994,2251,6,0,250,255,5,15569,15583,14,107,106,1,100
7fb9ac4fecc231473004a325fcce5de2916570c8,12,1437,79,1358,6,0,6,1,8,4,2,8,2.740870664,1599,7,1,377,209,168,18164,12220,5944,141,67,74,94.13202934
eb772e637d461ddb498fdf3236b33e0a4efdee2a,0,0,0,0,0,0,0,0,0,0,0,0,0,0,59,2,0,0,0,0,0,0,0,0,0,100
b3ec119995f86bbd3bb06ff6e04f991ba611bf61,0,0,0,0,0,0,0,0,0,0,0,0,0,0,4,0,0,0,0,0,0,0,0,0,0,100
d75c053164619e79cfca5617d34226ac8db9ac65,1,1,0,1,0,0,0,3,3,147,1,1,0,119,5,1,9,9,0,864,853,11,4,4,0,100
f764ea93d273038bc239eadc9f1a390551e3f724,1,1,0,1,0,0,0,2,4,176,1,1,0,157,60,3,23,23,0,1187,1176,11,12,12,0,100
3339536df3ddce70a0fff0f46664e037386cf5e1,6,297,1,296,4,0,4,2,2,33,1,4,2.065116607,112,6,2,43,18,25,1704,581,1123,33,12,21,99.15895711
0d5e43581d395cf26cc9ccde967065f4382623e3,2,21,22,1,0,0,0,2,3,7,1,2,0.271389588,512,7,3,90,90,0,3462,3477,15,32,32,0,100
b1d4dde5e6eb352e5b7b2386a1e03551978945a4,0,0,0,0,0,0,0,0,0,0,0,0,0,0,61,4,0,0,0,0,0,0,0,0,0,100
b3ee46494335fd4a8ab0c444ec1508b1b5962593,4,301,149,152,0,0,0,3,5,155,2,4,1.248757669,975,62,5,186,171,15,8526,7380,1146,63,51,12,99.75186104
5fc968e6caa2a7a3c4b7a75de6c93ff0dba89c9b,2,19,0,19,0,0,0,2,6,26,1,2,0.297472249,372,63,6,44,43,1,3127,2970,157,26,25,1,100
cbbb3bd7ae1053ae3794fada66160aee10664014,3,49,7,42,0,0,0,3,6,274,2,2,1.497249983,543,8,2,61,60,1,3572,3353,219,42,40,2,100
953185014ddedbb9d099845107e948bf4d33003c,4,11,12,1,0,0,0,2,9,20,1,4,1.809723879,1317,8,4,204,205,1,9048,9044,4,67,67,0,100
7c71b0c88cb5ed9d4f6acf7337104245a51a58c2,0,0,0,0,0,0,0,0,0,0,0,0,0,0,64,7,0,0,0,0,0,0,0,0,0,100
a27f633d225fe1f56528a36f3d8e91cddb33c1bc,2,50,17,33,0,0,0,3,10,4,1,2,0.999839302,810,9,5,134,130,4,5989,5780,209,43,41,2,100
37d8e84572183b980663255ed0cdd8a89b06f963,3,65,45,20,0,0,0,3,4,2,1,3,0.881416409,557,65,8,97,94,3,3877,3760,117,39,37,2,100
c7f7fa57aa406cd148f21c09d498b1468c1ce663,2,11,2,9,0,0,0,3,11,16,1,2,0.779349837,972,66,9,138,137,1,7342,7261,81,48,47,1,100
5743455f99b400b0be6f75e5f0f753c2a044d86d,1,2,2,0,0,0,0,3,5,5,1,1,0,449,67,10,78,78,0,3061,3054,7,25,25,0,100
afe8cd8dfed8f0118a97c1d9377eef262717d9ea,4,52,16,36,0,0,0,3,12,62,1,3,0.946633376,1075,68,11,201,201,0,7735,7295,440,89,89,0,99.83471074
540424d50f84c3ad0bd65370374e3d70c352bb72,9,481,29,452,3,0,3,1,13,45,3,6,2.144806538,1837,10,6,330,296,34,16688,14197,2491,115,98,17,93.74079529
3226ce992a32c52e76dd3ae5fdb1c9e870b0214f,3,65,12,53,0,0,0,3,13,59,2,3,1.227079821,944,69,11,157,150,7,7692,7177,515,53,51,2,100
7d214749a349567f258e3f83c554ae73cd5c0781,1,222,79,143,0,0,0,1,4,45,1,1,0,180,5,0,24,18,6,1964,1293,671,10,5,5,100
afe33c981062ad60320b06629c473ed16273d9de,1,3,4,1,0,0,0,4,5,45,1,1,0,85,11,7,13,13,0,436,463,27,8,8,0,100
3ea19d86d7108ae47dde462871d97e8249f3a2fe,1,4,0,4,0,0,0,4,10,72,1,1,0,629,6,1,84,84,0,4199,4183,16,34,34,0,100
c6f50f122d63b44dfae29cbed470bbf5b41f83f2,1,47,23,24,0,0,0,2,5,5,1,1,0,282,7,0,26,24,2,2025,1964,61,11,10,1,100
c9bc1e1f33401007de68a8d495c6ec904f0965fe,1,2,1,1,0,0,0,1,2,39,1,1,0,184,9,2,45,44,1,1089,1075,14,22,22,0,100
af795c024fd3d43ca3f7d6048d47cf4d0a485398,4,64,8,56,0,0,0,2,14,56,1,3,1.130082818,993,10,2,195,195,0,6771,6468,303,87,86,1,100
61a67cb956fe5552b15b335c2b9fb8fc4b8d2620,27,470,1589,1119,0,0,0,3,9,71,3,9,4.169668568,10533,12,7,2185,2503,318,69523,77610,8087,833,889,56,100
0cd62512a2c10e3521c27cf8eb2943f5d6e66e01,4,50,136,86,0,0,0,2,4,12,2,2,1.769921714,637,70,10,36,45,9,4171,4749,578,22,26,4,93.41111874
a989b17b44e194b39fda03371fca9a91a09d3fb6,15,178,180,2,0,0,0,4,9,315,1,1,3.491572652,3499,71,11,218,215,3,23602,24024,422,121,120,1,100
a7b45622309cc1753fa082be0c52d5e3e90faa42,23,1374,136,1238,1,0,1,2,15,88,4,17,2.799645042,4827,13,5,1071,785,286,42671,34709,7962,402,331,71,95.87255612
e2fcffe618ec9c9b922f0fc390cdada0557894c1,1,0,1,1,0,0,0,4,5,67,1,1,0,83,14,6,8,8,0,515,524,9,4,4,0,100
2f4819395bcaec9e244da7d5ddcf13de3e518012,1,1,1,0,0,0,0,5,11,0,1,1,0,319,15,7,58,58,0,2531,2531,0,12,12,0,100
8525fe62eee72a42178b8e8a64e60dffc9953401,3,236,50,186,0,0,0,1,8,17,2,3,1.1930151,1034,72,6,196,182,14,9740,8228,1512,60,55,5,92.66666667
12d6c965feda9e3a134c5877c5cb83dacd574834,5,278,34,244,1,0,1,2,20,186,2,4,1.731176666,1304,16,6,267,249,18,10991,9724,1267,71,63,8,97.17291256
f24db42b576c67c1b6caa8be6f8ead6b949d086a,1,8,1,7,0,0,0,1,3,9,1,1,0,73,17,7,11,10,1,339,325,14,7,7,0,100
ac70d73c6de06e2d912122770fae5a6e09fd1c8e,1,14,1,13,0,0,0,4,4,67,1,1,0,56,18,8,11,9,2,559,455,104,2,2,0,100
600f0f15eac08f63ef76eb1c2e66ee761f560cb0,37,804,100,704,14,0,14,5,16,17,3,9,4.546994372,6498,19,9,737,684,53,48726,45760,2966,320,295,25,90.20501139
112dd60bc6ca7948a6f3d75cb9c7c0d72e70f841,0,0,0,0,0,0,0,0,0,0,0,0,0,0,11,2,0,0,0,0,0,0,0,0,0,100
bc755d77d28691f1ff522b53633adb5da83c3e1a,2,126,1,125,0,0,0,2,11,1,2,2,0.274572665,873,12,3,140,133,7,8002,7165,837,47,45,2,100
7a9fd90c345a6e3f9656366773d452f18e0d5b15,3,59,12,47,0,0,0,1,21,2,2,3,0.725385321,1327,20,10,254,252,2,10140,9885,255,64,62,2,100
ff30d7ff5cc83bcaa69cb2214e4f7af0016639af,7,27,10,17,0,0,0,3,17,14,2,6,2.276228365,2614,13,4,437,429,8,19343,19209,134,141,141,0,100
7cfcc30025f881284d4b4f1e7d77a6f2f1f4a71e,1,2,2,0,0,0,0,5,10,8,1,1,0,272,21,9,31,31,0,1883,1883,0,12,12,0,100
cdc25da32c714b53a23228946cc0d1e4fe3e45c3,2,43,1,42,0,0,0,4,18,11,1,2,0.266764988,1076,14,5,165,164,1,8463,8114,349,54,53,1,99.83948636
7598d6829ef590f8f026c4a64e3cc3ef46c384d5,0,0,0,0,0,0,0,0,0,0,0,0,0,0,22,10,0,0,0,0,0,0,0,0,0,100
6e0def2cbc09872c3500bdbdb68ec1b796a2d620,1,13,1,12,0,0,0,4,7,3,1,1,0,176,23,11,27,26,1,1367,1309,58,15,14,1,100
c6a6dff6856d184f1bd6eb7f25ac1cb555148d4b,12,435,182,253,0,0,0,3,13,6,3,6,2.296191967,3471,15,5,577,560,17,28579,26821,1758,224,223,1,96.66666667
5f91a3e585a85bd84ad4fe6c222b487ad3ab4dea,1,1,3,2,0,0,0,4,6,23,1,1,0,127,16,6,32,33,1,633,644,11,25,25,0,100
1e96a028b981c0bd7e44f76822a8ff29be65fe00,1,14,5,9,0,0,0,4,6,12,1,1,0,280,17,7,40,40,0,1953,1904,49,11,11,0,100
546617be36504d1cfccbca5acd6a2a9d203f0bc4,1,2,2,0,0,0,0,4,7,1,1,1,0,289,73,3,40,40,0,1953,1953,0,11,11,0,100
23134c6312035e6a7073d8e58d0332c1da60d913,4,71,18,53,1,0,1,4,12,1,1,4,1.714575354,813,74,4,120,117,3,6078,5905,173,51,49,2,97.74193548
47dec01df2b57db165e49f03e2002023c5a2a104,1,10,6,4,0,0,0,4,9,0,1,1,0,295,24,12,41,41,0,2022,2008,14,11,11,0,100
42e2453a8427edce11dcb6439f559a0d7f73ad44,1,1,2,1,0,0,0,5,10,15,1,1,0,220,25,13,7,7,0,1566,1570,4,6,6,0,100
fcb561e282db9913bd7b3f26bfa9f3aa40d45992,1,36,33,3,0,0,0,2,3,3,1,1,0,132,18,7,27,26,1,978,948,30,7,7,0,100
9afc663d0d2e746180b3bf26315d32d64e7c7c1c,4,67,4,63,0,0,0,3,11,311,2,4,1.666704556,857,73,0,78,75,3,8238,7819,419,36,34,2,100
c04138d38fc4cb6ba23d8220bb40964fed653cc2,15,1075,26,1049,4,0,4,1,14,33,3,10,2.435366263,2052,26,14,364,267,97,20134,14019,6115,160,105,55,96.17151608
834033ad4566f9d4b8aaa5f215f9242dfeae5b59,3,54,30,24,0,0,0,5,12,8,2,2,1.442205707,825,19,8,37,36,1,7141,7034,107,27,26,1,100
8e7657a7ee3adb95cad9afb37a6b53dfa5b86d8f,2,0,9,9,0,0,0,3,3,264,1,2,0.99107606,124,20,9,14,16,2,620,684,64,14,16,2,100
c57c531798501a4bec4507b9d0ec93d43d4c1c1a,1,10,12,2,0,0,0,2,5,0,1,1,0,184,21,10,10,10,0,1227,1228,1,4,4,0,100
3071da2fca0a5e9123622334cdab8de22c5cee89,4,180,7,173,1,0,1,1,11,0,2,3,1.582106422,596,22,11,98,90,8,5379,4372,1007,63,58,5,99.78693182
38c4294ba398f85d8d0f1ad5b38ae48167d876f7,2,11,1,10,0,0,0,3,3,217,1,1,0.918295834,147,23,12,31,30,1,1014,967,47,10,9,1,100
f741870c2145dd7a060e6408d6e73ca26a175943,13,149,40,109,0,0,0,4,22,155,5,9,2.987305379,2924,27,15,473,448,25,20844,20183,661,140,134,6,100
b8fd11f4cb2ce66bee1a506439d16ada5350d956,3,77,72,5,0,0,0,5,13,12,1,2,1.088994011,655,28,16,77,76,1,5938,5867,71,27,27,0,99.57507082
13587ef40e72e8fc16821890bfa97ebe568dfc34,1,2,1,1,0,0,0,2,3,1,1,1,0,268,24,13,45,45,0,2075,2064,11,22,22,0,100
066b1c404df3a81ffe7eb293a54f03aed1d97f05,1,20,0,20,0,0,0,3,7,0,1,1,0,158,25,14,5,4,1,1192,1068,124,5,4,1,100
d37830c9a9b5c8bd571b87e676eb38627b38a139,5,65,12,53,0,0,0,4,23,8,2,4,0.948477774,1323,26,15,230,223,7,10188,9913,275,71,68,3,100
d454f842072626aaf466b458db0ae56f2a2afb0a,1,3,1,2,0,0,0,4,5,67,1,1,0,83,29,17,3,3,0,507,503,4,2,2,0,100
af23684612837c6277e2cd645d15bb4efd4db7fd,0,0,0,0,0,0,0,0,0,0,0,0,0,0,30,18,0,0,0,0,0,0,0,0,0,100
439cd651ac83ae90f7ee0f45027254e9f90c18b2,1,15,0,15,0,0,0,5,14,0,1,1,0,170,31,19,12,11,1,1755,1649,106,8,7,1,100
e8eb0120339069c8add074e7e7919bc904fce8cb,3,3,3,0,0,0,0,5,20,5,2,3,1.584962501,1374,27,16,179,179,0,10388,10384,4,63,63,0,100
ef624165b1b38d81b65b1df25da42486d7e7242f,1,0,15,15,0,0,0,5,15,0,1,1,0,182,28,17,11,12,1,1649,1755,106,7,8,1,100
39818322830827cc1ddf2ffef22a456688e4c40d,1,4,4,0,0,0,0,5,12,3,1,1,0,231,75,5,30,30,0,1758,1758,0,5,5,0,100
b08717243372973d2b264617314de629065278cb,4,3,4,1,0,0,0,4,24,4,2,4,1.950212065,1297,32,19,218,218,0,9674,9687,13,66,66,0,100
c53934070c07d337118c53eb0b19d6675202d26f,41,438,466,28,0,0,0,2,13,22,2,6,4.284251728,6890,76,4,474,482,8,48041,48176,135,252,256,4,98.76203576
19b9afa5f7c86ad3957aba4fb430fcd5264ea685,0,0,0,0,0,0,0,0,0,0,0,0,0,0,77,5,0,0,0,0,0,0,0,0,0,100
4c2ce79385866f086799deae82f4db5d9aab3099,1,1,1,0,0,0,0,5,15,2,1,1,0,380,33,20,57,57,0,2865,2865,0,26,26,0,100
282b79dd71c924f3b573f40f5c84e9fffdad0032,5,116,32,84,0,0,0,4,15,114,2,4,1.924155711,1216,78,5,178,164,14,9354,8908,446,103,94,9,100
c248a3dc10ebda552f5e10ca9173b3e9fd11a1a2,0,0,0,0,0,0,0,0,0,0,0,0,0,0,79,6,0,0,0,0,0,0,0,0,0,100
5134a092a0d45d608cdbef7a1763bc9092d7c4ca,3,891,53,838,0,0,0,3,21,17,2,2,0.82730516,1623,34,13,258,208,50,17303,12638,4665,82,69,13,100
eefdec94a251e6d7bbf0dcb32b487961c665ba69,2,20,3,17,0,0,0,3,14,19,1,2,0.965636133,844,80,7,159,157,2,6668,6518,150,57,57,0,96.46278556
f42bc7734c709ad5d96160271f8e62660574e133,8,187,19,168,0,0,0,4,22,11,4,7,2.150705957,3717,35,14,505,486,19,30075,29161,914,166,161,5,99.59481361
e0267df7c4777254228906efec2ec5f64290caca,7,147,21,126,0,0,0,4,23,7,3,6,2.241360301,4042,36,15,573,560,13,32817,31981,836,190,185,5,99.19807538
184968e814ecdf1a161847f8b4831638fdbdb45b,4,309,1,308,1,0,1,1,13,56,4,4,1.131807789,791,29,14,193,150,43,7761,5855,1906,60,50,10,93.55281207
5988495099432a977de9f161843b97e72c97cc98,2,10,0,10,0,0,0,3,13,166,1,2,0.721928095,257,30,14,34,32,2,1545,1491,54,15,14,1,100
b11f5aab9970b56886c8c9a04f7598ba3b50879c,15,4732,107,4625,6,0,6,5,24,16,3,10,2.9739027,8778,37,10,2772,1938,834,91268,65043,26225,1327,936,391,87.71306818
b41d9ee37cc705cc4a5eb86a9a7d04b2082a6458,14,981,219,762,2,0,2,5,25,55,2,5,2.1167534,3603,81,6,431,396,35,30473,26799,3674,172,150,22,99.56559513
07b0c9b86c8923dcec18d8797e395188c1607584,11,78,20,58,0,0,0,2,15,46,2,7,2.785821451,3127,38,11,355,346,9,25042,24726,316,134,129,5,99.74025974
0ebbb3775dc563bbd6f042e414f5ac3b6fdd973b,1,160,0,160,1,0,1,1,1,0,1,1,0,0,39,12,26,0,26,971,0,971,6,0,6,99.91334489
5df60185b402b2246590151252b38e178d46f28e,2,187,64,123,0,0,0,2,7,0,2,2,0.919618134,563,40,13,73,70,3,5293,4367,926,32,32,0,100
c737e3803b3e3a957eb8af3b4998bcf60597f9e7,1,1,0,1,0,0,0,5,15,3,1,1,0,200,82,7,27,27,0,1199,1197,2,11,11,0,100
66e425f20606233fa6753887c4d06f57c16672eb,3,17,14,3,0,0,0,5,15,267,1,1,1.491860346,803,83,7,26,26,0,5056,5010,46,24,24,0,100
1785f0ee59dacd6e26eb4596b79907f6b778d3d8,3,83,16,67,0,0,0,2,8,7,2,2,1.122296192,830,41,8,96,89,7,6962,6568,394,52,48,4,100
1a14264fd3014388a881f6b7928f75bcf4060f0f,4,26,7,19,0,0,0,4,25,11,2,4,1.884196368,3181,42,8,384,382,2,25370,25261,109,124,124,0,100
0c3954045c2b92816ce9674305e30b3eb79e6b72,1,1,1,0,0,0,0,1,3,7,1,1,0,542,84,6,20,20,0,3313,3313,0,18,18,0,100
bbec68b5837ad7015ef6dcfabb60e112c447bdf0,3,28,8,20,0,0,0,4,26,6,2,3,1.232660257,2768,31,2,316,315,1,22005,21907,98,107,106,1,100
d1727c5125fcb68e89d2fc63743cc142a82ffba7,1,3,1,2,0,0,0,2,2,21,1,1,0,157,85,6,27,27,0,1207,1196,11,12,12,0,100
56d4f563bc251e22cc1ee529b265f5b2b52b0258,2,25,4,21,0,0,0,3,7,114,1,1,0.849751137,641,86,4,129,125,4,4283,4197,86,49,47,2,100
26b208ed3032f6979ad92e978cd9f71328c0be99,3,14,5,9,0,0,0,4,27,32,1,3,1.189731917,1978,43,1,305,304,1,15307,15244,63,93,92,1,100
6465503be6a4268f7ff4a2d787ecf4a4ad174988,0,0,0,0,0,0,0,0,0,0,0,0,0,0,87,1,0,0,0,0,0,0,0,0,0,100
924f0b038f351c26b1df72e21ad7e5dedbdb525e,1,1,1,0,0,0,0,5,16,66,1,1,0,201,44,1,27,27,0,1199,1199,0,11,11,0,100
1411e3739ab6f161fe7094dbab99ee828af48dd5,0,0,0,0,0,0,0,0,0,0,0,0,0,0,88,1,0,0,0,0,0,0,0,0,0,100
5862bbe6e12248b2dd9c8c1ef26a7c25a2fefd0a,0,0,0,0,0,0,0,0,0,0,0,0,0,0,45,2,0,0,0,0,0,0,0,0,0,100
b17da44ef2e1e217da53bf3ea6e9290c3bb7df9b,0,0,0,0,0,0,0,0,0,0,0,0,0,0,46,2,0,0,0,0,0,0,0,0,0,100
0ec663f51bf1b1f238f3a7f8e94692589a542bbb,0,0,0,0,0,0,0,0,0,0,0,0,0,0,47,3,0,0,0,0,0,0,0,0,0,100
437e6c4dc3fb963f81a82ee4ab653cd84e48005d,2,70,7,63,0,0,0,4,11,224,1,1,0.879697578,726,7,0,99,92,7,5159,4767,392,39,36,3,100
1abc8db22b55d8c0e090080dda6c70c144b09e59,7,89,63,26,0,0,0,5,16,99,1,2,2.514427149,2051,32,0,152,147,5,14673,14587,86,63,62,1,100
6ab2a681e167c7899f3c26f9b5e97e4781111efa,0,0,0,0,0,0,0,0,0,0,0,0,0,0,48,4,0,0,0,0,0,0,0,0,0,100
5c5b87ce12988f5d8e16d148b23fd6d641c54a24,2,30,4,26,0,0,0,2,26,50,2,2,0.672294817,1182,33,1,160,159,1,8270,8119,151,44,44,0,100
d6b1eb6e8f74b95e3a1098c1a0e6e17b049fb102,8,168,344,176,0,0,0,2,28,124,2,7,1.981620359,3581,49,5,666,700,34,26197,27204,1007,208,213,5,100
c092f7dfe767d1a8cb5e79ee7b66b37190b98c7f,2,4,6,2,0,0,0,3,9,330,1,2,0.721928095,219,8,0,31,31,0,1424,1434,10,13,13,0,100
5a107094482e065ddc24143aba16cfee0b4fe500,16,318,113,205,1,0,1,2,27,109,2,8,2.88023976,4270,50,6,590,564,26,32622,31732,890,209,192,17,99.82698962
c643db28dcf385f7f2be553480c55241d252ecb1,1,1,0,1,0,0,0,4,7,0,1,1,0,563,8,1,21,21,0,3471,3454,17,18,18,0,100
a170f53bde4a3947243ca0439544b2769c9240ee,12,1432,1,1431,9,0,9,1,19,47,1,6,2.986664183,561,51,6,184,71,113,12202,4421,7781,106,20,86,96.33333333
46c506d96d49df9afd750347cb7a12ccac0f1e46,0,0,0,0,0,0,0,0,0,0,0,0,0,0,34,2,0,0,0,0,0,0,0,0,0,100
7b17cef735e4d35070deb40c2f535c317a1b14ab,17,1334,98,1236,4,0,4,1,29,67,5,14,3.453351986,5085,52,7,1130,991,139,46386,38937,7449,368,324,44,90.18987342
7e3f287ca9413cb2dd0c4c76ea352fb18048f295,1,0,3,3,0,0,0,5,20,0,1,1,0,486,53,8,72,72,0,3521,3535,14,41,41,0,100
3be10df92c92e39e4d91ff2114f3f72783926e82,2,278,0,278,2,0,2,1,1,0,1,2,0.879524943,0,54,8,31,0,31,949,0,949,13,0,13,99.61270333
63845fd384330ec02eb7393288ac2a60bf734b31,1,13,4,9,0,0,0,5,10,47,1,1,0,155,0,0,25,23,2,1231,1168,63,7,7,0,100
117c60136b18f8d33629276133dfdce09050d3e1,1,290,0,290,1,0,1,1,1,0,1,1,0,0,55,1,21,0,21,1901,0,1901,9,0,9,98.374613
49e682fdd444db1fe440240944d1191a91d6d3ca,3,29,2,27,0,0,0,1,2,40,2,3,1.229746413,621,56,1,67,65,2,4374,4199,175,39,38,1,96.76056338
b6c62f791de852608c4d292a0a13269fef097280,19,627,705,78,0,0,0,5,17,154,1,2,3.884836802,6015,89,0,363,374,11,43749,43177,572,180,185,5,100
7dc84d72d9df267af20d9ac3746390bb333dc409,6,44,30,14,0,0,0,5,18,42,2,3,1.786716323,2067,90,1,168,169,1,15039,14965,74,72,72,0,100
94118851fe2675ed1916b930a751415bbc6acf95,1,15,6,9,0,0,0,5,5,209,1,1,0,524,57,2,107,107,0,3704,3662,42,39,39,0,100
467915c6168c0b6e7712e1a39bd10884b757130a,0,0,0,0,0,0,0,0,0,0,0,0,0,0,91,1,0,0,0,0,0,0,0,0,0,100
416ca064404ef85ff5dd7de5a302592ca2569aa4,4,67,74,7,0,0,0,3,30,122,2,3,1.610857751,3006,92,2,384,385,1,23566,23564,2,120,120,0,100
05a239dadf27fd066a9ae1e2fdf961c2d7ee56e1,12,671,266,405,0,0,0,2,28,214,5,9,1.45170072,3822,93,3,538,523,15,30877,28164,2713,205,195,10,100
7a8645f0c459b6e091135fc45b343fdf5b2c8251,1,1,1,0,0,0,0,6,29,5,1,1,0,620,94,4,138,138,0,4610,4606,4,25,25,0,100
f7237c8070e828de3a6223ac1a37c897a1ebe936,2,32,7,25,0,0,0,3,5,342,1,2,0.477071306,129,95,5,24,19,5,955,823,132,14,14,0,100
70c47e803512efbec51dc5ec5c5d725a5dfa04c3,6,285,23,262,3,0,3,5,12,138,1,3,1.991485231,495,74,0,103,70,33,4464,3492,972,47,28,19,99.29622521
67f84187c3c04af33a938c5be6a2086632c79385,1,3,1,2,0,0,0,5,22,17,1,1,0,485,75,1,73,72,1,3532,3523,9,41,41,0,100
14a86ba9b623ebe4b6c2428c03e033f5ec6eddac,3,197,0,197,2,0,2,1,6,83,1,1,1.261649741,69,96,5,31,11,20,1083,578,505,13,2,11,99.68334389
bdb11123b989cd97aa7ca14aba099b9343025e14,1,16,16,0,0,0,0,4,9,65,1,1,0,162,97,6,4,4,0,1137,1141,4,3,3,0,100
218b1ea8e77132801bbcfd46c1539edc98909f4b,1,3,3,0,0,0,0,5,23,2,1,1,0,487,98,7,73,73,0,3532,3532,0,41,41,0,100
00a5eba1f645991d3eb2bf7365057c045f86a25f,0,0,0,0,0,0,0,0,0,0,0,0,0,0,58,0,0,0,0,0,0,0,0,0,0,100
89a9243fd3a11f0852c303533b92013633cd6c23,1,14,7,7,0,0,0,3,11,54,1,1,0,360,59,1,57,56,1,2722,2678,44,24,24,0,100
fd704487df49428cba258c8ef26db970dbc9d211,2,62,5,57,0,0,0,4,22,32,2,2,0.709825885,1706,60,2,159,156,3,14707,14367,340,54,53,1,100
dbcdb6d6430fd5cde17df1cf3bd0f805795da2d7,13,121,403,282,0,0,0,3,31,141,3,8,2.712246345,6962,99,8,1163,1234,71,51326,53024,1698,399,416,17,100
b8f0622ff6a73af2b4764f43165e105442965d3b,1,8,5,3,0,0,0,5,24,0,1,1,0,462,100,9,77,76,1,3829,3798,31,20,20,0,100
58be76016768fdb38f2cdb7e4b0acd7d8e468d0d,1,3,1,2,0,0,0,6,30,29,1,1,0,620,101,10,138,138,0,4619,4610,9,25,25,0,100
d1d2fd3dcb88c160803cecb02de104618838585d,0,0,0,0,0,0,0,0,0,0,0,0,0,0,102,11,0,0,0,0,0,0,0,0,0,100
fa5f81c7734f8af8e1bdc669d6cbe2e5951e2bac,9,3185,29,3156,3,0,3,5,32,104,1,4,2.641719227,9612,61,3,2841,2234,607,90779,71350,19429,1354,1115,239,93.18181818
1e5826f85601319a2ef9c4bdab999ff1db697668,3,83,1,82,0,0,0,4,31,42,2,2,1.065948201,1693,103,12,188,182,6,12536,11992,544,65,63,2,100
7a2b218527aed314db64865265550b3d809bae11,0,0,0,0,0,0,0,0,0,0,0,0,0,0,104,13,0,0,0,0,0,0,0,0,0,100
692ff834e2059ec2dec2ab35f05f5b77c207bc20,1,1,0,1,0,0,0,5,17,194,1,1,0,201,62,4,27,27,0,1201,1199,2,11,11,0,100
d93ec7c1a9be0dd21e89ebbb37e2e62773fd366d,1,1,0,1,0,0,0,5,18,0,1,1,0,202,63,5,27,27,0,1203,1201,2,11,11,0,100
f7f40b94428181bd06431f1bc60118d052f40f12,1,2,0,2,0,0,0,3,4,138,1,1,0,119,105,11,34,33,1,797,775,22,7,7,0,100
630be6b5fbf5e441a72af3008b2a31266cf5ccac,1,21,1,20,0,0,0,2,3,242,1,1,0,158,64,6,32,27,5,1259,1207,52,12,12,0,100
c57e65c5820b49657b9d059b5f039e71e90c3e77,1,1,0,1,0,0,0,6,32,10,1,1,0,632,65,7,140,140,0,4712,4710,2,25,25,0,100
a8cd4fbc65417ee28d0d8e86a6d166f78429cdba,0,0,0,0,0,0,0,0,0,0,0,0,0,0,106,11,0,0,0,0,0,0,0,0,0,100
b18457d2600a412746d3a2ebb03b66c6ed183188,1,121,32,89,0,0,0,1,2,149,1,1,0,131,66,8,15,9,6,1243,887,356,7,3,4,100
48b883f4c05217e65dc0eef57a0391a58e8b6c74,8,32,9,23,0,0,0,2,21,451,3,5,2.831969687,1066,107,12,219,213,6,8147,7989,158,80,74,6,100
ff19448eec13a121d658dde35b9bd46eeb3b7c31,1,1,2,1,0,0,0,5,12,38,1,1,0,285,108,13,40,40,0,1926,1926,0,11,11,0,100
128a23401fb872a4ffb2b39ee3e09e4f5b863364,2,104,2,102,0,0,0,5,33,19,1,2,0.077016876,1629,109,14,378,348,30,12401,11758,643,115,110,5,100
805a1c988d95597185c36be7f7f3adcc94395f84,1,6,1,5,0,0,0,4,22,0,1,1,0,609,110,15,123,122,1,4796,4763,33,36,36,0,100
a8f0c08ab6ee5dba84afe363e3330cb20821f147,0,0,0,0,0,0,0,0,0,0,0,0,0,0,67,9,0,0,0,0,0,0,0,0,0,100
60db85bab7f796c716545d72ab65802247c2a9ac,0,0,0,0,0,0,0,0,0,0,0,0,0,0,68,10,0,0,0,0,0,0,0,0,0,100
f6fc0422b61c88922d4e40db8e76d4ff89e8120b,5,322,66,256,0,0,0,5,26,20,1,3,1.978650863,2526,69,11,516,469,47,21234,19648,1586,183,177,6,100
2982e3d1cb230fcbc5134c62c402aad98cb3d33f,2,34,4,30,0,0,0,2,23,15,2,2,0.485460761,812,111,12,138,138,0,6191,6039,152,43,43,0,100
977d69f2263ba6d8c6866fc07153485ab62cc54e,3,54,5,49,0,0,0,5,33,67,2,3,0.595649145,1004,70,12,150,148,2,7883,7694,189,30,30,0,100
f31450c93e564cbcbc7f9a2c264887d056b2aecf,3,38,18,20,0,0,0,2,11,93,2,3,0.617523541,354,112,13,81,79,2,2593,2424,169,30,30,0,100
e916f17cc56bebcfe326d4d3d5fdb5d3acce75dd,1,1,1,0,0,0,0,2,2,179,1,1,0,70,113,14,0,0,0,569,569,0,0,0,0,100
1e0bbb733f94f7c8ec7cffa81f34d3faa02cc434,0,0,0,0,0,0,0,0,0,0,0,0,0,0,114,15,0,0,0,0,0,0,0,0,0,100
1cd88220831ebcd95cb42150dbbfd186f9573447,1,13,8,5,0,0,0,2,2,183,1,1,0,55,115,12,11,12,1,424,410,14,6,6,0,100
64203710529cd301018faa12e92bd7df24065faa,1,3,2,1,0,0,0,5,13,9,1,1,0,161,116,13,7,7,0,1021,1009,12,3,3,0,100
561b3c8a9620aa070030440ebdce045c9c23fd33,3,38,14,24,0,0,0,5,34,28,1,3,1.176980229,2179,117,11,347,344,3,17090,16938,152,99,99,0,100
af221d152a224481a86d79d866f1b35e50ba09c0,0,0,0,0,0,0,0,0,0,0,0,0,0,0,118,12,0,0,0,0,0,0,0,0,0,100
bfd7d10728c1184d3431c26de2f64eb180fb7af3,1,1,1,0,0,0,0,5,35,2,1,1,0,1197,119,13,239,239,0,8614,8606,8,65,65,0,100
ac3426ef30e5b689c06bb2763276f951c428efeb,0,0,0,0,0,0,0,0,0,0,0,0,0,0,120,9,0,0,0,0,0,0,0,0,0,100
95645f645499533ba5fec9ef7729aaf901dbe3a2,5,1538,18,1520,2,0,2,3,18,175,2,3,1.05515185,460,121,10,222,49,173,14259,3651,10608,63,23,40,97.71689498
58f5f529f5111a671be250d2f1db7512b9dfd232,0,0,0,0,0,0,0,0,0,0,0,0,0,0,0,0,0,0,0,0,0,0,0,0,0,100
2fb35eb9c51831eb6d54d25199b21cd4ebf15a2b,6,2019,1,2018,2,0,2,5,28,57,1,3,1.873993448,9211,122,0,2536,2130,406,80277,68728,11549,1284,1107,177,91.59356725
e4dc61d52b159b21ab2cced635a789c2b1e551d6,2,31,25,6,0,0,0,6,29,2,1,2,0.543564443,1058,0,0,115,116,1,8853,8898,45,37,36,1,100
de0cc9e7f62c1a44474b196d521b87d1ff902f0e,10,457,3,454,4,0,4,5,36,73,2,5,2.912403902,3259,123,1,508,476,32,27459,24974,2485,158,137,21,98.96373057
f81a224fc757c6204adf1aa9b7700cae38b05343,5,29,20,9,0,0,0,6,31,0,2,3,2.054995583,1550,1,1,223,221,2,11902,11867,35,59,59,0,100
9dc278379625a3a0f00fcbeea69daa7772190311,2,46,9,37,0,0,0,6,15,18,1,2,0.305400571,336,71,0,57,48,9,2498,2301,197,19,16,3,100
170112904d56bef33a47a45b9f85c7dad7a8c9c6,0,0,0,0,0,0,0,0,0,0,0,0,0,0,124,2,0,0,0,0,0,0,0,0,0,100
542246cce23e602cc79362fdd28777b79031f91a,4,43,0,43,0,0,0,4,34,206,2,4,1.101269849,1962,125,2,205,202,3,14719,14503,216,82,80,2,100
d9b375b9a8749989b7cfd2c9a79f518598056ac1,2,7,5,2,0,0,0,6,35,61,2,2,0.811278124,805,1,0,150,149,1,5801,5821,20,28,28,0,100
49e6086c23d661205a29dbd77bb6f65066acbe77,1,4,4,0,0,0,0,2,2,188,1,1,0,17,2,1,2,3,1,106,112,6,2,2,0,100
2e509e4bc4f06e1c207d5702aad55b290ef390a4,57,15455,48,15407,44,0,44,3,37,45,4,18,4.633391073,3834,3,2,3159,586,2573,122288,28808,93480,1280,196,1084,91.1627907
a79e39a53e0311f98f5a5d08fe156beda8b669d4,0,0,0,0,0,0,0,0,0,0,0,0,0,0,2,1,0,0,0,0,0,0,0,0,0,100
aab78731a7a7e8de1ed5344bef94152ac83d6207,3,98,64,34,0,0,0,2,36,299,2,3,0.916212894,826,4,3,175,180,5,6117,5933,184,34,35,1,100
13e83d6e524e696ef973f251577e93f236e39cd9,52,3775,547,3228,4,0,4,2,38,231,5,22,4.555290291,18677,126,2,4035,3586,449,160560,140801,19759,1351,1260,91,99.45684973
32e6715594a7a198d04f9dc4321288f5bd15b3e4,0,0,0,0,0,0,0,0,0,0,0,0,0,0,72,1,0,0,0,0,0,0,0,0,0,100
d540ad385d77d9847c3e9ddccc81c48e589ee833,1,59,23,36,0,0,0,2,2,17,1,1,0,658,3,2,62,56,6,5756,5579,177,24,22,2,100
fa26a0b4f53345974c9339a4f37bf6e85f78d69c,1,24,4,20,0,0,0,2,2,20,1,1,0,202,127,3,32,26,6,1831,1749,82,18,16,2,100
a8c878ab5f1b9fbfb28f7d985946913b155ebd64,3,58,13,45,0,0,0,5,39,3,2,3,1.531905284,3780,4,3,422,420,2,31157,30826,331,141,139,2,100
4bf55b881376abe1257678476150ca4c37c48596,5,15,16,1,0,0,0,5,22,193,2,2,1.275424537,2241,5,3,184,184,0,16390,16383,7,90,90,0,100
06d6f3e54648a9da7a334f2ea695c38f5eced332,0,0,0,0,0,0,0,0,0,0,0,0,0,0,6,4,0,0,0,0,0,0,0,0,0,100
dd971a1cd49b2e37e3bee966d47ca7e5145657bc,0,0,0,0,0,0,0,0,0,0,0,0,0,0,9,0,0,0,0,0,0,0,0,0,0,100
7701fd8e35779f8dd985c6eabe7b750224779f30,1,2,2,0,0,0,0,6,9,490,1,1,0,290,5,4,26,26,0,1820,1820,0,18,18,0,100
ac919b28dfb12730b22c27de0209d3da7897fccc,3,341,2,339,0,0,0,6,40,22,1,3,0.980371515,2535,7,5,362,329,33,21241,19885,1356,114,105,9,100
1a697a0909f1e43334bd36cf79c82b8c98b6f18a,1,13,16,3,0,0,0,2,2,55,1,1,0,308,6,3,52,51,1,2017,1994,23,26,25,1,100
3d3f96ca7939e687944f1426419db673f8797f3e,2,4,1,3,0,0,0,6,23,18,1,2,0.970950594,1216,8,3,57,57,0,10249,10232,17,34,34,0,100
c5cc86a802ba5e17e78df9ee7671ca42bb1fe465,1,38,25,13,0,0,0,2,2,55,1,1,0,185,7,4,32,29,3,1199,1147,52,13,13,0,100
86b20eba0670d6af5d5e0919ac780dc5ce5765ea,1,57,48,9,0,0,0,2,2,55,1,1,0,214,8,5,30,28,2,1609,1612,3,13,12,1,100
5d2a0ce7f19f1ba86f67f5efb9523d9edf9525b8,2,15,2,13,0,0,0,3,13,40,1,2,0.787126586,396,9,4,95,93,2,2956,2879,77,34,34,0,100
437f6d96c3cfc6764668b56ef46f88c6e8f2ae80,2,5,1,4,0,0,0,3,3,27,1,2,0.918295834,256,73,1,30,30,0,1927,1898,29,13,13,0,100
d88c157d83c10fdf66b76ead7b7c16fe60d82e26,4,251,12,239,0,0,0,6,41,14,2,4,1.059902806,4282,10,5,563,545,18,35669,34129,1540,183,180,3,100
02041c56dc1d2ef3a47cf6a2966c0850d3947236,8,95,11,84,0,0,0,2,3,40,2,5,2.622995893,1938,9,6,307,298,9,15753,15206,547,135,132,3,100
9da6a67330f179636d20f5719cd514e6fd8fe892,4,61,16,45,0,0,0,2,4,14,2,3,1.37904458,1366,10,6,160,155,5,11149,10850,299,69,68,1,100
3cec83721319ba6d7ff9dc7ca1135bcd9aeb9c4a,0,0,0,0,0,0,0,0,0,0,0,0,0,0,11,5,0,0,0,0,0,0,0,0,0,100
58efe72a1bbd7706ffa470a6b084ec96f1916925,1,4,2,2,0,0,0,4,6,255,1,1,0,89,12,5,17,17,0,574,559,15,7,7,0,100
eb53de39e4d700f124e70526dc0ac63a696001d0,5,238,43,195,0,0,0,5,14,26,2,5,1.228066979,1920,13,6,152,136,16,15867,14766,1101,81,78,3,100
ea8663e98569d3919888ae8054ab1df0c7ae0423,2,93,61,32,0,0,0,6,42,10,1,2,0.826354168,2791,14,7,376,376,0,21877,21719,158,117,116,1,100
2d3ff339c08b511be33a25645bd2f13992113640,3,14,17,3,0,0,0,3,25,51,2,3,0.753827515,812,15,8,163,163,0,6297,6410,113,43,43,0,100
a2b6184d2e6cf05f039140684b64e52271330505,2,28,5,23,0,0,0,3,3,1240,1,2,0.918295834,87,16,9,17,14,3,421,312,109,12,10,2,100
297e6dadc7ad4180a6439b6950ec285f1174183e,3,176,20,156,0,0,0,3,43,110,2,3,1.57115664,3005,17,10,405,398,7,23952,23235,717,138,134,4,100
b376c9ab76191dcc9e18eb3d23ceaf2d9dc10738,0,0,0,0,0,0,0,0,0,0,0,0,0,0,10,0,0,0,0,0,0,0,0,0,0,100
2ad16d05577ccef77b509da75c77bf040ba9b234,25,2304,759,1545,11,0,11,3,34,76,3,12,3.3687014,4912,128,0,872,752,120,46094,37635,8459,315,258,57,100
71b889ad90a31ce992f587799f6f190a4a89bb3a,2,25,8,17,0,0,0,2,6,42,2,2,0.884963636,1030,11,5,111,110,1,8596,8508,88,36,36,0,100
02f46d227a69bc1a43cabb451f75c84b5562d0c0,2,6,4,2,0,0,0,2,7,44,2,2,0.970950594,1027,12,6,115,115,0,8288,8277,11,53,53,0,93.30357143
d3ff8d05197837972dbf612e5bf88b98f269b2c2,0,0,0,0,0,0,0,0,0,0,0,0,0,0,18,10,0,0,0,0,0,0,0,0,0,100
66eef78f2b3207c72cfb399918d0d09a9c3f72c8,26,403,248,155,1,0,1,3,38,220,3,11,3.539945245,7409,129,1,929,907,22,56071,55138,933,378,367,11,99.3204391
4796ec9b4d7a7004487408d3843792846587f629,0,0,0,0,0,0,0,0,0,0,0,0,0,0,130,2,0,0,0,0,0,0,0,0,0,100
60bb10037aa0f5fc197262316e7c5040987874c1,25,2939,0,2939,25,0,25,1,1,0,1,10,4.418359705,0,11,1,334,0,334,13995,0,13995,186,0,186,99.3204391
bf3eb482e55f8cf29f9b87a190ee585e3e5f7e2f,57,31383,12,31371,50,0,50,1,44,77,2,13,4.661348326,1885,13,2,6263,340,5923,196752,13214,183538,2575,100,2475,100
bd2c5514b79e599f1564f13e11845434abb8dab7,8,23,95,72,0,0,0,5,39,212,3,5,1.869363261,1551,74,0,202,209,7,10942,11347,405,54,56,2,100
890456b9c6312b3f7663b636b28e5d079e13c410,0,0,0,0,0,0,0,0,0,0,0,0,0,0,75,1,0,0,0,0,0,0,0,0,0,99.3204391
6cb65f9f3bb282c2c0086649fbc7fe168972bf75,0,0,0,0,0,0,0,0,0,0,0,0,0,0,19,0,0,0,0,0,0,0,0,0,0,100
78b61c9af900ee194ad733befd43e40602a5822f,3,903,785,118,0,0,0,6,26,92,1,3,0.970164072,1119,20,1,80,78,2,10720,10093,627,46,45,1,97.00050839
36ac1ec911aa7a0f05532c63210db8eed61d8ee2,0,0,0,0,0,0,0,0,0,0,0,0,0,0,0,0,0,0,0,0,0,0,0,0,0,90.46180406
365b2421fa75830a224e2abcca02e8e72672c535,0,0,0,0,0,0,0,0,0,0,0,0,0,0,0,0,0,0,0,0,0,0,0,0,0,99.92319508
1daf731af3af522b4a8b4c5a41f24b9b21a7e91e,0,0,0,0,0,0,0,0,0,0,0,0,0,0,0,0,0,0,0,0,0,0,0,0,0,100
ca09fe03d9d0a95694a3f67e1b34f6f95d0e49c2,0,0,0,0,0,0,0,0,0,0,0,0,0,0,0,0,0,0,0,0,0,0,0,0,0,100
1f8ba5f7b1b5d09be00014fd984fd921f15bc829,4,43,37,6,0,0,0,4,40,420,1,3,1.33359494,1308,1,1,194,195,1,10134,10166,32,67,67,0,100
56802bba0e420936a0c39467076b6e41f3139ed8,7,352,3,349,3,0,3,6,20,66,1,4,2.309456593,756,21,2,119,91,28,7495,5374,2121,49,37,12,100
382a93318fa78ceb0d43c0991af467710e8fe68b,4,237,8,229,1,0,1,1,41,32,2,3,0.718481316,1341,1,1,233,216,17,11805,10462,1343,49,44,5,100
86e18a10f3ddd29fde7f05afa9c0096775ec8240,1,1,1,0,0,0,0,6,17,5,1,1,0,238,2,2,1,1,0,2193,2193,0,1,1,0,100
78eceb8fbd7f7958bafdc4c4d00f814aea6c82fd,2,12,4,8,0,0,0,2,2,6,1,2,0.543564443,139,1,1,16,15,1,1213,1140,73,8,8,0,100
4ef1792c097dac4ddc08343e2ab0a9c3c810a8dc,1,3,4,1,0,0,0,7,27,40,1,1,0,632,3,3,23,23,0,5536,5534,2,16,16,0,100
c7c52424ffa3f065820d036ef5ddc92370eb3390,2,9,2,7,0,0,0,6,9,191,1,2,0.684038436,770,4,4,105,104,1,6292,6207,85,59,59,0,97.00499168
4d6f6387672f5ba6da3aa61cc7b0a71088b2b70b,2,3,3,0,0,0,0,4,18,22,1,2,0.918295834,541,5,5,38,38,0,4670,4670,0,30,30,0,99.27797834
f418035616c3afc659caf0cdd243527e30ef9095,3,111,638,527,0,0,0,2,25,167,1,2,0.413813588,1256,0,0,111,152,41,5349,7908,2559,27,25,2,100
5b6a7aeae1fcf031356e3b20f4273f3181741685,12,210,113,97,0,0,0,7,28,216,1,3,3.11832851,1729,6,4,137,121,16,15550,15180,370,91,78,13,100
c80ea5c404321884ed749a5c4a151264c8821116,4,121,17,104,0,0,0,7,30,135,3,3,1.709501366,2829,7,5,337,329,8,23948,23399,549,130,126,4,100
2f579e9e50a12f68ae32237661e5a1c1e2815a83,1,0,2,2,0,0,0,7,16,159,1,1,0,161,2,1,8,7,1,1042,995,47,3,3,0,100
08adb2cbc16b2e49721a0eed23bd687490eb2b8f,7,61,21,40,0,0,0,5,12,708,3,6,2.084276446,1199,0,0,148,143,5,8439,8138,301,69,65,4,100
adf02be4cc3ea8d77cdf2ffbcff8388674b25681,6,298,0,298,6,0,6,1,1,0,1,2,2.45056996,0,12,0,20,0,20,1096,0,1096,16,0,16,100
3f98471282f002f641b3e0854a83cecb1273bd2b,4,53,1,52,0,0,0,4,21,386,2,2,1.844723108,669,3,1,91,85,6,5597,5298,299,46,44,2,98.98004435
a4ca17d57605ba33af4ed541d5f4b1b5ec01bdbd,4,107,193,86,0,0,0,5,26,187,1,2,0.569528931,1352,1,1,138,137,1,8874,9477,603,51,49,2,100
1190a792bef043a7d94bbe0b5f873b6e7008761a,2,94,0,94,0,0,0,4,19,112,2,2,0.382380675,762,131,0,33,31,2,5902,5337,565,11,9,2,100
155d8d630b3e369b2563edd0ec0ffca7fce6cc45,1,50,0,50,1,0,1,1,1,0,1,1,0,0,13,1,3,0,3,184,0,184,3,0,3,99.73764757
149b4dc75c2cee9a7b842591a0ddea11493b6e34,2,82,332,250,0,0,0,5,13,374,1,2,0.044119283,624,2,2,28,34,6,2331,3765,1434,14,12,2,99.17498914
427705ff8a7acb3ccdfb195a3ff0a24d26135438,16,1347,1,1346,15,0,15,4,4,47,1,3,3.693616028,46,14,2,122,5,117,7296,210,7086,83,5,78,95.74303406
36274c25c14370917981a53f63d8348a0c4a8bc4,9,564,57,507,4,0,4,1,27,70,2,5,2.686413133,1091,132,1,193,148,45,9994,7968,2026,60,41,19,99.68531469
169d337f1ed5febb89be0263071265ae8eb68246,2,34,1,33,1,0,1,1,3,115,1,2,0.315997133,58,22,0,12,11,1,462,380,82,10,9,1,99.86077271
0693dfb21866bdf4cea6a58be00548d241d96445,27,873,116,757,6,0,6,1,35,158,4,10,3.955766305,4017,133,2,645,558,87,35137,31562,3575,268,214,54,99.1394148
36aae7ad78456a950a4ec65d00c958ec446d9708,8,317,52,265,1,0,1,1,42,85,3,7,2.268537982,2261,134,3,465,445,20,17936,16640,1296,140,123,17,99.93192648
603ca89985db8623ff899d0f685c2c14b860c99e,1,2,2,0,0,0,0,7,22,38,1,1,0,253,1,0,32,32,0,1998,1998,0,5,5,0,100
3893e22dd879542419fd9da81fe548361f0821db,15,1347,25,1322,8,0,8,1,13,196,6,10,3.210266577,1142,2,1,254,163,91,14264,7399,6865,118,63,55,91.9592299
5868e65e3b0f6d0ac24b9683fb4969415058194b,4,57,41,16,0,0,0,2,2,200,1,2,1.81769355,1121,3,2,100,99,1,8833,8772,61,59,59,0,99.57537155
124b6f5ca4b79765d25f3630af040b5ee58326a6,0,0,0,0,0,0,0,0,0,0,0,0,0,0,3,2,0,0,0,0,0,0,0,0,0,100
0f8e5e452572c4f6afbcd6a26733d2d682f178a9,2,39,13,26,0,0,0,7,45,222,1,2,0.930586129,2865,4,2,384,380,4,22461,22333,128,122,119,3,100
fb783e930f12f5d57cecfcfcfd2ca5eb33502605,7,40,19,21,0,0,0,5,23,115,3,6,2.188816374,1092,135,3,138,136,2,7852,7739,113,77,77,0,100
e52a24d313bcfc356732ce79f7768074efa690be,1,20,69,49,0,0,0,2,2,964,1,1,0,157,5,3,8,12,4,744,1299,555,3,4,1,99.52850407
65470412038ab4e5f01b6dcaa78eeda79b23fb74,3,232,6,226,1,0,1,2,3,10,1,2,1.004912952,384,136,4,74,52,22,4321,3236,1085,39,29,10,98.94133216
dd9edc666b9f013f3c98094d47b63bc0a896855e,1,3,2,1,0,0,0,4,9,18,1,1,0,862,4,0,72,72,0,7180,7162,18,28,28,0,100
feb8cbee60e2d8d36667737d527c602de3e15d13,3,33,12,21,0,0,0,4,10,105,2,3,1.456564762,1323,14,0,142,143,1,10418,10314,104,55,55,0,100
90ea9aca11cc36de90c081d70588b43386b3148a,2,6,2,4,0,0,0,1,5,36,1,2,0.811278124,84,23,1,16,15,1,565,527,38,13,13,0,100
925afae8964ebae76f61eba73d955bf0a7a787c2,1,1,1,0,0,0,0,7,21,43,1,1,0,364,5,1,57,57,0,2421,2421,0,18,18,0,100
f5a99962ab8fb8a333d270f4b5059b2c791293b1,1,6,2,4,0,0,0,9,46,41,1,1,0,1574,8,0,312,311,1,11273,11246,27,82,82,0,100
49cf58b334a87082791bd70c6732d3dd0129e724,3,55,16,39,0,0,0,3,14,180,2,2,1.322761237,898,137,0,104,101,3,7324,7061,263,54,53,1,100
fd221580ad11998266f3e2436f7ccfd68317cbfb,1,0,1,1,0,0,0,3,6,298,1,1,0,280,138,1,58,58,0,2191,2204,13,15,15,0,100
4ade98ac6dd41f14b238c96f46c979dd31a1afe7,1,4,0,4,0,0,0,4,6,288,1,1,0,72,6,1,4,4,0,568,559,9,3,3,0,100
f1f7812ff73b05799e058891d826c6502c28e8a5,0,0,0,0,0,0,0,0,0,0,0,0,0,0,7,2,0,0,0,0,0,0,0,0,0,100
da98b3db06c8aca1df318d842acd8edfb14ec153,9,484,0,484,9,0,9,1,1,0,1,2,3.065121911,0,4,0,38,0,38,1775,0,1775,30,0,30,98.63013699
51f9d262f8c03d24b7b3cb3df47bcc15e20fb45a,3,149,0,149,2,0,2,1,2,136,1,2,1.209878691,174,139,2,35,25,10,1825,1270,555,17,11,6,99.67622572
a9a6c6f4a1d88a8aca5a541218deff2ce47fcd5f,17,588,251,337,5,0,5,6,36,67,3,9,2.995204073,2440,140,3,418,386,32,19946,18578,1368,143,133,10,98.15232087
80dc59287b0394efc727643e8d2e3d275977e6e1,4,425,10,415,1,0,1,4,11,196,2,4,0.381138779,1325,141,4,148,135,13,11418,10863,555,71,58,13,99.69122188
0ca68838338ff1418495a442249323c7da0ccbba,2,41,2,39,0,0,0,5,43,122,2,2,0.782444129,1058,142,3,174,171,3,7380,7185,195,40,38,2,100
b4e607a58c252b4a2b6c3f499654a29fcf5165d1,0,0,0,0,0,0,0,0,0,0,0,0,0,0,143,4,0,0,0,0,0,0,0,0,0,100
0d3a8f60716a42b48c7e6f5f9f8cce38520d9e1c,0,0,0,0,0,0,0,0,0,0,0,0,0,0,144,5,0,0,0,0,0,0,0,0,0,100
8cc22bee519cc24d56c4a06d5519616f11ece5c0,2,67,7,60,0,0,0,3,3,224,1,2,0.84185219,844,5,1,76,74,2,7487,7155,332,31,30,1,100
58adbe44e9e69a049e450f1bc5342135c8f92b3a,6,124,97,27,0,0,0,2,10,484,1,2,2.506935807,881,6,0,80,74,6,6055,5881,174,35,33,2,100
8e16e87ce019f719df0be830c8ccec4069a52ba5,15,1390,0,1390,15,0,15,1,1,0,1,2,3.690450556,0,6,1,146,0,146,7992,0,7992,80,0,80,88.94009217
fd31d2cd4b7d0d63dc6f8a61d2cf6b3cf4d4d72e,5,489,56,433,2,0,2,1,9,30,1,3,1.642497909,355,145,0,82,51,31,5074,2509,2565,32,19,13,99.75996159
24487610038e4be8eec0f320a0e20d2b79a2b035,3,255,161,94,2,0,2,1,13,150,1,2,1.348019624,496,7,1,32,28,4,4128,3871,257,15,11,4,99.76110846
7ae7fc375e3458e77f55e5e4feff45ef1f9a18e0,12,590,14,576,8,0,8,8,24,72,1,3,3.150543446,562,8,0,100,61,39,6321,4180,2141,44,26,18,96.92519504
a3adbb39151aa67ed0117897242743ecc6a97cf3,2,40,1,39,0,0,0,3,15,106,2,2,0.534943699,755,146,1,88,85,3,6099,5880,219,38,37,1,100
850bdb22262f79fb58cb559bce3073f5ddb3229a,4,62,11,51,0,0,0,3,13,398,2,3,1.730656683,540,15,0,70,64,6,4185,3904,281,36,32,4,100
9195cb9f512579bfd56a6894319ce739332b4cff,1,1,1,0,0,0,0,4,7,423,1,1,0,91,147,2,17,17,0,574,574,0,7,7,0,100
16ef2c3bd502ccdcf63b8bb1090c213c21f75e03,1,7,7,0,0,0,0,3,5,483,1,1,0,176,148,3,31,30,1,1317,1320,3,15,14,1,100
0b8d822ba3b88998aca0046780fe4f28bbcba48a,3,65,2,63,1,0,1,1,21,264,2,3,0.882607845,311,149,4,36,33,3,2139,1917,222,19,16,3,97.57260511
06ba44c7ac84d7b0d58d8315f45bf268f260c673,1,1,2,1,0,0,0,7,22,20,1,1,0,206,8,0,27,27,0,1208,1210,2,11,11,0,100
6498ce90dd1140b67064c244b27005d0df819355,0,0,0,0,0,0,0,0,0,0,0,0,0,0,9,0,0,0,0,0,0,0,0,0,0,100
357d83fbc619ba14bb63a6dce0200c5560e18376,16,1395,0,1395,13,0,13,2,3,47,2,9,3.324160806,769,7,0,289,128,161,13596,6411,7185,133,45,88,87.80396558
a48cc8c43ee813c73c2aa8d9f603e96350c641e5,1,0,17,17,0,0,0,11,44,121,1,1,0,672,10,1,142,147,5,4877,4990,113,25,27,2,100
14e6bdaba7b1bf2cd1c342f908c00c005e14521f,1,4,0,4,0,0,0,4,4,63,1,1,0,42,8,1,4,3,1,194,173,21,3,2,1,100
024faee9165efd20d63d630f2d455001bca50fd8,1,1,0,1,0,0,0,11,45,25,1,1,0,657,76,0,143,142,1,4880,4877,3,25,25,0,100
9dba28bd693627c07523d9c29d3145fae2dd9de9,1,15,1,14,0,0,0,4,5,19,1,1,0,45,77,1,7,4,3,268,194,74,3,3,0,100
0416dc016b9f594f89cf3cfbe9702592c21bf6da,2,14,0,14,0,0,0,3,31,340,1,1,0.749595257,783,78,2,107,106,1,6166,6109,57,59,58,1,100
67b2146e3b3914a44f45dd92092f835ba99362fd,23,144,139,5,0,0,0,6,14,664,3,12,3.936894014,2974,9,0,453,444,9,20865,21262,397,192,197,5,96.10655738
4d0e2e7c347f5e247b553aff3ddec8524ba221f1,2,8,3,5,0,0,0,1,2,64,1,2,0.684038436,481,9,0,75,75,0,3734,3708,26,36,36,0,100
42dfe9c8e3422a68bea6b49c40be8f349760c6ec,2,44,38,6,0,0,0,1,2,904,1,2,0.887172303,144,79,1,32,31,1,1013,949,64,15,13,2,100
6baaa612917bfab0ff883ff8e2c5d59cf7292367,0,0,0,0,0,0,0,0,0,0,0,0,0,0,80,2,0,0,0,0,0,0,0,0,0,100
ee9039389939be0bb16ad1c2850739f03b5b7e03,0,0,0,0,0,0,0,0,0,0,0,0,0,0,81,3,0,0,0,0,0,0,0,0,0,100
198bef5dd6061260c7c2f34fea27e434be4985ec,2,24,17,7,0,0,0,4,12,384,2,2,0.978869851,1044,150,0,114,117,3,8442,8402,40,54,54,0,100
4e03bdb24145eb56378c29aa6db23d7ac1d25d62,0,0,0,0,0,0,0,0,0,0,0,0,0,0,82,2,0,0,0,0,0,0,0,0,0,100
c56f1d26042defa06286910952a3c9c87e0dd124,0,0,0,0,0,0,0,0,0,0,0,0,0,0,11,0,0,0,0,0,0,0,0,0,0,100
9943a33f71f1257f95bb4ee956f94e2d3c85cb84,4,41,7,34,0,0,0,8,25,323,1,3,1.612547487,693,83,1,84,82,2,5349,5164,185,47,46,1,100
1556781c49361b821b8db55b28d9e5de5394565e,8,74,45,29,0,0,0,8,20,357,2,4,2.197372439,958,12,1,103,102,1,7730,7537,193,59,60,1,99.79064899
17fcc4d46e5a1eafd4c9780723aeecf84c0215dc,0,0,0,0,0,0,0,0,0,0,0,0,0,0,13,2,0,0,0,0,0,0,0,0,0,100
ce60020b9b8ebdc933c6158502e39651703ec888,0,0,0,0,0,0,0,0,0,0,0,0,0,0,84,1,0,0,0,0,0,0,0,0,0,100
c8d5fcef924bb04ba2029d7c03482aa60de20da0,1,3,1,2,0,0,0,2,2,1445,1,1,0,10,85,2,2,1,1,70,67,3,2,1,1,100
987618115b39d33937a44c0bdcdde3ff0c6be2f3,12,2293,0,2293,12,0,12,1,1,0,1,1,3.465181495,0,10,0,153,0,153,14296,0,14296,67,0,67,98.89617109
499074e3891da4324102568e8a4f3ae0bc003965,1,70,84,14,0,0,0,5,13,80,1,1,0,879,86,3,72,72,0,7162,7308,146,27,28,1,100
8bd827b28b8a6df69f2d075ffbc10b305fc98380,1,27,11,16,0,0,0,5,14,2,1,1,0,861,87,4,73,72,1,7254,7162,92,27,27,0,98.78472222
c9276faef6803b88f8df6a67c62398fe5e2b912d,0,0,0,0,0,0,0,0,0,0,0,0,0,0,88,4,0,0,0,0,0,0,0,0,0,100
fe8e7d99ba5da781048304df859a70e1162e8859,2,3,10,7,0,0,0,2,22,395,2,2,0.779349837,575,89,5,99,100,1,3674,3725,51,40,40,0,100
9dff149d657632a533f939f8c2541c9f190439f2,3,10,5,5,0,0,0,7,23,247,2,2,1.5058231,449,90,6,72,72,0,3078,3034,44,27,28,1,100
77ac9953a49d58467e4b88cb45c87940bee88ee5,1,20,5,15,0,0,0,2,2,21,1,1,0,178,24,0,17,14,3,1600,1538,62,4,3,1,100
7c2da749d3de908f77178a2ea2f409f45f640169,2,17,17,0,0,0,0,2,2,642,1,2,0.989992792,285,1,0,70,66,4,1598,1592,6,12,12,0,100
7eb7c7dabd5ec6034d30872f001752cc64e643b4,14,63,10,53,0,0,0,2,47,455,2,13,2.641703509,6243,91,6,801,798,3,48112,47705,407,289,288,1,99.71711457
f5445bbc602ede901ed4cc707e2ce11ee8961a31,14,403,63,340,2,0,2,2,3,461,1,7,2.77323902,1087,2,1,211,182,29,7623,6091,1532,92,77,15,98.90988372
412eea346dea9c65866fc4cbf0a88df21250a598,1,5,6,1,0,0,0,4,7,334,1,1,0,233,10,0,34,34,0,1500,1511,11,15,15,0,100
58a8358ca626877a2f7bd24d07274ee5eeaa0a1a,1,29,0,29,0,0,0,5,15,332,1,1,0,411,92,7,28,27,1,2534,2390,144,14,13,1,100
0dc5aa49fa769aebe64e18ce5cef7fbabb3fe7a4,17,141,37,104,1,0,1,3,37,560,1,6,2.932664904,8544,93,8,2259,2238,21,62882,62126,756,693,687,6,99.81350242
806953c3d4a9ccfe985cdf90b5e868787f66ac5f,9,517,168,349,3,0,3,2,4,453,3,8,2.507967363,919,11,1,121,108,13,9547,7266,2281,58,59,1,97.31873112
09d1a927939b5d69539726d81001507ee6d4f701,1,9,0,9,0,0,0,8,29,8,1,1,0,460,25,1,77,76,1,3589,3508,81,18,18,0,100
b7469a12cc1748904d55e423201db7dc9b7b5f8b,1,3,0,3,0,0,0,4,11,1007,1,1,0,183,26,2,6,6,0,1271,1246,25,6,6,0,100
18ba71baf63e1a1a1a3650ac539061800626630e,0,0,0,0,0,0,0,0,0,0,0,0,0,0,11,0,0,0,0,0,0,0,0,0,0,100
100e2397e5e30d8291a6c79329ff8778f8ddf21e,2,0,146,146,0,0,0,2,2,760,1,2,0.82715952,105,94,6,0,15,15,0,632,632,0,5,5,99.80820867
a5b37c7e122d0126a4d2a4f57ecf0359feadf0d5,4,153,11,142,0,0,0,5,16,245,3,4,0.880749224,2139,95,7,279,273,6,17350,16543,807,136,133,3,100
4da9dc22efc312719397a67448d78fee88f05a13,13,26,26,0,0,0,0,2,6,1053,1,1,3.700439718,7625,96,8,2068,2068,0,54815,54815,0,687,687,0,100
4a5c9c2c9052e6e87ccab39c9f9a73468407b188,0,0,0,0,0,0,0,0,0,0,0,0,0,0,14,0,0,0,0,0,0,0,0,0,0,100
6c3184acc1666f3ebcd6e9c73e9bef816121e032,0,0,0,0,0,0,0,0,0,0,0,0,0,0,12,2,0,0,0,0,0,0,0,0,0,100
92cde111f232a98bbce4b320100d408668cc444c,21,7256,410,6846,13,0,13,1,48,101,3,11,3.733154231,12384,13,3,3911,2823,1088,133101,91068,42033,1807,1339,468,96.5735568
4622aa4bd946a9cfcc9fe21740c00c87d0fca9b4,1,27,1,26,0,0,0,3,3,236,1,1,0,486,15,1,78,75,3,4333,4108,225,33,32,1,100
789af33b110919fd393fecb4e5821000cb3c805e,2,58,12,46,0,0,0,2,4,32,1,2,0.553507265,304,3,2,77,70,7,1981,1604,377,14,12,2,100
4440314741edd9b80032777ee3d10679b7ce2ec0,1,1,1,0,0,0,0,5,17,29,1,1,0,971,97,6,77,77,0,8042,8036,6,30,30,0,100
7613ede9c6b940fe132e6cc7657bac9b0cf236b2,2,32,8,24,0,0,0,5,20,612,2,2,0.286396957,1067,27,2,30,30,0,7829,7692,137,28,28,0,100
1e26d56ef36af04dc1b58d549dea95141be243a2,4,95,15,80,0,0,0,7,33,265,3,3,0.85039215,2992,28,3,357,352,5,25162,24648,514,135,135,0,100
19bbaacd1de4d3e7e23083a85ac8466f3e26fab9,7,458,147,311,1,0,1,5,30,398,1,3,1.396620922,2876,29,4,276,245,31,24753,22936,1817,110,102,8,99.92779783
6adcf783cb578ef54193d1dee0290a9126e68952,9,242,136,106,0,0,0,5,31,578,1,2,2.434943197,1782,30,3,151,145,6,13573,13370,203,61,59,2,100
30c2eaf5c6d6fecf87ba52a78395d8031a745f63,2,46,1,45,0,0,0,5,18,244,2,2,0.784992089,1045,98,1,95,92,3,8743,8532,211,43,42,1,100
7dd02191cb7254f1165081da43ea9be45d14c5a0,0,0,0,0,0,0,0,0,0,0,0,0,0,0,99,2,0,0,0,0,0,0,0,0,0,100
1712142b3fd22e623b667e500851d9c872dda4d0,0,0,0,0,0,0,0,0,0,0,0,0,0,0,16,1,0,0,0,0,0,0,0,0,0,100
35c62ffc6614ad97ecc537bd48da0cbf123269cc,14,206,449,243,0,0,0,3,14,348,4,8,3.16076455,1770,14,1,170,203,33,12249,13356,1107,87,108,21,99.27219796
2265ab80917a66b19c10a036185aa45aff0be9fa,0,0,0,0,0,0,0,0,0,0,0,0,0,0,12,0,0,0,0,0,0,0,0,0,0,100
a9c8d904d795826d43000f81523fe1966aa775b6,3,116,19,97,0,0,0,3,23,458,1,2,1.508329295,2106,100,3,157,150,7,16926,16312,614,52,51,1,100
5303089212752a410696cd3b5ad7b930f5a975ae,2,18,51,33,0,0,0,8,32,6,1,2,0.666578358,2069,101,4,186,188,2,17137,17302,165,56,57,1,100
e11062d3fc9f2cce0d706f575f98b1c5e3a17f9b,27,365,395,30,0,0,0,3,33,423,1,3,3.691230851,6738,102,4,523,521,2,48335,48625,290,225,219,6,100
fd293e117a31f7d1d1b6994b6a3a026e5d2abfe4,9,608,389,219,2,0,2,4,15,108,3,7,1.338756921,1874,17,1,236,234,2,15561,15002,559,109,107,2,99.59692195
d8063f5efe7e3209f112c5cbbfc4be21efb38ecf,1,1,1,0,0,0,0,7,24,71,1,1,0,208,31,1,27,27,0,1215,1215,0,11,11,0,100
0a93259cb738a0b256100e769c3f0426dac2b623,1,4,1,3,0,0,0,7,30,62,1,1,0,653,15,0,135,134,1,5217,5195,22,35,35,0,100
e90a1b663897cc445faecb8a53e179923c7f7cf1,6,301,4,297,1,0,1,3,46,217,3,5,1.789322419,1564,13,0,257,231,26,13475,11699,1776,66,56,10,99.92690058
b99fa755918cb8655569c000a72de945ada6507c,1,7,2,5,0,0,0,13,47,7,1,1,0,713,16,1,152,152,0,5367,5345,22,26,26,0,100
d4e6bbf7e8e355cc05777033f9318673022b53fc,1,22,4,18,0,0,0,8,17,623,1,1,0,171,17,2,10,8,2,1162,1042,120,3,3,0,100
f0714a244a9bd054997c539a3ff76b04c490ca29,0,0,0,0,0,0,0,0,0,0,0,0,0,0,18,1,0,0,0,0,0,0,0,0,0,100
3d53d254ac1c569e339515db4e8a04491bc27309,3,38,0,38,0,0,0,8,34,275,1,2,1.063393046,1496,19,1,144,142,2,12572,12333,239,81,79,2,100
9129d6ff3c788e17a1f89d649b41bcf5170534b3,1,1,1,0,0,0,0,7,25,54,1,1,0,208,32,0,27,27,0,1215,1215,0,11,11,0,100
6203a7a6554d49c2ae476d191a30633657d41887,2,73,16,57,0,0,0,5,19,507,2,2,0.155103272,1026,33,1,84,79,5,8742,8411,331,33,31,2,100
c9e47c8cadce0cc6300a46d02fe2224eec6cc882,4,118,9,109,0,0,0,5,48,57,2,4,1.615657252,1577,103,0,192,186,6,12805,12137,668,49,48,1,100
9ab8daaa7ea584e6616e5b8b88da92a55a056b98,1,1,1,0,0,0,0,5,20,5,1,1,0,1044,34,2,84,84,0,8565,8558,7,33,33,0,100
5f19d33e22a868be5bc54f898437da3b03f77207,4,52,18,34,0,0,0,5,21,267,2,2,1.806637909,1769,104,1,192,188,4,13909,13639,270,79,79,0,100
dd074b9fa1fc173733913ccb955c78927657595c,1,3,1,2,0,0,0,3,7,131,1,1,0,78,105,2,16,16,0,522,516,6,12,12,0,100
3c3fc5a7617d1bf331889b8707ed4741fc5279ad,4,75,95,20,0,0,0,3,11,424,3,4,1.305444839,1105,106,3,164,170,6,7912,7997,85,94,96,2,100
cedfc573c16d025cb928ac327003fb09d2a781e2,1,2,1,1,0,0,0,2,3,734,1,1,0,55,20,0,8,8,0,441,428,13,3,3,0,100
66b7096cb14a6f52d16ea3e6efef1f1af65e35b2,17,1355,306,1049,5,0,5,3,39,345,1,7,3.586747084,2464,18,0,429,339,90,26717,19099,7618,187,143,44,96.68064291
00f74f32a816082e07eb6c5984c63e97640310ae,1,18,20,2,0,0,0,5,7,608,1,1,0,74,19,1,3,4,1,581,568,13,3,3,0,100
b20f200c5c095001049a8a235f75aa555d4d0099,2,48,5,43,0,0,0,2,3,295,1,2,0.73676801,308,107,0,31,29,2,2836,2558,278,14,13,1,100
557c81834e3909f9b0d7325751b21e38129961df,9,223,63,160,1,0,1,2,15,488,4,8,2.778669543,2172,108,1,260,235,25,17607,17031,576,104,98,6,99.83260797
7fe082a65c56a8d87ecc223998977e5004947eeb,1,6,3,3,0,0,0,2,2,465,1,1,0,85,21,0,13,12,1,528,515,13,5,5,0,100
6c7c5f6d15ac4601cb07a0ca441c0bc4acd9e11e,9,218,29,189,1,0,1,1,28,409,2,6,2.064158026,2017,109,2,277,270,7,16249,15271,978,120,116,4,99.39393939
0263cd4a53638974110053804340704431354e33,1,1,1,0,0,0,0,8,29,0,1,1,0,168,22,1,0,0,0,1304,1304,0,0,0,0,100
fd8413952bfb0746c2a66e4f098b13fdfa094b6a,1,45,4,41,0,0,0,8,34,198,1,1,0,528,110,2,93,87,6,4191,4013,178,23,21,2,100
11f25c12f806f171ddea141a5d33022774bfc8c6,1,314,0,314,1,0,1,1,1,0,1,1,0,0,111,3,22,0,22,1553,0,1553,10,0,10,99.93229519
8695570e4ec0de1f53c56f602d3db7fb77785410,1,12,11,1,0,0,0,6,14,204,1,1,0,307,23,2,20,20,0,2416,2416,0,14,14,0,100
b5bbcf94e37f22616e1e8966dd4be87468e3ca46,1,12,11,1,0,0,0,5,9,207,1,1,0,210,24,3,15,15,0,1378,1363,15,5,5,0,100
695d60d075c4c735a555f350f2d953761c219cdf,1,3,0,3,0,0,0,3,4,290,1,1,0,262,25,4,17,17,0,2057,2028,29,4,4,0,100
4a4bfecfe77aca0c8152ad3357d92d19812fae0c,1,7,0,7,0,0,0,8,25,222,1,1,0,1519,26,5,100,100,0,13218,13169,49,36,36,0,100
52ec19483edf8ce8b5b7468edda77455cff833f4,10,166,123,43,0,0,0,6,18,295,1,2,1.914095192,3479,27,5,172,172,0,25268,24732,536,113,113,0,100
9615cc58b680e1153bd475e8549438d460c90f05,3,31,38,7,0,0,0,4,7,643,1,2,1.027413423,523,112,3,72,75,3,4074,4020,54,39,39,0,100
a1feebe2e3a99fb679f6d1972b24acbbd17221ce,0,0,0,0,0,0,0,0,0,0,0,0,0,0,113,4,0,0,0,0,0,0,0,0,0,100
cccebe099e2a7b54734aef4fc91cd212edde6a4d,2,30,13,17,0,0,0,9,30,75,1,2,0.583019417,251,20,0,14,13,1,1901,1775,126,8,8,0,100
2bd258105eb5395a83b14b6830f975342b8c1333,6,177,3,174,1,0,1,2,11,465,2,2,1.958964616,891,35,0,139,134,5,7429,6564,865,53,50,3,99.56021651
0b5ff1054333deafec55e85da58489a8b8ddaefa,1,3,3,0,0,0,0,2,2,277,1,1,0,102,114,4,19,19,0,613,613,0,6,6,0,100
3d6d69e09435ccef39e5868318cff08aa3bf22a7,1,317,0,317,1,0,1,1,1,0,1,1,0,0,115,5,23,0,23,1546,0,1546,14,0,14,99.8648192
f0aebaa949287b830f612972f6a5901cc15194f4,0,0,0,0,0,0,0,0,0,0,0,0,0,0,28,4,0,0,0,0,0,0,0,0,0,100
17a4c97f760fe3795a17505409b6cec67767d0a0,2,92,6,86,0,0,0,4,8,28,1,2,0.992476004,460,116,4,71,60,11,4352,3705,647,30,30,0,100
d3793ed21dc660f7d7070de0261925b8dd5ad05b,1,101,44,57,0,0,0,1,2,9,1,1,0,227,117,5,34,23,11,1732,1546,186,19,14,5,100
25d0fefb4161ce886459d816caff576415fc2a3f,2,40,3,37,0,0,0,8,49,328,1,2,0.640944185,3181,29,1,447,445,2,24788,24508,280,141,140,1,100
774afb70f8c0bd0842331048d7de0fd053ed6c79,1,1,1,0,0,0,0,3,4,144,1,1,0,145,30,2,27,27,0,953,953,0,19,19,0,100
f0b9367519f6db39ed6dcb3165b8c7fa01501422,1,1,1,0,0,0,0,3,5,0,1,1,0,145,31,3,27,27,0,953,953,0,19,19,0,100
e6e7d7311174c83c02b5074a0d959b3326f8223c,1,21,1,20,0,0,0,5,7,1284,1,1,0,80,36,1,16,14,2,748,658,90,3,3,0,100
439d5f29a51021f6b02af04b2539908133f3f92c,2,45,3,42,0,0,0,8,50,18,1,2,0.599314237,3209,32,4,449,447,2,25091,24788,303,142,141,1,100
a83c094f2025928cd59cfc53a3b11a3123606154,1,3,1,2,0,0,0,2,2,402,1,1,0,146,37,1,9,9,0,1499,1482,17,6,6,0,100
0b18f454d3fdca7176a66152a78cbcae17c0164f,4,29,28,1,0,0,0,7,49,702,2,4,0.639055278,1256,118,0,220,220,0,8996,9008,12,46,46,0,100
b2d71a8c5716f37eb26510d97f654c31d1c4bf53,7,164,15,149,1,0,1,3,50,731,3,5,2.248604437,1369,38,2,264,251,13,10750,10042,708,78,68,10,99.69656102
5e58f3fe6aab426e58085bb93fcf6efc9380bd5f,23,3303,9,3294,16,0,16,2,16,213,2,9,3.596309959,1674,33,1,749,319,430,29751,11932,17819,287,148,139,97.49348958
80b543fcaa5a74bc8aa8317ba09b68bc8a2407ba,0,0,0,0,0,0,0,0,0,0,0,0,0,0,34,2,0,0,0,0,0,0,0,0,0,100
d2913b8d55607ece2076a29ac93b30627a31916f,1,2,2,0,0,0,0,4,5,296,1,1,0,185,35,3,17,17,0,1501,1490,11,10,10,0,100
6052eb2d8b33bed1cb302fd09f360fc3ef13797f,1,6,10,4,0,0,0,2,3,131,1,1,0,88,36,4,11,13,2,497,528,31,5,5,0,100
d2a512ea30db126e5fb8bc72dc65e309b88d08b3,0,0,0,0,0,0,0,0,0,0,0,0,0,0,16,0,0,0,0,0,0,0,0,0,0,100
c2747d9e82d03724100f01d0f24b316de400f3fe,2,39,30,9,0,0,0,3,9,23,2,2,0.632920898,356,39,2,61,61,0,3038,2828,210,18,18,0,100
0c6062b412f164453b99291824481a32b3dbb959,1,9,1,8,0,0,0,8,24,35,1,1,0,252,40,2,33,32,1,2035,1985,50,5,5,0,100
0e2e678e6941edb5c5b05696f1ce537a9a53d548,1,1,9,8,0,0,0,8,25,10,1,1,0,257,41,2,32,33,1,1985,2035,50,5,5,0,100
7d6390e2cb833b4d3496971ee879cf008aae3fd1,1,9,1,8,0,0,0,8,26,0,1,1,0,252,42,3,33,32,1,2035,1985,50,5,5,0,100
422a175517ad3cce3acd0213d10f9eddb24e8eff,1,2,2,0,0,0,0,4,6,261,1,1,0,345,37,0,23,23,0,2275,2267,8,8,8,0,100
8a7b62194c5e858b4615100a3fcfcc9fbb3eba5e,0,0,0,0,0,0,0,0,0,0,0,0,0,0,43,4,0,0,0,0,0,0,0,0,0,100
8624435bc7a968b74a568b7fe5b2e77744863dfe,0,0,0,0,0,0,0,0,0,0,0,0,0,0,44,5,0,0,0,0,0,0,0,0,0,100
9fe720232120b27ada196a7693e57c2127db80ee,3,115,18,97,0,0,0,3,7,180,1,3,0.376840251,395,45,6,38,31,7,3613,3251,362,18,14,4,100
4b33ad92988a8bc0e0bc6d03962dbc7cda58827e,22,1104,878,226,0,0,0,5,22,902,2,6,3.845719229,10253,119,0,2201,2227,26,80677,79371,1306,955,943,12,98.80336352
06688cee637a86c99c6bf9c8ec22534e1d628b80,3,104,83,21,0,0,0,3,9,85,1,2,0.523385394,649,120,1,111,114,3,4233,4247,14,56,51,5,100
f1a2efac1d26d126e5cf0e395ef2c2b2d1751add,2,26,2,24,0,0,0,6,18,376,2,2,0.591672779,975,46,6,62,60,2,6594,6437,157,36,35,1,100
aca4d0e9ca2c5956a8f59ee3885f92a63af2f65e,11,8,6,2,0,0,0,1,5,349,1,4,2.896291529,903,17,0,162,213,51,5104,6979,1875,57,65,8,99.46843854
a661c182879dcabdb05366d1125c1d5c7fa56a5c,0,0,0,0,0,0,0,0,0,0,0,0,0,0,38,0,0,0,0,0,0,0,0,0,0,100
0adfc7384f531f93ff0a5d2a0b1470876fc10855,14,1489,6,1483,13,0,13,9,22,35,1,4,2.981930594,303,21,0,181,43,138,10565,2198,8367,57,21,36,99.01218308
3ee3e9320457a2df7cdd807183fb2700617de23c,1,5,0,5,0,0,0,3,5,59,1,1,0,53,47,0,14,12,2,394,369,25,10,9,1,100
67031139f0db369ed4969a23e97308c941a8c953,2,136,27,109,0,0,0,7,51,180,2,2,0.422598839,1181,48,1,193,184,9,8950,8412,538,44,41,3,100
5a827f6db54b1c0d3e310e98c1a35298c23ec114,2,429,1,428,1,0,1,9,35,126,1,2,0.721928095,555,0,0,142,93,49,6708,4191,2517,42,23,19,99.93476843
95b1e40e7062343f05e131afaea0a97bbf71ba4f,131,640,762,122,0,0,0,3,52,707,6,54,6.034261625,21532,49,1,3717,3721,4,153286,155618,2332,1420,1423,3,99.90218455
cb92ceb3bb45b100538642038567640797553a3d,1,1,1,0,0,0,0,13,53,0,1,1,0,747,50,2,156,156,0,5702,5698,4,26,26,0,100
1b6fe629c9049b2246adf4913dd448afa4abf398,2,42,2,40,1,0,1,1,6,0,1,2,0.439496987,162,51,3,43,42,1,1184,1092,92,27,26,1,99.93485342
2ae1befdad80a5d23f4efe25d29555d767c592d8,2,299,17,282,0,0,0,5,23,53,2,2,0.835406525,1480,52,4,165,146,19,13415,12061,1354,55,51,4,100
0ce626c1139e52a6e9db1edabb5ec68b43999fb9,1,18,16,2,0,0,0,6,11,848,1,1,0,202,121,0,19,19,0,1332,1357,25,11,12,1,100
ef9b73884896fe63ec8182cc0f7fa428389cf43d,1,62,25,37,0,0,0,9,26,264,1,1,0,1526,1,1,104,100,4,13513,13218,295,37,36,1,100
0f0fd359b17f3460c5254fbd617c5f417a2f2d6b,1,5,2,3,0,0,0,14,54,13,1,1,0,747,2,2,156,156,0,5731,5702,29,26,26,0,100
8529f8e121144d715986a485abb204aa036caa19,14,1097,53,1044,12,0,12,1,6,39,1,5,3.093211296,540,18,0,136,50,86,9697,4704,4993,50,17,33,98.74031008
d96f95160fd3dfa30c27b82d09fb5cc2c348b483,2,92,9,83,0,0,0,5,24,73,2,2,0.774020413,1434,53,4,126,120,6,12119,11626,493,54,52,2,100
20f3960cead3cf5c357596cc7d11e29e55254837,36,118,121,3,0,0,0,4,52,401,4,24,4.909130505,7255,22,0,1214,1205,9,54670,54963,293,403,408,5,95.13729977
a01a7501114ca0934255a0fb5e2635214f8ce887,2,14,4,10,0,0,0,1,4,15,1,2,0.764204507,449,19,1,74,73,1,3404,3345,59,25,25,0,100
6ed0a17012fb1ff352fdbbd395cddd9018e26573,1,9,2,7,0,0,0,14,55,13,1,1,0,750,54,5,157,156,1,5763,5731,32,26,26,0,100
39d07318d75511144498fdf585707806b0034211,1,3,1,2,0,0,0,3,6,35,1,1,0,269,122,1,36,35,1,1706,1698,8,16,16,0,100
a442fa679e4070dd01aef8fead08571f5482f7fc,2,66,8,58,0,0,0,2,2,52,1,2,1,768,20,2,71,61,10,6691,6411,280,26,24,2,100
597a3cdd319be84f2417c96d24db01553f264551,3,18,3,15,0,0,0,1,3,7,1,2,1.246705213,514,21,3,77,75,2,4158,4057,101,22,22,0,100
7f123002cdd031fe8a821eb869fc83152539b6c5,1,8,13,5,0,0,0,1,2,206,1,1,0,472,39,0,98,98,0,3394,3408,14,22,22,0,100
cda611aee5f93862e1e3db3f27aa6e37672d1d91,1,25,28,3,0,0,0,1,2,206,1,1,0,150,40,1,27,28,1,1049,1087,38,20,21,1,100
488f8806180c22d4a3cfd7be926e147f16e7bc58,1,13,17,4,0,0,0,2,4,2,1,1,0,97,22,4,17,19,2,789,790,1,4,4,0,100
25f88cb88329823b1474ab4189e477b26537a74a,8,233,116,117,2,0,2,2,4,15,1,6,2.050551942,1105,23,5,118,118,0,9600,8932,668,43,37,6,97.90647091
fba126789702ced8944b2ebe68a53972e0c7d8fb,2,21,10,11,0,0,0,2,5,50,1,2,0.999249248,123,24,6,34,31,3,1080,992,88,6,6,0,100
cd4e14225104f0be3b1325ed4d10db734de1def6,1,45,31,14,0,0,0,9,37,34,1,1,0,618,3,0,105,99,6,4721,4672,49,26,25,1,100
f49fb8d5303b1adc6cd21fec84acb6a3261c299e,9,767,0,767,8,0,8,2,3,91,2,7,2.906541739,21,4,1,71,0,71,4757,32,4725,40,0,40,98.52982754
89828a244ff62afb099f84291f8f78ef9a805dbb,9,0,767,767,0,0,0,2,4,0,2,7,2.906541739,668,5,2,0,71,71,32,4757,4725,0,40,40,98.52982754
8a669304b43d294dcc575d8de4e67c9365c443c0,0,0,0,0,0,0,0,0,0,0,0,0,0,0,123,1,0,0,0,0,0,0,0,0,0,100
5c2597de003310ea69f159acfba2bb75476492f4,12,3412,32,3380,3,0,3,2,53,308,1,6,2.570852298,11392,124,2,3133,2444,689,105926,85395,20531,1421,1168,253,99.16450591
5659d39d6c832da1e8261710798832601348d4b1,1,1,1,0,0,0,0,3,4,416,1,1,0,56,6,3,8,8,0,439,441,2,3,3,0,100
1665b93d04be174bf43ad5367fa7b686b2413b70,21,115,88,27,0,0,0,5,56,178,4,15,3.805374286,7785,125,3,1508,1502,6,56446,56186,260,505,505,0,100
65eda014575f1836da7b7beb1f8b9935adb992c3,1,3,2,1,0,0,0,6,19,168,1,1,0,860,126,4,32,32,0,5731,5718,13,28,28,0,100
5a352bf724f769d491ad79fab4ef21294930e091,5,24,24,0,0,0,0,3,17,463,3,3,1.948586303,712,25,3,66,66,0,5647,5647,0,32,32,0,100
219f6bc9d2c9b240b21c72fef456a2bb357d8229,0,0,0,0,0,0,0,0,0,0,0,0,0,0,7,4,0,0,0,0,0,0,0,0,0,100
e6f6c1fbcc7539c5f79d8c52542fbc303fbc1ad5,0,0,0,0,0,0,0,0,0,0,0,0,0,0,8,5,0,0,0,0,0,0,0,0,0,100
03b2f18823e23200d100c1610b5a53c4e641ca46,4,104,28,76,0,0,0,6,20,37,2,4,1.969542697,2331,127,4,262,257,5,17800,17356,444,113,109,4,100
59bbfdc7983c5aec465b643d2584ad888432e48b,7,1183,123,1060,4,0,4,1,14,442,2,3,2.291639783,1029,26,1,258,126,132,12973,6818,6155,116,54,62,99.68290574
cee62333935d8e85143a65b67e553e12e6867849,2,9,9,0,0,0,0,6,9,0,1,2,0.764204507,1111,41,0,190,190,0,8622,8622,0,67,67,0,100
219534765e3f285d30d2a8fd40f0914381301288,2,34,9,25,0,0,0,3,18,337,2,2,0.999609836,794,128,2,91,89,2,6258,6118,140,40,39,1,100
8669f8ae70d9646e270c90a1b56fbcdf1f1db840,1,12,6,6,0,0,0,7,21,6,1,1,0,884,9,2,33,33,0,5972,5905,67,29,29,0,100
bbef55f965a2c8d10234c1d75ca2aa9229af5ca1,1,1,1,0,0,0,0,6,19,18,1,1,0,387,10,3,63,63,0,2837,2849,12,26,26,0,100
a0215eea16c032650a43c3694cc460ec26b37c80,1,26,2,24,0,0,0,3,5,122,1,1,0,93,55,0,16,15,1,996,795,201,6,6,0,100
f727a0cf597fba3266ef24ca6782f8e29da1e650,1,1,1,0,0,0,0,2,2,24,1,1,0,292,11,4,51,51,0,1987,1979,8,19,19,0,100
34b5afc36feaaea19ea129e985c0cad95629c4e5,5,250,2,248,1,0,1,9,57,135,2,4,1.671217702,1395,0,0,219,195,24,11670,10402,1268,48,41,7,99.94252874
13a61bf9153029725fc323b29098e9d06cf61ddc,0,0,0,0,0,0,0,0,0,0,0,0,0,0,12,4,0,0,0,0,0,0,0,0,0,100
36125fddc098e7d08cf7f8207e1adfa1352162d3,1,1,1,0,0,0,0,4,13,20,1,1,0,423,1,1,28,28,0,3409,3409,0,14,14,0,100
a962e24254cc0ca31d18e36b18891390183f9630,10,49,39,10,0,0,0,2,55,404,3,10,2.67746862,5256,13,4,861,861,0,40109,40004,105,279,279,0,100
1c32c13ad75f6b299f9047e68615f3d0aaee399b,2,8,2,6,0,0,0,5,29,157,1,2,0.970950594,279,56,1,34,34,0,1626,1586,40,15,15,0,100
cfaa570f0e3b802407e690e630ca50572e2ffc3e,53,170,229,59,0,0,0,2,31,628,7,25,4.799755787,10949,2,2,1019,1023,4,89095,89918,823,562,562,0,100
36db9ba134444dab2d9cb06588a00186484063c4,36,129,200,71,0,0,0,2,38,778,1,8,4.578824522,8966,3,3,742,748,6,62538,63410,872,347,350,3,99.91384262
b095b5b991a164983163390f0c8c6f78557d017e,3,104,1,103,1,0,1,4,6,258,1,2,1.171187224,148,4,4,27,20,7,1794,1220,574,12,10,2,99.85652798
f5989d28d297d083f71ca4eaf1f996e82dce2024,0,0,0,0,0,0,0,0,0,0,0,0,0,0,5,5,0,0,0,0,0,0,0,0,0,100
3d05db9b06fb63194ce4373b57623d6c499ac2e1,0,0,0,0,0,0,0,0,0,0,0,0,0,0,6,6,0,0,0,0,0,0,0,0,0,100
baad976f0ea6d3808dc0487af0aaaba2c25a1cce,2,32,6,26,0,0,0,2,4,48,1,2,0.949452015,308,27,0,62,59,3,2222,2110,112,24,23,1,99.97133028
0619d8a1a0860674bae2fcc035148ce3d23d009f,2,16,0,16,0,0,0,4,58,602,1,2,0.988699408,898,129,0,184,182,2,6831,6699,132,36,35,1,100
e3b77f06eeb9f64a413a51df1294d7e881d315f9,5,227,51,176,0,0,0,4,32,208,1,3,0.946689955,1595,23,0,187,159,28,13523,12482,1041,84,68,16,99.34881087
c330a21c4488a15b12fa3f82b451ee370ab05f25,0,0,0,0,0,0,0,0,0,0,0,0,0,0,7,7,0,0,0,0,0,0,0,0,0,100
bc5c43450dddced02e61dc61cae1960c8132cd41,13,400,240,160,0,0,0,2,3,208,2,2,3.400623609,16853,0,0,4286,4229,57,125793,124663,1130,1961,1961,0,100
1434d15b0d585ec29c09c9245d64349d96edc904,1,22,0,22,0,0,0,4,7,41,1,1,0,394,130,1,37,36,1,2124,2030,94,10,9,1,100
326c38dc6ec59719f7612625028566e12695c119,98,133,133,0,0,0,0,5,39,664,6,30,6.462095571,18974,131,2,1544,1544,0,149553,149569,16,917,917,0,100
ac6c0f0cbd0d314fabd08ffe8d055dc5688eb550,9,601,0,601,9,0,9,1,1,0,1,2,2.909834625,0,42,0,38,0,38,2942,0,2942,30,0,30,99.44382647
2575adde2a1fddc2594ecd0f3cdce7e5866cd228,15,1459,0,1459,15,0,15,1,1,0,1,4,3.710211134,0,43,1,156,0,156,8542,0,8542,85,0,85,91.97512585
7ce037351b7060d9c46b5578669839caf62cadcd,9,767,0,767,8,0,8,2,5,117,2,7,2.906541739,21,14,0,71,0,71,4757,32,4725,40,0,40,92.64240506
184a32d68fd319ff00e187d5d3558bc330d3c560,18,419,102,317,0,0,0,2,4,0,3,7,3.423715143,1369,15,1,181,153,28,9519,8694,825,108,94,14,98.41743119
c117c65ba9dadc0a2ae7d52f40ec5d20b559ed9c,0,0,0,0,0,0,0,0,0,0,0,0,0,0,8,3,0,0,0,0,0,0,0,0,0,100
51f4e8d46445b83debfd3984620b2953378a82e0,4,15,11,4,0,0,0,2,5,0,1,3,1.943109546,374,9,4,50,49,1,2295,2245,50,28,28,0,100
734e190526aebfd1f199b705e16ebc6f40d31f32,6,37,27,10,0,0,0,2,3,0,2,5,2.347263392,540,10,5,76,73,3,3912,3785,127,35,35,0,100
01ed1243857cb9334b92a94c5aa825dd56e10fd9,15,1294,34,1260,7,0,7,1,7,2,4,9,2.789322763,964,11,6,273,143,130,15373,7449,7924,127,63,64,98.00915332
9b43369ac5bbd16d08d34d8c6f8294a695d6e03d,0,0,0,0,0,0,0,0,0,0,0,0,0,0,12,7,0,0,0,0,0,0,0,0,0,100
00a14d92a676ff01b6150f7ec7af7009bc415f8c,2,299,2,297,1,0,1,1,2,0,1,2,0.10188287,110,13,8,39,13,26,2740,678,2062,19,8,11,99.86574178
07df5fbadb09975bfd5c5bd609479b44c23b2d0c,9,30,35,5,0,0,0,1,4,0,3,5,2.414839142,1117,14,9,132,132,0,8977,9088,111,56,56,0,99.71008029
5720b64d277417e511bfe230f260503016f7b7cb,1,7,2,5,0,0,0,4,10,160,1,1,0,93,15,10,18,18,0,655,606,49,13,13,0,100
4643f988a5e0ce2b9749e6365edea3a16482de86,2,5,3,2,0,0,0,2,3,0,1,1,1,137,44,2,14,14,0,767,756,11,9,9,0,100
7a30c819cf66fcff833db2da7993899b03a9d664,27,2130,1150,980,4,0,4,2,59,57,2,11,2.675052498,4264,45,3,896,901,5,35957,33106,2851,344,445,101,93.48630644
3be4330c22495648084c5b4e7bc819ef8323f0f6,3,3,0,3,0,0,0,4,56,34,1,3,1.584962501,2324,46,4,387,387,0,16794,16769,25,109,109,0,100
0702f54b4e32ad952514cc1041447632b20a8e52,9,450,47,403,1,0,1,1,3,263,1,4,1.744548522,1286,47,5,252,235,17,12778,9891,2887,72,71,1,98.02941993
30f680774c17a3696b40c59a06b5b11d9e01f45e,0,0,0,0,0,0,0,0,0,0,0,0,0,0,48,6,0,0,0,0,0,0,0,0,0,100
bfb354f2b3226c28a7750124acf38e48c6009645,86,22206,0,22206,86,0,86,1,1,0,1,8,5.614910104,0,49,7,1400,0,1400,121814,0,121814,645,0,645,86.51484135
1b0596142ddc93523c2edd91c8179489e9aea759,3,97,23,74,0,0,0,8,40,67,1,2,0.851932579,1814,16,2,188,180,8,13247,12720,527,71,71,0,100
fd047665bc7b92c282ac2d569ec52d763d6d00ff,1,1,1,0,0,0,0,5,14,161,1,1,0,306,16,8,43,43,0,1935,1935,0,14,14,0,100
812159d9608c7ccd5c777a877ea678642a17437b,1,19,7,12,0,0,0,7,18,42,1,1,0,265,17,3,42,41,1,1728,1670,58,28,28,0,100
33afaefcdc2d8308fd2da402b5db813ae4dde514,0,0,0,0,0,0,0,0,0,0,0,0,0,0,132,0,0,0,0,0,0,0,0,0,0,100
e7d633c22ae5ae7187c9401f68410299a1a3c5a6,6,17,13,4,0,0,0,2,11,293,1,4,2.146465799,1674,18,2,292,292,0,13445,13387,58,107,107,0,100
a902c2856f03f7f8dd7481918e57c29ba8fa23c7,1,4,1,3,0,0,0,3,4,104,1,1,0,262,19,3,34,34,0,1734,1708,26,19,19,0,100
95db288b9c01735580fb08e6562920af0628b031,0,0,0,0,0,0,0,0,0,0,0,0,0,0,17,1,0,0,0,0,0,0,0,0,0,100
d7cc6e69ea54ddaafc59bc3568a9bfc0ac765db3,0,0,0,0,0,0,0,0,0,0,0,0,0,0,20,4,0,0,0,0,0,0,0,0,0,100
2387ddb96a21822e099b9e389669b1f3634271bf,1,64,27,37,0,0,0,10,20,125,1,1,0,210,21,5,16,11,5,1544,1332,212,5,4,1,100
6ecf48ddee24524c89d838f10df87d33c70e61a1,0,0,0,0,0,0,0,0,0,0,0,0,0,0,50,0,0,0,0,0,0,0,0,0,0,100
9b0614cfa9e2d4f6e4638117900d29b552f59189,1,1,1,0,0,0,0,5,9,186,1,1,0,89,22,6,17,17,0,575,575,0,7,7,0,100
c4b0573107b889a8a694127a197695a443e23e5e,0,0,0,0,0,0,0,0,0,0,0,0,0,0,51,1,0,0,0,0,0,0,0,0,0,100
f4a9ad51f5056696f7b14d821b30b3613a66af25,5,139,45,94,0,0,0,6,27,191,2,3,1.937305384,2358,133,1,294,285,9,20659,20078,581,120,118,2,100
e0ae5400bdca5102e3aa962d1307a8e2971f6010,1,142,32,110,0,0,0,1,2,774,1,1,0,383,24,0,128,94,34,3449,2755,694,47,42,5,100
a3f7510bb57a85265ea1a6e829b857652ff95165,2,227,29,198,0,0,0,3,57,63,1,2,0.990071,2524,25,1,481,470,11,21270,19678,1592,128,123,5,100
04881fa7acbf11ab3118c5402f2473c5f1fc15b5,6,232,15,217,0,0,0,2,42,150,2,4,1.194833315,2677,26,2,419,410,9,23719,21883,1836,154,152,2,99.42542495
68949951e97b206766bf3e07d24399d80799e7af,58,7776,552,7224,7,0,7,1,58,569,4,27,4.11719169,28075,27,3,7297,5982,1315,253748,210701,43047,3124,2553,571,94.6716233
d540e3b5af3f74360777945e27004471732620d4,2,56,5,51,0,0,0,2,4,34,2,2,0.894869231,626,28,4,114,110,4,4866,4506,360,57,54,3,100
89aa9b4c18c652076bd26f4b7d73936dd94c2fe5,4,656,1,655,3,0,3,1,5,52,1,2,1.648580636,94,28,0,98,17,81,4589,789,3800,28,4,24,99.82265011
65f5ffe45f3dcd547d7f3306f398067853bfb2c4,0,0,0,0,0,0,0,0,0,0,0,0,0,0,18,2,0,0,0,0,0,0,0,0,0,100
70d0eccef8b25d9db16001f9e4200aecca5542a5,3,761,0,761,3,0,3,1,1,0,1,2,1.159615633,0,19,3,78,0,78,4606,0,4606,24,0,24,99.64691047
6d79016aaf2c9179bea9171c393990a466248753,5,77,6,71,0,0,0,3,7,70,2,4,1.091429162,819,20,4,144,132,12,6268,5719,549,61,60,1,100
d94e900af45342d20f0f3c8a56b18240340755f4,141,3211,3052,159,20,0,20,5,59,109,5,60,5.573892178,15887,29,5,2202,1851,351,115688,91289,24399,954,731,223,88.77202209
c49ea3a8ef04bff8d6766d26a9eb212cc382d965,0,0,0,0,0,0,0,0,0,0,0,0,0,0,30,6,0,0,0,0,0,0,0,0,0,100
89d64b6609229c48a250682091ed47c49bf7ffa1,2,31,5,26,0,0,0,15,60,90,1,2,0.943601631,392,31,7,83,81,2,3027,2834,193,13,12,1,100
ed39dc855afc9beee3491c8c50fbffecfaee2e1c,2,28,11,17,0,0,0,1,3,14,1,2,0.961236605,381,29,1,61,59,2,3155,3066,89,16,15,1,100
383cfd3ca9f71068a328974a6c280a560999ea61,3,27,2,25,0,0,0,4,6,543,2,3,1.543990777,778,21,4,136,133,3,5692,5603,89,44,41,3,100
a11cf624d79f29adf8a6fe509271406003ffdde8,3,88,3,85,0,0,0,6,28,605,2,3,1.308271784,1568,22,5,146,140,6,12742,12321,421,53,50,3,100
ca4968cfeadb0c30abaf1fd4b40705b62b09d44d,1,1,1,0,0,0,0,3,5,11,1,1,0,182,32,8,45,45,0,1133,1137,4,18,18,0,100
a051630adf3a39d289f7d8379e22d7d75a6e2b4c,1,1,1,0,0,0,0,6,10,38,1,1,0,89,52,2,17,17,0,575,575,0,7,7,0,100
66b32afa87fab816af972d68b253f46c53ec7f58,14,1643,1397,246,3,0,3,1,42,165,1,3,2.342072761,3868,23,3,325,416,91,29344,37236,7892,138,174,36,99.23203511
370fab099b93d4265f25af01d1d864b7a829d86d,3,33,8,25,0,0,0,4,13,73,1,3,1.12824682,1726,23,6,179,178,1,15315,15161,154,83,83,0,100
6bc9ce703091bd5780e926e3cdd186f23d33f128,3,28,18,10,0,0,0,10,21,51,1,2,0.678407091,550,24,1,49,46,3,3754,3676,78,18,15,3,100
3f79a5d74136ba635aa8c2594aec9c5666827603,4,100,3,97,1,0,1,10,34,102,1,4,1.619258518,590,134,0,62,58,4,5127,4541,586,28,26,2,99.94535519
dd8828cade1c47b038ae96e918f644bd2b913438,3,19,20,1,0,0,0,2,3,80,2,2,0.760658477,565,33,4,58,58,0,4650,4618,32,24,24,0,100
df4524e97d2e92f66bc7d619ea8c4932a8b7ca1d,3,39,6,33,0,0,0,2,61,25,2,3,1.338268928,1374,135,1,205,203,2,10094,9878,216,47,45,2,100
51475b0c03bcff96b9f88bcce0b1af632e8e6fb0,0,0,0,0,0,0,0,0,0,0,0,0,0,0,136,2,0,0,0,0,0,0,0,0,0,100
fc5cd5a477860d0afe5e583f66f10a506bddccb8,1,1,1,0,0,0,0,9,20,32,1,1,0,323,30,1,60,60,0,2566,2564,2,14,14,0,100
793cb5d245274c9ccd490383c7ef9c1cd993e09a,2,2,2,0,0,0,0,3,8,78,2,2,1,179,0,0,21,21,0,1062,1062,0,14,14,0,100
0adf29344633d57654800174b01816ea85e3141c,4,625,203,422,0,0,0,3,60,53,1,4,1.594999569,4396,34,5,882,811,71,38052,34819,3233,227,212,15,99.91805518
d4165e423d57a230f8982c8dd795ac1d9dd48d0d,7,673,7,666,3,0,3,5,43,122,1,3,1.783094206,871,25,2,197,137,60,9933,6164,3769,64,39,25,99.42981265
c523c46ee66fb005be47a1646b0665038b3aa9d1,2,51,6,45,0,0,0,2,15,50,1,2,0.219297308,1364,35,6,155,153,2,12270,11957,313,85,84,1,100
d89955bd6c5002b30a49a0832e0f3ac7b27af63a,5,114,38,76,0,0,0,7,14,141,1,3,2.13686746,1929,24,3,275,277,2,15863,15385,478,102,102,0,100
0db74b863824c03a2d0164b86c7a1330afc76b97,5,88,43,45,0,0,0,2,16,224,2,5,1.368223411,1670,36,4,178,176,2,14995,14628,367,94,93,1,99.64769648
fd1fbf70d247e4eefa50f9621faeb85db03645dd,1,43,31,12,0,0,0,2,4,50,1,1,0,191,31,1,42,38,4,1590,1518,72,8,7,1,100
e82a8c652a8f1d2a106f5cdf2df965058f937d8e,15,18,18,0,0,0,0,2,45,41,4,10,3.725480557,3895,37,4,582,582,0,32883,32847,36,195,195,0,99.89112684
afb6d9ae11c80d037015a75c698d02f8bdf74af8,2,12,1,11,0,0,0,3,4,32,1,2,0.89049164,481,1,1,62,60,2,4144,4018,126,21,21,0,100
1cbf44ade98a96985ec260c623ff6fd9122ad953,2,3,2,1,0,0,0,3,4,40,1,2,0.970950594,481,2,2,65,65,0,3981,3966,15,20,20,0,100
eceaaf8e0f83930a28e81d9380e5f75e3ebc4019,11,393,123,270,3,0,3,3,35,43,2,6,2.423951585,1558,32,2,221,194,27,13553,12051,1502,83,73,10,97.55832881
36cb81a8e83b0d9e0e6a2e5e2b242bce6a41f880,88,488,377,111,0,0,0,6,61,415,7,38,5.786922921,15421,0,0,2769,2743,26,110952,110677,275,1049,1019,30,100
8a99bd22cb934c2ff9fe85181a9d3fadf844083f,2,59,2,57,0,0,0,10,32,56,1,2,0.976414308,1669,25,1,171,162,9,13762,13473,289,89,88,1,100
2109f42945cb132c4bf738649abf2935288d1e20,1,1,1,0,0,0,0,2,3,168,1,1,0,27,53,0,0,0,0,51,52,1,0,0,0,100
c2c7af7e3f38b6f707a0949440c2e4f2b28c3a04,0,0,0,0,0,0,0,0,0,0,0,0,0,0,33,2,0,0,0,0,0,0,0,0,0,100
463aafc173a3ee2b03bedefcca9635030824d6cf,2,7,0,7,0,0,0,3,26,24,2,2,0.591672779,708,54,1,20,20,0,5330,5271,59,18,18,0,100
6888f4a137355be527576a78988c1cf203a7d8cc,14,47,39,8,0,0,0,2,19,106,3,6,3.680276639,1521,34,3,251,216,35,12217,10612,1605,82,73,9,99.37106918
c29f19bda26dfdffc5cc37862c12caddcc1c68ad,14,50,53,3,0,0,0,10,37,438,1,6,3.07749311,2980,137,0,302,305,3,22874,22976,102,125,125,0,100
6c453a0980f1e8621285c348e78d72c6a4d8e66e,0,0,0,0,0,0,0,0,0,0,0,0,0,0,0,0,0,0,0,0,0,0,0,0,0,100
f6f730c32874dd70062c283eeb80632c7fe5282b,86,154,165,11,0,0,0,6,62,130,6,43,5.840078915,23909,38,1,2959,2970,11,186018,185788,230,1145,1156,11,98.23837049
b4a64f976dd3b98225bbbe8fcf4bf8d7ecddce90,16,549,18,531,5,0,5,3,44,495,1,4,2.708963802,1411,26,0,238,201,37,11926,9444,2482,101,78,23,99.59038777
78e0393a3185eb452cf6a97554b360d44ad49039,0,0,0,0,0,0,0,0,0,0,0,0,0,0,39,2,0,0,0,0,0,0,0,0,0,100
f222f3ec38b8cdfabad3ba0fad9206615a09e96c,1,2,1,1,0,0,0,6,12,4,1,1,0,187,26,1,32,32,0,1406,1401,5,16,16,0,100
47b437544ad1c5524a98f76390063396adc6abd5,1,4,1,3,0,0,0,3,3,1880,1,1,0,36,27,2,2,2,0,120,120,0,2,2,0,100
ee15429a57dc8328227a902e7bd8e73a027ef32f,0,0,0,0,0,0,0,0,0,0,0,0,0,0,40,2,0,0,0,0,0,0,0,0,0,100
bc2929096a607dbea90be3e82a833a969f7aa432,3,84,0,84,0,0,0,3,62,57,2,3,0.314827719,998,55,0,92,89,3,7929,7400,529,24,22,2,100
8f453adfc29bc6cbc357e0fdb769591861469ad1,2,79,0,79,0,0,0,3,28,0,2,2,0.511639784,781,56,1,24,22,2,6313,5854,459,22,20,2,100
42744cc97918fdd528a53745b7518957edd1506d,15,363,9,354,1,0,1,6,9,94,3,11,2.653918892,1679,28,2,237,198,39,15029,12776,2253,137,123,14,97.13534823
e67bde0daed57eeaf778510f72b8082f99588c7d,86,5068,3011,2057,0,0,0,3,9,901,2,4,5.22142452,63273,138,1,16661,16434,227,480106,463739,16367,7001,6822,179,100
24f7c2d95184ec4cea9196574342159319f96533,2,23,1,22,0,0,0,9,63,28,1,2,0.41381685,3783,41,3,528,526,2,29446,29353,93,169,168,1,100
e5b6d4b3e7aa63b8e1c4f2edd4b3eb6e98e55667,1,1,1,0,0,0,0,4,5,51,1,1,0,36,139,2,5,5,0,208,208,0,2,2,0,100
26fbeba799979f5bf49426ad2316c7d0af56a078,3,83,1,82,0,0,0,3,45,23,2,2,0.83507841,1495,57,2,131,129,2,11795,11288,507,50,48,2,100
79204bc2cc886dafc30818dd1bf4b3727c5d09fc,1,66,0,66,0,0,0,5,7,41,1,1,0,220,58,3,21,15,6,1678,1347,331,8,7,1,100
170eb22f62733483cb17cb269ee21e893a182f1b,1,37,0,37,0,0,0,10,28,43,1,1,0,1559,140,2,106,104,2,13794,13498,296,38,37,1,100
38098b46167204761a24ca39f1e8bca2038156cc,2,15,1,14,0,0,0,2,63,82,2,2,0.543564443,527,141,3,85,85,0,3871,3768,103,14,14,0,100
81990992b42690ed064564fc67aa7c6c840a9b46,4,101,0,101,1,0,1,8,31,58,2,4,1.363585456,1927,27,0,188,179,9,15442,15073,369,75,67,8,99.9492128
08b2212bbce3a9e672734ceeed01832fd3fdbd6e,1,2,2,0,0,0,0,1,2,5,1,1,0,27,28,1,4,4,0,147,151,4,4,4,0,100
8cd392b55560e6c109469e5efabc2d96053f741e,6,60,102,42,1,0,1,1,30,139,2,5,2.181586561,2248,59,0,202,207,5,16931,17033,102,77,83,6,99.89847716
8b8442bb2fec8af75335451ef3a63f95064e7c12,16,37,36,1,0,0,0,1,3,252,2,7,3.606792369,6280,60,1,569,569,0,48356,48284,72,196,196,0,96.34017904
3dbfe881130a81b14ad57d298fc361cd8f5c5d76,2,61,2,59,0,0,0,1,3,114,1,1,0.99107606,403,27,0,56,51,5,3512,3163,349,22,20,2,100
caa630c97438c29c8d43e345431bddd4ed3cf9ef,2,33,2,31,0,0,0,8,31,88,2,2,0.660962335,1750,29,0,168,166,2,14106,13928,178,56,55,1,100
24b686edecfc7ee61765278a259f043ad00a9c5d,23,140,130,10,1,0,1,0,31,46,3,13,3.680828485,8846,29,2,836,833,3,67623,67771,148,294,289,5,96.23486045
ca8137e89dc7c1354e50dff852fe7c76e4f426b9,25,378,178,200,1,0,1,1,32,199,4,15,3.308056102,9060,30,1,882,874,8,70213,69059,1154,308,306,2,96.23486045
5630fc5cecfa7720c372f84ebb0bdc059ebc2c2e,46,732,1843,1111,4,0,4,0,46,254,5,23,4.550420028,11350,29,0,1090,1167,77,79898,86177,6279,384,421,37,94.08
e7ec257a76c7175a49e95b17ca4676dbd74a8d67,5,262,18,244,1,0,1,9,64,72,2,4,1.806494625,4385,30,1,729,681,48,34604,33497,1107,246,228,18,99.94799792
79659ad986bc5b9641182d8c02a95d3fd910ae52,55,1926,1061,865,13,0,13,1,63,258,5,25,4.845092153,16274,61,2,2024,2003,21,128190,123456,4734,727,709,18,94.02985075
6fbff11fa45d8962fda706c8a823909f71ef1f2c,3,36,32,4,0,0,0,3,40,43,1,2,1.286074688,1011,62,3,147,149,2,7894,8039,145,79,75,4,99.9726477
312ed27fe2d892b4225d30cc763b5800c36cff6c,2,20,7,13,0,0,0,4,15,80,2,2,0.605186577,433,142,0,92,87,5,3312,3209,103,27,27,0,100
528f34a899482a7726df0e3eacc35d98741b7a9e,3,41,2,39,0,0,0,2,29,112,2,2,1.387785886,2647,63,4,269,265,4,21912,21654,258,122,121,1,100
ef8902178141eba2959cfda438a51faa908135aa,1,66,0,66,0,0,0,1,3,38,1,1,0,220,64,5,21,15,6,1678,1347,331,8,7,1,100
915b80248a2504c1f98a6b13f8c1480417fee937,2,28,0,28,0,0,0,1,2,295,2,2,0.222284831,1131,65,6,35,34,1,8346,8204,142,31,30,1,100
1b65698cdf8bac61785c820a1df1d1b45a6f2354,63,1490,2117,627,6,0,6,1,64,196,5,28,5.033037699,20163,142,0,2221,2245,24,151930,154967,3037,822,839,17,93.66178429
09a8dcb0127c38b0c53bb8874bfa00aece9ce7da,63,2196,1492,704,13,0,13,0,63,231,5,28,5.048196445,19752,31,0,2247,2225,22,155263,152077,3186,839,826,13,93.66178429
8256776bc6f0acb1644b8d058f7f8a1d08ba6402,1,62,0,62,0,0,0,7,9,148,1,1,0,343,28,0,25,23,2,2698,2258,440,9,8,1,100
de7c26a8a13bdf102fd713a4fd3903ade0f1e835,64,1494,2260,766,6,0,6,1,64,198,5,28,5.086454997,20608,31,0,2244,2273,29,154188,158030,3842,830,849,19,93.66178429
a70cff999180486183e68fd9229818970f6b8fc1,24,982,711,271,5,0,5,2,65,148,3,10,3.643458668,8384,143,1,1095,1077,18,65896,66115,219,390,368,22,98.63296363
73d77bcd0ce12ba5109a903fb51bf122df20c2db,20,1279,370,909,14,0,14,1,48,28,2,5,3.48689066,1822,144,2,360,225,135,18904,12952,5952,182,89,93,98.70360956
a381e5bcd94ceefc58d3b6e48d232618119fb927,96,3267,3980,713,15,0,15,0,63,188,5,30,5.692531961,24651,66,3,2730,2859,129,189858,191587,1729,1017,1118,101,92.68100735
d6d4bf280492716b6551242fa57a6dfd4c5e75f3,3,86,1,85,0,0,0,1,4,22,2,2,0.844004788,1836,67,4,144,142,2,14080,13573,507,61,59,2,100
c6c9fabb48ec896904bc0370e69540b7cb2bc3cb,2,34,5,29,0,0,0,1,4,48,2,2,0.961236605,743,68,5,125,119,6,5282,5080,202,31,30,1,100
29e5fd0253e9b2f63dbcc21a65f7ebbcde118007,1,16,7,9,0,0,0,2,3,155,1,1,0,308,69,6,67,60,7,2429,2306,123,15,15,0,100
a53b20ad4aae6a9f2037e87addea2f7c93bbed17,2,25,0,25,0,0,0,10,30,102,2,2,0.529360865,1968,70,7,183,180,3,17207,17027,180,57,56,1,100
b72221b8dae93d9d1c50d7ce9a2f1192b39df34c,1,13,2,11,0,0,0,1,3,68,1,1,0,1559,71,8,105,104,1,13564,13498,66,37,37,0,100
7deefdb1d96aafe3085d901760b0611672bbdd4d,1,18,6,12,0,0,0,6,16,39,1,1,0,308,72,9,67,60,7,2429,2306,123,15,15,0,100
6f298b0f71efb9c26ee21ea27a514b4ebca02cd8,98,3985,3476,509,25,0,25,1,65,136,5,33,5.7417142,25256,30,0,2986,2890,96,196825,196601,224,1145,1055,90,92.68100735
a62664153e51256ad38d6aaf9e717e52230d15a0,6,0,0,0,0,0,0,1,1,0,1,2,0,274,32,1,37,18,19,1878,792,1086,18,18,0,99.34492315
8f67cf568a1e7f7ca301ad4374797075e59c537a,108,3551,4039,488,15,0,15,0,64,185,5,35,5.795022781,27970,42,0,3170,3253,83,216427,215639,788,1143,1246,103,92.18463152
170c2a1b585be883eb5b8fefdc4d5b7a7497ea9d,2,183,0,183,1,0,1,1,46,59,1,2,0.180780761,654,32,1,114,105,9,5959,4979,980,31,26,5,99.6173818
17ed7cb7fa02b67b0c9dd4c0097a981fb977af2f,111,4063,3761,302,25,0,25,0,65,120,5,35,5.843445603,28222,33,2,3280,3166,114,217934,217211,723,1245,1147,98,91.90251572
5cdd7cdfc5d363964ee6fd5336006e95ee7d8628,14,313,68,245,1,0,1,4,66,35,2,6,2.723317585,6755,145,2,885,865,20,54888,53637,1251,328,314,14,96.55403893
f13323008c46283796952fe8b71bc40ed4dc6523,403,4104,4940,836,17,0,17,4,64,73,7,85,6.346631159,119308,43,1,21449,12531,8918,894592,745916,148676,8970,6001,2969,72.98269274
2ce6bb275f41662ba5b7b98563d3e05fa442fd90,405,4998,4369,629,30,0,30,4,66,265,7,76,6.377767102,119048,31,1,21564,11510,10054,894630,584257,310373,9083,6329,2754,72.93351303
39c473c1f47ae73a131bc3ab607d4400a4aabe54,5,198,0,198,2,0,2,1,31,19,2,3,2.01521305,570,32,1,106,84,22,4417,3674,743,45,34,11,99.87949387
3bff594d87249e90d226d0953539d4ed4335d95a,412,4533,6138,1605,18,0,18,4,64,65,7,88,6.372513656,120156,33,0,21512,12712,8800,898884,754221,144663,9002,6105,2897,72.58028296
9da220abce69fbb2bb4e4467edab59622f96a241,26,26,22,4,0,0,0,7,24,194,5,14,4.668295834,3259,44,1,338,338,0,24727,24623,104,185,185,0,99.89801122
985f4ad59e87d065a961e950be49fb29c7cd1302,2,2,2,0,0,0,0,2,5,33,1,2,1,1734,73,0,119,119,0,14017,14015,2,51,51,0,100
64fb094abef815ea87cc79056bbcc4e65faaced1,1,24,0,24,0,0,0,1,4,81,1,1,0,1566,74,1,107,105,2,13721,13564,157,38,37,1,100
ddae7c04e3bd41a21223bdc1c59f6a12720423e6,2,35,4,31,0,0,0,2,6,70,2,2,0.821280942,769,75,2,128,125,3,5511,5282,229,32,31,1,100
f45727ab1a70a8e108c326da38aab2d00ba00f75,11,7,9,2,0,0,0,9,25,3,1,5,0.811278124,976,45,1,118,99,19,6522,5853,669,56,42,14,93.75443577
5a96dcdae86f99ed5218e1443daf47411cec536e,440,6961,5205,1756,35,0,35,4,66,248,7,86,6.476029904,122203,146,0,22057,4987,17070,921949,382247,539702,9306,2278,7028,73.26898867
c0ddd6121c2eec30ab43ef7b9511a5114507f773,10,357,70,287,1,0,1,3,50,186,3,6,1.457792515,1977,34,0,325,296,29,16319,14955,1364,133,126,7,99.96001599
e3f0a9f87ca16723a8c1fba4a6fe19adf28c01c9,4,568,18,550,2,0,2,10,33,6,2,3,1.412973896,768,35,1,187,143,44,8477,5022,3455,54,35,19,99.90017968
53dc2d6f41633b55711f0aff8d5e4c9be301255d,445,5163,8105,2942,21,0,21,4,64,47,7,96,6.533455288,123935,29,0,21862,13548,8314,919014,798764,120250,9169,6468,2701,73.13089005
df2b27364753cf146d34d912ff9d9037c4cca9aa,2,6,2,4,0,0,0,3,11,106,2,2,0.811278124,692,34,0,98,97,1,5664,5645,19,42,42,0,100
e84890aede5560a0d8c005ad00bda54117d3ecb1,6,2105,2105,0,3,0,3,2,35,91,1,2,1.799338958,2986,30,1,216,220,4,24056,23930,126,86,84,2,95.69648924
4f9b61fe517884f056f76c16cf2c4ed3c72c494e,1,19,0,19,0,0,0,1,2,0,1,1,0,365,31,2,8,8,0,3136,3136,0,5,5,0,100
92ebf1d465493efdf85771ef6c16329dccab5b35,450,9897,7380,2517,41,0,41,4,66,240,7,87,6.218896115,122425,36,2,22168,5036,17132,928160,384490,543670,9351,2304,7047,72.13149979
cf93a3a3e66ac7e21f92a1232b63a2a50cf8f86a,450,7349,10011,2662,25,0,25,4,64,46,7,96,6.223858247,123962,1,0,21876,13549,8327,920649,798827,121822,9179,6469,2710,72.10051546
a5ed6d912d1cac5f2239a629a34ce063ac97e6a4,10,193,185,8,0,0,0,3,48,179,1,5,2.583058758,2556,32,2,241,236,5,18508,18467,41,115,114,1,100
ed965d8712ae087bff3fddd6d74b4d475a541349,3,9,11,2,0,0,0,4,6,272,1,1,1.558871848,724,1,0,76,76,0,5918,5934,16,33,33,0,100
5acaa8ee265e8c83926013b208b786aa4083f5f5,2,27,25,2,0,0,0,1,2,40,1,1,0.866725613,1212,33,3,101,103,2,9548,9641,93,41,41,0,100
164ea5f1a66889cf2b7cfe3cacaa83ae645f557c,0,0,0,0,0,0,0,0,0,0,0,0,0,0,2,1,0,0,0,0,0,0,0,0,0,100
cbc7efcfb9cc8d254a4733dc07385d1ef49d756d,2,2,2,0,0,0,0,2,3,1455,2,2,1,247,3,1,42,42,0,1694,1694,0,23,23,0,100
f048132a7e7e111ea0d2f28220cc992b66ed95f8,457,9775,7795,1980,41,0,41,4,67,239,7,89,6.251839198,123666,0,0,22262,4475,17787,933733,343117,590616,9409,2144,7265,70.41062802
a8fd2e0effedbf5e427a1b1383c263acc3a716d2,456,7504,9890,2386,25,0,25,4,64,53,7,98,6.23813821,124746,143,0,22002,13693,8309,928013,807497,120516,9245,6549,2696,70.41062802
ad929e81897b015db7a4b52a2e76a89d02e52e31,457,9775,7795,1980,41,0,41,4,67,239,7,89,6.251839198,123666,147,0,22262,4475,17787,933733,343117,590616,9409,2144,7265,70.41062802
e77ec8a6e7374db40b8389a9106a2db8090db780,457,7647,9892,2245,26,0,26,4,64,53,7,98,6.259146327,124746,0,0,22010,13693,8317,928593,807497,121096,9247,6549,2698,70.34532722
ab2c4a3d5ac666ec72a13eabd30f29aafd99c053,457,9775,7795,1980,41,0,41,4,67,239,7,89,6.251839198,123672,1,1,22263,4475,17788,933776,343117,590659,9409,2144,7265,70.4249155
b7500ec237a02b2afb5ec50d4146e2a9289a01df,1,0,0,0,0,0,0,1,1,0,1,1,0,101,2,2,7,7,0,537,537,0,2,2,0,99.89959839
1e6ea0ea2b8a1294d28990c35be95bcbe064f463,458,7545,9897,2352,25,0,25,4,64,54,7,98,6.249957595,125217,144,1,22071,13790,8281,931528,812246,119282,9274,6594,2680,70.3283438
7138db63c7341f60b11e683022cd8a4ffc42a962,1,2,1,1,0,0,0,6,10,461,1,1,0,95,4,0,18,17,1,761,752,9,4,4,0,100
59dbe626c9e4553e03ebafe7c37d7017ede68758,2,61,94,33,0,0,0,2,2,274,1,2,0.172904304,1774,35,0,112,112,0,14799,15408,609,61,61,0,100
0b8301f2808cdd15278786dd33253df6018e04f5,460,9784,7839,1945,41,0,41,4,67,236,7,90,6.265261237,124226,37,0,22344,4556,17788,937136,346939,590197,9440,2177,7263,70.3283438
a43f7dff0ea999c57e8135f581ee0735bef7996f,461,8177,9902,1725,27,0,27,4,64,56,7,100,6.273984679,125279,34,0,22188,13807,8381,935943,812998,122945,9302,6598,2704,70.26766337
e96151ad36f92c1c54427906f6c5a6484b60a9cd,462,9818,8469,1349,41,0,41,4,67,232,7,91,6.285953381,124779,38,1,22344,4655,17689,937219,351202,586017,9440,2201,7239,70.26766337
049308d9ebef235e6a23e939969e7287a053ba5d,4,14,7,7,0,0,0,4,8,160,2,3,1.746435384,456,3,0,62,61,1,3493,3474,19,25,25,0,99.92467989
13c3305de5d13d02fda9cfb149843697280518f9,9,1126,1190,64,2,0,2,6,68,41,1,4,1.44817297,4062,42,0,615,636,21,29936,29435,501,202,203,1,98.38872105
44dc1598e5e6a98137a84b51005cafac36ad3272,464,9570,11257,1687,28,0,28,4,64,55,7,101,6.218070911,125385,145,0,22224,13870,8354,937879,816051,121828,9323,6627,2696,70.45454545
b8be26f84277644ddfd5d0e8512404857dc89ab1,1,13,2,11,0,0,0,6,16,492,1,1,0,302,146,1,45,43,2,1977,1933,44,14,14,0,100
7d39a6ef87ab5e76c5cc162ab95efdae5e3f4b5c,7,260,48,212,1,0,1,4,17,418,1,4,2.428164837,936,147,2,129,108,21,8827,7360,1467,62,51,11,95.26184539
caf924b5fe7862932443d445bdf46de1bedd2a61,471,11192,10123,1069,44,0,44,4,68,224,7,92,6.283096143,125702,148,0,22414,4838,17576,943548,361311,582237,9479,2280,7199,70.6868067
a8c405a9ab6910fd6341588db76ccb78c5bcb535,1,13,2,11,0,0,0,6,16,492,1,1,0,302,149,1,45,43,2,1977,1933,44,14,14,0,100
1024efb4de784e8a6bc952633dd0a52ae1599176,7,260,48,212,1,0,1,4,17,418,1,4,2.428164837,936,150,2,129,108,21,8827,7360,1467,62,51,11,99.59534648
b124675c0d571a4b85026d5390a7758092e04842,466,9624,11308,1684,29,0,29,4,64,55,7,101,6.234393934,125125,35,1,22186,13827,8359,934978,813162,121816,9297,6600,2697,70.79102715
9e153050b18ea299c6620f31158df540b75d12eb,466,11204,9814,1390,44,0,44,4,68,233,7,92,6.238754441,124444,33,0,22277,4676,17601,935391,350758,584633,9421,2207,7214,70.82841633
844b037223ab8e3d73dcdaa8b919296424a79ebd,464,8142,10015,1873,27,0,27,4,64,55,7,100,6.287913163,124971,46,0,22121,13840,8281,933346,814827,118519,9281,6620,2661,70.19417476
441a4f64aa624310d180eae821c12fea1c2f437b,12,225,345,120,0,0,0,2,3,234,1,6,3.443219205,4803,1,0,840,846,6,36821,38011,1190,258,264,6,96.20223119
97c9f7398fab3444edd46704a33d58d9be5673d6,464,9860,8425,1435,41,0,41,4,69,235,7,91,6.297019725,124291,4,1,22271,4610,17661,934222,348221,586001,9415,2183,7232,69.50074147
d8425a8d89ad7b9a8d9e597322b456909d60cfa8,9,319,95,224,1,0,1,5,43,315,2,4,2.260212953,1601,0,0,231,218,13,12949,12129,820,111,104,7,99.87370548
73a5eabeaef5f9b76a9366bc74d5cbd99a32bc3f,468,8387,10230,1843,28,0,28,4,64,57,7,100,6.342943357,125500,36,0,22188,13855,8333,936703,816916,119787,9311,6634,2677,69.37297027
12fe979dca6148246d439819bbeec4e328efc061,466,10099,8440,1659,42,0,42,4,69,238,7,91,6.325845175,124468,39,0,22300,4626,17674,936544,349723,586821,9433,2194,7239,69.35363115
d9763f6b98b4440f72883991467c0ad96b20952d,466,8336,10389,2053,28,0,28,4,64,55,7,101,6.344435239,125204,37,1,22131,13795,8336,933757,813460,120297,9286,6604,2682,69.37858747
9e5508ea87b777016d35a70ed5f96dec4ee3699b,467,10262,8648,1614,43,0,43,4,69,238,7,92,6.358789669,124508,40,1,22300,4640,17660,936544,350641,585903,9433,2201,7232,69.37858747
fcce5667024b47d2b986395262b402d4cd893666,466,8336,10389,2053,28,0,28,4,64,55,7,101,6.344435239,125204,38,2,22131,13795,8336,933757,813460,120297,9286,6604,2682,69.37858747
1911c49065c46be976dd5bf35b417bb307a4f75d,466,10099,8440,1659,42,0,42,4,69,239,7,91,6.325845175,124508,41,2,22300,4626,17674,936643,349723,586920,9433,2194,7239,69.37858747
d9ab452f0ba86177e741ccf147a16da551d01da7,465,8466,10484,2018,27,0,27,4,64,55,7,100,6.313579313,125244,39,3,22134,13817,8317,933409,814497,118912,9291,6614,2677,69.37858747
9f0b14db938d2d3ecf38a8a619b0cedd81fba3d3,1,54,14,40,0,0,0,2,2,92,1,1,0,76,40,4,11,11,0,614,437,177,5,5,0,100
5eb2d42af100153bea90d8132b0261d5f6d0f616,466,10100,8481,1619,42,0,42,4,70,240,7,91,6.335027237,124504,42,3,22303,4626,17677,936218,349723,586495,9438,2194,7244,69.37858747
ee0040a84c2a52fc670a41c22d08dd7588b21ffe,1,54,14,40,0,0,0,2,2,109,1,1,0,76,43,4,11,11,0,614,437,177,5,5,0,100
0af1aafce65066c15ed122d19db0537276e5436d,465,8115,10213,2098,27,0,27,4,64,55,7,100,6.309779341,125235,4,0,22134,13817,8317,933586,814497,119089,9291,6614,2677,69.37858747
7ed5c486494408a8e9a4e4b7942fd79581104698,466,10086,8427,1659,42,0,42,4,70,240,7,91,6.324480495,124504,4,0,22303,4626,17677,936395,349723,586672,9438,2194,7244,69.37858747
ff623a9444a711ddcf3b8ed558530709ddbf0623,465,8219,10225,2006,27,0,27,4,64,55,7,100,6.321889373,125235,5,1,22138,13817,8321,934201,814497,119704,9294,6614,2680,69.37858747
7c345602033dcad6f6470d2b990aeeaf49fd630e,466,10086,8427,1659,42,0,42,4,71,240,7,91,6.324480495,124564,5,1,22307,4626,17681,937010,349723,587287,9441,2194,7247,69.37858747
b479df4ba383a8920661b1b20d086e40a8ac2e1c,467,8560,10412,1852,27,0,27,4,64,54,7,100,6.310429757,125697,41,2,22189,13866,8323,936972,817107,119865,9313,6628,2685,69.37858747
4abd1869fbb86fb3b5dd07c4898f9926f40bcd44,4,632,642,10,0,0,0,2,6,366,2,2,1.202391915,1792,42,3,158,151,7,14199,14243,44,57,56,1,100
55947a5d7944b45d967b3e40fe3741bd9ca9f73a,1,31,7,24,0,0,0,5,9,141,1,1,0,290,43,4,39,39,0,2118,1857,261,16,16,0,100
f48da48f4a1cab221a9ddb81b701114af8c681f7,2,576,169,407,0,0,0,3,6,16,1,2,0.449550571,3691,6,2,545,516,29,30279,29220,1059,195,173,22,100
2a812120c88e99964b1166626ebfab55a16db91c,470,10287,8889,1398,42,0,42,4,72,234,7,91,6.337082004,125808,6,2,22466,4765,17701,944093,356127,587966,9503,2240,7263,69.37858747
55d2721c866f0820f03162d92b0a62768eea2d1b,469,8582,10424,1842,27,0,27,4,64,55,7,100,6.322758889,126372,7,3,22305,13947,8358,941639,820523,121116,9361,6654,2707,69.37858747
0bf0a99908ebefd6203eb61bc5fc9f2c2646c2ee,470,10293,8888,1405,42,0,42,4,72,234,7,91,6.337470266,125804,7,3,22466,4765,17701,944102,356127,587975,9503,2240,7263,69.37858747
3d88779068ff20a31f842e70caa624a47fd1e34b,1,0,6,6,0,0,0,12,37,0,1,1,0,422,8,4,65,66,1,2764,2789,25,22,23,1,100
3c11bb2dd7704bee0c2376958031abea6bfea53f,469,8620,10417,1797,27,0,27,4,64,55,7,100,6.324061663,126369,8,0,22305,13947,8358,941639,820523,121116,9361,6654,2707,69.37858747
31cd4d0d44230d304f51e22ff7b3fd3d27b5a602,470,10287,8888,1399,42,0,42,4,73,234,7,91,6.33700163,125804,9,0,22465,4765,17700,944077,356127,587950,9502,2240,7262,69.37858747
99aea6fcc3b92345e4cdf82f6f1eb9677e89b5cf,470,8597,10418,1821,27,0,27,4,64,56,7,100,6.327070267,126436,9,1,22314,13955,8359,942097,820868,121229,9368,6661,2707,69.37858747
cf8a16f2ae2c7aa5a0cf49d81e8de13f598c3c10,470,10287,8888,1399,42,0,42,4,73,234,7,91,6.33700163,125804,10,1,22465,4765,17700,944077,356127,587950,9502,2240,7262,69.37858747
6125ac9bd541cb141beafa844fc7e32157c532d0,13,586,916,330,2,0,2,4,45,335,2,6,2.961158348,1489,11,2,135,176,41,8303,9639,1336,62,83,21,99.54579864
1a238c0ecf1788a7bda93ae99b7744dac67f5c43,466,8618,10097,1479,27,0,27,4,64,55,7,100,6.27680773,126127,44,0,22309,13905,8404,941746,819204,122542,9361,6633,2728,69.5
5e6da0cabb968160d41425a6808bcab37b27c368,467,9984,8894,1090,39,0,39,4,74,245,7,91,6.290002446,125818,44,0,22428,4765,17663,942835,356127,586708,9481,2240,7241,69.5
b34a736a64a60790651b39fd77d0a9ce39cd3c2a,7,720,276,444,1,0,1,2,51,292,3,4,1.252079955,1852,45,1,338,270,68,16984,14420,2564,90,75,15,99.92420414
854934cb218cf113bd089f51ca4fdfe72ecef0ee,470,8594,10618,2024,27,0,27,4,64,59,7,100,6.297781738,126864,10,2,22354,14029,8325,943995,824409,119586,9388,6675,2713,69.46526737
56b0f19a5a53d75b6d9bc28ff663a37f7cd182af,468,10149,8615,1534,40,0,40,4,75,249,7,91,6.30750478,125744,12,3,22484,4768,17716,944950,356192,588758,9496,2240,7256,69.46526737
2a89d2bfe33eff2d861469caf9058b4062c85d98,467,8345,10302,1957,27,0,27,4,64,55,7,100,6.301948434,126412,45,1,22298,13975,8323,941230,821791,119439,9361,6648,2713,69.46526737
1458d1a3b2e6733be20f54917c4d4dbc4d90bcc1,468,10148,8614,1534,40,0,40,4,75,249,7,91,6.307215007,125737,46,2,22485,4768,17717,944895,356192,588703,9496,2240,7256,69.46526737
6df0a66d7d914df2bbafb0b9d6a328dd6966bc41,10,401,1,400,3,0,3,1,13,274,2,5,2.429825429,814,47,3,182,138,44,7279,6046,1233,106,76,30,99.59809093
cb0f1003600b3101918f11863d830f985b63cee5,0,0,0,0,0,0,0,0,0,0,0,0,0,0,13,4,0,0,0,0,0,0,0,0,0,100
aba45daf7825abad87e27d66284a32f3f3e37cc0,476,8321,10672,2351,27,0,27,4,64,61,7,100,6.358785745,127167,11,3,22382,14103,8279,945598,827392,118206,9418,6735,2683,69.25180214
58d76b93a0765f906ac4246d0a252baa8c807bae,6,124,20,104,0,0,0,10,65,707,2,4,2.168841836,1566,46,2,258,247,11,11511,10975,536,59,57,2,100
62bdcbfe90e85dba65ee6992c3e7c6ad9ed985e9,4,331,322,9,0,0,0,2,10,103,1,2,1.262040708,2517,47,3,493,493,0,18259,18213,46,167,167,0,100
79cbd178a8fbd6d742294a79236dec3b27811585,480,10561,8734,1827,43,0,43,4,76,227,7,91,6.389927584,126696,48,4,22646,4896,17750,952149,362703,589446,9599,2315,7284,69.25180214
d44e6702751ec2b316d16498a646c51a07065d8f,479,8440,10684,2244,27,0,27,4,65,67,7,100,6.376511886,127497,48,4,22426,14136,8290,947787,828999,118788,9436,6751,2685,69.25180214
c4d3b5eae26f615cee02f7e77c642ff6dd7f0706,480,10562,8734,1828,43,0,43,4,76,227,7,91,6.38987587,126696,49,5,22647,4896,17751,952178,362703,589475,9598,2315,7283,69.25180214
963d5e643e8b575ff22cce11cd0659f4e4774334,479,8442,10706,2264,27,0,27,4,65,67,7,100,6.381332016,127488,49,5,22424,14137,8287,947737,829026,118711,9434,6750,2684,69.25180214
91168c6234f6aee63728202d6571d7d590d16e85,480,10594,8735,1859,43,0,43,4,76,227,7,91,6.396069304,126685,50,6,22654,4896,17758,952192,362703,589489,9598,2315,7283,69.25180214
6d8214e70476ba6cb2e09aef6cf47eb24a2316bf,0,0,0,0,0,0,0,0,0,0,0,0,0,0,51,7,0,0,0,0,0,0,0,0,0,100
9652979cfa3d25b491cc168f109395f7e8ab9527,2,60,1,59,1,0,1,1,22,409,1,1,0.998254569,256,0,0,23,19,4,1858,1595,263,10,8,2,99.95004995
78bd5ded70340d1724469a75e443e4ac9b5f6a67,1,4,23,19,0,0,0,3,4,23,1,1,0,114,1,1,9,11,2,576,626,50,3,5,2,100
d5176b2ea2e80d51f49d9e13075d794436fbe504,6,124,20,104,0,0,0,11,64,709,2,4,2.168841836,1504,2,2,253,242,11,11036,10500,536,58,56,2,100
b98b587e9e3d8a4598108d1c4887a74e5b116aae,1,39,41,2,0,0,0,5,7,39,1,1,0,349,14,0,74,75,1,2442,2381,61,11,11,0,100
2911c532bb83e75f60902fa75bb2097688881947,15,1254,243,1011,1,0,1,2,77,177,2,11,3.010778054,6653,52,3,1097,1019,78,55345,50961,4384,382,357,25,95.09954058
7770b6ea0cc227a778894c51d43e92d50e7f663f,2,32,15,17,0,0,0,5,9,247,2,2,0.342463772,635,15,1,120,116,4,4553,4446,107,30,30,0,100
4cfc08be4c6b30345867ab3210b6a6dd76e190db,3,0,658,658,0,0,0,3,3,483,1,2,1.427027381,359,3,3,0,58,58,0,2044,2044,0,39,39,99.84402418
5d17ebb17d8069a7c9c90d8b9bd470005c3ae9af,14,126,251,125,0,0,0,2,10,437,3,3,2.863222334,1119,53,1,185,200,15,8259,8678,419,87,102,15,99.84362783
17bf43f388763a933823a602c097c777274f0743,472,8611,11269,2658,26,0,26,4,65,65,7,99,6.329190267,127771,0,0,22439,14122,8317,948435,828937,119498,9436,6707,2729,70.94166485
9f09f305afd7abbabea0ecfc1a1d0b8edc2922bc,473,11146,8905,2241,39,0,39,4,77,255,7,91,6.342978647,126698,54,2,22688,4909,17779,955621,363294,592327,9575,2319,7256,70.94166485
3ada8a36e08b14fd6c86a879867cc2748e97e693,2,170,164,6,0,0,0,16,78,12,1,2,0.822927484,2694,4,4,527,525,2,19497,19377,120,180,182,2,100
c4afd37b4a31e04c815896f8e3dc7c0c881b2808,472,8500,11106,2606,26,0,26,4,65,65,7,99,6.34127985,127775,50,0,22439,14122,8317,948453,828937,119516,9436,6707,2729,70.94166485
938b2c2baded5542365f5d77cab72ce25d8077f6,1,3,4,1,0,0,0,3,4,960,1,1,0,390,1,1,57,57,0,3129,3125,4,9,9,0,100
183af2c9bc56a77ea3b718e3f7e3b0f767119303,473,10983,8794,2189,39,0,39,4,78,255,7,91,6.355021633,126750,5,4,22690,4909,17781,955741,363312,592429,9573,2319,7254,70.94166485
e840bdb1572d597205d9bbd85b80ff0f3a9f7c8c,2,11,6,5,0,0,0,3,16,316,1,1,0.322756959,448,6,3,48,48,0,4395,4348,47,31,31,0,100
a79f923dc61d050ddf88dafc87399c9b00577fc2,5,53,3,50,0,0,0,3,17,127,2,2,1.956144944,809,7,4,95,90,5,8516,8022,494,67,65,2,99.98043053
60a05f618cd192c564a519f1437173d6dd60749a,472,8520,11190,2670,26,0,26,4,65,65,7,99,6.344618812,127827,2,2,22439,14127,8312,948278,829478,118800,9436,6709,2727,70.94166485
5849ab0e530a8e3a250b7e58fde211842960288f,473,11037,8793,2244,39,0,39,4,79,254,7,91,6.354845598,126736,8,5,22695,4909,17786,956107,363312,592795,9575,2319,7256,70.94166485
dc03ed502f53d8c31b69f7cf346909a9bd36ef2b,1,1,1,0,0,0,0,15,48,110,1,1,0,210,55,3,0,0,0,1627,1627,0,0,0,0,100
322c281afedefcdd7b0c5dbad19782f140c30454,472,8499,11160,2661,26,0,26,4,65,65,7,99,6.3411056,127813,51,1,22439,14127,8312,948278,829478,118800,9436,6709,2727,70.94166485
8da7208e79f49ddf941bca2022709cc313dcb885,473,11037,8793,2244,39,0,39,4,79,254,7,91,6.354845598,126736,56,3,22695,4909,17786,956107,363312,592795,9575,2319,7256,70.94166485
72841bff7f3feb761332040540662afef053a8ff,1,5,2,3,0,0,0,5,11,32,1,1,0,397,57,4,85,84,1,2849,2832,17,14,14,0,100
0a1a736475493bad96fccd41f35ecf9057c845c1,1,1,7,6,0,0,0,5,12,0,1,1,0,399,58,5,84,85,1,2830,2849,19,14,14,0,100
3f99bbdb3a75637f070cd51910853fb82ae34a49,2,11,1,10,0,0,0,15,49,44,1,1,1,648,59,6,67,67,0,4486,4422,64,22,22,0,100
797740292164b0200dc620f0d198aa039b68ca6a,473,8499,11168,2669,26,0,26,3,65,67,7,99,6.342819856,128043,3,2,22489,14178,8311,949990,831195,118795,9455,6728,2727,70.94166485
e3aaa7fb73a1e83af37424b51403f6e28cd0cd22,473,11044,8793,2251,39,0,39,4,79,254,7,91,6.356072623,126736,9,5,22695,4909,17786,956169,363312,592857,9575,2319,7256,70.94166485
33d9f6fe45d7b5149ee2ea472b58045b1eccbed2,1,15,3,12,0,0,0,1,3,56,1,1,0,61,60,5,15,14,1,377,329,48,7,7,0,100
21fbb9d43fa850cdac536958732ecd50149701ac,1,26,17,9,0,0,0,5,13,12,1,1,0,395,16,0,85,84,1,2845,2830,15,15,14,1,100
3817f18befe5d081b80af42f527d23579fb8b2ce,1,5,2,3,0,0,0,5,14,1,1,1,0,399,17,1,85,85,0,2862,2845,17,15,15,0,100
b596fe9b884db583215a58a3309677590969b71f,5,162,16,146,1,0,1,11,80,30,1,3,1.383953778,4381,61,6,626,618,8,34486,33887,599,240,234,6,99.90211433
fc8c626eeea9889d2108764c8023e4320e41204e,474,9092,11794,2702,27,0,27,4,65,67,7,99,6.350398742,127909,4,1,22436,14129,8307,948365,829580,118785,9439,6710,2729,70.84426947
71f47698586916f2f4e3713346d10cf41485284e,475,11203,8796,2407,39,0,39,4,81,243,7,91,6.349390698,126763,10,1,22702,4911,17791,957162,363438,593724,9585,2321,7264,69.59262852
f783277f821dd7698fc143a78858459181328318,4,1735,1,1734,2,0,2,12,53,223,1,2,1.522777768,13357,11,2,3531,3211,320,109165,99215,9950,1834,1664,170,99.88123515
c0333a9cf119c8792130ff8bbf67d7cf041a2a66,8,75,15,60,0,0,0,16,54,1000,2,4,2.367359363,2137,12,3,337,332,5,16398,16114,284,77,77,0,99.92872416
5209076418d93c12404057ac52bf5c21c783fea9,1,15,3,12,0,0,0,2,4,21,1,1,0,61,13,4,15,14,1,376,331,45,7,7,0,100
7aac09ec6351b7c7f8281ce6032efbb1239f5ad6,1,3,15,12,0,0,0,2,5,0,1,1,0,68,14,5,14,15,1,331,376,45,7,7,0,100
1c6ba5ebe4a4374b2472633dd21435eec9933d6f,7,156,43,113,0,0,0,12,82,110,2,6,2.583706912,5212,62,6,748,736,12,40990,40601,389,272,265,7,100
c2013f236c9d4d92d813c962f4dc5ab85ce89749,479,8516,13274,4758,26,0,26,4,66,69,7,101,6.364610587,129958,5,2,22511,14404,8107,952293,840791,111502,9473,6848,2625,69.48823672
aecf3f281e4c87feb4063d87e02373f4ae747a1b,482,13538,8820,4718,43,0,43,4,83,255,7,92,6.402982572,127309,15,6,23145,4986,18159,972804,367364,605440,9813,2355,7458,69.40406977
af5c004b6f7925be291dae95e8ba592d651aa1f8,7,10,14,4,0,0,0,3,65,487,3,6,2.163890987,1633,16,7,215,216,1,11002,11098,96,67,67,0,100
5f850cc8ac4800995bb31ed2fc61d8341d8efcdc,481,8652,13671,5019,28,0,28,4,66,66,7,101,6.409262971,129642,6,3,22457,14360,8097,949016,837785,111231,9449,6833,2616,69.36849746
e35d36cd278dcb496cbf0da142a637d3c2c0034f,482,13531,8955,4576,43,0,43,4,83,255,7,92,6.4198642,126856,17,8,23073,4932,18141,968975,364029,604946,9783,2331,7452,69.36849746
48ec01dd7db3d345976db9a3ea8c60162c72501e,0,0,0,0,0,0,0,0,0,0,0,0,0,0,18,9,0,0,0,0,0,0,0,0,0,100
6f4a88bd112260866b6140475676b5f1ab74f7f9,483,8666,13682,5016,28,0,28,4,66,69,7,101,6.412074897,129662,7,4,22461,14364,8097,949142,837903,111239,9453,6837,2616,69.36849746
afdfd86b0ed9756a10ace04ce7439429b1153e32,484,13542,8969,4573,43,0,43,4,83,254,7,92,6.422653559,126878,18,2,23077,4936,18141,969093,364163,604930,9787,2335,7452,69.36849746
731a5d15eb78178e6ffdcd1f7444f8c4172bf663,7,16,13,3,0,0,0,2,84,455,3,6,2.611041014,5330,19,10,801,801,0,41609,41599,10,257,257,0,100
8f5c17dbce6417b0c98ba6c2c31fa9c7fd8b222f,13,560,197,363,5,0,5,12,85,106,2,5,3.114629643,5376,63,1,771,758,13,42718,41734,984,315,303,12,99.33806147
2fbaacc8e11dbd5a63922ec8051854b39857b85b,1,8,1,7,0,0,0,6,7,107,1,1,0,197,20,9,43,42,1,1581,1559,22,10,10,0,100
f0e1dfbd0c6eb21219993c84eff49d4ad3da0e5e,1,2,1,1,0,0,0,7,10,895,1,1,0,95,21,10,18,17,1,761,752,9,4,4,0,100
5b1a89ea36fafa9fae25953eddb3690ba0683c65,16,37,36,1,0,0,0,2,3,972,2,7,3.606792369,6280,22,11,569,569,0,48354,48282,72,196,196,0,96.94477086
94ec0b44c40b7a72c3c7292df47047aa390feab7,3,248,38,210,0,0,0,9,32,920,2,3,1.422348654,1666,23,12,155,144,11,14064,13058,1006,59,52,7,100
62b00232123c285d2bc856d43682e02984060337,0,0,0,0,0,0,0,0,0,0,0,0,0,0,24,13,0,0,0,0,0,0,0,0,0,100
b850bbb0c079922d34302b514bc2b0dc17a44482,3,36,32,4,0,0,0,3,39,710,1,2,1.286074688,1066,25,14,155,157,2,8298,8443,145,79,75,4,99.88320486
51209d98f50bf63522162427858c29eb24870b0f,1,19,4,15,0,0,0,5,7,895,1,1,0,123,26,15,32,26,6,1006,891,115,12,12,0,100
dbf72f5ae908fc1ff78b209048d5470c1dbe4aaf,1,66,0,66,0,0,0,2,3,0,1,1,0,220,27,16,21,15,6,1678,1347,331,8,7,1,100
b385440ed9d23d39af5da784ca715d61c23e0638,2,28,0,28,0,0,0,2,2,1045,2,2,0.222284831,1131,28,17,35,34,1,8346,8204,142,31,30,1,100
86f67e606acd2c1b8a357b50ab82b1ced62e3c2a,1,82,5,77,0,0,0,11,25,14,1,1,0,317,29,18,27,24,3,2313,1948,365,11,10,1,100
b2121119bee5b7b6d70080c5bf07ab77405d75da,1,62,0,62,0,0,0,7,9,875,1,1,0,343,30,19,25,23,2,2698,2258,440,9,8,1,100
f40831d709e84ec6ad7b7e8a31b0067ef32a1d97,2,85,0,85,0,0,0,2,3,0,2,2,0.487369571,1152,31,20,37,35,2,8812,8346,466,33,31,2,100
1e031de81dd3f64bc6efff95b53a31a13efa135c,3,86,1,85,0,0,0,2,4,0,2,2,0.844004788,1836,32,21,144,142,2,14080,13573,507,61,59,2,100
63352d834387588547c7e0a5f284533c2e54aa99,1,16,7,9,0,0,0,3,3,875,1,1,0,308,33,22,67,60,7,2429,2306,123,15,15,0,100
7868f80c2b07ad7eae62d58de24cfa0246b28744,2,25,0,25,0,0,0,11,30,402,2,2,0.529360865,1961,34,23,182,179,3,17136,16956,180,57,56,1,100
f71e2e825b30fcd72fb0b217c3a11105b254880d,1,13,2,11,0,0,0,2,3,0,1,1,0,1559,35,24,105,104,1,13564,13498,66,37,37,0,100
c8de9a907f06c5ab08836e816176cb2a1598199b,2,183,0,183,1,0,1,1,52,90,1,2,0.180780761,673,36,25,117,108,9,6087,5107,980,31,26,5,99.95344507
c34ce7298b8cba046c82c8be3561f9d60f2bc468,1,24,0,24,0,0,0,2,4,0,1,1,0,1566,37,26,107,105,2,13721,13564,157,38,37,1,100
df7c7dd40ad67af7a4a2fc2a802d8ddcd6fed1ff,2,35,4,31,0,0,0,2,4,0,2,2,0.821280942,743,38,27,122,119,3,5309,5080,229,31,30,1,100
f6d31428fc6013528002c586f2d3cf21d27a70f5,2,6,2,4,0,0,0,3,10,879,2,2,0.811278124,692,39,28,98,97,1,5660,5641,19,42,42,0,100
f407a680a10fe233ff4fb209134d6ef876a69624,1,261,0,261,1,0,1,1,1,0,1,1,0,0,40,29,16,0,16,1427,0,1427,7,0,7,99.95348837
f2176bbf6f7392392d812fbe75804e373660f6b7,3,9,11,2,0,0,0,4,5,615,1,1,1.558871848,724,41,30,76,76,0,5916,5932,16,33,33,0,100
5994ec3a1726754b659eee3d7d2eac308b5eada6,2,2,2,0,0,0,0,7,13,2073,2,2,1,246,42,31,42,42,0,1679,1679,0,23,23,0,100
3cbaa91cfd3a007e276a4b522145d98f6e278167,1,31,7,24,0,0,0,5,9,402,1,1,0,290,43,32,39,39,0,2118,1857,261,16,16,0,100
27117ac612eeccd4890915647b96f1ed31f2ba1a,1,2,2,0,0,0,0,11,26,0,1,1,0,365,44,33,27,27,0,2289,2313,24,11,11,0,100
65568d3c0e75c2a71e303877ced0e5e80b7e4301,2,32,1,31,0,0,0,9,33,90,2,2,0.532835063,1853,45,34,181,179,2,15019,14841,178,59,58,1,100
218be0c59efb7d4f57bcb64e8d5fef8c51e06556,1,1,3,2,0,0,0,7,17,0,1,1,0,316,46,35,67,68,1,2429,2441,12,15,15,0,100
0bec6c728727638469b955589e9f167da4024ba7,3,39,2,37,0,0,0,2,31,331,2,2,1.305239411,2727,47,36,279,275,4,22492,22251,241,123,122,1,100
b15b95ed6e6920225db0b077b197aa2baeabcd07,2,34,5,29,0,0,0,2,5,0,2,2,0.961236605,771,48,37,128,122,6,5511,5309,202,32,31,1,100
3a02a62825d52248764b6103a248223fd2fa848f,6,98,44,54,0,0,0,2,66,392,2,5,1.629339156,2674,49,38,286,279,7,20097,19777,320,93,93,0,100
f19a68cb69e72a9df3dbd3cefeb3a51535c71360,4,56,57,1,0,0,0,2,40,552,1,2,1.231566328,1170,50,39,193,196,3,9245,9467,222,87,83,4,100
f88f82ae99b9b1004a742aed61b6dc9e5eeaf6a9,8,430,885,455,1,0,1,9,34,336,2,5,1.94124341,3592,51,40,280,299,19,28103,30793,2690,115,133,18,99.6744186
7ff19b555a43a32ca372a670acaa58a196d069f6,6,2125,2106,19,3,0,3,3,35,160,1,2,1.804549681,2987,52,41,216,220,4,24065,23939,126,86,84,2,99.7211248
fea27d419cb2725eb56769b97ff630a020cda07c,10,193,185,8,0,0,0,4,53,719,1,5,2.583058758,2575,53,42,244,239,5,18606,18581,25,115,114,1,100
0613eb62be0ecb7767f2e473662b74405a7c0764,2,27,25,2,0,0,0,1,2,0,1,1,0.866725613,1212,54,43,101,103,2,9546,9639,93,41,41,0,100
8aaa73de7585eb1e28080eb48ae7c06906cedcff,3,42,8,34,0,0,0,6,18,745,2,2,1.496907322,992,55,44,114,110,4,8044,7789,255,63,61,2,100
8fa5fa54fd022c2cd6db9d53a42598ee10966906,454,5272,11623,6351,20,0,20,4,49,60,7,89,6.29743596,121746,52,0,21396,13340,8056,876430,772347,104083,9102,6497,2605,70.89516515
2a4d9c50fb4b347c1dc61669d58b4b53c0d96170,455,11471,5575,5896,43,0,43,4,85,311,7,80,6.3051138,117808,64,1,22102,4584,17518,904411,344033,560378,9478,2220,7258,70.89516515
4ccc453200c53e984a5eeecff8d3f7a7cb6de928,454,5268,11614,6346,20,0,20,4,49,61,7,89,6.294659632,121745,53,1,21397,13340,8057,876438,772341,104097,9102,6497,2605,70.89516515
fd16d74abcd602b758ef06fea44248ffa4665924,455,11471,5575,5896,43,0,43,4,85,313,7,80,6.3051138,117810,65,2,22103,4584,17519,904419,344033,560386,9478,2220,7258,70.89516515
268ee50ef05f3863184f139f0b6ccb867823b604,11,597,120,477,5,0,5,2,25,249,3,7,2.964520478,1963,56,36,329,300,29,15304,14151,1153,146,129,17,99.23611111
a913b9d0ed66f2ebbc81712e88605a3b7fb4fa8c,459,5850,12421,6571,20,0,20,4,49,62,7,90,6.337837398,121980,8,0,21399,13366,8033,877950,773475,104475,9108,6514,2594,70.8353222
2811311ea6dfe2e26af67a545333486ca0e89092,465,12561,7262,5299,51,0,51,4,86,308,7,81,6.411404004,118074,66,2,22015,4601,17414,900749,344826,555923,9447,2224,7223,70.52631579
7b3878cf321b31dcaf4e96cb9f6a3dbe72c980ae,4,630,4,626,2,0,2,1,29,181,1,2,0.681727182,361,57,1,152,53,99,6998,2735,4263,38,14,24,99.86101459
1992e5bdebefe019820c2a2219efe32e63fd44ec,463,6306,12717,6411,22,0,22,4,49,63,7,90,6.383988686,121982,9,1,21423,13346,8077,879658,773213,106445,9116,6487,2629,70.65710872
085b1c2d181a2a83251d0886e799393bd47f8970,464,12595,6645,5950,51,0,51,4,87,307,7,81,6.392221454,118211,58,2,22123,4608,17515,906014,345741,560273,9476,2228,7248,70.65710872
ddb4fcaf40cb081b98bd2ec9c27a224d4073184a,0,0,0,0,0,0,0,0,0,0,0,0,0,0,59,3,0,0,0,0,0,0,0,0,0,100
15613a1cc26fc9ea1962026d40b05a4a9d4ab82a,2,0,652,652,0,0,0,5,10,275,1,2,0.971129748,514,60,4,0,46,46,0,4425,4425,0,22,22,99.86088569
9739dd80a1635dc07f71f05857b5d3278872d1ca,3,78,45,33,0,0,0,5,6,33,1,1,1.580377952,120,61,5,13,13,0,1053,881,172,9,9,0,99.81403998
0773053d6ff3549c450fcbee8871cc7cb145cca9,465,7161,12840,5679,24,0,24,4,49,68,7,90,6.414224781,122013,10,2,21455,13370,8085,886269,777173,109096,9139,6503,2636,70.72352659
f0f77668b3e8468d00f61de10897db80ce382929,466,12691,7498,5193,51,0,51,4,87,307,7,81,6.425626283,118785,62,6,22108,4645,17463,907902,352692,555210,9472,2254,7218,70.72352659
ed27522584773075a484a4828fe9b7aeb0922961,2,37,40,3,0,0,0,6,19,68,2,2,0.394814846,682,63,7,127,127,0,4778,4798,20,33,33,0,100
64b175ddb72950019183c2705fdff3c22de47aac,3,210,76,134,0,0,0,2,9,653,2,3,1.052692905,1396,64,8,207,205,2,12195,11735,460,87,82,5,100
57ded0a9e8eba50192b09813bfebcbb3ea1d0508,1,21,22,1,0,0,0,3,5,3,1,1,0,268,65,8,40,40,0,1839,1828,11,17,17,0,100
a21a41971c229a8f0c2379716bf928cd17fc429f,5,81,5,76,0,0,0,12,88,102,1,3,1.181413984,4592,66,9,629,622,7,36009,35513,496,242,241,1,98.34024896
c94cfa6ed4de85ae8e88cca649e583db5cfb0cc7,4,144,16,128,1,0,1,12,89,218,1,3,1.755860979,4527,67,10,628,610,18,35984,35294,690,241,234,7,99.90865494
7748003430b94cc1b403690f9bb4d1e68d40ac86,0,0,0,0,0,0,0,0,0,0,0,0,0,0,68,11,0,0,0,0,0,0,0,0,0,100
7d28a41a000b4f2b5006047f4c04bc86dbcc6d3d,6,524,265,259,0,0,0,12,90,260,1,6,1.61778396,5503,69,11,713,711,2,44128,42581,1547,293,287,6,100
ff79cf27103d79d019cd360ed45336f7fc8fd182,1,8,8,0,0,0,0,12,57,116,1,1,0,1002,70,12,171,171,0,8292,8234,58,31,31,0,100
ff369db20e3f1928c8d6b98f6b8ec4842390e7f8,2,137,0,137,2,0,2,1,1,0,1,1,0.920709731,0,71,13,17,0,17,398,0,398,6,0,6,99.20580894
6835fa95bf47372f16adb9363577244201587398,3,4,8,4,0,0,0,2,7,27,1,2,1.5,188,72,6,36,36,0,985,1039,54,18,18,0,100
d3aeb958a51c029c5c309768352c5bed3c18fdeb,1,14,4,10,0,0,0,6,20,45,1,1,0,414,73,7,89,87,2,2983,2950,33,16,16,0,100
a5e772b516579ad65ce9b759389ed695dc88bffe,10,1019,169,850,1,0,1,2,91,42,3,6,2.165261689,7102,67,0,953,889,64,59081,55246,3835,371,339,32,99.06733394
618260530e190d01dd3c1412b81703e514725e4f,1,4,6,2,0,0,0,3,6,241,1,1,0,153,74,8,18,18,0,875,889,14,5,5,0,100
a13f2fb83c3bdabae22e99973fa4cfc21852498c,6,99,52,47,2,0,2,1,54,424,1,2,1.958084785,1043,75,7,150,144,6,7590,7535,55,44,42,2,99.81676592
bfb0456fc3575a97e81886b4a9e2c5cb2f86b7e4,11,657,423,234,0,0,0,2,92,146,3,6,2.262456092,4605,76,8,757,727,30,35707,34956,751,290,269,21,100
2199b74fb8af4715941c87893518c8288365f4ae,1,2,1,1,0,0,0,5,7,920,1,1,0,99,68,1,17,17,0,839,831,8,7,7,0,100
a81591e6ea33047daab600b726ebbdee152fb022,463,6290,13799,7509,21,0,21,4,49,68,7,90,6.391226016,122624,54,0,21417,13466,7951,882397,778998,103399,9121,6556,2565,70.78384798
3c2a8a2e5c6badb96359d3cdb28c07e31682f1f9,615,104490,97160,7330,200,0,200,4,92,190,7,106,7.22113017,125929,77,8,24140,23087,1053,970773,952396,18377,10336,10004,332,70.76703871
ec1e01d450422af380c17a8786289deb933a0441,1,1,1,0,0,0,0,12,55,18,1,1,0,2252,78,9,133,133,0,19329,19325,4,71,71,0,100
14b3b904a83b3b4bb5c245bff9e839a7e40836f7,35,1129,858,271,4,0,4,3,59,393,3,14,2.924493424,5451,79,10,750,807,57,42931,44567,1636,322,347,25,99.20146019
3722abec4ea077566c46b8221f3b050d2e0dbf86,1,11,3,8,0,0,0,12,56,2,1,1,0,2252,80,8,134,133,1,19344,19329,15,71,71,0,100
05bc5a6e415005008ed5ed4a003e8607e2d6a5ec,1,60,45,15,0,0,0,6,23,12,1,1,0,469,81,9,95,92,3,3528,3449,79,16,16,0,99.95446266
c625dfe946b5a79c02eea660b4a190159a778080,628,98064,105688,7624,176,0,176,4,64,69,7,109,7.270734304,130322,11,0,23308,32398,9090,940119,1403464,463345,9918,14567,4649,70.59241706
5a8e38a86a29e371cccc8806c6fedc8c3afc2867,628,105688,98064,7624,213,0,213,4,92,191,7,107,7.270734304,125929,82,10,24148,23158,990,970847,957776,13071,10348,10057,291,70.59241706
d128f8396a04e84454eb8661e7659a7b1c58a1f5,629,98071,105692,7621,176,0,176,4,64,70,7,110,7.271169312,130418,5,0,23326,32416,9090,940913,1404225,463312,9922,14571,4649,70.59241706
80070f2775652b2d3dd9a7e060519a96ef093b01,629,105702,98071,7631,213,0,213,4,92,192,7,108,7.271260527,126028,83,11,24168,23176,992,971679,958570,13109,10352,10061,291,70.59241706
48fea20427ce8daad6aa3fa2658d06c624bdb7d6,1,6,7,1,0,0,0,6,24,11,1,1,0,483,19,0,94,95,1,3523,3528,5,16,16,0,100
ab94c439a018509966de70d3fdb8c27463bee647,5,38,9,29,0,0,0,1,3,20,1,1,2.179960659,417,84,10,60,56,4,2538,2437,101,32,30,2,100
18998c04ed84895d5fc5f3b292ef3e2595005a63,8,208,70,138,0,0,0,2,53,301,2,3,1.864967984,2707,85,11,330,318,12,20598,20047,551,92,86,6,100
3834e3b15471259081b547b95be5f4f07393dd1f,632,98256,106046,7790,177,0,177,4,64,71,7,111,7.281710248,130845,12,1,23359,32496,9137,943073,1408058,464985,9935,14597,4662,70.59241706
39d7b61665ead6ca7bd9d3a778c2ab6a3441b714,631,106033,98236,7797,214,0,214,4,92,192,7,108,7.280618673,126237,86,9,24198,23222,976,973690,960912,12778,10365,10071,294,70.59241706
4ccc15fe7ad91c546b8bee70c2a0ebc4f86114e8,2,12,9,3,0,0,0,8,11,628,2,2,0.998363673,180,87,10,27,27,0,1302,1269,33,9,9,0,100
d926483b7b985a66e6580c50c01a1e7e18ba514a,1,4,2,2,0,0,0,11,28,888,1,1,0,291,88,11,40,40,0,2087,2069,18,20,20,0,100
6d7677d94f8681d9ffa63ca02ba91334f577b003,1,39,6,33,0,0,0,6,26,14,1,1,0,488,89,12,99,96,3,3620,3565,55,19,17,2,100
0acd85384d0a6d066336122001c71970f8e3138d,0,0,0,0,0,0,0,0,0,0,0,0,0,0,90,10,0,0,0,0,0,0,0,0,0,100
7da5d5e571376c3b8ae399b92d7db6e97dc66b41,2,12,0,12,0,0,0,13,44,10,1,1,0.918295834,1024,91,11,177,175,2,6882,6850,32,45,45,0,100
829bf171706cca45dce153849aec7001ae17661f,1,2,2,0,0,0,0,1,4,22,1,1,0,78,92,12,0,0,0,351,351,0,0,0,0,100
101bc048ca11af6f142ef0ecbf5a6e1e17028457,1,19,9,10,0,0,0,1,3,27,1,1,0,105,93,12,22,21,1,525,486,39,13,13,0,100
d2eb8a440d1bb6edab120e980aee40e91cc6423f,0,0,0,0,0,0,0,0,0,0,0,0,0,0,20,1,0,0,0,0,0,0,0,0,0,100
306ccb390b7579f015caadc0e604648e59b3a32b,631,98245,106090,7845,177,0,177,4,67,71,7,110,7.281292554,130973,13,2,23397,32540,9143,943729,1413180,469451,9927,14591,4664,70.59241706
60e6244f21245c98afa85008f2df458db93baf7b,630,106087,98230,7857,214,0,214,4,92,194,7,107,7.280579829,126142,94,12,24186,23204,982,973120,960165,12955,10363,10067,296,70.59241706
ed47850a797f14c20c47dccf99cb02ef5aaad635,10,86,56,30,1,0,1,2,16,792,2,2,2.765517345,1364,95,13,359,359,0,8554,8409,145,160,160,0,97.91241207
17a8c4985738b53e88e2816ce5da01584a14bf05,1,4,0,4,0,0,0,6,28,11,1,1,0,505,96,13,102,101,1,3664,3645,19,19,19,0,100
d5848ef3edc5b5c5ab277fb8e851c90ca15eff50,2,29,1,28,0,0,0,3,45,21,1,1,0.918295834,660,97,14,116,112,4,4502,4369,133,33,32,1,100
3c32f29c868983fae517c51a636aa99b14ee9b15,2,42,19,23,0,0,0,16,93,71,1,1,0.120681014,2565,98,14,495,495,0,18841,18683,158,176,176,0,100
04db24b219f2547c096f2980a500134064007b0e,5,326,135,191,0,0,0,2,29,59,2,3,1.370353846,3549,99,15,324,316,8,28841,28086,755,111,105,6,100
d8df7827918761e941fc8dc9c2079edecc0633b0,2,39,9,30,0,0,0,16,94,49,1,2,0.543564443,2876,100,16,544,544,0,21181,20961,220,196,196,0,100
afa4a6ebcd8c6c2b98771499af0a36579acd6cb4,637,99634,107797,8163,183,0,183,4,64,74,7,109,7.335062239,130884,6,0,23323,32758,9435,941530,1418143,476613,9923,14712,4789,70.22432113
7c43d760a67e28aa4583ec716173fc6214558541,0,0,0,0,0,0,0,0,0,0,0,0,0,0,7,1,0,0,0,0,0,0,0,0,0,100
68ed22c15c7716f96555f2c832ac16d3eb9465b7,638,107840,99634,8206,222,0,222,4,94,199,7,108,7.336541961,126142,21,1,24201,23482,719,974676,965843,8833,10371,10185,186,70.17461067
5a2322338749cf5cf3f1a2b7e87645926ce469f1,3,9,9,0,0,0,0,3,30,127,1,2,0.986426729,857,101,16,138,138,0,6342,6342,0,39,39,0,100
81eed11a91139cd9f4e0582e8f2daa3d839df61b,8,450,209,241,1,0,1,12,95,27,1,4,1.584372926,5723,102,17,814,792,22,45301,44274,1027,303,296,7,99.90972692
71de208d8eed1f3a949530877c3778985245f2d3,5,72,16,56,0,0,0,10,55,44,2,3,2.029506999,2150,103,18,374,369,5,15786,15470,316,85,82,3,100
172b1485631e696599534eeef61b228ea4c4d3c4,1,1,0,1,0,0,0,16,96,1,1,1,0,2569,104,19,491,491,0,18842,18829,13,175,175,0,100
f30b80b286bfec05a76fad189899d849b451c6de,4,214,3,211,3,0,3,1,4,2,3,4,1.7540428,190,22,2,43,32,11,2017,1331,686,21,12,9,99.86486486
d360d08e360a817f165e1c8b49f27d878a4f996b,643,99685,108403,8718,184,0,184,4,64,76,7,109,7.348350421,131237,14,1,23323,32801,9478,941504,1420443,478939,9923,14735,4812,70.02590064
75a8faf15e8b6c340774145bde0e5f080f68b7fd,642,108352,99637,8715,226,0,226,4,96,199,7,108,7.345432233,126139,105,13,24239,23482,757,976692,965843,10849,10390,10185,205,70.02590064
f1bae505e18ef73dd20c401195dc4b9de70a671f,642,99636,108352,8716,183,0,183,4,64,76,7,109,7.345436887,131234,15,2,23323,32798,9475,941497,1420311,478814,9923,14732,4809,70.02590064
9c11c32c6a571d710c9317f61679d0de99ff7d04,642,108351,99636,8715,226,0,226,4,97,199,7,108,7.345444414,126138,106,14,24239,23482,757,976685,965836,10849,10390,10185,205,70.02590064
cc923c8db0d7d909148e47f7290d2e5217d88f90,3,62,16,46,0,0,0,12,98,14,1,3,1.53066058,5441,107,13,740,738,2,42858,42615,243,268,265,3,100
afdcfa4358f9380902d2153c7d19c9f4df0de117,642,99641,108397,8756,183,0,183,4,64,76,7,109,7.344958119,131255,16,2,23323,32800,9477,941519,1420547,479028,9923,14735,4812,70.02590064
5d09e7e25aa93e5b01f3e610e1cebbc3dc1dc233,642,108402,99641,8761,226,0,226,4,99,199,7,108,7.344920167,126143,108,3,24241,23482,759,976950,965858,11092,10393,10185,208,70.02590064
2c56790067cebf635bc207c2fb2635f8c4fd4831,642,99616,108402,8786,183,0,183,4,64,77,7,109,7.344731072,131260,17,3,23318,32800,9482,941407,1420569,479162,9921,14735,4814,70.02590064
445eeae674928db87d1e08faf896e1c6524ce259,642,108377,99616,8761,226,0,226,4,99,199,7,108,7.34454268,126121,109,4,24236,23477,759,976838,965746,11092,10391,10183,208,70.02590064
dc7f2cf5373ca560df9ee3d532dc71dfc21659b8,643,99797,108509,8712,184,0,184,5,64,80,7,109,7.350388554,131238,18,4,23323,32802,9479,941597,1420994,479397,9923,14735,4812,70.02590064
4a1365de92281f87792a75a4829a5a3292446dda,643,108524,99797,8727,227,0,227,4,100,199,7,108,7.350420567,126149,110,5,24236,23489,747,976900,966473,10427,10391,10187,204,70.02590064
42b092a56f51c301191f0296fb5045bc16dd6b3d,2,49,48,1,0,0,0,6,34,46,2,2,0.66959206,865,111,6,157,156,1,5990,5996,6,42,42,0,100
732561bddbaf1002e23cfec42212375beb000616,1,0,2,2,0,0,0,3,6,59,1,1,0,395,23,0,8,8,0,3224,3228,4,5,5,0,100
768f460303df44db38bf7a2218648b39e07b498c,4,10,10,0,0,0,0,12,60,42,1,3,1.952724196,2519,24,1,175,175,0,21155,21090,65,91,91,0,100
2f70aac336da7bc5f57d07967f56250e0c3f3804,1,1,0,1,0,0,0,16,101,6,1,1,0,2591,25,2,493,493,0,18986,18979,7,177,177,0,100
5dc6b2855e6d3d7f0c2b7b7acaa0a6c179644632,52,1581,1630,49,4,0,4,5,61,395,5,26,4.872302123,10803,112,4,1444,1432,12,82513,83097,584,577,568,9,99.14279269
e44fa87e95872107af176dafd9a722cb122a4657,1,1,1,0,0,0,0,2,8,81,1,1,0,585,113,5,25,25,0,4725,4725,0,16,16,0,100
acf5debe3c6dffd2c519f2394b1c27d1b1429379,6,364,35,329,3,0,3,1,102,72,2,5,2.298860814,2618,26,3,514,495,19,20434,19050,1384,186,178,8,97.94459339
9e6d970ce1ce5d5c16b24252f609e86d04543876,4,250,15,235,0,0,0,3,103,44,1,3,0.659596121,3484,114,6,643,641,2,27429,25553,1876,218,216,2,99.80136835
46c806912bfe37c4901555f5ae09c7c3defb63d3,4,25,34,9,0,0,0,7,8,181,2,2,1.599786269,297,115,7,36,37,1,1701,1718,17,15,15,0,100
2d6179cdbbed8dd441e87fe148d40878fcc6bbcf,0,0,0,0,0,0,0,0,0,0,0,0,0,0,116,8,0,0,0,0,0,0,0,0,0,100
a2cff586da31cedf497ad4f6b6ebd901ac0b0eb3,656,100894,110129,9235,190,0,190,5,64,76,7,116,7.404770038,133766,19,2,23723,33199,9476,957552,1438154,480602,10060,14848,4788,70.66915365
a29596e5fdc2d23bb84ad6a2223724934f0e7069,656,110118,100885,9233,232,0,232,5,103,206,7,115,7.404095833,128274,117,9,24669,23958,711,995606,986049,9557,10547,10332,215,70.66915365
688c116682fb5bb5d31c03e5b067829b9b2a5408,6,1601,12,1589,2,0,2,4,6,93,1,2,1.517065291,3758,118,8,1194,885,309,37578,28189,9389,588,445,143,99.77954145
a785d29c9045842e8f9a502d7b102f5ece2ccf99,14,150,130,20,0,0,0,16,104,149,3,6,3.0615514,3377,119,7,632,636,4,24135,24131,4,252,253,1,99.40528634
28f9610a8973e79dbf1faa0b0c06f1b930cc4ddf,660,100961,111875,10914,190,0,190,5,64,77,7,117,7.428183287,135207,8,0,23736,33522,9786,958213,1448563,490350,10068,15001,4933,70.47729919
c3e92f2f7e7361ee9f686b055949f85e63cbd96a,658,111797,100955,10842,234,0,234,5,104,201,7,115,7.425836868,128274,1,0,24974,23953,1021,1004999,985709,19290,10689,10329,360,70.51013277
efb2a059a7647d87dfec8242ff527146a6e8ef35,3,79,7,72,1,0,1,17,105,4,1,2,1.096021393,2690,0,0,530,522,8,19809,19589,220,196,192,4,99.95590829
8d53da5fbd70236728c69e3f2faada1cdc73cbb5,660,101044,111916,10872,190,0,190,5,64,72,7,116,7.430246326,135389,20,1,23766,33535,9769,961557,1451570,490013,10077,15006,4929,70.47729919
3105a1bfbf2134daa6394a09f9b380a2a521a79d,659,111869,100953,10916,235,0,235,5,105,199,7,115,7.427563566,128308,120,8,25002,23973,1029,1005429,985919,19510,10698,10334,364,70.47729919
627469f314444fe52dfce20c07b49acfa1830edf,2,250,52,198,0,0,0,12,106,32,1,2,0.997435911,4935,121,7,648,637,11,40592,39200,1392,255,251,4,99.97796386
79983e00bcda78a36cb855ccaa5d863250308abd,4,243,49,194,1,0,1,1,12,252,1,4,1.36335247,349,122,8,64,47,17,3016,2216,800,29,25,4,99.8898193
4d7c4cedeef370a60dcfee1cc8a2907bc738e08e,2,82,60,22,0,0,0,16,56,119,1,2,0.106792032,363,123,7,14,18,4,2568,2494,74,6,5,1,100
f5b4a15763b5a181cb5fa89007b144a5a7ba4cfd,3,110,11,99,0,0,0,16,57,125,1,2,0.368788013,531,124,6,69,60,9,4680,4074,606,22,18,4,99.97796386
a2892aa736666514b6ffdd14824ade7f097d9cf6,1,25,7,18,0,0,0,17,107,6,1,1,0,2639,125,7,504,504,0,19393,19386,7,179,179,0,100
1e1499d8e5d553a5524394334d0eafa3795be7d0,659,100953,112400,11447,190,0,190,5,64,72,7,116,7.430264665,135488,9,1,23743,33485,9742,957762,1446670,488908,10065,14972,4907,70.47729919
6164b27502d6e2a243ad2e35444bbfa665e3a063,659,112400,100953,11447,235,0,235,5,107,199,7,115,7.430264665,128308,2,1,25035,23963,1072,1008308,985239,23069,10711,10328,383,70.47729919
1b3535ea45fee98691c00ede39fb2df4a6375c39,1,3,1,2,0,0,0,2,2,1457,1,1,0,40,126,6,6,6,0,305,288,17,1,1,0,100
b5fadbb1ef754aa3ce844f4c6df23deae5642695,659,100953,112400,11447,190,0,190,5,64,73,7,116,7.430264665,135489,21,0,23743,33485,9742,957779,1446670,488891,10065,14972,4907,70.47729919
d9d5b4e49e18f8f6a6b20833196f990bd2acbf37,6,409,52,357,0,0,0,5,8,1028,1,3,1.767831447,906,22,1,230,167,63,10189,8191,1998,86,72,14,100
c8d0f24a23186eac015292214d025ac7d9e9e415,663,112594,101504,11090,236,0,236,5,107,203,7,115,7.446096308,128810,1,0,25076,24084,992,1010857,990359,20498,10727,10365,362,70.47729919
b9eca2144cb78062294f995a36f5f56d4c516ca5,24,740,110,630,4,0,4,12,108,184,2,6,3.743811442,6704,127,6,950,908,42,55457,51486,3971,401,368,33,98.42432312
5c1d559930c3baaa943e2a220e8c89b1f7b51118,17,9,441,432,0,0,0,3,58,963,3,12,3.047734896,3067,128,7,376,414,38,20058,22089,2031,135,147,12,99.84336541
747c226013f31d02e623b82902f2bc62a87fc4e9,8,413,210,203,3,0,3,1,48,143,1,2,2.526143341,1759,129,6,302,267,35,12769,12146,623,105,85,20,99.64213822
03705977464e8ff596aa6652b798cada4c0a5a72,2,104,27,77,0,0,0,7,109,20,1,2,0.361062084,2899,130,7,538,535,3,21473,21207,266,197,194,3,100
2fcd69aa2ed6b0f80c5c0e91a6a84ce24459a336,2,39,2,37,0,0,0,6,37,2,1,1,0.978869851,832,131,7,153,153,0,5932,5664,268,42,42,0,100
d4b64faa307aa17776ac6b5011f0a580b12b8074,4,123,2,121,0,0,0,13,110,1,1,3,1.182213569,5910,2,1,741,733,8,46447,45941,506,290,285,5,100
0c7256686ff2d93da37821278547b00c14feb787,5,86,53,33,0,0,0,14,50,9,2,3,2.108065982,1488,132,8,229,228,1,9898,9671,227,90,90,0,100
e4936efdc4cb1f7bcffd4c0b23835088e81f1af3,3,1,12,11,0,0,0,2,60,32,2,2,0.991264261,1507,133,9,161,163,2,10696,10755,59,55,55,0,100
bc91c38dee1b44ea0dbb43628eb5e6fd322570f3,676,101918,113666,11748,192,0,192,5,64,78,7,118,7.473731534,137112,10,1,23999,32783,8784,968193,1388907,420714,10165,14871,4706,70.41031653
72c21872a8c025a9963fd4a3c5439ff277b3d7a7,675,113667,101919,11748,242,0,242,5,110,215,7,117,7.473689063,129647,3,1,25237,24217,1020,1019859,995630,24229,10832,10429,403,70.41031653
2664dbb934a8efcd56a2ebdd16528532c6da967a,675,101925,113669,11744,192,0,192,5,64,78,7,118,7.474078802,137010,11,2,23980,32764,8784,967620,1388294,420674,10159,14865,4706,70.41031653
50a127bf39cccf8a0e5232b0182aa6c35e179980,675,113667,101919,11748,242,0,242,5,110,215,7,117,7.473689063,129651,4,2,25237,24217,1020,1019899,995670,24229,10832,10429,403,70.41031653
e5bb466efc621318c69f4a929dea3e39a77962af,19,2150,824,1326,3,0,3,6,111,76,3,9,2.83048001,8893,3,2,1250,1185,65,75634,68627,7007,469,420,49,98.8452143
c56f48cc62e5b346d6c8432ccfa07d7f9fa4f110,19,858,2184,1326,0,0,0,6,112,0,3,9,2.811840289,9793,4,3,1185,1250,65,68627,75634,7007,420,469,49,98.8452143
8b897d8ee3554e7e799f6d7e68b44088efb801f9,19,2150,824,1326,3,0,3,6,113,0,3,9,2.83048001,8893,5,4,1250,1185,65,75634,68627,7007,469,420,49,98.8452143
3a7b54fab53d86b713ae9f1f4169fcdde3b254f8,19,858,2184,1326,0,0,0,6,114,0,3,9,2.811840289,9793,6,5,1185,1250,65,68627,75634,7007,420,469,49,98.8452143
024d99de2663b6bdb741498f03862cd9337d9ad3,21,2532,1206,1326,5,0,5,6,115,0,3,9,3.188626696,8893,7,6,1259,1192,67,79046,71544,7502,478,427,51,98.66755496
3112d2b619888c900a5e1e1f43e6d1e4d07cbea0,0,0,0,0,0,0,0,0,0,0,0,0,0,0,5,2,0,0,0,0,0,0,0,0,0,100
a656d39f0df03d22145db04ae593bf7474da3fd8,0,0,0,0,0,0,0,0,0,0,0,0,0,0,6,3,0,0,0,0,0,0,0,0,0,100
f2ac38363c5dfef70732a50f8378079465fad0ad,2,22,32,10,0,0,0,4,8,283,2,2,0.605186577,1936,8,7,206,212,6,15111,15164,53,65,64,1,100
07d3ec17013e17c45690410f4c2169452a48fc06,21,1206,2532,1326,2,0,2,6,116,0,3,9,3.188626696,9793,9,8,1192,1259,67,71544,79046,7502,427,478,51,98.66755496
4cdb506c15ab393cc15c0516032010cc5c340b50,17,2126,801,1325,3,0,3,6,117,0,3,9,2.760918127,8649,10,9,1243,1178,65,73852,66858,6994,465,416,49,98.8452143
0659a2a8b3c9ea9dfdea5d8c387d600c473a78d9,680,101955,115018,13063,192,0,192,5,64,79,7,120,7.49262469,138639,12,2,24149,32992,8843,972986,1400639,427653,10192,14948,4756,70.3030303
073b9e9f8c1d6a8423c4d29410cc1e0ffa31c8e5,679,115013,101950,13063,245,0,245,5,117,213,7,118,7.492173005,130137,7,4,25400,24321,1079,1030402,999232,31170,10904,10451,453,70.3030303
5b7cccccf245252e1f972f360e3fba294b102a01,1,0,2,2,0,0,0,3,13,2,1,1,0,497,11,10,88,89,1,3559,3565,6,24,24,0,100
adbf1ae832d853bb4392ea5af48d734907eb725d,680,101992,115013,13021,192,0,192,5,64,80,7,120,7.493230366,138450,13,3,24097,32934,8837,971664,1399087,427423,10187,14943,4756,70.3030303
bcb7ffeb00b24f0e5fbfefb7d167f17278dc39a9,679,115024,101967,13057,245,0,245,5,117,214,7,118,7.492459555,130154,8,5,25401,24323,1078,1030451,999315,31136,10904,10451,453,70.3030303
eed5383a47209c5010843d63165a26bfb99244fb,1,4,0,4,0,0,0,2,3,0,1,1,0,223,9,6,29,29,0,1304,1276,28,11,11,0,100
ca315fe971d32a9ca87183746c9dd1744a76e8d4,3,278,24,254,0,0,0,4,45,6,1,2,1.412949405,709,134,8,81,63,18,6796,5429,1367,35,27,8,100
ad7837f92dc0b8dbb98753409a64637b640629fa,9,412,73,339,0,0,0,3,12,415,1,5,2.029489976,1225,135,9,281,220,61,12533,10596,1937,102,90,12,100
b6239b2bad38399d356f3dccb703e4d80250bdb2,678,101808,115398,13590,194,0,194,5,64,76,7,119,7.492871564,138083,0,0,23932,32867,8935,965149,1397130,431981,10127,14905,4778,70.27027027
b7a952cac04fb87cf58c91ed8fe421beb3daa43d,0,0,0,0,0,0,0,0,0,0,0,0,0,0,1,1,0,0,0,0,0,0,0,0,0,100
66686420bb6fbca4c8922c4b502266da1e6551c1,679,115781,101810,13971,247,0,247,5,117,211,7,118,7.498029669,129455,136,9,25344,24187,1157,1029428,994491,34937,10884,10403,481,69.7019479
de7698b48077e7b6e07f41f7ee793982e1411771,1,44,29,15,0,0,0,3,15,3,1,1,0,499,137,6,89,89,0,3666,3570,96,25,25,0,100
04e30c62186e580f517495257674e57fdfebd675,0,0,0,0,0,0,0,0,0,0,0,0,0,0,10,7,0,0,0,0,0,0,0,0,0,100
b7e4906a013154f9d37d411a53ddeff7013f22e6,679,101808,115794,13986,194,0,194,5,64,76,7,119,7.498024489,138338,0,0,23932,32889,8957,965149,1399251,434102,10127,14923,4796,69.7019479
74e3913d72dbffc34b7886c9ea76427dc11bf98d,679,115818,101810,14008,247,0,247,5,118,211,7,118,7.497901205,129455,138,4,25344,24187,1157,1029679,994491,35188,10884,10403,481,69.7019479
c2f6fa609cb73416722d96447d955f2e399e93f7,1,40,20,20,0,0,0,1,2,142,1,1,0,211,139,5,36,32,4,1338,1279,59,10,10,0,100
a6b0b42dbb0a1111d10cbed0d86d3aad510d5583,0,0,0,0,0,0,0,0,0,0,0,0,0,0,163,6,0,0,0,0,0,0,0,0,0,100
3965d17a3d4d228c4c066253cad1abf435cb68b0,0,0,0,0,0,0,0,0,0,0,0,0,0,0,24,7,0,0,0,0,0,0,0,0,0,100
b19cb01b4df53a4aa2d1bc269ce3e24a8b265ba9,28,124,129,5,0,0,0,3,68,618,2,10,4.119590362,7501,13,5,1418,1016,402,55716,37478,18238,534,278,256,97.69090078
a68386e3a2af834b7679129c76a168c5402727af,20,1069,374,695,10,0,10,4,4,260,1,2,3.96055714,394,14,2,156,78,78,5548,2774,2774,128,64,64,99.25529439
67d64d0d57ebf108b2be62b674dfac89aaf8d0c9,9,108,89,19,0,0,0,4,14,14,3,6,2.166766021,3489,15,3,425,423,2,27834,27914,80,176,175,1,100
1a97f5ab0c222cdb5bc33461e4f934b530462871,13,350,64,286,0,0,0,1,119,252,1,6,2.985511656,9113,16,4,1137,1119,18,74240,72539,1701,436,431,5,99.55648926
92a183f663c16fc8daf806dcb4a0b264dc811376,24,129,204,75,0,0,0,2,120,374,6,20,3.456534574,12504,25,2,1481,1486,5,99092,99795,703,564,568,4,97.27052608
9681099b330eadc498aff4d368129179c793f923,0,0,0,0,0,0,0,0,0,0,0,0,0,0,26,2,0,0,0,0,0,0,0,0,0,100
4a1b78e712bd79f6095e2e7e9507e8d956b16fad,5,1125,26,1099,2,0,2,1,48,38,1,2,1.381001103,776,35,0,265,126,139,11547,4877,6670,77,48,29,99.91728701
5842648ccd01e143571b6950ca50f0abbffada84,4,73,42,31,0,0,0,6,121,12,1,4,1.457135334,6112,36,1,722,722,0,48776,48616,160,296,296,0,100
b2107fc164fedcfe8f7cb39088111a20b9fbb8c6,8,79,59,20,0,0,0,9,11,1413,4,8,2.09278266,1261,37,2,207,205,2,10261,10093,168,75,75,0,100
7bac9f4f979e7d5e06f55dc6a7c0714ee3655ee7,1,56,0,56,0,0,0,14,75,6,1,1,0,2539,38,3,150,148,2,22472,22067,405,80,78,2,100
2fa149d19eff8f56414e916955b76a3c73135686,1,8,7,1,0,0,0,3,4,11,1,1,0,199,39,4,35,35,0,1351,1343,8,10,10,0,100
5eae90ea99d7c43da2974c11549967bfa89f117a,4,15,12,3,0,0,0,6,122,10,1,4,1.458715528,6166,95,0,724,724,0,49236,49181,55,298,298,0,100
ebb94b1897e74fd4ce98b848845b441da6f99672,5,10,10,0,0,0,0,3,68,112,4,5,2.170950594,2535,40,5,191,191,0,19613,19613,0,72,72,0,100
a41a1447b206abe2129a1656faf7d28e2b9d4176,3,226,3,223,2,0,2,1,10,320,1,2,1.159784318,144,164,0,33,18,15,2267,1292,975,16,6,10,99.89682212
201808de059b9cda38a34c3aefb4253b402b891d,4,155,68,87,0,0,0,3,11,203,1,3,1.654201634,1748,165,1,425,414,11,14324,13905,419,149,145,4,100
c659a3e684df6ef8020be0da77d70429245aa368,0,0,0,0,0,0,0,0,0,0,0,0,0,0,166,2,0,0,0,0,0,0,0,0,0,100
8ee4f4b851b3bd62ba11552cfef4e4316b8cf093,1,71,46,25,0,0,0,7,14,129,1,1,0,258,167,3,33,30,3,1890,1801,89,14,14,0,100
24c1db670a0af4d97b9552fdca91b8ed5da953c9,1,0,47,47,0,0,0,2,2,1573,1,1,0,39,27,0,0,4,4,0,155,155,0,3,3,99.95874587
19a70338abd63bac2124d3f09ca382257c28ea29,0,0,0,0,0,0,0,0,0,0,0,0,0,0,28,1,0,0,0,0,0,0,0,0,0,100
ab906afa2bba09fd007172d522ff808d7257ef32,11,184,105,79,1,0,1,2,123,91,2,8,2.981414575,7179,0,0,822,818,4,57869,57605,264,343,339,4,99.91750876
d30febf1a84760f52219a68baebd8b8132082442,0,0,0,0,0,0,0,0,0,0,0,0,0,0,29,2,0,0,0,0,0,0,0,0,0,100
49e4958f3d64af1563ce65ccc85b2896d55a0038,0,0,0,0,0,0,0,0,0,0,0,0,0,0,2,0,0,0,0,0,0,0,0,0,0,100
9c28d202a8eb692ef58c76f2a9e145c6d912d183,2,66,2,64,1,0,1,1,11,8,2,2,0.322756959,150,3,1,22,18,4,1567,1303,264,10,6,4,99.87639061
6cf5efdb984750e14e48d7857cf3b1f41008ebaf,1,3,1,2,0,0,0,3,9,188,1,1,0,162,168,4,14,14,0,967,949,18,6,6,0,100
1e29fa981c1e1a6477f0f2400b6d9b77283d8731,2,14,6,8,0,0,0,4,14,108,1,1,0.881290899,113,169,5,15,14,1,793,757,36,5,5,0,100
8474ec7de7d973895ffaa603b2adb94ae43820d8,5,50,3,47,0,0,0,2,7,199,1,1,2.010544644,409,41,2,55,52,3,2277,2119,158,35,33,2,100
24ea4a412355a4d839ca8357adee301441de6da2,1,4,4,0,0,0,0,4,4,573,1,1,0,223,1,1,50,50,0,1712,1712,0,19,19,0,100
bfb07b4a54ac9a69b1fbea1a44751008e70bd9d5,8,459,217,242,2,0,2,2,124,29,2,4,2.536771007,4171,2,2,657,646,11,31942,31081,861,265,259,6,98.04607158
7d18d1bf79efd6f27319b99de9f7635d98f6846b,13,167,166,1,0,0,0,7,125,51,2,7,2.846812388,7872,170,6,974,974,0,63521,63360,161,397,397,0,100
f0fffa2792c117354c39c5d937e2eabc9b8f2283,0,0,0,0,0,0,0,0,0,0,0,0,0,0,3,3,0,0,0,0,0,0,0,0,0,100
e3eccaaa140977517df035ab90fc6c7754444cfe,0,0,0,0,0,0,0,0,0,0,0,0,0,0,42,2,0,0,0,0,0,0,0,0,0,100
afbd8975070f25b517b7700cb314fc17c0c5de46,26,26,22,4,0,0,0,8,24,1319,5,14,4.668295834,3260,48,0,338,338,0,24730,24626,104,185,185,0,99.91779696
d0b12a4baba02868ba0bb7beeefe91a2f88361c4,1,1,1,0,0,0,0,1,2,1573,1,1,0,346,76,0,15,15,0,2799,2797,2,12,12,0,100
efe2e01b096b439ad1eee195d4e5604828f57ff3,7,84,40,44,0,0,0,3,21,80,2,5,2.178781531,2993,171,7,255,254,1,23713,23458,255,98,97,1,100
fab09a73b62ffb50e6a88966da62aa309190b7fd,1,81,42,39,0,0,0,5,8,172,1,1,0,90,4,4,14,13,1,723,715,8,7,5,2,100
d02c48754e843a13f88b0db4eb89deca8b91b2c5,1,2,2,0,0,0,0,4,17,2,1,1,0,71,172,6,6,6,0,448,448,0,3,3,0,100
2ef77fc017853f67509360a33859a949fd0046aa,7,145,68,77,0,0,0,15,126,50,2,5,2.127690582,5900,173,6,752,748,4,47287,46963,324,315,311,4,98.75502008
1275be7e3ed9cb31959fc5e9424576bb03e2fc02,2,21,15,6,0,0,0,1,52,16,1,1,0.997772472,382,5,5,64,63,1,1914,1901,13,21,21,0,100
c302da78189790d48191856cfaee2db6fcf7e9c7,4,92,10,82,0,0,0,7,127,92,1,3,1.496993398,3790,174,6,610,600,10,28066,27796,270,239,235,4,100
398a8a9378cb43fea7f66153df917b9eb3abd40c,10,30,9,21,0,0,0,3,22,121,1,3,3.169928027,729,43,2,127,124,3,5446,5331,115,75,73,2,100
a7a2d69c798d562bb1dbc94f73761d0a3d6ee214,11,524,57,467,6,0,6,1,60,8,2,5,2.930081631,991,6,6,166,141,25,7947,6424,1523,73,52,21,98.60098522
bab5063c637ad0b258afc21ac217b5eb42bb11e7,1,27,16,11,0,0,0,8,55,1,1,1,0,269,175,7,44,44,0,1424,1398,26,14,15,1,100
25c1c6063dc8ae9c75fa7c800589b2e7bb737b84,4,27,2,25,0,0,0,6,12,62,3,4,1.658188322,1824,7,7,139,137,2,15367,15205,162,73,71,2,100
ea524f1bdf41775a3bbdc205af850d600517904b,0,0,0,0,0,0,0,0,0,0,0,0,0,0,8,8,0,0,0,0,0,0,0,0,0,100
4031003719edb820edcf1e5f18ee03fb6810cef1,11,13,14,1,0,0,0,6,30,586,2,9,3.361937855,1451,0,0,171,171,0,10739,10771,32,98,98,0,100
b75b9d96882570d9b0736e464efa081988c16f8e,0,0,0,0,0,0,0,0,0,0,0,0,0,0,9,9,0,0,0,0,0,0,0,0,0,100
bbf5ce1fd7f4cc57af6bf8291c2455685a0e33f7,1,2,3,1,0,0,0,6,12,56,1,1,0,641,176,8,189,189,0,4052,4052,0,68,68,0,100
b38267765be842ca30b0bfa86f1e47bce6fdd313,5,75,11,64,0,0,0,2,128,69,1,4,1.57675541,4257,177,9,734,727,7,31861,31574,287,242,238,4,100
342025640a61567df3a7628b701efb1c9590ef24,1,1,1,0,0,0,0,6,9,16,1,1,0,98,44,3,14,14,0,724,723,1,7,7,0,100
213a37092b2b32f78208666358d3585d99574dac,1,81,67,14,0,0,0,18,129,5,1,1,0,2845,178,8,522,522,0,20687,20681,6,189,191,2,100
d4172ba9f957610637978da5dfa4032464d4aafc,3,32,16,16,0,0,0,5,22,27,2,2,1.043435696,847,45,4,152,149,3,6073,5958,115,42,42,0,100
b107cae11cf3bbb676ac84f98a4120e51b159b41,1,1,1,0,0,0,0,6,9,1452,1,1,0,37,10,6,0,0,0,199,197,2,0,0,0,100
59684194900b0b8b030c8387342bcb4d54cd147d,0,0,0,0,0,0,0,0,0,0,0,0,0,0,11,6,0,0,0,0,0,0,0,0,0,100
da1863f3479026ee2cccade53ef422c2ccc9ff91,29,446,203,243,2,0,2,5,69,349,3,12,3.486915127,9542,12,6,1249,1222,27,77131,76001,1130,466,449,17,99.90116624
44c5d9f4a744bd71047bab773cdb783ee3b89b44,7,1007,0,1007,7,0,7,1,1,0,2,2,2.543614672,0,179,1,127,0,127,4801,0,4801,60,0,60,99.68491532
1abb1f90303342aa94f9752881330d5ea470491a,17,0,1716,1716,0,0,0,0,4,84,3,3,3.759419326,1174,13,3,0,205,205,0,7559,7559,0,125,125,99.04610493
186e75543a23f286e24c56f73859099405b7b73a,0,0,0,0,0,0,0,0,0,0,0,0,0,0,14,4,0,0,0,0,0,0,0,0,0,100
19efc0e44ad71e796c8fc8cac1cbd30b988f8ebb,10,266,42,224,0,0,0,3,23,614,1,3,2.419583543,2104,0,0,542,484,58,15496,13949,1547,229,212,17,100
1749f7ebe85e5d6a515ad264e69fad27b0624f06,1,102,40,62,0,0,0,7,15,122,1,1,0,271,179,0,39,33,6,2096,1890,206,14,14,0,100
d7a6667cb7d5c40bab753c254d01a5d4ba68de2e,6,346,415,69,1,0,1,5,10,918,1,3,2.503463521,1112,30,0,137,163,26,9153,9710,557,44,47,3,98.84778654
06073221d466b1079457ff6b697a648237b35c23,3,17,8,9,0,0,0,5,8,1006,1,2,1.217796812,592,31,1,83,81,2,5212,5153,59,26,26,0,100
3d0f470529ebc2dc2df7e17f20ba3c13aa13b4d2,7,80,178,98,0,0,0,4,22,338,2,4,1.569037474,1446,32,2,226,238,12,11257,11919,662,68,70,2,99.09402054
18634c182f7900d3e672113be4282650c31c7a41,1,5,6,1,0,0,0,18,130,88,1,1,0,2839,15,0,522,522,0,20687,20687,0,189,189,0,100
b4a593ef50fd25526f910d0083be1cc3032c41b3,2,2,2,0,0,0,0,6,9,22,1,2,1,508,0,0,71,71,0,4407,4405,2,22,22,0,100
6aacd830af046d69680ed31bfc0510dbe0c62a8c,0,0,0,0,0,0,0,0,0,0,0,0,0,0,16,1,0,0,0,0,0,0,0,0,0,100
bbedb2ad660cc1b11b04d73d94953052fc325823,0,0,0,0,0,0,0,0,0,0,0,0,0,0,17,2,0,0,0,0,0,0,0,0,0,100
f73b1a8d998528c9af649ac8c3821cf0335f9a54,0,0,0,0,0,0,0,0,0,0,0,0,0,0,18,3,0,0,0,0,0,0,0,0,0,100
c3810a661f0b466f086f4005fc6b09f0d23066c0,0,0,0,0,0,0,0,0,0,0,0,0,0,0,19,4,0,0,0,0,0,0,0,0,0,100
9927bc4a3a5d993b4e20d9855f8f5b16d1dbdfbb,5,543,2,541,1,0,1,1,10,50,2,4,0.318919691,736,33,3,169,120,49,9716,6101,3615,56,39,17,98.91260572
dbfd7fa867ab3a7056a37ce0a1a385097388fd21,1,1,1,0,0,0,0,3,8,137,1,1,0,117,20,5,1,1,0,563,563,0,1,1,0,100
2ec0f3f825e915b928268c6623c9be554934dcc4,0,0,0,0,0,0,0,0,0,0,0,0,0,0,21,6,0,0,0,0,0,0,0,0,0,100
ce049714b529df02e795ffd3575ae1d33646329a,2,12,0,12,0,0,0,15,61,112,1,1,0.811278124,831,22,7,124,123,1,4953,4916,37,40,40,0,100
e901041d810635e5f8e36ae0438e43017012e274,13,1281,55,1226,4,0,4,7,69,157,2,7,2.297959202,4015,23,8,595,434,161,38959,32541,6418,174,132,42,98.47786902
cd3a60abf10d526b6cc5ee2d4cec3c2709fe5b24,5,18,122,104,0,0,0,5,8,1012,1,2,1.695671171,648,34,4,54,79,25,4742,5543,801,20,23,3,98.35863767
2cd0f76071c4150f6a2646fdc694f68ff5f56a73,0,0,0,0,0,0,0,0,0,0,0,0,0,0,24,9,0,0,0,0,0,0,0,0,0,100
74d7d3ad7f33245fb2467b0d8e8be2105c218438,0,0,0,0,0,0,0,0,0,0,0,0,0,0,25,10,0,0,0,0,0,0,0,0,0,100
e0bdf3e65c0e999d2190269ae497a3c03a449462,4,50,0,50,0,0,0,3,70,240,2,3,1.32223569,1799,26,11,231,227,4,14188,13886,302,53,52,1,100
6e1651fab00bdc9bb5f713d1a04fddecdd7b7d27,6,11,11,0,0,0,0,5,5,975,2,5,2.049452073,662,35,4,116,106,10,4228,4025,203,57,45,12,99.82913285
09761c709a08473a2c34f054218d0c34bd192492,2,5,2,3,0,0,0,5,11,218,1,2,0.985228136,328,1,0,47,46,1,3396,3341,55,17,17,0,100
436787cb6745da67f296984230949b07e28f00ca,4,40,9,31,0,0,0,5,14,524,2,4,1.660277247,864,27,12,121,117,4,6889,6674,215,56,56,0,100
6000ca9976253dcef03e19fd964a7b30be91e957,7,1007,0,1007,7,0,7,1,1,0,2,2,2.543614672,0,36,4,127,0,127,4801,0,4801,60,0,60,99.68064722
d9dbe56ca257f89652ffa430bfc4c594f35e3557,5,27,30,3,0,0,0,2,2,65,1,1,2.041833396,586,37,5,104,104,0,3677,3685,8,39,39,0,100
10dec6b605678faef8a491191fa4a7ef788ddeb1,0,0,0,0,0,0,0,0,0,0,0,0,0,0,38,6,0,0,0,0,0,0,0,0,0,100
3c8c72ca25627b20771f04fbba441550122d71a3,0,0,0,0,0,0,0,0,0,0,0,0,0,0,39,7,0,0,0,0,0,0,0,0,0,100
c649777d670133d011439f97114552354227f86a,0,0,0,0,0,0,0,0,0,0,0,0,0,0,40,8,0,0,0,0,0,0,0,0,0,100
922b3169615a0e42f6469135d6f95bcec17f01b7,3,9,9,0,0,0,0,2,3,21,1,1,1.530493057,448,41,9,85,85,0,2923,2923,0,37,37,0,100
800584a164d99567dfb75b5f422efe50e690233b,12,918,1062,144,3,0,3,0,3,0,3,4,3.076399716,1029,28,13,154,171,17,6435,6498,63,42,84,42,96.74814028
e5381cdcf450d7f31ca2b4bbd2436ac731364e32,0,0,0,0,0,0,0,0,0,0,0,0,0,0,36,4,0,0,0,0,0,0,0,0,0,100
db7cedcfa7a586ff5ee817012f8baddab6e14acb,7,1004,0,1004,7,0,7,2,3,36,2,2,2.543546376,0,43,11,127,0,127,4793,0,4793,60,0,60,99.68173138
fa78d2590d24618f4eb8090742869e953538e9b1,10,194,1051,857,0,0,0,0,7,106,3,4,2.804246474,1410,17,0,70,193,123,5774,9860,4086,30,87,57,99.68173138
1f77657c9d8f97cad48de614663c9d664cd698d6,1,22,6,16,0,0,0,9,12,162,1,1,0,144,29,14,18,18,0,1402,1303,99,6,6,0,100
36fb263c1383e6eafe61d1606378dbe5d0175595,7,1004,0,1004,7,0,7,2,3,36,2,2,2.543546376,0,44,11,127,0,127,4793,0,4793,60,0,60,99.68173138
99f03c35dc53bb5076b015faa27375829b2f2c38,2,21,94,73,0,0,0,2,9,14,2,2,0.126531592,311,45,12,66,80,14,1703,2355,652,15,16,1,100
7dbadfe859ae7caf06fcd3aca6e81d20636515d8,13,45,944,899,0,0,0,0,131,158,4,8,2.8907733,4474,2,1,715,824,109,27227,31288,4061,255,313,58,99.21510395
6d44cfd9b5c8ec12fdf5310bb86cfa09e7b84562,26,329,836,507,3,0,3,2,9,1142,1,4,4.49088986,668,37,4,122,134,12,4488,5523,1035,36,50,14,96.30171333
cfa8abb07f460a9021b70694c1d63a0892db01d9,34,90,90,0,0,0,0,7,42,356,3,23,4.25769018,10116,38,5,1298,1298,0,80056,80056,0,506,506,0,100
99efc7fc960d5680fc7605400e0375a7883bae37,1,1,6,5,0,0,0,15,59,104,1,1,0,668,18,1,107,108,1,5053,5083,30,28,28,0,100
6fa02888fc6b5bc866f9ece344e03ce95e9ebf86,2,14,1,13,0,0,0,6,10,2,1,1,0.721928095,579,19,2,56,52,4,4504,4385,119,29,28,1,100
8be62797b1e6e476f1d012eb6a35feb128a708c2,7,931,0,931,7,0,7,2,5,37,2,2,2.609323288,0,48,15,113,0,113,4143,0,4143,59,0,59,99.50950337
54fbb9a9449b87c4981f3d481cb25714eb217f49,10,57,931,874,1,0,1,0,70,54,2,5,2.82457427,1065,0,0,31,142,111,3072,6894,3822,14,71,57,99.40828402
1944cca83c1af4a87ffd98f4df2aaedf389033d9,0,0,0,0,0,0,0,0,0,0,0,0,0,0,30,3,0,0,0,0,0,0,0,0,0,100
c6723a80c0d7b08eda4093cd0d755c3f04adfd80,0,0,0,0,0,0,0,0,0,0,0,0,0,0,31,3,0,0,0,0,0,0,0,0,0,100
64476a7478c8f9aec1ba0ad4388d15b0bb6db352,6,496,0,496,3,0,3,14,71,12,2,5,1.695089084,626,3,1,100,54,46,7029,4828,2201,47,25,22,99.85699694
0235d595930ecdd12e48da1b7e090f8eb801ef2a,1,6,1,5,0,0,0,15,60,23,1,1,0,664,32,3,108,107,1,5083,5053,30,28,28,0,100
3a97427db410473189e8c0fe05cb2d6815978a56,4,91,20,71,0,0,0,15,59,148,2,4,1.333063927,1063,4,2,156,154,2,8785,8358,427,49,47,2,99.97960016
5b8cec9cdcc42f507dd937848f8762dbfb13f5d0,1,6,1,5,0,0,0,15,60,23,1,1,0,664,5,3,108,107,1,5083,5053,30,28,28,0,100
5aea068eb7bddd9343b66b9242123c8a31ea1f18,2,7,1,6,0,0,0,19,132,24,1,2,0.811278124,3056,20,2,522,522,0,22360,22360,0,189,189,0,100
cd4c80d48547d75320b4832a127978569f8b2743,20,855,656,199,7,0,7,2,131,90,5,13,3.648394783,5066,49,3,842,810,32,38361,37976,385,327,299,28,99.28687857
a001e445598f62bbf1551282f64d3d600c4775a3,22,785,856,71,4,0,4,0,132,45,5,13,3.822575774,6202,6,4,878,906,28,45749,45370,379,334,360,26,99.28687857
e23fc4ef88b1ba2170d97aaa563bedc9ba521c7e,11,535,549,14,1,0,1,5,9,1627,1,1,2.856133925,1479,39,2,109,133,24,12690,12797,107,56,56,0,99.91840065
0c4f5e78fd59ea8f756535352b71f2f9eb76dacc,2,74,70,4,0,0,0,5,17,201,1,2,0.105591036,1013,21,3,105,116,11,7706,7576,130,47,48,1,95.78789823
913be9a9d38fe737a89835fe39799a68c427fa75,1,5,1,4,0,0,0,7,16,105,1,1,0,302,180,0,40,39,1,2121,2096,25,14,14,0,100
36128ec2f64fc31dc215808fdb00b4516d0aa1ff,2,70,74,4,0,0,0,5,18,0,1,2,0.105591036,1012,22,4,116,105,11,7576,7706,130,48,47,1,95.78789823
cdd0314eeb832ee7a6aeb49fbbed282b2d631353,2,74,70,4,0,0,0,5,19,0,1,2,0.105591036,1013,23,5,105,116,11,7706,7576,130,47,48,1,95.78789823
8de33e0855f5254595efebe2c2d593eea0fe13b3,1,1,6,5,0,0,0,15,61,16,1,1,0,668,24,6,107,108,1,5053,5083,30,28,28,0,100
fe48f482ea8687bf34f91e572cfcc2db01cff0ad,1,3,1,2,0,0,0,14,70,144,1,1,0,1018,181,1,174,174,0,8446,8432,14,31,31,0,100
8a80d60bb61a0d39154ca23776e57640b8573e09,3,2,10,8,0,0,0,6,62,351,1,2,0.816689088,947,25,5,134,135,1,8004,8055,51,39,39,0,100
e62fa28d0fe342a8a154e0f50221cf34a658a045,97,3734,7719,3985,18,0,18,4,23,1049,5,29,5.811990216,10827,26,6,853,1172,319,58266,79801,21535,399,600,201,93.82022472
598b203c8cf91897a970ad086461f4c75897c74c,0,0,0,0,0,0,0,0,0,0,0,0,0,0,33,3,0,0,0,0,0,0,0,0,0,100
a001d43992eab3d543927580da1f7533a3279897,3,20,17,3,0,0,0,2,2,1710,2,3,1.510583033,269,34,4,33,33,0,1872,1913,41,19,19,0,100
151ba5358697fd600c20f9fab8ea053b12d95bd9,3,17,20,3,0,0,0,2,3,0,2,3,1.510583033,265,35,5,33,33,0,1913,1872,41,19,19,0,100
24d8243807cfe274963cf08934515345c7d17eb0,10,188,34,154,0,0,0,5,13,57,1,6,2.806143083,2145,40,1,274,255,19,19355,18318,1037,95,93,2,95.06861063
f951f0944b9e4b3ff4422b7c57b50c516a93d132,7,839,0,839,7,0,7,2,6,34,2,2,2.652714998,0,52,3,84,0,84,3394,0,3394,54,0,54,94.16891471
d38478787d36ac6b2c87eaebeb3c7face43cf0d7,1,8,58,50,0,0,0,2,7,29,1,1,0,144,53,4,22,21,1,647,621,26,11,11,0,95.76450657
3dc878e1ca440ad4bfe9250c43384971bd344c3b,6,560,471,89,0,0,0,2,8,39,1,1,2.26825679,531,54,5,96,80,16,3871,3007,864,44,50,6,93.98464164
8fdfad8ff5e2b5d654e1a16c2b1c853286f3d8e1,1,0,96,96,0,0,0,2,2,149,1,1,0,69,55,6,0,5,5,0,413,413,0,4,4,99.89336746
2314e465496114444d83cec7dced60f482670179,24,748,1253,505,6,0,6,0,14,300,3,7,3.983822432,2750,41,2,288,383,95,17006,20728,3722,111,140,29,93.5401615
a689c65f03b82b75c7a23b5f974c8d7c7a3d4c97,5,782,0,782,5,0,5,2,4,47,1,1,2.123728479,0,57,8,96,0,96,3871,0,3871,44,0,44,98.9010989
81128e6bc96009ed77ec04e2afceab45aa70885f,1,59,2,57,0,0,0,2,5,3,1,1,0,249,58,9,48,43,5,2073,1668,405,21,20,1,96.55100334
5fc1e97790936ff0002fbebc156fccd06b4a9014,24,476,1592,1116,0,0,0,0,15,0,3,7,3.951623208,2963,42,3,287,389,102,16857,21282,4425,96,156,60,95.44994944
9c541adf15194c44800555f0fb161463df68feac,3,90,2,88,0,0,0,16,80,345,2,3,1.253380506,2877,7,1,199,198,1,25219,24658,561,101,99,2,100
832e8da0f30f8db9131e30fabad5dca9f8631d21,1,1,1,0,0,0,0,19,133,33,1,1,0,2839,8,2,522,522,0,20700,20702,2,189,189,0,100
0b487f3787286e334e8157e4dc31c0bba83b7bbb,0,0,0,0,0,0,0,0,0,0,0,0,0,0,36,3,0,0,0,0,0,0,0,0,0,100
a355979914bd50cfb68fe9f45dcf471a33e5f9c4,2,10,0,10,0,0,0,11,33,67,1,2,1,1011,37,4,115,115,0,7996,7946,50,34,34,0,100
5f64fe9f34fb857ccca5a5b09b9ff46300c98674,16,221,45,176,0,0,0,7,71,275,2,10,3.255797818,5689,38,5,798,781,17,44363,43679,684,291,278,13,100
372ffc9b4c662b0d076940b7526d2fe58c8a6a09,4,413,0,413,2,0,2,11,43,38,2,3,1.277466808,975,39,6,180,142,38,9084,7266,1818,100,77,23,99.71346705
fe3ef2370c64f221d45f4156d1d25e0ffecb0b56,5,839,0,839,5,0,5,2,5,42,1,1,2.067768661,0,60,10,101,0,101,4276,0,4276,45,0,45,94.40851241
b882eb496c9060e8dfeb0f648b2fd126384d077b,1,2,58,56,0,0,0,2,6,9,1,1,0,302,61,11,43,48,5,1668,2073,405,20,21,1,95.59293166
755e94250e430e290a0642bcb5a575d29f190b4c,14,459,1063,604,2,0,2,0,9,7,3,3,3.183698466,2215,27,6,201,287,86,12917,16001,3084,90,128,38,94.08333333
1860b946b90f8fa3c17d00a6b419deb583fd538f,1,10,8,2,0,0,0,16,81,9,1,1,0,2660,40,7,153,154,1,23336,23344,8,83,83,0,100
f3e93a4758266bab77d6359bc2f7c8c7ddfc1b32,2,3,3,0,0,0,0,15,63,21,1,2,0.918295834,1409,28,7,188,188,0,10867,10867,0,57,57,0,100
3dc8d2f90e4336e736dbe1a73bb70ad1c77f95c1,3,122,1,121,0,0,0,8,134,34,1,3,0.993921831,3832,41,8,594,590,4,29060,28472,588,226,224,2,100
b85b323fbf17f0d0a1fffbc3be7ef95fe79583fa,2,6,13,7,0,0,0,8,72,302,2,2,0.74248757,509,42,9,87,88,1,3524,3537,13,9,9,0,100
9fd29f9dfbe621c498461227472824a087845ac6,8,1178,1,1177,5,0,5,1,3,445,3,4,2.341635049,144,29,5,145,12,133,7273,702,6571,50,8,42,95.28753994
332bc1b741788992ca537a76e2d5f8b3c97b480f,30,1079,1778,699,5,0,5,2,133,194,6,15,4.019834053,11189,62,11,1319,1368,49,82823,86977,4154,509,515,6,95.25264874
b8cc95a0b62bf0e4bc1c6463849940baa72bc4c9,25,1778,306,1472,7,0,7,1,134,167,5,14,3.572081737,10142,63,12,1368,1223,145,86977,79052,7925,515,465,50,96.94641052
ef81e090782ea9188f66ddfb713b61f6931c074f,1,3,3,0,0,0,0,2,8,0,1,1,0,261,64,13,46,46,0,1683,1685,2,21,21,0,100
b9d2107f47128bd62ee0d8cf268366c71f065d2d,2,50,4,46,0,0,0,8,15,226,1,2,0.999010271,160,43,10,16,6,10,1393,1147,246,6,4,2,100
03a8729237d46d9677ae5b55644b035551dc7b6c,0,0,0,0,0,0,0,0,0,0,0,0,0,0,44,11,0,0,0,0,0,0,0,0,0,100
6f398378c549e0aa0f681a538d575510694d39ad,4,58,1,57,0,0,0,5,14,1282,1,2,1.736886513,377,45,12,43,39,4,3578,3231,347,25,21,4,100
a3a20a195cc54c3b414cd0b5734d854332096db2,0,0,0,0,0,0,0,0,0,0,0,0,0,0,46,13,0,0,0,0,0,0,0,0,0,100
782d132ce4f45ac05d1c26d2f77030ddd5f1d997,0,0,0,0,0,0,0,0,0,0,0,0,0,0,47,14,0,0,0,0,0,0,0,0,0,100
2de4adff96110ed3fa4ed13e0a2f3172448a8cc8,26,267,1917,1650,0,0,0,6,64,223,3,8,3.255234473,6099,48,15,594,829,235,39970,49527,9557,249,301,52,99.55624156
2488be5bf5a8dfc0e41b39a5d9e550aa53615fb9,0,0,0,0,0,0,0,0,0,0,0,0,0,0,30,3,0,0,0,0,0,0,0,0,0,100
7f3084bea616e311b3d993d636ff8d0182bf6cfa,0,0,0,0,0,0,0,0,0,0,0,0,0,0,49,13,0,0,0,0,0,0,0,0,0,100
297088b579d19d2f698bad8ba258a63c96f245ff,0,0,0,0,0,0,0,0,0,0,0,0,0,0,65,14,0,0,0,0,0,0,0,0,0,100
b165c691431ae85c8cec149fea74ca72375d65ca,0,0,0,0,0,0,0,0,0,0,0,0,0,0,31,4,0,0,0,0,0,0,0,0,0,100
989cb7f3551ebd895fbda668665778104e4d6db9,0,0,0,0,0,0,0,0,0,0,0,0,0,0,50,14,0,0,0,0,0,0,0,0,0,100
35e9d48cd239a5e49c2127cd6e61989ee83cb9d4,0,0,0,0,0,0,0,0,0,0,0,0,0,0,51,15,0,0,0,0,0,0,0,0,0,100
da879a0cc4a960636f02084f3ed1f0ae66b885da,0,0,0,0,0,0,0,0,0,0,0,0,0,0,52,16,0,0,0,0,0,0,0,0,0,100
0becb24e8df7facd85fbfe1144e952ce71124fd5,0,0,0,0,0,0,0,0,0,0,0,0,0,0,53,17,0,0,0,0,0,0,0,0,0,100
4583c26ad5dbd73119b861c6bded2ff486474de6,0,0,0,0,0,0,0,0,0,0,0,0,0,0,54,18,0,0,0,0,0,0,0,0,0,100
3fe0dfa96bcac59c371de240adb5912d71be617b,0,0,0,0,0,0,0,0,0,0,0,0,0,0,32,5,0,0,0,0,0,0,0,0,0,100
10de29b392f7ba86e1f71867d27dda3cda958a7e,0,0,0,0,0,0,0,0,0,0,0,0,0,0,33,6,0,0,0,0,0,0,0,0,0,100
344be54e8d057eae60e86a001bae10b5d15a448c,0,0,0,0,0,0,0,0,0,0,0,0,0,0,66,4,0,0,0,0,0,0,0,0,0,100
71daaf0372f8c418ad8035bdc6969e12303aacc4,2,4,4,0,0,0,0,2,10,128,1,2,1,951,55,6,196,196,0,6957,6957,0,46,46,0,100
72be6e755374b04709ae83fbfa9f1ebed4d84dcb,4,40,13,27,0,0,0,4,135,100,1,2,1.466616984,3459,56,7,629,627,2,24518,24240,278,230,230,0,100
129f4ed9a9300c732f556d842a20f2ec1d1c188b,2,2,5,3,0,0,0,4,9,522,1,1,0.985228136,460,57,8,10,10,0,3552,3564,12,7,7,0,99.96136012
71283bda28927e59ab7d85f3e081776c190db86a,4,250,111,139,0,0,0,16,136,120,2,3,0.944701155,5701,58,9,693,690,3,47758,46097,1661,281,282,1,99.3967698
f2e566a050c700ac3692b30e6c84f5454e24f8d5,1,16,11,5,0,0,0,2,5,508,1,1,0,143,183,0,19,17,2,782,759,23,11,10,1,100
4a768a8c7d2867018b1d77c0ae031a3c1c124e19,1,75,121,46,0,0,0,5,7,1731,1,1,0,126,59,9,1,1,0,950,995,45,1,1,0,100
a4924edc79b26f937e3e5ea3584f0b4307dd4135,0,0,0,0,0,0,0,0,0,0,0,0,0,0,60,5,0,0,0,0,0,0,0,0,0,100
23bc2159ae3754d2b09fc058f8a9cab62daa9d38,1,52,0,52,0,0,0,8,24,141,1,1,0,265,9,0,57,43,14,2300,1971,329,15,15,0,100
4dc017163c18d941ee06d160ec0e83f8e60620f1,19,213,108,105,0,0,0,8,71,1086,5,15,3.542622731,4770,34,0,706,687,19,37295,36142,1153,237,238,1,99.7440441
6b644c97a5ddb39b0848abd954017a8585430723,16,613,1262,649,3,0,3,4,7,1149,3,6,3.669137418,1086,61,0,60,111,51,3490,7039,3549,28,77,49,95.15996719
6cfd35716fbfb89e014692414103b353b7ee2c49,1,3,3,0,0,0,0,2,2,426,1,1,0,77,62,1,8,8,0,547,538,9,3,3,0,100
b5910d24bfeb7dc42ec098080b3faafc50537250,19,748,471,277,6,0,6,2,16,171,2,6,3.592513581,2123,63,2,288,287,1,17006,16857,149,111,96,15,97.07553124
01c76e79ef5d2dd3fac2df1206918a91de8a7b01,19,476,753,277,0,0,0,2,17,0,2,6,3.598431697,2283,64,3,287,288,1,16857,17006,149,96,111,15,97.07553124
5a7b076435dfe54f9d093fbf892d4b7141634d66,8,1400,112,1288,4,0,4,1,13,47,1,4,2.295450622,855,65,4,290,147,143,14253,6563,7690,88,36,52,96.27525253
b87651cf9b140f03d44297129fbe68b82052da8e,10,550,62,488,5,0,5,5,20,75,1,2,2.886064662,2057,35,1,160,140,20,17955,15997,1958,84,70,14,99.75098568
c4226f649d71697e24ca9540907cdecd9bcdb9f5,16,41,35,6,0,0,0,1,137,138,2,4,3.576803564,6790,66,5,976,798,178,48472,54081,5609,366,332,34,99.0376569
f1b8bf783626038a58c7bd31a9d7e25dab3e86d5,0,0,0,0,0,0,0,0,0,0,0,0,0,0,67,6,0,0,0,0,0,0,0,0,0,100
604ed84c41442765d2b7f05feb9e544c9f3c758c,1,1,1,0,0,0,0,8,10,964,1,1,0,397,68,6,25,25,0,2698,2698,0,9,9,0,100
1b71cfb04cd2799c269e92b9220ad41309afbe8b,1,1,1,0,0,0,0,1,2,33,1,1,0,146,69,6,19,19,0,778,774,4,11,11,0,100
afcaa4997afae428522e7f0d7fb5917e9e58580d,15,1108,164,944,5,0,5,5,138,72,3,7,3.350923339,8745,36,0,1029,960,69,74181,68907,5274,407,384,23,99.40387481
a178d7ed86a48be937e780487333103870a70064,15,163,1107,944,0,0,0,5,139,0,3,7,3.350107728,9390,37,1,960,1029,69,68907,74181,5274,384,407,23,99.40387481
5a5a9d8831a28c185464cb2f3d78b4fc5e6c7bd1,0,0,0,0,0,0,0,0,0,0,0,0,0,0,70,2,0,0,0,0,0,0,0,0,0,100
76b65ee1d205bb700e1894a1bb75a19a3c87f2d8,1,9,1,8,0,0,0,2,2,381,1,1,0,240,0,0,50,50,0,2004,1979,25,14,14,0,100
ea50feb565d40d49cf4274881d8b6cb448429c12,2,138,138,0,1,0,1,1,12,430,2,2,1,98,71,1,18,18,0,752,783,31,4,4,0,99.87312328
b002854868f4179519558f8f9e2cc13e5c7d2fd9,4,8,7,1,0,0,0,6,21,706,1,4,1.806238929,1237,72,2,225,225,0,10189,10181,8,74,74,0,100
94cfb1b425b64285385fcb716a1c12877c24d6d0,11,591,61,530,1,0,1,4,140,192,3,6,1.957358,6364,38,0,984,963,21,49157,46513,2644,359,344,15,99.85216473
936be4e7cd08f33616fe1e296af63ed4325195bf,1,1,1,0,0,0,0,2,4,412,1,1,0,56,67,0,5,5,0,361,361,0,2,2,0,100
4cd3f1e983d8eb0559d52db0db08aaa5237935b6,0,0,0,0,0,0,0,0,0,0,0,0,0,0,68,1,0,0,0,0,0,0,0,0,0,100
f557a0380cf0ddc250010d4eb1b49e127f86f271,3,858,1092,234,0,0,0,3,141,637,1,2,0.590471597,3199,184,0,574,574,0,21359,23063,1704,212,212,0,96.61369656
d3aef7c8aae7403c637b0b146d32d656b608a20d,1,23,18,5,0,0,0,2,2,336,1,1,0,230,73,0,43,42,1,1864,1840,24,9,9,0,100
0ec31c0f786a4c8eaca3901eb716297f74cab4ea,1,8,1,7,0,0,0,20,142,35,1,1,0,2615,1,0,519,519,0,19102,19045,57,189,189,0,100
a8646b256a85d0b4a42dfdbf69288bf84e3583cb,1,1,8,7,0,0,0,20,143,2,1,1,0,2620,2,1,519,519,0,19045,19102,57,189,189,0,100
5db336d79b6f637840fc92427ae0648117f383ca,1,4,1,3,0,0,0,20,144,3,1,1,0,2615,3,2,519,519,0,19056,19045,11,189,189,0,100
51c02fa2456cd72b1088ac5662e2f17681aebd3a,1,9,9,0,0,0,0,2,3,99,1,1,0,537,74,1,97,97,0,3774,3774,0,25,25,0,100
4e2009104cf6bdc65b7ddd27e35ed5068f7b3d21,3,15,14,1,0,0,0,2,16,417,2,3,1.501357929,935,69,0,138,138,0,7471,7423,48,40,40,0,100
d817d4d301dcacb21d2d135e5ffa6ed9aaddbf47,4,62,8,54,0,0,0,1,5,137,2,3,1.061716278,1586,39,0,133,132,1,12931,12635,296,58,57,1,100
252c1e0a9e76281318887e677cbdf588e052e82f,0,0,0,0,0,0,0,0,0,0,0,0,0,0,70,1,0,0,0,0,0,0,0,0,0,100
e4dcc8ed2d61c654fff80fb23da0b41e3b451765,16,16,16,0,0,0,0,3,66,476,5,13,4,3113,4,0,540,540,0,21633,21601,32,168,168,0,100
66665515a106ee6e12080c49d49395e6768444de,86,300,300,0,0,0,0,4,12,1019,2,4,4.379054192,67899,40,1,17351,17351,0,500298,500298,0,7319,7319,0,100
535e186fc699b2fb3f8b57ebd55c9f93dfc81f62,86,86,86,0,0,0,0,4,13,0,2,4,6.426264755,67899,41,2,17351,17351,0,499954,500298,344,7319,7319,0,100
1c77f5d3bdba0a6327e6bbe87abf542610f50f06,1,4,3,1,0,0,0,3,5,54,1,1,0,537,0,0,97,97,0,3774,3774,0,25,25,0,100
514a3b1bfdb7d2f2b7967f779dd91bc24af1bd79,4,4,11,7,0,0,0,5,145,239,2,4,1.723231429,4027,75,0,622,622,0,30001,30060,59,231,231,0,100
68f568a69dea04cfefdc6b22433c2f408aaf535f,1,1,1,0,0,0,0,10,14,870,1,1,0,90,5,0,17,17,0,590,590,0,7,7,0,100
0668237aa703e24602afb75a90e127839fb67e15,0,0,0,0,0,0,0,0,0,0,0,0,0,0,76,1,0,0,0,0,0,0,0,0,0,100
6752f14aafad2f9ead0198f2f840db120182b268,33,82,64,18,0,0,0,1,12,107,2,8,4.587400785,6082,71,0,917,1274,357,48161,94736,46575,329,496,167,95.6928839
6e78a486f18fcca9dbc26baee9bc15c4d71ebeec,0,0,0,0,0,0,0,0,0,0,0,0,0,0,6,1,0,0,0,0,0,0,0,0,0,100
912b1dbe85fba5bbe7f7fa5c8eb9befc7a081c44,13,706,93,613,2,0,2,16,146,423,2,8,2.019058588,7458,42,0,1181,1070,111,63210,59545,3665,456,411,45,93.52372386
902c90b3fa30cb4947258e324917c8a3d74997d7,1,0,741,741,0,0,0,12,42,508,1,1,0,668,77,1,0,139,139,0,5322,5322,0,35,35,99.77722772
1efc5562889c264ab980472990b35870e1dd1f65,1,2,1,1,0,0,0,3,9,612,1,1,0,117,78,2,1,1,0,563,563,0,1,1,0,100
4c49a3fb094223f5801239d9aaaa8c420b696fa7,0,0,0,0,0,0,0,0,0,0,0,0,0,0,7,2,0,0,0,0,0,0,0,0,0,100
e94c5d6d0fafb821211eecb74575df32a5388576,5,112,42,70,0,0,0,14,147,173,4,5,1.577009203,7864,8,3,955,944,11,64635,64222,413,352,350,2,99.97522299
e4791a029a27506afa4caf37552041216ad0a43b,0,0,0,0,0,0,0,0,0,0,0,0,0,0,9,4,0,0,0,0,0,0,0,0,0,100
135f764ba8f661776b8b4e332c79add09eb213d9,3,129,70,59,0,0,0,3,17,1074,1,1,1.180239895,647,10,5,213,201,12,4610,4309,301,79,70,9,95.57542951
b2314682606cc36cd54138e3a8376d69e46895cf,2,28,23,5,0,0,0,8,14,334,1,1,0.977417818,411,43,1,96,95,1,3097,3078,19,43,43,0,98.05001147
af8ea0ac16852cd370efb5d76f881c81e327fa6c,232,1679,759,920,3,0,3,2,148,162,7,62,5.456913991,98452,79,3,20339,4562,15777,750277,254982,495295,8406,1818,6588,85.08220503
7ac2b05e5681e902dc01fc0d4cc21ac9eb13ae43,2,136,0,136,0,0,0,4,33,1447,2,2,0.430551867,535,11,5,40,36,4,5116,4238,878,25,21,4,100
b65f5b2b4fe31a5a700122bf5d174d199fa8bd4f,3,43,8,35,0,0,0,17,149,727,2,3,1.025881487,5518,44,2,691,688,3,45012,44762,250,276,275,1,100
71b868b4353932348b26a2aa542ac9be99d835be,2,88,10,78,0,0,0,5,30,14,2,2,0.749595257,357,45,3,75,59,16,3141,2735,406,19,17,2,100
edd8a7aee911a13d3815c611c50da53bbb99ce24,232,688,1768,1080,0,0,0,2,150,0,7,59,5.464378369,99454,80,3,20186,5019,15167,745475,319011,426464,8365,2400,5965,85.08220503
48422f4cc0995d5e0fd0d9705fba7cc3f8e13a40,231,938,759,179,2,0,2,2,151,0,7,61,6.566743462,98533,81,4,20219,4581,15638,745609,255630,489979,8374,1821,6553,85.11976772
266857472e49bccb02a70328a3d1f45eb01863a4,2,260,22,238,0,0,0,2,10,1281,1,2,0.980720116,203,46,4,80,49,31,2679,1403,1276,42,31,11,96.12137805
a06e656394672f67c648de73a6e8965478dadde6,2,60,2,58,0,0,0,7,152,187,2,2,0.205592508,2880,12,5,545,544,1,21231,20953,278,207,206,1,100
97f666345c1c068fed56a29512f9dcea77e44c8a,6,1184,165,1019,0,0,0,14,153,247,3,5,1.106561342,8574,13,2,1161,1028,133,75308,70320,4988,405,367,38,99.89509022
b97f5c7aa89d3c9061dd1b6655fc0702caa93f1f,133,89,91,2,0,0,0,1,1,0,1,21,3.268788126,27149,82,2,3423,798,2625,212532,49343,163189,1500,798,702,84.44997737
9351d19de9526dc281c7304fe636468bc7afcaff,133,91,89,2,0,0,0,2,155,0,2,21,3.268788126,27148,83,1,3423,532,2891,212372,34846,177526,1500,532,968,84.44997737
7db84b2fec3c8f51c5c78dc1c52718295dd42cd7,133,89,91,2,0,0,0,1,3,0,1,21,3.268788126,27149,84,2,3423,798,2625,212532,49343,163189,1500,798,702,84.44997737
e6703a5802962689ef60dd8f952cb09b988dbced,3,158,1,157,0,0,0,2,5,6,2,3,1.127328212,1347,47,0,207,201,6,11738,10844,894,42,40,2,99.97536946
f462149080a77ca96c752be578062073e632e93f,5,2310,0,2310,3,0,3,2,5,9,1,2,1.677772629,14173,48,1,3883,3406,477,118846,105376,13470,1954,1756,198,99.77876106
60f95b3d74ef524fe17c42e671e70f5461640681,3,95,12,83,0,0,0,6,28,54,2,3,1.172100125,1207,14,1,142,135,7,9301,8986,315,65,63,2,100
74f130fe579f6655b4f33be60408f7f7f359249a,6,1467,169,1298,0,0,0,2,6,38,1,2,1.95097256,17458,85,3,4535,4245,290,138026,130038,7988,2169,2058,111,100
10217aab572eddae40cd2fa623a3b201839e2c9b,1,50,17,33,0,0,0,2,4,19,1,1,0,3106,15,2,631,636,5,22381,22380,1,220,219,1,100
360e9c304cf67beb63a02f9b33417730456f04a5,2,49,10,39,0,0,0,2,5,10,1,2,0.923842228,6195,16,3,820,814,6,49839,49674,165,315,313,2,100
315a8913aa9dfc5fad7a9863c766267fd6f7877b,2,34,43,9,0,0,0,2,6,0,1,2,0.557081908,6219,17,4,815,820,5,49851,49839,12,316,315,1,100
212eb0ccd43c63ba1b5b4846ecaa4ae1c48c9e9d,8,533,15,518,2,0,2,2,9,28,2,5,2.614244276,3062,86,4,541,492,49,26415,23443,2972,176,159,17,99.4100295
097948e320f71912f195bbbeb834fddb8fc9c85c,0,0,0,0,0,0,0,0,0,0,0,0,0,0,18,4,0,0,0,0,0,0,0,0,0,100
112cdcd4f671bd9554f68752ecafdb943cd1e163,8,405,625,220,1,0,1,3,7,15,1,4,1.763775802,7301,49,2,980,1009,29,57781,57780,1,409,415,6,99.92614476
4f75cc1c4be7e10f48abf42caeee6e500808cee8,5,126,2,124,0,0,0,3,9,530,1,2,1.856019647,295,50,3,49,36,13,3200,2202,998,19,16,3,92.51646904
cfd4962c851b896c263de6ed05c5abf5a3a0e59b,1,7,2,5,0,0,0,1,5,17,1,1,0,910,87,4,153,153,0,6418,6425,7,82,82,0,100
283fe7c5ad520733f334735c8d3eb70f6907833a,0,0,0,0,0,0,0,0,0,0,0,0,0,0,51,4,0,0,0,0,0,0,0,0,0,100
d41696d6ae32dec16767d15d0d8d31b9e34f38fd,0,0,0,0,0,0,0,0,0,0,0,0,0,0,52,5,0,0,0,0,0,0,0,0,0,100
3f32313d196c5ff9844530450a301392c7d4eb4d,0,0,0,0,0,0,0,0,0,0,0,0,0,0,53,6,0,0,0,0,0,0,0,0,0,100
25f025f3ca89b1e4b4ce7adee8477b4d130214d7,1,2,0,2,0,0,0,1,6,2,1,1,0,909,88,5,153,153,0,6425,6418,7,82,82,0,100
64292b85094db8d9dbbaf9113e7c777d2233f920,0,0,0,0,0,0,0,0,0,0,0,0,0,0,54,7,0,0,0,0,0,0,0,0,0,100
035333a4da12681d4a4406da101915b976a2cdc9,0,0,0,0,0,0,0,0,0,0,0,0,0,0,55,8,0,0,0,0,0,0,0,0,0,100
9c3614bcebd84b4218ec3195201483cc88d8be4a,2,4,4,0,0,0,0,3,22,183,1,2,1,865,89,4,176,178,2,6735,6757,22,41,41,0,100
6d2ad5fa59810038f1649c7216741082c4e3171b,1,4,1,3,0,0,0,2,2,2365,1,1,0,58,90,4,7,7,0,326,313,13,5,5,0,100
bee44c28adac869ccf9972854d31e88adcc5f251,7,500,19,481,2,0,2,1,23,59,3,5,2.384939291,2283,91,5,419,381,38,20219,17893,2326,172,155,17,99.80192417
86c12d64ee47d2644a7bcda7277bedcae98c8aba,5,664,92,572,1,0,1,2,8,30,2,3,1.694456842,1332,56,7,241,197,44,12642,9712,2930,132,106,26,99.23922232
1e9c6626f3b9a40e9cdbfce712953168bffa530a,2,15,15,0,0,0,0,2,5,83,2,2,0.353359335,552,92,6,99,99,0,3766,3766,0,32,32,0,100
47d339a011e73587009e8d38547eb6c08b519c71,0,0,0,0,0,0,0,0,0,0,0,0,0,0,93,6,0,0,0,0,0,0,0,0,0,100
ca6de57e5c132d79686ff9b0eada2567e37165de,1,1,2,1,0,0,0,3,8,38,1,1,0,2907,94,7,592,592,0,21076,21084,8,214,214,0,100
f330be532b8425bb2b6ba6d9ca64f99bf951e764,1,2,2,0,0,0,0,7,10,110,1,1,0,52,57,8,1,1,0,451,451,0,1,1,0,100
4d9bc9cea94f13b7994817d33c016c776fa7dcda,9,869,47,822,1,0,1,3,33,42,3,7,2.555191718,8286,58,9,1228,1148,80,71732,67275,4457,431,405,26,99.77509137
3278c714c490d505b84b798bb9b77732f7f7ef7f,2,80,40,40,0,0,0,3,10,2,1,2,0.934068055,6264,59,9,809,804,5,51871,51559,312,318,318,0,100
74842080936b93a8ef9b874774fd841764adc42c,1,68,0,68,0,0,0,3,3,2519,1,1,0,230,60,10,26,22,4,1885,1517,368,12,10,2,100
9caa0d1d05871028ae1fc53bfc945c37e9c6eadc,30,1093,128,965,3,0,3,2,34,203,3,13,2.428254591,13564,61,11,1747,1736,11,110964,108673,2291,619,612,7,91.84084613
3ae60f6b8dc21887517e8b5a6a20a279e8d699bf,3,37,2,35,0,0,0,6,24,837,1,3,1.215126381,833,95,8,145,140,5,7390,7142,248,63,59,4,100
9aeb2e236045c960aa90eea4a36ff050cc78c1d8,3,127,27,100,0,0,0,4,34,575,2,2,1.037122413,1483,19,0,59,56,3,11643,11045,598,45,42,3,100
cfd1036fea2d66d39c29587e22d44861aadcba1f,2,40,3,37,0,0,0,3,12,2,1,2,0.933025295,6295,96,8,812,809,3,52246,52000,246,319,318,1,100
0397fc5e3f6956ff5d56bb32acbb8670c18d0659,1,26,4,22,0,0,0,3,12,23,1,1,0,564,97,8,120,118,2,4194,4133,61,26,26,0,96.11245333
e358fde7f7a22f6848f464d55644d6eec89b5f88,111,0,29709,29709,0,0,0,2,16,1858,2,14,6.070691629,22720,98,9,0,2344,2344,0,164169,164169,0,985,985,87.60586656
8e64b2fa5fc84c4683d59097229355329dd06526,2,9,3,6,0,0,0,6,25,2,1,2,0.650022422,813,99,10,137,136,1,7354,7243,111,55,55,0,100
96a473390aaeafc145ecc466a94879d0f0b809ab,11,3308,0,3308,2,0,2,3,13,16,1,7,2.174327992,23773,100,11,5368,4793,575,202334,182448,19886,2648,2369,279,99.6763754
7bbcec262ee57ab9097b14d1eeae5e18f251014f,0,0,0,0,0,0,0,0,0,0,0,0,0,0,101,12,0,0,0,0,0,0,0,0,0,100
d0536f55cbb64dfb1d1f69831e4fedf14ec8447b,5,210,165,45,0,0,0,3,11,31,2,4,1.213028773,2789,20,1,561,551,10,22071,21756,315,151,150,1,100
00274ccd676b8378b9cf80f414c6a643a46655b5,1,53,20,33,0,0,0,3,12,6,1,1,0,3374,62,6,196,196,0,31167,30853,314,101,101,0,100
03ef821ec4d2948020eb0fdf4b1bdbd5bf807a20,7,229,158,71,0,0,0,3,12,9,2,5,2.007238313,3931,102,12,760,723,37,30875,30208,667,247,238,9,97.35764793
9eea789b589b4a4a32a6170a59aad62c19b715cc,1,1,1,0,0,0,0,7,10,882,1,1,0,98,21,2,14,14,0,724,724,0,7,7,0,100
702495b404fd6b55587f23de14e1feedd9cb64ce,4,110,8,102,0,0,0,2,14,12,1,3,1.352860056,5050,63,7,916,905,11,39636,39048,588,286,282,4,100
dbf83ab2b31219b9d3d1e94265917ae1a292cc69,6,578,76,502,2,0,2,6,29,19,2,5,1.231887318,5744,22,3,1026,1006,20,46548,44355,2193,333,317,16,99.91416309
4d9665f60c240eba17356c6c91646c1c357a62d5,6,9,9,0,0,0,0,7,20,40,1,1,2.281036113,363,64,2,36,36,0,2525,2507,18,22,22,0,100
13010b0b600c4f2e7a7ea7f0ec8dcae87632950a,2,35,1,34,0,0,0,4,14,909,1,2,0.764204507,1042,23,2,234,232,2,8812,8596,216,85,84,1,100
4a75a39314ec772d13e56a9b53de5d6603327493,1,26,18,8,0,0,0,2,5,62,1,1,0,172,65,2,27,25,2,1232,1215,17,8,8,0,100
ef90f311f9138ecc35f8e6faf487d5b019bbf0af,1,4,2,2,0,0,0,2,5,75,1,1,0,146,66,3,30,30,0,765,755,10,17,17,0,100
061ef73fefedf4dc60a6c2ffb2d3973c3dddee33,1,18,26,8,0,0,0,2,6,20,1,1,0,179,67,3,25,27,2,1215,1232,17,8,8,0,100
a3a1999950d6dc8292651494491302cc808dbba1,1,26,18,8,0,0,0,2,7,0,1,1,0,172,68,4,27,25,2,1232,1215,17,8,8,0,100
3dab053e18b4197e97f4a654e2707cb1eb673047,6,73,25,48,0,0,0,2,15,245,2,5,2.428523947,1477,69,4,257,254,3,10285,9828,457,83,82,1,100
049da445fd5f1320f7b4cde888d8f3433e20e4ba,5,126,3,123,0,0,0,2,19,247,2,5,1.640563871,1579,0,0,116,112,4,13244,12298,946,55,53,2,100
f3f238ab991cd82ae7f468f9658ddef1e273ac1e,13,15,15,0,0,0,0,3,68,158,2,9,3.640223929,7618,1,1,701,701,0,65262,65262,0,298,298,0,100
fb7bb7bc6cdd5ea6f12e28c5e81001a0b5cce60b,37,669,666,3,0,0,0,4,35,113,4,20,3.869657076,16335,2,2,2632,2519,113,129445,126677,2768,996,948,48,99.5702252
c30d5611194d852df76ea34d3b6c3dd3676ccf34,10,380,32,348,0,0,0,7,35,786,5,7,1.785473343,5317,24,0,911,891,20,40973,39470,1503,345,336,9,100
acdb36df38bfa2ebb978d879fd796b9933aa8bd0,5,38,86,48,0,0,0,2,18,3,2,4,1.94953371,5523,70,0,937,944,7,42656,42871,215,303,304,1,100
03236072c606d305fb4a9975fdfa7bbfbdbfb82e,6,407,97,310,1,0,1,1,17,140,1,5,1.786245223,2179,103,0,382,354,28,19986,18409,1577,111,91,20,90.46363437
8f600a6a6fea26d13a0e7ec17028fc5da004ddd1,9,276,37,239,0,0,0,6,73,124,3,7,1.950601373,4175,25,1,554,545,9,33431,32548,883,156,154,2,100
7c5be79b4fdcc32afee95e56899a55786d8952a8,1,31,15,16,0,0,0,2,2,1859,1,1,0,56,26,2,11,7,4,384,224,160,5,4,1,100
8446e8f17183d9ad3c55c53cf846028e5d821497,0,0,0,0,0,0,0,0,0,0,0,0,0,0,27,3,0,0,0,0,0,0,0,0,0,100
3d062f39ce6a047138660a7b3d0024bde916c5b4,0,0,0,0,0,0,0,0,0,0,0,0,0,0,3,3,0,0,0,0,0,0,0,0,0,100
c6d139762e941fa896c0395eb06e36749c9cd67d,5,309,4,305,2,0,2,1,37,219,2,2,1.23459109,1393,104,1,222,187,35,12688,11175,1513,57,41,16,98.23332318
260d11abf85fa3f36952c05dae82ba706269e297,1,3,3,0,0,0,0,4,6,24,1,1,0,122,71,1,29,29,0,892,892,0,19,19,0,100
f0f9d620af09013e6ce6ab97db944ab73a6e4ef9,1,36,20,16,0,0,0,4,19,24,1,1,0,1380,72,2,251,252,1,11565,11485,80,42,41,1,100
e0d99fef5c23e34613a0d90705fa61346816cb78,4,189,7,182,1,0,1,1,26,78,2,3,1.257079366,1091,105,2,244,220,24,9176,8190,986,63,52,11,99.93883792
f099f0abdbeae094fa78d612812cc49b443b48df,6,154,45,109,0,0,0,2,19,199,1,5,1.667694024,4531,4,2,839,822,17,35746,34829,917,310,309,1,100
2c5723e15cdee96ea3a60a1757e27828c84abe8b,6,80,30,50,1,0,1,7,33,19,3,5,2.18140371,5897,106,3,993,990,3,45705,45483,222,323,320,3,99.93891265
8028cef7efb6c1a2e8c493ed1d1566aae176912d,6,146,2,144,1,0,1,2,21,95,1,4,2.285461093,2321,73,3,344,338,6,19897,19165,732,104,100,4,99.44717445
f255c34218a0a07d46ecab3166e5c996dc07960d,3,81,12,69,0,0,0,2,21,30,2,3,1.053296761,3392,74,4,735,727,8,25163,24791,372,263,261,2,100
50e1d23e4d07d27b0e3917e84b23b4a054d1b438,1,91,4,87,0,0,0,4,22,3,1,1,0,3078,5,2,630,628,2,23194,22577,617,227,227,0,100
85cf7f2964f5c4be7b9f21ea4ffec46ec2ca3fdb,10,431,293,138,0,0,0,2,34,404,1,2,2.337945212,2857,75,4,204,185,19,22374,21539,835,92,89,3,100
2c37d83816a38677ba5eb95faa6e97909851dc59,0,0,0,0,0,0,0,0,0,0,0,0,0,0,107,3,0,0,0,0,0,0,0,0,0,100
cb1cd1f80332b449000f28913e6086aea7fa1356,1,1,1,0,0,0,0,3,6,75,1,1,0,541,6,2,97,97,0,3838,3838,0,25,25,0,100
2cf239a2139af8941fee0c0307d5897cebd4dc07,0,0,0,0,0,0,0,0,0,0,0,0,0,0,108,1,0,0,0,0,0,0,0,0,0,100
d9cc5c9fd0f930d3fad74c6427aef1bfcda408f7,0,0,0,0,0,0,0,0,0,0,0,0,0,0,109,2,0,0,0,0,0,0,0,0,0,100
2492be15d2140658e7aca39c78d4719659992553,2,118,16,102,0,0,0,4,23,64,1,2,0.958462584,6537,110,3,831,826,5,54948,54361,587,331,328,3,100
4e6305e891442e55db6e9c0e463f789a53959b6a,4,29,29,0,0,0,0,2,14,133,2,3,1.471070728,2545,7,2,316,316,0,19802,19802,0,133,133,0,100
aefaa029dcb532fe3fd1740efa255a90ef63da35,2,6,2,4,0,0,0,4,22,131,1,1,1,1705,111,4,292,292,0,13856,13792,64,56,56,0,100
6b078d8720a00df765d45a1789c80f4bbbb191c7,0,0,0,0,0,0,0,0,0,0,0,0,0,0,112,5,0,0,0,0,0,0,0,0,0,100
d6122850313c731de76a0d682bece2920a2aed2a,6,9,9,0,0,0,0,8,21,161,1,1,2.281036113,363,28,0,36,36,0,2507,2525,18,22,22,0,100
2fc3374b958c728df133befae428186d2824240e,14,786,0,786,14,0,14,1,1,0,1,2,3.560865263,0,29,1,42,0,42,1378,0,1378,27,0,27,99.08256881
1fbb0aa4177cf80760f6b16952d4eb67265c50a7,4,50,6,44,0,0,0,6,74,88,2,3,1.619781601,1978,113,5,235,227,8,15077,14904,173,59,58,1,100
65eceff0863bc1a06a5c09c62b46e97675ca7421,3,372,27,345,2,0,2,1,5,85,1,2,1.39342471,90,114,6,35,17,18,2175,590,1585,17,7,10,99.81867634
e38d8b017d046174c8c056c58fcf03762a669773,0,0,0,0,0,0,0,0,0,0,0,0,0,0,30,2,0,0,0,0,0,0,0,0,0,100
44ada78c356aa70c875357472a6711e80acc905a,2,26,13,13,0,0,0,1,4,330,1,2,0.999525689,148,115,6,33,32,1,1047,1003,44,16,15,1,100
b31210701ab73eda7cd0ac53097f9963c3bc0e64,1,1,1,0,0,0,0,2,6,19,1,1,0,79,31,3,14,14,0,492,492,0,7,7,0,100
c7c5df28628049932db7f75e1b970bffe75522ae,5,212,0,212,1,0,1,4,23,89,2,5,1.802520559,2295,116,2,346,329,17,20064,18924,1140,83,78,5,99.8794091
e90ab35db32e34eb359f39cd94a9ca48b8c7aeda,6,1023,20,1003,0,0,0,5,24,98,1,4,1.02577664,24256,0,0,5184,5004,180,192178,186308,5870,2565,2471,94,100
8315949073ebca169ef18791a3e750cbfdfbb252,1,13,17,4,0,0,0,7,13,797,1,1,0,88,1,1,11,11,0,608,608,0,5,5,0,100
a7b68f62c5dfa7f8a2a3b81772d1d279962ecbc7,14,427,34,393,1,0,1,2,23,2281,2,6,2.645503621,2676,8,0,481,442,39,21860,19724,2136,180,161,19,100
2c9a927a9e87cba0e4c0f34fc0b55887c6636927,3,188,7,181,0,0,0,2,75,80,2,3,0.415065413,1111,32,1,133,125,8,9813,8999,814,25,23,2,100
74676535b066b48939ae9ad9c1a1061986450f3d,3,41,0,41,0,0,0,5,25,37,2,3,1.065805532,6842,76,0,837,833,4,56930,56645,285,335,334,1,100
170b0c38b5e9011cb739f1ebf01eb68424685ff9,5,96,2,94,0,0,0,4,26,86,1,3,1.434137608,4526,9,0,766,758,8,34090,33670,420,286,283,3,100
542e984ba844b33d452e80946b87ae3cefde4be6,2,102,1,101,1,0,1,1,4,209,1,2,0.844099172,83,10,1,26,19,7,968,516,452,8,5,3,99.9397953
985b7088742906b266f0c1af393916e1d58ddd0e,2,172,1,171,0,0,0,2,27,25,2,2,0.690832039,3818,33,0,697,694,3,29308,28502,806,255,252,3,100
bd0583db9d52cfc03e8c75a3ac1eaac8fd535695,1,3,4,1,0,0,0,3,5,258,1,1,0,372,11,2,57,56,1,2526,2520,6,24,24,0,100
a7550a0b6d4ac158e45274c51a89e536d5f0e42f,4,319,23,296,0,0,0,2,28,109,2,3,0.689326665,7592,34,1,951,939,12,63975,62669,1306,386,382,4,100
6734686acf9345c7adb5604bd48b1561fc71194b,1,1,0,1,0,0,0,2,4,884,1,1,0,343,117,0,74,73,1,2543,2540,3,10,10,0,100
8e0505703eaf7c75c268593f5f31a3e66bb04a56,11,763,890,127,2,0,2,5,36,209,3,7,2.364835561,9748,118,1,1338,1329,9,79796,80717,921,475,464,11,99.93986771
4e473e9d3965c28d9b120776e48c0d4593d719b2,4,74,6,68,0,0,0,2,37,113,3,4,1.082425954,2005,35,2,282,281,1,15488,15175,313,81,80,1,100
5d4465284b7b80e2683d162e462ff546fbfac7a6,4,216,175,41,0,0,0,5,30,8,1,2,1.155749442,6624,12,3,807,811,4,55533,54861,672,335,335,0,100
d4c622845b9d32f214d1704e81fe443ce8c63290,3,26,8,18,0,0,0,1,25,744,2,3,1.327218537,613,119,2,106,104,2,4173,4143,30,58,57,1,100
12429f12578be31f58bf5a30cc133119b38b7678,10,23,0,23,0,0,0,8,12,1657,2,3,3.294663586,459,120,3,55,55,0,1902,1752,150,40,40,0,100
374d55a62f402c375779163ad3fe0aff0753fe83,2,39,5,34,0,0,0,5,31,22,1,2,0.632130278,6274,77,0,796,796,0,52725,52552,173,328,327,1,100
987c692d66dbada1f898e28118214289a11ce73e,1,33,46,13,0,0,0,4,8,554,1,1,0,345,121,2,46,47,1,2382,2467,85,15,16,1,100
0a609faba761daa62a330cab5e2c74d70105419b,1,8,1,7,0,0,0,5,10,590,1,1,0,130,13,0,23,22,1,936,885,51,10,10,0,100
aeeb8ab5aaa749a12f43fcf639f95846985112e0,1,21,3,18,0,0,0,3,3,347,1,1,0,76,122,0,16,11,5,484,384,100,7,5,2,100
ea7a33b77cb5ea6a26477289f594358c780a6e4b,18,754,402,352,10,0,10,1,6,113,1,5,3.449220422,1171,123,1,165,144,21,9132,8034,1098,71,55,16,98.80774963
7a43209685506b8b8a869bab00086d367a524ebf,8,217,31,186,0,0,0,6,19,1395,4,7,1.864868333,2560,78,0,272,260,12,24705,23594,1111,114,108,6,100
097cf0b05d52c291868debfb2a52afa02aa32eca,9,279,129,150,0,0,0,2,26,317,3,8,2.270895974,4424,79,1,801,777,24,36479,35533,946,263,259,4,99.91126886
41b090fbe578f5e3cab4907883bc39dba50cee1d,4,20,0,20,0,0,0,4,32,133,1,3,1.883383098,4271,14,0,683,682,1,32765,32685,80,269,268,1,100
d7fe398693ac5bfc9e450c27e9afdc9d9de3dd62,7,293,74,219,0,0,0,5,33,208,2,5,1.955307089,6851,80,2,894,872,22,57371,56320,1051,381,370,11,100
afdf7bd5cc4163c658b5ac577a5203015f00357b,1,0,1,1,0,0,0,7,35,336,1,1,0,843,15,1,100,100,0,6564,6573,9,33,33,0,100
5bfa963b76db3f3ae08c63767627e739d0dbbf01,2,4,7,3,0,0,0,2,8,373,1,2,0.945660305,907,16,2,106,106,0,6758,6794,36,34,34,0,100
3ba5998b87595ea158d1d3b71b00cbcdb4092a0a,14,1131,186,945,4,0,4,2,11,532,2,7,3.01338307,2380,124,0,477,411,66,22071,17204,4867,221,184,37,98.2232751
365e73b09c8b95c510250866a11039fde77a5039,3,232,0,232,0,0,0,5,34,106,1,2,1.102337868,6500,81,0,809,797,12,55899,54639,1260,337,333,4,100
b398a721fe0051e81b02ea2bee84758cf202845b,1,2,0,2,0,0,0,2,2,135,1,1,0,56,17,0,3,3,0,316,313,3,1,1,0,100
9a1f1be9022313eef3e586da76a894ba2110ba9a,0,0,0,0,0,0,0,0,0,0,0,0,0,0,72,0,0,0,0,0,0,0,0,0,0,100
447e643fd55ff193f544341e0341fd909f818f34,1,20,32,12,0,0,0,2,4,715,1,1,0,121,18,1,19,22,3,721,760,39,9,9,0,100
6bfd755ced7a402eb564c15048b21f04910a144b,1,22,0,22,0,0,0,7,10,773,1,1,0,186,36,0,39,38,1,1177,1139,38,21,21,0,100
63f7f8939bc9a02272a4033b07ee4cb95d8d4785,3,20,7,13,0,0,0,7,36,466,2,3,1.279974914,1891,37,1,135,135,0,16006,15938,68,64,64,0,100
72ac123228cb059ff5448df86ca46f1a33a6748e,2,55,9,46,0,0,0,5,35,32,1,2,0.785560292,6475,19,2,810,809,1,54817,54453,364,338,337,1,100
1b8127eab26fa2fc146f13663e056b8f4f5409d0,3,24,9,15,0,0,0,4,8,1136,2,2,0.760732746,1219,20,3,221,220,1,9338,9287,51,48,48,0,99.94072318
0067d477ff83970246f81ed5badd738e9d0f8319,7,188,11,177,0,0,0,8,69,1189,2,5,1.968233571,3085,38,2,413,387,26,25746,24763,983,119,115,4,100
677656fddacb628315f0c6aa8bbf1442be246917,4,100,30,70,0,0,0,3,20,388,2,3,1.038740141,918,21,3,128,124,4,6766,6370,396,46,46,0,100
27ad7a74d7511b0ca0375031894ee565b3323316,7,111,34,77,0,0,0,4,17,1065,1,3,2.253909569,1567,82,0,389,382,7,11773,10932,841,134,131,3,100
3edbd2e8c239e6eb148722043033202346bbe66e,2,25,1,24,0,0,0,5,12,614,1,2,0.391243564,230,22,4,32,30,2,2350,2125,225,18,16,2,100
8701ac1d256505d8bc67ac3f8d4aaa5766bc2cd3,6,73,12,61,0,0,0,5,36,96,1,3,1.927908114,7564,83,1,1005,994,11,62592,62293,299,406,406,0,100
6842d1da7d57922dd81c1bd0e2469237666e7f35,6,52,28,24,0,0,0,10,76,791,4,6,2.19760259,1838,23,4,366,368,2,13722,13512,210,89,88,1,100
a9326c813ace760b01c19c0ef52a7531cee0dfbb,1,3,2,1,0,0,0,2,5,438,1,1,0,72,24,5,12,12,0,477,470,7,4,4,0,100
6b070c55341a4a62ae2619d51ce87892056a7351,2,73,23,50,0,0,0,3,10,95,1,2,0.997180399,912,2,0,109,108,1,7099,6804,295,35,34,1,100
d818793374978f07c02b818a8a2ec23572e2c707,8,1908,0,1908,2,0,2,3,27,222,1,4,1.760252909,20244,3,1,4923,4559,364,162538,151382,11156,2516,2339,177,99.88158674
83c9748ebf03eb552f1d7287c69bdad5b8e24c17,2,96,2,94,0,0,0,15,37,408,2,2,0.40790598,4816,25,4,739,735,4,38427,37718,709,276,274,2,100
d5acd57fab39c9dc0edd269a16d2cb15a7a5f4c4,9,1226,96,1130,4,0,4,1,10,679,2,3,2.272551219,977,84,2,185,121,64,14149,7547,6602,93,60,33,99.6171967
a00cc807728f02329f332b4f8d052de11ae85900,1,1,1,0,0,0,0,9,16,27,1,1,0,750,85,3,207,207,0,5133,5133,0,72,72,0,100
33db3ca694a58e9bd85f5f9303627172f8b277e2,8,367,48,319,0,0,0,8,70,749,2,5,1.656016995,2097,39,0,249,234,15,18608,16414,2194,117,110,7,100
312add87b8aeeba0cf5876cf77604b7451e98158,2,56,8,48,0,0,0,7,11,125,1,1,0.912999214,608,40,1,102,98,4,4656,4345,311,47,46,1,99.43969331
850b82b514082059eb440c075fef7b5e65f15f02,3,68,7,61,0,0,0,5,17,207,2,3,0.982491386,1467,86,2,267,263,4,10941,10504,437,97,96,1,100
2005d56bb868e2913bacbaa28eaf10454496cc70,1,4,5,1,0,0,0,4,7,456,1,1,0,244,87,3,52,50,2,2046,2007,39,14,14,0,100
9820281569d0da85db58c8de06a18a99efd09b8b,12,1936,0,1936,11,0,11,1,6,2,2,3,3.132784517,186,88,4,215,16,199,12097,1841,10256,98,11,87,99.26492208
6aaacd957df1c005e00064cc2e8c5c7d3fff99bc,1,6,4,2,0,0,0,2,6,62,1,1,0,73,26,0,12,12,0,493,477,16,4,4,0,100
f859446b65bbc274bc4899464892151eec8217c6,3,233,11,222,0,0,0,5,38,68,1,2,1.052058159,6714,41,2,873,857,16,57653,56233,1420,367,361,6,100
505b42e81a9d85c4ebe8db3f48ad7a6e824a5db5,1,104,41,63,0,0,0,10,18,102,1,1,0,757,27,0,241,210,31,5425,5157,268,72,72,0,100
148ba6c225ac785844476213f3d70ccbf637e9ba,6,2423,2,2421,2,0,2,5,28,263,1,3,1.964669453,19650,4,0,5032,4565,467,161923,146977,14946,2541,2349,192,99.53501889
b71a78ed960702536b35e1f048dc40dfc79992d4,2,71,52,19,0,0,0,5,20,4,1,2,0.461216041,1252,5,1,151,147,4,10898,10765,133,72,72,0,100
941ce0443de53938d7f9085a05ab928fd4c180b1,4,85,21,64,0,0,0,13,77,850,2,3,1.141533278,1677,28,0,246,238,8,13087,12731,356,47,47,0,100
943b3e00ba4771e4005bc7eb25014b8bc640f0c8,1,3,3,0,0,0,0,3,7,459,1,1,0,405,29,0,61,61,0,2866,2845,21,24,24,0,100
be2e6e8ee17bc9e50bf55f39fea94c3826c64f44,14,353,106,247,1,0,1,4,8,2942,2,4,2.72549677,1202,89,0,182,142,40,11237,9376,1861,93,79,14,99.94212963
8b536800d20b70b6aa286cb1e7c6decec645a6af,4,112,11,101,0,0,0,5,20,2043,2,4,1.727931288,928,42,0,132,123,9,8234,7421,813,47,41,6,100
75392e87a9f2e91410702475a0153b1795ecab2f,1,3,2,1,0,0,0,6,11,1136,1,1,0,137,90,0,23,23,0,940,936,4,10,10,0,100
f5dbc69b5c0ff6cae2606e58efd204df754e5232,2,4,2,2,0,0,0,14,29,744,2,2,0.918295834,625,91,1,62,62,0,3735,3724,11,23,23,0,100
1a2a1ecb237dc2ef3c1e7d0ad11c36c1c374cd89,5,154,10,144,1,0,1,1,71,547,2,3,1.877886501,1176,43,0,184,172,12,8933,8194,739,61,56,5,99.85561652
843368fc2aeb154f9cf7b18d191c128644295ce5,37,1511,299,1212,6,0,6,9,72,1891,5,23,3.957397827,7014,1,0,1053,900,153,60558,52748,7810,418,361,57,95.0220022
f5cad4fb15fa9b3aaf9d691e2df3065860b11353,7,233,20,213,3,0,3,1,73,0,3,5,1.939876369,2073,44,1,354,336,18,18066,16760,1306,108,98,10,94.22263974
e2dd73d995be51f237cce3ae8240cc8c3407e820,0,0,0,0,0,0,0,0,0,0,0,0,0,0,92,0,0,0,0,0,0,0,0,0,0,100
dd51db4431cd63df26d72779421a61f785f183bf,1,35,34,1,0,0,0,5,39,1526,1,1,0,3194,93,0,628,627,1,23782,23767,15,235,235,0,100
ae2e91fd2e06ba6c2fedd5e5d6efdea164daf176,2,47,3,44,0,0,0,5,40,763,1,2,0.981453895,6708,45,0,831,827,4,56584,56414,170,346,343,3,100
