CommitID,NMF,TotalAddLines,TotalDeleteLines,LC,FileAdd,FileDelete,NAD,NDEV,NUC,AGE,NS,ND,Entropy,LT,EXP,REXP,CommitComplexity,LastCommitComplexity,CFC,CommitTokenCount,LastCommitTokenCount,NCC,CommitMethodNum,LastCommitMethodNum,NMC,a2a
c8aabc11f13e2225334b0022efe5e198615dc285,47,2704,1494,1210,28,0,28,1,1,0,4,17,4.990266002,1253,0,0,244,267,23,11020,9136,1884,139,115,24,3.846153846
e1df983cac89e612db7192a718cc819816bf95b1,49,1570,2704,1134,21,0,21,0,2,0,4,17,5.075078932,1527,1,1,274,244,30,9660,11020,1360,119,139,20,5.504587156
52460fa99bbd5b40dd2718ee1b20fde6584b21aa,21,369,8,361,0,0,0,1,3,0,1,5,4.391363332,1312,2,2,274,274,0,9660,9660,0,119,119,0,100
7a33946d5c3f13eaefca2dbf66aa3739ea602229,10,798,26,772,6,0,6,1,4,0,1,3,2.566993171,461,3,3,178,80,98,7820,3806,4014,63,28,35,82.40740741
4c1f4c8f97e04ca9bfa00c361f86ed568f443e92,15,703,391,312,8,0,8,1,5,0,1,4,2.611059527,735,4,4,145,132,13,6241,5450,791,55,42,13,84.7826087
4128b89eb1e1f48cc3b1e50241b2a131548bc795,3,74,6,68,0,0,0,1,5,0,1,1,1.12087997,201,5,5,13,13,0,1762,1600,162,13,13,0,100
5273b41f502ea19b9b049e190810e46cd3f4ac13,62,2710,3050,340,25,0,25,1,2,0,4,17,5.440974774,2072,1,1,253,385,132,11598,14655,3057,143,167,24,7.042253521
040ee99cb74645fc570747c68c22c91a91358d83,67,3484,2824,660,32,0,32,0,6,0,4,17,5.529914766,1635,6,6,484,263,221,18043,11956,6087,205,153,52,7.947019868
8936008d41a09cb9f9d665fb00e61b9f3a065651,65,2616,3572,956,25,0,25,1,3,0,4,17,5.520568491,2481,2,2,247,484,237,11039,18005,6966,140,205,65,7.947019868
5279a71cc0b4baa145b7896fe90edf1b26bcf1c8,6,317,11,306,4,0,4,1,4,0,2,3,2.278189066,143,3,3,42,15,27,2886,1020,1866,36,11,25,89.43661972
b8feeebf7a191601d05fd2a44961f230fc47b5eb,71,3611,3036,575,32,0,32,0,6,0,4,18,5.597788118,1815,7,7,499,284,215,18955,13263,5692,216,175,41,14.94252874
37ec473dd22b2f945183c034ab96183cece49b32,3,112,33,79,0,0,0,1,6,0,1,2,1.297355534,810,8,8,144,138,6,6319,5862,457,57,54,3,100
f09a14be116ed1a1e7320d0424baa4e97b91a993,9,257,146,111,0,0,0,1,7,0,1,3,2.823161179,892,9,9,160,146,14,7802,7145,657,49,44,5,95.05494505
71ac0a94ece496b07d7f5600f8c1677df8618e29,71,3048,3889,841,31,0,31,1,5,0,4,19,5.621894135,2752,4,4,285,519,234,13608,20031,6423,174,224,50,6.097560976
978acb672d22592c664a982c9f60b1bed8b34284,80,4095,3162,933,39,0,39,0,7,0,4,21,5.733097504,1912,0,0,524,295,229,20909,13966,6943,229,184,45,8.839779006
806b9aed7e89708412cba246553d199439642205,78,3048,4183,1135,31,0,31,1,5,0,4,21,5.719519674,2957,0,0,285,524,239,13608,20871,7263,174,229,55,8.839779006
2d335d555ee950f1725c4948c66fa87aca802ffd,80,4095,3162,933,39,0,39,0,7,0,4,21,5.733097504,1912,10,10,524,295,229,20909,13966,6943,229,184,45,8.839779006
d3e60d7148e583e310b69415161e657fa84143d9,15,541,126,415,5,0,5,1,7,2,1,3,3.264370449,1058,11,11,269,226,43,10431,8364,2067,98,67,31,80.39215686
ec4e5b67adfcbc613ab33eb23b5252dfa776c3f2,0,0,0,0,0,0,0,0,0,0,0,0,0,0,12,12,0,0,0,0,0,0,0,0,0,100
14281eea1d8a409c74a2ce41a51b3d375ba7f3f3,0,0,0,0,0,0,0,0,0,0,0,0,0,0,13,13,0,0,0,0,0,0,0,0,0,100
232a95c6465a0003d482563c971b8346f683cde0,7,465,10,455,3,0,3,1,8,2,1,4,1.986471146,339,14,14,163,69,94,5386,2781,2605,58,32,26,80.55555556
e05c8845b67b782806730c47bc2bfbff986df16e,14,414,73,341,2,0,2,1,6,4,1,3,3.340372625,1100,15,15,324,287,37,9572,8384,1188,118,109,9,82.53968254
4d6019076c91b0922410bfdafa238fd4115bec10,2,14,3,11,0,0,0,1,7,2,1,2,0.997502546,206,16,16,63,61,2,1633,1575,58,23,21,2,100
745db5cba5d63053ea4415da61c6c73a81ac9806,55,0,0,0,0,0,0,1,1,0,1,7,0,3797,17,17,710,165,545,27161,49170,22009,299,165,134,30.44982699
6d1cb9821a1ba58dac6ac673428764caa172e3cd,35,3142,0,3142,35,0,35,1,5,0,3,14,4.847997093,0,18,18,285,0,285,13608,0,13608,174,0,174,71.68367347
34941a4f55f975f2548414699189d3bf492caa2d,0,0,0,0,0,0,0,0,0,0,0,0,0,0,19,19,0,0,0,0,0,0,0,0,0,100
4139050e2bd02f9a16c69422c3b8c72a76c7ca71,4,15,0,15,0,0,0,2,3,14,1,1,1.921928095,471,1,1,68,68,0,3489,3489,0,33,33,0,100
77030a8c5a2d163b4c3f6f2028d5f1f8aa2c2add,57,274,214,60,2,0,2,1,2,0,1,9,5.509696868,3797,20,20,710,162,548,28284,48365,20081,299,162,137,45.34313725
0a208d18895103e434d7059921fb9d66ed6d6b83,1,134,0,134,1,0,1,1,1,0,1,1,0,0,21,21,2,0,2,639,0,639,2,0,2,96.03960396
6c00ad96958046b505e865b8b99fc5451618e16d,6,1055,27,1028,0,0,0,1,2,6,1,4,1.743976,878,22,19,405,211,194,12875,6523,6352,202,81,121,98.03921569
bf00ea9141f018831d516684ddf53978184fe3e9,5,168,30,138,0,0,0,1,3,6,1,1,1.933510539,645,23,20,153,129,24,5825,5018,807,105,92,13,98.28850856
2810310f2c4d7752fbb37a83b274726a39ca5ed2,8,236,65,171,1,0,1,1,4,3,1,3,2.594593144,937,24,21,192,164,28,8271,7361,910,132,116,16,96.74418605
546efae9625889c67293a3759ccc5156df6ffd63,7,57,37,20,0,0,0,1,5,2,1,4,1.989908298,1096,25,22,257,251,6,8444,8272,172,159,159,0,100
82209db0f4d9b8f711f24be35b9ff34eb9367fdf,4,113,11,102,2,0,2,1,5,0,1,1,1.672308859,299,26,23,65,56,9,2433,1993,440,30,23,7,96.37188209
9cdc25eefacd64f63e1a8190e1db5c23582e594c,3,939,0,939,3,0,3,1,1,0,1,1,1.532324016,0,0,0,131,0,131,5427,0,5427,72,0,72,98.39816934
7dc5d3f0cd8ac47a2086c49fe589c18085feecf0,0,0,0,0,0,0,0,0,0,0,0,0,0,0,0,0,0,0,0,0,0,0,0,0,0,100
1bb33f9724394552432b2ef8e716b658cedc68a1,0,0,0,0,0,0,0,0,0,0,0,0,0,0,1,1,0,0,0,0,0,0,0,0,0,100
0c46cbad4f524114b6dcea7bb0795870602a2d6e,0,0,0,0,0,0,0,0,0,0,0,0,0,0,2,2,0,0,0,0,0,0,0,0,0,100
b5bd9d1aa1db5ac9b582468f8bd3f4fa2ca80285,10,356,14,342,1,0,1,1,6,1,1,4,2.527285296,1137,27,18,311,256,55,10615,8568,2047,183,164,19,97.99554566
733101c8046db808873f483835b09daf8618feb2,9,432,2,430,3,0,3,1,7,8,1,4,1.641566532,2416,28,19,591,553,38,20991,18565,2426,265,244,21,97.35099338
3fe82d569651c95e21d069c267c67448bbce916a,1,51,0,51,0,0,0,2,4,50,1,1,0,98,0,0,17,17,0,950,589,361,13,13,0,100
de47ef0217f8aae7676385f2b0f7011f10e14669,1,3,0,3,0,0,0,2,5,0,1,1,0,129,1,1,17,17,0,956,950,6,13,13,0,100
16cd0767cbb7821348fceca942b837fd74f98fc6,0,0,0,0,0,0,0,0,0,0,0,0,0,0,29,19,0,0,0,0,0,0,0,0,0,100
f98781732d235f639c2e689bdecf7cdb40a31273,1,2,2,0,0,0,0,2,2,55,1,1,0,52,2,2,10,10,0,326,326,0,10,10,0,100
b06c7fe991136dc296abdf8eb6ca23b19ba4cdc4,1,1,0,1,0,0,0,2,3,0,1,1,0,52,3,3,10,10,0,326,326,0,10,10,0,100
c28f14942087e933ba84b6af7e8133e4c1917bc3,1,0,1,1,0,0,0,2,4,0,1,1,0,52,4,4,10,10,0,326,326,0,10,10,0,100
cbecec830ca474e40eb85403955337a890a5a031,0,0,0,0,0,0,0,0,0,0,0,0,0,0,5,5,0,0,0,0,0,0,0,0,0,100
b8eecb202363ddbdac38e5f5bf1535297188bb24,0,0,0,0,0,0,0,0,0,0,0,0,0,0,30,16,0,0,0,0,0,0,0,0,0,100
f8356cb5b095aed1180f3f7bba42d96f860b20a8,0,0,0,0,0,0,0,0,0,0,0,0,0,0,31,17,0,0,0,0,0,0,0,0,0,100
1143f69df5bd1ca2ac24175644cd4e044d1e9014,3,170,41,129,2,0,2,1,4,17,1,2,1.236360435,49,2,0,19,8,11,653,343,310,13,2,11,98.21826281
112dffb023693252f6a9c342a57616602fae2de9,6,193,10,183,1,0,1,1,4,27,1,1,2.489484342,924,32,10,252,210,42,7250,6435,815,111,96,15,99.33035714
d14e0e10ef7876179689450ef6106c97540a971d,0,0,0,0,0,0,0,0,0,0,0,0,0,0,0,0,0,0,0,0,0,0,0,0,0,100
b8308a31ee67b567644d469d3b8e359b878b0a34,3,0,0,0,0,0,0,1,1,0,1,1,0,698,1,1,131,42,89,5427,4275,1152,72,6,66,97.33333333
98d436c214e599f1bdd6c0c3b51f8244a119f6fc,10,36,300,264,3,0,3,2,2,35,2,3,2.435728073,211,2,2,2,5,3,141,956,815,2,5,3,93.12638581
7f08d5549441d5d135530ff2a9befbb2d89be205,10,300,36,264,7,0,7,1,1,0,2,3,2.435728073,22,3,1,5,2,3,956,141,815,5,2,3,93.12638581
003b5a52e14b237d6ce13d53c8f3f1f0795f45e1,0,0,0,0,0,0,0,0,0,0,0,0,0,0,33,10,0,0,0,0,0,0,0,0,0,100
c1995379fb6905d3c1bd4bc0179775e68cb3c917,2,5,3,2,0,0,0,1,2,50,1,2,0.811278124,209,34,11,63,61,2,1771,1755,16,14,14,0,100
d1335fc9f9fb85462d5111e46c0deafefdadc992,1,74,51,23,0,0,0,3,6,26,1,1,0,130,0,0,25,17,8,1073,956,117,14,13,1,100
21197b678f3be35c2228c12b814b8f2fbc9a9780,5,169,89,80,0,0,0,1,5,0,3,4,1.613202504,751,1,1,167,158,9,5692,5255,437,93,86,7,100
d12cca6d04007c7f91aa457149dba3acb962b640,3,79,54,25,0,0,0,1,6,42,2,3,0.376840251,339,2,2,88,78,10,2844,2711,133,28,27,1,100
b9cae771802d84b8fa41e3f823848f19e947d529,19,388,494,106,7,0,7,1,5,14,4,8,3.429804734,1055,3,3,192,182,10,7237,6781,456,97,99,2,90.13157895
1643827eb003ac199cf0bb4e525e039abffc50e3,3,79,54,25,0,0,0,1,6,42,2,3,0.376840251,339,4,4,88,78,10,2844,2711,133,28,27,1,100
82aa80c04445f8abefa12a6adaf0eead74381585,2,115,10,105,0,0,0,2,2,2,1,1,0.866123681,390,3,3,89,70,19,2981,2411,570,66,58,8,100
ba14612a2dfc66087d7febeed616b28444106dcd,3,3,0,3,0,0,0,2,3,1,1,1,1.584962501,791,4,4,150,150,0,5997,5997,0,80,80,0,100
13aa58b66d596587ced3efde6132e2c0ba0f89dc,1,1,8,7,0,0,0,3,4,0,1,1,0,241,3,3,25,25,0,1814,1871,57,2,2,0,100
798860f4dc2f539974587008a2ed0c640a6d4891,0,0,0,0,0,0,0,0,0,0,0,0,0,0,4,2,0,0,0,0,0,0,0,0,0,100
a3ac80fefaf517625ae37fff8329c5a69c163575,0,0,0,0,0,0,0,0,0,0,0,0,0,0,0,0,0,0,0,0,0,0,0,0,0,100
3291e928450b96e72392967b0fc6b06aaff557e5,0,0,0,0,0,0,0,0,0,0,0,0,0,0,5,3,0,0,0,0,0,0,0,0,0,100
385adc5f892ef33813597452eacc15b5b3ff6fcc,4,13,7,6,0,0,0,1,7,31,1,3,1.846439345,1038,35,8,196,194,2,6652,6603,49,94,93,1,100
46e6d18dd45cc2802001cd163d788d3b2f58dd25,0,0,0,0,0,0,0,0,0,0,0,0,0,0,6,4,0,0,0,0,0,0,0,0,0,100
959bb8087fb1cf14bdb429e9f1fa81c309a54ab8,0,0,0,0,0,0,0,0,0,0,0,0,0,0,36,9,0,0,0,0,0,0,0,0,0,100
0afaaa5eb8404051ff7b41efd1e72b67b110f06d,0,0,0,0,0,0,0,0,0,0,0,0,0,0,7,5,0,0,0,0,0,0,0,0,0,100
402e36803228a2c88abde3a4cdf9478904eb0f6c,0,0,0,0,0,0,0,0,0,0,0,0,0,0,8,6,0,0,0,0,0,0,0,0,0,100
34e7f58ac4bfe2454603d477778fabc9da8f32d0,0,0,0,0,0,0,0,0,0,0,0,0,0,0,37,10,0,0,0,0,0,0,0,0,0,100
e0423116dd67d2d417a17d8acfa9b3289341521f,2,0,130,130,0,0,0,2,2,72,1,1,0.997266543,105,9,7,0,7,7,0,838,838,0,5,5,98.03921569
3c3507801dacf8096fe1fab5adf1d29da63f6d99,4,148,9,139,2,0,2,1,8,12,2,3,1.553476992,363,38,10,91,82,9,3126,2249,877,57,51,6,98.03921569
639671ca5def707ea40539b0fc3c91480a87871f,17,1016,97,919,5,0,5,1,9,35,3,9,3.022301883,946,5,0,229,139,90,10701,6809,3892,126,86,40,93.11064718
7b20569753a425a33c272a8d5ac566e42f481869,0,0,0,0,0,0,0,0,0,0,0,0,0,0,39,11,0,0,0,0,0,0,0,0,0,100
c1af145602d97c724645f69a6d64dbbf11532f57,31,657,1409,752,8,0,8,2,7,22,3,11,3.988680529,2067,10,8,254,334,80,11026,14723,3697,160,185,25,89.5049505
36e8243a1710adbcd1f51d009499715ac8c4376a,32,1426,657,769,7,0,7,1,9,16,3,11,4.024468635,2000,40,11,405,323,82,17831,14022,3809,219,193,26,89.5049505
fb2207c0ee46f343bb553b7372dd8aff63025cb2,0,0,0,0,0,0,0,0,0,0,0,0,0,0,41,12,0,0,0,0,0,0,0,0,0,100
935d30f7321a5a86b17348d09b10e32599357686,33,675,1435,760,8,0,8,2,7,19,3,12,4.071777447,2556,11,9,330,412,82,14834,18589,3755,199,225,26,89.5049505
e3073d897b7536709a07e90eb05c302ecf00db9a,0,0,0,0,0,0,0,0,0,0,0,0,0,0,12,10,0,0,0,0,0,0,0,0,0,100
5db2e582b56d66ae58b5f0541498c0f839031dad,0,0,0,0,0,0,0,0,0,0,0,0,0,0,13,11,0,0,0,0,0,0,0,0,0,100
a56bf342f8c76db5ae9076b642e9c4c578eedc42,1,4,2,2,0,0,0,1,2,6,1,1,0,11,14,12,1,1,0,83,66,17,1,1,0,100
caac858f4218a9b2c3e9e742c3dd2ff5268eb233,15,106,537,431,0,0,0,2,8,27,3,7,3.298344738,821,15,13,62,95,33,3925,4901,976,47,71,24,92.36947791
faf0b48b3b33f78b86fd9cbe4edf7e173d89e81a,41,1927,738,1189,13,0,13,1,9,8,4,14,4.492952228,2097,1,1,449,321,128,20119,14891,5228,249,189,60,84.98985801
96350bdabe43867bc7a76d215ef7dd3865eee78d,40,718,1907,1189,8,0,8,2,8,15,4,14,4.405063868,2807,1,1,321,449,128,14891,20119,5228,189,249,60,85.59837728
34cdef44d8e58bc646f6ce97469d0a8e5c7f6732,28,2339,1519,820,3,0,3,2,10,9,5,13,3.439486688,2473,16,14,533,441,92,22238,18276,3962,285,242,43,92.85714286
42dee9f32a961730aedd42af149ad3928f400a47,3,10,10,0,0,0,0,1,1,0,1,1,1.295461844,785,5,4,150,75,75,5940,5442,498,80,6,74,97.59036145
29d3299db147d5c72a8316daa7cc9ff1ad3bcee7,1,104,0,104,1,0,1,1,1,0,1,1,0,0,42,10,0,0,0,11,0,11,0,0,0,99.6
255fa079e138602cdc5ea63395de106a5d76cc17,14,451,152,299,2,0,2,1,8,20,3,8,3.080459233,975,6,1,153,133,20,8957,7277,1680,87,79,8,93.77358491
ed517933752e98e2aeb906de300ab601a32e41f5,1,43,3,40,0,0,0,1,2,0,1,1,0,88,7,2,9,7,2,987,687,300,7,6,1,100
0ed96321b2c1acf21bde8d9fe1b626dd84af5a72,1,9,3,6,0,0,0,2,8,0,1,1,0,86,8,3,8,7,1,740,678,62,4,4,0,99.82078853
cd448abe9da7520776c5ccecb000b29e60cc7113,1,18,1,17,0,0,0,1,3,0,1,1,0,121,9,4,9,9,0,1122,987,135,7,7,0,100
e3a2173c9ea40f0b6e7bfb1b6f99d5b5b4b851df,1,1,1,0,0,0,0,2,2,78,1,1,0,29,0,0,3,3,0,185,185,0,3,3,0,100
b1b89a3cb0a0fdf8d50aabb81586a5d17ceb6094,10,8,8,0,0,0,0,1,1,0,1,4,1.061278124,1036,17,15,194,250,56,8087,18140,10053,92,20,72,92.83154122
0c54f27e9d3bc2cecc8e3293616d210531452e7b,0,0,0,0,0,0,0,0,0,0,0,0,0,0,3,3,0,0,0,0,0,0,0,0,0,100
bcfd2e7b381412436c3992b5ac111aa79236b7b3,13,116,75,41,0,0,0,1,10,28,3,8,2.513365352,2782,10,5,529,530,1,21033,21045,12,224,223,1,100
3d274303cac9baa211b0036ef269924f77158bde,0,0,0,0,0,0,0,0,0,0,0,0,0,0,11,6,0,0,0,0,0,0,0,0,0,100
ce7d8e79a05b4dab04860528ceaf4946bfad0af8,16,148,137,11,1,0,1,1,9,5,4,11,3.057255751,3057,4,4,559,555,4,23292,22911,381,227,227,0,97.49552773
f16be50f3a05d60144f3c2eb2a954ce4d429d22b,13,116,75,41,0,0,0,1,10,28,3,8,2.513365352,2782,5,5,529,530,1,21033,21045,12,224,223,1,100
3b68cbdaadc8900ccc9aa061bd9baa193150b6cf,0,0,0,0,0,0,0,0,0,0,0,0,0,0,43,10,0,0,0,0,0,0,0,0,0,100
76fcba1a59223f762eddab9d722f369949e9be17,0,0,0,0,0,0,0,0,0,0,0,0,0,0,44,11,0,0,0,0,0,0,0,0,0,100
8285e3b99319394675038b753745c0fcd9cf05fd,12,160,122,38,1,0,1,1,7,23,2,6,2.68950009,2158,45,12,364,368,4,16186,15870,316,148,149,1,95.89552239
386d8d3862c7275ae26c82b1bdf3835b49389ca1,8,566,302,264,0,0,0,1,9,2,2,4,1.461297393,870,12,7,159,125,34,8610,6830,1780,70,64,6,92.76190476
ea38da100488af30296212dbd9b0dfa603f2aa23,20,304,197,107,3,0,3,2,9,2,2,11,2.93295411,1726,13,8,255,302,47,12954,15296,2342,125,177,52,87.36263736
1d1531ef67885da8f168f67bc1fb3576de11820c,3,89,0,89,0,0,0,4,7,6,1,3,1.320039353,597,46,12,107,96,11,5078,4549,529,32,30,2,100
be7c4cb6a024cd159a611cd74d79a75fc411644a,3,267,164,103,0,0,0,2,6,4,2,2,1.358528683,728,14,9,123,120,3,6291,5695,596,40,37,3,100
7da5e03f87a848303dd332784386d816d6159820,6,141,48,93,0,0,0,2,10,5,2,4,2.015205732,1095,15,10,164,156,8,8931,8346,585,63,60,3,99.64285714
6e506d7316bcc04cdcab04f20e40323bc3675399,0,0,0,0,0,0,0,0,0,0,0,0,0,0,18,12,0,0,0,0,0,0,0,0,0,100
898e73178b025cbb5ffe7fa42a638b113514a7e9,4,819,1,818,3,0,3,2,8,19,2,3,1.33771932,473,0,0,172,116,56,9644,3921,5723,121,88,33,95.32258065
760b3b9666a8f4ba00613864543fb4bcdee31145,2,542,542,0,0,0,0,1,2,0,1,2,0.507548394,374,1,1,31,31,0,3931,3931,0,27,27,0,100
1f7fe9415cf06f79fb2866c40f96f2043c8df3a5,10,196,26,170,2,0,2,2,9,8,2,7,2.879346153,1311,16,11,218,209,9,10592,9811,781,86,82,4,98.52724595
882c40fa6a08260285919b1cfd15eb61bfd9ef13,2,6,5,1,0,0,0,1,9,44,1,1,0.945660305,545,47,10,127,127,0,4583,4569,14,94,94,0,95.67233385
61079cac67247d56c9ac90fc04d9804d72f07049,0,0,0,0,0,0,0,0,0,0,0,0,0,0,17,12,0,0,0,0,0,0,0,0,0,100
d3db08d22514b91df4318f54683549ce5aea2151,3,49,12,37,0,0,0,2,3,0,1,2,1.085036574,564,1,1,61,55,6,5883,5662,221,36,33,3,100
f5c4dc4cb926a47fdcf2cfdb3d4c06a8168da4b8,1,245,0,245,1,0,1,1,1,0,1,1,0,0,18,13,13,0,13,1634,0,1634,12,0,12,95.1986755
e0699c8f560f68871827193bbfe36f555a23d36a,2,6,1,5,0,0,0,2,4,0,1,1,0.985228136,545,2,2,55,55,0,5545,5459,86,34,34,0,98.99497487
0e9af0174d2aeaa2a1c6b4c94a6b7db1032a1201,0,0,0,0,0,0,0,0,0,0,0,0,0,0,48,11,0,0,0,0,0,0,0,0,0,100
1089e0363ad330a5273b53db1038b506b1f07d22,7,214,61,153,1,0,1,3,6,4,3,4,2.099897346,1849,3,3,331,318,13,17001,15952,1049,107,102,5,98.99833055
54ccb87fb2e66d2454ea5314aa74191dbb80f31e,3,213,5,208,2,0,2,1,3,6,1,3,1.551825494,50,19,9,15,3,12,1460,367,1093,13,1,12,98.49749583
bc7bf44afe8d98e93228a4a8419067bc7d08c781,4,6,5,1,0,0,0,2,5,4,3,3,1.936260028,196,20,10,17,17,0,1621,1614,7,9,9,0,99.32885906
04997e4c3081232cc620a2690437b4a2350b7381,21,357,466,109,4,0,4,2,5,6,4,10,3.672061941,2419,0,0,407,390,17,20081,20611,530,131,132,1,89.05472637
555960a5e46e03b1375d5a24787e9238c594ba48,14,401,128,273,3,0,3,3,6,4,4,9,3.069914351,2239,1,1,423,403,20,19897,18201,1696,189,176,13,95.90163934
2bd124a01396d3a6de6cf581005a61d940b9c700,8,21,20,1,0,0,0,3,6,5,2,6,2.538829287,1192,2,2,230,224,6,8426,8072,354,155,153,2,97.55700326
0f4abad7f3ce12929082a7af1caefc02af0d031a,0,0,0,0,0,0,0,0,0,0,0,0,0,0,3,3,0,0,0,0,0,0,0,0,0,100
f5eef50515c3fb2493df0da20acb33d69e5033cf,19,398,650,252,3,0,3,1,5,1,3,11,3.058916804,1653,0,0,231,314,83,11209,12197,988,116,182,66,89.79238754
55febc443871bb101e5c47341e1a6d5628020d25,17,313,146,167,4,0,4,3,6,8,2,9,3.007831082,1463,4,4,309,208,101,11734,9439,2295,180,104,76,87.82051282
cdb6c314bcdc8ab9891f0da9c42e39255224a30c,22,172,693,521,2,0,2,3,10,2,3,11,3.061042091,1869,21,10,235,340,105,11322,13713,2391,129,209,80,87.09677419
9ec7ad376ce3675c9526af9e7e949dd1af6353cd,2,12,5,7,0,0,0,4,10,0,1,2,0.997502546,203,22,11,18,18,0,1555,1555,0,16,16,0,100
b0d8bb9048545ed8a4d343bf52fe953ba2b67894,17,313,146,167,4,0,4,3,6,8,2,9,3.007831082,1463,5,5,309,208,101,11734,9439,2295,180,104,76,87.98701299
46667712854d4fbf6f2e397c548ba618a6f42940,23,200,688,488,4,0,4,3,9,0,4,12,3.145267316,2008,1,1,258,355,97,12732,14931,2199,141,213,72,87.09677419
b6d4e0941b76d9f0d0b6321398ccc6e765d370af,5,39,52,13,0,0,0,3,10,19,1,2,2.190831723,272,2,2,27,31,4,1883,1979,96,25,29,4,98.68913858
adca9c0ca61b4bdd17bb8db6f77c780b7dc85759,17,313,146,167,4,0,4,3,6,8,2,9,3.007831082,1463,6,6,309,208,101,11734,9439,2295,180,104,76,87.98701299
953ceabb498ba201f2683c8145e92a62127a8fb2,10,134,88,46,2,0,2,1,3,0,2,7,2.716425213,405,7,7,59,57,2,3556,3346,210,30,27,3,94.44444444
6418f2c2f51d29b8e2d18574ed4b4e9fbdd7bc88,0,0,0,0,0,0,0,0,0,0,0,0,0,0,19,13,0,0,0,0,0,0,0,0,0,100
dde33712a1fce906b4a6094e3941f2955ae47850,2,23,2,21,0,0,0,2,3,54,1,1,0.942683189,73,20,14,23,18,5,632,494,138,8,7,1,100
5ffad3285785d131a1d9b0d81ea982ce191e85b5,13,557,206,351,1,0,1,2,11,14,4,8,2.983733174,2080,21,15,316,286,30,19260,17075,2185,172,154,18,96.01837672
a92298c5fb260b777f6108c8376f7f457fe358c7,1,1,1,0,0,0,0,4,12,0,1,1,0,164,22,16,14,14,0,1282,1283,1,12,12,0,100
9638120668c8875c11ec0bf28b01a439a2820c92,5,61,49,12,0,0,0,4,13,0,3,4,2.016930814,551,23,17,45,45,0,4230,4258,28,30,30,0,100
22e8a75057c58e7accbb3e9aaa6dfb5ee22ad86a,2,93,14,79,0,0,0,1,7,8,1,2,0.608669676,213,3,3,30,23,7,2204,1770,434,14,12,2,100
d8d9da299c4e0a91be90798ddd6e0457ef76ce84,3,319,68,251,0,0,0,1,8,6,1,2,1.098455778,841,24,18,166,133,33,7824,6259,1565,51,44,7,100
dec14a89fc17f0d53a7f45bdc726eac92f0b14b1,2,20,17,3,0,0,0,1,8,2,1,2,0.84185219,259,4,4,27,30,3,2252,2204,48,13,14,1,100
7828bdf5e75e2fa50d4fcf547beb0ac81854eb82,2,6,7,1,0,0,0,1,9,0,1,2,0.995727452,260,5,5,27,27,0,2250,2252,2,13,13,0,100
c721804684333433427fb9e007fd5bd9afec72e7,9,41,43,2,1,0,1,1,7,8,3,7,2.609721772,964,23,6,200,197,3,6376,6440,64,159,158,1,99.375
d97a7236249897e1561687f6ecefdb17fa83bea2,2,23,21,2,0,0,0,1,9,0,1,2,0.811278124,259,24,7,27,30,3,2250,2204,46,13,14,1,100
de243153c68abb6d3529a821fa00e4ce4191012a,1,156,75,81,0,0,0,3,9,2,1,1,0,717,25,19,140,133,7,5619,5207,412,34,30,4,100
c1e20f8d3cef0c1db413bdeb2338377959db7b4b,45,623,3,620,0,0,0,1,11,16,5,19,5.202560399,3756,26,20,624,624,0,28022,28022,0,326,326,0,100
3ba61b9e7d7427068f766a4e6d5ee5bf82206778,2,3,6,3,0,0,0,1,10,0,1,2,0.99107606,950,27,21,156,154,2,6872,6903,31,46,46,0,99.22600619
ec8177bb70cba2000c2036f35dd24936e56e9cb2,6,195,137,58,0,0,0,3,13,6,2,5,1.556738242,1183,6,6,183,180,3,9372,8905,467,57,56,1,99.07407407
b3d8e037e9047ebb4b942368c03cf533b2429113,2,3,6,3,0,0,0,1,12,0,1,2,0.99107606,1037,7,7,168,166,2,7737,7768,31,49,49,0,99.23076923
b10f93a22f387b7c9ae6337264696ccabaf06971,2,14,14,0,0,0,0,3,13,0,2,2,0.99631652,996,8,8,167,167,0,7510,7510,0,41,41,0,100
0adfeb180fd35f7332d009cbf30a0041eba195f7,5,137,59,78,0,0,0,4,14,8,2,3,1.127266704,1623,4,4,249,228,21,14044,13642,402,86,80,6,100
2679dab3f02506f8e5116d54d970141516285ffc,3,29,1,28,0,0,0,3,5,0,1,2,1.58014547,60,9,9,4,4,0,590,590,0,4,4,0,100
2769809de7e6d6084bb9237b74f6d09ae1958160,1,46,0,46,0,0,0,3,4,11,1,1,0,151,10,10,21,21,0,1028,1015,13,12,12,0,99.84756098
ee060fcccbb37d1500d1966ed0f6ca4913d4be89,10,294,52,242,3,0,3,2,6,0,3,7,2.582122272,465,25,8,71,51,20,4841,3652,1189,45,34,11,94.1089838
7edf5221eb94f15a80d65418f940991b37f97de3,4,91,3,88,0,0,0,4,8,0,1,2,1.82872272,798,5,4,101,91,10,8265,7512,753,52,49,3,100
10e7dba68e8b2abec827c26e610d117166747ecc,1,366,0,366,1,0,1,1,1,0,1,1,0,0,8,8,23,0,23,2181,0,2181,14,0,14,95.93613933
83e593ad6119d7f4c5b795565e5b21c88698b7d2,1,1,1,0,0,0,0,1,2,0,1,1,0,294,9,9,23,23,0,2181,2181,0,14,14,0,100
5ffae6ae5a621fa82b6388cd95a82246d1c5cc34,2,9,3,6,0,0,0,2,7,2,2,2,0.918295834,125,26,8,2,9,7,638,938,300,1,6,5,100
ebcb1392c3dab35664f6f9fe7725c76910b57426,1,2,1,1,0,0,0,1,3,0,1,1,0,294,10,10,23,23,0,2190,2181,9,14,14,0,100
4978a9be90527096a1c4dc7ff188c1d8b63ce502,5,23,19,4,0,0,0,3,15,0,2,4,1.895392508,1062,11,11,175,175,0,8086,8136,50,45,45,0,100
c4f8a6d9228bc06e06b08376f40687b1ba904f13,1,2,2,0,0,0,0,3,13,0,1,1,0,113,12,12,13,13,0,1012,1022,10,4,4,0,100
657b74a40511bd79d526948598f2967f532279c8,0,0,0,0,0,0,0,0,0,0,0,0,0,0,49,6,0,0,0,0,0,0,0,0,0,100
06ade6c4423e61f8a0e9211e086ba768e8079be3,0,0,0,0,0,0,0,0,0,0,0,0,0,0,50,7,0,0,0,0,0,0,0,0,0,100
5b413d3da25f5d8554e981e3a86352dce79ef2c9,1,19,0,19,0,0,0,2,6,41,1,1,0,409,51,8,77,75,2,3168,3086,82,39,38,1,100
004301b29995e44713df4f1081c7322f5de99d5c,2,19,33,14,0,0,0,1,5,9,2,2,0.947062243,713,11,11,97,100,3,5313,5358,45,52,53,1,100
9822e9c787c683c31c6179379c47f0a009998791,1,19,0,19,0,0,0,2,6,41,1,1,0,409,12,12,77,75,2,3168,3086,82,39,38,1,100
8cff958950109bcb8510f9c76ff4aa06335769a4,7,341,137,204,2,0,2,3,16,7,1,4,1.863681854,1356,28,18,267,226,41,10856,9662,1194,91,80,11,90
b5539fc143f8e99af00683e2ec27939467f02a41,8,138,342,204,0,0,0,3,15,2,2,5,1.894860579,1604,13,13,239,280,41,10674,11868,1194,84,95,11,90
072aee8d870d26b86e6770d342e7f883165630e4,7,341,137,204,2,0,2,3,16,7,1,4,1.863681854,1356,14,14,267,226,41,10856,9662,1194,91,80,11,90
db6dffc9748d2016ec69c7da868625a41102ca45,0,0,0,0,0,0,0,0,0,0,0,0,0,0,52,9,0,0,0,0,0,0,0,0,0,100
51d00a853b4c3b028b7baaab3370ed72c8bec4cc,1,1,1,0,0,0,0,3,9,2,1,1,0,374,6,5,30,30,0,4055,4055,0,27,27,0,100
25ff452be1ea3e69b63394c1ac7387329ac55496,6,137,130,7,0,0,0,1,17,3,1,2,1.906041388,1546,29,17,242,247,5,11423,11615,192,79,82,3,100
f02580f0c71d4f02f12738d7eeac30ac22f62708,0,0,0,0,0,0,0,0,0,0,0,0,0,0,53,10,0,0,0,0,0,0,0,0,0,100
98d4baceb30d6b271c371a7a35d3b7a16d36d002,2,9,2,7,0,0,0,3,18,2,2,2,0.684038436,984,15,15,171,171,0,7399,7369,30,41,41,0,100
7aece73b8daded697836c538733241efe2ec23c9,0,0,0,0,0,0,0,0,0,0,0,0,0,0,54,8,0,0,0,0,0,0,0,0,0,100
189811684fc77a8f5332c08ca7609455316f6d96,6,73,0,73,0,0,0,1,19,7,2,5,2.380406747,1114,16,16,185,180,5,8800,8542,258,54,50,4,100
39c84bd68e729def17da7a4994e48f5bc0381291,6,438,420,18,2,0,2,2,20,1,1,6,2.362813962,1099,30,16,179,178,1,8297,8188,109,56,55,1,93.20557491
a8ef4901f7f095c4425abfe16e8e7f8e26519cc1,0,0,0,0,0,0,0,0,0,0,0,0,0,0,55,8,0,0,0,0,0,0,0,0,0,100
4301264e7298552a20135cb1da6993b984e6c088,2,75,23,52,0,0,0,1,11,14,2,2,0.14372617,460,13,13,56,52,4,3719,3317,402,35,33,2,100
f0f2276583f7a9dac7d46fe4c6b0fc5e967181a4,4,350,65,285,1,0,1,1,21,6,1,2,1.048228499,1047,31,15,217,198,19,9340,7411,1929,66,55,11,93.84615385
0494a5267807b968316eaa65930f66c2f09f5dba,0,0,0,0,0,0,0,0,0,0,0,0,0,0,32,16,0,0,0,0,0,0,0,0,0,100
2e5646016a497119bc777a552ce04ee23267ca38,0,0,0,0,0,0,0,0,0,0,0,0,0,0,33,17,0,0,0,0,0,0,0,0,0,100
8f5a2a29ad00bbe94284733fee166c4f29f322ad,0,0,0,0,0,0,0,0,0,0,0,0,0,0,56,9,0,0,0,0,0,0,0,0,0,100
9853d9d139a0b8469323da21056fb1740e19ac9d,0,0,0,0,0,0,0,0,0,0,0,0,0,0,57,10,0,0,0,0,0,0,0,0,0,100
57a100731896a2a406b7c2cfd6c3b92a5f23c424,0,0,0,0,0,0,0,0,0,0,0,0,0,0,58,11,0,0,0,0,0,0,0,0,0,100
537cc23c18721187f2d73c562ef694c087ebb73b,0,0,0,0,0,0,0,0,0,0,0,0,0,0,59,12,0,0,0,0,0,0,0,0,0,100
d7c7467814cb2d277fc8571c89b2cd33d0cf9a50,0,0,0,0,0,0,0,0,0,0,0,0,0,0,60,13,0,0,0,0,0,0,0,0,0,100
475949233c97f42c7f4c92aaa84413b3b8b53890,0,0,0,0,0,0,0,0,0,0,0,0,0,0,61,14,0,0,0,0,0,0,0,0,0,100
b06e45b894f92c81dfac5929955bb68e67858a87,0,0,0,0,0,0,0,0,0,0,0,0,0,0,62,14,0,0,0,0,0,0,0,0,0,100
fca624df517f0b02c987f3787b82ba4996105e2d,0,0,0,0,0,0,0,0,0,0,0,0,0,0,63,15,0,0,0,0,0,0,0,0,0,100
7f8d9f0298f0c16499305e2dde32096c4afe214d,0,0,0,0,0,0,0,0,0,0,0,0,0,0,64,15,0,0,0,0,0,0,0,0,0,100
58b527385228d5b6f2ac9adc76acbf3a8c7b0672,0,0,0,0,0,0,0,0,0,0,0,0,0,0,65,16,0,0,0,0,0,0,0,0,0,100
4b8751cb7ca7dcc9a19ca9cad065b57c0e23a27e,1,26,24,2,0,0,0,2,8,29,1,1,0,182,17,2,25,24,1,1433,1425,8,6,6,0,100
6b7162cfeda6320a6b0b872a34220835d1b444ac,0,0,0,0,0,0,0,0,0,0,0,0,0,0,24,13,0,0,0,0,0,0,0,0,0,100
3e9bb4c29847168447c7108f4f536af3cfb9cf73,0,0,0,0,0,0,0,0,0,0,0,0,0,0,25,14,0,0,0,0,0,0,0,0,0,100
e2f143016e1e30d29244a70a4d2c5403ebe151a8,0,0,0,0,0,0,0,0,0,0,0,0,0,0,2,2,0,0,0,0,0,0,0,0,0,100
1d850208ec9295c89576a87af6908ff447e5a920,0,0,0,0,0,0,0,0,0,0,0,0,0,0,66,11,0,0,0,0,0,0,0,0,0,100
7a8e847a51ba5fc8fde005a1458632e07625f995,5,713,111,602,1,0,1,4,10,52,1,2,1.329278405,873,7,0,180,101,79,11769,8265,3504,73,52,21,99.34318555
2181803a3b92e438ed1bb7d5a0567b95a34d1b0f,1,55,3,52,0,0,0,4,4,89,1,1,0,243,4,0,74,64,10,1298,1129,169,74,64,10,100
fad5c8e6c32a16bfc9a4ed2304e5d64ad5aa2b37,2,216,111,105,0,0,0,5,5,90,1,1,0.844563024,538,5,1,116,86,30,5659,4807,852,16,16,0,100
2412d7cc45e1dbadbe03ef9e69e6967f2acb0918,5,307,14,293,2,0,2,5,10,9,2,3,1.263978911,591,0,0,109,85,24,6998,4802,2196,44,32,12,98.2171799
36c2d35d385ef3f7ed05c525d718e5b5a8ccbf40,5,14,307,293,0,0,0,4,9,39,2,3,1.263978911,806,6,0,85,109,24,4802,6998,2196,32,44,12,98.2171799
99cfa510d7c9e5e1f23ec26d129c792967322497,5,307,14,293,2,0,2,5,10,9,2,3,1.263978911,591,7,1,109,85,24,6998,4802,2196,44,32,12,98.2171799
0e07ef0af27d0e82537e6eb98b50598fab14fd46,1,1,1,0,0,0,0,6,6,1,1,1,0,257,8,2,30,30,0,1963,1963,0,2,2,0,100
f6e02d431c4cd406e899c7e5b38132538bbecf58,0,0,0,0,0,0,0,0,0,0,0,0,0,0,9,3,0,0,0,0,0,0,0,0,0,100
3982b85773e1d6daa411265c04c52b076f7564ec,1,1,1,0,0,0,0,5,5,2,1,1,0,280,10,4,74,74,0,1296,1298,2,74,74,0,100
0b11134fbbfdec782ceb0c8e0e9c59f4d0876d3e,1,1,1,0,0,0,0,6,7,0,1,1,0,257,11,5,30,30,0,1963,1963,0,2,2,0,100
8e5d48275c54d21dfd0af4279cec9b762453bb38,17,541,48,493,7,0,7,1,6,54,2,6,3.043140615,1147,1,1,106,67,39,11227,8653,2574,77,54,23,95.44159544
9d01934b5abdd5a10a1387b55d7a438fd9f8b6e3,11,641,269,372,2,0,2,2,22,67,2,7,2.530043296,1493,34,0,273,231,42,12896,11299,1597,95,70,25,99.11054638
88391aa85d03bfae62100194ee53636a761089d5,3,319,60,259,0,0,0,2,17,92,1,2,1.194311454,250,35,1,43,26,17,3886,2162,1724,28,16,12,99.74747475
14ea109819b9de5c56b172716f3c8b1d5e31f96d,1,1,1,0,0,0,0,4,12,84,1,1,0,158,36,2,30,30,0,1090,1085,5,19,19,0,100
72fee44b55397573bb74cef8225d9602d3070018,0,0,0,0,0,0,0,0,0,0,0,0,0,0,37,3,0,0,0,0,0,0,0,0,0,100
582c2294da85dc91ea3fc22ba001ec672c484759,6,173,94,79,0,0,0,1,3,33,2,4,1.91100978,403,2,2,48,44,4,4682,3982,700,28,25,3,99.13793103
b6e5ab468a41055a0c973e026938087d89983746,0,0,0,0,0,0,0,0,0,0,0,0,0,0,26,0,0,0,0,0,0,0,0,0,0,100
a4a576445fbb416df5429380c2db76e790b98e0e,172,7273,6350,923,8,0,8,1,23,8,7,58,6.100040773,14819,38,4,2404,3071,667,119137,99746,19391,1172,1083,89,57.96344648
ac67d212d1001e915a3c36324dc6c5cf6415607d,4,58,4,54,0,0,0,2,19,0,1,1,1.963603214,434,39,5,45,45,0,3477,3477,0,17,17,0,100
87e36721796d051d7e9f7ec9333d563629fe9147,3,34,33,1,0,0,0,1,2,0,1,2,0.85721853,324,40,6,30,29,1,3317,3308,9,17,16,1,99.57081545
d3a275c38c57a759809ebb110a4814ef7ca3450d,1,3,2,1,0,0,0,1,2,0,1,1,0,92,41,7,5,5,0,950,929,21,5,5,0,100
e79ca3ca2e27f176567079d65b9078290e7c8b35,5,220,16,204,0,0,0,2,11,5,2,4,1.791112322,781,42,8,61,54,7,7746,6441,1305,44,40,4,100
7a63f7ea9c7d9e55244551bb768e0faaf2a0a8a0,0,0,0,0,0,0,0,0,0,0,0,0,0,0,43,9,0,0,0,0,0,0,0,0,0,100
2f231bef8635db6e6f75cf9074fa302caae3ca2b,0,0,0,0,0,0,0,0,0,0,0,0,0,0,67,0,0,0,0,0,0,0,0,0,0,100
48a088fcd5e5efc1be09dca8ef626e17f32d1a38,0,0,0,0,0,0,0,0,0,0,0,0,0,0,68,1,0,0,0,0,0,0,0,0,0,100
6ea66f7acbe383f0fe1e8fd85c9787d275421631,1,45,12,33,0,0,0,1,6,15,1,1,0,190,44,10,48,42,6,1531,1340,191,12,10,2,100
82c06b747a4b14dbc09578985284c60a1ab4eb58,12,838,416,422,0,0,0,2,24,9,3,8,2.69050373,2039,45,11,325,301,24,16568,15222,1346,151,129,22,98.69375907
3d9862e9fbaa609d6e4f436ec498ec5a820f8627,0,0,0,0,0,0,0,0,0,0,0,0,0,0,69,2,0,0,0,0,0,0,0,0,0,100
767611af80d833d5c0bb950aeea2f044c5ecc272,0,0,0,0,0,0,0,0,0,0,0,0,0,0,70,3,0,0,0,0,0,0,0,0,0,100
ca9fd2f5f07b615dfb9d878b19e1b40354c686ba,1,25,2,23,0,0,0,2,2,18,1,1,0,110,71,4,3,2,1,974,810,164,3,2,1,100
65b613b8aeb78d95ff1a0275a171415b5c7cd286,10,295,51,244,0,0,0,1,25,20,2,8,2.196267307,2012,46,12,288,270,18,16961,15384,1577,134,124,10,99.55621302
665165eddfd3dfe366e0387810f36016852e3366,0,0,0,0,0,0,0,0,0,0,0,0,0,0,72,5,0,0,0,0,0,0,0,0,0,100
543f3a72419432cdd5ea739e25867103701b5bda,1,5,1,4,0,0,0,2,3,9,1,1,0,447,73,6,79,78,1,3255,3238,17,40,40,0,100
305d16a1877b9ad4f3fcdc902634f8f95d02ba67,2,25,2,23,0,0,0,4,26,17,1,2,0.605186577,958,74,7,187,182,5,6950,6835,115,62,58,4,100
3718af6b429003963496f4454fdc9399caf856c1,0,0,0,0,0,0,0,0,0,0,0,0,0,0,75,8,0,0,0,0,0,0,0,0,0,100
398286a9005ad7ccf3a56f83989661dd86a1a1d8,2,53,8,45,0,0,0,2,4,3,2,2,0.777152994,590,76,9,118,110,8,4417,4212,205,62,55,7,100
c7b8238781c15f710031079ec1e6396311a20aff,2,82,4,78,1,0,1,1,6,15,1,2,0.717252478,52,47,13,8,6,2,783,404,379,4,2,2,99.70326409
77b11f26a2b753065cd872c8efe1f47654a4f66f,21,339,138,201,1,0,1,1,20,7,3,9,3.731320814,3234,48,14,338,315,23,26250,25832,418,201,181,20,96.60265879
9648a823c62dd1abb0d9cdc380043a939ecb9e16,6,720,19,701,3,0,3,1,9,54,1,5,1.972294036,128,0,0,63,14,49,4888,992,3896,28,11,17,98.83211679
82aeb21d42a6ff607dc3a05b5950e96d4ce2dca8,8,29,726,697,0,0,0,0,8,40,2,6,2.099531912,1202,77,10,109,156,47,4828,8669,3841,64,81,17,98.83211679
ee143338492ebcbe615bfdddca511cb771bb6881,28,864,436,428,3,0,3,2,27,12,4,15,3.739439034,3623,3,0,672,606,66,30284,27067,3217,306,279,27,94.19087137
2ee66639540e8c187dd46620b27215831e120636,29,652,652,0,0,0,0,1,1,0,1,14,2.857812147,3784,49,11,576,29,547,28763,3277,25486,291,29,262,84.53608247
6d3693283e5c002c134dab027b0c8bc1190e5fcd,1,1,1,0,0,0,0,3,3,2,1,1,0,180,78,11,52,52,0,1456,1451,5,12,12,0,100
a2e16bb9e1be53fefec64ab3f88818f98fa7f5b7,16,248,100,148,2,0,2,2,28,0,3,8,3.071451308,2952,4,1,395,380,15,23900,23212,688,184,174,10,99.36628644
858348b09bc5072687692d7c4013d831cfb3af93,8,593,21,572,2,0,2,1,8,5,2,6,0.930543252,1620,50,8,239,212,27,16482,12590,3892,131,104,27,97.79681763
643b648939e67c862fa9c4e7651172dc719c7168,6,90,9,81,0,0,0,2,4,35,2,4,2.060885546,627,79,12,151,144,7,5105,4796,309,75,68,7,100
9a4a353d482e888ee3bfa5a170435b36fc24c405,1,1,2,1,0,0,0,2,3,0,1,1,0,112,80,13,6,6,0,993,935,58,6,6,0,100
8900b0aeb42f494714d65b810235e1746b949f68,0,0,0,0,0,0,0,0,0,0,0,0,0,0,81,14,0,0,0,0,0,0,0,0,0,100
35adfb8e68bfa79e1f316d1ee1949cc7bd36c141,7,77,16,61,1,0,1,1,9,24,1,4,2.185751772,721,51,7,144,142,2,5538,5305,233,81,79,2,94.86215539
e747e2ae77b98ede07d712c34ee6954c0e281909,14,427,500,73,0,0,0,2,29,9,3,9,2.019896126,3037,52,8,341,346,5,23747,24197,450,174,176,2,99.47089947
a86f0f3e10a5c96d5f384cb1ee65a7b313c0e5f2,4,441,94,347,1,0,1,1,2,7,1,3,1.142660091,837,53,9,122,91,31,8962,6913,2049,68,52,16,99.60422164
4f928a8dc63de7858ecb42fdec18e3a8b0a7a500,7,21,47,26,0,0,0,2,20,1,3,4,2.458410981,1043,54,10,97,99,2,8471,8631,160,71,72,1,100
73748b46457b2ae990498619439810a29ac670aa,2,3,5,2,0,0,0,2,7,52,1,1,0.954434003,516,0,0,33,33,0,4236,4246,10,22,22,0,100
cbdbed1d227396b6d372f6c23adcc4a3d17c19ae,3,448,644,196,1,0,1,1,8,0,1,2,1.533452058,514,55,11,23,33,10,2913,4236,1323,18,22,4,99.20844327
7f4227e2d24403e19d0eea82267a557e2f8ade8f,28,96,997,901,0,0,0,1,30,14,3,16,3.939378903,3870,56,12,470,542,72,25897,29663,3766,188,235,47,97.16216216
e5feaabfd814d09f448d075bc4e6a77e48039a5e,10,446,1604,1158,1,0,1,2,4,3,3,8,2.661770128,2255,5,2,165,258,93,10943,18406,7463,82,129,47,96.79218968
1d0dcc02e7ea212a6bce7d4bafd224d23d5d851c,0,0,0,0,0,0,0,0,0,0,0,0,0,0,82,13,0,0,0,0,0,0,0,0,0,100
8612a451ea0e44ed00838aad7c63e1dfb8ac34fd,0,0,0,0,0,0,0,0,0,0,0,0,0,0,83,14,0,0,0,0,0,0,0,0,0,100
571fd25b9f709673b72f3d1d1332394eda268f26,0,0,0,0,0,0,0,0,0,0,0,0,0,0,84,15,0,0,0,0,0,0,0,0,0,100
0d38165dd1eeb7d756c40ad89c290390195f64cc,6,124,105,19,0,0,0,3,5,2,4,6,1.294015906,1129,6,3,200,197,3,9259,9329,70,70,65,5,100
309af260a30252b176dcb4381abd393dc9f6dbb4,7,226,71,155,0,0,0,1,8,0,4,7,1.931675884,1373,57,11,165,158,7,11708,11318,390,80,76,4,99.00990099
6e212def4135a0af004b0ad1ead9b29fc96995b9,0,0,0,0,0,0,0,0,0,0,0,0,0,0,85,13,0,0,0,0,0,0,0,0,0,100
fb3f6b46d53d273a6e91ab8687e33dfd4408c26a,3,53,31,22,0,0,0,2,5,3,1,3,1.08433655,717,7,4,113,109,4,6053,5820,233,40,38,2,99.57446809
af99895b253951ec94e0f26733ffbc2ee10675f6,0,0,0,0,0,0,0,0,0,0,0,0,0,0,86,14,0,0,0,0,0,0,0,0,0,100
49828added781fc8efb38247da3b62e39c443a6d,9,758,71,687,3,0,3,1,13,44,2,8,2.360220818,879,0,0,175,129,46,10893,7179,3714,69,53,16,98.73595506
92a68d05a4b174f124ea94b9c86b7dc2cfdc9602,3,149,1,148,1,0,1,3,15,0,1,3,0.279024022,127,2,2,25,11,14,1820,1101,719,12,8,4,99.44521498
b91dcefd6b418c94eb5c142d0ba6580f15ecebc6,2,0,148,148,0,0,0,3,16,14,1,2,0.179256067,171,3,3,4,18,14,560,1279,719,4,8,4,99.44521498
cb5ceb132c430afb33e891d826dbf09a671104a0,3,53,31,22,0,0,0,2,5,3,1,3,1.08433655,717,4,4,113,109,4,6053,5820,233,40,38,2,99.58275382
95675ad478af5532e8d1bc28546839fbcf6b4592,0,0,0,0,0,0,0,0,0,0,0,0,0,0,87,15,0,0,0,0,0,0,0,0,0,100
0e5555b7f1d4a8672ffbac295013866a71535755,3,28,2,26,0,0,0,3,6,15,2,2,1.178613717,668,8,5,105,100,5,5987,5731,256,44,43,1,100
12beefbb437fd7fe0902e29d62ac6afa38c9374d,0,0,0,0,0,0,0,0,0,0,0,0,0,0,9,6,0,0,0,0,0,0,0,0,0,100
4e8718a6008011c483a9c239d3141bc99a51b2b0,150,2,28,26,0,0,0,2,31,4,5,49,1.178613717,16814,1,0,2528,2533,5,127394,127650,256,1253,1254,1,100
403c04b38d96acbfebe11dbc6e3bd5b02d0ade4f,152,341,2,339,2,0,2,1,30,3,5,50,1.435320499,16790,5,5,2557,2528,29,128969,127394,1575,1267,1253,14,99.31034483
da7a6a88c912f8536d4cf9d84d2d6f339c5e8282,3,38,34,4,0,0,0,1,10,6,1,2,1.052940761,306,6,6,30,23,7,1833,2089,256,18,18,0,98.90410959
e51d3d6bd546cbfd12f6155ded72f5425cc82f00,3,0,317,317,0,0,0,0,9,6,1,2,1.076146672,309,88,11,5,30,25,481,1833,1352,4,18,14,99.31034483
c1c6510bed16f47fc242917d35a4e076d30f8014,3,317,0,317,2,0,2,1,10,6,1,2,1.076146672,69,7,7,30,5,25,1833,481,1352,18,4,14,99.31034483
fcbce418eb986ccc219dfd976b78acde79fc0860,4,87,107,20,0,0,0,1,9,17,2,4,0.62138127,964,58,9,99,103,4,7004,7181,177,46,46,0,100
c87130eb2173217c37b406471095c93ed44a0764,155,628,247,381,4,0,4,2,31,4,5,52,3.140641486,16950,5,4,2565,2538,27,130127,128289,1838,1272,1261,11,98.37177748
aeada976f9459fe1d9cb783697e8cff70b150b95,3,28,2,26,0,0,0,4,7,3,2,2,1.178613717,668,8,4,105,100,5,5987,5731,256,44,43,1,100
87ccb77e676b1cc7ed878de9e7366b18433ba971,0,0,0,0,0,0,0,0,0,0,0,0,0,0,9,5,0,0,0,0,0,0,0,0,0,100
5324e905590a4e6f753a476fa8e0ee467a1d5074,0,0,0,0,0,0,0,0,0,0,0,0,0,0,88,10,0,0,0,0,0,0,0,0,0,100
a15b6ef19d9bbbdf4b1479d7894f6f3233ff4264,17,287,70,217,0,0,0,3,32,0,3,15,3.092757252,3545,10,6,555,485,70,28727,25676,3051,223,202,21,98.39786382
1380771dc71acf3a7d4794a076b35daa70c3a4a6,4,87,107,20,0,0,0,2,12,1,2,4,0.62138127,1028,59,9,104,108,4,7669,7846,177,50,50,0,100
f592043c4e0047acaf1277c48a1f896b7eb88d2d,11,703,89,614,4,0,4,1,33,0,3,8,2.409331717,2207,60,10,322,290,32,21211,17735,3476,155,137,18,98.41688654
ed06c79199c4bf31523dc30699e2359c669a5b9e,1,56,84,28,0,0,0,2,6,0,1,1,0,402,61,11,23,27,4,2859,3012,153,19,20,1,100
9670a3d77a75e01fb4669d9264fca93a91afacf7,3,50,12,38,0,0,0,3,34,2,1,2,1.198691322,1545,62,12,261,259,2,11445,11326,119,89,88,1,100
84a28168f99f5fd902ec33351b7f01f09f2cad5e,2,22,14,8,0,0,0,3,7,0,1,2,0.650022422,707,63,13,65,64,1,6279,6278,1,45,44,1,100
8a0c08f75ba2a8ef4933c5d022709d5c855bf63e,3,72,7,65,0,0,0,3,25,6,2,3,1.251514741,396,13,8,50,43,7,3667,3265,402,31,28,3,100
b195719e29d590587e0e80d6ec4255584f6f2808,1,46,36,10,0,0,0,2,3,10,1,1,0,188,9,8,12,12,0,1286,1252,34,9,9,0,100
6edfdb77ceda00404a8abe6e16743c463d896663,3,13,9,4,0,0,0,1,9,9,2,3,1.582023941,422,64,10,38,38,0,3665,3657,8,20,20,0,100
b1e6c379577a9b6d1e69ad56526fdc9332474984,3,430,2,428,1,0,1,2,7,5,2,3,0.102294256,461,65,8,49,30,19,6278,3530,2748,39,22,17,99.7382199
879eda63480a49fccf684a9d17a8daf006d03dd5,12,469,185,284,0,0,0,3,35,8,2,8,2.885624766,2870,66,8,320,311,9,24485,23145,1340,157,148,9,99.47984395
4719701ce0dbb4c28bb4b65df2f865cf91e4497f,2,4,7,3,0,0,0,2,9,4,2,2,0.994030211,772,67,9,44,44,0,5906,5900,6,39,39,0,100
86fe0801e394cc37d16a60f4e21a1b770d09134f,5,38,10,28,1,0,1,3,6,36,3,3,1.687441233,370,14,4,32,31,1,2790,2724,66,21,20,1,99.48320413
29c930bba4f273cc1103cfc5f805f7668d9e2f2d,0,0,0,0,0,0,0,0,0,0,0,0,0,0,10,1,0,0,0,0,0,0,0,0,0,100
26e699dce4e5be67db76deb1ddd49a4420128891,0,0,0,0,0,0,0,0,0,0,0,0,0,0,11,2,0,0,0,0,0,0,0,0,0,100
c41930f5d1aaa5a23a1cabac00d39d435ef80c2d,0,0,0,0,0,0,0,0,0,0,0,0,0,0,0,0,0,0,0,0,0,0,0,0,0,100
bb64966dd552c51cd5acba8aedf0cf5f51997a69,18,225,123,102,0,0,0,3,36,35,4,14,2.826150459,4011,15,1,659,647,12,30621,29860,761,253,250,3,100
42578cccfad66a23ac7ae3f6eb258138b0e854a9,3,234,206,28,1,0,1,1,4,23,2,2,1.143351367,207,16,2,14,13,1,1442,1355,87,10,10,0,99.61439589
5828806956e5beb03a75a837d73622ba00c0d9a7,0,0,0,0,0,0,0,0,0,0,0,0,0,0,12,2,0,0,0,0,0,0,0,0,0,100
816486c483c7648aab0cbc2abfd4de6baad42b09,0,0,0,0,0,0,0,0,0,0,0,0,0,0,13,3,0,0,0,0,0,0,0,0,0,100
300dc52754165b82e3ae5e65ad5739fc2ef5019c,0,0,0,0,0,0,0,0,0,0,0,0,0,0,14,4,0,0,0,0,0,0,0,0,0,100
7622c3e1c539d94afda331fd3ea80389822b7180,1,5,0,5,0,0,0,7,23,55,1,1,0,208,0,0,34,33,1,1535,1518,17,23,23,0,100
827cc3fb8d70fd61f97211f716b09dcc5d057afb,1,0,5,5,0,0,0,6,22,8,1,1,0,210,0,0,33,34,1,1518,1535,17,23,23,0,100
d2add35e33066591ee4656d3a8a2fa0f24154327,6,41,27,14,0,0,0,2,3,51,1,5,1.992833821,768,15,5,50,60,10,5033,5047,14,35,33,2,100
1e835435c6b1472e9b689294ac45b99b2a433dd7,0,0,0,0,0,0,0,0,0,0,0,0,0,0,1,1,0,0,0,0,0,0,0,0,0,100
f999c67a45bb9f9a925f4da249ae0dbc3a9fe6a7,26,355,499,144,0,0,0,0,35,5,4,19,3.18694441,4928,1,1,709,712,3,35140,35974,834,285,290,5,99.61439589
589c2a653b67d9ae5303e960e037f37d8f077dd7,27,503,354,149,1,0,1,2,36,35,4,20,3.211748753,5023,0,0,746,742,4,37509,36658,851,313,308,5,99.61439589
58dce4c6649c4da65279b12f060ba4cb01348452,1,5,4,1,0,0,0,7,24,0,1,1,0,210,1,1,34,34,0,1563,1535,28,23,23,0,100
28139b40482379c7aee4a7fac2edffe37e32cf1e,1,1,1,0,0,0,0,7,26,0,1,1,0,212,3,3,34,34,0,1563,1563,0,23,23,0,100
a4af9e31fd3b534a2ca0717f59bda43b7b2a9353,6,47,36,11,0,0,0,6,22,44,3,5,2.399634748,1130,17,3,181,178,3,9026,8974,52,87,85,2,100
dcfc483f2ee89d0d8cab84bfbd684b9c9aa1be6f,30,385,546,161,0,0,0,0,35,6,5,21,3.508874681,5451,2,2,781,788,7,39357,40288,931,333,340,7,99.61439589
db8ac80d04ba10d9e2429ede0e4eb7b5114597e9,30,545,384,161,1,0,1,2,36,39,5,21,3.501649736,5322,0,0,788,781,7,40288,39357,931,340,333,7,99.61439589
8cac97e57c777a72fe997cc6975f6a6d2b21b001,6,36,47,11,0,0,0,7,27,14,3,5,2.399634748,1142,4,4,178,181,3,8968,9026,58,85,87,2,100
e4d54817af3a6fdc47c36d50662bb6e11c8a4979,5,47,30,17,0,0,0,2,9,52,2,4,2.183035713,918,0,0,148,144,4,7508,7411,97,64,62,2,100
abf35d6238c8739003643f5aca1f5574e95a5993,0,0,0,0,0,0,0,0,0,0,0,0,0,0,18,4,0,0,0,0,0,0,0,0,0,100
e02cfc05de0f3b9fab628d142b84ed7fab527672,0,0,0,0,0,0,0,0,0,0,0,0,0,0,8,8,0,0,0,0,0,0,0,0,0,100
172f3c8cb5b06fae4e398f78781d776e70ebe871,0,0,0,0,0,0,0,0,0,0,0,0,0,0,8,8,0,0,0,0,0,0,0,0,0,100
27eb676c70d0dfeb3170df1100878cf1afa702bf,0,0,0,0,0,0,0,0,0,0,0,0,0,0,9,9,0,0,0,0,0,0,0,0,0,100
f1eb7ced356a0247fd275312cb3c5f6254a0197b,0,0,0,0,0,0,0,0,0,0,0,0,0,0,10,10,0,0,0,0,0,0,0,0,0,100
1a13eea3bb838400d44b77928737ad6d5ed803df,0,0,0,0,0,0,0,0,0,0,0,0,0,0,1,1,0,0,0,0,0,0,0,0,0,100
ee6126ff0d833c5e23c6cf283c08a2d9dd10a20b,0,0,0,0,0,0,0,0,0,0,0,0,0,0,90,0,0,0,0,0,0,0,0,0,0,100
356fde94ba784cc7cb3344ab80eccf8ef4845115,0,0,0,0,0,0,0,0,0,0,0,0,0,0,8,8,0,0,0,0,0,0,0,0,0,100
683625ff6ba19bf8d460bf6d13df28b261ff3270,0,0,0,0,0,0,0,0,0,0,0,0,0,0,9,9,0,0,0,0,0,0,0,0,0,100
9ce130b0ee8f7f0f6d6993369a76bae3d2dfcb5e,0,0,0,0,0,0,0,0,0,0,0,0,0,0,10,10,0,0,0,0,0,0,0,0,0,100
0cdacb1d9dccebb4848aae002b359c4a12b9cac3,0,0,0,0,0,0,0,0,0,0,0,0,0,0,90,0,0,0,0,0,0,0,0,0,0,100
1361d0cba3027c45ce111786a39a714ecae387fc,3,24,9,15,0,0,0,3,7,28,1,3,1.030426461,147,19,4,15,14,1,1144,1037,107,8,8,0,99.22580645
e631ed0a1390e04341c11e49d09ee0f29737aaf3,0,0,0,0,0,0,0,0,0,0,0,0,0,0,19,4,0,0,0,0,0,0,0,0,0,100
b2ec0c35c602b09583dea61744a1375aecc08119,0,0,0,0,0,0,0,0,0,0,0,0,0,0,2,2,0,0,0,0,0,0,0,0,0,100
2fa785cc94d8c8e4735a124e68fd3391a1b6f0bc,0,0,0,0,0,0,0,0,0,0,0,0,0,0,16,6,0,0,0,0,0,0,0,0,0,100
aea795d531d0aab526cd399d214e6ab1e829c103,0,0,0,0,0,0,0,0,0,0,0,0,0,0,16,6,0,0,0,0,0,0,0,0,0,100
fc4dfcfe0ac0b071a714fc154716320ad06f4347,0,0,0,0,0,0,0,0,0,0,0,0,0,0,17,5,0,0,0,0,0,0,0,0,0,100
5ed7b7fff0d08beca847ef30505cb6617dc33504,0,0,0,0,0,0,0,0,0,0,0,0,0,0,17,5,0,0,0,0,0,0,0,0,0,100
e79fed42f421f7ca23290db74630ebdb272fc87d,0,0,0,0,0,0,0,0,0,0,0,0,0,0,18,6,0,0,0,0,0,0,0,0,0,100
be8ba79589171d90b2d8e4579baa6d3a611a4f2e,0,0,0,0,0,0,0,0,0,0,0,0,0,0,18,6,0,0,0,0,0,0,0,0,0,100
5fda7b705872b86190916ad158fbb8c27ff4b4ce,3,62,3,59,0,0,0,3,4,93,1,2,1.440955775,599,91,1,98,92,6,4629,4230,399,37,33,4,100
63fb91a327f55b6db1f00ed69c2bcab7465e2572,3,3,62,59,0,0,0,2,3,50,1,2,1.440955775,644,11,11,92,98,6,4230,4629,399,33,37,4,100
f82182e4be157c05c9c9c86dc0e70732384d7f2e,3,62,3,59,0,0,0,3,4,93,1,2,1.440955775,599,91,1,98,92,6,4629,4230,399,37,33,4,100
a0d7b9986238c556743e97d42e256029c5414236,13,480,77,403,1,0,1,1,37,51,2,8,2.431040646,3051,68,0,464,448,16,24910,22936,1974,207,193,14,99.48253558
8ee845beba04e41c19af60ee0b03d79f1b74acd3,15,85,485,400,0,0,0,0,36,24,3,9,2.550294078,3526,12,12,481,497,16,24267,26224,1957,216,230,14,99.48253558
a9d61e1b8b4621b6500c7664f8c437310c6c0401,15,485,85,400,1,0,1,1,37,53,3,9,2.550294078,3230,69,1,497,481,16,26224,24267,1957,230,216,14,99.48253558
8ba831bcb81c356c0aee0bdb478423a4419355ef,0,0,0,0,0,0,0,0,0,0,0,0,0,0,70,2,0,0,0,0,0,0,0,0,0,100
8e73ed24df3c6e5eca2bc8dfce5c539cc5d44194,2,8,5,3,0,0,0,3,10,22,1,1,0.779349837,177,1,1,33,33,0,1331,1314,17,23,23,0,100
4b2a4caed572fb358cddb37ce1b183072e08a0a6,4,42,53,11,0,0,0,4,38,4,2,3,1.13896072,2048,20,5,331,331,0,15187,15201,14,142,141,1,100
dd9a76b025a598d7d6c3789697be9738328db302,0,0,0,0,0,0,0,0,0,0,0,0,0,0,22,7,0,0,0,0,0,0,0,0,0,100
64c784428b7c87aab5e6a8311c9121de48e9183e,3,27,21,6,0,0,0,3,10,30,1,3,0.725185987,757,21,6,115,115,0,6232,6194,38,41,41,0,100
4112fbf5dca1d21331a5551a00eaac7b58d7b6cc,0,0,0,0,0,0,0,0,0,0,0,0,0,0,3,3,0,0,0,0,0,0,0,0,0,100
786b1f3b63157e7d8cf09b1bd5ef862729bab29c,1,1,4,3,0,0,0,4,10,0,1,1,0,261,13,12,34,34,0,2252,2263,11,18,18,0,100
9b02a58ff68e0c39dc110dc1e5b8316481eb118a,0,0,0,0,0,0,0,0,0,0,0,0,0,0,2,2,0,0,0,0,0,0,0,0,0,100
d7807410d653760e347809d6c6f9c99d6793611a,6,61,57,4,0,0,0,4,21,82,2,3,2.254359729,1226,0,0,113,110,3,10415,10447,32,64,64,0,99.87113402
ab91112a91e870e7c9eb06dd076f9d468abb5e16,6,57,61,4,0,0,0,3,20,13,2,3,2.254359729,1228,4,4,110,113,3,10447,10415,32,64,64,0,99.87113402
bbc46662255208dcded3d6b1cdc8a62bc7004618,7,76,88,12,0,0,0,4,22,15,2,3,2.26821867,1285,1,1,116,114,2,10864,11017,153,67,68,1,100
074211dbd0db37cefa4d40203241b6399b2d5f4d,4,33,24,9,0,0,0,2,23,23,2,3,1.49961557,1028,2,2,88,88,0,8762,8687,75,61,61,0,100
01ee72a3ccef99323c73d1796087f84080995a66,12,306,248,58,0,0,0,3,20,16,3,7,2.704294881,2675,22,5,278,272,6,23116,22602,514,153,150,3,100
91cfa6a6f4a15f3f95c1d01bd836510a63b6802e,0,0,0,0,0,0,0,0,0,0,0,0,0,0,25,8,0,0,0,0,0,0,0,0,0,100
5a86e50e268702ed0327ee37b6a5a4337c905beb,12,245,305,60,0,0,0,4,23,19,3,7,2.704359812,2728,3,3,272,278,6,22588,23116,528,150,153,3,99.87113402
6b744bc26018362b0f5c43c21a6c28e55d23fd5a,1,15,10,5,0,0,0,5,14,8,1,1,0,523,4,4,91,92,1,3889,3754,135,51,52,1,100
cb5f3d407029f2c4b146e2386ef2c4596776e0df,3,6,9,3,0,0,0,3,28,84,2,2,1.241946032,305,5,5,39,39,0,2261,2292,31,28,28,0,100
7d9294076b80f5e1915bd9d78d87c302abf03e94,4,37,38,1,0,0,0,4,24,0,2,3,1.610482035,802,6,6,72,74,2,6728,6670,58,52,52,0,100
635c51d68c5c84c29e7bb80fe1c95f3aaba1e27c,1,1,1,0,0,0,0,5,13,0,1,1,0,163,7,7,29,29,0,1260,1258,2,19,19,0,100
2c65ac46bb19dc873d1e616d96a4a6e9feaa930a,18,340,271,69,0,0,0,3,27,16,5,12,3.084953386,3885,23,6,475,465,10,32132,31698,434,252,248,4,99.87113402
bb3022b8e2cbbcedfec9796180241e4e531ae9f1,0,0,0,0,0,0,0,0,0,0,0,0,0,0,0,0,0,0,0,0,0,0,0,0,0,100
438688121370628ea0879bae748048867e44c05c,19,1145,59,1086,6,0,6,2,13,31,3,12,3.129307274,1361,19,3,211,130,81,15367,9494,5873,115,76,39,96.56925032
18f6aefd6be7fed41709b301dba341050c3c5a67,0,0,0,0,0,0,0,0,0,0,0,0,0,0,0,0,0,0,0,0,0,0,0,0,0,100
bbf98001ac1e732e31bddd4e629cf0a32be1b73d,0,0,0,0,0,0,0,0,0,0,0,0,0,0,20,4,0,0,0,0,0,0,0,0,0,100
7b29331ef451988d6e8c567c133b4a0dc782fdb9,3,5,15,10,0,0,0,4,20,27,2,3,1.236160254,760,22,6,86,87,1,6172,6242,70,39,39,0,100
6a0004ddb0479cacb6ffecffebd7002c7b39fbef,34,321,1466,1145,0,0,0,2,28,18,5,20,3.939988468,5586,8,8,492,594,102,36592,43576,6984,279,334,55,96.44218551
b5bf5cd907b6c463995957f9ec92c52b325e6a4a,1,2,2,0,0,0,0,5,25,14,1,1,0,379,9,9,21,21,0,3329,3329,0,20,20,0,100
0b13234217ffec5a7f2dce62c02e106911f93855,36,1482,327,1155,6,0,6,2,27,21,5,22,3.984518869,5075,5,3,655,564,91,46194,39887,6307,348,305,43,96.44218551
215d7400d20edf2807e809296d7149bb934c2073,0,0,0,0,0,0,0,0,0,0,0,0,0,0,6,4,0,0,0,0,0,0,0,0,0,100
ed7d2bf06484c4bc3473eefae3b493da96515077,5,43,1,42,0,0,0,3,5,125,1,2,1.968522477,845,92,1,200,195,5,6765,6575,190,84,81,3,100
4e7d2b9b8b66e163c8d825d440afac92fa2d45c3,3,5,15,10,0,0,0,4,20,27,2,3,1.236160254,760,94,2,86,87,1,6172,6242,70,39,39,0,100
d88cdbb25fb7f9cef1d3d9da1ca0a6216dfa4f74,3,15,5,10,0,0,0,4,21,38,2,3,1.236160254,752,21,5,87,86,1,6242,6172,70,39,39,0,100
14089ea875fbedf363ad4bb6b54ce62d6e7316a3,3,5,15,10,0,0,0,4,20,27,2,3,1.236160254,760,23,7,86,87,1,6172,6242,70,39,39,0,100
f3b8232db0653bba5f6421da881f9acc76e79783,3,15,5,10,0,0,0,4,21,38,2,3,1.236160254,752,22,6,87,86,1,6242,6172,70,39,39,0,100
c8115932644abf53e6f6f34bd5180a1e6dfb090e,3,5,15,10,0,0,0,4,20,27,2,3,1.236160254,760,24,8,86,87,1,6172,6242,70,39,39,0,100
4543c8371e4cf70be7b4f54ff938fbb6a342cb49,4,22,6,16,0,0,0,4,21,61,2,4,1.746092179,847,23,6,104,102,2,6817,6708,109,46,46,0,100
75dad3000f9e41359955c11e33a239a801666c59,3,5,15,10,0,0,0,4,20,27,2,3,1.236160254,760,25,7,86,87,1,6172,6242,70,39,39,0,100
8aeb64e32cf475e041b75084439944a323c3f69b,1,1,7,6,0,0,0,1,1,0,1,1,0,101,0,0,16,17,1,536,575,39,7,7,0,100
2bda3511bb2557fd31449cbf2593c15a0f0aa173,4,26,8,18,0,0,0,4,21,62,2,4,1.607455099,847,0,0,102,102,0,6731,6708,23,45,46,1,100
f73dab3e3f28fc6b7c20ceeea662cb61fcbb7abb,6,19,18,1,0,0,0,4,28,36,4,5,2.245815761,1395,24,4,184,181,3,11444,11295,149,102,101,1,100
6e0ae677131357cbfcd5cd4106e406e65d2d4828,8,69,62,7,0,0,0,4,39,23,4,7,2.442026589,2864,24,4,385,384,1,22626,22594,32,188,186,2,100
de1744606c0d7c9760c172d2e5fe87271993c868,8,67,69,2,0,0,0,4,38,28,4,7,2.466684432,2867,25,5,385,385,0,22615,22626,11,187,188,1,100
0438f50d58f506a39d3048a67b2cd1d963a34b02,8,20,44,24,0,0,0,4,27,15,4,7,2.707605603,1653,1,1,218,222,4,13121,13314,193,115,116,1,100
5233657476570c7604c7252f4ca7542d9cf31655,5,382,0,382,5,0,5,1,1,0,1,3,1.927174957,0,2,2,31,0,31,1922,0,1922,18,0,18,98.51851852
104e71e8ee4b632ce0dbe737573d05f09673a066,0,0,0,0,0,0,0,0,0,0,0,0,0,0,3,3,0,0,0,0,0,0,0,0,0,100
b4b8079d599dd06241c804906d0e0bbcf081a0c5,0,0,0,0,0,0,0,0,0,0,0,0,0,0,4,4,0,0,0,0,0,0,0,0,0,100
0c3c5f4071769161279da1496cc0ed7b8ffcf3ea,3,63,3,60,1,0,1,1,2,0,1,3,0.906200447,50,5,5,8,3,5,703,415,288,6,2,4,99.75728155
55e893d56215ad0be4565317828c4b339f2d005f,0,0,0,0,0,0,0,0,0,0,0,0,0,0,6,6,0,0,0,0,0,0,0,0,0,100
ac594b24814d1dd872cd703fd2d991185a40aacc,13,43,467,424,0,0,0,4,21,23,4,10,2.835426917,2005,14,2,185,219,34,14476,16512,2036,100,122,22,98.27586207
1cf48c3e1df9e2d257e46fdfc225d67fa93ef84a,3,20,18,2,0,0,0,3,12,8,2,3,0.590723919,942,15,3,107,107,0,7787,7741,46,44,44,0,100
dfadd1a699802fccca649e3377467e3524c41431,0,0,0,0,0,0,0,0,0,0,0,0,0,0,16,4,0,0,0,0,0,0,0,0,0,100
167671feb0333b7ddc431382b7be8c9506f27bc4,0,0,0,0,0,0,0,0,0,0,0,0,0,0,17,5,0,0,0,0,0,0,0,0,0,100
c183b38cdecff45b0c820db4a1c7ce6478060b7e,0,0,0,0,0,0,0,0,0,0,0,0,0,0,7,4,0,0,0,0,0,0,0,0,0,100
e8fd5f7c3b9a45d5eb3820e2827860bc5ea4abed,1,1,1,0,0,0,0,4,11,24,1,1,0,82,18,6,9,9,0,725,725,0,9,9,0,100
3e0fa2dad38507221e0c3ad415f0901e32e520ee,2,2,2,0,0,0,0,2,2,16,1,1,1,385,19,7,42,42,0,3126,3126,0,25,25,0,100
71fc73fc1aeb6b82de93bef9d32d6a4377b061be,0,0,0,0,0,0,0,0,0,0,0,0,0,0,20,8,0,0,0,0,0,0,0,0,0,100
ca905722f1f74cf5aa7bdaef7d9bdf23a9e6127d,0,0,0,0,0,0,0,0,0,0,0,0,0,0,8,5,0,0,0,0,0,0,0,0,0,100
f526e359a3e8d71ab62fb868923ca17c2fef1b4f,17,491,66,425,6,0,6,4,20,9,4,12,3.050632911,2598,7,7,339,305,34,23339,21333,2006,168,146,22,98.27586207
eddb4480b259a1986d6c522cb30c1f978ce6e31d,20,88,505,417,0,0,0,4,28,16,5,14,3.22763222,3325,3,2,380,412,32,24988,26910,1922,194,215,21,98.27586207
40e160bbc95f7d5ec2ad2beb88cd430b4f1c72a6,3,55,45,10,0,0,0,4,39,32,1,3,1.570575053,1703,1,1,248,246,2,12910,12815,95,99,97,2,100
e4385af664d11e5896019f510e1d77eb866159fa,1,4,2,2,0,0,0,4,16,20,1,1,0,239,4,3,44,46,2,1579,1665,86,12,13,1,100
dccadff34784576df3f1797faca648ff69d3ce83,11,87,103,16,0,0,0,4,38,15,2,8,2.833996626,3688,26,6,494,494,0,28870,28990,120,211,212,1,100
0cf80d27c11cf7771412df2011a079b2fa6cb2ec,0,0,0,0,0,0,0,0,0,0,0,0,0,0,27,7,0,0,0,0,0,0,0,0,0,100
4dbe5820040a80a19ca33c6ba2092b0790610b3e,11,103,87,16,0,0,0,4,39,14,2,8,2.833996626,3671,2,2,494,494,0,28990,28870,120,212,211,1,100
6a9193c79b137cfa76db5080fa69424594b8d2cf,12,119,128,9,0,0,0,4,30,25,4,6,3.104542915,2338,11,11,261,262,1,18885,18824,61,162,164,2,99.87468672
f4547da345d2da3799c974b37f89e696b68d93bc,0,0,0,0,0,0,0,0,0,0,0,0,0,0,3,3,0,0,0,0,0,0,0,0,0,100
252acd01cdd38976f2a28725564514257097e4c0,33,834,266,568,8,0,8,3,38,7,6,20,4.365198525,6269,8,8,846,792,54,52720,49724,2996,420,387,33,97.55201958
ae227ea93707f7e9934ccb4285260291da32bd62,1,2,1,1,0,0,0,1,3,0,1,1,0,12,9,9,1,1,0,74,69,5,1,1,0,100
a98af5ecdb44a6be8430fc80338682699ad7cb02,1,7,1,6,0,0,0,1,2,130,1,1,0,95,0,0,17,16,1,575,536,39,7,7,0,100
b82f8f92c751f422a0fa2c3d894b9321c1b5d8f0,3,36,2,34,0,0,0,1,4,0,1,2,1.24273038,126,10,10,16,16,0,955,955,0,11,11,0,100
b2e0fe35559ba249222b4ee3f6b32dd58c93b913,8,0,634,634,0,0,0,1,5,5,1,4,2.762202263,430,11,11,0,57,57,0,3375,3375,0,33,33,97.6744186
54c3c7f055e84b3da571cf6446a00f76c5ac3cfd,24,261,234,27,0,0,0,4,39,17,5,15,4.062899146,6140,93,1,775,773,2,49159,48814,345,380,380,0,99.87468672
26f3b76b8db68e8f414b6ccb5f6e25e9d219e092,24,234,259,25,0,0,0,3,38,11,5,15,4.062147085,6169,95,1,773,775,2,48824,49159,335,380,380,0,99.87468672
1776b1f11876e6c1b2e891fcb667b42f52131ae6,26,390,305,85,0,0,0,4,39,22,5,17,3.983845282,6296,12,11,798,795,3,50852,49919,933,392,392,0,99.87468672
1a536c2a4cbb72f074115b7a2be95aca5f4d478d,1,2,0,2,0,0,0,5,15,35,1,1,0,528,13,12,91,91,0,3899,3889,10,51,51,0,100
2f8fc054ae9016d1656c943132ec8d6c3b58f65b,12,140,186,46,0,0,0,4,31,18,4,9,3.039114378,2148,29,7,261,262,1,17497,18007,510,141,141,0,100
9d2ce09bfeb3cee270bcbf95d15777f4dc49c6f6,1,1,1,0,0,0,0,1,3,32,1,1,0,68,24,5,9,9,0,514,514,0,1,1,0,100
777978924ca5e30c6696d56292ad80e45e51e1ea,27,282,323,41,0,0,0,3,38,12,5,17,4.227557674,6568,26,4,837,839,2,51973,52406,433,402,402,0,99.87468672
dec21146f46dd1f452e31b5660ddf1b530b6db72,27,323,282,41,0,0,0,4,39,21,5,17,4.227557674,6526,71,0,839,837,2,52406,51973,433,402,402,0,99.87468672
5becd8a5b2eb9d11f41152f50af40ec6233e007e,3,122,3,119,0,0,0,2,9,58,2,2,1.357909288,207,72,1,25,17,8,2138,1597,541,13,9,4,100
5e815267a8e28ca014b576ebb5b9e1477cf172ff,3,3,122,119,0,0,0,2,8,5,2,2,1.357909288,278,33,9,17,25,8,1597,2138,541,9,13,4,100
5bc3501a1c89764c30adf6382dd34e9932bfc3d9,3,122,3,119,0,0,0,2,9,58,2,2,1.357909288,207,34,10,25,17,8,2138,1597,541,13,9,4,100
9d50a245c0d1409c035ace09c5e13ae10b15e033,14,225,254,29,0,0,0,4,30,42,3,9,2.65086304,2061,12,9,278,274,4,16109,16391,282,131,122,9,100
93fed80a3b5d288e55b9787dea144a2726c0a18a,8,187,52,135,0,0,0,2,31,46,2,7,2.450504778,868,13,10,132,124,8,7399,6760,639,59,55,4,100
e013e656165349cd5bacdff2b0a4b9a0c2c55a59,19,249,429,180,0,0,0,4,32,22,4,11,3.365157475,3138,14,11,363,381,18,24955,25402,447,182,199,17,100
002a43ec9adc20d51024daeda749f2395c4f7b42,8,187,52,135,0,0,0,2,34,42,2,7,2.450504778,869,15,12,131,123,8,7397,6758,639,59,55,4,100
c6a0787eabce902be1a099aafc95134fa7798283,13,242,197,45,0,0,0,4,31,32,4,7,2.512747362,2462,4,4,292,282,10,20186,20378,192,167,154,13,100
6ec3972ad0a6b784d25d7327930cefd105c1f02f,13,196,242,46,0,0,0,4,34,19,4,7,2.510796842,2490,16,13,282,292,10,20367,20186,181,154,167,13,100
a91e147b35696c8cc88706ba30a86c18e26678ad,1,1,1,0,0,0,0,6,21,0,1,1,0,204,17,14,36,36,0,1665,1665,0,20,20,0,100
6be1655023590a48edb105cac2dd6e9e801eb6d8,6,178,72,106,0,0,0,4,28,53,2,3,1.00757148,1137,20,17,156,144,12,9701,9344,357,76,63,13,100
fe107bbf56a4f5ae444bd7d9c32701a5fe9db65f,1,7,7,0,0,0,0,6,24,0,1,1,0,205,21,18,36,36,0,1637,1673,36,20,20,0,100
9310e0bcc5480361829b48ce85f0c99295a1a754,2,16,18,2,0,0,0,6,28,0,2,2,0.873981048,424,22,19,65,65,0,3126,3157,31,38,38,0,100
fc19d8bad38dd6f9446e5c500f9521a9e9878fe1,1,0,2,2,0,0,0,5,23,0,1,1,0,118,23,20,11,11,0,993,993,0,4,4,0,100
7794686b33d3ca506a0e0ea902664faf90f9d261,1,2,0,2,0,0,0,5,24,0,1,1,0,118,24,21,11,11,0,993,993,0,4,4,0,100
ac4c3080796e5ea74be7e4b9385e68cdca0f9317,4,11,18,7,0,0,0,5,35,0,3,4,1.759757842,628,25,22,89,89,0,4760,4788,28,51,51,0,100
bd1567a768d7ee4bfd4c25e48f972140672ca6e4,0,0,0,0,0,0,0,0,0,0,0,0,0,0,5,5,0,0,0,0,0,0,0,0,0,100
be0ddddcae0b56e3623a07de3685f3104c6f998f,0,0,0,0,0,0,0,0,0,0,0,0,0,0,25,6,0,0,0,0,0,0,0,0,0,100
a7483feeed6cad17c28f386f0ae2d53698029436,13,140,297,157,0,0,0,4,31,11,4,7,2.507400802,2533,33,11,280,294,14,19829,20629,800,154,167,13,100
58b6280eb7aa8e5f6d09209291643358d0a72116,0,0,0,0,0,0,0,0,0,0,0,0,0,0,2,0,0,0,0,0,0,0,0,0,0,100
223840c6a03cf184bb69bc7bcdf4eadd9f78ecac,13,297,140,157,0,0,0,4,35,30,4,7,2.507400802,2410,6,6,294,280,14,20629,19829,800,167,154,13,100
cd96e3ad38ab301aa6cd87bef5ba8bb01cb891c2,17,177,301,124,0,0,0,4,40,17,4,11,2.831276365,4158,30,6,547,559,12,32331,32906,575,257,269,12,100
0893e742b38a31d3705d918c03aae69a13dec310,0,0,0,0,0,0,0,0,0,0,0,0,0,0,31,7,0,0,0,0,0,0,0,0,0,100
01eaf5003498117d0b394c9ed661d5adfc56db51,20,325,184,141,0,0,0,4,39,31,4,13,3.050346563,4261,26,7,588,573,15,34215,33521,694,278,265,13,100
6e9dbbe8a1b9509168107302eca4896aeeeb8b60,0,0,0,0,0,0,0,0,0,0,0,0,0,0,35,13,0,0,0,0,0,0,0,0,0,100
a4d62eb70ce7a65f41f30d9a5656af2d038ce063,16,147,321,174,0,0,0,4,31,20,4,9,2.758824687,2750,27,0,306,323,17,21019,21938,919,162,176,14,100
30ba5a0a060794df61d2c92a043bc9708e8d6b10,16,321,155,166,0,0,0,4,35,30,5,10,2.812054488,3110,26,18,406,392,14,26030,25169,861,225,212,13,100
01953121fc135eeec325222c7598d5cb5bb342f9,3,24,7,17,0,0,0,1,4,20,2,3,0.993099939,200,27,19,29,26,3,1309,1190,119,9,8,1,100
c58bdf36020e219d7175624abab108a1b85be02b,1,3,3,0,0,0,0,5,17,0,1,1,0,529,28,20,91,91,0,3899,3903,4,51,51,0,100
9df2a228c8dcd828f92753834a69acfef45aa101,1,1,1,0,0,0,0,4,15,0,1,1,0,150,29,21,20,20,0,1295,1297,2,6,6,0,100
8954844c2bd1080833fa509387dfeb206aa938e5,0,0,0,0,0,0,0,0,0,0,0,0,0,0,5,2,0,0,0,0,0,0,0,0,0,100
c00f8de6e57e3b3432c2dbcd55ebb7328528dd70,5,37,4,33,0,0,0,4,40,30,2,5,1.536902613,1830,6,3,303,301,2,14124,13899,225,123,122,1,100
529ebcf82e57b56942c1d4b5e7be90dccac1d11d,0,0,0,0,0,0,0,0,0,0,0,0,0,0,7,6,0,0,0,0,0,0,0,0,0,100
6e9be90b5f3a6267b2a06c1fe84ae972c4dd5c5f,1,1,1,0,0,0,0,1,5,5,1,1,0,68,27,7,9,9,0,522,522,0,1,1,0,100
c0106166c564382daef3e45c991601a9ca878c60,0,0,0,0,0,0,0,0,0,0,0,0,0,0,37,14,0,0,0,0,0,0,0,0,0,100
114fa269faba2afc0d57a21b70e55594f6a1967a,4,17,14,3,0,0,0,5,29,47,2,3,1.349407895,744,73,2,68,68,0,5448,5435,13,44,44,0,100
36c73675e78ffac36c2ddece36f39a8d514b0e97,4,14,17,3,0,0,0,5,28,1,2,3,1.349407895,747,73,2,68,68,0,5435,5448,13,44,44,0,100
cee73f6ca9bee30ad8b29c9214edc7ffc1959659,4,17,14,3,0,0,0,5,29,45,2,3,1.349407895,744,74,3,68,68,0,5448,5435,13,44,44,0,100
40826d1466e39bd991caf7d1d4f0e2bd7a77c4d4,7,131,431,300,0,0,0,3,17,36,2,5,1.537260909,1698,32,8,158,209,51,12399,14202,1803,89,103,14,100
92ff97c6b1d92ba8dbe805fa6519180babb75120,1,2,2,0,0,0,0,2,4,14,1,1,0,260,30,22,50,50,0,2257,2249,8,16,16,0,100
ba98137930b38d61a581ee1fe7ca09d7044dbdcf,0,0,0,0,0,0,0,0,0,0,0,0,0,0,6,5,0,0,0,0,0,0,0,0,0,100
93a16d2b466499bbb2d56fac13b83eb7dc317488,31,600,519,81,0,0,0,4,39,19,5,19,3.425863616,6376,0,0,835,803,32,51290,50707,583,389,390,1,100
58e013fc1cc89f6e93524df0627e62380f5a8623,31,519,600,81,0,0,0,4,40,23,5,19,3.425863616,6451,31,23,803,835,32,50707,51290,583,390,389,1,100
44c4519c72d43de888f73663b9b7aac5dc13d0c1,0,0,0,0,0,0,0,0,0,0,0,0,0,0,7,6,0,0,0,0,0,0,0,0,0,100
e2392607f9f2be2915694bb41f10b2c4f4a0634d,4,21,3,18,0,0,0,5,30,9,3,4,1.176065104,930,32,24,123,121,2,8027,7882,145,65,64,1,100
63fd0a25af40ecb7a9cb01e9dafe66129ad6c721,0,0,0,0,0,0,0,0,0,0,0,0,0,0,8,7,0,0,0,0,0,0,0,0,0,100
113313e2b2f8a8a4f008a597481dc426ec5b9897,0,0,0,0,0,0,0,0,0,0,0,0,0,0,11,10,0,0,0,0,0,0,0,0,0,100
c95c71b4a46ce8a57e6a52675dea71560837f06f,1,17,5,12,0,0,0,4,17,21,1,1,0,162,33,23,15,12,3,1457,1344,113,9,9,0,100
1abeba456d1ff976f31aaf055c46445815f6bf4f,0,0,0,0,0,0,0,0,0,0,0,0,0,0,7,4,0,0,0,0,0,0,0,0,0,100
3e695bade0a5daedb3812cd967f1f5182385dffc,7,291,133,158,0,0,0,4,41,8,3,6,2.013055115,2241,33,9,399,376,23,18252,17306,946,149,134,15,97.03791469
fa81143d993bc6b8714aecbc76806914e9ecc1fb,0,0,0,0,0,0,0,0,0,0,0,0,0,0,8,5,0,0,0,0,0,0,0,0,0,100
f7da366d3d2d25646c4f3f86a0b661455d893d93,5,61,11,50,0,0,0,4,17,65,2,3,1.633535047,1171,34,10,154,152,2,9629,9227,402,99,96,3,100
f7d633de7cbfeb16ff63333240c7448f271a7c2d,0,0,0,0,0,0,0,0,0,0,0,0,0,0,9,6,0,0,0,0,0,0,0,0,0,100
aa27c1bf339c1e480902770cfea283ff377c8cb2,8,275,14,261,2,0,2,1,17,104,1,3,1.705190856,704,35,11,181,147,34,6387,5165,1222,92,70,22,99.44071588
43081eeeb3507c2f60c84188e795508eaa8defd8,0,0,0,0,0,0,0,0,0,0,0,0,0,0,10,7,0,0,0,0,0,0,0,0,0,100
9728c6adad8fa21c24765abcfb33005b80cdaa0d,0,0,0,0,0,0,0,0,0,0,0,0,0,0,28,7,0,0,0,0,0,0,0,0,0,100
466338d98f3012619206a364d757028095cb3831,20,164,645,481,0,0,0,4,40,27,5,10,3.2857554,4086,39,14,596,658,62,29170,31853,2683,258,298,40,96.46226415
d85002a2acd154ec0446e68da3d970fe70deb926,20,644,163,481,2,0,2,4,41,55,5,10,3.281172133,3752,12,11,658,596,62,31853,29170,2683,298,258,40,96.46226415
e74de9c769c8244b1d474740eb1c97bf9901191e,25,190,648,458,0,0,0,0,41,45,4,11,3.395222705,4815,34,24,626,682,56,34859,37256,2397,288,328,40,96.46226415
32fcfddc038fa80fe4eeeb1bc7371b0a56ad6c5e,26,653,190,463,2,0,2,5,41,48,5,12,3.427492255,4620,76,5,693,637,56,38249,35852,2397,332,292,40,96.46226415
d1a20a45085f693b3bb265490b1c9371bf58fb24,0,0,0,0,0,0,0,0,0,0,0,0,0,0,74,3,0,0,0,0,0,0,0,0,0,100
9f28c42287c9d9b7d9ce4b7db611a07266230ab5,0,0,0,0,0,0,0,0,0,0,0,0,0,0,29,8,0,0,0,0,0,0,0,0,0,100
247a4d0907f2a686bf787ded439345f8ad9c69ee,0,0,0,0,0,0,0,0,0,0,0,0,0,0,41,16,0,0,0,0,0,0,0,0,0,100
cf0342a4ba407e618673fa83afdebd5d16da61ba,0,0,0,0,0,0,0,0,0,0,0,0,0,0,12,12,0,0,0,0,0,0,0,0,0,100
bb9c1e108b2f1751a9e8f50457edd4379407c69f,1,7,11,4,0,0,0,5,29,19,1,1,0,209,75,4,24,23,1,1758,1769,11,8,8,0,100
fe30c2c07f896739e11eb7e47d08da99de2ead54,0,0,0,0,0,0,0,0,0,0,0,0,0,0,77,6,0,0,0,0,0,0,0,0,0,100
ef9a07ab3aca424294c08798a76e7c187f15e3fa,0,0,0,0,0,0,0,0,0,0,0,0,0,0,30,9,0,0,0,0,0,0,0,0,0,100
b3ef6f22e7fcb7bfaf470521399443ac03478d4c,0,0,0,0,0,0,0,0,0,0,0,0,0,0,42,17,0,0,0,0,0,0,0,0,0,100
0ee43c5e9f3c98fb7679c53d7e5f8ed7867a4283,0,0,0,0,0,0,0,0,0,0,0,0,0,0,1,1,0,0,0,0,0,0,0,0,0,100
28d8ab4bef5e0e6b7f59e4fb12c528df81b99bd1,0,0,0,0,0,0,0,0,0,0,0,0,0,0,0,0,0,0,0,0,0,0,0,0,0,100
c33e5acdffe317b56fb375aa4e19fd683c3f0afc,2,9,1,8,0,0,0,5,18,54,1,1,0.721928095,1063,98,4,239,235,4,7237,7160,77,117,117,0,100
7bf187a8e51943bef64017a5adc34befbb92fd62,0,0,0,0,0,0,0,0,0,0,0,0,0,0,94,2,0,0,0,0,0,0,0,0,0,100
6fd729f44cf3dcc39ee503137c5679ebb95655d6,0,0,0,0,0,0,0,0,0,0,0,0,0,0,76,5,0,0,0,0,0,0,0,0,0,100
3938e4dee639eb08aaba06f4334bca6bca04a38b,0,0,0,0,0,0,0,0,0,0,0,0,0,0,78,7,0,0,0,0,0,0,0,0,0,100
43759e75621c224627a93a8c71971fe6c4f6df5a,0,0,0,0,0,0,0,0,0,0,0,0,0,0,99,4,0,0,0,0,0,0,0,0,0,100
59b4c32d80a9f6d4781872604b98333cd16c1926,0,0,0,0,0,0,0,0,0,0,0,0,0,0,95,2,0,0,0,0,0,0,0,0,0,100
b9e4d865712ddb3590e7cfacc1fb0bb13311d209,10,32,21,11,0,0,0,4,43,79,2,6,2.951972033,3163,9,8,416,413,3,23963,23790,173,191,191,0,100
1bc9ad9ce9d8a78dd99651f83d3dc486a5f1896f,0,0,0,0,0,0,0,0,0,0,0,0,0,0,14,13,0,0,0,0,0,0,0,0,0,100
1b5d4260249c7e421835d6de4c276c087102c8b4,15,69,59,10,0,0,0,5,41,31,3,9,3.293483724,4526,36,12,629,634,5,34282,34278,4,299,297,2,100
5e78203da5b1e98885d61cdc0c1bc9e78054706b,13,53,33,20,0,0,0,5,43,69,3,7,3.321464315,4020,10,9,596,588,8,30016,29777,239,269,269,0,100
fbf782a2f81838334c08c9fe6afd1cb5c3030cac,5,27,41,14,0,0,0,5,31,9,2,5,1.60450241,1007,35,25,112,113,1,8129,8250,121,64,64,0,99.88888889
27fb8eebc33e40dc60c1b331c69225aaa9207290,1,0,5,5,0,0,0,4,9,5,1,1,0,99,35,25,17,18,1,705,739,34,10,11,1,100
6ba3c963da8e14b4b19b59a91095465403c00453,2,36,6,30,0,0,0,5,33,54,1,2,0.453716339,492,36,26,41,38,3,4525,4282,243,30,28,2,100
2a436f2378bc84870231458a6d9fdb8cf5c91ad4,0,0,0,0,0,0,0,0,0,0,0,0,0,0,38,28,0,0,0,0,0,0,0,0,0,100
0b880eb4d694a0a8fbc9ea7560adac3174383a8c,0,0,0,0,0,0,0,0,0,0,0,0,0,0,11,8,0,0,0,0,0,0,0,0,0,100
fed7af934d3a307a64df7a61b6252c150ed8937d,5,11,52,41,0,0,0,5,30,50,2,5,1.573571107,1016,102,6,110,114,4,8007,8338,331,62,65,3,99.88888889
f2b81b65c30f09a14a4896e830bc00332d8147ef,5,52,11,41,0,0,0,5,33,26,2,5,1.573571107,982,96,3,114,110,4,8338,8007,331,65,62,3,99.88888889
8242de3084c10cb90b7c9d347c82e9b26c46bfee,2,9,8,1,0,0,0,4,14,6,1,2,0.873981048,631,37,13,50,50,0,5496,5476,20,46,46,0,100
a2a739a5a1a07c3353f0e0f24bb1abcbf45cca45,5,11,52,41,0,0,0,5,30,50,2,5,1.573571107,1016,41,14,110,114,4,8007,8338,331,62,65,3,99.88888889
900b3a51326c192ad82109bc8f07bcd5cf3a3f22,8,154,12,142,0,0,0,2,33,41,3,6,2.19524344,1814,77,6,170,162,8,15885,14890,995,109,102,7,99.88888889
58e1d1886cd1a1525499f244f2638ef56aa1f26e,5,11,52,41,0,0,0,5,30,50,2,5,1.573571107,1016,82,11,110,114,4,8007,8338,331,62,65,3,99.88888889
3b9e1b2fb2d70ac9fbe44e80ece509f59868dede,5,52,11,41,0,0,0,5,33,26,2,5,1.573571107,982,31,7,114,110,4,8338,8007,331,65,62,3,99.88888889
d3c05341d9f3741ee0f06e924643a9ff633f7cab,5,11,52,41,0,0,0,5,30,50,2,5,1.573571107,1016,45,14,110,114,4,8007,8338,331,62,65,3,99.88888889
58ea465064622cb163746759f65a31c304b82eb6,5,52,11,41,0,0,0,5,33,26,2,5,1.573571107,982,16,15,114,110,4,8338,8007,331,65,62,3,99.88888889
fbf32c033097146d1ccb0cb5db889bdd0b9f8064,8,57,151,94,0,0,0,2,30,17,3,5,2.628434366,2085,39,28,169,170,1,16749,17304,555,116,120,4,100
08af18addf0d6d550b526c9019abf02a9e7bd549,5,111,9,102,0,0,0,2,14,42,3,5,1.598210015,1463,40,29,106,102,4,13043,12359,684,90,86,4,100
d2fba3b42cb14eb5e6d9962ce145c4577e59b211,1,14,12,2,0,0,0,2,9,0,1,1,0,152,41,30,16,16,0,1239,1240,1,6,6,0,99.88888889
087a715605965a7e48364e03a719213564b4a4ba,8,109,88,21,0,0,0,5,36,15,2,4,2.716778198,1973,78,7,179,179,0,15164,15080,84,115,114,1,97.31759657
0d74787e484091ca683209dd9a9a735289b6bb8d,0,0,0,0,0,0,0,0,0,0,0,0,0,0,84,13,0,0,0,0,0,0,0,0,0,100
456a80961163a42229090e126d3face87fca6a51,1,24,0,24,0,0,0,7,20,4,1,1,0,456,104,8,37,36,1,4055,3914,141,30,29,1,100
479b58a9f38c082b89f2db3bf38a3c16edcd6d05,0,0,0,0,0,0,0,0,0,0,0,0,0,0,97,4,0,0,0,0,0,0,0,0,0,100
cb6583e6972af3ae4cd502285333f5424b405451,1,8,23,15,0,0,0,4,8,22,1,1,0,144,98,5,28,33,5,928,942,14,17,16,1,100
1c90177fa71e4b892834f950d9eee5801d765c7d,0,0,0,0,0,0,0,0,0,0,0,0,0,0,105,9,0,0,0,0,0,0,0,0,0,100
a992f12e1d345f6f4c7a0a5dd6a7b80ccf640b70,0,0,0,0,0,0,0,0,0,0,0,0,0,0,2,0,0,0,0,0,0,0,0,0,0,100
c0e1e99a3c9a0d7c06a313285388f49ae95a94e3,0,0,0,0,0,0,0,0,0,0,0,0,0,0,27,0,0,0,0,0,0,0,0,0,0,100
ccccd8611098fe2afa0d470995849456ef2516af,0,0,0,0,0,0,0,0,0,0,0,0,0,0,0,0,0,0,0,0,0,0,0,0,0,100
208b2bf1fcfc81122f9582dcf0298cc7bcfc6281,0,0,0,0,0,0,0,0,0,0,0,0,0,0,0,0,0,0,0,0,0,0,0,0,0,100
94ed0809a7e0e3b7486672da26115f741650f82a,0,0,0,0,0,0,0,0,0,0,0,0,0,0,0,0,0,0,0,0,0,0,0,0,0,100
0f1c94d00c79759bb3ba5af9d06d4de015dcdd04,0,0,0,0,0,0,0,0,0,0,0,0,0,0,1,1,0,0,0,0,0,0,0,0,0,100
a10b34d1b1096cc94707e271f68e17c78bfae225,0,0,0,0,0,0,0,0,0,0,0,0,0,0,1,1,0,0,0,0,0,0,0,0,0,100
333a141e061769f374e21ec10f55c3624249bfb2,0,0,0,0,0,0,0,0,0,0,0,0,0,0,2,2,0,0,0,0,0,0,0,0,0,100
1541ec7ff1d3f58405e13481d516740704f3c830,0,0,0,0,0,0,0,0,0,0,0,0,0,0,2,2,0,0,0,0,0,0,0,0,0,100
8c9d1a5af9f2374d18203a0bd21f45211a945f1e,0,0,0,0,0,0,0,0,0,0,0,0,0,0,3,3,0,0,0,0,0,0,0,0,0,100
75447595938a4048453c7f1e5ab2ff8f8aedae7f,0,0,0,0,0,0,0,0,0,0,0,0,0,0,3,3,0,0,0,0,0,0,0,0,0,100
abbec78416bfca914e33035f2534c07c72f86249,0,0,0,0,0,0,0,0,0,0,0,0,0,0,4,4,0,0,0,0,0,0,0,0,0,100
5b415fe0e5e6e3e1908314b9a859e99d87f0deed,0,0,0,0,0,0,0,0,0,0,0,0,0,0,4,4,0,0,0,0,0,0,0,0,0,100
e8276c192f027d46a02131b881f0298bd65ae15c,1,4,0,4,0,0,0,4,15,4,1,1,0,175,44,14,19,19,0,1381,1362,19,19,19,0,100
a107508929fd1eb013ebf16f1b35fc8d4e6fc487,0,0,0,0,0,0,0,0,0,0,0,0,0,0,38,11,0,0,0,0,0,0,0,0,0,100
d0ce7d60d82532f40dfea33506b635ff3017fc25,0,0,0,0,0,0,0,0,0,0,0,0,0,0,79,8,0,0,0,0,0,0,0,0,0,100
c4a7d6f7baa9c3f144bbdc4385dabc13fe629113,0,0,0,0,0,0,0,0,0,0,0,0,0,0,85,14,0,0,0,0,0,0,0,0,0,100
84c8636d03cc9d8bd3e90e34a25597e43e31f9c8,4,62,52,10,0,0,0,5,30,5,1,1,1.89400235,695,12,7,83,80,3,5629,5501,128,36,36,0,99.89626556
e3935d5f8f0b878143b968fb53845515a2d68fd0,8,170,118,52,2,0,2,2,44,29,1,5,2.278102236,1652,39,10,290,288,2,12955,12756,199,93,93,0,96.3273872
b90fbdd95967c13edfcf0123fa0a3f4a5267250b,1,1,1,0,0,0,0,4,18,0,1,1,0,155,40,11,20,20,0,1334,1332,2,6,6,0,100
4e1e84b162178cd6e5c286da12228e027f3cf491,0,0,0,0,0,0,0,0,0,0,0,0,0,0,13,8,0,0,0,0,0,0,0,0,0,100
deaf31640a7f0c6b42ccc10bad1bd1cdd955220e,19,230,286,56,0,0,0,5,44,20,4,12,3.494362268,4744,42,30,571,569,2,36846,37177,331,290,292,2,93.84098544
25a68075029cd6c7a7b7ca01ded80d171f3cba1b,15,262,166,96,2,0,2,2,46,18,3,10,3.232045976,3694,14,9,473,472,1,28984,28425,559,238,235,3,94.49339207
018bbd626df3d2faa464ab9ab5d0399033196185,15,201,291,90,0,0,0,2,44,28,3,10,3.157880815,3788,43,31,471,473,2,28499,28984,485,235,238,3,94.49339207
80674f0a2a25060897b0315fb9bf3649550a87cc,15,262,166,96,2,0,2,2,46,17,3,10,3.232045976,3699,44,32,472,471,1,29056,28499,557,238,235,3,94.27312775
b4f4221bc9aca711cf49d1f76e5c8bdb74b047a1,1,0,6,6,0,0,0,8,39,0,1,1,0,253,45,33,37,37,0,1775,1849,74,25,25,0,99.79466119
ca728273eaab402833ebd9f37061cb5f3e1c6c2d,0,0,0,0,0,0,0,0,0,0,0,0,0,0,15,10,0,0,0,0,0,0,0,0,0,100
e6c741b4c1c089005bccad67c8fdde3fcf1d33f9,7,72,109,37,0,0,0,5,45,3,4,6,2.131881624,2438,41,12,353,357,4,18952,19097,145,157,159,2,98.33159541
d86caa89c2286b7a3c8e696c099be2cfbd40ba51,6,93,53,40,0,0,0,5,48,2,3,5,1.588233744,2225,11,7,336,334,2,17696,17470,226,139,138,1,98.4358707
7cf0db5bd0154589e4fd9a4a8d7858bbd49cab9b,0,0,0,0,0,0,0,0,0,0,0,0,0,0,49,17,0,0,0,0,0,0,0,0,0,100
7843e2aee2d8222063f5c843e17d65b859ad7cb8,1,17,5,12,0,0,0,5,32,0,1,1,0,213,80,9,25,25,0,1921,1813,108,8,8,0,100
6b38df1c932b7c6cea68dea86fd32602e8186622,0,0,0,0,0,0,0,0,0,0,0,0,0,0,88,17,0,0,0,0,0,0,0,0,0,100
4de5cfd04b71e1caac250b2f298333b75b7702ec,3,103,19,84,0,0,0,5,49,1,2,3,1.496677742,1937,81,10,264,262,2,16060,15454,606,114,112,2,100
378ec6e668431ae55004d9d03049825732a7c357,0,0,0,0,0,0,0,0,0,0,0,0,0,0,89,18,0,0,0,0,0,0,0,0,0,100
5299b83750e243b22c40c39f431bfb4f66e055e6,60,1054,1880,826,0,0,0,4,39,16,5,24,4.721202385,11054,0,0,1336,1390,54,80878,86085,5207,666,720,54,93.90519187
de0371f8e96936a374beffd81fcaf9bebf24b073,0,0,0,0,0,0,0,0,0,0,0,0,0,0,1,1,0,0,0,0,0,0,0,0,0,100
dd61e708cba4be7a86e6563c7a7d84fa8f7df98c,0,0,0,0,0,0,0,0,0,0,0,0,0,0,2,2,0,0,0,0,0,0,0,0,0,100
1da516d2cef292682248d49d22612d9f1c48c8d8,61,1928,1078,850,4,0,4,4,50,34,5,25,4.736110089,10505,42,13,1399,1343,56,87089,81603,5486,727,670,57,93.20619785
455abf46d49b763532d598102e9c2bd75fa981bd,0,0,0,0,0,0,0,0,0,0,0,0,0,0,16,11,0,0,0,0,0,0,0,0,0,100
6bc7f5c75c74d195f996b2f0d66715fc21b7d6d6,2,24,16,8,0,0,0,4,19,6,1,2,0.848548178,545,43,14,67,66,1,4707,4668,39,43,44,1,100
36a1f612329ccfd0a742d0cf61a48fb094025a5c,0,0,0,0,0,0,0,0,0,0,0,0,0,0,12,8,0,0,0,0,0,0,0,0,0,100
e4991a542b44af63b70ca64acee9b38516250570,3,167,55,112,0,0,0,7,33,3,2,3,1.19788327,597,44,15,117,89,28,5404,4788,616,57,46,11,99.88636364
4789407518ae3aa923a379bfe358221f9193ac30,0,0,0,0,0,0,0,0,0,0,0,0,0,0,13,9,0,0,0,0,0,0,0,0,0,100
f7a24adbb253b6c32d64dc817d4ea2f4fe463132,3,23,15,8,0,0,0,4,20,0,1,3,1.461838199,837,45,16,127,127,0,7008,6889,119,60,60,0,100
971ea90faea3812fd38875c24d35e756209fe57a,0,0,0,0,0,0,0,0,0,0,0,0,0,0,14,10,0,0,0,0,0,0,0,0,0,100
9e79cd945b25a18b175f290a8a258a501c292cff,4,75,203,128,0,0,0,7,32,4,2,4,1.576333357,1060,50,18,135,164,29,7940,8714,774,71,81,10,99.88636364
381bc538d771d7cf31ac0faca13a5f318770b116,2,24,16,8,0,0,0,4,19,6,1,2,0.848548178,545,51,19,67,66,1,4707,4668,39,43,44,1,100
45c2251405b7a58410369107b0f41eadadd3adf9,3,167,55,112,0,0,0,7,33,4,2,3,1.19788327,597,52,20,117,89,28,5404,4788,616,57,46,11,99.88636364
fee7c5cc2ec4f514d686a16be59c3057d22b27c5,3,23,15,8,0,0,0,4,20,0,1,3,1.461838199,837,53,21,127,127,0,7008,6889,119,60,60,0,100
6b9acc52a335b523a50e9ab5ebdf8ca6d2766ad2,21,367,724,357,0,0,0,5,43,4,5,14,3.810959797,5354,5,5,702,740,38,40297,42719,2422,332,347,15,93.82448537
4f38b829b6ed2545ea89c04b64c1f350341578c4,0,0,0,0,0,0,0,0,0,0,0,0,0,0,6,6,0,0,0,0,0,0,0,0,0,100
cbf662db026a9a85994006a5e3c6812bb2682ffc,0,0,0,0,0,0,0,0,0,0,0,0,0,0,7,7,0,0,0,0,0,0,0,0,0,100
9cea4f64a8a13147daea83df927520ba474cbfec,0,0,0,0,0,0,0,0,0,0,0,0,0,0,8,8,0,0,0,0,0,0,0,0,0,100
41c81145e03b18e4085ee097f8fc155fbb5df15a,0,0,0,0,0,0,0,0,0,0,0,0,0,0,0,0,0,0,0,0,0,0,0,0,0,100
6740d6bb668686d16759bc1be7a40ad1303d4fbd,0,0,0,0,0,0,0,0,0,0,0,0,0,0,9,9,0,0,0,0,0,0,0,0,0,100
017c0f72a20f103fa2a2383a5e19bfbe65db48fc,0,0,0,0,0,0,0,0,0,0,0,0,0,0,1,1,0,0,0,0,0,0,0,0,0,100
3bf027b7aabad8cc09273444f82480b6a9013174,0,0,0,0,0,0,0,0,0,0,0,0,0,0,10,10,0,0,0,0,0,0,0,0,0,100
1f03b1ae0dd207c031f492958f3cd5cd82f4f8be,0,0,0,0,0,0,0,0,0,0,0,0,0,0,29,2,0,0,0,0,0,0,0,0,0,100
365f6e26e3e171e3ba15ad6b5749e88974e3d6f1,0,0,0,0,0,0,0,0,0,0,0,0,0,0,30,3,0,0,0,0,0,0,0,0,0,100
fbb7582c411cd0b72e779eebfeaafdfed4ca5300,0,0,0,0,0,0,0,0,0,0,0,0,0,0,11,11,0,0,0,0,0,0,0,0,0,100
3f08d7e2f713f92da8cd7ef5b052433f5865823a,21,727,367,360,2,0,2,5,50,18,5,14,3.808454306,5034,46,17,740,702,38,42769,40297,2472,347,332,15,93.82448537
40e0d41ea99f90b31cbad715b9aa684069fd7263,0,0,0,0,0,0,0,0,0,0,0,0,0,0,47,18,0,0,0,0,0,0,0,0,0,100
812ee5baf6e73be202b48ef1ba6509bde5410c4f,1,2,14,12,0,0,0,6,22,0,1,1,0,361,48,19,45,47,2,3118,3215,97,24,24,0,100
f7ce5a27154e155279faa3b16af9023807179ba4,21,382,730,348,0,0,0,5,43,4,5,14,3.822698466,5346,12,12,702,738,36,40297,42672,2375,332,347,15,93.82448537
fe28c00531b05f2e5c387e4f6ab1fb435c0b0514,0,0,0,0,0,0,0,0,0,0,0,0,0,0,31,4,0,0,0,0,0,0,0,0,0,100
4982dfeb9133b31a3e95b5e4335ba449d524f53b,21,732,380,352,2,0,2,5,50,18,5,14,3.821433899,5034,82,11,739,702,37,42683,40297,2386,347,332,15,93.82448537
a687d7666fa790ed93dc440e6a1b6d865235b71e,2,16,7,9,0,0,0,4,20,0,1,2,0.755375413,594,90,19,78,76,2,5037,4990,47,52,52,0,100
3ccee8562740c2dfc6141f01202c9bc26d277568,1,8,3,5,0,0,0,8,42,0,1,1,0,255,91,20,40,39,1,1849,1819,30,25,25,0,100
7de696cc1ff1348ce24581f5d7709538f75a8624,2,7,16,9,0,0,0,4,22,2,1,2,0.755375413,602,83,12,76,78,2,4990,5037,47,52,52,0,100
cd0e3950dcf391c0654a74e4359fcc727b17ae92,0,0,0,0,0,0,0,0,0,0,0,0,0,0,61,29,0,0,0,0,0,0,0,0,0,100
9a32f180ccbe3dc958725b8dbd89e0c3990919a5,2,28,10,18,0,0,0,4,23,2,1,2,0.899743759,594,49,20,80,76,4,5105,4990,115,53,52,1,100
6dd20ef7de537aebac29f4bd52d6dadbd0f16209,0,0,0,0,0,0,0,0,0,0,0,0,0,0,15,11,0,0,0,0,0,0,0,0,0,100
44c4a289e78416155bdbdfd5f0b8376100210a89,6,29,20,9,0,0,0,2,43,6,2,6,2.375101789,1782,46,32,175,175,0,15077,14916,161,128,128,0,95.04132231
4f7e672cd828502c10821d18d2543f6685d9de1d,1,5,0,5,0,0,0,5,23,0,1,1,0,253,47,33,32,32,0,2045,1973,72,29,29,0,95.34161491
74c54aa9bc9c614fa7c166c6e35c73ffeb4676f3,0,0,0,0,0,0,0,0,0,0,0,0,0,0,0,0,0,0,0,0,0,0,0,0,0,100
5506e778f17a8bab28821d585b118e24b27dd1d8,0,0,0,0,0,0,0,0,0,0,0,0,0,0,14,2,0,0,0,0,0,0,0,0,0,100
a94aa21a2773c9981aa4a30493fd0c1b01f55a5b,0,0,0,0,0,0,0,0,0,0,0,0,0,0,84,11,0,0,0,0,0,0,0,0,0,100
b4d8ae344530cacf65d6de02fab396472cdae762,0,0,0,0,0,0,0,0,0,0,0,0,0,0,96,23,0,0,0,0,0,0,0,0,0,100
8f64e6afc8fadda9eb25696b90088faeae724462,23,403,792,389,0,0,0,5,43,4,5,16,3.877253698,6258,13,13,756,798,42,47830,50594,2764,381,397,16,93.37676439
bde6316c2d345813c02ba69446f4b40a07cb1079,25,858,479,379,2,0,2,2,50,7,5,17,4.072520269,6629,85,12,837,796,41,56121,53468,2653,432,416,16,93.37676439
e643d510db9a4376a1e5341825225406eb28e0ba,2,10,11,1,0,0,0,7,35,0,2,2,0.276195428,672,86,13,68,68,0,5833,5841,8,48,48,0,100
79f92b61c6571e22d11fc74e7f961beead64ada2,2,11,10,1,0,0,0,7,34,7,2,2,0.276195428,671,97,24,68,68,0,5841,5833,8,48,48,0,100
e1f5cb67bc48471d9aa1f9adff1accc388e4abef,2,10,11,1,0,0,0,7,35,0,2,2,0.276195428,672,98,25,68,68,0,5833,5841,8,48,48,0,100
24c9b7b562a3fbe65f2f78f21316858df8c02d64,25,493,871,378,0,0,0,2,43,5,5,17,4.08940655,6958,4,4,796,837,41,53468,56113,2645,416,432,16,93.37676439
aea51890bf380cdaf904c69e967c5f784df8e7a9,0,0,0,0,0,0,0,0,0,0,0,0,0,0,32,5,0,0,0,0,0,0,0,0,0,100
4942ebec35ae86aa27da0ec14311f275d72f2aa0,25,858,615,243,2,0,2,2,50,7,5,17,4.137987451,6629,87,14,829,796,33,55281,53468,1813,428,416,12,93.37676439
9c96922ec4debe7b1cd847f47a18a26944887f4b,4,122,6,116,0,0,0,2,19,4,2,4,1.824301588,969,88,15,81,67,14,8575,7956,619,62,49,13,100
5b40e65445cd676d646321accfd69de9624cde16,4,6,122,116,0,0,0,2,18,4,2,4,1.824301588,1065,99,26,67,81,14,7956,8575,619,49,62,13,100
1ed4dee64a41cf1d37bd5cbcd89d012d74b79a7f,4,122,6,116,0,0,0,2,19,4,2,4,1.824301588,969,100,27,81,67,14,8575,7956,619,62,49,13,100
2b4ffc4e358ddc306566c05f47cc41a3509b3251,25,624,983,359,0,0,0,2,43,5,5,17,4.215270711,6956,33,6,796,843,47,53468,55900,2432,416,441,25,93.37676439
8305460a2d5df4d5b8358dde3ac13c5f5e5f93c9,24,796,401,395,2,0,2,5,50,3,5,16,3.895001884,6152,48,22,843,801,42,52231,49432,2799,409,393,16,93.66812227
ed6b9bf4532e276f3299c021168f90771109c003,12,204,234,30,0,0,0,2,46,4,4,12,3.033116842,3367,49,23,350,345,5,27126,27458,332,219,210,9,100
2270d05fb0d1a6cb927f187b0fd9e338ced2c585,0,0,0,0,0,0,0,0,0,0,0,0,0,0,17,12,0,0,0,0,0,0,0,0,0,100
21109f1e36c977d48143ce286df38710ad330c16,4,97,45,52,0,0,0,2,26,0,2,4,1.594369864,1122,50,18,186,179,7,9852,9576,276,82,79,3,100
6e9d6948e811485d4347b5d8dadd660724962941,0,0,0,0,0,0,0,0,0,0,0,0,0,0,16,10,0,0,0,0,0,0,0,0,0,100
5ff1cb16b173b82a634a187351426db0838f6974,1,0,17,17,0,0,0,4,22,0,1,1,0,257,64,27,52,52,0,2059,2059,0,9,9,0,100
747266684ed5f495c861617399d73b337431c754,5,63,99,36,0,0,0,2,25,5,2,5,1.604398435,1404,50,24,224,231,7,11190,11465,275,91,94,3,100
eff6c6ef498a38485ba7ac481fe371de81ee35e1,2,2,7,5,0,0,0,5,22,0,1,2,0.764204507,289,51,25,48,48,0,1792,1802,10,13,13,0,100
3033474253097bea98917d348e60b9b0bd89f479,7,110,51,59,0,0,0,8,47,5,2,7,2.090330942,1680,89,16,273,266,7,13614,13329,285,120,117,3,100
17e473eb06f38607c0e414c252fdee374d924155,2,2,19,17,0,0,0,8,47,0,2,2,0.702466551,530,106,33,91,91,0,4020,4020,0,34,34,0,100
5fce46d4e5c118d8150842336e151944c4aeaf58,3,20,3,17,0,0,0,8,47,0,3,3,1.06761116,746,1,1,127,128,1,5734,5741,7,55,55,0,100
e142b83d8fa23474b41a2fbbd1cfd1e8f5545fad,26,652,1070,418,0,0,0,2,43,4,5,17,4.199236073,7242,6,6,841,894,53,55070,57806,2736,428,456,28,93.66812227
6eb60f1e3fcb53022b1a97e73c67ba90557b1c2e,0,0,0,0,0,0,0,0,0,0,0,0,0,0,34,6,0,0,0,0,0,0,0,0,0,100
57fa7b9a97e8be69aba9b64f762da1699f06c640,0,0,0,0,0,0,0,0,0,0,0,0,0,0,35,7,0,0,0,0,0,0,0,0,0,100
4d5970880775120ad2bf03b4856bb17e15611741,0,0,0,0,0,0,0,0,0,0,0,0,0,0,5,5,0,0,0,0,0,0,0,0,0,100
6272aa5c9373232e7c5fe0011c55123a0086d6cc,0,0,0,0,0,0,0,0,0,0,0,0,0,0,36,8,0,0,0,0,0,0,0,0,0,100
ef2332efec48f8172a4d9c4a632b1033acef28de,28,1119,694,425,2,0,2,2,50,1,5,18,4.23682274,7268,51,19,960,907,53,60814,58011,2803,484,456,28,93.66812227
3f6490c8bbeacdd6300de9456b465d6f48918597,0,0,0,0,0,0,0,0,0,0,0,0,0,0,18,13,0,0,0,0,0,0,0,0,0,100
93f34483973e5b8cf7b0eb08852c2f69eb3f1da6,2,12,9,3,0,0,0,4,48,51,2,2,0.863120569,673,52,20,121,121,0,4915,4865,50,52,52,0,100
f0682e416947d069e6aa9df70f4dac1a78b95e79,13,155,51,104,1,0,1,2,51,16,3,9,3.180339414,3949,90,17,490,480,10,31725,31259,466,241,233,8,99.42462601
5f42bfcbcc02802a27126f632a01707e9bfd87bc,10,34,58,24,0,0,0,4,47,5,4,6,2.95758281,1998,107,34,296,295,1,15545,15605,60,124,124,0,100
ce61caae71a9456d4e48cbc5c151c3b019dd4796,11,70,43,27,0,0,0,4,48,16,5,7,3.136192421,2390,19,14,377,378,1,18559,18449,110,151,151,0,100
271efbb9c6e28ecedd2d2c2871adcf5182d1f096,11,46,70,24,0,0,0,4,48,12,5,7,3.119296925,2401,108,35,378,377,1,18470,18559,89,151,151,0,100
ec046d195ae2e96a078430bf69f0a795cbfdf41b,11,70,43,27,0,0,0,4,49,16,5,7,3.136192421,2392,91,18,377,378,1,18580,18470,110,151,151,0,100
0dd414f29563b6151407a9a6fa6198eb410002b1,6,91,150,59,0,0,0,8,37,33,2,5,1.77368755,1594,53,21,204,203,1,13285,13407,122,114,113,1,98.85583524
57c17116ba2ef026aa5eb7b936e904aa9bef0e71,16,205,169,36,0,0,0,5,49,9,5,11,3.169685414,3979,65,28,523,522,1,32624,32596,28,262,262,0,98.85583524
666d92e9192166bc20f1aa4f2594af4961be2ebc,11,70,43,27,0,0,0,4,50,16,5,7,3.136192421,2392,53,21,377,378,1,18581,18471,110,151,151,0,100
5c3180ad80987aca04f4bb3b53506d79a66d851c,2,2,19,17,0,0,0,8,54,0,2,2,0.702466551,535,69,32,91,91,0,4094,4094,0,34,34,0,100
3943a6402cf1d220c25b50db809caf371e1d9147,12,109,83,26,0,0,0,4,50,58,4,6,3.026285458,2215,92,19,234,234,0,18500,18349,151,141,141,0,99.8853211
e688ca0fd32559d44e6c72daf64d6dda4d545e5f,3,3,20,17,0,0,0,4,54,16,3,3,1.06761116,699,112,39,99,99,0,5608,5608,0,42,42,0,100
6310fed15f90ddb620c41f9ef9f06c212442943c,11,50,15,35,0,0,0,4,52,4,3,6,2.526858952,3266,93,20,468,463,5,25854,25684,170,186,186,0,99.5412844
6de1b8454468f0b219408752f161ad56ac6e736c,4,4,21,17,0,0,0,4,54,12,3,4,1.384381458,924,113,40,129,129,0,7197,7197,0,60,60,0,100
f8099e4856a37dd0d3a8e334b823e02e9444b429,38,808,1360,552,0,0,0,4,43,12,5,19,4.495345067,8731,7,7,1032,1101,69,65917,69644,3727,515,552,37,93.36235038
e24e0265145bf985a24b8679ff59e217e354f31c,38,1367,798,569,3,0,3,4,52,21,5,19,4.481603675,8247,32,4,1101,1034,67,69644,65987,3657,552,517,35,93.36235038
19630615a750a0e0111fcfb9d3135a7879923f42,4,4,21,17,0,0,0,4,54,12,3,4,1.384381458,924,47,8,129,129,0,7197,7197,0,60,60,0,100
161939b75ec2736fbcdfd7856168b770058c99c8,38,808,1360,552,0,0,0,4,43,12,5,19,4.495345067,8731,37,9,1032,1101,69,65917,69644,3727,515,552,37,93.36235038
52227873746303961537c91e32bc2884af2d7d6b,0,0,0,0,0,0,0,0,0,0,0,0,0,0,38,10,0,0,0,0,0,0,0,0,0,100
f65c378fa1cc21f04174afb95a03b2bb2881a264,0,0,0,0,0,0,0,0,0,0,0,0,0,0,8,8,0,0,0,0,0,0,0,0,0,100
370e1618f0fb08d84d02ce89fdad9536eeaa7008,0,0,0,0,0,0,0,0,0,0,0,0,0,0,39,11,0,0,0,0,0,0,0,0,0,100
d1a7872f076c6283e7c61f90a6a00ca2bf7d21ab,0,0,0,0,0,0,0,0,0,0,0,0,0,0,2,2,0,0,0,0,0,0,0,0,0,100
eb8111532e1c3f8d9ca693e3f32f955f9d47d596,0,0,0,0,0,0,0,0,0,0,0,0,0,0,14,14,0,0,0,0,0,0,0,0,0,100
0702815a513e0651232b5feab3615c2798489799,0,0,0,0,0,0,0,0,0,0,0,0,0,0,0,0,0,0,0,0,0,0,0,0,0,100
668d886e06382e46cd512a8d719d7cd66967b3d6,0,0,0,0,0,0,0,0,0,0,0,0,0,0,1,1,0,0,0,0,0,0,0,0,0,100
16b81ab73f4d70e85872907fff10b01f7ab229ac,0,0,0,0,0,0,0,0,0,0,0,0,0,0,2,2,0,0,0,0,0,0,0,0,0,100
b1363ee2fe93bba97bc8b5ad3496e4f46ca9471e,0,0,0,0,0,0,0,0,0,0,0,0,0,0,3,3,0,0,0,0,0,0,0,0,0,100
2e4d18b1117d284f1924594cd5b38d224a17de17,0,0,0,0,0,0,0,0,0,0,0,0,0,0,4,4,0,0,0,0,0,0,0,0,0,100
6076a8cbf66d49518b1ee2e679bf20c97d879819,0,0,0,0,0,0,0,0,0,0,0,0,0,0,5,5,0,0,0,0,0,0,0,0,0,100
3e0cadf0ec628773afa095d1d3af367e2be7cdb8,0,0,0,0,0,0,0,0,0,0,0,0,0,0,6,6,0,0,0,0,0,0,0,0,0,100
6b8c1312410401212af058ea1417e3bdf106503d,0,0,0,0,0,0,0,0,0,0,0,0,0,0,7,7,0,0,0,0,0,0,0,0,0,100
9dfa18244a4363d6c2497cb3554055e32f40cd64,0,0,0,0,0,0,0,0,0,0,0,0,0,0,8,8,0,0,0,0,0,0,0,0,0,100
beb788a8f9a4df5bc53df2db1ffaf10d5f9845c8,0,0,0,0,0,0,0,0,0,0,0,0,0,0,40,12,0,0,0,0,0,0,0,0,0,100
d9498da1b8b8d11ace8bea8a8036f5b57d6de5c0,0,0,0,0,0,0,0,0,0,0,0,0,0,0,41,13,0,0,0,0,0,0,0,0,0,100
727e6843ef9af2de0333a2a1ed8a755ce50bc9fc,0,0,0,0,0,0,0,0,0,0,0,0,0,0,42,14,0,0,0,0,0,0,0,0,0,100
7fa04b10893651df7ddcb73c483a667dff2b68bd,0,0,0,0,0,0,0,0,0,0,0,0,0,0,9,8,0,0,0,0,0,0,0,0,0,100
6369ab28e02e2bfe54fdc7476320bbdd5c7a5ca0,34,1381,866,515,3,0,3,2,51,16,5,19,4.384022709,7735,54,21,1059,994,65,64976,61473,3503,523,487,36,95.1496388
01224ddd1ed119d655da8ae61e4b77ce41fa6fd7,26,341,265,76,0,0,0,4,52,27,5,14,3.626121366,5990,54,21,843,840,3,48114,47839,275,412,412,0,93.70932755
c073f640e20f74dd37542db324f20a77566bb8fb,3,7,29,22,0,0,0,5,39,38,2,3,1.28067213,1203,54,21,188,191,3,9024,9178,154,98,100,2,100
3520666435d73d5bb581a5e46c2dd696f700a0b9,0,0,0,0,0,0,0,0,0,0,0,0,0,0,17,9,0,0,0,0,0,0,0,0,0,100
189a7d4b7b546ab4c183968ba2062da26d6f3d02,2,23,1,22,0,0,0,5,40,21,2,2,0.543564443,1059,18,10,178,175,3,8118,7972,146,96,94,2,100
25066cd87bcb105742657828cc57970e56dd28cb,3,4,24,20,0,0,0,4,39,38,2,2,1.057585158,1252,55,22,190,193,3,9465,9579,114,103,105,2,100
2d636736dd483af91f3792d38bc30bf35af7f9fc,2,23,1,22,0,0,0,5,40,21,2,2,0.543564443,1059,20,13,178,175,3,8118,7972,146,96,94,2,100
3d9b865d6d1e497892d2a17fdfa386daa2eaadaf,9,163,186,23,0,0,0,2,52,46,3,8,2.562587782,1971,19,11,255,249,6,16603,16395,208,145,142,3,93.77729258
e1bdafa20076b9a1c972f05fba5e333a8948be9c,4,4,21,17,0,0,0,4,57,14,3,4,1.384381458,920,26,16,129,129,0,7194,7194,0,60,60,0,100
b5eaf350900fe0c78d078a2e74097d9140dd75b3,41,956,1509,553,0,0,0,4,43,13,5,19,4.532435447,9301,3,3,1178,1256,78,69392,73497,4105,582,624,42,95.01557632
c8fe5a4a4ea3787bd0cd9095b3e37fd2ba3578cb,0,0,0,0,0,0,0,0,0,0,0,0,0,0,4,4,0,0,0,0,0,0,0,0,0,100
4497f83c08ecd93c721d596e5375aacc01dfe0e7,0,0,0,0,0,0,0,0,0,0,0,0,0,0,5,5,0,0,0,0,0,0,0,0,0,100
8e5fc82f5e59be96bc52b3291959ab47b85e7958,0,0,0,0,0,0,0,0,0,0,0,0,0,0,10,9,0,0,0,0,0,0,0,0,0,100
f7fe3750c8da64b124dccf2b63c59af68fc85e10,32,1239,667,572,4,0,4,4,51,14,5,18,4.507078614,7391,50,17,969,906,63,62715,59497,3218,499,467,32,93.11111111
3ecb6d114145762aa220839f778b55d5f7f14a05,2,2,3,1,0,0,0,5,24,104,2,2,0.970950594,390,53,20,77,77,0,2693,2704,11,25,25,0,100
e8fca05bd1dbc3051df28ca2746eee9e6451b2f7,34,614,416,198,1,0,1,4,54,34,5,18,4.295772182,7858,54,21,1082,1051,31,64228,62657,1571,535,518,17,94.345898
b14d7ef3c8624e013d15b5c21f8f1df1fc2305b5,0,0,0,0,0,0,0,0,0,0,0,0,0,0,55,22,0,0,0,0,0,0,0,0,0,100
2cbd25ccad3e699d6c8fadb75c3c820bbbfd043e,1,1,2,1,0,0,0,3,4,0,1,1,0,125,56,23,23,23,0,960,955,5,10,10,0,100
c71b5b3167120e8a7326d77fdbb353a5243463a1,18,81,287,206,0,0,0,4,57,11,4,14,3.27384234,3943,108,10,613,635,22,29410,30238,828,252,263,11,99.06735751
8b4bc508653aa2036f779f9a28b679f531b5f355,4,21,4,17,0,0,0,4,52,12,3,4,1.384381458,920,99,5,129,129,0,7194,7194,0,60,60,0,100
414beba57944d1952075edbe2ac366cf10e1fdae,176,1355,1412,57,1,0,1,1,3,22,5,55,6.849679908,21048,94,20,2945,2050,895,157945,187273,29328,1514,1426,88,28.12858783
8e0521daa91840a7ad4c5eb629ed16c787be67ce,1,1,1,0,0,0,0,1,2,0,1,1,0,148,95,21,30,30,0,1039,1035,4,19,19,0,100
1a7dba9f73600f3daac1ef60413e9b8e455173e2,0,0,0,0,0,0,0,0,0,0,0,0,0,0,96,22,0,0,0,0,0,0,0,0,0,100
260481095a603943c1715a36a7b6ed2788229d7d,153,1179,1211,32,0,0,0,2,57,18,5,43,6.727660786,19005,116,40,2581,1683,898,145738,185283,39545,1315,1224,91,24.72727273
811058e17712746b63c71007f2501133a54472ea,64,1127,1689,562,1,0,1,4,43,5,5,31,4.950664625,11460,11,10,1571,1651,80,84279,88237,3958,799,843,44,93.45692475
307119733894a5bb9b121b32f75f469c4c2ddf16,325,27149,26572,577,154,0,154,3,58,0,5,96,7.740054208,20514,117,41,2945,4505,1560,157945,324071,166126,1514,2663,1149,29.5194508
4ad5c42dd948ad7a81872855f5d8e3eb562ac054,1,1,1,0,0,0,0,1,2,0,1,1,0,148,118,42,30,30,0,1039,1035,4,19,19,0,100
b286488cbfa9c31bf57545b3df794a3169d02734,0,0,0,0,0,0,0,0,0,0,0,0,0,0,122,46,0,0,0,0,0,0,0,0,0,100
8d8b0b718e81d898a3537b50b4d6b68ea6aa13e8,331,27404,27150,254,157,0,157,2,55,2,5,96,7.75203309,21023,57,24,2979,4628,1649,160755,343232,182477,1531,2738,1207,27.87258248
db437bcb5c2c2adca54c55b4e2d6b250781bfad7,334,27429,27403,26,157,0,157,3,53,0,5,96,7.760448118,21161,58,25,2980,4695,1715,159036,337191,178155,1532,2779,1247,27.74631937
33e4de48a6d3c1c882c1bdb4494eab60d9ca65bc,1,1,1,0,0,0,0,2,3,0,1,1,0,259,59,25,20,20,0,2165,2165,0,9,9,0,100
70344bb52e002cbce5583d5f71430a349f317f07,20,78,340,262,0,0,0,1,3,10,4,14,3.386384737,4743,59,24,741,774,33,34694,35766,1072,328,346,18,96.81933842
189ba064bd83a2d9f6d4fb8246db5e312f5244aa,0,0,0,0,0,0,0,0,0,0,0,0,0,0,21,11,0,0,0,0,0,0,0,0,0,100
8e4ddf42cbc42141fefcb0ded442dffb5a9ec56c,20,348,90,258,3,0,3,2,6,0,4,14,3.415810477,4578,60,26,774,741,33,35708,34694,1014,346,328,18,96.81933842
0ed1a1d0c927d5f00149f3970387dbbd90497c35,23,92,367,275,0,0,0,1,3,9,4,15,3.568453586,5382,76,36,831,864,33,39773,40787,1014,363,381,18,96.81933842
1ff82a7e14ae663639aec0f6e30a655174b1931c,23,381,96,285,3,0,3,2,6,0,4,15,3.5318146,5222,61,26,866,831,35,40914,39773,1141,381,363,18,96.81933842
ee3af4a5bde30c7e81b4d3d1b9837a53dc9b1207,328,26573,27436,863,151,0,151,2,43,2,5,96,7.748780788,21195,9,9,2866,4610,1744,155552,338333,182781,1471,2716,1245,29.38496583
92afb649a164b3060234acc5153424d3d2556ca5,328,27433,26573,860,157,0,157,3,53,0,5,96,7.748864094,20514,62,23,2982,4527,1545,159099,326333,167234,1532,2679,1147,29.38496583
b10b34e09e7ac374563103b757203d1e94f82f73,1,1,1,0,0,0,0,2,2,1,1,1,0,538,22,10,147,145,2,3324,3311,13,66,66,0,100
fc19063959b75c7dca565f84704c5eafda38b702,4,5,22,17,0,0,0,1,6,0,3,4,1.458715528,942,77,35,132,132,0,7267,7267,0,58,58,0,100
21986cd60a27d9760b76a602ea5327cda507bc5f,4,22,5,17,0,0,0,1,4,0,3,4,1.458715528,942,33,1,132,132,0,7267,7267,0,58,58,0,100
e9dacce053e6820faf92a2cb2b4f2450505d3845,4,5,22,17,0,0,0,1,6,0,3,4,1.458715528,942,49,2,132,132,0,7267,7267,0,58,58,0,100
11fd359a23b16a968ffbb9e04592dbd6dc70201f,92,867,861,6,0,0,0,3,5,0,5,29,5.686801013,13993,60,22,1996,1974,22,106380,105838,542,923,894,29,93.2346723
8c5428613802b5362cebd2d8b193a11aaba0524a,0,0,0,0,0,0,0,0,0,0,0,0,0,0,20,9,0,0,0,0,0,0,0,0,0,100
8f9dec9d5338d337db106e12afc92a9b8a1e7fba,93,900,881,19,0,0,0,2,5,0,5,29,5.698410186,14023,63,21,1963,1943,20,107064,106349,715,924,895,29,93.02325581
13aae4bf9135743badad8a78d2537d2668a8631a,93,882,901,19,0,0,0,3,5,0,5,29,5.699547866,14043,61,23,1965,1941,24,106938,106479,459,924,895,29,93.02325581
3e1637a48acfde2fb6100ebe7d4d8394852e91c6,3,33,29,4,0,0,0,3,5,0,3,3,1.087057926,978,62,24,161,162,1,7742,7771,29,79,79,0,100
f4579b6b50b51399cd76261ab48051d5ebe92d93,4,5,22,17,0,0,0,2,8,0,3,4,1.458715528,939,81,37,132,132,0,7233,7233,0,58,58,0,100
720957e8508a6ba50db67657a28e3f7ebfa82b03,94,954,921,33,0,0,0,2,5,0,5,30,5.709314395,14276,64,22,2016,1994,22,109095,108342,753,934,904,30,93.02325581
d75aeb5d7998edfe82dffd81610728cd04d02731,94,892,909,17,0,0,0,3,7,0,5,29,5.704506902,14056,65,23,1963,1942,21,107029,106544,485,924,896,28,93.2346723
b1099dffe3998a59078b0b7758deb8f902f0101d,328,26573,27425,852,151,0,151,2,43,2,5,96,7.748513122,21184,12,6,2866,4588,1722,155552,335918,180366,1471,2700,1229,40.13539652
fdd841ddd98958f6a7bb45473278f5a9d81a1cf4,328,27425,26573,852,157,0,157,3,53,0,5,96,7.748513122,20514,23,10,2982,4494,1512,159112,322940,163828,1532,2655,1123,40.13539652
22624786ee4fe86c94d94fee4bcf4c0855919901,4,0,1284,1284,0,0,0,3,4,8,1,2,1.687013462,966,63,24,0,191,191,0,7030,7030,0,91,91,98.9021043
fef50cee33d3cb8becb79de754950ad363c6adc4,129,2589,3717,1128,0,0,0,2,8,0,5,46,5.820659383,19057,64,25,2628,2628,0,145322,145336,14,1317,1317,0,99.7235023
24eb03b79c06aa0c6aa483ae7b44e68db7df398f,328,27982,26422,1560,155,0,155,2,43,2,5,96,7.788194368,19070,13,7,2866,4298,1432,155552,317975,162423,1471,2537,1066,38.791423
054dfb763ef6b945060f0a4e005cd55d1733c62b,324,25799,29382,3583,153,0,153,3,53,0,5,94,7.808740075,20514,97,16,2587,4362,1775,142249,309368,167119,1315,2559,1244,31.73277662
ee049a606c3778198a785e065d9ca3fbd91c753e,0,0,0,0,0,0,0,0,0,0,0,0,0,0,98,17,0,0,0,0,0,0,0,0,0,100
341d95e575a345c4af299094eb3837f699cc0762,0,0,0,0,0,0,0,0,0,0,0,0,0,0,99,17,0,0,0,0,0,0,0,0,0,100
214d82d58f35f9c5417d775f6f3a34e0b0fd5d45,0,0,0,0,0,0,0,0,0,0,0,0,0,0,100,18,0,0,0,0,0,0,0,0,0,100
869e6cf81c063d4d7585c1be51ca34e2f56e07a3,0,0,0,0,0,0,0,0,0,0,0,0,0,0,101,19,0,0,0,0,0,0,0,0,0,100
3d025dc6766eed1f9e8f848d9ab82b56d3e46189,4,9,9,0,0,0,0,2,4,0,2,4,1.657742727,1004,102,20,144,144,0,8862,8862,0,63,63,0,100
18aab0ae5bebaf785fa947d119986e796e38286f,0,0,0,0,0,0,0,0,0,0,0,0,0,0,103,21,0,0,0,0,0,0,0,0,0,100
2febe216db3a0c00ca4164a898e5bd9a30a047c9,0,0,0,0,0,0,0,0,0,0,0,0,0,0,104,22,0,0,0,0,0,0,0,0,0,100
2fbe8d9b233b05fd61e46186025851ea3a7a0841,4,7,23,16,0,0,0,2,12,0,3,4,1.506350818,883,131,39,131,131,0,7180,7180,0,58,58,0,100
09693bfbeb2e4761e2ec149c346a268e363fa6d3,5,25,9,16,0,0,0,2,8,1,3,5,1.85169245,953,34,2,138,138,0,7771,7771,0,62,62,0,100
0e18270bdeb1ca32d6ec0a9211841d1a19feebc4,4,7,23,16,0,0,0,2,12,0,3,4,1.506350818,883,51,4,131,131,0,7180,7180,0,58,58,0,100
f6d57f72606df9d1466f35f90df006b389070ae3,4,23,7,16,0,0,0,2,8,0,3,4,1.506350818,885,105,21,131,131,0,7180,7180,0,58,58,0,100
d54a5981f6bb40cc992ec71b52f841621e26c5c2,4,7,23,16,0,0,0,2,12,0,3,4,1.506350818,883,43,11,131,131,0,7180,7180,0,58,58,0,100
1efb57bc453206b8377bb63e6f659d2861212697,0,0,0,0,0,0,0,0,0,0,0,0,0,0,44,12,0,0,0,0,0,0,0,0,0,100
63c86bff05c420001cc1e6b1b7baacb8e41c937c,0,0,0,0,0,0,0,0,0,0,0,0,0,0,45,13,0,0,0,0,0,0,0,0,0,100
6c896a7af360c21dec207fc0cad92a715264f116,0,0,0,0,0,0,0,0,0,0,0,0,0,0,46,14,0,0,0,0,0,0,0,0,0,100
eb9eb4cf43b2a748cedbd168836f6354e6164272,0,0,0,0,0,0,0,0,0,0,0,0,0,0,47,15,0,0,0,0,0,0,0,0,0,100
2fa32eca1774e51264266ea0143a291624e2bc06,0,0,0,0,0,0,0,0,0,0,0,0,0,0,0,0,0,0,0,0,0,0,0,0,0,100
da9f12a334b2a5a00fee6675ecabc6763b309e52,0,0,0,0,0,0,0,0,0,0,0,0,0,0,0,0,0,0,0,0,0,0,0,0,0,100
474bf7a89dc73169f8f33d034b80a2f1042287dc,4,23,7,16,0,0,0,2,8,0,3,4,1.506350818,885,65,16,131,131,0,7180,7180,0,58,58,0,100
aefca9a358dc4316495a2a765e031dd559eb2c8e,4,4,4,0,0,0,0,2,4,12,3,3,2,533,66,16,47,47,0,3977,3977,0,35,35,0,100
ed9b669f967132230ab3a58502d822014e89b79f,0,0,0,0,0,0,0,0,0,0,0,0,0,0,35,3,0,0,0,0,0,0,0,0,0,100
f4e4396deb826d60a1a669ba13e3df0f744b0fb8,4,4,4,0,0,0,0,3,5,0,3,3,2,533,36,4,47,47,0,3969,3977,8,35,35,0,100
e426db2ddafda5071a6174f411323e37dbda1fd6,8,11,27,16,0,0,0,2,12,3,4,7,2.352764531,1416,14,8,178,178,0,11157,11149,8,93,93,0,100
d55f4b0f32a75dae195ffc94aca7681d3f9ef288,8,27,11,16,0,0,0,3,8,0,4,7,2.352764531,1418,106,21,178,178,0,11149,11157,8,93,93,0,100
caff3c20be2e22bdee20bf33c7fdaf81586e864d,0,0,0,0,0,0,0,0,0,0,0,0,0,0,107,22,0,0,0,0,0,0,0,0,0,100
9071ce2a3317b8e1906151c33cd70ddff78c1f42,0,0,0,0,0,0,0,0,0,0,0,0,0,0,108,23,0,0,0,0,0,0,0,0,0,100
7f2b49ba82347a7efd2a782b65d132831458017d,4,7,23,16,0,0,0,2,12,0,3,4,1.506350818,883,136,38,131,131,0,7180,7180,0,58,58,0,100
32a794db747e6697094409f2ab4e5b0ad95edcaf,1,18,12,6,0,0,0,2,5,15,1,1,0,134,86,23,11,11,0,1070,1027,43,8,8,0,100
0cffbff03f07384cb1059264408d84f0b412880d,0,0,0,0,0,0,0,0,0,0,0,0,0,0,87,24,0,0,0,0,0,0,0,0,0,100
d813519fd81c2699ed096fbe1072aa689edfca67,0,0,0,0,0,0,0,0,0,0,0,0,0,0,137,35,0,0,0,0,0,0,0,0,0,100
155554e66600cf6d7598c30bf7051e4c5946f529,1,3,3,0,0,0,0,3,4,19,1,1,0,166,55,8,18,18,0,1138,1139,1,7,7,0,100
970115d0862943a228f94477f24d8ac6f206e97e,6,19,25,6,0,0,0,2,4,3,4,5,1.579511326,836,48,14,76,76,0,6143,6177,34,50,50,0,100
5da401828aa983e84e99bec06075934e45046d9e,0,0,0,0,0,0,0,0,0,0,0,0,0,0,49,15,0,0,0,0,0,0,0,0,0,100
4cce8b267193cf3a42223363c9036616811a0569,0,0,0,0,0,0,0,0,0,0,0,0,0,0,49,15,0,0,0,0,0,0,0,0,0,100
ad65f51b332a0c062d57ef7319979866b4393782,0,0,0,0,0,0,0,0,0,0,0,0,0,0,49,15,0,0,0,0,0,0,0,0,0,100
989176218aa194cdc4e445a53cd20ad9abfe4d66,0,0,0,0,0,0,0,0,0,0,0,0,0,0,50,13,0,0,0,0,0,0,0,0,0,100
240d7c4830b9ee161a3266fc20f5c7f30b1e3650,0,0,0,0,0,0,0,0,0,0,0,0,0,0,52,15,0,0,0,0,0,0,0,0,0,100
11b78ad5a37e3bbf4af875751bf415e9aff77d95,0,0,0,0,0,0,0,0,0,0,0,0,0,0,54,17,0,0,0,0,0,0,0,0,0,100
883251c0da0c27d179c837bcb891bd0f0dbaf11c,8,55,25,30,0,0,0,3,5,9,5,7,2.30748991,1285,88,15,167,165,2,10152,9895,257,85,84,1,100
901aca9d804e7175b8fb9e6191048f7719a9ceed,0,0,0,0,0,0,0,0,0,0,0,0,0,0,89,16,0,0,0,0,0,0,0,0,0,100
6b33bcf647264131cf5b37838485675d2ed9c017,5,37,9,28,0,0,0,3,9,30,2,4,1.886600544,2146,90,15,388,387,1,17278,17046,232,149,148,1,98.12695109
d6f5d9da692c54464c0e25abb82e841a9cd849a1,0,0,0,0,0,0,0,0,0,0,0,0,0,0,138,22,0,0,0,0,0,0,0,0,0,100
15639ee996f6a6b09f3d328b8a1a876385c6f373,5,86,22,64,0,0,0,3,6,31,2,5,1.808741618,1194,56,5,186,179,7,10233,9855,378,75,73,2,100
b273520e086616c32fc8bcfc9fef3bd0e72eea95,0,0,0,0,0,0,0,0,0,0,0,0,0,0,57,6,0,0,0,0,0,0,0,0,0,100
864cc5bc30a03eaef6ffc4f3f93e40c42b30af3d,5,22,31,9,0,0,0,3,7,55,1,3,2.256183007,1186,91,0,166,165,1,9858,10017,159,88,87,1,97.47081712
b178df2ea87ff83997e6eb002b3e4d1ecbe8e8c7,2,75,4,71,1,0,1,1,5,47,1,2,0.885883479,96,58,0,20,18,2,1152,785,367,10,8,2,92.78579356
7653e5063abff114c2b1c668d5cca2a9ecfaf98c,0,0,0,0,0,0,0,0,0,0,0,0,0,0,59,1,0,0,0,0,0,0,0,0,0,100
b582b0cf5baff9b93b6411885e8e5d4628b3f985,0,0,0,0,0,0,0,0,0,0,0,0,0,0,92,1,0,0,0,0,0,0,0,0,0,100
97219f6aeef8edabbb3d2ff957b139868ac213de,0,0,0,0,0,0,0,0,0,0,0,0,0,0,93,2,0,0,0,0,0,0,0,0,0,100
414816720e1284b0fd2434c78b1c1e89b5b5fb82,0,0,0,0,0,0,0,0,0,0,0,0,0,0,94,3,0,0,0,0,0,0,0,0,0,100
5e00edea2967ce944ad025211aacc531f451729d,2,11,3,8,0,0,0,3,5,116,2,2,0.863120569,1011,95,4,182,180,2,8109,8075,34,97,96,1,100
b832faf0c7982af4ad6cf776fb153614b5578383,0,0,0,0,0,0,0,0,0,0,0,0,0,0,96,5,0,0,0,0,0,0,0,0,0,100
266d7cc00bef49356bcdb1290930e05748182b12,23,337,160,177,1,0,1,3,13,91,3,14,2.92289165,2912,97,5,276,260,16,24172,23004,1168,184,179,5,97.68392371
9d303743382549b46aad56f78c650b466efa69f1,16,240,154,86,2,0,2,2,6,54,4,10,3.167628528,1524,98,6,194,184,10,11405,10993,412,90,85,5,98.80478088
b93fe4a466058597d3c49e1bedf51f13356d2aae,12,532,712,180,4,0,4,1,8,6,3,6,3.107677588,1044,99,7,91,178,87,6253,12226,5973,47,96,49,97.14656291
96059e0a9cd1ae7cd25e4e9a365bdde3633228ff,6,20,11,9,0,0,0,2,4,151,2,4,2.30730122,641,100,8,41,39,2,4870,4803,67,34,34,0,100
39c52b2b7b1b27cd52dbba00599f74b7cf8c635e,3,88,64,24,0,0,0,3,10,106,2,3,1.022104067,759,101,7,94,88,6,6936,6687,249,47,46,1,100
7fc68497caac671427cc3032f5e8834b1dc22f69,1,15,0,15,0,0,0,2,6,23,1,1,0,88,102,7,9,8,1,683,651,32,4,3,1,100
256b259913284650647ab331d67d3a31e5333e34,0,0,0,0,0,0,0,0,0,0,0,0,0,0,103,5,0,0,0,0,0,0,0,0,0,100
751b4c876464e9cb2e4a90244a9698f9a96bd0f4,0,0,0,0,0,0,0,0,0,0,0,0,0,0,104,6,0,0,0,0,0,0,0,0,0,100
b627a681edc795c71ccf13e75a79ef102e75a916,15,710,52,658,8,0,8,3,7,9,3,8,3.088728741,610,105,7,124,67,57,6913,4098,2815,73,41,32,94.12429379
147242e17a9e40d4b69b95df6a3879a66877b73c,0,0,0,0,0,0,0,0,0,0,0,0,0,0,106,8,0,0,0,0,0,0,0,0,0,100
48343db999b495458409644c8b9d2fd0bd9fa99d,2,998,0,998,1,0,1,2,5,23,1,2,0.223983734,38,107,8,216,5,211,7442,234,7208,33,2,31,99.59473151
5b2aa81fa118c94a6d2595bbd0d779c9ae64b603,0,0,0,0,0,0,0,0,0,0,0,0,0,0,60,0,0,0,0,0,0,0,0,0,0,100
113feb3af4d8b2eed2a8c7b67d4a55b336470119,0,0,0,0,0,0,0,0,0,0,0,0,0,0,61,1,0,0,0,0,0,0,0,0,0,100
2ed767c21cde5de256b914655d16e2dd4b15ab6a,1,1,0,1,0,0,0,2,2,79,1,1,0,84,62,2,6,6,0,583,572,11,5,5,0,100
133690f759f13901c6161666df951134fdf9d519,0,0,0,0,0,0,0,0,0,0,0,0,0,0,63,3,0,0,0,0,0,0,0,0,0,100
e77d3d336649560c70d574964a79be837e342bdb,0,0,0,0,0,0,0,0,0,0,0,0,0,0,108,0,0,0,0,0,0,0,0,0,0,100
367f5f8ee73bf0c64dd849683c9ce908bade9775,0,0,0,0,0,0,0,0,0,0,0,0,0,0,109,1,0,0,0,0,0,0,0,0,0,100
e4c5648b642851519d7877945545fe7183234050,0,0,0,0,0,0,0,0,0,0,0,0,0,0,139,0,0,0,0,0,0,0,0,0,0,100
fd4ff8eca8e37a5d19fbf67ccb2f71ce5339b6f6,0,0,0,0,0,0,0,0,0,0,0,0,0,0,140,1,0,0,0,0,0,0,0,0,0,100
37db995596f5a571a148e584eaf4242381b19450,0,0,0,0,0,0,0,0,0,0,0,0,0,0,141,2,0,0,0,0,0,0,0,0,0,100
15ba43c661029534048d47b8e8a0da7250668a17,0,0,0,0,0,0,0,0,0,0,0,0,0,0,142,3,0,0,0,0,0,0,0,0,0,100
d1eef49e2607b98e2cfd66a24d236a7634192a15,0,0,0,0,0,0,0,0,0,0,0,0,0,0,143,4,0,0,0,0,0,0,0,0,0,100
ff5b1f172b18442c404db949f657e3f8e1317327,0,0,0,0,0,0,0,0,0,0,0,0,0,0,144,5,0,0,0,0,0,0,0,0,0,100
1e1ed482cebff075664577d383d5e7a3bc6d12c3,0,0,0,0,0,0,0,0,0,0,0,0,0,0,145,6,0,0,0,0,0,0,0,0,0,100
c4d4797445d0e80a6badbd0834239477512c52a6,0,0,0,0,0,0,0,0,0,0,0,0,0,0,146,7,0,0,0,0,0,0,0,0,0,100
016e36c007f05dbba0071b1d21d9b26fa8fe0b01,0,0,0,0,0,0,0,0,0,0,0,0,0,0,147,8,0,0,0,0,0,0,0,0,0,100
1bfda02a11762cee733bf5c5b1b82e1e256acda0,68,2225,2525,300,8,0,8,1,14,167,7,32,5.101409454,10359,110,2,1319,1284,35,83678,90184,6506,669,681,12,87.83482143
c3453f60af575c7ec8e830b629280931b5e72e2d,2,38,1,37,0,0,0,2,9,0,1,2,0.291818257,623,111,3,106,105,1,5633,5239,394,61,60,1,100
9ebfd1b1bccde5e1877231c0f13905ca5325daad,0,0,0,0,0,0,0,0,0,0,0,0,0,0,112,2,0,0,0,0,0,0,0,0,0,100
57a7d1bc6185a01a689908d7929bd767f82c209e,1,32,34,2,0,0,0,3,9,17,1,1,0,320,113,3,58,60,2,2525,2544,19,11,11,0,99.87531172
5611f149ea6dee3a91a73f23fb267096fb960438,1,15,1,14,0,0,0,1,2,141,1,1,0,778,114,4,211,209,2,7046,6982,64,31,30,1,100
c12ac955a789366d3f32a8d1706792ee315ba91c,0,0,0,0,0,0,0,0,0,0,0,0,0,0,115,5,0,0,0,0,0,0,0,0,0,100
9828c973b50a270e6c325b6e79293d47c8a7a136,0,0,0,0,0,0,0,0,0,0,0,0,0,0,116,6,0,0,0,0,0,0,0,0,0,100
983e5baab2d893f6219b9aceefc0bf62fb02e83f,3,3,3,0,0,0,0,2,5,222,2,2,1.584962501,787,117,7,201,201,0,6223,6222,1,111,111,0,100
c76bcb20a60af14c675d5a993ab5a693417694b5,0,0,0,0,0,0,0,0,0,0,0,0,0,0,118,8,0,0,0,0,0,0,0,0,0,100
7ade9fe52eab4f767877fb4fad8a48ca7db3e0db,0,0,0,0,0,0,0,0,0,0,0,0,0,0,119,9,0,0,0,0,0,0,0,0,0,100
539f243141d12873aff214942cbb9ddff3fc3af6,0,0,0,0,0,0,0,0,0,0,0,0,0,0,120,10,0,0,0,0,0,0,0,0,0,100
7660c9b2921df6baacf88791077424a374f4aae9,11,580,460,120,1,0,1,2,9,86,3,8,2.38572908,3311,121,11,566,550,16,26799,26197,602,275,270,5,95.95505618
23151244777d917bb0178dabb297287a2fd5b342,0,0,0,0,0,0,0,0,0,0,0,0,0,0,122,12,0,0,0,0,0,0,0,0,0,100
cf2c8bc0c2821b9672761c6cf551783613f003ab,0,0,0,0,0,0,0,0,0,0,0,0,0,0,66,0,0,0,0,0,0,0,0,0,0,100
ebd6d9e3c754535d834cf262db2968d07547272a,0,0,0,0,0,0,0,0,0,0,0,0,0,0,67,1,0,0,0,0,0,0,0,0,0,100
8fce71f17352064702c0fb7919f68e5e901d20b3,0,0,0,0,0,0,0,0,0,0,0,0,0,0,68,2,0,0,0,0,0,0,0,0,0,100
69e33ad6c9bf2239deb04871009cfa577b5aa6ef,0,0,0,0,0,0,0,0,0,0,0,0,0,0,69,3,0,0,0,0,0,0,0,0,0,100
538fa496eed1f76a0dfaab8ee313ea3be51f21d3,0,0,0,0,0,0,0,0,0,0,0,0,0,0,70,4,0,0,0,0,0,0,0,0,0,100
461a2a4e322ffcccf00886413c5c2e227801f33b,8,31,33,2,0,0,0,2,6,183,2,4,2.888551813,797,123,11,37,37,0,6264,6240,24,32,32,0,100
4f61fff2b7467d9fa82c2dd7f81624b2ab885281,0,0,0,0,0,0,0,0,0,0,0,0,0,0,71,5,0,0,0,0,0,0,0,0,0,100
e39c595988d52e44f847d7ab661cbc8f20b44646,0,0,0,0,0,0,0,0,0,0,0,0,0,0,72,6,0,0,0,0,0,0,0,0,0,100
0a875627898b852be8a9947664192c7593706f24,0,0,0,0,0,0,0,0,0,0,0,0,0,0,73,7,0,0,0,0,0,0,0,0,0,100
04d1c1327bf877bd979e79352995114f6fc01a77,1,0,1,1,0,0,0,2,7,21,1,1,0,320,124,7,40,40,0,2441,2452,11,33,33,0,100
fdafb3598b077d72b48380d1b4839f30b3469602,2,27,38,11,0,0,0,2,10,22,1,2,0.89049164,637,125,8,96,98,2,4856,4966,110,42,44,2,100
b37c030d70c5cc4fe7b17fa860536a089b30035d,2,13,13,0,0,0,0,1,1,0,1,2,0.779349837,169,126,5,21,2,19,1232,600,632,11,2,9,99.18200409
23ce5c9693e0fdefd27a8be6b4e64f6d2568678d,1,0,2,2,0,0,0,3,15,74,1,1,0,320,74,8,48,48,0,2473,2478,5,27,27,0,100
c794588d15a4ffdd697d50174cd3b78d6b6ae03a,0,0,0,0,0,0,0,0,0,0,0,0,0,0,75,9,0,0,0,0,0,0,0,0,0,100
bbf48d90a9ac0ebd0a3771f0fc8049fa25766c69,0,0,0,0,0,0,0,0,0,0,0,0,0,0,76,2,0,0,0,0,0,0,0,0,0,100
143f21039f264d523b9dc6bc88bca44e3ef6dc41,4,126,144,18,0,0,0,3,8,100,2,3,1.448929839,984,77,3,123,119,4,8919,8954,35,69,67,2,99.48717949
ad7c221d59327380d9ed296adefcf4427a6c349a,1,5,5,0,0,0,0,3,6,107,1,1,0,292,78,4,23,23,0,2608,2608,0,19,19,0,100
3b6a2c8d392813fe64a34aed3333966e5534c81d,0,0,0,0,0,0,0,0,0,0,0,0,0,0,79,5,0,0,0,0,0,0,0,0,0,100
92490b9e20abb1b5689238701a21ed32882e8988,3,16,15,1,0,0,0,3,9,15,2,3,0.683810421,979,80,5,123,123,0,8927,8919,8,69,69,0,100
177011cf78cdb6ddc434051fee2adac6a20cbb1c,2,4,4,0,0,0,0,2,8,60,1,1,0.811278124,396,127,0,53,53,0,3689,3673,16,14,14,0,100
d9f2bf5072e28c442e519dcd6687bccfacfff826,2,2,2,0,0,0,0,3,8,74,1,1,1,317,81,5,42,42,0,2551,2551,0,22,22,0,100
aafc06c4c477158b6dfbf46c2d8c164a46ad85d5,6,9,9,0,0,0,0,2,3,234,1,4,2.281036113,791,82,6,63,63,0,5636,5636,0,31,31,0,100
27a39063d17ceaa32b602f2661d7a7ffb6dbf3ab,0,0,0,0,0,0,0,0,0,0,0,0,0,0,83,7,0,0,0,0,0,0,0,0,0,100
0fad1ed2c88679a1e5afc95feb5c719508ba4b80,0,0,0,0,0,0,0,0,0,0,0,0,0,0,84,8,0,0,0,0,0,0,0,0,0,100
e4543de6762064d364876de3dd5ee8fcf9dc61c5,0,0,0,0,0,0,0,0,0,0,0,0,0,0,85,9,0,0,0,0,0,0,0,0,0,100
800df29a9f6b87784c2ef412bb476b6ae21ddab2,0,0,0,0,0,0,0,0,0,0,0,0,0,0,86,10,0,0,0,0,0,0,0,0,0,100
32913f31b609fb305fa77baae011df539e12a40d,0,0,0,0,0,0,0,0,0,0,0,0,0,0,128,1,0,0,0,0,0,0,0,0,0,100
e48dbc9d62e075a53bb74598a4b72313a2b8358f,0,0,0,0,0,0,0,0,0,0,0,0,0,0,129,2,0,0,0,0,0,0,0,0,0,100
c93e0972a1201dcd0d5ce8a9286a4c96348c6b44,0,0,0,0,0,0,0,0,0,0,0,0,0,0,87,9,0,0,0,0,0,0,0,0,0,100
6f421e9977f0a1f34af145c991b44662cfd53e45,21,1301,238,1063,8,0,8,1,16,121,5,10,3.83075928,1046,130,3,201,130,71,11532,7110,4422,127,75,52,92.10526316
5bc6f6bdba7d904db371b28f542c75d8f2e5c544,2,37,14,23,0,0,0,2,4,2,2,2,0.95260921,139,131,4,20,19,1,1146,984,162,17,16,1,100
ebc4502a815189848daadb9be3288d6e76bcd3e7,18,2289,12,2277,17,0,17,2,3,7,1,2,3.14639478,787,88,9,431,211,220,17611,7046,10565,142,31,111,96.81742044
f6592123ed5939bbe60a8a08500da246ac6b8707,0,0,0,0,0,0,0,0,0,0,0,0,0,0,132,5,0,0,0,0,0,0,0,0,0,100
35d42ad1976ed17853044fcc1877db0ef7ece056,0,0,0,0,0,0,0,0,0,0,0,0,0,0,89,8,0,0,0,0,0,0,0,0,0,100
c0b4975bcbaeb195703241bc37796624aed8d04d,2,363,154,209,0,0,0,1,2,20,2,2,0.954612006,157,133,5,30,15,15,2522,1279,1243,23,11,12,97.37072743
43639766001c0fe0e067eb50f0125e3489dc41d7,3,74,7,67,0,0,0,2,9,140,1,3,1.54614263,1595,134,6,273,269,4,14019,13516,503,104,102,2,100
9370d4a89af9fdbdb58de1f9b769248f55ed5cea,0,0,0,0,0,0,0,0,0,0,0,0,0,0,90,9,0,0,0,0,0,0,0,0,0,100
eec811ea3bee97312f3367071bc25c4605efc28b,3,21,17,4,0,0,0,2,9,107,2,3,1.255663166,665,135,7,62,63,1,5577,5484,93,48,49,1,99.90494297
ad36c887df65765ee41e99752ad95f5e8e59719f,1,6,4,2,0,0,0,3,10,2,1,1,0,306,91,10,39,38,1,2344,2318,26,31,31,0,100
f671d3ad71cf00f275427bac79c3064deeab7be0,0,0,0,0,0,0,0,0,0,0,0,0,0,0,136,6,0,0,0,0,0,0,0,0,0,100
4f3512192d35b0209f00a2389074d399e34b920c,1,23,0,23,0,0,0,2,2,192,1,1,0,112,92,4,13,12,1,1033,852,181,8,7,1,99.90512334
9710cff0bc0c44375081a5e33e816d8744775764,0,0,0,0,0,0,0,0,0,0,0,0,0,0,93,5,0,0,0,0,0,0,0,0,0,100
c9176273bd57870733a9642e1efeeb5fd2921cca,1,6,5,1,0,0,0,2,9,47,1,1,0,121,137,5,12,12,0,888,887,1,7,7,0,100
238ca11cd5aa65f40616bc347b4b6d4e5964e98a,0,0,0,0,0,0,0,0,0,0,0,0,0,0,138,5,0,0,0,0,0,0,0,0,0,100
91ad0218f4ad1babe26d2024861002a4f352c27e,0,0,0,0,0,0,0,0,0,0,0,0,0,0,139,4,0,0,0,0,0,0,0,0,0,100
919120f65f551f80a02d2782cb4e01f87202f7a5,23,584,122,462,3,0,3,1,10,18,2,6,2.44673755,2703,94,3,492,3609,3117,21893,121956,100063,169,538,369,88.63636364
bf5672c545ff2e076c0d1e0eac20526626478155,33,936,138,798,3,0,3,3,17,219,6,14,4.30483258,5219,95,4,771,667,104,50661,45841,4820,408,366,42,95.87852495
fd468f4557a743cf7dd1f72fce2f9678bcd40e7f,2,39,5,34,0,0,0,3,18,99,1,2,0.439496987,436,96,4,69,66,3,3515,3308,207,36,34,2,100
4aef164cf81e37a9857007a570e03f15779aa76e,2,30,20,10,0,0,0,3,11,138,1,2,0.795040279,641,140,3,87,87,0,5707,5519,188,59,59,0,100
cc2d886022dd314ae951e0e1dc44a808e6bc31c9,0,0,0,0,0,0,0,0,0,0,0,0,0,0,141,4,0,0,0,0,0,0,0,0,0,100
6c3f0964b039d60517c6aa2ea90ab0583e0f28c2,0,0,0,0,0,0,0,0,0,0,0,0,0,0,142,5,0,0,0,0,0,0,0,0,0,100
51656991fc008e57936bfc12afa51b9e372ae6a5,68,3025,1322,1703,5,0,5,3,19,140,8,25,3.883040573,9687,143,6,1806,1619,187,90456,78299,12157,857,819,38,92.40246407
b82ff048496f416e2ea794a1054e2a9f57667005,2,14,4,10,0,0,0,3,10,7,2,2,0.503258335,652,144,7,89,88,1,5666,5592,74,58,58,0,98.65702479
adb6c76db6c262fd538cb81be2e0538ab24ae4ce,1,78,0,78,1,0,1,1,1,0,1,1,0,0,97,5,7,0,7,323,0,323,3,0,3,99.78991597
323b9005841cc59590c26e4deaf7f76974fc1617,0,0,0,0,0,0,0,0,0,0,0,0,0,0,98,4,0,0,0,0,0,0,0,0,0,100
532d6cec5c0c947f706668355f81c116732a62a9,0,0,0,0,0,0,0,0,0,0,0,0,0,0,99,5,0,0,0,0,0,0,0,0,0,100
001f074b5d4d32317ed7b1e55145b0076bfe5b92,0,0,0,0,0,0,0,0,0,0,0,0,0,0,100,6,0,0,0,0,0,0,0,0,0,100
6dfbda1145d1fc74c14985e190d1767a4178ff58,0,0,0,0,0,0,0,0,0,0,0,0,0,0,101,7,0,0,0,0,0,0,0,0,0,100
f8dd5dcb358b0328d34f57d5b1c6fcd730fb48e1,3,64,2,62,0,0,0,3,11,56,3,3,1.096139159,566,102,8,97,87,10,4627,4349,278,55,50,5,99.8951782
afb9e618a290fcc79f59600418cbf68f1356fd30,2,149,0,149,2,0,2,1,1,0,2,2,0.992676976,0,102,8,7,0,7,902,0,902,7,0,7,98.828541
1d859f0393c2ceb5c196858e882302888bf83551,0,0,0,0,0,0,0,0,0,0,0,0,0,0,104,10,0,0,0,0,0,0,0,0,0,100
90692af5bf0a08b95a1e205ffcba28af64956e69,0,0,0,0,0,0,0,0,0,0,0,0,0,0,105,11,0,0,0,0,0,0,0,0,0,100
dce31ab89be353e8e1e23a2ce1e1e903745db084,23,581,196,385,2,0,2,3,20,37,6,18,3.612113666,4360,145,6,624,577,47,38619,36465,2154,345,313,32,98.4962406
8cbb2c13bbe71957daf0de9222daaf4dd01199d3,15,267,189,78,0,0,0,3,21,13,4,10,3.279122602,4170,146,7,543,534,9,38464,37784,680,266,262,4,100
ae1d636fbb48346f4cfc926be469a6bfc884f71e,1,189,0,189,1,0,1,1,1,0,1,1,0,0,106,10,13,0,13,1009,0,1009,7,0,7,99.78723404
fa502b21700fb3c05c0ee8df1ed0f7525b7d3030,1,0,189,189,0,0,0,1,2,0,1,1,0,129,107,11,0,13,13,0,1009,1009,0,7,7,99.78723404
2cae42c08a4122db672f3188a46b8385992ddc02,10,139,172,33,0,0,0,3,14,22,3,5,2.483820715,2075,108,12,300,297,3,17975,18001,26,136,143,7,100
125cdf5af9d34eaf8ada5f1b8d7fd587da483ecb,0,0,0,0,0,0,0,0,0,0,0,0,0,0,109,13,0,0,0,0,0,0,0,0,0,100
ab6e64202727034425ba6a4165990d06be94d1e4,0,0,0,0,0,0,0,0,0,0,0,0,0,0,110,14,0,0,0,0,0,0,0,0,0,100
a230f4ffdf6317020c977e6ed59aadae8404a0ab,0,0,0,0,0,0,0,0,0,0,0,0,0,0,111,15,0,0,0,0,0,0,0,0,0,100
30a2ec1fa450664d6ae90f70a71fde80f8882b68,3,55,16,39,0,0,0,3,9,34,2,3,1.58028972,784,147,2,54,54,0,7218,6894,324,47,47,0,100
aeec7618a8505f75715f74530ea900cf65bc847d,4,84,21,63,0,0,0,2,13,20,1,3,1.221962451,1320,148,3,97,96,1,13003,12450,553,68,67,1,100
6a9078e1fa4c81b6a6e6f695284cce5e267d116a,0,0,0,0,0,0,0,0,0,0,0,0,0,0,149,4,0,0,0,0,0,0,0,0,0,100
611ac3028ea5ba3c44434dec9cdcf193912cfa07,0,0,0,0,0,0,0,0,0,0,0,0,0,0,150,5,0,0,0,0,0,0,0,0,0,100
be6971f2dc82c90761635dda197d7819729311d9,4,13,13,0,0,0,0,2,5,349,2,3,1.854285872,339,151,6,40,40,0,2075,2075,0,23,23,0,100
34857de8cf23a0ed69614e7098a4bac0ade712b6,0,0,0,0,0,0,0,0,0,0,0,0,0,0,152,7,0,0,0,0,0,0,0,0,0,100
cd139e501f5502c1155d67d32d0b74d751fbd761,8,19,13,6,0,0,0,2,7,162,2,6,2.702819531,779,153,8,84,84,0,5491,5440,51,40,40,0,86.94665153
70d54988288e7545848a5992af0806708d8b840f,0,0,0,0,0,0,0,0,0,0,0,0,0,0,154,9,0,0,0,0,0,0,0,0,0,100
086b4a3ee0480d37f9aa66fb878c9dc978aaa043,15,1623,6,1617,12,0,12,1,11,6,2,13,3.324359279,781,155,10,247,105,142,16738,7499,9239,155,73,82,82.08469055
c0cf21291c048f6e57d257aa9ce185ef4e3e7045,0,0,0,0,0,0,0,0,0,0,0,0,0,0,156,9,0,0,0,0,0,0,0,0,0,100
4e1cc7625fa2564b0de1887030d2dbfb81c648b2,0,0,0,0,0,0,0,0,0,0,0,0,0,0,157,7,0,0,0,0,0,0,0,0,0,100
90a3a9e708077304bb2fac90c3b13ce9359edd8c,1,44,0,44,1,0,1,1,1,0,1,1,0,0,158,6,1,0,1,49,0,49,1,0,1,99.80392157
4bd2df49e4495c95ef115ffc070b20d61b37b0c6,0,0,0,0,0,0,0,0,0,0,0,0,0,0,159,3,0,0,0,0,0,0,0,0,0,100
646f29c37deb394cdcce71a3c7499e19367eba0c,0,0,0,0,0,0,0,0,0,0,0,0,0,0,160,4,0,0,0,0,0,0,0,0,0,100
0e81ceb4adc732b9a8f9a5075d5f9c57654d412a,4,201,36,165,1,0,1,2,10,119,1,3,1.240283718,747,161,5,76,61,15,8256,7126,1130,56,43,13,83.83297645
c4eebe0ed4a8489d92a9f75edef4819dc3fcde32,0,0,0,0,0,0,0,0,0,0,0,0,0,0,162,6,0,0,0,0,0,0,0,0,0,100
a46711c54a4d24e2ddc5ffe9d557e08e336dd626,5,371,21,350,1,0,1,2,12,94,1,3,1.827872163,921,163,7,242,204,38,9647,7861,1786,83,68,15,97.81609195
b77d7c7bc7cb11a047808c95b051eb2fbd2c813c,9,1078,41,1037,7,0,7,1,12,50,3,6,2.534963271,336,164,8,179,57,122,8535,2692,5843,60,11,49,97.80701754
fd070cb80dcf08582f1e02486b10b95d124f4039,1,1,1,0,0,0,0,3,7,80,1,1,0,316,165,6,28,28,0,3544,3544,0,24,24,0,100
d519ae8cfe458c637c837d1f029bcb5c5522e0a6,26,364,288,76,0,0,0,1,7,138,2,12,4.293244751,1709,166,7,228,225,3,11037,11014,23,141,138,3,100
64de5233600b2f4a837415d148a3c3aa7234c7a4,6,105,19,86,0,0,0,2,13,115,1,4,1.946641948,1591,167,7,252,247,5,13967,13163,804,100,100,0,99.89247312
b93e9f3561c77449431c5d4243b37379c4dae626,0,0,0,0,0,0,0,0,0,0,0,0,0,0,168,8,0,0,0,0,0,0,0,0,0,100
0003160b08bd55b32eae0049048a6164d5b02d32,0,0,0,0,0,0,0,0,0,0,0,0,0,0,169,9,0,0,0,0,0,0,0,0,0,100
f3ac2c0f1e2b9e7db2aa867b2a05a68dfee75f1b,0,0,0,0,0,0,0,0,0,0,0,0,0,0,170,10,0,0,0,0,0,0,0,0,0,100
dbe1061538abdd50462cc04f6606d7b5942f27f6,2,32,18,14,0,0,0,3,14,61,1,2,0.881290899,611,171,10,94,92,2,5050,4974,76,43,42,1,100
9f28540b5f2eab79fed7159b9f0610b5af53a227,0,0,0,0,0,0,0,0,0,0,0,0,0,0,172,11,0,0,0,0,0,0,0,0,0,100
a1fb9edae97c199670291c6c383b14bdeeb00ff5,1,5,4,1,0,0,0,3,15,113,1,1,0,538,173,12,41,41,0,5261,5238,23,33,33,0,100
19f24d50de1dff153b5d22d44208eab04b6fd76c,0,0,0,0,0,0,0,0,0,0,0,0,0,0,174,13,0,0,0,0,0,0,0,0,0,100
7b07a222c14c9093abbee587131402c783c45e6e,0,0,0,0,0,0,0,0,0,0,0,0,0,0,175,12,0,0,0,0,0,0,0,0,0,100
8c4a7faef286a5ae5cf6f986f6796da60f0251ab,2,382,69,313,1,0,1,1,12,55,1,2,0.994599136,343,176,13,75,50,25,4963,3237,1726,51,29,22,99.78540773
6c06fd0a72e94d9575ea14c9e4bf662f00592590,0,0,0,0,0,0,0,0,0,0,0,0,0,0,177,14,0,0,0,0,0,0,0,0,0,100
6ec94374a907a033b36a8af297be054b79ee8fa4,0,0,0,0,0,0,0,0,0,0,0,0,0,0,178,14,0,0,0,0,0,0,0,0,0,100
d2b9b99f4b21129667f1a12d3564fb950d42d07c,4,48,5,43,1,0,1,1,9,95,2,4,1.161948015,454,179,12,87,85,2,4111,3915,196,44,43,1,86.15537849
20608f0221108c2495820c3b098494dd66fe0854,14,359,26,333,0,0,0,3,22,90,5,11,2.936033144,3571,180,9,524,490,34,34091,32052,2039,233,217,16,97.74571686
bd47628fef161af96462c25a3f382002c9cb8c34,0,0,0,0,0,0,0,0,0,0,0,0,0,0,0,0,0,0,0,0,0,0,0,0,0,100
21b403bb72ceaaa11ad1d46b103d13de18e4ab80,0,0,0,0,0,0,0,0,0,0,0,0,0,0,0,0,0,0,0,0,0,0,0,0,0,100
e06b1ee29220923e33080a0b0fbcc53c8c77fed7,6,92,10,82,1,0,1,3,17,38,3,6,2.008518865,1739,181,1,197,190,7,16481,16065,416,108,102,6,99.82547993
ddb14b54cd7994a1bc5afe0155a95ef10f101124,2,14,2,12,0,0,0,1,6,128,2,2,0.954434003,335,182,2,47,46,1,2485,2435,50,28,27,1,100
60ebe8bea73058f180e7ef08dc55a616aec4b525,0,0,0,0,0,0,0,0,0,0,0,0,0,0,0,0,0,0,0,0,0,0,0,0,0,100
64bda5a419cf43c2cdac08d54eee24610b8ad002,1,1,2,1,0,0,0,3,4,752,1,1,0,156,112,0,21,21,0,1311,1319,8,7,7,0,100
cdb3c0bb8f1e6f85116f4e4652cc653930bac4b7,0,0,0,0,0,0,0,0,0,0,0,0,0,0,113,1,0,0,0,0,0,0,0,0,0,100
648c8d8f6b5eadb6c736974fbb16ef5120da4716,0,0,0,0,0,0,0,0,0,0,0,0,0,0,114,2,0,0,0,0,0,0,0,0,0,100
95590d23017523cc006359fe5b5be389c7aa0c0b,2,15,2,13,0,0,0,3,8,406,2,2,0.936667382,119,183,2,7,7,0,982,865,117,4,4,0,100
e181131d35e92de4fa074ffe0a2f71ed95f49a72,4,15,17,2,0,0,0,3,23,130,3,4,1.886960293,1243,115,3,135,134,1,10746,10784,38,74,73,1,100
3869b8a2f6e1351e0b259f1c7ad08940a3c07d20,2,15,2,13,0,0,0,3,8,406,2,2,0.936667382,119,116,4,7,7,0,982,865,117,4,4,0,100
999219300cf594a0a7fe4b92725e84aa85abe8d9,6,10,11,1,0,0,0,2,13,162,4,4,2.432257449,830,184,3,110,110,0,6738,6779,41,62,62,0,100
ecd0f610555b8a5598c5a725d851e83a4cf959cc,0,0,0,0,0,0,0,0,0,0,0,0,0,0,185,4,0,0,0,0,0,0,0,0,0,100
6a63f7154720a8670064c5b6f5feb82dbb216489,0,0,0,0,0,0,0,0,0,0,0,0,0,0,186,5,0,0,0,0,0,0,0,0,0,100
92574b57484684da3fd62d9e21cf7f3841dc2ff7,0,0,0,0,0,0,0,0,0,0,0,0,0,0,187,6,0,0,0,0,0,0,0,0,0,100
de9b890dd05816cf3d71da7250e59ba760a9116f,4,63,15,48,0,0,0,2,6,124,1,2,1.639964547,180,117,5,23,23,0,1407,1407,0,20,20,0,100
cda983f34b004ccc3e849cfedae9578a9c5e8637,1,1,1,0,0,0,0,2,6,0,1,1,0,6,188,7,0,0,0,32,32,0,0,0,0,100
b9575f29df3cc014f1b076abf52d88249bf4d0ef,0,0,0,0,0,0,0,0,0,0,0,0,0,0,189,6,0,0,0,0,0,0,0,0,0,100
b6fb1f1ac27f19e1b077f14d47c88548ae2df106,26,297,208,89,0,0,0,3,12,253,4,12,4.090535811,5081,190,6,781,776,5,45377,43962,1415,390,387,3,100
a77d1ab535c8d8bc81fcd96cd5c9defa81a5c7a1,0,0,0,0,0,0,0,0,0,0,0,0,0,0,191,7,0,0,0,0,0,0,0,0,0,100
7ebb20136cefb6efe325ee1f30455abd9a3d57da,6,810,47,763,1,0,1,2,12,41,1,4,1.588535395,2027,118,1,305,252,53,24229,18727,5502,124,105,19,99.65247611
5b748aa47b970298a3c6b0c03495b3299079cd3e,6,127,100,27,0,0,0,3,24,142,2,5,2.10277898,2129,192,7,311,309,2,18822,18591,231,155,152,3,100
0defc6e80a2d816f8a25a11cd44b1cb89e2f610a,7,150,38,112,0,0,0,2,15,66,2,6,1.70493214,2117,193,7,237,227,10,20426,19615,811,148,140,8,100
161079155c403b86f4318e683ae46356017c7624,2,73,20,53,0,0,0,2,2,232,1,2,0.554778163,391,119,2,55,49,6,4040,3539,501,24,20,4,100
98fdc6d85d8e3da7b2ac434d4a4d1d102a017a53,20,438,22,416,7,0,7,1,25,50,3,16,3.43144863,2872,120,3,414,391,23,27457,25565,1892,221,205,16,96.20689655
125dc976bf901693d9cc688cb7c10d7e3c65b5d9,4,234,24,210,0,0,0,3,17,1,1,4,1.029003997,1431,194,7,218,194,24,14701,13153,1548,125,113,12,100
046ff52b02636e80aca33976457b74c73d79813b,0,0,0,0,0,0,0,0,0,0,0,0,0,0,195,8,0,0,0,0,0,0,0,0,0,100
3cdd9f57d8b3cb31e407f2ac237676f34a7d08af,33,324,191,133,0,0,0,3,26,116,4,17,4.621231991,8086,196,9,876,868,8,74316,73448,868,511,509,2,100
44dbfe576d0f627255b81be6bd8422e5ae845cf4,0,0,0,0,0,0,0,0,0,0,0,0,0,0,197,10,0,0,0,0,0,0,0,0,0,100
ad7604fcf4bf4f84a66b339b8ea1f4473cd9f84a,2,98,32,66,0,0,0,3,18,10,1,2,0.302515747,861,121,4,137,129,8,7816,7451,365,66,63,3,100
ad0d764dde83e7159a862fef4ec9d97aa0766cbb,6,478,3,475,3,0,3,1,3,143,3,4,1.618209994,73,198,9,51,8,43,3047,471,2576,26,4,22,99.40323956
cd392fd7488b6e49484f98b6c729e25ce34b07e4,4,87,43,44,0,0,0,3,19,10,1,4,1.073097282,1628,122,4,237,226,11,15313,15077,236,132,128,4,100
382a4c8f59578312609310f68d123e88eee17486,0,0,0,0,0,0,0,0,0,0,0,0,0,0,199,7,0,0,0,0,0,0,0,0,0,100
b2efaf76d409e31d580f0d12458a82f1430490e2,0,0,0,0,0,0,0,0,0,0,0,0,0,0,200,8,0,0,0,0,0,0,0,0,0,100
4285526e52d57f85f4e1ec02273ca9f0dbb75a12,0,0,0,0,0,0,0,0,0,0,0,0,0,0,201,8,0,0,0,0,0,0,0,0,0,100
dd66e15806c8e9678521f92c152b2998a37ef0f2,0,0,0,0,0,0,0,0,0,0,0,0,0,0,202,8,0,0,0,0,0,0,0,0,0,100
985465fc73be355986e326ee3d491d3b6a077e05,2,37,1,36,0,0,0,1,17,93,1,2,0.689201985,543,203,9,77,73,4,5237,4947,290,52,51,1,100
bca454e16f0b289b39ab75986e6acdca49488d04,49,1247,662,585,8,0,8,2,27,132,7,30,5.179013411,5918,204,5,842,782,60,49943,47045,2898,431,392,39,95.89270746
8bde666ba1986f5b6c9e20cad82d6037a6739db9,30,2481,68,2413,15,0,15,1,28,45,7,21,4.394805133,2870,205,6,659,477,182,35226,22826,12400,362,240,122,90.98814229
0fc2071960f11b237b3d7c510b1d6fed6be7ee63,8,322,7,315,2,0,2,1,15,110,3,6,2.507685151,749,123,0,135,111,24,8018,6152,1866,85,68,17,99.16981132
6b0f7d82db762858249e276bf9fd6d06e869f949,4,285,151,134,0,0,0,2,20,47,2,4,1.308777199,2259,124,1,321,310,11,21917,20808,1109,135,132,3,100
faad323e2fbeb4a92904946d3efe219caa44887c,4,143,5,138,2,0,2,2,4,66,1,4,1.265646866,290,125,2,48,40,8,3026,2371,655,22,18,4,99.54921112
5a0be80579c5f5dce7be6ab4105ee299ef5a642f,8,228,333,105,0,0,0,2,21,12,1,8,2.331293622,2478,126,3,338,338,0,21769,22765,996,172,181,9,99.9251497
e4aa387fb497285097e09ee6bac156ba2331f854,6,199,64,135,2,0,2,3,17,157,2,3,2.259672209,1401,127,4,260,253,7,12434,11309,1125,117,112,5,99.62714392
ce73ec3527f05fca35ce4e720dd0bad414523c8f,1,0,2,2,0,0,0,3,22,1,1,1,0,717,128,5,86,86,0,6343,6359,16,63,63,0,100
c1d4e7c9cd030e5625fee9fe33c89e3fbfd2dbfa,4,22,22,0,0,0,0,1,15,3,2,4,1.606831583,849,206,7,63,63,0,8126,8208,82,41,41,0,99.7037037
98f4d40a17668c8ee65b58fcbcb6d09ea6a682e5,17,978,268,710,5,0,5,2,19,18,5,10,2.766314332,1882,129,6,304,223,81,19193,14927,4266,183,142,41,98.15225425
ef9ef3c10e8caf0ecf0cf729fe19809d5c4fff09,7,179,21,158,0,0,0,3,29,77,4,6,2.338586568,3167,130,7,421,405,16,28672,27705,967,216,211,5,100
47619ee69422f13bdf73d1586bfa8d54dac61599,5,91,2,89,0,0,0,2,18,23,3,4,1.901573326,1215,131,8,205,195,10,9294,8857,437,121,113,8,100
009330de2cd5503c06a26bd0dcf21dec377d8935,10,571,50,521,3,0,3,1,3,3,2,4,3.049449891,725,132,9,123,77,46,8691,5601,3090,81,53,28,99.48491538
46365f8c484b06fe4f2ef681d0f8533c698820ff,7,536,195,341,0,0,0,1,23,20,3,7,1.518208316,2387,133,10,425,377,48,21963,19923,2040,226,190,36,100
fe6e696d9aaf03e3032ca737f40bef0350ecb718,0,0,0,0,0,0,0,0,0,0,0,0,0,0,134,11,0,0,0,0,0,0,0,0,0,100
a908001970c1b760fdac0f3c00869a5b4ef742fc,0,0,0,0,0,0,0,0,0,0,0,0,0,0,135,12,0,0,0,0,0,0,0,0,0,100
b8f4ffb68cf6adab4015d545715d1370a1ee57b9,0,0,0,0,0,0,0,0,0,0,0,0,0,0,136,13,0,0,0,0,0,0,0,0,0,100
755e59c08dbbc3b03fc2f6fc4908396433b97e88,3,114,8,106,0,0,0,3,24,6,1,3,1.114696124,1640,137,14,279,266,13,15021,14232,789,151,144,7,100
1a390f011236b645404e025aa0f6134c4cb60994,2,101,7,94,0,0,0,3,25,0,1,2,0.950956048,1369,138,15,239,225,14,12381,11779,602,124,118,6,100
85afbefc0c9a90f5f2366e626557e7f6425a0d27,11,79,27,52,0,0,0,3,14,234,3,9,2.524402349,2050,207,3,342,335,7,17300,16930,370,175,170,5,100
c2356f8efdbb8a14ee79d773bacc23b7eb743615,25,630,288,342,2,0,2,3,30,29,7,17,3.953403715,6105,208,4,888,851,37,55052,53264,1788,466,446,20,99.19117647
a5f8c5aa068141bf85411d9e78c4085f54fd1477,0,0,0,0,0,0,0,0,0,0,0,0,0,0,209,5,0,0,0,0,0,0,0,0,0,100
2824f15a0a58afebff940e4026dd07338974b959,2,48,13,35,0,0,0,3,21,0,1,2,0.60365225,1110,210,6,129,127,2,10956,10731,225,56,55,1,100
f7146ede45f13e6d4e27e43c272884b39e0e26ab,14,1327,0,1327,14,0,14,1,1,0,1,7,3.638634744,0,211,6,125,0,125,5701,0,5701,64,0,64,97.61904762
daf812aadf0179682ff0a1947cf93811e10b9460,2,11,7,4,0,0,0,3,27,8,1,2,0.99107606,1443,139,16,239,239,0,12399,12367,32,124,124,0,100
40ee9492192f8ea3afc4be7f6fa55803214e8247,38,2197,1502,695,5,0,5,3,28,89,7,16,3.68839012,9778,212,6,1512,1448,64,88124,85124,3000,744,683,61,96.73691366
922a83c9a10e857d54855463225e9a5c375bc2b9,4,60,10,50,0,0,0,3,29,15,1,4,1.724039301,2126,140,11,319,313,6,18855,18485,370,177,175,2,100
81a0c6ffe76ef0bd4eeaf93b2dfb36c56cae9976,12,684,16,668,7,0,7,1,4,16,3,7,2.720373837,394,141,8,105,59,46,6495,3044,3451,65,34,31,98.70045484
f147d3fff28e6a26395de48c6a0b964e79fc7d48,5,244,59,185,0,0,0,3,30,7,2,5,1.620309026,2843,142,8,444,431,13,25318,23973,1345,252,241,11,100
25c2adf36bfa3d16aa78c041348217239393c2db,4,42,26,16,0,0,0,3,31,15,1,4,1.724387938,1849,143,9,213,213,0,16836,16618,218,152,152,0,99.93564994
f312a577df7a7bb12bc1774f10e0b92b377a53b7,0,0,0,0,0,0,0,0,0,0,0,0,0,0,144,7,0,0,0,0,0,0,0,0,0,100
2e90ff1f6627a17c3a96ec444bc85e8cd730ea7a,0,0,0,0,0,0,0,0,0,0,0,0,0,0,213,6,0,0,0,0,0,0,0,0,0,100
53574720c79cc99dddf5d3dbbe5cae61748eeee4,0,0,0,0,0,0,0,0,0,0,0,0,0,0,214,6,0,0,0,0,0,0,0,0,0,100
574da752d81a49c3200ef66e2b71c560f06b33c7,1,318,0,318,0,0,0,3,15,39,1,1,0,258,145,5,26,16,10,3869,1957,1912,17,13,4,100
7d040c52ffa2daa467e4de3243a94bf655f79693,0,0,0,0,0,0,0,0,0,0,0,0,0,0,0,0,0,0,0,0,0,0,0,0,0,100
c69df40f7c069646b613ebb58739f6be47ea0f89,0,0,0,0,0,0,0,0,0,0,0,0,0,0,1,1,0,0,0,0,0,0,0,0,0,100
73640cc68a2045fe10a2508fac51701d62629f4f,0,0,0,0,0,0,0,0,0,0,0,0,0,0,215,2,0,0,0,0,0,0,0,0,0,100
b2ae1371be24cfcb13f12dcb4ebad6920b9bfd80,23,1760,201,1559,15,0,15,1,8,61,1,8,4.130230245,696,216,3,168,82,86,12154,5463,6691,116,57,59,96.21848739
f8748ccec4a53a7a8d6d4560850122de29aef862,0,0,0,0,0,0,0,0,0,0,0,0,0,0,217,4,0,0,0,0,0,0,0,0,0,100
5c16d42a014426a926250aafc0987d3413933839,2,45,0,45,1,0,1,1,6,34,1,2,0.15374218,85,218,5,15,14,1,805,623,182,7,6,1,93.83857055
feff0cf71e2971524a4de3263de11b2df1c0adbe,0,0,0,0,0,0,0,0,0,0,0,0,0,0,2,2,0,0,0,0,0,0,0,0,0,100
dab9cb7ca3068dfb13a1682233467d78109112fe,0,0,0,0,0,0,0,0,0,0,0,0,0,0,219,6,0,0,0,0,0,0,0,0,0,100
33354e328dcb56f27cded6ed4bb57a402ae9eb85,0,0,0,0,0,0,0,0,0,0,0,0,0,0,3,3,0,0,0,0,0,0,0,0,0,100
334429a83cdc5052b0ec6f050df804b0bf75bba5,1,1,1,0,0,0,0,2,3,100,1,1,0,28,4,4,3,3,0,209,208,1,3,3,0,100
1e3029bc7283e233dc816de7d83b28eddd4f4b36,28,1118,242,876,3,0,3,2,32,121,4,16,3.388286772,6310,220,7,884,722,162,57262,50589,6673,547,414,133,92.26804124
2c0dc4068eac70a18f7cfa430b7e0bc7d84f7524,6,284,100,184,1,0,1,1,16,112,1,2,2.074450502,1250,221,8,297,284,13,11596,10379,1217,96,87,9,99.87789988
53bbebcba6f26aeffea857d9fd87b7d9eaddad65,1,18,10,8,0,0,0,4,33,8,1,1,0,1094,5,5,123,121,2,9357,9296,61,91,90,1,100
1ddf3137b969749980076ec8948630848eb4b06d,3,10,6,4,0,0,0,1,34,22,2,3,1.5,1722,222,7,265,264,1,14514,14496,18,141,140,1,100
34f51a2a233c43e797a4d355e82f86b1e8332cc9,18,339,101,238,1,0,1,2,28,65,4,10,3.628025472,2769,6,6,381,343,38,22898,21497,1401,205,197,8,97.08846585
a963e9806c7dd85b50d6957ec915233865c6216b,17,1930,4,1926,16,0,16,2,3,0,1,5,3.627708096,140,7,7,265,17,248,10899,1025,9874,86,11,75,98.22064057
856ee6b5d7f7dd32c8e34c500c055bbb5db9f3cc,4,96,46,50,0,0,0,4,35,13,1,4,1.647674402,2141,146,1,328,320,8,18767,18531,236,182,178,4,100
4f9cba4b031fe25d394f61d4a43283dadc0856f9,0,0,0,0,0,0,0,0,0,0,0,0,0,0,147,2,0,0,0,0,0,0,0,0,0,100
5e724675bf0560a77b6b84bc19cb3015445ee297,4,22,21,1,0,0,0,2,7,225,1,2,1.80463283,608,8,8,111,111,0,5070,5019,51,40,40,0,100
9155957803b8b0d5030e5fd988ba8679185da489,12,878,0,878,12,0,12,1,1,0,1,1,3.255972137,0,9,9,1,0,1,1019,0,1019,1,0,1,98.62068966
bfd5f5caa609b9084ec816deb4c6bf11eec18bab,5,99,34,65,0,0,0,3,18,174,2,5,1.248519871,930,223,8,109,100,9,7447,7097,350,62,59,3,100
54dc670af7f9b90206879a0212487c5076062f41,7,345,84,261,1,0,1,2,8,71,3,5,1.583987483,1191,148,2,168,142,26,12074,10710,1364,87,74,13,99.85436893
07b8b4d3c9673f231f1c9dab175ed3fbb2a98267,4,29,23,6,0,0,0,4,36,21,1,4,1.138100261,2288,149,3,338,338,0,20357,20331,26,188,188,0,100
98769871e56d9a97792e2dba52345e876908ac63,11,395,147,248,1,0,1,2,9,35,2,4,2.836333839,1080,10,10,155,131,24,9894,8701,1193,100,81,19,99.80544747
af63bb887e817a64d55f75a37e815cecc4fe0c26,0,0,0,0,0,0,0,0,0,0,0,0,0,0,150,4,0,0,0,0,0,0,0,0,0,100
454feb47a1de4da727ab963a8a927996bdcf4965,0,0,0,0,0,0,0,0,0,0,0,0,0,0,11,11,0,0,0,0,0,0,0,0,0,100
28991c52b3e74278bd49c1d79674ff3f9b49a4f7,14,410,73,337,1,0,1,1,9,270,1,3,2.97209422,2437,224,9,618,587,31,20986,19247,1739,198,190,8,99.90262902
b6a0eee7f70ea841e8c3fdd0c507de1e0db73e5a,0,0,0,0,0,0,0,0,0,0,0,0,0,0,12,11,0,0,0,0,0,0,0,0,0,100
9e1f366374827d5471a84c9ece438e89e814b7f8,20,699,225,474,6,0,6,3,37,55,3,16,2.982637436,4422,151,5,623,580,43,41979,39547,2432,355,332,23,99.32432432
857561a392543a7ff8a422b3ace413690abadf3d,0,0,0,0,0,0,0,0,0,0,0,0,0,0,13,11,0,0,0,0,0,0,0,0,0,100
b65dd91c3587d35abafc4ec136e162f9a5c92ac1,12,839,586,253,2,0,2,1,25,131,4,6,2.763735831,2358,225,6,269,224,45,21717,18719,2998,172,155,17,96.84638861
aaf2971ad16ccd9c37040f593121695cd8c9cacb,86,8355,22,8333,82,0,82,1,32,1,4,12,6.072532505,677,14,11,701,119,582,46990,5271,41719,436,53,383,91.15087041
a05107a07a0e1415915c87228fd7c65dd3b23e42,0,0,0,0,0,0,0,0,0,0,0,0,0,0,15,12,0,0,0,0,0,0,0,0,0,100
440bd2ae42c4f2ef02df7387392a1a29d98f3bc9,0,0,0,0,0,0,0,0,0,0,0,0,0,0,16,13,0,0,0,0,0,0,0,0,0,100
5f248157bcb7daec1db66afe8d05f52f791296bc,8,904,84,820,3,0,3,1,18,60,3,6,2.133705843,972,226,5,213,152,61,11931,8570,3361,125,84,41,99.69525468
7c73f0c4a5d8cfff96987c915e749ba9dff5057d,2,107,0,107,2,0,2,1,1,0,1,1,0.999432878,0,227,5,2,0,2,440,0,440,2,0,2,99.82668977
19751c60b284346884e84ce8a38d7712750435a5,2,196,9,187,1,0,1,1,2,3,1,2,0.659375881,78,228,6,27,18,9,1665,602,1063,17,10,7,98.68073879
353ea964e594cb33096263791fae95720203d2cc,23,553,480,73,2,0,2,2,3,4,3,6,3.828815241,1884,229,7,327,198,129,13437,9533,3904,88,53,35,96.8
74eafd3e6758d41fc9e67d2ef6d9c72274aa740b,0,0,0,0,0,0,0,0,0,0,0,0,0,0,17,9,0,0,0,0,0,0,0,0,0,100
74d9b3fb0ea6ced1468c57c11ef3885c1107f86b,3,437,0,437,2,0,2,1,8,4,1,3,0.737294119,80,230,7,67,18,49,2570,534,2036,19,7,12,99.77963861
153fc362325b6934bef27872e9753fcd13a9c030,0,0,0,0,0,0,0,0,0,0,0,0,0,0,18,8,0,0,0,0,0,0,0,0,0,100
705014eb3352180ff8f2cac05dbbc0809b421d8c,39,1344,650,694,2,0,2,2,38,54,7,19,4.390926907,9560,231,8,1435,1349,86,87505,83036,4469,749,707,42,99.20913884
70f715705bc4dfd5bc7ab4728388ed0d340c2413,0,0,0,0,0,0,0,0,0,0,0,0,0,0,19,7,0,0,0,0,0,0,0,0,0,100
2e02ae62850eef6b9fd65fb0c796748d0d348044,2,120,14,106,0,0,0,4,39,22,1,2,0.983870575,1765,232,7,289,274,15,15896,14981,915,147,142,5,100
0143486ad2024f14f9f8fb2f03c4013f1462c2ce,0,0,0,0,0,0,0,0,0,0,0,0,0,0,233,8,0,0,0,0,0,0,0,0,0,100
56c13aa366027c3eb1d4527bfb9286ddc3d61ffb,4,23,3,20,0,0,0,4,40,275,1,3,1.634695839,2142,152,0,314,313,1,19046,18836,210,167,166,1,100
65d95ebe23744f72c0ed40b9a171d3c42cd2906c,1,30,27,3,0,0,0,4,35,2,1,1,0,653,153,1,157,156,1,5589,5570,19,50,50,0,100
42d5e37e3b1c03738787746587dd357330c72296,0,0,0,0,0,0,0,0,0,0,0,0,0,0,20,6,0,0,0,0,0,0,0,0,0,100
208e90b1ae33074aeb89c79e48a0a3489d5cc415,0,0,0,0,0,0,0,0,0,0,0,0,0,0,21,7,0,0,0,0,0,0,0,0,0,100
b15aa4007efbf4cf5d74a68175b85cfab8d4b7c1,0,0,0,0,0,0,0,0,0,0,0,0,0,0,22,7,0,0,0,0,0,0,0,0,0,100
a05f752d251544be8f06adffc5ae8f6f551ee18d,0,0,0,0,0,0,0,0,0,0,0,0,0,0,154,2,0,0,0,0,0,0,0,0,0,100
6148b22acd479f83335b5f272981f04771f86158,0,0,0,0,0,0,0,0,0,0,0,0,0,0,155,3,0,0,0,0,0,0,0,0,0,100
59268875d256c92f748198cea999ed5057c6bf18,1,1,1,0,0,0,0,2,2,36,1,1,0,32,156,4,7,7,0,253,253,0,1,1,0,100
83d053978873e988604de2f07021878b5b987764,2,174,8,166,1,0,1,1,2,273,1,2,0.788771599,307,23,7,54,46,8,3535,2389,1146,31,26,5,99.64896885
b8a5d4d616e5d12b635fbea071eb36bba2598209,0,0,0,0,0,0,0,0,0,0,0,0,0,0,24,8,0,0,0,0,0,0,0,0,0,100
d41e549f2857e954f5e72971d3e8acfc151f7c7e,26,781,68,713,2,0,2,1,8,23,3,8,4.059727409,1948,25,8,255,193,62,21946,17642,4304,164,127,37,94.78229579
86494ffd7c79e8c2b3f7a90abd10085002cbf5f7,0,0,0,0,0,0,0,0,0,0,0,0,0,0,157,5,0,0,0,0,0,0,0,0,0,100
db0d3f9b7b935ce6b36c14c8dbc11c1bc270e608,0,0,0,0,0,0,0,0,0,0,0,0,0,0,0,0,0,0,0,0,0,0,0,0,0,100
9e23fdc1bf456c049c66cddf1b8035d99044afd9,0,0,0,0,0,0,0,0,0,0,0,0,0,0,0,0,0,0,0,0,0,0,0,0,0,100
d661964c2c049820958678a17218b33b3128fd6a,4,621,37,584,1,0,1,1,3,3,1,2,0.763108555,388,158,6,71,49,22,7477,3276,4201,54,32,22,98.7357775
b66f05729d11327ac5945032f5f6376255983266,0,0,0,0,0,0,0,0,0,0,0,0,0,0,26,8,0,0,0,0,0,0,0,0,0,100
395296ce3985c5dfd37151de59a90c2112a06821,13,712,84,628,1,0,1,2,32,99,4,10,1.827005824,2654,27,9,495,373,122,23872,21003,2869,258,201,57,99.40515532
0901714a6f7cd9acedaa2c23129f4bba340c58df,0,0,0,0,0,0,0,0,0,0,0,0,0,0,28,10,0,0,0,0,0,0,0,0,0,100
a1d54d6560c0fc79276ae9739f8ce5e699e46412,0,0,0,0,0,0,0,0,0,0,0,0,0,0,29,11,0,0,0,0,0,0,0,0,0,100
606690c49c5417c0755b3cfd3def67180a6692f2,0,0,0,0,0,0,0,0,0,0,0,0,0,0,159,7,0,0,0,0,0,0,0,0,0,100
6eaeaaa334ede5f52410e60ae0248494ec34d314,3,46,10,36,0,0,0,3,5,72,2,3,0.442660898,324,234,2,69,63,6,2459,2210,249,11,10,1,100
94a8db33ac61770624c328cf6cd0a118de3cec62,0,0,0,0,0,0,0,0,0,0,0,0,0,0,235,3,0,0,0,0,0,0,0,0,0,100
5ab199511898ab195892152e00679ebe560dae17,4,23,3,20,0,0,0,2,2,564,1,1,1.553415107,741,30,11,108,109,1,5496,5500,4,38,36,2,100
868cd831b8add7a2353a1447aaf41666e402b677,3,78,7,71,1,0,1,1,18,80,1,2,1.151182736,111,236,3,18,12,6,1292,1080,212,10,6,4,99.76612095
7e3830a739c6a0168ab1cfe7e63fed35f4ef917f,0,0,0,0,0,0,0,0,0,0,0,0,0,0,160,7,0,0,0,0,0,0,0,0,0,100
67a1133a3ba14b5a89d90c1447607d066ab6be30,2,44,34,10,0,0,0,2,4,70,1,1,0.961236605,230,31,11,29,27,2,1463,1411,52,11,11,0,99.86572675
5b627b5a1e3103f750fd4ba981ef569ad2377bd1,2,30,5,25,0,0,0,2,6,92,1,2,0.985228136,236,237,3,32,29,3,2342,2151,191,17,15,2,100
056044a9f98e8ca4c95d091867bc0009384ca3e7,38,638,169,469,0,0,0,2,4,40,2,8,4.431462166,4104,32,12,442,404,38,39757,36317,3440,309,288,21,99.07786885
f47cea3f84c816787b3d147d4adde1ebf5e4f9df,0,0,0,0,0,0,0,0,0,0,0,0,0,0,33,13,0,0,0,0,0,0,0,0,0,100
0a44790e7866e92b6591d442f140705a079fef30,3,428,8,420,2,0,2,1,3,6,2,3,1.129699542,42,34,14,29,6,23,2462,270,2192,18,3,15,98.12706574
e0536224a0a0b66c6f3416b1d798798139b7aad2,19,78,75,3,0,0,0,4,41,50,3,17,3.785433039,6680,35,15,853,853,0,60864,60673,191,469,469,0,100
8fefd165586f5fd8acd5c3a5786d6012dda68a5b,2,146,58,88,0,0,0,4,42,0,1,2,0.932304708,1880,161,7,294,291,3,16664,16103,561,151,148,3,100
aad34ae00fb0d39d292dff9743fce1ceb3eaa270,2,54,17,37,0,0,0,1,19,31,1,2,0.999856899,566,238,4,92,88,4,5649,5402,247,29,27,2,100
39eb9f1eea636c0cf823570aed5f7dc5e8141bc5,2,76,39,37,0,0,0,4,20,106,2,2,0.738982118,635,36,13,122,119,3,5536,5366,170,52,49,3,100
c9ee6d3f759437ca14d711d312b79dbf2e89983a,0,0,0,0,0,0,0,0,0,0,0,0,0,0,37,12,0,0,0,0,0,0,0,0,0,100
86dd72aff5eabb8b73722388bce82ad713181400,6,64,17,47,0,0,0,3,20,109,1,4,1.270666064,2488,239,5,239,236,3,22611,22181,430,144,141,3,100
a2e7738aa25bba20bafa5f42ee1d628807a26b52,6,353,15,338,1,0,1,2,10,150,1,5,2.367629488,447,38,12,94,62,32,5359,3368,1991,55,33,22,96.74880219
4f6816572cbcdbe7bbd0cf84ac21f799d51acde3,2,5,3,2,0,0,0,1,2,58,2,2,0.954434003,183,39,13,24,24,0,1384,1358,26,16,16,0,100
9d1040b7cf8e19728ad4c8d12ee24da28fb05ff8,4,77,5,72,0,0,0,4,43,35,1,4,1.004746982,2459,162,4,373,366,7,22126,21429,697,199,196,3,100
6f241db4aeeba896c00f0b447fd269f0cee804da,2,11,6,5,0,0,0,4,44,0,1,2,0.997502546,1709,163,5,203,203,0,15063,15030,33,136,136,0,100
8c1c969fc7dc9205ed4ed2000c43093653afc2d7,0,0,0,0,0,0,0,0,0,0,0,0,0,0,164,6,0,0,0,0,0,0,0,0,0,100
59bd56c8ef8f8794f8e1dd8785d8f78363c91da5,0,0,0,0,0,0,0,0,0,0,0,0,0,0,1,0,0,0,0,0,0,0,0,0,0,100
c0cd9f0ac8e4417ae47b5ce98f0d20ae2fb910c3,0,0,0,0,0,0,0,0,0,0,0,0,0,0,0,0,0,0,0,0,0,0,0,0,0,100
9dd0f5c63dfa8ecb19544843d0a74368fe8bf52d,0,0,0,0,0,0,0,0,0,0,0,0,0,0,2,1,0,0,0,0,0,0,0,0,0,100
436a524518e9b36ac8865a51e80e53606d099f28,0,0,0,0,0,0,0,0,0,0,0,0,0,0,165,6,0,0,0,0,0,0,0,0,0,100
e30ab3d8d78cfe3dae70babff9d3c6bcf9065f20,14,880,375,505,1,0,1,3,45,57,3,13,2.634878876,2925,240,6,476,449,27,28734,26128,2606,247,244,3,96.76126878
f4670dd3a1bc8f767ad027c349d25244e2e61187,0,0,0,0,0,0,0,0,0,0,0,0,0,0,166,7,0,0,0,0,0,0,0,0,0,100
d838cf3852c1229dc4f70ef41588e8387fbf780a,21,193,219,26,0,0,0,3,46,46,5,19,3.788930179,6864,241,7,1057,1057,0,58942,59185,243,523,524,1,100
f4ca40e239a76d103b4a7584ca72359b70b832b9,0,0,0,0,0,0,0,0,0,0,0,0,0,0,242,8,0,0,0,0,0,0,0,0,0,100
7b3ace5e5ea5101631309af405109be7dda9a593,1,16,2,14,0,0,0,2,9,84,1,1,0,82,40,13,19,18,1,610,552,58,7,7,0,100
1c3b2befbefacf57ab75d277de8206d08e0818b6,0,0,0,0,0,0,0,0,0,0,0,0,0,0,243,9,0,0,0,0,0,0,0,0,0,100
814f066d99eab276bf4cec44e9bd2d3839b95f7b,2,10,4,6,0,0,0,4,47,0,1,2,0.940285959,1957,244,10,296,296,0,16817,16774,43,152,152,0,100
32a5b761078f7ba2c31815b1ccf6b35e3692d535,5,4,478,474,0,0,0,2,10,677,1,3,0.827350746,836,245,11,46,103,57,4157,6723,2566,32,57,25,99.85218034
5b4cf4402b895464fb90b477514b8359b6f51c30,3,303,197,106,0,0,0,4,48,0,2,3,1.002056822,2448,41,14,395,378,17,22676,21380,1296,178,173,5,100
dfd9c96bab0252800f56c5419d7f005e55d3fc47,1,3,0,3,0,0,0,2,3,21,1,1,0,138,246,12,15,15,0,1087,1081,6,13,13,0,100
b25d198ca8b0f9d572ce46681a05f9c418cb745d,0,0,0,0,0,0,0,0,0,0,0,0,0,0,42,15,0,0,0,0,0,0,0,0,0,100
3a68ea85e10c191a7fa6143ef5770f5bc08b9efa,4,57,95,38,0,0,0,3,12,230,3,4,1.609637648,867,167,8,129,130,1,7326,7731,405,50,50,0,100
c4650913edfa2b3d25cc7eaec443cd0fab1fbed3,0,0,0,0,0,0,0,0,0,0,0,0,0,0,168,9,0,0,0,0,0,0,0,0,0,100
014abba5ea0d2cafe900adc6f16ce7b48eab0b55,0,0,0,0,0,0,0,0,0,0,0,0,0,0,169,10,0,0,0,0,0,0,0,0,0,100
3a1fe600f770ae8d239f8a5a4ee21a881419bcf5,0,0,0,0,0,0,0,0,0,0,0,0,0,0,0,0,0,0,0,0,0,0,0,0,0,100
7666ae996db5b888b3976d45b8a45ffe5ec02d94,0,0,0,0,0,0,0,0,0,0,0,0,0,0,170,11,0,0,0,0,0,0,0,0,0,100
a7869beebf5cd32caebf86a24fd2661f6229c45a,2,74,3,71,1,0,1,1,23,0,1,2,0.237508144,486,171,12,83,82,1,4855,4563,292,23,21,2,99.9260355
9b00a9ddce40150fd66d87ddaae65250247bf196,18,858,174,684,5,0,5,1,36,58,4,11,3.294265537,2414,247,13,438,395,43,22512,22938,426,227,234,7,99.15410077
ce7d83c19ffda8df550ec0a5b2e1362aec5b2ba7,1,4,9,5,0,0,0,4,49,1,1,1,0,1319,248,14,143,143,0,11954,11996,42,102,102,0,100
89175edcf8f19f3d1ac4b57a8e7d992996034d24,0,0,0,0,0,0,0,0,0,0,0,0,0,0,249,15,0,0,0,0,0,0,0,0,0,100
fec431774556868ee926b0ed4bf713807c82bc16,0,0,0,0,0,0,0,0,0,0,0,0,0,0,172,13,0,0,0,0,0,0,0,0,0,100
8cce9a9fc9d1dbeaa028aa42476c7b9d54cb7efa,0,0,0,0,0,0,0,0,0,0,0,0,0,0,173,13,0,0,0,0,0,0,0,0,0,100
78d787fec222f3b6e8b26596cf566eaba8ee4b79,1,2,1,1,0,0,0,3,18,18,1,1,0,272,250,14,11,11,0,2805,2793,12,10,10,0,100
7993de0effee55a87f8366881656b9f109111bc2,2,249,40,209,0,0,0,1,4,30,1,2,0.999576759,407,43,12,45,30,15,5213,3885,1328,35,25,10,99.74264706
202893a99f0e704554dc39973daea2fc8150cd73,9,96,55,41,0,0,0,2,50,100,4,9,2.35336494,3100,251,14,415,412,3,27152,26610,542,261,258,3,100
2692f4768fe1bcfc07e7c69ed026089d5e8d3563,1,8,6,2,0,0,0,2,2,621,1,1,0,802,44,13,210,211,1,7036,7009,27,31,31,0,100
607e7de266234c19dbb7d86d0210735ed1efce5f,0,0,0,0,0,0,0,0,0,0,0,0,0,0,45,14,0,0,0,0,0,0,0,0,0,100
0bf878de6f9b6c6d9000343690e25c4569cc062c,1,1,1,0,0,0,0,2,3,54,1,1,0,92,46,14,30,29,1,670,661,9,3,3,0,100
2b28ce4d02714dcea7234bb2d1355781989ebbb4,0,0,0,0,0,0,0,0,0,0,0,0,0,0,174,13,0,0,0,0,0,0,0,0,0,100
377bc63519dba0b6408af86e6d567a5c8d1f48e6,0,0,0,0,0,0,0,0,0,0,0,0,0,0,175,14,0,0,0,0,0,0,0,0,0,100
76b0560384f53ecb68b1b7e3e702bfde7e88e59b,2,142,54,88,0,0,0,2,37,27,1,2,0.980685732,579,176,15,87,78,9,6063,5384,679,50,48,2,100
6908b8426cf291adc7059869dcff18f5951162b6,0,0,0,0,0,0,0,0,0,0,0,0,0,0,252,13,0,0,0,0,0,0,0,0,0,100
7403ebff168790bccc02732e6b7beb0829d0676a,0,0,0,0,0,0,0,0,0,0,0,0,0,0,253,14,0,0,0,0,0,0,0,0,0,100
95f4f2f021bf1388766b007fc869f52fb17d2aa8,0,0,0,0,0,0,0,0,0,0,0,0,0,0,254,15,0,0,0,0,0,0,0,0,0,100
727b27fbd212e5bf77f1ba7f77104b757523dded,0,0,0,0,0,0,0,0,0,0,0,0,0,0,255,16,0,0,0,0,0,0,0,0,0,100
c438e51149924c4ec88eac67140ae430994841d2,0,0,0,0,0,0,0,0,0,0,0,0,0,0,256,17,0,0,0,0,0,0,0,0,0,100
f370386c69bcf31f3124b31e8bf0e8e4afbf35c9,0,0,0,0,0,0,0,0,0,0,0,0,0,0,47,9,0,0,0,0,0,0,0,0,0,100
07cf4a3e3189eedd95309e72777a6734b8465e5e,0,0,0,0,0,0,0,0,0,0,0,0,0,0,0,0,0,0,0,0,0,0,0,0,0,100
14863225da35327a625998aa7638f3f0a3354e2e,0,0,0,0,0,0,0,0,0,0,0,0,0,0,177,15,0,0,0,0,0,0,0,0,0,100
f623bddf80265f0a4874b2305d198a6cf399e469,0,0,0,0,0,0,0,0,0,0,0,0,0,0,178,13,0,0,0,0,0,0,0,0,0,100
f51c886158c9c0f7dc115f0c6f0aa0e08772e0b9,4,472,199,273,0,0,0,3,51,20,2,4,0.921035775,2613,179,14,452,404,48,25425,23146,2279,210,202,8,100
d381f3d58aae758162e1aa9d49566d4a5f2a59c0,0,0,0,0,0,0,0,0,0,0,0,0,0,0,257,14,0,0,0,0,0,0,0,0,0,100
8056a8d543ef71a15c07e090fd7dfd59497d98bf,0,0,0,0,0,0,0,0,0,0,0,0,0,0,258,15,0,0,0,0,0,0,0,0,0,100
b731f64aef7426d3d17689affb5178eede4db0d9,0,0,0,0,0,0,0,0,0,0,0,0,0,0,259,13,0,0,0,0,0,0,0,0,0,100
33fdad76d1cda550c6abfe6eb39da40a9274410b,0,0,0,0,0,0,0,0,0,0,0,0,0,0,260,10,0,0,0,0,0,0,0,0,0,100
dda382f491f1bb26bdeb31620092a11ce9fdb710,3,407,0,407,2,0,2,1,6,27,1,3,1.108795148,108,261,11,48,13,35,2788,842,1946,25,5,20,99.81570217
ed07049a0e4296e55e88b875adaea21129af6f8f,3,45,0,45,0,0,0,2,5,104,1,1,0.986426729,292,262,12,43,34,9,2018,1753,265,16,14,2,100
b9ce7a11162466654ae9d8d5b84c2b592b6bfef8,1,16,15,1,0,0,0,3,19,59,1,1,0,535,263,13,28,27,1,4014,3996,18,18,18,0,100
043d2aa642e695c7c61c0b771d978fc352caf203,7,1024,0,1024,7,0,7,1,1,0,2,6,2.592875544,0,264,13,151,0,151,4160,0,4160,49,0,49,99.2321755
7fc276f609280ea51b782426a72d979613ae6707,4,51,4,47,0,0,0,3,52,274,2,3,1.869094096,2210,265,14,329,325,4,19225,18901,324,183,181,2,100
1ee2c1bc45599a19f6a9546ca2718366f46f47b5,1,15,22,7,0,0,0,2,4,89,1,1,0,78,266,15,12,13,1,386,419,33,2,2,0,100
2ad344f02db95a7ff4af83fd1de9bfb17ded650e,0,0,0,0,0,0,0,0,0,0,0,0,0,0,267,15,0,0,0,0,0,0,0,0,0,100
072a73e00d091232133006289d412a2f3a2a14b3,0,0,0,0,0,0,0,0,0,0,0,0,0,0,268,16,0,0,0,0,0,0,0,0,0,100
e13fa5ecd20dc877be6c6be2179f194255e69200,0,0,0,0,0,0,0,0,0,0,0,0,0,0,269,17,0,0,0,0,0,0,0,0,0,100
80051c9e846101130f29956db459d8d4243e2bd4,2,31,2,29,0,0,0,1,14,62,1,2,0.684038436,226,270,17,23,19,4,2243,2102,141,13,12,1,100
079ce35ef2604a8f6eff35c698a38052009792df,1,7,1,6,0,0,0,3,7,17,1,1,0,117,271,18,13,13,0,979,931,48,5,5,0,100
fa9fbbd7c74c2ff9e1e897258f6a102755ad4b4f,0,0,0,0,0,0,0,0,0,0,0,0,0,0,272,18,0,0,0,0,0,0,0,0,0,100
99d51436752489cc9da440b8876a61ab26a8c68a,0,0,0,0,0,0,0,0,0,0,0,0,0,0,273,19,0,0,0,0,0,0,0,0,0,100
34f67ae0e75b61a12f5c261b358a64478ec37f07,0,0,0,0,0,0,0,0,0,0,0,0,0,0,274,17,0,0,0,0,0,0,0,0,0,100
de0bf1db9f1116b02ef30d72cbfc157649a5010a,15,137,16,121,0,0,0,3,53,100,6,11,2.979252397,4842,275,18,492,482,10,45338,44247,1091,319,315,4,96.24003038
ab624ddabba53772ca72a5cb717baa22712ab27d,9,87,32,55,0,0,0,2,5,248,3,8,2.705461571,1127,276,19,97,93,4,9992,9430,562,77,75,2,99.76133652
8f229628f96bcc283e9d05f1fdf615f5cfd93b52,2,51,13,38,0,0,0,2,9,160,2,2,0.661976064,598,277,20,118,109,9,4521,4292,229,17,16,1,100
b28ab21ee543c9f75df4f00a8d14f770277dbd4c,7,62,28,34,0,0,0,3,54,106,4,6,2.431102277,2864,278,21,360,358,2,26210,25945,265,217,214,3,100
1b1f9d2aa945cdbc3a58da67090a67add1d2dae4,0,0,0,0,0,0,0,0,0,0,0,0,0,0,279,22,0,0,0,0,0,0,0,0,0,100
e895819fec853d86ed5f8a4ee7fb7a7f1bd5aa1a,3,156,30,126,0,0,0,3,20,33,1,3,0.826290664,1115,280,23,116,110,6,9944,9103,841,54,50,4,100
bff013f04759df3b1ce84184e1d3222ce7aef756,9,665,178,487,1,0,1,4,24,69,2,2,2.677376752,1508,1,0,261,199,62,16092,13480,2612,93,83,10,99.92050874
3f47408e72fe717ad63e7b8464c6ef6fd4ae59b5,0,0,0,0,0,0,0,0,0,0,0,0,0,0,180,0,0,0,0,0,0,0,0,0,0,100
038b6b315d8353e75fe3fd663ac034e025e541d2,7,14,19,5,0,0,0,3,55,62,1,7,2.514577651,3539,181,1,531,532,1,32477,32512,35,255,255,0,100
7cc347134a0084d45c740c42bb2760c7c3ac01cf,0,0,0,0,0,0,0,0,0,0,0,0,0,0,2,1,0,0,0,0,0,0,0,0,0,100
d64112d6a95e6279fd54f2164e89857124450b67,12,290,143,147,1,0,1,2,23,120,1,5,2.574397842,3547,281,22,665,656,9,31123,30211,912,225,219,6,96.69522644
0cf25009940f222e0abdf823db539f2e5218e3e5,0,0,0,0,0,0,0,0,0,0,0,0,0,0,182,2,0,0,0,0,0,0,0,0,0,100
f672aaeffdad9539b52d0122cc2593e7352d6329,0,0,0,0,0,0,0,0,0,0,0,0,0,0,282,22,0,0,0,0,0,0,0,0,0,100
67acb9d6edf3c62ddc63299bb7bb304b950b7f7d,4,78,52,26,0,0,0,3,56,46,2,3,1.102330121,2703,283,23,250,249,1,24332,24114,218,170,169,1,100
085d5c8642f6a47f25cf7ed6d6e3526dbbdc625f,22,441,269,172,1,0,1,3,40,97,5,15,3.490914092,6616,284,24,748,733,15,58249,57139,1110,473,465,8,98.98904802
8e8b51b8ed4e3e62eadaa806c19d5981421111f7,1,1,1,0,0,0,0,1,2,36,1,1,0,156,285,25,30,30,0,838,838,0,11,11,0,100
b7f5995aa815fa203617d70a23ce34022e57afa9,1,1,1,0,0,0,0,3,7,0,1,1,0,164,183,3,23,23,0,1409,1404,5,7,7,0,100
e15629c2eb10265676c8fae6b1444a07c005e1aa,29,325,254,71,0,0,0,3,45,142,9,19,4.331349366,8139,3,2,1611,1581,30,65339,64941,398,604,605,1,100
b73e62ba3cb58df422246bfad880657b982f1bc5,1,16,7,9,0,0,0,2,2,38,1,1,0,232,184,4,65,63,2,1480,1436,44,17,17,0,100
a10444d3939c93a6ab8b21c0f03a97e295190bc4,5,497,10,487,1,0,1,1,39,105,2,4,0.569872003,1156,286,19,280,189,91,12408,9034,3374,118,90,28,99.91546915
65b1dee9f430719d9cfde696bd263e91ad866df4,0,0,0,0,0,0,0,0,0,0,0,0,0,0,185,5,0,0,0,0,0,0,0,0,0,100
fa47dd2d5daa3e1add9223727e8895abb9ce7c52,0,0,0,0,0,0,0,0,0,0,0,0,0,0,186,6,0,0,0,0,0,0,0,0,0,100
d934645b294e390ad4690791e55932d71ea41391,10,353,162,191,0,0,0,3,40,44,5,7,2.796822408,3130,187,7,508,483,25,26598,25213,1385,280,272,8,98.64061172
46ec799cc53af51806722e2e7ad7d5ef61e02df6,0,0,0,0,0,0,0,0,0,0,0,0,0,0,188,8,0,0,0,0,0,0,0,0,0,100
56e97e225e65b50d15e6f59211f796788dd97446,1,1,1,0,0,0,0,5,41,16,1,1,0,450,189,9,68,67,1,4154,4146,8,35,35,0,100
d0a9b99999a8d51a6612da62d025fbb48c471bc6,2,17,8,9,0,0,0,6,46,10,1,2,0.529360865,1247,4,3,271,268,3,10990,10966,24,93,93,0,100
2dba5feabd6ab1821546888c607bb3e8d032de61,2,14,17,3,0,0,0,3,3,2,1,2,0.770629069,526,5,4,71,72,1,3924,3873,51,42,42,0,100
5de10081cdd2092ebba54700091db2a04fbdb711,2,3,5,2,0,0,0,2,9,16,2,2,1,547,190,10,113,113,0,4578,4578,0,34,34,0,100
425237d59cc0344abfa74819f6e16f7214a59945,0,0,0,0,0,0,0,0,0,0,0,0,0,0,0,0,0,0,0,0,0,0,0,0,0,100
9ab13a315bca318eb63a98ea50e2305f6362b8dd,0,0,0,0,0,0,0,0,0,0,0,0,0,0,1,0,0,0,0,0,0,0,0,0,0,100
4bc3e738eb692cdf141263e92b9b9785ff99da5c,5,53,6,47,0,0,0,3,32,13,3,5,1.586255451,1932,287,11,266,263,3,16454,16055,399,159,159,0,100
05277c27db46dec01727be798f99a7964cdba15f,0,0,0,0,0,0,0,0,0,0,0,0,0,0,288,12,0,0,0,0,0,0,0,0,0,100
2b14ec1022f442576c996a5ec20e9a2a3803f011,3,8,4,4,0,0,0,1,10,84,1,3,1.384431504,378,289,13,65,65,0,2415,2413,2,25,25,0,100
28c9efb1dea7b9c6aff026aa93584858201606fb,0,0,0,0,0,0,0,0,0,0,0,0,0,0,290,9,0,0,0,0,0,0,0,0,0,100
a4ceec90cc32a09d8035fe07e7377ee0f71923a7,0,0,0,0,0,0,0,0,0,0,0,0,0,0,3,0,0,0,0,0,0,0,0,0,0,100
1c9b8b4191390b5024596bbe15d657b3bf84eb78,2,30,5,25,0,0,0,3,12,59,1,2,0.970950594,758,291,10,161,159,2,6172,5979,193,73,71,2,100
96a11675d83a0afc36e6893b6750abbb61a7c0fd,6,105,63,42,0,0,0,2,23,44,2,5,2.168754581,1206,292,11,229,228,1,9176,8945,231,106,105,1,99.70098249
69f6adfbc78e13485db0e20a7b8b2add431333d2,0,0,0,0,0,0,0,0,0,0,0,0,0,0,293,12,0,0,0,0,0,0,0,0,0,100
8a3c167ab3587ef1316fcfea445530974076daba,0,0,0,0,0,0,0,0,0,0,0,0,0,0,0,0,0,0,0,0,0,0,0,0,0,100
838a0d4594385b2106867ee7fcd31982c448cd0b,6,439,261,178,2,0,2,4,57,39,2,6,2.110971116,2852,191,8,461,451,10,26588,25535,1053,216,208,8,97.87322769
6078c9aecce94e0a5e74711531e96fccf7ef6b84,0,0,0,0,0,0,0,0,0,0,0,0,0,0,1,1,0,0,0,0,0,0,0,0,0,100
bb78955020044d111589b24c96df9d755657853c,0,0,0,0,0,0,0,0,0,0,0,0,0,0,4,1,0,0,0,0,0,0,0,0,0,100
a165234cd373a2fbbcea23ca2a4d6936c907519f,10,173,30,143,0,0,0,2,33,177,2,5,2.642504219,2574,0,0,318,304,14,22091,21185,906,185,180,5,98.26822392
dd030ecaa06e1514d5c80aa816cd206f0bf16d68,2,33,2,31,0,0,0,3,15,18,1,2,0.994693795,429,192,7,48,45,3,4023,3831,192,29,28,1,100
9eafb165addfe6d919c5179412cea5e34b3003e3,4,25,4,21,0,0,0,3,11,32,1,4,1.997482603,672,193,8,84,80,4,6585,6342,243,52,52,0,99.80087614
a2801f0eaff29a834915f243245e2d28b86a2bc3,2,72,63,9,0,0,0,3,12,151,1,1,0.26231122,464,6,2,96,94,2,4006,3949,57,30,30,0,100
81ceabbdf6f817c1a25f439073941d5e19b88c9c,0,0,0,0,0,0,0,0,0,0,0,0,0,0,5,2,0,0,0,0,0,0,0,0,0,100
38fd4f35845400f454b24cdd1db8e28ad3f84f21,0,0,0,0,0,0,0,0,0,0,0,0,0,0,6,3,0,0,0,0,0,0,0,0,0,100
3f51160f4a89536fa95cc167abbae4fab362e127,3,68,74,6,0,0,0,2,44,19,1,2,1.207885323,710,294,7,92,93,1,6607,6648,41,51,54,3,100
d1940ba75df69cada0dea11708fc9052071bd41e,3,42,14,28,0,0,0,4,58,4,1,3,1.177965317,2607,295,8,425,420,5,23862,23571,291,187,186,1,100
d671b12768b19d9d2b4e84c3528db1bec43388de,0,0,0,0,0,0,0,0,0,0,0,0,0,0,2,1,0,0,0,0,0,0,0,0,0,100
89f25d411897dbd35a2baf7a96a0cf137c273f4a,1,8,4,4,0,0,0,6,49,0,1,1,0,819,296,9,207,206,1,7065,7052,13,59,59,0,100
91072c10669c390338e39a9b705ffdd3bb5a3868,10,101,67,34,0,0,0,2,59,126,3,10,1.888939176,3653,297,10,439,434,5,32031,31687,344,252,249,3,100
1abd5a248ef424642aef2c40ce0bb7abbbc900ce,3,38,7,31,0,0,0,2,6,269,1,2,1.210435447,318,194,9,49,43,6,2812,2661,151,26,24,2,100
2ef0fc46d0e32c636da369911a1527e849f09049,0,0,0,0,0,0,0,0,0,0,0,0,0,0,3,2,0,0,0,0,0,0,0,0,0,100
4fa10b6aecb248d09ee2a58b289a1d47f7d24419,68,4179,406,3773,29,0,29,2,20,57,3,17,4.966023984,4054,0,0,984,135,849,46148,15521,30627,467,78,389,91.23082973
beb5a09976f943c4a4943f04d8bc58b36dba3771,0,0,0,0,0,0,0,0,0,0,0,0,0,0,4,3,0,0,0,0,0,0,0,0,0,100
2a7c4326cd6160b3e54c53b34399f96a4db8723f,1,3,2,1,0,0,0,1,2,261,1,1,0,43,195,5,2,2,0,284,267,17,2,2,0,100
7826a1ab5adb7a20f9b01e27f34451252369240f,0,0,0,0,0,0,0,0,0,0,0,0,0,0,196,6,0,0,0,0,0,0,0,0,0,100
127b378df5ff2712754abf32e86bdc279d7a29e2,6,168,10,158,0,0,0,1,19,40,1,4,2.070771706,1619,298,11,290,278,12,15280,14154,1126,119,115,4,97.86407767
d06b8229ab0a08b52c9bac87056c30a5b9ad02ac,7,496,69,427,0,0,0,2,25,102,1,2,2.266471779,1978,2,2,352,294,58,20039,17358,2681,155,134,21,95.0059453
a07f3cc041813e5431bfc5e1b43f0d466756ca70,2,6,3,3,0,0,0,1,46,199,2,2,0.764204507,480,197,6,79,78,1,4276,4266,10,39,39,0,100
bf2e60917b7f202ccfa45accbdd836c7513427f2,1,15,1,14,0,0,0,4,8,66,1,1,0,223,0,0,62,59,3,1416,1344,72,49,48,1,100
c1efcf061d39d46ae184cd180455b001e0a33b75,0,0,0,0,0,0,0,0,0,0,0,0,0,0,5,3,0,0,0,0,0,0,0,0,0,100
531a9684f57836a600e7172d7b6d089cef19f7ca,0,0,0,0,0,0,0,0,0,0,0,0,0,0,1,1,0,0,0,0,0,0,0,0,0,100
7f2a40864df223cde3b1292961b40ebbeaec4267,9,44,37,7,0,0,0,6,47,40,3,8,2.86274516,2516,7,1,286,278,8,23483,23504,21,168,168,0,100
30893c5e5be5a1c3a2f104d554cc3772a6ef7b81,13,404,241,163,1,0,1,3,17,241,5,9,2.412865575,1482,198,7,241,228,13,11524,10541,983,129,122,7,94.18653283
bed2a70d6302325ec909ff119694784618d5bda4,0,0,0,0,0,0,0,0,0,0,0,0,0,0,0,0,0,0,0,0,0,0,0,0,0,100
ab95c1a7bbf1209c22aaf661a69bd007c5277bc8,9,231,56,175,1,0,1,3,26,31,1,4,1.615538976,2491,299,5,536,523,13,21645,20688,957,159,155,4,99.82706442
6fddccd6a28d7cf194926c3d44debeb1b49cd434,1,64,58,6,0,0,0,4,4,37,1,1,0,195,199,7,59,58,1,1618,1580,38,13,13,0,100
eb98bfe78942caf1fa630e35f619f3a4f2f61856,2,31,27,4,0,0,0,3,21,13,1,2,0.216396932,1110,200,8,186,187,1,9540,9433,107,89,89,0,100
8cdc8981d7d6f71b5de506b3ba390763e9e7e80b,1,6,0,6,0,0,0,2,7,35,1,1,0,238,201,9,38,38,0,1908,1836,72,17,17,0,100
1a405f9c18f9570886ffb56f3bf008b2cc4adc0c,1,2,1,1,0,0,0,4,13,43,1,1,0,276,202,8,38,38,0,2437,2426,11,17,17,0,100
7b7f4e0b68637fec82af4443aedcecc63cf10747,2,3,8,5,0,0,0,2,4,117,1,2,0.845350937,105,203,9,17,18,1,600,633,33,12,13,1,100
64f017a7079d547ebd9b972b4a115ce807855e33,10,110,20,90,1,0,1,3,24,85,5,9,2.919862461,1798,204,10,190,180,10,17523,17040,483,123,115,8,99.78438982
ec94d2ad169f92feb9005ca1dc06845216c77055,3,41,2,39,0,0,0,3,24,20,1,3,1.191464644,1241,205,11,182,178,4,9602,9367,235,78,77,1,99.82780887
f408e93eebfd870f7eef547438c41260f729fdd9,3,22,3,19,0,0,0,3,11,117,2,3,1.202292189,639,206,11,113,111,2,4400,4301,99,51,51,0,100
0023236fbaee47e6c80852943d253b3ff641f823,0,0,0,0,0,0,0,0,0,0,0,0,0,0,7,0,0,0,0,0,0,0,0,0,0,100
a2c3faad143a284dd22557b289efa8190688abf1,0,0,0,0,0,0,0,0,0,0,0,0,0,0,8,1,0,0,0,0,0,0,0,0,0,100
e817b214387525def94930a7375b297157037155,2,6,2,4,0,0,0,5,48,50,1,2,1,709,9,2,97,97,0,6960,6910,50,53,53,0,100
f54325f1c99fec1a9d06a1fab7893b7656a8398f,0,0,0,0,0,0,0,0,0,0,0,0,0,0,10,3,0,0,0,0,0,0,0,0,0,100
4b2e6ba9e81bc5d1c1c2e12d1a6bedb27bdf2f0e,0,0,0,0,0,0,0,0,0,0,0,0,0,0,3,0,0,0,0,0,0,0,0,0,0,100
0596c9fc3edcd4fbf9dae5a0bedf31e99cabc930,1,25,22,3,0,0,0,7,50,105,1,1,0,822,0,0,209,207,2,7073,7065,8,60,59,1,100
96f2306f9dfc133f9e7d79421dc97eee0a4d671e,1,56,0,56,0,0,0,6,42,105,1,1,0,567,1,1,109,94,15,4798,4462,336,53,52,1,100
8044ca48d041f59a66ccd597a1cf7e9832a60146,5,26,9,17,0,0,0,3,51,111,4,4,2.049215766,1264,8,0,280,280,0,10367,10244,123,87,87,0,100
5ca1ed3f0e1fd3b896a4b7160b960d40864dfd89,0,0,0,0,0,0,0,0,0,0,0,0,0,0,2,2,0,0,0,0,0,0,0,0,0,100
165efca69939577f56526d7df48b07ec4509c8e0,3,12,2,10,0,0,0,5,9,148,2,3,1.198117421,530,3,3,104,104,0,3607,3552,55,18,18,0,100
2f195e7f275839436c49bfee4de4afa4f586d736,0,0,0,0,0,0,0,0,0,0,0,0,0,0,300,0,0,0,0,0,0,0,0,0,0,100
b856269e98f6e094f2bea775afb97ad2c4d9d9c7,0,0,0,0,0,0,0,0,0,0,0,0,0,0,301,1,0,0,0,0,0,0,0,0,0,100
b6e0d60fd5f18171397bc2a9c160614149515ae5,3,139,0,139,0,0,0,7,34,132,2,3,1.407140562,2109,4,4,312,297,15,19412,18419,993,154,149,5,100
e8a148497192863d8ad019474faddb74974d4e2c,3,0,139,139,0,0,0,7,35,0,2,3,1.407140562,2210,5,5,297,312,15,18419,19412,993,149,154,5,100
dd0b051ec58ca292fca1862701e1089ad408e18d,6,161,10,151,0,0,0,7,43,64,4,5,1.924771721,3641,302,2,497,481,16,33307,32200,1107,249,244,5,99.87085665
7bb2709d16694fb7957e2018532121474a810f14,0,0,0,0,0,0,0,0,0,0,0,0,0,0,303,3,0,0,0,0,0,0,0,0,0,100
c1081a49da3553f55b33edecb416de99c90d10b4,3,7,53,46,0,0,0,3,44,62,1,3,0.693767374,1567,304,4,150,165,15,12563,12836,273,94,95,1,100
71e0e09b9d7c9f999741a71b4e779eb89a051760,2,2,3,1,0,0,0,3,21,109,1,2,0.970950594,743,305,5,77,77,0,6767,6776,9,45,45,0,100
180c6e571efed300e067bfa0cd009f7ce55d2ee5,20,789,53,736,3,0,3,3,45,250,3,7,3.046984384,3642,306,6,749,644,105,35375,30485,4890,341,287,54,99.4411006
100749b49a394f928cebd24ba085a5120066dcad,0,0,0,0,0,0,0,0,0,0,0,0,0,0,307,5,0,0,0,0,0,0,0,0,0,100
4c56c61f85c4c38a1d2bec3088130f2ea5f1e8fe,3,111,25,86,0,0,0,2,21,451,1,3,1.54999544,455,308,6,39,29,10,5029,4325,704,23,21,2,100
a52112d8633c2eb5dea0c3a6ffd3f308594a3996,5,312,26,286,1,0,1,4,60,135,1,4,1.853982489,2464,309,7,409,380,29,24877,22688,2189,184,172,12,99.8714653
698a56526ce5704e49054b8f8e40ab173a9a3166,48,8234,0,8234,48,0,48,1,1,0,2,10,5.324720254,0,310,8,1291,0,1291,40897,0,40897,577,0,577,87.47007183
2a441bec1f4d0ae2621e4b878f4738c032392e0a,1,10,5,5,0,0,0,2,4,9,1,1,0,91,311,9,18,16,2,793,748,45,3,3,0,100
630a562b2d0adf6178f29cb802d6179c074c213e,1,0,3,3,0,0,0,2,3,539,1,1,0,20,312,6,2,2,0,133,164,31,1,1,0,100
adfdef023b3dbdf7c03b4039a814d47a50ef41e3,1,64,22,42,0,0,0,3,8,243,1,1,0,444,207,0,106,96,10,3466,3229,237,12,10,2,100
1d84cbbdc3d8acc0a02c94b8c8076500acf6c93c,14,311,30,281,0,0,0,2,2,0,2,5,3.575745807,1904,208,1,533,510,23,15302,13603,1699,293,268,25,99.32760553
3e4f28f50c03035915187f624a41064a82d2af37,0,0,0,0,0,0,0,0,0,0,0,0,0,0,6,0,0,0,0,0,0,0,0,0,0,100
d2d6ff7d18bf6f6165feaa440359b5a7fc5c2723,85,2812,2233,579,3,0,3,2,49,165,6,28,5.527259896,12681,209,2,1866,1778,88,108981,106722,2259,919,877,42,89.36994016
0d01f356c93d4a06fb907a2de3401c4f11dd1d13,2,5,3,2,0,0,0,2,27,30,2,2,0.811278124,366,210,3,43,42,1,3779,3767,12,22,22,0,100
f8fe0945c9c99a6979c3acfa463e0796db50b42f,32,3507,130,3377,16,0,16,1,22,1,4,13,3.956291894,2504,211,4,1132,640,492,36059,18500,17559,514,338,176,98.19849329
7d9f22c2dd30013e05105f238e052e5c2f2d2a48,1,0,4,4,0,0,0,1,2,0,1,1,0,9,212,5,1,1,0,67,67,0,1,1,0,100
5b7945eebd283c535992476b12c341ff5c8d5f99,0,0,0,0,0,0,0,0,0,0,0,0,0,0,213,6,0,0,0,0,0,0,0,0,0,100
a2eca47e3b0cb7deb25e0d182582d9ad906a83b8,1,17,5,12,0,0,0,4,19,19,1,1,0,120,313,1,16,14,2,888,812,76,7,7,0,100
51d24ae3b9da0996d9d2d1bcb1496c810d27e287,0,0,0,0,0,0,0,0,0,0,0,0,0,0,314,2,0,0,0,0,0,0,0,0,0,100
e5fe91a44bff992e571d3ff5811113068d635e36,15,691,397,294,0,0,0,3,4,21,3,8,1.903041538,3224,9,0,785,734,51,25099,23491,1608,323,311,12,99.90331937
92dc6faa0c6d9f80340e27dfdea76b1a6a6c2d3c,0,0,0,0,0,0,0,0,0,0,0,0,0,0,10,1,0,0,0,0,0,0,0,0,0,100
d185522b52767e2468e8d0a5ebd375a8827b0fa8,7,583,65,518,0,0,0,2,5,4,2,4,2.128148778,1525,11,2,497,393,104,14210,11075,3135,154,122,32,99.25057022
4d9cf4564baa5aac6a1e123d8670fc1c13034668,8,45,24,21,0,0,0,3,4,18,1,1,2.507548583,1415,214,5,391,388,3,9048,8876,172,141,138,3,100
eb6e656be868fba22aaa330d98137be78e30bdcb,19,1108,907,201,1,0,1,3,5,6,3,8,2.622988534,4207,12,3,956,958,2,31672,30728,944,379,359,20,99.56996361
3cc1bd5b837c944c8af1d50451ef89a1d3f15ee6,0,0,0,0,0,0,0,0,0,0,0,0,0,0,315,2,0,0,0,0,0,0,0,0,0,100
b6acff6d5ba1cdde8ddde96fe55071732fb83da0,0,0,0,0,0,0,0,0,0,0,0,0,0,0,316,3,0,0,0,0,0,0,0,0,0,100
08f56903929861a4c81445646be07fb18d099b5b,14,755,423,332,0,0,0,3,6,4,3,5,2.968297331,3172,13,4,770,695,75,25987,23888,2099,263,256,7,99.47019868
a96424a1ad566b8d13c18bd1d1694ffd0d33844c,3,77,66,11,0,0,0,2,9,83,1,3,1.419776039,798,317,4,70,66,4,7543,7506,37,59,55,4,100
5a4dd2e724bdca8db02dd4b9b6d59eb19296de95,7,482,45,437,1,0,1,2,6,6,2,3,2.124706014,1480,14,5,412,366,46,13598,11227,2371,124,110,14,99.90085922
fdf97ae4d0caf4b10c8f3f6562132a0cdac76c38,15,447,247,200,4,0,4,3,8,111,4,7,3.332765138,2614,215,5,566,541,25,20631,19644,987,212,204,8,99.14191419
aa15cd0aec15000a225f2a32477c4158d224b24e,5,10,7,3,0,0,0,4,50,193,1,5,2.228072225,1338,216,6,205,205,0,12167,12100,67,94,94,0,100
69af0ae77a389afffa5dcfedd6297528628b12f8,26,2070,44,2026,23,0,23,1,13,3,3,5,4.098182194,525,2,0,254,100,154,11012,3869,7143,168,65,103,98.41218406
d3bca39fd90b77b28902fbdc5a9050a204ec8898,7,95,76,19,0,0,0,2,8,13,2,3,2.504698592,2018,217,3,553,553,0,15479,15323,156,173,173,0,100
9dc4cfbcb10f38cbf8fa331fe76093d9791d6204,0,0,0,0,0,0,0,0,0,0,0,0,0,0,218,4,0,0,0,0,0,0,0,0,0,100
0b85d5a0cac7b0d9ca9e3548538051f8b332bc25,23,741,224,517,2,0,2,2,47,57,4,16,3.574064363,7014,219,5,916,846,70,63340,60366,2974,494,468,26,93.67216425
c9e58e0aa31fa833981a8c069e23a4ca3e07b293,4,1181,10,1171,2,0,2,1,4,14,2,4,1.404186185,115,220,6,113,27,86,9125,1001,8124,59,8,51,98.8355681
29880e77c953cf4ddc8e9733b5d71c6dd75a328c,1,3,9,6,0,0,0,3,24,2,1,1,0,490,221,6,118,118,0,3634,3631,3,36,36,0,100
315b5d184b4d0dda414693573c8f5e7e880c19f9,0,0,0,0,0,0,0,0,0,0,0,0,0,0,222,7,0,0,0,0,0,0,0,0,0,100
9f643b5b916a97b8d39626d2d50aba4953a542fa,2,10,2,8,0,0,0,1,5,0,2,2,0.650022422,442,223,8,83,83,0,3613,3557,56,38,38,0,100
0c7468954f5cf9f85fd066397707e3528ee89da8,11,1288,27,1261,8,0,8,1,24,0,3,7,3.134101236,776,224,9,211,58,153,12726,7321,5405,132,44,88,92.2988944
6a24cad180b071290211c2695c567e83c13e9f97,3,179,46,133,0,0,0,1,6,22,1,2,1.530124965,529,15,1,110,94,16,4855,3472,1383,42,38,4,99.45401092
f3bbdc151d3aed6c8843f763c06d12c81033de7b,6,243,192,51,0,0,0,2,25,15,2,5,1.830802899,2237,16,2,538,516,22,17091,17087,4,188,178,10,99.58088852
2ea3a455ecc9ba7add35b76c15b7d3089e52f070,1,2,0,2,0,0,0,2,7,663,1,1,0,65,318,0,10,10,0,463,454,9,7,7,0,100
def9e385cc17c2bceb9450c82947370fadc09c3c,40,633,2299,1666,1,0,1,3,61,135,3,28,4.375870118,10628,17,2,1722,1843,121,80948,91904,10956,705,783,78,87.95620438
c3bf72cd0bf40db688b425d6db9f6f58c73e34a9,1,8,2,6,0,0,0,2,27,22,1,1,0,886,319,1,76,76,0,8651,8606,45,43,43,0,100
7fca22fff296bc63d049b36cf95a95f985435a02,0,0,0,0,0,0,0,0,0,0,0,0,0,0,7,0,0,0,0,0,0,0,0,0,0,100
bf5f53a7f9f32ff3ff98742536f14f665611d48b,2,10,9,1,0,0,0,4,10,195,2,2,0.899743759,370,320,2,67,67,0,2682,2674,8,20,20,0,100
ee5b03cabcf20cbe72094f84d687252b17cf395d,15,221,16,205,2,0,2,4,10,30,3,5,2.275270547,2983,0,0,764,727,37,22237,21032,1205,280,265,15,99.67585089
ed2632c87c42b4e942f0d14ea19a8ccf3c81b5e9,0,0,0,0,0,0,0,0,0,0,0,0,0,0,0,0,0,0,0,0,0,0,0,0,0,100
cd342783a65b56040a77f615c94a0f443a8c1d40,0,0,0,0,0,0,0,0,0,0,0,0,0,0,3,1,0,0,0,0,0,0,0,0,0,100
ed3c32c125cc77c74d18d5053a38278f43e3d77b,1,1,3,2,0,0,0,4,9,428,1,1,0,74,18,3,8,8,0,572,591,19,7,7,0,100
46f9f0f8e27632213f89c30f92c93cd04ecaef84,0,0,0,0,0,0,0,0,0,0,0,0,0,0,1,0,0,0,0,0,0,0,0,0,0,100
e20d76e3bcbc8fd743f96bf64fc2d1526a1dc885,15,189,89,100,0,0,0,2,10,26,2,5,3.298879302,2677,19,4,742,716,26,20440,19924,516,314,307,7,100
71714d20f1e3d5e4e30332ca3c692e186f90c220,2,9,10,1,0,0,0,4,11,4,2,2,0.899743759,372,225,8,67,67,0,2674,2682,8,20,20,0,100
2119666fd0d224c8d6f0d9c139ad11749e58bf73,2,8,6,2,0,0,0,4,11,166,2,2,1,479,20,5,84,84,0,4266,4250,16,33,33,0,100
ea6c3cb5a0c69ae76fe6a6d337080fe87c48aa5b,9,1133,0,1133,6,0,6,1,27,12,4,7,2.381929396,167,0,0,119,12,107,8411,1581,6830,68,8,60,98.22980367
f6388234b8f1fac00e83df08614c346957107573,1,1,22,21,0,0,0,8,54,19,1,1,0,893,1,1,214,218,4,7547,7691,144,59,62,3,100
758b3d4df5033d60b5fa42a15d5bc4ee196c89bc,12,1356,452,904,4,0,4,4,37,178,2,5,2.491679954,2004,1,1,387,256,131,22931,17041,5890,234,149,85,99.61759082
33d60746ab6be129251dabae7a3b104c8533e095,30,1953,57,1896,16,0,16,1,49,23,4,13,4.300273635,3591,226,6,679,493,186,41915,31247,10668,335,249,86,96.46632437
d95775161d1b51cff7bfc8756c0a72f639667cec,1,0,0,0,0,0,0,1,1,0,1,1,0,249,227,7,35,35,0,1919,1919,0,15,15,0,96.18171683
43a1e25bdd1d3f7700c905a29c21dcd601591872,6,98,92,6,1,0,1,3,16,247,3,4,1.99196821,600,321,3,73,73,0,4846,4711,135,48,47,1,99.81086193
ae92406d993c0f9be7fd90deb0647f3845f5ba0a,0,0,0,0,0,0,0,0,0,0,0,0,0,0,228,5,0,0,0,0,0,0,0,0,0,100
854b792802f9a56a47bb7bb461077921867bd967,7,634,15,619,3,0,3,2,9,200,1,2,1.605035083,663,1,0,231,131,100,7236,4568,2668,57,20,37,99.81116806
1821667e7e666e89e7440ca22e34a5bbd665d700,2,10,9,1,0,0,0,4,13,9,2,2,0.899743759,370,322,4,67,67,0,2679,2671,8,20,20,0,100
1b066acb0cd8dd334b3e0ba3d7cb05e3d30aa47e,0,0,0,0,0,0,0,0,0,0,0,0,0,0,323,5,0,0,0,0,0,0,0,0,0,100
710c17f5505d99429d76ae16479f31d6c09dbd81,1,1,1,0,0,0,0,1,3,21,1,1,0,265,21,4,65,65,0,2019,2019,0,21,21,0,100
95083cb01fd2daeded1d55f6a2ce4791a933c974,6,599,45,554,1,0,1,6,15,46,3,6,0.788271016,636,1,1,170,87,83,9440,5811,3629,73,55,18,93.54651163
774975c970cc2613a9f955c35f8eead16ad1d9bf,17,291,13,278,1,0,1,3,28,259,4,8,3.05205811,4556,0,0,894,864,30,38137,36528,1609,353,335,18,98.13542689
9dc96c467a6315c6713ec76d8afe32dbe46271a1,6,139,124,15,0,0,0,2,32,268,1,2,2.310130761,1677,0,0,129,132,3,16476,16405,71,93,97,4,100
4db76f9594f442045990bfb4f055868b959aaafc,0,0,0,0,0,0,0,0,0,0,0,0,0,0,22,5,0,0,0,0,0,0,0,0,0,100
94a827220cc02b722607adbb40f2060809a12ab9,1,10,4,6,0,0,0,4,7,15,1,1,0,87,23,6,20,19,1,506,471,35,5,5,0,100
1fa05264311fbdbaf7f4cb63bb7b3e09628f80f8,18,427,347,80,5,0,5,6,30,94,3,8,3.652089494,3434,324,5,653,666,13,28683,28818,135,224,211,13,99.49307198
699498d70efa0aedf3370abe44ffceffa41e7df6,3,22,0,22,0,0,0,5,9,488,1,2,1.544024096,271,0,0,30,27,3,2097,1982,115,16,15,1,99.8990239
c1b57d5648a1707528908b1ad70bdc7c7cf6ddeb,10,178,28,150,0,0,0,2,11,28,3,5,2.528788801,2154,24,6,581,555,26,17534,16333,1201,247,237,10,100
cea70bc6f94c61607b8fc7406bf15ff0f4b3df90,0,0,0,0,0,0,0,0,0,0,0,0,0,0,2,2,0,0,0,0,0,0,0,0,0,100
f694a910b8743c197b6c33c3513558fd940e3478,3,186,84,102,0,0,0,9,33,9,1,2,1.196761149,1159,2,2,105,98,7,12014,11101,913,66,65,1,100
d4efc378437f690669a382bdd413ef9371fac568,23,602,782,180,4,0,4,2,26,16,3,6,3.959970626,1889,25,6,312,333,21,14362,15615,1253,136,153,17,97.59538314
b9525a576d1f4149883fad494f4d4e8310cc7f85,4,71,41,30,0,0,0,7,14,98,1,1,1.837330176,924,3,2,91,88,3,9501,9235,266,47,47,0,100
52a8805e92ce41e87e542b42ea6d1b73206d2af4,0,0,0,0,0,0,0,0,0,0,0,0,0,0,4,3,0,0,0,0,0,0,0,0,0,100
db359532ac32130ce1af044784b6d746fdafc70a,1,3,2,1,0,0,0,6,62,49,1,1,0,1416,5,4,151,151,0,13283,13278,5,95,95,0,100
86740c148b16940930bdbfe88998b31046d781f6,1,2,3,1,0,0,0,6,63,0,1,1,0,1416,6,5,151,151,0,13278,13283,5,95,95,0,100
b688f80e9072d6c7c9bc46d441b8ce87318bcdd5,1,11,9,2,0,0,0,1,2,24,1,1,0,393,2,1,81,80,1,3387,3379,8,19,19,0,100
6600335558587d3446124a155a9753c26670858e,0,0,0,0,0,0,0,0,0,0,0,0,0,0,3,2,0,0,0,0,0,0,0,0,0,100
94478b4928fbfdc8af95e3e0491a6d9fcdcd85fc,0,0,0,0,0,0,0,0,0,0,0,0,0,0,7,6,0,0,0,0,0,0,0,0,0,100
e8ab914274f7f108eced0f6c35bd4607c2287850,0,0,0,0,0,0,0,0,0,0,0,0,0,0,8,6,0,0,0,0,0,0,0,0,0,100
5d8c80a75484b228e5bbbc0f849f4a01e2d08821,0,0,0,0,0,0,0,0,0,0,0,0,0,0,9,7,0,0,0,0,0,0,0,0,0,100
20aa6cf2536b4ca7c8fbf3fde285bb545898659c,5,47,11,36,0,0,0,2,11,60,1,4,1.572731761,1172,26,5,305,300,5,8785,8544,241,113,110,3,99.96938151
3d212311ccc45eb48d3e9b36cb2f472ece2a0846,0,0,0,0,0,0,0,0,0,0,0,0,0,0,0,0,0,0,0,0,0,0,0,0,0,100
7a1b8c15f95b05fedbbf2393f39bf769e7d885e2,1,9,5,4,0,0,0,7,64,14,1,1,0,1416,1,1,151,151,0,13294,13278,16,95,95,0,100
eec1201c9ff604b0697af2def66ade6d02ab0603,2,157,23,134,1,0,1,1,5,11,1,2,0.81996531,107,4,3,25,14,11,1863,956,907,8,4,4,93.57456882
389ec561475350ae6ff0d2994b7dbf9445dd63db,0,0,0,0,0,0,0,0,0,0,0,0,0,0,2,2,0,0,0,0,0,0,0,0,0,100
be9c264824a5e5860c2dd2b44f70cb38f7c628f0,0,0,0,0,0,0,0,0,0,0,0,0,0,0,3,3,0,0,0,0,0,0,0,0,0,100
74a8de1a99cc3b511dfe7f7a233e5adb8f7a9e75,1,1,1,0,0,0,0,8,55,51,1,1,0,875,10,8,214,214,0,7547,7547,0,59,59,0,100
c413975aa9a10b2e3f576c68fefeffe11229b693,9,118,49,69,2,0,2,1,9,343,4,4,2.544100881,298,1,0,74,66,8,2146,1943,203,32,29,3,94.46626205
6fb7b82a8fb2442f6ffb08c9946fc446c34b6707,2,2,2,0,0,0,0,3,3,48,1,2,1,534,229,0,78,77,1,4367,4363,4,26,26,0,100
3567060906bcd329cfbb8461bd59aba75b9fecde,6,503,119,384,0,0,0,5,29,96,1,3,1.094259515,1978,0,0,198,157,41,19484,17121,2363,137,110,27,100
e8a438ca69da3843fe1aaad64b141160e4d7fa0a,2,18,17,1,0,0,0,6,17,35,2,2,0.512709142,266,3,0,29,29,0,2314,2310,4,9,9,0,100
a1f9008b8c1184dc3c0ab2d6a7beaa7c0fd558fc,1,8,2,6,0,0,0,4,6,23,1,1,0,107,230,1,12,10,2,1032,956,76,4,4,0,99.9661476
c91f582a787a6ea88c4b8d2e4828e85f708ce7f0,2,18,0,18,0,0,0,2,4,244,1,2,0.650022422,1075,231,2,261,261,0,9188,9052,136,69,69,0,100
78c835edf1597c7d0082790c248235f08fb8474a,1,7,1,6,0,0,0,8,56,18,1,1,0,875,232,3,216,214,2,7593,7547,46,59,59,0,100
de6122fa31998bf591b48c73c325fc502a1b1837,2,9,5,4,0,0,0,4,18,43,1,2,0.985228136,544,4,1,68,66,2,4068,4026,42,44,44,0,100
2c881a4668de7c077c01df886158423d20d65b8a,12,243,486,243,0,0,0,7,38,178,2,3,2.900066951,3328,5,2,396,401,5,28330,30780,2450,266,269,3,99.93229519
28410df5f40cdfd2cb09c9fe99cbfb615b2038c0,10,168,139,29,0,0,0,7,39,6,3,3,2.982661888,2882,6,3,377,368,9,25844,25599,245,234,231,3,100
d9d487bc33b4711d483490ccaaf17aabf5c480aa,3,15,9,6,0,0,0,7,36,0,2,2,1.554585169,991,7,4,97,95,2,9326,9302,24,67,67,0,100
d612d75f48d7fb8742d4d78de64b3161708f37e1,0,0,0,0,0,0,0,0,0,0,0,0,0,0,233,4,0,0,0,0,0,0,0,0,0,100
765ce51c3713ed18ff644949760cc42b891dd2b0,2,6,14,8,0,0,0,4,5,818,1,2,1,340,0,0,26,27,1,2353,2366,13,10,10,0,100
ed4ae0e3ea7ef5646e8ecc30143929e21b8aaab4,2,47,14,33,0,0,0,4,57,143,2,2,0.60365225,1010,234,5,244,239,5,8705,8498,207,69,68,1,100
3bffc0dcc525d456d84011170ffe9f62885cb6c8,29,319,613,294,0,0,0,3,27,261,8,13,4.73186573,4629,8,5,1074,1200,126,32218,34309,2091,597,594,3,99.89847716
efc8d09c8664f2105b15519d52c79c3b1fb425df,0,0,0,0,0,0,0,0,0,0,0,0,0,0,8,0,0,0,0,0,0,0,0,0,0,100
f6e27b59c8e1c4a322853f0820d68d75985b166d,6,206,79,127,0,0,0,4,11,74,3,6,1.933041623,2099,235,6,310,281,29,16732,15915,817,146,143,3,98.46005775
1620284e4c5d81a8722746d93fc32482bf41583a,168,609,804,195,0,0,0,3,65,249,12,76,6.477957557,32892,9,6,5714,5732,18,263764,266435,2671,2402,2404,2,96.91203993
edc4786b957988f8029a652ce7cf1c97d0e40711,0,0,0,0,0,0,0,0,0,0,0,0,0,0,6,0,0,0,0,0,0,0,0,0,0,100
b305ba5059997f043a47a7a8e802e6355bb5e31f,0,0,0,0,0,0,0,0,0,0,0,0,0,0,9,1,0,0,0,0,0,0,0,0,0,100
b3efebc9690774750d7bfa5fe43d27328746f75a,0,0,0,0,0,0,0,0,0,0,0,0,0,0,7,1,0,0,0,0,0,0,0,0,0,100
05bdbc621f5312e001c428fbd4abe4dc1341a7c0,1,1,1,0,0,0,0,3,3,2,1,1,0,123,27,0,17,17,0,873,873,0,9,9,0,100
3b1a7d09c9f54a816b6e3a2c5b8f942b6052e3af,2,56,26,30,0,0,0,3,6,496,1,1,0.978869851,245,2,0,33,31,2,1735,1521,214,11,11,0,100
ec1b160ac10cf6e35d764a6c33f337e173f9466f,30,1368,372,996,1,0,1,7,66,69,5,13,3.233002095,7651,10,6,1142,1051,91,74191,67354,6837,633,575,58,97.02085402
3725dcf113056c47184e4a5ba95aeb7d57e61de0,2,17,20,3,0,0,0,2,6,330,1,2,0.494182935,175,1,0,31,36,5,1299,1368,69,5,5,0,100
40e639eddf377e683ff4a1ba88fb6c120eb36ab3,41,201,226,25,0,0,0,3,53,171,10,32,4.55309128,9277,11,6,1691,1691,0,71335,71554,219,596,596,0,100
590b38ac59dfcd94c3b31e93aa5e4f8143792216,0,0,0,0,0,0,0,0,0,0,0,0,0,0,8,2,0,0,0,0,0,0,0,0,0,100
0e7ef3af9e59584bd9ea87b10d6264a97ba4b41e,1,0,54,54,0,0,0,3,3,239,1,1,0,21,0,0,0,0,0,0,217,217,0,0,0,97.9329041
c3318467eb3954b7fc6490312bee4ce0d36cf081,2,13,3,10,0,0,0,3,4,51,1,2,1,256,28,1,43,41,2,2109,2072,37,14,14,0,100
ac80b8b61b122abe57a644cbfe3868f07c301914,2,1,15,14,0,0,0,10,40,382,1,2,0.69621226,823,3,0,77,79,2,7543,7666,123,48,49,1,100
6145bf481c2244e6b505086f41c3a5d58519d303,3,186,6,180,1,0,1,1,11,61,2,3,1.278518299,143,1,0,39,18,21,2203,1092,1111,22,12,10,99.6993988
c99117308509efac5bc937f1de102d65de27db2b,1,23,17,6,0,0,0,9,59,57,1,1,0,896,236,0,219,218,1,7681,7623,58,60,60,0,100
e5b6438f2af3193edd7567af013eb23261d3ef45,0,0,0,0,0,0,0,0,0,0,0,0,0,0,9,1,0,0,0,0,0,0,0,0,0,100
cae6522da3a209c0bb32492293553fc6bd23c313,2,12,34,22,0,0,0,5,19,73,1,2,0.495969072,549,5,0,64,68,4,3912,4053,141,44,44,0,100
ffcdbb17689ed325715a43dc407ca20348277a5a,6,19,33,14,0,0,0,5,20,59,3,5,2.19995881,1716,12,0,280,289,9,12272,12386,114,118,118,0,100
90efc4afb6cac6be09f28afd1aaf467ae05b64b5,12,154,48,106,0,0,0,3,52,324,2,7,2.754583264,3737,6,1,672,665,7,33109,32361,748,276,270,6,100
b72a4c44a107e9640838730fe5ac66e38c65f21e,11,103,19,84,0,0,0,4,31,126,2,6,2.847620647,3966,4,0,731,717,14,32072,31607,465,291,281,10,99.96659987
6e5863e867791c65916b63e08905a4a04de0beaf,2,12,0,12,0,0,0,4,10,490,2,2,0.811278124,116,4,1,11,8,3,1140,1044,96,5,5,0,100
03857baa6a895147ce2cdffb214bf77b3f72704b,0,0,0,0,0,0,0,0,0,0,0,0,0,0,237,1,0,0,0,0,0,0,0,0,0,100
407ff00c1b51cf164dffc356526e8966acee5dc8,8,102,3,99,0,0,0,5,53,56,2,5,2.675274005,2918,0,0,536,523,13,25410,24807,603,201,198,3,100
6c3b981ad055fa17cae818c8f0f79ff49416de11,0,0,0,0,0,0,0,0,0,0,0,0,0,0,7,2,0,0,0,0,0,0,0,0,0,100
46f539e1535986b0e3992da7fe6e1c7f6f01a69c,14,940,9,931,6,0,6,1,29,39,4,7,2.52873983,1064,8,3,259,137,122,14605,9141,5464,128,61,67,99.43465248
22650d6eb49d3ffb0c33dd1d7d63b4c22c680ff7,2,5,0,5,0,0,0,4,7,273,1,2,0.721928095,256,29,0,18,17,1,1833,1809,24,12,11,1,100
d8db43100cc182ecb59a75236b810ca45c19e725,2,32,0,32,0,0,0,2,2,98,1,2,0.928362072,593,11,0,67,63,4,5274,4983,291,42,40,2,100
e92502ddffe6632af515468b60c6b52add8d50e1,3,42,13,29,0,0,0,5,54,15,2,3,1.322179346,1665,1,1,231,228,3,15167,14945,222,128,125,3,100
cc503701d4b91d6d2cfe9f5a909343bc87805c3e,5,60,9,51,1,0,1,1,12,51,1,1,1.904953528,1127,10,0,236,235,1,7595,7458,137,46,45,1,99.90072799
384c33585e549dbd9f729e3bb61c6fda2448016d,1,47,7,40,0,0,0,2,3,196,1,1,0,85,30,1,23,15,8,995,785,210,8,7,1,100
9683c1170e4455eb69ace90d3d92bc57e65eea60,3,19,5,14,0,0,0,1,12,24,2,3,1.534337198,279,2,1,41,39,2,2262,2203,59,23,22,1,100
b725caaa879240f3012e85bf888072a42f2d4308,1,9,3,6,0,0,0,5,10,81,1,1,0,624,12,1,207,204,3,4711,4643,68,72,72,0,100
53f88222a70c9afbb367758d810b5590d9b72bf7,2,3,3,0,0,0,0,3,13,10,2,2,0.918295834,703,2,2,98,98,0,6016,6016,0,66,66,0,100
e0c6b98ef274e984ae3b1a61bddf79c5e21aa17c,4,229,91,138,1,0,1,2,2,24,3,4,1.557626234,517,13,2,130,110,20,5262,4462,800,65,55,10,99.83471074
9c0c46dbcb4687b0db199248610da327273cab1d,1,53,3,50,0,0,0,2,2,709,1,1,0,98,9,4,26,15,11,1101,805,296,11,9,2,99.90089197
34d235f393c9d5e83b47c19b846cd7c96f10577d,7,365,133,232,0,0,0,7,32,50,1,1,2.448884117,2716,31,2,703,619,84,22614,21827,787,186,185,1,100
10e82ff47c915bb7f3d750b9fbc398b2dd04f88d,10,555,152,403,0,0,0,6,33,76,3,3,2.361200146,2404,32,3,548,442,106,22620,20485,2135,104,106,2,99.57010582
100fee3dfde04415dd5d7f1aa6110e52aee74b44,0,0,0,0,0,0,0,0,0,0,0,0,0,0,33,4,0,0,0,0,0,0,0,0,0,100
2139e2879852d3c4a9551c83e0d84df515ffca14,0,0,0,0,0,0,0,0,0,0,0,0,0,0,34,5,0,0,0,0,0,0,0,0,0,100
b6c408b372c57da90faf348f0f9d804fd8274b9f,0,0,0,0,0,0,0,0,0,0,0,0,0,0,35,6,0,0,0,0,0,0,0,0,0,100
75bcccd1d12e01f749b223bdc894fc2f3ca988f2,6,189,25,164,1,0,1,11,32,28,4,6,1.084286301,2310,4,0,319,308,11,19315,18607,708,179,167,12,99.76851852
511c88670d6b0a9b668fec8a1d9513709b4dc2e4,6,300,21,279,0,0,0,4,10,566,2,2,1.410925342,1022,10,2,266,207,59,9999,8529,1470,77,63,14,97.24137931
2f1cb57a757e15c97a2b1437e282be48c553d4e8,50,3446,270,3176,18,0,18,4,32,43,4,19,4.61633538,7303,238,0,1744,1285,459,77321,59333,17988,721,537,184,96.20656678
cc08c517e2e3d5e45e8ea6d8ed7a0ff07dc4d412,1,41,15,26,0,0,0,3,4,26,1,1,0,343,5,0,77,74,3,2316,2127,189,17,16,1,100
49453f280bcf221cbe35ee018c26b6be61ad6443,0,0,0,0,0,0,0,0,0,0,0,0,0,0,10,0,0,0,0,0,0,0,0,0,0,100
bda289ef7e001c2831a219c527ae102ebab8d104,8,236,103,133,0,0,0,2,11,110,1,4,2.756103584,1751,36,7,440,404,36,14502,13511,991,196,169,27,100
7f914ab9eb3c4cb0ceccea090bed47db220c3780,8,235,2,233,1,0,1,3,55,34,4,7,2.411897269,1266,14,3,230,196,34,11224,10032,1192,112,97,15,98.35013749
c8f3184fccd5236e9f2b5366c301fd3b286f6ef2,2,38,3,35,0,0,0,6,12,54,2,2,0.964956767,243,11,1,54,50,4,2077,1793,284,9,8,1,100
143c0f813527c85edc30d3d589837fc20bf9bb04,6,275,3,272,2,0,2,2,13,183,4,5,1.822458004,745,13,0,177,146,31,7077,5598,1479,79,65,14,99.82030548
6679c8eed29d9850a43b682970084e197ad16dc7,0,0,0,0,0,0,0,0,0,0,0,0,0,0,12,2,0,0,0,0,0,0,0,0,0,100
c9c26d74187532f6f6922443f52ffa2739e81c86,0,0,0,0,0,0,0,0,0,0,0,0,0,0,13,2,0,0,0,0,0,0,0,0,0,100
bf377abbba2e8f855636c2bb897e9c80f8a20d1d,7,106,57,49,0,0,0,3,33,105,1,5,2.459038315,2007,11,2,390,387,3,16608,16259,349,187,186,1,99.91026025
92d02817846d9431042923182f7feeb1a3a2a7d2,3,227,46,181,1,0,1,1,2,4,2,3,1.033518529,153,14,1,41,25,16,2332,1179,1153,18,12,6,99.82052049
6cd68119412dc6458947557f47debe253bd8abf3,0,0,0,0,0,0,0,0,0,0,0,0,0,0,5,1,0,0,0,0,0,0,0,0,0,100
89f70609645fa53cb5492035c49c2aa4b99031e9,20,1004,365,639,3,0,3,6,56,44,2,8,3.56591231,6037,6,2,1070,993,77,54597,51333,3264,403,374,29,99.73134328
19a5f65c9bcafc77df164c4dd75c89782b4f4076,1,28,0,28,0,0,0,1,2,1,1,1,0,91,15,2,5,5,0,847,791,56,3,3,0,100
6ccba52c293d4c7e419a63326665faee7db9f231,25,815,229,586,0,0,0,3,18,19,3,8,2.683137524,4779,239,1,1024,981,43,41721,37985,3736,388,369,19,97.02292349
57f4f79d6f8c39ee2504b23e27b1082b667e8cb1,7,860,4,856,3,0,3,11,28,75,3,5,1.432009117,1525,12,3,307,245,62,18930,12809,6121,172,125,47,97.84881984
4b8b9e22f8e279f739899bc50e20ffdae6142586,9,450,217,233,0,0,0,4,19,43,2,7,2.34689346,2944,37,6,653,620,33,24295,23156,1139,277,269,8,100
f83e8ee863d1657be652130024f3e7c99a2482f1,13,61,31,30,0,0,0,4,12,252,4,6,3.581977937,1283,38,7,221,214,7,8906,8798,108,67,67,0,100
d204df78e4babb3fe3c515c00596a03cd40c4794,0,0,0,0,0,0,0,0,0,0,0,0,0,0,39,8,0,0,0,0,0,0,0,0,0,100
37c8a4d1a57aabec88d5ecee60df6f562caaf8b8,7,643,44,599,5,0,5,1,17,1,2,5,2.582620142,303,7,3,113,66,47,5079,2445,2634,45,16,29,99.58146487
804de951d20d3b0f694f122b0841c1d86e10c7e0,1,1,0,1,0,0,0,4,4,136,1,1,0,145,1,0,15,15,0,1218,1211,7,6,6,0,100
f74bd951b038588017cbff173b945e548c8e6d06,0,0,0,0,0,0,0,0,0,0,0,0,0,0,2,1,0,0,0,0,0,0,0,0,0,100
2763ff3038d167bdf971fca3c5d18e378911b09e,2,18,2,16,0,0,0,2,12,4,1,2,0.468995594,746,40,9,138,138,0,5390,5397,7,56,56,0,100
224eaffe78d0e5844755f0015eee35732eeb5028,3,99,29,70,0,0,0,3,6,98,1,3,1.490611602,596,41,10,165,154,11,4051,3553,498,74,69,5,99.21921922
c8f9f363bf67a4a464510fdd2831d8b3162dba24,0,0,0,0,0,0,0,0,0,0,0,0,0,0,42,11,0,0,0,0,0,0,0,0,0,100
a7870cdede63eca6a11e1fd5d42824d0efd63186,1,30,0,30,0,0,0,7,14,23,1,1,0,180,11,1,30,24,6,1517,1360,157,7,6,1,100
5d8fae555492cb53fc9ce33974184e471103b39c,21,462,312,150,0,0,0,4,17,21,3,10,2.879938188,5465,14,3,1151,1117,34,45010,44260,750,435,415,20,99.51456311
f640da72112cd2647b6dee5a5ac498b360a83ee3,2,3,3,0,0,0,0,5,33,107,2,2,0.918295834,1094,43,11,113,112,1,10227,10224,3,66,66,0,100
aa74c73d0e9fbfd9c51de9f6cdcdea6141575e8e,52,5044,258,4786,25,0,25,1,35,94,2,8,4.765259091,2989,8,4,874,431,443,40172,22471,17701,548,225,323,95.74887387
4367c491579e4de90770d95e4c746e289a6cf930,12,170,81,89,0,0,0,3,9,11,4,8,2.969720964,2855,240,2,399,392,7,25104,24384,720,158,157,1,98.7026202
a810f15648e764d1e15f1e810718da8eba7758f6,5,115,2,113,0,0,0,3,14,194,1,3,1.200034863,1846,5,0,284,278,6,17555,16667,888,97,91,6,100
ebf23779428421255fb5f18bc1199d0ae18c301b,4,5,4,1,0,0,0,1,2,0,1,1,1.974937501,107,9,5,21,21,0,681,673,8,13,13,0,100
352f4397e9430d1ca25dc0fa334a8405a8d63e7f,4,4,5,1,0,0,0,2,3,0,1,1,1.974937501,107,44,11,21,21,0,673,681,8,13,13,0,100
5adca84101913a4f9f2ae87d13fa759089407019,52,254,5040,4786,1,0,1,2,36,0,2,8,4.763715566,5715,45,12,426,878,452,22305,40322,18017,222,552,330,95.82890542
e5e324ceef430218b7912512dd2f76858397a425,1,4,0,4,0,0,0,1,2,18,1,1,0,446,13,3,36,36,0,4212,4160,52,21,21,0,100
62a05c97c0bcc33bc28ed1141cc8f742776677a4,54,5071,279,4792,25,0,25,2,37,0,2,9,4.806659853,3340,10,5,958,515,443,42934,25231,17703,584,261,323,95.82890542
09089e09f80c1f10123d4132438f7c426087acb1,12,272,141,131,0,0,0,3,38,47,2,8,2.800557251,5990,11,6,719,705,14,53581,53024,557,323,318,5,98.15815324
02cf8c4884eb346f7b993bd46d6e789bd73f006d,7,519,54,465,4,0,4,5,35,45,1,3,2.379571742,1286,12,7,326,291,35,12684,10869,1815,130,102,28,98.40977184
d8c2a10e080eb79ba23f646270313089b2afdfda,36,1205,756,449,3,0,3,5,20,42,4,11,4.363012154,5612,241,2,1018,957,61,49379,46260,3119,456,444,12,99.5856956
4f4ab9b98d2f0cfa9b6e9fddac0e993c2b1203c1,5,69,81,12,0,0,0,4,7,0,1,2,1.947761188,681,46,9,114,116,2,5604,5706,102,39,39,0,100
acfe9a48fa3b1a4f75f52b6d43d0bd6ee964c441,10,271,227,44,0,0,0,6,22,33,4,8,2.21440737,2817,47,10,666,660,6,21950,21959,9,250,247,3,100
5f508c97c7ea9436e16dbacb6770f14d0114eca3,35,1447,336,1111,3,0,3,5,57,31,7,21,4.183370451,13093,13,8,1912,1813,99,121630,114471,7159,894,844,50,95.73301549
48477e20816b9cb890e65da0b6ed289e51f3bb69,13,338,664,326,0,0,0,11,30,1,3,10,2.815081394,4718,48,11,771,850,79,36919,38753,1834,286,300,14,100
808eb1d1c314ae0445f05afa90ca90490e2723e8,26,1158,546,612,1,0,1,6,36,10,5,15,3.52764303,5561,14,3,1024,884,140,51703,47958,3745,482,447,35,96.79937549
dd7447658e4d917eb9a25aec6412b0a96016cc5c,0,0,0,0,0,0,0,0,0,0,0,0,0,0,15,2,0,0,0,0,0,0,0,0,0,100
15baa4da02290f6a7bb257b9ee6c619581746568,0,0,0,0,0,0,0,0,0,0,0,0,0,0,16,3,0,0,0,0,0,0,0,0,0,100
7ed6b02c4351ed9094d29842998db2927d83fd0c,0,0,0,0,0,0,0,0,0,0,0,0,0,0,49,12,0,0,0,0,0,0,0,0,0,100
03684a0568f8569eca44573c791fc090d9a9a8b5,2,36,28,8,0,0,0,3,7,8,2,2,0.585873293,229,50,13,34,32,2,2032,1947,85,29,29,0,100
db18c82409dc2c2dadba4a19aea44a97a7e64776,2,17,0,17,0,0,0,6,26,9,1,2,0.936667382,805,0,0,194,192,2,6555,6499,56,44,43,1,100
a67e896253e3af4631cfbe40c77e14221f06f278,3,90,81,9,0,0,0,4,9,0,1,2,0.545391441,1025,51,14,144,138,6,9296,9322,26,51,46,5,99.89706639
1e105174cfc0ba82ad254efaeb666ba880956dea,4,76,15,61,0,0,0,4,58,8,1,4,1.122396175,1078,1,1,197,189,8,8542,8186,356,101,100,1,100
141b78c16ef5df9e16ec57c73ea730bda3fa2eee,0,0,0,0,0,0,0,0,0,0,0,0,0,0,3,2,0,0,0,0,0,0,0,0,0,100
b63d6316e3b3b9ad7bd96d49914ffc724c0b80fa,4,91,25,66,1,0,1,5,23,115,1,4,1.431261109,671,14,7,60,59,1,6241,5934,307,40,39,1,99.94855967
9cb56c541e26eb35ff3ab486de31cb20076fe1fe,13,922,56,866,5,0,5,3,23,34,3,7,3.053428758,1181,3,0,347,235,112,13762,9330,4432,166,92,74,99.53857985
0fe4d8854c3c263327b8f3b9120bd826cb2c1f11,8,176,575,399,0,0,0,5,24,80,4,7,1.9864518,2365,16,0,290,326,36,17348,19108,1760,118,157,39,100
30a8e228119ee0141ad5d8fd9912f9ea5b4be0a2,1,8,4,4,0,0,0,6,29,7,1,1,0,619,15,0,126,126,0,4876,4888,12,68,68,0,100
9e7e5f05aaf526406f65feaba64e5fdb4d2c7776,0,0,0,0,0,0,0,0,0,0,0,0,0,0,17,3,0,0,0,0,0,0,0,0,0,100
3b4ccb7f9bb8f0796c9a7bc71857a56ae615b0a2,0,0,0,0,0,0,0,0,0,0,0,0,0,0,18,4,0,0,0,0,0,0,0,0,0,100
938af9ee854c0c63b6de59d5ac1f4ddf7ad45eac,2,50,13,37,0,0,0,5,30,84,1,2,0.918295834,862,52,15,147,141,6,7746,7443,303,83,82,1,100
414b7bbc9fcc523e45846533b4b8eae247eee13c,0,0,0,0,0,0,0,0,0,0,0,0,0,0,19,5,0,0,0,0,0,0,0,0,0,100
ce20d6f59da89b245c8e4d393dd87ff62f95847f,48,2383,2532,149,2,0,2,7,37,11,4,16,4.487749351,10991,53,13,1995,1989,6,90469,91454,985,848,849,1,94.296875
9db4d26191b4250b714fa3a9cd6d708cca172b83,3,26,70,44,0,0,0,8,16,31,2,3,1.086672184,487,17,1,61,61,0,3647,3776,129,19,19,0,100
997abdb0ac68d2296a43ff66dba0c4169c85390a,6,195,43,152,1,0,1,6,11,184,3,4,2.101671102,620,6,1,145,133,12,4764,4184,580,26,24,2,99.9469496
c6ace7afd203fb08ce13f41bf87dca36f3117c93,1,18,1,17,0,0,0,3,5,1,1,1,0,86,54,14,5,5,0,758,758,0,3,3,0,100
a3f365dc089d718a6fbd55a935fa4876d97b69fd,0,0,0,0,0,0,0,0,0,0,0,0,0,0,55,15,0,0,0,0,0,0,0,0,0,100
29396c9df695c881a2498fba972a2bb6ee293fd9,5,36,28,8,0,0,0,3,17,0,3,4,2.094190177,1672,56,16,332,330,2,14728,14746,18,102,103,1,100
169ab553c6aa5af753f6be6142d29e78c701cf05,3,138,6,132,1,0,1,6,15,108,2,3,1.533999269,348,6,0,92,68,24,3032,2498,534,24,16,8,99.94700583
8be1be6779a112818d0e5704e6ae78904fcf6969,17,135,114,21,0,0,0,3,38,22,3,7,3.532390154,5015,57,16,1182,1185,3,39646,39803,157,392,391,1,100
b2ec89d59cd997ec3c12b9442112428c4a02e2b5,0,0,0,0,0,0,0,0,0,0,0,0,0,0,20,6,0,0,0,0,0,0,0,0,0,100
2a93a6aa4090612c5c013037b40dfd687fc7f399,3,33,116,83,0,0,0,3,11,2,1,2,0.979638748,553,16,1,81,82,1,4079,4554,475,31,32,1,99.12652197
c7540b38f50718e0f8d488b25defa47c9c34f3c2,11,192,169,23,0,0,0,5,21,3,2,3,2.647217473,2631,58,15,606,599,7,21893,21667,226,210,207,3,99.97354497
aa67f8aee8eac8effbe2e9f4a27a28a4a32b8285,15,1310,120,1190,2,0,2,1,39,15,3,7,2.19411577,4167,242,2,887,805,82,43001,34508,8493,369,323,46,99.19896641
42de5913256e7e40c2833de6ee76d7a3eea698b1,1,74,10,64,0,0,0,5,8,50,1,1,0,106,0,0,28,14,14,1120,702,418,5,4,1,100
58bbee4ce1083c63a1f263b38daa0d5be776fa83,0,0,0,0,0,0,0,0,0,0,0,0,0,0,21,6,0,0,0,0,0,0,0,0,0,100
9b8a5ddcb1582140ba9722a6dcfba8dffbe82e1f,0,0,0,0,0,0,0,0,0,0,0,0,0,0,22,7,0,0,0,0,0,0,0,0,0,100
c5ea4f0e1aa96add052adb63d41fa8c3bf2a18ec,1,35,29,6,0,0,0,4,10,2,1,1,0,181,59,15,57,57,0,1284,1276,8,28,28,0,100
68c559254336b8c6d7dbd6537b064d4d31d0529d,17,1002,204,798,0,0,0,3,22,0,3,8,3.363087074,4659,15,1,945,793,152,44327,39644,4683,344,311,33,100
6170063c877870856e21ab9b6fa1bdf638860421,17,905,125,780,6,0,6,3,17,34,4,7,3.344156883,1966,4,1,493,391,102,19512,15680,3832,218,162,56,98.84318766
20fb5894d8be8551d0f2cf325d32f062f866832a,2,24,23,1,0,0,0,6,16,6,2,2,0.704576713,406,7,1,88,88,0,2842,2842,0,21,21,0,100
90f1566afabaec8aca5d87050eab43f56f911644,1,52,10,42,0,0,0,1,2,8,1,1,0,46,7,1,11,4,7,438,302,136,1,1,0,100
68a324e395b55dcff1fd9a2f185e1ac742df8d1f,5,49,56,7,0,0,0,1,16,3,2,3,1.464893429,1382,243,2,198,198,0,12765,12586,179,70,70,0,100
69db4a8283c55c83fd36439af9601a70b88e177c,1,162,0,162,1,0,1,1,1,0,1,1,0,0,244,3,16,0,16,919,0,919,13,0,13,97.78617711
e4cc16ac7bd133964bf02eda360fe660d9225484,3,76,111,35,0,0,0,6,15,9,2,2,0.17056788,482,0,0,70,72,2,3505,3742,237,37,37,0,99.22923209
3a0865ad03b9f576f1a32dca7ef238f461ea1801,24,366,636,270,0,0,0,4,27,96,4,9,3.370905113,3236,18,2,575,763,188,22865,30921,8056,264,319,55,95.16554351
852a711831c2de2f2c9a469f01a872131649b38c,6,559,29,530,3,0,3,6,27,14,2,3,2.103415793,1615,8,2,264,232,32,19218,15335,3883,98,83,15,99.67741935
1d85e95fa06a98d70417c9671cd4d0a0b33a9ed1,14,300,164,136,1,0,1,1,28,6,3,8,3.100912993,3242,5,2,451,437,14,28741,28069,672,187,178,9,99.79490185
ce54e8a4de04f410c3129ebe1dafc6864e1aa98c,6,32,18,14,0,0,0,4,18,1,2,4,1.973828629,1259,19,3,225,224,1,10084,9948,136,95,94,1,100
b6b6f9450885cb21b395b19f37d6639c86ff2a52,5,142,15,127,0,0,0,6,29,50,2,3,1.588199224,657,20,4,75,75,0,4893,4799,94,38,38,0,100
ea38942baa73774f35004d36fc1805a2368c2ace,7,186,25,161,1,0,1,8,19,162,3,5,1.786651422,1911,21,5,218,199,19,19096,18248,848,88,83,5,99.94145199
8cd6a6445ff59d1345985581e229adc13bc0c7b0,3,52,14,38,0,0,0,3,42,17,3,3,1.483157026,884,17,2,145,141,4,7474,7277,197,102,100,2,100
7303a412ef4812dec9bb0f3b65a10146ccfd8330,24,163,160,3,0,0,0,7,43,5,4,12,3.778813568,8638,60,13,1268,1270,2,76096,75986,110,575,576,1,99.97074312
343d0b1f6b6efcfbc93de814dda145e404b7cc5c,1,1,28,27,0,0,0,5,6,29,1,1,0,435,22,6,16,17,1,4291,4409,118,16,17,1,100
bb1c386a7c6c2d649f09b103105712a78ec32507,3,40,27,13,0,0,0,5,13,46,2,3,0.783003173,525,61,13,94,94,0,4286,4171,115,51,51,0,100
2fb3057b1b2d77b78c2a47ac40cdf13dec3f3fef,1,2,2,0,0,0,0,7,17,12,1,1,0,159,23,8,31,31,0,1066,1066,0,12,12,0,100
b4a694154de8372b405ed3eca6f0254753e146e5,4,20,19,1,0,0,0,5,14,14,3,4,1.298187397,726,62,14,145,145,0,5281,5320,39,63,63,0,100
485573fcab1c7cd263289ccc4da40357607dce82,1,14,14,0,0,0,0,2,2,12,1,1,0,123,63,14,22,22,0,1027,1039,12,6,6,0,100
2904f4c425d414293e6910bba7f1bac0bca4ab55,2,82,2,80,0,0,0,2,7,107,2,2,0.791858353,72,64,15,34,16,18,883,504,379,11,9,2,99.91251094
e7eaa9966ccb330d5aa50aafc08cd1107ae30ce6,2,5,1,4,0,0,0,1,21,9,2,2,0.918295834,380,6,3,73,72,1,3024,3007,17,23,23,0,100
f5f9fa09948b2e5ade1a084b8063cd2bbe6e80a0,10,21,228,207,0,0,0,2,18,195,1,3,2.644380014,2007,65,15,401,439,38,14249,15440,1191,105,109,4,100
dbfca6224965574b5c6e9be0ebc846cb0439e944,1,22,8,14,0,0,0,9,21,13,1,1,0,338,8,2,49,46,3,2530,2461,69,13,12,1,100
b7d880ddea3745d97b8173818c012f5ff275f47d,0,0,0,0,0,0,0,0,0,0,0,0,0,0,9,3,0,0,0,0,0,0,0,0,0,100
c74ba142adf99fff7a17026e179b799ec315ff93,0,0,0,0,0,0,0,0,0,0,0,0,0,0,24,7,0,0,0,0,0,0,0,0,0,100
17a9aad063c0905f9e15cfa650a92ac26f2c46ba,0,0,0,0,0,0,0,0,0,0,0,0,0,0,25,8,0,0,0,0,0,0,0,0,0,100
4ed4ba15ad230bdb0134bcc37eaa6a199d81f26b,2,48,5,43,0,0,0,1,11,36,1,2,0.698700353,218,23,7,48,43,5,1992,1699,293,9,8,1,94.95548961
fa0d6dbef00f9307578162bc8ccc883cb0c2fc4c,0,0,0,0,0,0,0,0,0,0,0,0,0,0,26,9,0,0,0,0,0,0,0,0,0,100
e1524d3b434bf22985fb1ed4d7bef6827dc8375e,0,0,0,0,0,0,0,0,0,0,0,0,0,0,27,10,0,0,0,0,0,0,0,0,0,100
69c4806ac04362e4a70f4fd0755f42606020f9d8,6,105,1,104,1,0,1,9,38,47,1,3,1.761405821,2012,15,1,271,257,14,16104,15695,409,158,149,9,99.94969819
c7900f25540ad5b522e5d3eb1c93a14cbce578d1,0,0,0,0,0,0,0,0,0,0,0,0,0,0,28,9,0,0,0,0,0,0,0,0,0,100
765d556cce4f276d295d06cdb513fc3b9b00dc51,11,377,67,310,0,0,0,2,59,83,5,8,2.590522883,2951,16,1,557,519,38,26214,24263,1951,222,214,8,97.28357451
08944c54de13054b4b7a76dbcba79218779f02d3,2,88,11,77,0,0,0,2,13,80,1,2,0.764204507,1189,66,13,283,281,2,9704,9298,406,104,104,0,100
0c1d599ddca7ad9e4c677c77908e96dd492a8f90,2,23,15,8,0,0,0,6,60,81,2,2,0.485460761,1244,67,14,290,287,3,10305,10294,11,78,78,0,100
515130ccd09003dbc0bbfd9436629c7d5648b15c,5,160,55,105,0,0,0,1,31,12,3,3,1.014662669,862,7,3,177,155,22,7299,6680,619,53,52,1,99.97439836
4503955e12dc46e8cce9f28e300b060f271f4a2a,0,0,0,0,0,0,0,0,0,0,0,0,0,0,29,9,0,0,0,0,0,0,0,0,0,100
9e16600c41deefdb616db5c790848f7874010d36,1,6,0,6,0,0,0,4,6,220,1,1,0,66,18,2,8,7,1,693,666,27,6,5,1,99.92333248
8244f8bf9a3a9e2bd51889cac708ef57c3188e53,1,12,8,4,0,0,0,2,2,30,1,1,0,63,19,3,11,11,0,459,457,2,3,3,0,100
101abe6eedb18a0ef3e30c6ad7926b02fb89605a,9,362,141,221,0,0,0,8,38,14,3,6,2.507083277,2805,245,2,628,587,41,24860,23542,1318,163,149,14,100
8bb31fdf98d214063b63ee8d730828e04c534fdc,8,437,37,400,0,0,0,1,23,25,2,4,1.332528914,3567,246,3,527,507,20,35964,32776,3188,211,202,9,100
b1717f2e8f721765ad0ff5b9cce08cc6de999807,13,199,84,115,0,0,0,2,44,50,3,7,2.721149769,4101,17,2,700,661,39,35711,34920,791,280,279,1,100
48c10133e1b67ac727b0a858aa51801150ddb35e,7,236,84,152,3,0,3,3,6,29,2,5,2.505000483,620,24,6,127,108,19,5589,5131,458,33,30,3,99.82147411
0feb60a2f1e70fbc32f765fc67ffeaad6618c997,7,103,23,80,0,0,0,2,60,32,3,6,2.186881624,2392,18,3,395,375,20,20639,20230,409,159,155,4,100
88ca02c623345890e42bab300602f8f733949012,2,36,9,27,0,0,0,6,19,0,1,2,0.99107606,1302,68,9,216,212,4,12702,12500,202,62,61,1,100
214c1572adf71ec5565db29036d7ec3d0dd6354b,2,23,8,15,0,0,0,6,20,0,2,2,0.708835673,1389,69,10,68,66,2,13545,13462,83,49,48,1,100
3860c95d35d0052eebc48e1ef6afce8b8d437576,10,722,32,690,3,0,3,1,24,11,2,5,2.270910612,3825,9,2,659,612,47,38701,33509,5192,208,184,24,94.10269446
84f6923e12d91307af59c98a9bc6a25fbc9708b6,4,73,72,1,0,0,0,3,7,56,1,2,1.632560406,739,70,11,169,167,2,6103,6128,25,43,42,1,99.22680412
46b1b36e97b7d405d023b7594e679b65b0226c8a,14,545,737,192,1,0,1,4,45,40,2,5,3.044839236,3948,25,7,544,560,16,32913,33913,1000,318,334,16,99.6841274
6fd04d9a8c56610a855b3950040ace9b6699c38b,35,3951,40,3911,25,0,25,3,39,56,3,13,4.313658596,2547,3,0,679,254,425,41695,21202,20493,397,166,231,93.53808354
44df46cf14c216021d80c1a49c62bd0e48f6844a,4,23,4,19,0,0,0,7,61,3,3,3,1.6349308,967,71,11,164,162,2,7885,7768,117,73,73,0,98.07194921
48b05f364201b01cf04fd6492a375cc154bd2536,2,7,3,4,0,0,0,4,34,24,1,2,0.721928095,519,72,12,132,130,2,3023,2979,44,56,56,0,100
11e220223d86250f132e267e694430fc5a096334,2,14,5,9,0,0,0,3,10,114,1,2,0.485460761,500,73,13,143,140,3,2952,2878,74,56,56,0,100
82142995fbdd946109a54af612555679ab60043a,2,66,67,1,0,0,0,7,35,2,2,1,0.063853685,580,26,8,120,120,0,4414,4415,1,59,59,0,100
98990b8d0cf6b90916c300e31b6aa4ad8e7f0d4c,7,223,26,197,1,0,1,5,41,39,2,4,1.365076481,1352,27,9,330,295,35,11340,10207,1133,107,100,7,99.49928469
9bddaeb3ccfa089d8b7ac3b77b47cd8e99e9af07,10,143,109,34,0,0,0,7,44,6,3,8,2.501089836,4168,19,3,578,576,2,37851,37608,243,240,242,2,98.11667432
525082baa6f48085c5f436e7b193d3f2c4f58fed,12,338,124,214,0,0,0,1,28,126,4,6,1.925797191,1510,8,3,320,271,49,12637,11431,1206,95,82,13,99.91029379
9e578251af355481dbb1f75a358cb3e36f365ea6,0,0,0,0,0,0,0,0,0,0,0,0,0,0,12,0,0,0,0,0,0,0,0,0,0,100
7753f2e869b32104cf992722b11fef82fe5b5655,0,0,0,0,0,0,0,0,0,0,0,0,0,0,30,7,0,0,0,0,0,0,0,0,0,100
a4b16bbabadb59ae071ff472d95df822ced71e43,2,121,13,108,0,0,0,4,8,165,1,1,0.678114052,259,10,2,54,31,23,2095,1599,496,13,12,1,100
b99151fb83d39ff3bfbad503acae65ac7dd6dbec,0,0,0,0,0,0,0,0,0,0,0,0,0,0,31,8,0,0,0,0,0,0,0,0,0,100
9ba2ff0d0fcae86095a0ded78e3d415b80572fb4,1,89,2,87,0,0,0,3,15,28,1,1,0,547,28,9,139,115,24,4441,3966,475,36,32,4,100
e841619c384b5358c96b3362ffcb042dededfd40,2,42,42,0,0,0,0,3,8,2,1,1,0.993447238,575,74,14,137,139,2,4367,4416,49,37,37,0,100
98f02ff79b32b6dbc3a26036823f3376a26ceb8f,0,0,0,0,0,0,0,0,0,0,0,0,0,0,75,15,0,0,0,0,0,0,0,0,0,100
2bbbd1a5adc7e2856d16c5b53833480c7f950e8c,8,188,27,161,0,0,0,2,22,23,3,5,2.600597164,998,20,4,298,273,25,7808,6926,882,112,104,8,99.88771615
670a4c00158bcde1e99986a719c84cebcf6336c9,3,29,3,26,0,0,0,2,7,0,3,3,1.336251632,471,21,5,125,119,6,3971,3853,118,53,52,1,100
b9779eca9c5bbc36e6c36e8ef6bcfb4979e07f10,0,0,0,0,0,0,0,0,0,0,0,0,0,0,32,9,0,0,0,0,0,0,0,0,0,100
72641fb78215140b6f89c59d4f543512ffea9d18,7,201,139,62,0,0,0,3,8,8,3,7,2.24806738,1452,76,16,304,301,3,11583,11409,174,119,116,3,100
571f8d4e5e2291c435ef1ad7b86db7752eb55d3c,0,0,0,0,0,0,0,0,0,0,0,0,0,0,33,10,0,0,0,0,0,0,0,0,0,100
df7d76896cd59e30acca611a708facf4356c6902,5,352,100,252,0,0,0,6,20,25,2,2,1.71505978,797,77,17,181,151,30,7652,6342,1310,89,87,2,100
bcc138ac693b3927b26d5dbfe8020b4cedfff66d,1,2,0,2,0,0,0,7,19,111,1,1,0,181,78,18,13,13,0,1774,1770,4,10,10,0,100
c572e54120b79bd362d6d4e78490277ce2741b8e,1,11,11,0,0,0,0,4,6,0,1,1,0,92,34,11,11,11,0,656,656,0,4,4,0,100
40e2e37d4fafe34ea58149a549f2106b6bf617a3,3,86,36,50,0,0,0,4,9,3,1,2,0.276371172,347,79,18,93,78,15,2744,2466,278,10,10,0,100
e54fe04d7a87d7d3ebaf780dd0f7b388e030d91a,0,0,0,0,0,0,0,0,0,0,0,0,0,0,35,12,0,0,0,0,0,0,0,0,0,100
543a85d7c0f8f07c2e38be260e56e4e48a6e48f5,32,32,0,32,0,0,0,6,62,421,6,9,5,6978,29,6,1367,1367,0,56786,56722,64,531,531,0,100
42a441aa63d2015e75ddc783167aa1b817c5e829,0,0,0,0,0,0,0,0,0,0,0,0,0,0,36,13,0,0,0,0,0,0,0,0,0,100
fe86177a1d55b18b9b1a205fcd1cae83c6b85606,2,15,6,9,0,0,0,3,9,70,2,2,0.918295834,503,80,18,118,115,3,4259,4198,61,32,32,0,100
dc89e7f44699d2bd8e08b7d50fbac493cba3ca2e,1,64,0,64,0,0,0,3,7,65,1,1,0,341,22,6,91,81,10,3070,2667,403,29,26,3,100
6a4fcb95dc1b6479cde4d0e29442b98564c219d0,3,38,9,29,0,0,0,6,29,87,2,3,1.39275524,920,9,3,234,227,7,6321,6161,160,77,76,1,100
f673eba408f25be7574391254f91dc7522c44d75,5,46,5,41,0,0,0,4,8,197,3,5,1.076062211,628,247,2,122,120,2,4422,4193,229,71,70,1,100
232e59629b9bdeb27d384474dd33b0a59c5e2b90,1,2,1,1,0,0,0,6,12,78,1,1,0,164,30,7,33,33,0,1160,1152,8,13,13,0,100
d0e9d48b101f475bb9cb6b441d4082fde3843287,0,0,0,0,0,0,0,0,0,0,0,0,0,0,81,19,0,0,0,0,0,0,0,0,0,100
f87f5f22b8de37c8b08dfeaf0b2c5ca289675c84,4,54,8,46,0,0,0,12,67,134,4,4,0.876980289,2524,23,7,301,292,9,23246,23036,210,170,169,1,100
7d622bdfae11d535d184497e0221584a59f73e49,1,7,7,0,0,0,0,4,6,6,1,1,0,58,31,8,22,22,0,177,177,0,1,1,0,100
0ed5e0aa5a0afb1cef8031e274645a8398d2a7f0,2,22,6,16,0,0,0,9,40,40,1,2,1,990,24,8,252,248,4,8104,7987,117,87,86,1,100
d0f2ce5e9aa61b5fc8b3949d41cd2af902b39a12,8,128,95,33,0,0,0,5,26,83,4,6,2.246816961,2153,248,3,291,288,3,19565,19301,264,129,129,0,99.91015274
9ca6136e2e6e431b0f463344e7e3a731af69646b,0,0,0,0,0,0,0,0,0,0,0,0,0,0,37,13,0,0,0,0,0,0,0,0,0,100
ab43b2808bf15e9d667d7cadfaa518baf9d47308,0,0,0,0,0,0,0,0,0,0,0,0,0,0,32,8,0,0,0,0,0,0,0,0,0,100
3fee23c8c7fa4955c4be36104744ab3711d9f55e,0,0,0,0,0,0,0,0,0,0,0,0,0,0,82,8,0,0,0,0,0,0,0,0,0,100
de7ae290a11876809ab509a4e64921bc77272f5b,0,0,0,0,0,0,0,0,0,0,0,0,0,0,83,9,0,0,0,0,0,0,0,0,0,100
89a387279d9d0cae66f8e0a75a9ee3610da8c173,2,11,4,7,0,0,0,4,36,43,2,2,0.836640742,363,84,10,60,59,1,3024,2954,70,19,19,0,100
7154e12d13fe4ccba4207bbf6f411353411f06b2,4,74,36,38,0,0,0,1,23,61,2,2,1.655208222,951,10,1,189,179,10,7388,7210,178,82,76,6,100
0c9790289cf707a35b09c92edcd1484de8523c82,1,6,6,0,0,0,0,4,10,34,1,1,0,293,85,11,71,71,0,2440,2440,0,9,9,0,100
1612b3058a0bc8317dd6f3ff4980fead0d36df28,2,40,1,39,0,0,0,8,30,35,2,2,0.281193796,785,25,5,156,149,7,6043,5880,163,43,41,2,100
f379c9ffd08dbdafd27d163cd155f9b9f5c2a695,16,516,363,153,1,0,1,4,61,465,4,13,2.414893032,3090,11,2,577,552,25,26832,26027,805,207,202,5,99.77563383
2d68d4cefd6a2f38d51b4856fab8d7b3bd2fb774,1,5,1,4,0,0,0,6,12,32,1,1,0,429,26,6,130,129,1,2266,2256,10,52,52,0,100
e0145ffd40c08054cea7073239541879447794b4,0,0,0,0,0,0,0,0,0,0,0,0,0,0,38,6,0,0,0,0,0,0,0,0,0,100
919503968f81dc46e93bc73ba3da84a10cbcee7c,2,0,137,137,0,0,0,3,3,629,1,2,0.952393679,70,11,0,0,10,10,0,513,513,0,4,4,99.91027367
23c8f71dad17476d38363c58341627b1159c6197,0,0,0,0,0,0,0,0,0,0,0,0,0,0,39,7,0,0,0,0,0,0,0,0,0,100
9e5ef85cab47ce01e8d7be946283726336e101a0,0,0,0,0,0,0,0,0,0,0,0,0,0,0,40,8,0,0,0,0,0,0,0,0,0,100
bec9370e5807f73e7dfc8e72da42d06557a745b4,2,88,11,77,0,0,0,4,7,41,1,2,0.98337619,287,33,4,80,67,13,2513,2158,355,18,14,4,100
537f6e31f00f3406a6eb1a03a0f1223ce74ba9a4,1,4,4,0,0,0,0,3,4,738,1,1,0,311,12,1,15,15,0,2740,2729,11,15,15,0,99.97754827
160b28740b0689d7892299fd246394508c28d2dd,12,237,132,105,0,0,0,1,31,46,3,4,1.939115237,1897,12,3,481,457,24,14276,13630,646,193,183,10,99.91029379
94158e16e74c2bc5104b5a6018b221cb1de6e2ca,1,0,1,1,0,0,0,7,13,51,1,1,0,571,27,5,55,55,0,4886,4903,17,40,40,0,100
b86e8591a96740d638f548e52fd18fdad34da781,2,9,2,7,0,0,0,1,8,5,2,2,0.845350937,338,13,4,76,74,2,2338,2306,32,28,28,0,100
d6e40806f8133db38996d93ac0da3161c39865fa,5,42,43,1,0,0,0,5,24,281,2,5,1.934334753,857,13,2,148,148,0,6189,6166,23,53,53,0,100
a127e26be618eeabcebdc0d4d3574da64b4bb745,1,1,0,1,0,0,0,9,55,9,1,1,0,458,86,4,71,71,0,4071,4060,11,34,34,0,100
1cc40fd9eff4827aa4507e78b274829511a2acb7,2,33,0,33,0,0,0,3,16,62,2,2,0.32984607,1359,87,5,385,380,5,10147,10028,119,132,127,5,100
ae6fd0a183b42ca7bbeea1a574da0d1d48b51b76,1,1,1,0,0,0,0,6,15,8,1,1,0,767,28,3,246,246,0,5700,5700,0,96,96,0,100
220213dba5c6a9766efe33723f873143c09a8a77,2,4,2,2,0,0,0,8,20,38,2,2,0.918295834,667,29,4,116,116,0,4897,4890,7,62,62,0,100
1aa38090ac8f667c2d357c005370cad214591e3b,0,0,0,0,0,0,0,0,0,0,0,0,0,0,41,3,0,0,0,0,0,0,0,0,0,100
41839141b30ca0bd258c4b7a15fde99593636efe,5,31,21,10,0,0,0,7,38,75,2,2,1.87233443,1233,34,2,279,272,7,9800,9761,39,73,73,0,99.95525727
2dd0f0709cbfb4dd9fbd8421640ee4067b730629,5,176,29,147,0,0,0,2,32,40,2,2,1.070600533,1928,88,6,493,457,36,16580,15627,953,122,113,9,100
a9f3da62d4c131c837a908c27555fb66bcdcdd05,1,1,1,0,0,0,0,3,8,109,1,1,0,52,14,4,13,12,1,435,428,7,2,2,0,100
d5a5238b2671ce6d903c560c56fd4ef96217662a,4,290,114,176,0,0,0,4,17,57,2,4,1.159634159,1816,30,5,522,476,46,14538,13582,956,168,161,7,100
30284c9a8ff1b1c6d1a66e84b4e7cff9d18e5b60,10,90,92,2,0,0,0,4,39,57,4,9,2.497335384,2162,31,6,424,424,0,17544,17490,54,162,162,0,100
65581a31e63dc5d359ba7394e7f8b3890613cac9,0,0,0,0,0,0,0,0,0,0,0,0,0,0,32,7,0,0,0,0,0,0,0,0,0,100
401d39af229c245316d83605e90c4fcedab343ac,0,0,0,0,0,0,0,0,0,0,0,0,0,0,4,0,0,0,0,0,0,0,0,0,0,100
d0cb5c37df9a99f79f2be23c40f693417ae2a26a,0,0,0,0,0,0,0,0,0,0,0,0,0,0,0,0,0,0,0,0,0,0,0,0,0,100
2720af61499db1f4bd42d1dfa2cec766aeabd702,7,110,16,94,0,0,0,7,30,59,2,4,2.290396429,3088,35,1,839,813,26,23782,23350,432,263,258,5,100
8cc5e510fdc3c505c41b3ad50ad4fc3d429f3379,0,0,0,0,0,0,0,0,0,0,0,0,0,0,14,0,0,0,0,0,0,0,0,0,0,100
97209e817a73ab34093687a059c45f3ee5e95027,0,0,0,0,0,0,0,0,0,0,0,0,0,0,42,0,0,0,0,0,0,0,0,0,0,100
c9a9126491bef62daa91e30a8e8ff0051dc4e8ba,0,0,0,0,0,0,0,0,0,0,0,0,0,0,1,1,0,0,0,0,0,0,0,0,0,100
81d3184dbceb1e10042e2bbf3cd2130282508b36,1,4,8,4,0,0,0,3,5,351,1,1,0,40,15,1,6,6,0,240,265,25,4,4,0,100
b1fd699549c280e5fd29b8dd522ecc7fd0660f9d,0,0,0,0,0,0,0,0,0,0,0,0,0,0,16,2,0,0,0,0,0,0,0,0,0,100
c3813d298ef1606afb0d003127143f260c1c675f,0,0,0,0,0,0,0,0,0,0,0,0,0,0,43,1,0,0,0,0,0,0,0,0,0,100
cb554197785dd012f919321c41b69c166a6dc840,8,51,38,13,0,0,0,3,63,131,4,7,2.80186857,2622,15,0,451,445,6,21825,21691,134,184,184,0,100
ceea868de288de8541b67738b7bdf4b9f8b602ac,0,0,0,0,0,0,0,0,0,0,0,0,0,0,16,1,0,0,0,0,0,0,0,0,0,100
7f03fc8e746ddba868f5520edbca4850c540b5df,0,0,0,0,0,0,0,0,0,0,0,0,0,0,2,2,0,0,0,0,0,0,0,0,0,100
42426a1b7f7418aa16c427130a767a73629fbda6,0,0,0,0,0,0,0,0,0,0,0,0,0,0,3,3,0,0,0,0,0,0,0,0,0,100
8a32ccaae6ce24f52371a2802c29973db59244d3,12,881,16,865,6,0,6,9,25,5,2,3,2.69534243,1221,17,2,325,204,121,14565,7682,6883,147,98,49,99.21857557
5dfe20232548079cc716d4cd532507351e7a078e,4,98,9,89,0,0,0,4,12,98,3,3,1.332889285,566,33,1,156,143,13,5014,4554,460,54,53,1,100
be93da8b83d0b19e4d015ab31190a0922ca48a2c,3,14,14,0,0,0,0,4,13,0,2,2,1.431560284,447,34,2,94,94,0,3620,3620,0,14,14,0,100
29524aa06de730ce80b2a42672e46d1f5492d4cd,3,15,1,14,0,0,0,1,6,19,2,2,1.505240815,328,18,3,44,43,1,2732,2689,43,31,31,0,100
0fc1c116127fbfb2416f619b9ade55a22d0594d5,0,0,0,0,0,0,0,0,0,0,0,0,0,0,17,3,0,0,0,0,0,0,0,0,0,100
928bbc5dcad5ca770d451e17ba685cd6e199217a,0,0,0,0,0,0,0,0,0,0,0,0,0,0,19,4,0,0,0,0,0,0,0,0,0,100
e92593e9462c6b5593109ad13bc761e04ac6d93f,1,13,1,12,0,0,0,4,9,38,1,1,0,117,35,2,18,15,3,914,856,58,6,5,1,100
bcc89f3c459d6f02b24eae245f88f27bdbd9a65e,1,20,19,1,0,0,0,6,13,313,1,1,0,481,18,3,107,106,1,3462,3442,20,12,12,0,100
466372ef838e03e6bd393e495e174cfcc8ce192c,1,2,6,4,0,0,0,6,14,0,1,1,0,482,19,4,106,107,1,3434,3462,28,12,12,0,100
2615b308e62e617c6e979b91533fefb2bbfc7d01,10,174,28,146,1,0,1,1,40,142,2,5,2.675956988,2653,249,0,470,458,12,22052,21280,772,178,171,7,99.88839286
4feee3bf61a032f742c0c4738e6ffdb423cdd14d,13,246,5,241,0,0,0,3,39,174,6,11,3.077837188,4164,36,1,674,643,31,37429,36009,1420,241,232,9,100
3a70d11d3c1a5d51e2c783ec28d9693b61bea71b,1,8,2,6,0,0,0,9,42,158,1,1,0,897,37,2,190,189,1,7852,7826,26,26,26,0,100
19d344cd87eeee19b011f181f88ee5696470138d,0,0,0,0,0,0,0,0,0,0,0,0,0,0,0,0,0,0,0,0,0,0,0,0,0,100
ca64ef4e80fe621435b93888abb2feee712a6283,3,46,21,25,0,0,0,4,14,33,2,2,1.336753755,456,38,3,102,97,5,3794,3678,116,16,15,1,100
c4fc5b4f557e9a23cd717f885beca3bdb4acf7e5,2,11,3,8,0,0,0,1,3,8,1,2,0.985228136,90,250,1,13,13,0,802,712,90,6,6,0,100
d30fa2c2624038026e690eabb90f7f6436d626d8,4,54,25,29,0,0,0,4,15,76,2,3,0.569736601,554,39,4,130,124,6,4133,3997,136,17,17,0,100
c3b1bcb1c4240027b2fa613bf32b7dd7a3a3d205,0,0,0,0,0,0,0,0,0,0,0,0,0,0,1,1,0,0,0,0,0,0,0,0,0,100
e8a73821793c11e3ec3501eff88903d270f1a843,0,0,0,0,0,0,0,0,0,0,0,0,0,0,44,0,0,0,0,0,0,0,0,0,0,100
f6ea040aced9fe2f76785dc2e6cb171f33b10aec,0,0,0,0,0,0,0,0,0,0,0,0,0,0,45,1,0,0,0,0,0,0,0,0,0,100
09425abc7ca92c5ec84480c4d39451fa175f2f8c,2,164,70,94,0,0,0,1,3,46,1,2,0.999947304,754,20,2,170,157,13,6714,6188,526,67,58,9,100
3a9594e1811e7c860f265fea0ef79713612ed0f5,3,77,64,13,0,0,0,5,23,144,1,3,1.338574804,909,36,0,186,182,4,8085,8065,20,51,50,1,100
b2951a9297896df8bada1bb61f9c31645bf5a9e6,1,61,12,49,0,0,0,4,19,85,1,1,0,666,37,1,166,154,12,5055,4792,263,42,39,3,100
70931e197b2d4a3637c2c0d42ab4d465b5ba893c,0,0,0,0,0,0,0,0,0,0,0,0,0,0,20,3,0,0,0,0,0,0,0,0,0,100
b6eef8c2b732d49d9cd1c7b18d23aeed388cc395,2,5,12,7,0,0,0,5,20,145,1,2,0.936667382,1016,40,5,239,239,0,7522,7532,10,70,70,0,100
235f4e9e2d761812976515a0853169d5cb934494,49,423,424,1,3,0,3,4,41,248,3,16,5.137738361,12043,38,2,1074,1069,5,108093,108785,692,737,735,2,99.68791797
96d9a0ec283aacaf05ddbfa504ef4f06d133d92e,1,7,0,7,0,0,0,3,5,0,1,1,0,266,0,0,30,29,1,2179,2142,37,23,22,1,100
1decc731684ca6f2eb72d7f7c9cc3aa223f7a957,0,0,0,0,0,0,0,0,0,0,0,0,0,0,2,2,0,0,0,0,0,0,0,0,0,100
2fd87e2a3acdb2c86040c893872bdb2a54ee512b,0,0,0,0,0,0,0,0,0,0,0,0,0,0,39,3,0,0,0,0,0,0,0,0,0,100
b2bee2cca2a7e4a7080693552f96f45a074efe66,0,0,0,0,0,0,0,0,0,0,0,0,0,0,3,3,0,0,0,0,0,0,0,0,0,100
fc7d300943b40c2aeb56162d047ef0cca9b4ed7d,0,0,0,0,0,0,0,0,0,0,0,0,0,0,46,2,0,0,0,0,0,0,0,0,0,100
30ec76c8533f79d2b10da5937ea21fbb3b8f0b54,9,230,31,199,0,0,0,6,31,211,3,9,2.607630057,2825,40,4,586,548,38,24143,22929,1214,236,229,7,100
a0bb463879614abca5f86634096f3f2ed6779e33,0,0,0,0,0,0,0,0,0,0,0,0,0,0,4,3,0,0,0,0,0,0,0,0,0,100
d7a139e11edd415786208f3c920da8a2f34d26c2,1,18,7,11,0,0,0,3,5,346,1,1,0,364,21,1,77,77,0,2392,2316,76,17,17,0,100
cf64a03e05c64ce25777bd478d4dda888f3e6a9c,0,0,0,0,0,0,0,0,0,0,0,0,0,0,5,3,0,0,0,0,0,0,0,0,0,100
f2255da116af44da4c1c86c585fe7428d218691a,5,101,1,100,0,0,0,5,42,196,2,3,2.093418969,1987,41,1,246,233,13,16331,15767,564,156,149,7,100
bbf93327bb6377793aecb4f9ede3d75e1c59b636,0,0,0,0,0,0,0,0,0,0,0,0,0,0,6,4,0,0,0,0,0,0,0,0,0,100
0cccec93f60bd8dd530b924dced3d8de5dcccf3a,3,9,3,6,0,0,0,4,16,51,1,2,1.040852083,445,42,2,113,112,1,3221,3197,24,11,11,0,100
f0f7fe2cf1dd775bbea64fe7df5fa864ffbd446b,0,0,0,0,0,0,0,0,0,0,0,0,0,0,47,1,0,0,0,0,0,0,0,0,0,100
138bc6f1bddb1e376277d6544534b4d5419d1fdd,0,0,0,0,0,0,0,0,0,0,0,0,0,0,48,2,0,0,0,0,0,0,0,0,0,100
04451449dd18f6c5df93fb4517c3d7fbdc122da7,5,329,109,220,1,0,1,1,17,93,2,5,2.004690463,1036,21,0,237,207,30,9313,8127,1186,108,94,14,99.95551601
35c776448cb932723e64fda6b642f65659e83879,1,6,1,5,0,0,0,4,10,232,1,1,0,416,0,0,103,102,1,3350,3328,22,28,28,0,100
35e5828fb8649d14cfe4b1079237562f31186ad4,178,2362,2534,172,9,0,9,3,64,180,10,54,6.194456825,36460,41,3,5534,5561,27,304318,307817,3499,2285,2311,26,94.27855502
cfc3436be1c821273759f52aa4bfb12f0e229717,1,0,0,0,1,0,1,5,9,6,1,1,0,0,42,2,0,0,0,0,0,0,0,0,0,99.96061442
b557b98c0110f2042571b72d41676229766719c5,2,35,8,27,0,0,0,1,2,48,2,2,0.99648599,42,43,3,9,4,5,434,283,151,4,3,1,100
bbdc31476332b5cf06c54d5db27afff0a3c62b93,0,0,0,0,0,0,0,0,0,0,0,0,0,0,43,2,0,0,0,0,0,0,0,0,0,100
d0e48cfd44393c97c0627ff710a82c71da548e7f,0,0,0,0,0,0,0,0,0,0,0,0,0,0,7,3,0,0,0,0,0,0,0,0,0,100
e483712bd5964493f94a3dc0f679f250da740d64,0,0,0,0,0,0,0,0,0,0,0,0,0,0,8,4,0,0,0,0,0,0,0,0,0,100
363b88cf806be8be362a6234c1bc3f292c72ff70,0,0,0,0,0,0,0,0,0,0,0,0,0,0,49,2,0,0,0,0,0,0,0,0,0,100
bd69a4f1c6012c4b1a61594b91458990d5b9a26a,0,0,0,0,0,0,0,0,0,0,0,0,0,0,9,5,0,0,0,0,0,0,0,0,0,100
64988b8a36258541b2131ad32cbdadc80e4faadd,0,0,0,0,0,0,0,0,0,0,0,0,0,0,10,6,0,0,0,0,0,0,0,0,0,100
e75984c483501f5c6325a1da91750c0f45d6c6fe,0,0,0,0,0,0,0,0,0,0,0,0,0,0,11,7,0,0,0,0,0,0,0,0,0,100
1c3dcc07e6d042a04cb34d06204c5aa511bfb83b,5,24,22,2,0,0,0,3,10,426,3,4,2.079185398,768,44,3,59,59,0,6600,6602,2,49,49,0,100
9d6ad848abcf6cfd8bb9a2d2b790d45db1dcf9b0,0,0,0,0,0,0,0,0,0,0,0,0,0,0,12,6,0,0,0,0,0,0,0,0,0,100
bc1576da487bb948e8fac5858846e2ae146eb1b2,2,9,4,5,0,0,0,2,4,12,2,2,0.779349837,185,45,4,14,14,0,1497,1437,60,14,14,0,100
d2198bb4130e2e625f0e8ed573e537da04319034,0,0,0,0,0,0,0,0,0,0,0,0,0,0,13,7,0,0,0,0,0,0,0,0,0,100
4c9c3bb592a43cb24fb2113d4f9ab5db2116f3db,13,817,94,723,6,0,6,9,27,62,3,4,3.254410185,822,22,0,210,124,86,10581,6250,4331,104,58,46,98.41595229
e19495ad2743af1557395248a29be7c960af4059,1,9,0,9,0,0,0,6,19,30,1,1,0,413,44,1,111,109,2,3455,3396,59,14,14,0,100
4eb8bf23be13d44b6d0d2441d6fef19b5f8f3b88,2,5,13,8,0,0,0,3,20,4,1,2,1,498,45,2,117,119,2,3967,4024,57,22,22,0,100
f5e0d528be7129c02e19cfdccf8afa6c6520a918,8,336,14,322,1,0,1,1,36,67,2,5,2.323354538,951,23,1,240,194,46,8968,7313,1655,102,72,30,99.96465182
edd4aa9ad8f4a27ece75fe0d110b6b740ccd2005,0,0,0,0,0,0,0,0,0,0,0,0,0,0,50,1,0,0,0,0,0,0,0,0,0,100
aa6d87e1c8f373f6c2ef0ca5586d03f64339c236,5,511,2,509,4,0,4,1,9,9,1,1,1.906394026,94,0,0,77,21,56,2542,531,2011,34,6,28,99.82363316
e0072e5ff293adee07554174b0318f0b70027072,0,0,0,0,0,0,0,0,0,0,0,0,0,0,22,0,0,0,0,0,0,0,0,0,0,100
6b9399e00dcd2fb2b231c91064dfe15f46feaf1d,23,1923,143,1780,9,0,9,7,42,145,5,15,3.806026906,4033,4,0,1180,955,225,38271,29839,8432,475,389,86,94.71751989
82b6f727ca272b1e86625bfaa89bb5d638a0805c,4,35,6,29,1,0,1,1,12,45,2,3,1.004746982,446,46,1,77,76,1,3179,3118,61,34,33,1,99.95155039
894a91f6097969073c8356fd6aac6490b6b619d9,0,0,0,0,0,0,0,0,0,0,0,0,0,0,23,1,0,0,0,0,0,0,0,0,0,100
c2c05d673071073f036d18a2d82460f3025310cf,0,0,0,0,0,0,0,0,0,0,0,0,0,0,14,2,0,0,0,0,0,0,0,0,0,100
1de6016df57c13100e18f7278c560fb3f4e50500,8,121,120,1,0,0,0,1,43,7,3,7,2.549982442,901,5,1,168,168,0,7068,7068,0,65,65,0,99.85440427
d9f62cb5a97d033448567688bd21e7a4ea25d65a,11,158,9,149,0,0,0,7,25,272,2,6,2.718371612,4619,1,0,934,920,14,39110,38215,895,325,316,9,100
c6081ddcfdb4c8100a4b099405ac8d397fbf9583,2,48,5,43,0,0,0,11,44,74,1,2,0.997687576,1182,0,0,128,126,2,9453,9238,215,62,60,2,100
906f36517bd13cb3f5318e7843ebfd0276a2975f,1,5,0,5,0,0,0,8,11,269,1,1,0,128,24,2,37,36,1,932,920,12,5,5,0,100
c2d52759ff7ce70f0a17e6f7f2ac46f7e160b647,3,5,5,0,0,0,0,11,45,65,1,2,1.570950594,1646,89,0,194,194,0,12629,12624,5,118,118,0,100
242b5585c97a9565ac35641d8a1ed8ee3a8fd883,23,1001,50,951,4,0,4,1,44,194,5,17,2.918307569,4326,46,0,1216,1063,153,38695,33669,5026,479,408,71,99.78171235
f053fd59b5337429d96d441a07ad3d44eac65a5d,5,103,27,76,1,0,1,1,13,75,2,4,1.931597253,822,24,0,218,211,7,5408,5000,408,110,104,6,99.9516441
e0abdb3c35221c81b293399b2bb454a3c8127cdb,1,13,10,3,0,0,0,2,4,5,1,1,0,112,6,2,33,38,5,799,817,18,10,10,0,100
bcb128af3283432a1da3ab4a524cd200f647f862,4,364,9,355,1,0,1,1,44,56,1,4,1.367298639,970,25,1,245,195,50,9079,7031,2048,91,58,33,99.95169082
4f16db450921fb90b02e0103392669a389ef9745,10,261,33,228,0,0,0,1,45,2,4,8,2.137925856,1415,47,1,346,326,20,11999,10446,1553,115,102,13,100
5bb2dcbeb366a2e09423811506078b8e5ddf19f3,11,552,256,296,1,0,1,1,46,34,3,7,2.502181131,2581,7,2,608,584,24,22252,20420,1832,217,209,8,96.94487492
0e7f8ea4603c858cc295259bbd1a22314b732f62,18,405,570,165,2,0,2,2,18,501,2,5,3.764191621,3733,25,2,391,388,3,31114,31868,754,220,226,6,95.54030875
8101883cce0698a59f9f43fb67c94543585127d0,11,677,61,616,5,0,5,1,5,51,2,3,3.073394064,986,26,2,288,208,80,11973,8412,3561,134,83,51,99.66397849
7c262b40ba4bbf6946c2423f36ddb0f3ee12c8f8,36,2367,127,2240,5,0,5,3,33,199,6,23,3.708492336,4095,47,0,1215,859,356,44547,33130,11417,486,350,136,99.57908728
9a4ed469cc64cf107b98fba1851525017fec2024,0,0,0,0,0,0,0,0,0,0,0,0,0,0,51,0,0,0,0,0,0,0,0,0,0,100
958c48c2c1807e68dd8cceda6857ec065c083a4b,0,0,0,0,0,0,0,0,0,0,0,0,0,0,27,3,0,0,0,0,0,0,0,0,0,100
617bc25ecc89f0bb38098faafc8fc1e4e1afb4de,1,9,9,0,0,0,0,1,4,14,1,1,0,357,8,2,80,79,1,2824,2815,9,18,18,0,100
d22fa7eba93d3a97800f4a5f2b5c3935223f7625,1,1,0,1,0,0,0,1,2,9,1,1,0,288,48,1,64,64,0,2297,2295,2,10,10,0,100
45d0930b270caa10434f3d97dbea0224bc68740c,3,32,28,4,0,0,0,2,47,27,1,3,1.136477335,465,9,3,68,68,0,4037,3993,44,27,27,0,100
c4fd42b86bfe1f4654460ba621714bcea3336fbb,0,0,0,0,0,0,0,0,0,0,0,0,0,0,15,0,0,0,0,0,0,0,0,0,0,100
497dcc079eb5240c366b378d4e0776294ba3f810,5,84,18,66,0,0,0,4,48,177,1,2,1.973242125,1856,26,1,301,297,4,16434,16219,215,204,199,5,100
1c4e8b7ffa34a9194d2a6d060c1f335a52c6dce0,0,0,0,0,0,0,0,0,0,0,0,0,0,0,28,2,0,0,0,0,0,0,0,0,0,100
ee8c81df45801fa3798c19f3999b635140e835f7,2,17,8,9,0,0,0,1,48,16,2,2,0.242292189,488,10,3,88,86,2,3972,3911,61,22,22,0,100
b13501825028ea6c8ede8f6eacdf97bf58feacb8,0,0,0,0,0,0,0,0,0,0,0,0,0,0,16,1,0,0,0,0,0,0,0,0,0,100
8fe110c3f3c4902d17b082f8431de190fecb0f6f,16,763,152,611,1,0,1,1,49,91,2,7,3.206974799,5963,48,0,1714,1606,108,49379,45878,3501,624,590,34,99.95592772
ad398393f712fdbb689a33883182f65f8ef58ac7,0,0,0,0,0,0,0,0,0,0,0,0,0,0,0,0,0,0,0,0,0,0,0,0,0,100
ea1c3b68ee8882f46cec1f9394b2aadad1f80f7a,0,0,0,0,0,0,0,0,0,0,0,0,0,0,52,1,0,0,0,0,0,0,0,0,0,100
4e62a0626c5946c7b81943669e859033884f919b,0,0,0,0,0,0,0,0,0,0,0,0,0,0,53,2,0,0,0,0,0,0,0,0,0,100
40d909ef8726b807a263ff8f8be57150e51f910d,6,48,31,17,0,0,0,7,30,322,4,4,1.90482315,2192,2,0,519,514,5,17405,17341,64,140,141,1,99.91189427
b0470f50e10837d052db8e0fe74847b0559bfabf,3,39,5,34,0,0,0,8,24,24,1,2,1.396535273,1186,49,1,301,297,4,10353,10214,139,67,66,1,100
18745cf4b98af9c45e853daa280342dde8da1300,1,31,25,6,0,0,0,7,13,51,1,1,0,309,29,2,51,51,0,2212,2224,12,17,17,0,100
c3808cf1f9010467801a0a1567d60a407fed4f79,4,25,11,14,0,0,0,6,50,3,2,3,1.390982641,2432,50,2,609,604,5,20292,20212,80,172,172,0,100
de91608446514df864995d1e50a8db4276b08ad8,1,17,0,17,0,0,0,6,24,54,1,1,0,763,27,1,187,184,3,5628,5499,129,46,45,1,100
0d8f9f8d2d3902471dc246bd51d3eb7512021f74,9,34,26,8,0,0,0,2,16,48,2,5,2.708888031,1652,28,2,217,217,0,13759,13681,78,103,103,0,100
bcec42e3306c9517c1ded5e7ed538c76cfd29c33,17,1216,1387,171,5,0,5,4,29,21,3,7,3.230593228,3022,49,1,659,677,18,22490,23276,786,219,233,14,99.75760247
84c6d52d266c6aa2039e7e8cb9a7edb8f4bb8a93,0,0,0,0,0,0,0,0,0,0,0,0,0,0,54,2,0,0,0,0,0,0,0,0,0,100
eddab3b12a1318f6e787d062816e28479715f077,1,4,0,4,0,0,0,10,30,2,1,1,0,366,0,0,52,51,1,2653,2638,15,15,15,0,100
bcabde9bbe8361bc7b4461b395dd2ffcb0906962,3,22,1,21,0,0,0,5,11,0,1,3,1.537984108,206,29,3,35,33,2,1923,1860,63,19,17,2,100
3962057c640e1fbecb4cfb6a785475e441a7de1d,3,93,11,82,0,0,0,1,5,210,1,2,0.948157555,741,30,2,180,169,11,6376,5912,464,74,67,7,100
abc4856e94e24837eee0dc5efc1763a5ceba6fc9,2,82,60,22,0,0,0,1,23,8,1,1,0.816811428,752,50,1,210,206,4,6334,6172,162,34,33,1,100
d7ce0a535621e2cd1176ff3e069ce60b27b04c17,3,14,0,14,0,0,0,1,24,3,1,1,1.577406283,852,51,2,240,237,3,7007,6923,84,52,51,1,100
71f9c065225405d188c622a6898686ee5a73817f,0,0,0,0,0,0,0,0,0,0,0,0,0,0,17,1,0,0,0,0,0,0,0,0,0,100
377fe19f023a4036f9fa1503dec6ea698fdb214b,3,51,40,11,0,0,0,2,4,3,1,1,0.766427929,514,90,0,141,139,2,4186,4162,24,40,41,1,100
cfb6b84f41b05275db826bbd43e4c39145b6d2d5,4,61,18,43,0,0,0,2,5,3,1,1,1.622092863,590,91,1,167,153,14,5052,4685,367,42,42,0,100
24a106b4e1a1581b266a453cc6c920bcd06d7a9b,4,124,43,81,0,0,0,2,38,57,1,3,1.212267709,1368,31,3,323,307,16,11045,10559,486,116,107,9,100
cda7f56d5a71970c21de4e2c49771dc85c4a47f0,1,6,1,5,0,0,0,1,6,34,1,1,0,365,11,1,83,82,1,2910,2876,34,18,18,0,100
5527afb0d4cdf4414f2e95e0d419392dc78c9d9a,0,0,0,0,0,0,0,0,0,0,0,0,0,0,55,3,0,0,0,0,0,0,0,0,0,100
f74e43c2bc3fde30cb1d707f1e7c08b8770ec67e,5,148,98,50,0,0,0,7,18,8,1,2,2.020897172,925,92,2,248,237,11,7920,7638,282,61,60,1,100
02e4e86b5adeb52044ba09a978c8ccbb2200d67d,21,1446,286,1160,3,0,3,1,44,58,2,8,3.243783622,6547,51,3,1633,1527,106,60024,52604,7420,615,566,49,99.82467675
3d3be40848775b43c97f4f94df47591762e78d0b,2,16,4,12,0,0,0,2,6,60,2,2,0.468995594,172,32,4,35,33,2,1490,1454,36,18,16,2,100
e0fb7dc17000724fada89cb573db9b4fa1654a2e,4,69,39,30,0,0,0,2,7,0,1,1,1.954870652,703,93,3,174,173,1,5827,5758,69,28,27,1,100
13ba156f1d76caaa969e2f6fd93e2387307ae7c7,3,15,5,10,0,0,0,1,27,60,1,3,1.234497797,1387,52,4,295,294,1,12399,12355,44,72,71,1,100
62d85a4caebeb8f459c0a1774fade83cd49b9c35,3,19,18,1,0,0,0,2,8,0,1,1,1.180764852,583,94,4,151,150,1,4674,4739,65,26,25,1,100
f511f27267adbd5c602e9c2089aba3cac3a314fa,0,0,0,0,0,0,0,0,0,0,0,0,0,0,56,4,0,0,0,0,0,0,0,0,0,100
e0d2cdc27c32742ebecd24db4cca62dc04dcdf4b,10,131,102,29,0,0,0,2,28,51,3,3,2.999426669,3271,95,5,931,926,5,24738,24628,110,280,277,3,100
d23d61b2a88a472978dcd15428a61dfa48d31215,2,42,8,34,0,0,0,4,5,415,1,2,0.881290899,227,33,4,33,28,5,2112,1909,203,19,18,1,100
de251913cdcfade1e77c826072d6869f78dfc91d,0,0,0,0,0,0,0,0,0,0,0,0,0,0,96,6,0,0,0,0,0,0,0,0,0,100
7fb09b0f964f4b4373c885b427359ccf58dfff26,2,19,10,9,0,0,0,4,29,38,2,2,0.978449329,672,97,7,183,182,1,4833,4784,49,65,65,0,100
2e8f6013fa1dedcf7902be425b7bbada1f6b24b9,0,0,0,0,0,0,0,0,0,0,0,0,0,0,52,3,0,0,0,0,0,0,0,0,0,100
6547af2d035fae7402d7a4d77e640e0599fb1075,2,30,6,24,0,0,0,5,6,10,1,2,0.979868757,252,30,3,36,33,3,2249,2112,137,20,19,1,100
c97275ca3b09195f4d37a5d6e7f5a3245ddf4d4e,1,5,4,1,0,0,0,2,2,193,1,1,0,136,31,4,7,7,0,930,930,0,6,6,0,100
8931d475829da92bae9787811ce4dfa774812215,2,71,1,70,0,0,0,4,25,116,1,2,0.41381685,1124,0,0,241,239,2,8755,8220,535,65,64,1,99.95636046
d8b868339ef2233620db3318f8667f0653873ee1,0,0,0,0,0,0,0,0,0,0,0,0,0,0,53,3,0,0,0,0,0,0,0,0,0,100
6fb2a0388a89369ceec57a74954d129df600e163,8,243,113,130,0,0,0,7,45,74,2,6,1.461763313,4130,34,4,633,614,19,36183,35384,799,240,236,4,99.93442623
9b72de98072f4b4adcc3179399342fd63494043b,7,227,28,199,0,0,0,4,30,79,3,4,2.209167819,1433,54,4,413,376,37,11678,10526,1152,93,91,2,94.45452712
e75473a3babb61cf7530fd42ed4ff6fd133c574c,3,92,88,4,0,0,0,2,11,0,1,1,1.493950059,718,98,8,175,175,0,5845,5811,34,27,27,0,100
9eb8134a113bd018f9467284d45f499c26423d3c,0,0,0,0,0,0,0,0,0,0,0,0,0,0,53,2,0,0,0,0,0,0,0,0,0,100
668b4347b97998ed9e66ffaedd54ca20919e3b76,0,0,0,0,0,0,0,0,0,0,0,0,0,0,35,4,0,0,0,0,0,0,0,0,0,100
eb82ef9b76012fbcdad17543d2478ec70fbf00e6,1,2,2,0,0,0,0,5,8,210,1,1,0,154,32,2,28,28,0,971,969,2,3,3,0,100
52489d6003ac8c227e048d808175024dc9fe6724,11,151,15,136,0,0,0,4,27,72,2,6,2.39100195,5006,99,7,547,535,12,46532,45819,713,252,245,7,97.44214373
b59460ffa93f2544aaa0d35488a69474f4a95ca0,0,0,0,0,0,0,0,0,0,0,0,0,0,0,1,0,0,0,0,0,0,0,0,0,0,100
0267eecd831c4927cac7aa460a548f8628fb31f8,4,50,10,40,0,0,0,7,16,42,2,3,1.1877339,540,33,3,93,87,6,4334,4208,126,38,36,2,100
eb5d6fcdcbbfb6d6a69f2c78ef64a7c5a47425ec,2,14,17,3,0,0,0,7,24,18,2,2,0.345117315,1216,55,3,333,333,0,8812,8854,42,123,123,0,100
38297a8441e7d32d41e717fd6efc415804e640af,1,9,7,2,0,0,0,6,34,101,1,1,0,567,56,4,148,147,1,4122,4114,8,40,40,0,100
dd00c8596625703dd3c18474fb9700a07d08f9d8,4,24,12,12,0,0,0,10,31,23,2,3,1.820549241,707,36,4,109,107,2,5808,5702,106,51,49,2,100
ecd053685e547ac86dbfaed290cd3063955ce94a,1,5,3,2,0,0,0,3,8,0,1,1,0,112,100,7,21,21,0,1007,1007,0,7,7,0,100
daf6c0267a41670a5191fef1bd7741f492678970,0,0,0,0,0,0,0,0,0,0,0,0,0,0,57,1,0,0,0,0,0,0,0,0,0,100
c585b60de737a4c8e8974f2752a92ec1f659d6e3,0,0,0,0,0,0,0,0,0,0,0,0,0,0,58,1,0,0,0,0,0,0,0,0,0,100
e0bd96b73d4330e221e65aae0ecb25c9fd9fdc26,1,3,0,3,0,0,0,7,26,41,1,1,0,481,1,0,127,127,0,3947,3906,41,15,15,0,100
87a421ac1d659c9111b8743df26f57e97cb640b3,7,441,96,345,1,0,1,3,45,51,2,5,2.322193914,2847,54,1,767,684,83,25240,23313,1927,280,256,24,94.50835685
3f2d191507fcef46957fce10ebdb06b93c43f303,2,48,20,28,0,0,0,2,51,39,2,2,0.26086291,406,12,0,74,69,5,3596,3395,201,21,21,0,100
1298c83deba4269d4cf9fb9c525d4987f10d7fa3,0,0,0,0,0,0,0,0,0,0,0,0,0,0,59,2,0,0,0,0,0,0,0,0,0,100
fb28760a37aaec81df69b05936cc4234e20380ec,0,0,0,0,0,0,0,0,0,0,0,0,0,0,57,4,0,0,0,0,0,0,0,0,0,100
e1a142b5a783f2a3fc083b40c9ad4d6bca3d5dd9,0,0,0,0,0,0,0,0,0,0,0,0,0,0,37,3,0,0,0,0,0,0,0,0,0,100
d0beadf2e4a83bce17b8c42e7a584a035cf416c2,0,0,0,0,0,0,0,0,0,0,0,0,0,0,60,3,0,0,0,0,0,0,0,0,0,100
02a6e4771598ce418f6081966b50008a7be195a4,0,0,0,0,0,0,0,0,0,0,0,0,0,0,13,1,0,0,0,0,0,0,0,0,0,100
6f9684b4fb0a1c96993df900305d0c45c9a4e32f,2,57,14,43,0,0,0,6,18,78,1,2,0.816811428,518,38,4,67,65,2,4414,4113,301,28,27,1,100
5d26d6649b2281e802d142ce10f246aaddd41b74,0,0,0,0,0,0,0,0,0,0,0,0,0,0,61,4,0,0,0,0,0,0,0,0,0,100
d86be7a3b5db557a4650e4b57f726e42eb87b721,1,2,2,0,0,0,0,1,2,138,1,1,0,20,34,2,4,4,0,94,94,0,4,4,0,100
cd49be50a2fc351f50165f6bd0573db561612699,2,97,89,8,1,0,1,2,3,1390,1,1,0.99866515,73,35,3,5,5,0,475,436,39,4,4,0,99.72434266
b714fe00656f529cec8e4b467322a41729f0ddc5,4,49,23,26,0,0,0,4,52,37,3,3,1.630742073,869,58,3,198,190,8,7091,6938,153,45,45,0,100
856a0c61b273dd9b4a70c69bd743c51e2425a568,6,93,76,17,0,0,0,6,13,476,5,6,2.327521058,888,0,0,173,173,0,6575,6575,0,68,68,0,100
376298540ceca9315d3726c9dbaab619d33ea4f7,1,2,2,0,0,0,0,4,6,122,1,1,0,321,1,1,61,61,0,3222,3220,2,52,52,0,100
fa11d13a5c431fe3c46a7ad2b267bea1f61da3e9,0,0,0,0,0,0,0,0,0,0,0,0,0,0,62,5,0,0,0,0,0,0,0,0,0,100
fae00825291dd79b54867b7b7d0c2a233ce163fd,5,1218,48,1170,1,0,1,1,12,45,1,2,0.891917572,823,59,2,412,195,217,14222,6654,7568,113,29,84,95.8304378
56374ff7e3a6faa3e444db1ba3fa14905f356dc9,0,0,0,0,0,0,0,0,0,0,0,0,0,0,101,1,0,0,0,0,0,0,0,0,0,100
63ed2a5dac174d0fc241e9ae2d8dc5b97408c826,1,1,1,0,0,0,0,5,10,43,1,1,0,115,14,2,15,15,0,969,969,0,15,15,0,100
f2a49beadd0d8aab16dfc0f53fd2795278bf2e48,10,248,6,242,1,0,1,5,53,45,3,7,2.224352645,1882,55,1,460,431,29,15836,14560,1276,129,124,5,96.01226994
bb9384ca32b2d4773fa3985851f3d5edf861dc13,6,54,38,16,0,0,0,4,49,21,3,5,1.501640941,2082,56,2,457,456,1,16786,16592,194,137,137,0,100
b23dc8584a9d798e83d982ea5264de1e8025288b,0,0,0,0,0,0,0,0,0,0,0,0,0,0,63,5,0,0,0,0,0,0,0,0,0,100
a9514d4b1c22b653b8d3fa1d83204ab91dbefedd,1,38,0,38,0,0,0,2,8,26,1,1,0,296,57,3,76,68,8,2744,2473,271,19,17,2,100
e80b6c360c3a5b255d822d0dc006d89a5eba530d,1,2,24,22,0,0,0,5,13,0,1,1,0,159,36,2,14,15,1,1163,1325,162,10,11,1,100
a7e2f50b0afd64cb951b13fdccbdea5197c406ee,0,0,0,0,0,0,0,0,0,0,0,0,0,0,102,1,0,0,0,0,0,0,0,0,0,100
86fb9da494f23ed7689e67b131e736344afa1811,3,9,6,3,0,0,0,3,7,174,1,2,1.399581231,1539,58,4,149,149,0,13948,13880,68,79,79,0,100
6d8c50cca95a51db509c87c73c735ea1445c3fa3,0,0,0,0,0,0,0,0,0,0,0,0,0,0,64,5,0,0,0,0,0,0,0,0,0,100
2c84d7029808c090489b7a8cecdf691ffed71a93,1,13,2,11,0,0,0,6,22,261,1,1,0,282,59,5,46,44,2,2191,2124,67,19,19,0,100
ce8f65c9c5f7f2cff3934829258ce3d2ebe84b60,1,11,4,7,0,0,0,2,13,5,1,1,0,510,60,3,139,138,1,4056,4011,45,25,25,0,100
2841b85ec5039170d39ec8252724f74e4362112f,0,0,0,0,0,0,0,0,0,0,0,0,0,0,65,6,0,0,0,0,0,0,0,0,0,100
1496257312abf06a471efc54c844634d7200b9dd,1,5,6,1,0,0,0,3,4,25,1,1,0,77,39,2,5,5,0,477,475,2,4,4,0,100
b54f4b87659dec53d57c55c77799367d5f0fe399,8,16,16,0,0,0,0,8,31,165,1,1,2.858458593,2220,103,2,650,650,0,15290,15306,16,217,217,0,100
88eadb9bfa74b17dfff26dcbad0617d240d856e9,3,20,3,17,0,0,0,7,29,164,3,3,1.325784781,1065,60,5,227,226,1,8145,8032,113,52,51,1,100
024fd221043ae745921d9bfa9e6e689507972f1a,5,84,33,51,0,0,0,3,46,175,3,5,2.033847155,2699,61,6,568,560,8,22260,21821,439,227,225,2,100
97ae3a3c819a371d9af39cd4de28e4f8b28e19a6,0,0,0,0,0,0,0,0,0,0,0,0,0,0,66,5,0,0,0,0,0,0,0,0,0,100
bb1897663b43feb79faf6e2fc2818380fd16b9dd,5,6,6,0,0,0,0,2,68,560,3,5,2.251629167,2161,62,7,250,250,0,20731,20721,10,162,162,0,100
64c9bde668b52c6f621c19110f2da0a0907704d8,2,31,20,11,0,0,0,2,11,20,1,1,0.999722648,323,104,3,63,60,3,2802,2753,49,6,6,0,100
2f6d7b2491140a5efd5a9fae5b8aaf3ccee5b514,6,86,99,13,0,0,0,3,35,275,2,6,2.330809173,2464,105,4,581,582,1,18460,18549,89,165,167,2,100
b445a1d2ba49764e3f9c898d0a6bb8b5faaddc80,6,150,40,110,0,0,0,8,32,82,2,3,1.830875558,2539,63,8,729,701,28,20708,19998,710,239,234,5,100
a6c0793feaa6871d69fda24189f35b244e606e0e,2,5,0,5,0,0,0,3,30,276,1,2,0.970950594,877,2,2,210,208,2,6408,6376,32,49,49,0,100
8686333985311f3ed907ffc71942eb7e92896808,2,2,2,0,0,0,0,8,25,38,1,1,1,1087,3,3,332,332,0,7852,7852,0,123,123,0,100
c6155816c51ebdbce8bef0069a8bccca1418c7d0,0,0,0,0,0,0,0,0,0,0,0,0,0,0,0,0,0,0,0,0,0,0,0,0,0,100
cba5f7622b0724b158e93ac3d9cd7bd8de6d4c2b,0,0,0,0,0,0,0,0,0,0,0,0,0,0,4,4,0,0,0,0,0,0,0,0,0,100
a32e2b2e7f043740f2a282607ef356f8fea38bbf,0,0,0,0,0,0,0,0,0,0,0,0,0,0,67,5,0,0,0,0,0,0,0,0,0,100
4820a20b1a0df96054ca210aaa0a89bfa48704e1,0,0,0,0,0,0,0,0,0,0,0,0,0,0,106,5,0,0,0,0,0,0,0,0,0,100
15d67e52f118ce689724f62ac3c83cfd3128e34f,17,165,554,389,1,0,1,1,31,245,1,4,3.886558733,3297,5,5,649,703,54,24270,27503,3233,189,204,15,90.52083333
1b7e41f1adbfea4f046ff66b904d22ee839e095b,0,0,0,0,0,0,0,0,0,0,0,0,0,0,64,9,0,0,0,0,0,0,0,0,0,100
f59284adbb3f0231fe6cc0da3a521c29f0210dba,10,481,113,368,0,0,0,3,47,63,2,5,2.912294304,4411,65,10,1080,1057,23,39247,36614,2633,315,304,11,100
42ccc44a9289274133528324eab02cff15ffb955,8,54,17,37,0,0,0,5,11,655,1,5,2.251562883,877,6,5,90,85,5,6804,6607,197,49,48,1,100
20742f1e685a9a58b9c5ef4ba0ac9fbaadf9f8e6,1,1,1,0,0,0,0,4,6,0,1,1,0,58,107,6,3,3,0,406,404,2,1,1,0,100
58794583a1977a684ed5f5567d7376806b262090,0,0,0,0,0,0,0,0,0,0,0,0,0,0,66,11,0,0,0,0,0,0,0,0,0,100
68f66e92acfed5d8fdd5652245bd989aa6bbfb94,1,51,12,39,0,0,0,3,5,297,1,1,0,142,67,12,41,34,7,1450,1186,264,9,7,2,100
ef300f15a500948b983b8a49c5828e5f39dcd35d,1,2,1,1,0,0,0,5,12,2,1,1,0,101,7,5,10,10,0,961,956,5,4,4,0,100
b837c0ee304174a100fc2f4507cbdd7e9a4195b9,3,188,5,183,1,0,1,6,19,40,1,2,1.567893749,552,40,1,87,67,20,5397,4414,983,38,28,10,99.81476581
9d38c6a94f1962a55efb8e047428c2be1e61ad25,1,4,4,0,0,0,0,6,10,5,1,1,0,246,41,2,14,14,0,2404,2404,0,14,14,0,100
1dcc3073abe7b920c9a0fb1fd3055b8daa22cf1e,2,127,91,36,0,0,0,5,12,44,1,2,0.307456533,647,15,0,154,147,7,5173,5018,155,52,51,1,100
7eff37a6f4e23f75b4fce75bbc3c77e3258a6c6d,1,259,0,259,1,0,1,1,1,0,1,1,0,0,42,2,29,0,29,1247,0,1247,12,0,12,99.94731296
a5d52418d26be3de93f95f8811b9a73a74623b1e,2,20,14,6,0,0,0,9,32,15,1,2,0.322756959,1343,68,5,329,328,1,10066,10026,40,82,82,0,100
4deee50c2eb405934ab06e0ae2d8eb478dcd2574,0,0,0,0,0,0,0,0,0,0,0,0,0,0,43,3,0,0,0,0,0,0,0,0,0,100
d603afa2708948d6d33478baf05b5adca2089149,0,0,0,0,0,0,0,0,0,0,0,0,0,0,68,0,0,0,0,0,0,0,0,0,0,100
2acf41fd1e5e3c86a9b377c407f8aee2b7be53a0,0,0,0,0,0,0,0,0,0,0,0,0,0,0,69,1,0,0,0,0,0,0,0,0,0,100
636a6213745f3abf039253b9ff96d6b5a9461dbf,1,6,2,4,0,0,0,6,40,138,1,1,0,565,44,4,125,124,1,4269,4252,17,33,32,1,100
8348f2212187750a20fee7bb4ebe0c1d739d6cc0,4,96,24,72,0,0,0,4,54,113,2,3,1.57898824,475,0,0,83,73,10,4632,4114,518,53,45,8,100
1dc7f54999952d18a677a3bc60f437071764cc16,5,282,100,182,0,0,0,1,14,91,2,3,1.980081834,1943,61,0,496,462,34,16108,15077,1031,158,153,5,91.21495327
8eb9c95677c0466835fc5aa6cbcfa630616cbd3b,1,1,1,0,0,0,0,1,6,170,1,1,0,185,45,5,41,41,0,1198,1195,3,24,24,0,100
13fed7a9d746a7f28d6ed6f930b4e6497f9317c1,1,23,8,15,0,0,0,2,15,1,1,1,0,514,62,1,143,140,3,4132,4059,73,26,25,1,100
a785e935dc77234f783013f51ff23d8c9f0eca59,1,29,1,28,0,0,0,2,16,1,1,1,0,525,63,2,154,143,11,4231,4132,99,26,26,0,100
d1c585a22c4c1abd866e553480efbd21f9cffcd0,1,96,33,63,0,0,0,2,17,0,1,1,0,545,64,3,188,154,34,4491,4231,260,29,26,3,100
6e56185209297e20169520f076f9eb3581abad89,1,25,0,25,0,0,0,2,6,97,1,1,0,97,65,4,39,32,7,857,701,156,19,18,1,100
586b5eb209d146397dc05b5af44716c877d56c2a,14,603,22,581,0,0,0,8,55,192,2,9,2.806544008,5269,16,1,978,925,53,46887,43649,3238,417,394,23,100
979200e7b7ed29d66b43d071d8df0c803e0edf27,3,68,6,62,0,0,0,10,26,164,2,2,1.008623268,964,17,2,254,247,7,7616,7399,217,111,106,5,100
3440240e51a5e4105021ea741be8af15cd1dce88,0,0,0,0,0,0,0,0,0,0,0,0,0,0,70,2,0,0,0,0,0,0,0,0,0,100
f1c464663ff86a4b7913d4e8a8d1547602d44b76,0,0,0,0,0,0,0,0,0,0,0,0,0,0,71,3,0,0,0,0,0,0,0,0,0,100
c623835f5376bdb04797ba9cb886da70fbef0f8c,7,258,178,80,2,0,2,6,42,74,1,5,1.810463635,1009,1,1,181,178,3,8533,8302,231,69,68,1,99.89509022
45b84fa201bdd63cc36094613d33b16741e4fb7a,2,4,4,0,0,0,0,2,2,152,1,2,0.954434003,264,2,2,50,50,0,2040,2043,3,25,25,0,99.9371201
d67b0498edf907ea7370247447b7e86d46645c2a,7,50,46,4,0,0,0,3,16,764,2,5,2.485664347,1245,0,0,252,252,0,10144,10123,21,74,74,0,100
ccd121e74204e1d85001be62abf09446d879889d,27,1492,86,1406,11,0,11,5,56,107,4,17,4.00447155,3449,46,4,918,756,162,34340,27188,7152,381,283,98,99.07192575
c1f4007a9d9f85f888a5c9164e11937025157edb,3,10,13,3,0,0,0,5,49,0,2,3,1.409844941,1348,108,0,348,344,4,10600,10584,16,122,121,1,100
2bcbd259e6f01ba0cde9852f251b70a4805d19ba,0,0,0,0,0,0,0,0,0,0,0,0,0,0,0,0,0,0,0,0,0,0,0,0,0,100
1dee77afc5262755880d80e0c82c5fa9dce2f2ff,6,25,32,7,0,0,0,2,31,96,1,4,2.320652436,1819,3,3,394,394,0,14526,14587,61,128,128,0,99.91507431
67c04c63e1126791ab8537e2a8e8411f0b9e6897,2,53,10,43,0,0,0,6,14,10,1,2,0.549108745,247,4,4,45,39,6,2306,2071,235,28,24,4,100
400477c419eb87c1f4678f7aa3dc1b4d4bda6b2f,8,243,105,138,0,0,0,5,32,0,3,6,2.030587054,1394,47,4,310,292,18,12007,11172,835,100,94,6,100
c0f0abc13037a9d05499dbce2d0e1b65beb9d656,2,18,9,9,0,0,0,2,13,18,1,1,0.950956048,383,66,5,74,73,1,3190,3125,65,6,6,0,100
ae576650c7af86ca8489a077596d3388d5ea2558,0,0,0,0,0,0,0,0,0,0,0,0,0,0,72,4,0,0,0,0,0,0,0,0,0,100
baccd1d8d768cc9e4650c3b39383c304e936e503,1,68,35,33,0,0,0,10,62,563,1,1,0,940,109,1,237,227,10,8043,7899,144,61,60,1,100
9d01689d326f938443de715a090afe26f6df1300,1,1,1,0,0,0,0,6,22,68,1,1,0,610,69,0,148,148,0,5025,5024,1,41,41,0,100
f90cca9dac46fbfb4486b735818c36d13895cdb9,0,0,0,0,0,0,0,0,0,0,0,0,0,0,0,0,0,0,0,0,0,0,0,0,0,100
f75871f4563fa91e74863602786b9669a8aff495,0,0,0,0,0,0,0,0,0,0,0,0,0,0,1,1,0,0,0,0,0,0,0,0,0,100
30138316734373b83f9fb1cdb59857bbfa6bb9fa,0,0,0,0,0,0,0,0,0,0,0,0,0,0,2,2,0,0,0,0,0,0,0,0,0,100
454eb66a3a5d877ca495a5b048d1f5d064c1f6b3,0,0,0,0,0,0,0,0,0,0,0,0,0,0,73,5,0,0,0,0,0,0,0,0,0,100
20f2fba7e3a79e1d3baacdb1b97d1b37acc39c95,0,0,0,0,0,0,0,0,0,0,0,0,0,0,74,6,0,0,0,0,0,0,0,0,0,100
d6d349e5e11d5dad4c888dc182fbf1daddf80761,17,373,26,347,3,0,3,7,42,322,2,11,3.254023368,4713,67,6,568,534,34,44167,42626,1541,308,286,22,98.15450644
a9ca60e3854ab0f07d744560dd7cd8d3a39589ac,1,1,1,0,0,0,0,9,32,0,1,1,0,683,0,0,52,52,0,6535,6534,1,43,43,0,100
7cce1c4af84001c79b7e0d9ad2e566b8cbaf7ccb,7,214,103,111,0,0,0,5,33,7,3,6,1.750338237,1439,48,4,308,297,11,11940,11516,424,98,94,4,100
944a99b550091f2b09fab163b1a42133f1b9ce33,2,121,5,116,0,0,0,2,7,269,1,2,0.117594666,514,37,0,110,84,26,4001,3348,653,26,23,3,100
6a64cd9c284d3bdf5bdd9100c3d6580e74187c41,1,10,5,5,0,0,0,2,18,24,1,1,0,601,68,7,190,188,2,4502,4491,11,29,29,0,100
40666d181853f752f2cd4e010104962129369a42,1,21,15,6,0,0,0,4,8,20,1,1,0,165,49,5,41,37,4,1519,1478,41,19,19,0,100
b78cbe9be55e7df8eec472611659855f22dd4f89,0,0,0,0,0,0,0,0,0,0,0,0,0,0,70,1,0,0,0,0,0,0,0,0,0,100
24d8d186251780b4e13607047098c678426c84ea,0,0,0,0,0,0,0,0,0,0,0,0,0,0,75,5,0,0,0,0,0,0,0,0,0,100
6426e9df2742e4670a47e087b1a418efdb2e8994,0,0,0,0,0,0,0,0,0,0,0,0,0,0,76,6,0,0,0,0,0,0,0,0,0,100
234b3005abc1876e4eb03ff767601f9097d14a22,0,0,0,0,0,0,0,0,0,0,0,0,0,0,77,7,0,0,0,0,0,0,0,0,0,100
9e59fabe39368414517c82cdc5da78772f1d97af,1,11,9,2,0,0,0,5,14,59,1,1,0,555,1,1,142,140,2,4256,4242,14,37,37,0,100
aaeddd38730ed0ddb69b8ea4712082994a86e403,1,4,3,1,0,0,0,7,10,378,1,1,0,162,2,2,28,28,0,1116,1109,7,5,5,0,100
049c5120e19bd12ff16142da2d0c6fd609e492d7,8,136,1,135,0,0,0,6,57,257,3,3,2.163908589,1338,0,0,196,185,11,10610,9856,754,90,87,3,97.36842105
187730dd745f5f558e00393e28b919963c24bf08,41,677,693,16,1,0,1,2,46,141,7,21,3.082898418,11028,69,8,1519,1101,418,96543,76494,20049,689,464,225,97.68672809
5746ec9d0b91287328b349ad675092b52a125629,0,0,0,0,0,0,0,0,0,0,0,0,0,0,70,8,0,0,0,0,0,0,0,0,0,100
f5508315a6b7758fd994eb0766fc11b89db2d715,0,0,0,0,0,0,0,0,0,0,0,0,0,0,78,8,0,0,0,0,0,0,0,0,0,100
d7acdba7c949c08b2320be95de97d9c35d41a386,0,0,0,0,0,0,0,0,0,0,0,0,0,0,79,9,0,0,0,0,0,0,0,0,0,100
f18555cdd579857e679e158adfc922cb2c16af26,0,0,0,0,0,0,0,0,0,0,0,0,0,0,50,4,0,0,0,0,0,0,0,0,0,100
57fbb9cea1592a85b59a02b6a672bab43092f1d3,3,222,135,87,0,0,0,1,19,34,2,3,0.444388747,1800,71,5,486,473,13,13758,13443,315,159,156,3,100
3af543640c944dc98cdc3334588a2ffc5a12e34c,3,27,10,17,0,0,0,4,20,86,1,2,0.969414207,752,72,6,242,228,14,5141,5024,117,30,30,0,100
d541a378678c1fc2b9640a65d38f5d9bec20cf14,20,848,283,565,4,0,4,2,17,601,2,7,3.503092853,1305,110,2,249,179,70,13455,10863,2592,155,117,38,96.56577416
05514255c6fcb988b68976b2d2d8be95ac80376e,2,11,12,1,0,0,0,1,8,0,1,1,0.965636133,270,111,3,41,41,0,2143,2147,4,14,14,0,100
657e0f1272d1361dacee61f3bf328f8a3185cfab,9,51,25,26,0,0,0,7,58,12,4,8,2.29393635,3356,38,1,553,544,9,28176,27952,224,224,223,1,100
70f2ee3a153906aa71e297fb76737dc20ae3ce73,0,0,0,0,0,0,0,0,0,0,0,0,0,0,80,8,0,0,0,0,0,0,0,0,0,100
52848ab63449608d05367f959da007f562bccd5b,0,0,0,0,0,0,0,0,0,0,0,0,0,0,81,9,0,0,0,0,0,0,0,0,0,100
fe05e15751dca5dc4b84bccfdb0b1a236f1d65a4,0,0,0,0,0,0,0,0,0,0,0,0,0,0,82,10,0,0,0,0,0,0,0,0,0,100
dd7eb14e47ae999464a4ab07d4e62be6f634e5ae,1,9,9,0,0,0,0,2,21,11,1,1,0,626,73,7,203,203,0,4728,4701,27,29,29,0,100
4fe70de83dcbca883b119dc6a7d08ede4dede2d6,0,0,0,0,0,0,0,0,0,0,0,0,0,0,83,11,0,0,0,0,0,0,0,0,0,100
9a8c71254c70a0e70241c8b9c8892603ecb03e7c,11,344,28,316,2,0,2,1,19,45,2,4,2.697220197,770,51,2,164,122,42,7448,6036,1412,94,69,25,96.56710628
6a18b5c65257a7905b4a50612e9e2c8978bfaa6d,1,10,1,9,0,0,0,8,20,1,1,1,0,157,112,2,32,31,1,1069,1041,28,13,12,1,100
29465efb337fe3c47131a0853b50650356f01903,0,0,0,0,0,0,0,0,0,0,0,0,0,0,18,0,0,0,0,0,0,0,0,0,0,100
e406603a1612eb09806ee1a643032baff465f1bc,0,0,0,0,0,0,0,0,0,0,0,0,0,0,84,9,0,0,0,0,0,0,0,0,0,100
2ed39cce31358876b1da8ceb9915c9c471c6f401,0,0,0,0,0,0,0,0,0,0,0,0,0,0,85,10,0,0,0,0,0,0,0,0,0,100
943eb2bb01d8a2b7c59eef49ea7559b176102087,1,12,2,10,0,0,0,10,63,57,1,1,0,963,74,4,239,237,2,8065,8043,22,62,61,1,100
701b011228fa6fc45cc3d06458f028660b9012d7,0,0,0,0,0,0,0,0,0,0,0,0,0,0,19,1,0,0,0,0,0,0,0,0,0,100
4bf2ebb4b4e8d982739d5f6f1f087989104f00c9,0,0,0,0,0,0,0,0,0,0,0,0,0,0,20,2,0,0,0,0,0,0,0,0,0,100
f5dd2f07893918a601c58e114f91bc0aac709fb3,0,0,0,0,0,0,0,0,0,0,0,0,0,0,86,8,0,0,0,0,0,0,0,0,0,100
ea1b981e631e1d093f0df3294d9c4484873ca890,0,0,0,0,0,0,0,0,0,0,0,0,0,0,75,4,0,0,0,0,0,0,0,0,0,100
48feaa3529cdcc29434d6f769c0247cc7d2de7b1,1,2,1,1,0,0,0,8,23,82,1,1,0,363,5,0,87,87,0,2865,2854,11,34,34,0,100
27918145448a3b6bb7b2c7af0add7a875d684d11,1,36,11,25,0,0,0,7,17,279,1,1,0,496,39,1,114,110,4,3679,3548,131,12,12,0,100
a3bafb1e75a55e894cefc3f995e21ee2ffcb749b,1,2,0,2,0,0,0,11,47,50,1,1,0,362,76,5,67,67,0,2637,2635,2,27,27,0,100
59f83fc0633f52179a48f0cbe70cbab079c63b72,4,107,124,17,0,0,0,5,34,57,2,3,1.112225356,1274,77,6,122,124,2,11044,11066,22,73,75,2,100
8663eb1dedfc9f3136ea44460055f7e332e3212c,1,21,11,10,0,0,0,7,37,63,1,1,0,598,6,1,159,157,2,4408,4369,39,42,42,0,100
32fa4be52b0459209525ab4e7ecc8469f44fb07f,0,0,0,0,0,0,0,0,0,0,0,0,0,0,3,0,0,0,0,0,0,0,0,0,0,100
96d4d31d0216061846d1fc894763fc50a1aaf8c7,1,8,15,7,0,0,0,10,64,17,1,1,0,969,113,1,237,239,2,8028,8065,37,60,62,2,100
a9928f90e14877c1cee81a47e32fb8ff016480f3,1,134,0,134,1,0,1,1,1,0,1,1,0,0,78,4,24,0,24,661,0,661,11,0,11,99.92022337
96da2306df01023ba8bf202368a482ffa59dc4cb,91,2,10644,10642,0,0,0,4,32,1293,3,15,5.936699909,7690,71,0,161,905,744,6859,64651,57792,44,516,472,95.24776604
5add1aeb7695436e9039b7628cc6767d70ceb662,0,0,0,0,0,0,0,0,0,0,0,0,0,0,79,5,0,0,0,0,0,0,0,0,0,100
3959b318e4cc1e8df26f03a4632cfb6ecd8cb357,7,67,4,63,0,0,0,4,65,418,3,7,2.397870035,2553,114,2,544,537,7,18945,18692,253,187,180,7,100
c08bac80a8aae344874e7393dd94fa7efece752b,1,41,27,14,0,0,0,2,2,80,1,1,0,327,0,0,65,63,2,3469,3352,117,56,54,2,100
bd513f259a8b6fbf4191c4245e7dff8107adf7c2,6,343,28,315,2,0,2,1,9,51,3,6,1.971466816,1136,80,6,217,187,30,11590,9619,1971,127,105,22,99.87600744
749d8bcc21f12793c2686fd3fcb047a694693d45,0,0,0,0,0,0,0,0,0,0,0,0,0,0,81,7,0,0,0,0,0,0,0,0,0,100
d9b2bd06fb32bc631168a09bac983866564e8dd7,0,0,0,0,0,0,0,0,0,0,0,0,0,0,82,8,0,0,0,0,0,0,0,0,0,100
b05b855622166bf98ef6a18198ae94a9414bf21d,7,6036,0,6036,7,0,7,1,1,0,1,5,1.784202895,0,0,0,948,0,948,29035,0,29035,460,0,460,99.63001028
a9f4c21ce2f893045f242b2e19dcb82ddecf6c28,0,0,0,0,0,0,0,0,0,0,0,0,0,0,72,1,0,0,0,0,0,0,0,0,0,100
9370bf75e12a01b0fab13ed843988ff6675be751,0,0,0,0,0,0,0,0,0,0,0,0,0,0,73,2,0,0,0,0,0,0,0,0,0,100
ea52e1f33910d687a316cb2f6feaa7e966812393,0,0,0,0,0,0,0,0,0,0,0,0,0,0,74,3,0,0,0,0,0,0,0,0,0,100
5d1868bbfac1fb9abbd6436dcb68d5f75e2cfeeb,0,0,0,0,0,0,0,0,0,0,0,0,0,0,7,2,0,0,0,0,0,0,0,0,0,100
503dddb8c820ae0dba62d200052262144409d3cf,55,4278,126,4152,26,0,26,7,50,100,3,20,4.612488753,8252,2,0,2088,1566,522,89525,66314,23211,793,513,280,97.16843639
81296b5e7da4cf69b2181a6ad90f0228ae269861,0,0,0,0,0,0,0,0,0,0,0,0,0,0,3,1,0,0,0,0,0,0,0,0,0,100
eaad45bda51e1461998a3e9fc015084277e09ec8,0,0,0,0,0,0,0,0,0,0,0,0,0,0,4,0,0,0,0,0,0,0,0,0,0,100
1e01c01afc8281e5b3f2abacd590c546e169a753,0,0,0,0,0,0,0,0,0,0,0,0,0,0,87,0,0,0,0,0,0,0,0,0,0,100
3b597fb5e2a48823ff5bc1e7469de534629c52c5,1,3,3,0,0,0,0,7,25,9,1,1,0,610,75,4,148,148,0,4927,4935,8,41,41,0,100
8e40ab15d83c09e3496d5740c31deffdd5c6471f,2,6,6,0,0,0,0,12,47,8,1,2,0.918295834,1058,4,2,97,97,0,7961,7933,28,55,55,0,100
091347707eca26213754b7c2e3e4560300ffb825,3,50,38,12,0,0,0,2,36,112,2,2,1.402992131,1443,76,5,132,132,0,13803,13718,85,82,82,0,100
c7a61629dd03775804dd7fd62a6a2e0419b4aaf8,0,0,0,0,0,0,0,0,0,0,0,0,0,0,5,3,0,0,0,0,0,0,0,0,0,100
1869aee3dcf1d5a073c79292fa2442d3f829774c,0,0,0,0,0,0,0,0,0,0,0,0,0,0,1,0,0,0,0,0,0,0,0,0,0,100
3b9ea1dd7e34c3c294c9f03ed7652d137d96096e,0,0,0,0,0,0,0,0,0,0,0,0,0,0,5,1,0,0,0,0,0,0,0,0,0,100
e9b9513143ee489b0521bf58c42b25d6cbc6866e,0,0,0,0,0,0,0,0,0,0,0,0,0,0,88,1,0,0,0,0,0,0,0,0,0,100
37be53bbb7eec13f8ce57377c8653f482216553f,0,0,0,0,0,0,0,0,0,0,0,0,0,0,89,2,0,0,0,0,0,0,0,0,0,100
af51fbcf2d8c94659ed454d78f1b5551c56d052a,0,0,0,0,0,0,0,0,0,0,0,0,0,0,90,3,0,0,0,0,0,0,0,0,0,100
549310e3fbb73fdd969fe771821ef857246cc385,1,0,51,51,0,0,0,11,37,20,1,1,0,684,77,5,53,54,1,6154,6583,429,42,43,1,100
c5da0fa1efcfc46775ff7d238154ae71bf05a974,0,0,0,0,0,0,0,0,0,0,0,0,0,0,78,3,0,0,0,0,0,0,0,0,0,100
0abf84caaf0b8dd0b4a6e40d3f589a4d05683e57,1,1,1,0,0,0,0,7,14,510,1,1,0,163,79,4,33,33,0,1134,1134,0,13,13,0,100
435fe3fbad0dbb41297cc7af7986d3062704d7ee,339,7381,40673,33292,39,0,39,4,69,487,10,90,7.488165136,54120,115,0,5106,8379,3273,263882,453610,189728,2330,3950,1620,84.18065153
41e5404f96395c8fc3f1f8045ba921f283a49cce,0,0,0,0,0,0,0,0,0,0,0,0,0,0,116,1,0,0,0,0,0,0,0,0,0,100
6a1c4f4df2b906673a8cedd6abbd20761fcfb183,1,8,4,4,0,0,0,2,3,0,1,1,0,119,117,2,24,23,1,1194,1182,12,4,4,0,100
2b43fd0064e1cf7b4f2b8724e2a502106a567999,17,249,153,96,0,0,0,3,70,0,5,10,2.954173845,6289,80,3,964,951,13,55068,54228,840,469,467,2,100
2bc6f9076e91143975051c31ddcb5b44a656674a,21,399,19,380,3,0,3,4,29,96,3,11,3.603420956,4146,81,4,472,424,48,39117,37218,1899,280,262,18,99.61697113
b57d16ca2d6648384c2057649eb7173d2be2bb64,0,0,0,0,0,0,0,0,0,0,0,0,0,0,6,0,0,0,0,0,0,0,0,0,0,100
a5dbd157e9450e98abd93892258860b0e3a73c83,1,5,5,0,0,0,0,1,2,62,1,1,0,131,7,1,27,27,0,1052,1052,0,13,13,0,100
a74f1b335a638ed2262aeb7b3279f62b79ca6d51,67,425,364,61,0,0,0,2,19,270,5,23,5.944914444,9061,118,3,2131,2131,0,64162,64255,93,1275,1275,0,100
12d83b5bd52fe1314004188475b59cc945bcd6d1,0,0,0,0,0,0,0,0,0,0,0,0,0,0,119,4,0,0,0,0,0,0,0,0,0,100
6dea2e4f6318911328ff5d1edc52f66521826d6f,0,0,0,0,0,0,0,0,0,0,0,0,0,0,120,5,0,0,0,0,0,0,0,0,0,100
0765d57966ddc5a9f5876b1dae039a8584e7c2fa,6,83,16,67,0,0,0,7,36,72,2,4,2.287640204,2024,82,5,509,497,12,16029,15701,328,159,153,6,100
4a8777b40e641584c088e6e9bc14145f72f681c0,0,0,0,0,0,0,0,0,0,0,0,0,0,0,21,0,0,0,0,0,0,0,0,0,0,100
f5c5971032143f864268b8476b528ce89abf1b98,0,0,0,0,0,0,0,0,0,0,0,0,0,0,83,6,0,0,0,0,0,0,0,0,0,100
a7e89196fe7f084cdc5a6e57916bb64ef1d6b466,2,24,6,18,0,0,0,2,14,112,1,1,0.987137774,400,121,6,79,76,3,3405,3246,159,6,6,0,100
9bf0d12ebce3489e08c5d18c6df678dd09fc5d4d,0,0,0,0,0,0,0,0,0,0,0,0,0,0,40,0,0,0,0,0,0,0,0,0,0,100
92f3d4498c9f8d2825ab358f48b6cee9b7cdde8b,2,20,9,11,0,0,0,11,66,48,1,2,0.578794625,1425,41,1,313,308,5,12267,12142,125,96,94,2,100
dae1dd9d3be500a95d694d7f3c26d0f743e4e199,0,0,0,0,0,0,0,0,0,0,0,0,0,0,8,0,0,0,0,0,0,0,0,0,0,100
0ddc022fe95eca6dbb411b81ed19cc9100c00e00,0,0,0,0,0,0,0,0,0,0,0,0,0,0,6,0,0,0,0,0,0,0,0,0,0,100
3205ca4af5f067e6d7bf1fc166f10d204b750e23,0,0,0,0,0,0,0,0,0,0,0,0,0,0,84,3,0,0,0,0,0,0,0,0,0,100
3ee4f25355be771e70fe714a519c375f5e676a60,10,410,309,101,1,0,1,4,20,94,3,6,2.466747441,2330,122,4,265,252,13,20808,20475,333,140,135,5,99.38416422
d991222dc0517791df5a7e21a3193496895769db,1,1,1,0,0,0,0,3,4,48,1,1,0,137,123,5,8,8,0,1355,1351,4,8,8,0,100
12622e020c8c486ef5b927aa32be9e897966b166,0,0,0,0,0,0,0,0,0,0,0,0,0,0,124,6,0,0,0,0,0,0,0,0,0,100
1e75da0d2787b032390360acf05fdbb5af97e2fc,5,121,29,92,0,0,0,2,33,275,1,3,1.77345332,1640,125,7,388,373,15,12802,12184,618,157,148,9,100
d1aa36c46dded79be0197a5c961e393547b1cc68,0,0,0,0,0,0,0,0,0,0,0,0,0,0,126,6,0,0,0,0,0,0,0,0,0,100
1f8e2146e890fa81235235b9f6e496ce0741aa61,31,779,723,56,2,0,2,2,71,167,5,18,3.945434554,8998,127,6,1161,1165,4,80074,80035,39,610,599,11,99.29721816
914da6ee8b3cc506e50e52ffd1d8be31ba88ff87,2,2,2,0,0,0,0,7,20,50,1,1,1,587,3,0,158,158,0,4131,4131,0,91,91,0,100
eef3c08985ac684746050353de62b72231aee4cd,0,0,0,0,0,0,0,0,0,0,0,0,0,0,85,2,0,0,0,0,0,0,0,0,0,100
d569e538089c37ccd218e975a5c75cc1648212c7,0,0,0,0,0,0,0,0,0,0,0,0,0,0,7,1,0,0,0,0,0,0,0,0,0,100
a6fdfbb75c088d61d4044288e8a9b8f8b03bb94d,0,0,0,0,0,0,0,0,0,0,0,0,0,0,8,2,0,0,0,0,0,0,0,0,0,100
1c58f3aae4bef0406c2415a8fc148b3558e02cae,5,89,19,70,0,0,0,2,34,24,2,3,2.022261716,1503,128,7,407,399,8,11115,10815,300,146,140,6,100
7892a331cd665f81ee782d90638cf66ca5bf8617,1,4,0,4,0,0,0,6,15,309,1,1,0,262,86,2,74,73,1,2003,1980,23,19,19,0,100
a78b9c0046cd13ac276113e41cbaf70f488e9aa2,0,0,0,0,0,0,0,0,0,0,0,0,0,0,0,0,0,0,0,0,0,0,0,0,0,100
2b5c0047fbbc7e573f4fdf8b74dccfac231918b2,0,0,0,0,0,0,0,0,0,0,0,0,0,0,42,2,0,0,0,0,0,0,0,0,0,100
ca04aead3220da83f22c08fab16db9276b3574c0,1,1,1,0,0,0,0,6,16,1,1,1,0,265,87,3,74,74,0,2003,2003,0,19,19,0,100
69330a5d33c4d0007c4aaa47800f0a9a03427fbb,0,0,0,0,0,0,0,0,0,0,0,0,0,0,91,0,0,0,0,0,0,0,0,0,0,100
f87072f3d2345d28b47878f9fdd69c899568108d,2,9,4,5,0,0,0,4,6,10,1,2,0.961236605,914,88,4,141,140,1,7909,7852,57,82,82,0,100
4e1ed9aee42a56349e767b39a77c4c2b4777e6a1,2,0,113,113,0,0,0,2,3,34,2,2,0.974941566,62,89,5,0,8,8,0,389,389,0,6,6,97.89443323
1d0a1356500bca57abe5bdf150413b5e556cf614,0,0,0,0,0,0,0,0,0,0,0,0,0,0,22,0,0,0,0,0,0,0,0,0,0,100
28fb3cc6ec7d6481652eff11d96e271bfbfefed9,3,7,32,25,0,0,0,5,13,70,3,3,1.344618002,526,129,8,133,142,9,3730,3864,134,46,49,3,100
667abe4aa04af375e8ebd33e660c6319886ff07f,2,16,2,14,0,0,0,3,37,87,1,2,0.764204507,756,130,9,203,196,7,5786,5743,43,28,28,0,100
b9b3810e99bc2e3123522828a3169b8dc18575d0,0,0,0,0,0,0,0,0,0,0,0,0,0,0,8,0,0,0,0,0,0,0,0,0,0,100
acb34ca7bca092fc6a26b5f516ae66ae0896b24f,0,0,0,0,0,0,0,0,0,0,0,0,0,0,23,1,0,0,0,0,0,0,0,0,0,100
5ba64a8b34cb5cffb2fdeb76c25f26cf65efb24c,27,0,4122,4122,0,0,0,3,7,641,1,5,4.270092503,2653,90,6,0,451,451,0,21312,21312,0,246,246,97.90636813
71a30876d74b9e286dc207f1b5c1f70d96a782c2,0,0,0,0,0,0,0,0,0,0,0,0,0,0,1,1,0,0,0,0,0,0,0,0,0,100
5bd5327c40e6dfc4454c2311165d5ee6b75f109a,17,5532,135,5397,9,0,9,5,38,54,2,6,2.881972804,1229,9,1,990,230,760,37120,10133,26987,547,59,488,98.93016345
d1e79fa06c455f161b6dc3bd2c4ffee577e98b37,2,473,0,473,2,0,2,1,1,0,1,1,0.748177478,0,1,0,60,0,60,2603,0,2603,22,0,22,97.25990233
f89fa44156d64e86920d66ba776852fc55297e12,1,6,1,5,0,0,0,2,8,333,1,1,0,331,24,2,73,72,1,2704,2677,27,16,16,0,100
a40f3c2c5234acec5e4566394e748620697ba119,7,28,10,18,0,0,0,4,72,250,2,7,2.144023911,2850,131,3,517,515,2,22595,22507,88,253,251,2,100
728aac65f9e6427d0dc66ec32e197720e5d1d686,0,0,0,0,0,0,0,0,0,0,0,0,0,0,2,0,0,0,0,0,0,0,0,0,0,100
ac0764beeabb3d7e7f93231c73095c867fb0ec13,14,1492,1342,150,2,0,2,7,39,15,3,6,2.906347534,5472,10,1,1140,1056,84,37904,36103,1801,609,582,27,99.7005988
faeecf10130bb2745dd41a74feb8709752d15951,3,124,5,119,1,0,1,8,45,69,2,3,1.149338306,688,132,3,198,171,27,5608,4958,650,58,57,1,99.9501992
5614bf0d6da416455c366cf44bbaace72b0893b2,5,334,152,182,0,0,0,4,40,0,1,3,1.298552437,1950,11,2,516,486,30,14924,13722,1202,190,173,17,100
db77c65becac07ed0674fa4e6bc050a846991718,0,0,0,0,0,0,0,0,0,0,0,0,0,0,25,3,0,0,0,0,0,0,0,0,0,100
14df38de4a53baa063cdcaf0e299d5fb46dfb7f5,4,48,3,45,0,0,0,2,16,179,1,2,0.709025551,1547,133,4,339,330,9,12064,11852,212,97,96,1,100
247ad8b2620b92d7ca9c99d3f82082e3f60f17d5,1,2,1,1,0,0,0,7,26,6,1,1,0,249,134,4,38,37,1,1902,1878,24,18,18,0,100
1e64199b2ca8229f2eab54e37d59d49c1c7d5a1f,0,0,0,0,0,0,0,0,0,0,0,0,0,0,11,0,0,0,0,0,0,0,0,0,0,100
2a2b07e983851c08f792b72cd5518cb455f59971,0,0,0,0,0,0,0,0,0,0,0,0,0,0,26,3,0,0,0,0,0,0,0,0,0,100
5384a74274b435118e0c4d4c521557df0b0f7eef,4,64,47,17,0,0,0,2,5,31,2,3,1.495017461,1615,135,4,277,273,4,12347,12174,173,162,161,1,100
8db8b5c7c199c25c6d83074940fc3020cd3815d0,15,434,380,54,1,0,1,1,59,42,2,6,3.136590475,3391,83,0,672,541,131,24470,21287,3183,252,196,56,99.5017439
d2244dcb2f116d681c4f97b8b6d1d260cc9d40cc,0,0,0,0,0,0,0,0,0,0,0,0,0,0,12,1,0,0,0,0,0,0,0,0,0,100
15c5434d97da13808771d222d7d3c01d63a49f3f,0,0,0,0,0,0,0,0,0,0,0,0,0,0,13,2,0,0,0,0,0,0,0,0,0,100
6eff6b67b768e03e6c0a598ba49ab987b9de0db2,1,17,13,4,0,0,0,10,49,82,1,1,0,866,136,5,179,178,1,7382,7340,42,26,26,0,100
4516418b5c9cd36d1096f1186d43e18746dcc4fe,2,21,0,21,0,0,0,2,5,223,2,2,0.791858353,141,43,0,28,25,3,1159,1046,113,24,21,3,100
9abc89bf8f55e073b43b86a7ba5ce6917e2f7a6d,0,0,0,0,0,0,0,0,0,0,0,0,0,0,2,0,0,0,0,0,0,0,0,0,0,100
02a618afd16e7b7959140d48e2a12390aa043171,0,0,0,0,0,0,0,0,0,0,0,0,0,0,3,1,0,0,0,0,0,0,0,0,0,100
716afc53b35624027a1f6788b0d56e6d813012ef,8,208,168,40,1,0,1,3,50,105,4,6,2.034827123,1611,91,0,288,289,1,14118,14563,445,84,86,2,99.90024938
1ff791cfca9c8167db92bbde0ce02969620cdd60,1,6,5,1,0,0,0,1,2,1,1,1,0,107,92,1,20,20,0,894,858,36,9,9,0,100
38159334645dfcd8b3c948aea18e71cc0d7dfcbc,8,188,62,126,0,0,0,8,52,141,3,7,1.878756001,4953,137,3,845,843,2,42908,41628,1280,291,290,1,99.85041137
3f330194c765cd0fef7e894397ebe9bd2aa5b247,1,4,15,11,0,0,0,7,27,41,1,1,0,250,138,4,40,38,2,1846,1902,56,18,18,0,99.95014955
4353aa919635568e2dceaada12331df6e07b90c8,1,26,6,20,0,0,0,4,11,162,1,1,0,183,93,2,38,33,5,1700,1558,142,11,10,1,97.64309764
413aa88e61b899792678135a3c66754be4d93583,1,1,1,0,0,0,0,6,17,90,1,1,0,265,94,3,74,74,0,2011,2003,8,19,19,0,100
08ac11c091f62ab7e006a0b4491959ebb2949df7,3,38,5,33,0,0,0,10,28,157,2,3,0.429122341,792,139,3,189,183,6,7015,6774,241,63,62,1,100
df9f5d276286c0b510591e39fb8af2cbdc2ebfbb,2,12,7,5,0,0,0,10,51,90,2,2,0.981940787,1057,140,4,222,221,1,8949,8933,16,33,33,0,100
ab316c9b375931306111c7d075b99ecd50c81803,0,0,0,0,0,0,0,0,0,0,0,0,0,0,4,2,0,0,0,0,0,0,0,0,0,100
b5989c84435ed6829c2cf48fbcc3efba4814628e,16,1221,629,592,3,0,3,5,42,40,1,5,2.981551548,5220,12,0,1143,1074,69,36702,33907,2795,621,562,59,99.51508621
7f7af565eb673486c1a2d0e7b1eb5fb1bb3923ab,8,203,3,200,0,0,0,2,5,506,1,1,2.624062483,641,141,5,185,134,51,6502,5272,1230,39,32,7,97.53694581
4dc953395abbe6b1b884f5190c5a0c2369377516,2,4,4,0,0,0,0,5,7,502,1,2,1,266,44,1,36,36,0,2253,2249,4,20,20,0,100
b51a32db9202873a7c635f7b318ca9718159beee,1,1,1,0,0,0,0,3,5,422,1,1,0,77,45,2,5,5,0,477,477,0,4,4,0,100
212417c966ea1812ee80d898ed08dd5c2ee53a49,0,0,0,0,0,0,0,0,0,0,0,0,0,0,13,1,0,0,0,0,0,0,0,0,0,100
c9303742fad6749803dfc85c5e2a7edbd6250944,4,44,302,258,0,0,0,2,6,0,1,2,0.894737931,1632,14,2,260,282,22,9555,10541,986,140,163,23,99.81185325
cef91eb84e2952182e211cdd7a368411a8d313af,5,577,133,444,2,0,2,7,43,15,3,4,2.047675997,1168,142,6,349,274,75,11413,8907,2506,93,62,31,99.62453066
74e565446b48b3a87ea9b51096265b00ea5f890b,10,68,35,33,0,0,0,3,29,117,3,5,2.632779772,3913,95,4,486,477,9,36147,36047,100,295,294,1,99.62121212
f2342f595f7f0d78e28a2ceb97734b40c0b95ef4,2,4,4,0,0,0,0,5,15,114,1,2,1,167,96,5,18,18,0,1418,1418,0,12,12,0,100
5c9259209acc5227762de45014edf27bf8f4097d,1,3,0,3,0,0,0,10,52,7,1,1,0,869,84,0,180,179,1,7404,7380,24,26,26,0,100
c6cc3314f234c87f856f928f2bdf1e2a935df5a2,2,17,13,4,0,0,0,2,44,2,1,2,0.970950594,1214,15,3,327,329,2,9176,9151,25,96,95,1,100
9f0866c8a758319bff96b7b281ee05eb31a88d41,0,0,0,0,0,0,0,0,0,0,0,0,0,0,5,3,0,0,0,0,0,0,0,0,0,100
8535e88cd538c8b5ee2e7dbf803358654391d25d,5,119,103,16,0,0,0,7,53,67,3,3,1.941000258,2303,143,7,450,448,2,18619,18410,209,130,130,0,100
b17d0e970b61950d2738ec721fa3a4d5a1e3f3c9,0,0,0,0,0,0,0,0,0,0,0,0,0,0,46,3,0,0,0,0,0,0,0,0,0,100
a7f3e1ad3c0a452a25ef886c7e259497147c3b2f,0,0,0,0,0,0,0,0,0,0,0,0,0,0,27,0,0,0,0,0,0,0,0,0,0,100
c746a0505722adc46c19def24f2fb9c6b76fb367,1,7,1,6,0,0,0,2,7,358,1,1,0,185,16,4,42,41,1,1220,1198,22,24,24,0,100
8253653bcadd52e2658749df362cf78616a546e1,7,128,68,60,0,0,0,2,7,4,1,2,1.741617089,1803,17,5,354,346,8,12869,12489,380,189,185,4,100
ecf8095ff92252f252e14292bb5d82d7b6aa1951,8,47,32,15,0,0,0,5,73,44,4,7,2.687047931,4808,97,6,659,655,4,43329,43215,114,304,304,0,99.64990452
f28d0f54d74a0c6c715d79070986547e6d03d269,8,238,176,62,0,0,0,2,45,7,1,3,2.162524875,2518,18,6,553,529,24,18527,18304,223,210,196,14,99.65057179
8c9d3da2cecccd043dd8257c4102b8b147e4f6b7,4,12,11,1,0,0,0,1,74,39,2,4,1.749060324,2178,98,7,274,274,0,19857,19846,11,158,158,0,100
d5b438b5db08cc4ecff69912b425104cd7ecd924,1,9,2,7,0,0,0,9,32,24,1,1,0,1103,99,8,295,294,1,9470,9397,73,61,61,0,100
59c676961bf8aeb31ca2704463ae966665800e6f,0,0,0,0,0,0,0,0,0,0,0,0,0,0,2,0,0,0,0,0,0,0,0,0,0,100
ba9566e974f6eaf5ad075b6682b54e10902ed0c9,0,0,0,0,0,0,0,0,0,0,0,0,0,0,28,1,0,0,0,0,0,0,0,0,0,100
0345cd41a80f45e6b7330749b79a0e4c379768b3,4,47,47,0,0,0,0,5,75,47,1,4,0.601896117,1851,100,9,200,199,1,17678,17654,24,124,124,0,99.9682136
6b4c3aa7eb1a8af53ba910d23784da2d04308398,0,0,0,0,0,0,0,0,0,0,0,0,0,0,6,4,0,0,0,0,0,0,0,0,0,100
4c9a3bf7f885bba275d9bef6fc36999fa95705e6,9,322,185,137,0,0,0,2,60,7,2,3,2.681990005,2085,19,7,461,397,64,15437,14279,1158,234,226,8,99.77714104
511370530ff34affe9be48466be835c914fc84a8,6,364,317,47,1,0,1,3,7,6,2,3,1.27706943,3209,85,1,569,566,3,19881,19681,200,363,360,3,97.08794409
97e47d24d99456b621b7f8962c47c5e16a5559b1,1,1,1,0,0,0,0,4,5,110,1,1,0,49,20,8,19,19,0,158,158,0,1,1,0,100
bbdeaee3f1b0d1adfe00ba7c9832e559192407cf,2,3,4,1,0,0,0,3,8,0,1,1,0.985228136,315,144,7,21,21,0,3182,3195,13,18,18,0,100
9050e74df13ed4b4c6c7842fa92210b5c1262ee5,0,0,0,0,0,0,0,0,0,0,0,0,0,0,145,8,0,0,0,0,0,0,0,0,0,100
3689a358292ce6d854b19056bede958d247ce8d3,2,2,3,1,0,0,0,6,76,16,2,2,0.970950594,1572,101,10,165,165,0,14739,14744,5,106,106,0,100
72030ad1bde9e7d00084e9811b6a2051068e0ed2,0,0,0,0,0,0,0,0,0,0,0,0,0,0,102,11,0,0,0,0,0,0,0,0,0,100
7c80aba28bedd2a53aeb7a2f8a4e5ad47b31d06d,1,16,9,7,0,0,0,2,4,16,1,1,0,110,9,0,19,20,1,875,888,13,8,9,1,100
f1f828fdc58b87cd4fcf51c3c10e9c5a34216a5a,1,10,0,10,0,0,0,4,9,247,1,1,0,580,21,9,147,144,3,4756,4689,67,47,46,1,100
74d4827943a3b4e4003f14653c78e487387fa595,1,3,0,3,0,0,0,5,13,199,1,1,0,134,103,11,21,20,1,1053,1013,40,4,4,0,100
bd87c3f624d45e9d6d2080c28197e3e1ab9a4ebc,0,0,0,0,0,0,0,0,0,0,0,0,0,0,104,12,0,0,0,0,0,0,0,0,0,100
39be2ccfdf5ec3edb59d7779e7b3f7d95413b632,1,8,4,4,0,0,0,5,10,0,1,1,0,589,47,3,149,147,2,4784,4756,28,47,47,0,100
5c2f7a0c85f8f501a21e70b303ddf0c9d0ee14c8,0,0,0,0,0,0,0,0,0,0,0,0,0,0,146,7,0,0,0,0,0,0,0,0,0,100
4c2f7bf203d2e688e4ef80570657ce5a979cf93d,5,38,27,11,0,0,0,6,33,244,1,3,2.045073467,2231,22,10,569,566,3,18397,18314,83,165,162,3,100
84f4f1035c25a5adcd9742b3c67cf60062adf8bb,7,80,34,46,0,0,0,7,46,174,3,4,2.111616074,2235,105,10,574,568,6,17731,17431,300,151,148,3,88.03858521
5900fcb001a9a757dc853eb786638601276b7b99,8,186,65,121,0,0,0,4,61,156,2,5,1.817513151,3398,106,9,745,722,23,28291,27494,797,263,256,7,100
b7b462e391f18eb8c8326d660bc10ad85dd989af,0,0,0,0,0,0,0,0,0,0,0,0,0,0,107,10,0,0,0,0,0,0,0,0,0,100
5447608bf3fe491fc0219d6731ec55ac0062a176,0,0,0,0,0,0,0,0,0,0,0,0,0,0,147,3,0,0,0,0,0,0,0,0,0,100
4c4981855aa1c579790a552f6e93f2a0de27cdc3,1,2,2,0,0,0,0,3,5,207,1,1,0,224,23,5,34,34,0,1912,1914,2,23,23,0,100
1fee4a5b61e219c974deaab15254e41e3fa92624,0,0,0,0,0,0,0,0,0,0,0,0,0,0,148,4,0,0,0,0,0,0,0,0,0,100
c35f82ca1a3af5bbb1565afe6b9ff7358ed5c243,12,708,475,233,1,0,1,2,62,29,2,3,2.891448351,2513,24,5,590,533,57,19384,17831,1553,279,255,24,99.47728187
77dd50c6403cfbf197ee12aaf91e8419bfd528f3,1,17,0,17,0,0,0,8,19,223,1,1,0,509,48,1,117,114,3,3782,3679,103,12,12,0,100
9c8492cb17a50025c8c1239525e9e1ea6a735feb,7,128,207,79,0,0,0,5,11,292,2,6,2.331260225,1029,25,6,99,107,8,7607,7981,374,57,65,8,88.97007655
809cf0a746e7d3bed1f47ba2580fa6c718b108ff,1,1,1,0,0,0,0,12,35,47,1,1,0,353,0,0,48,48,0,2593,2593,0,15,15,0,100
804c4635e66e05fae627ad1e9344c1b11251ad35,4,76,11,65,0,0,0,2,9,0,1,2,1.521644207,1395,86,1,406,391,15,10312,9963,349,170,165,5,100
cbfdd7fcc2ccb011c6f3000e3cb7a9de79268445,85,14159,0,14159,85,0,85,1,1,0,1,3,6.284652781,0,0,0,825,0,825,25967,0,25967,589,0,589,94.41565918
d7ac76c481b78730e088f982fd07bb7d22424b64,1,22,1,21,0,0,0,5,7,50,1,1,0,534,10,1,119,117,2,4130,4053,77,61,61,0,100
37b2710725e8744e1af4cfcab33cdd1dd448b67d,11,323,246,77,0,0,0,3,54,273,3,8,1.820926567,2987,108,7,606,587,19,25028,24308,720,243,242,1,91.4148968
dcdd3d6864479930f3ed9cc471961579d189c940,0,0,0,0,0,0,0,0,0,0,0,0,0,0,7,0,0,0,0,0,0,0,0,0,0,100
a02be15d490939b6a411fede89cd1b1f44696404,11,777,235,542,0,0,0,7,46,188,6,10,2.790484662,3169,149,3,669,608,61,28610,24918,3692,275,242,33,99.6657754
76fbe643e50d7adc8d6c21dc7e920a58bfd47488,0,0,0,0,0,0,0,0,0,0,0,0,0,0,2,0,0,0,0,0,0,0,0,0,0,100
0a876f933b0463409936e45b25508405ef4c7e02,6,247,235,12,0,0,0,2,47,10,1,3,0.768761644,2547,87,1,574,570,4,18187,18167,20,219,216,3,100
bd4a7be91b8c72180551eddc012d57cb040e2469,3,32,22,10,0,0,0,2,13,0,1,2,1.330264331,1590,26,5,326,325,1,11232,11134,98,148,148,0,100
134d60fb2b9ea44accdce685b5051fc54e15a31c,1,89,55,34,0,0,0,9,24,380,1,1,0,398,88,2,65,65,0,2907,2907,0,21,21,0,100
ba4df832e96f75459a137f83a75d821701b857e6,4,62,56,6,0,0,0,2,14,7,1,2,0.983136529,1813,27,5,391,390,1,12686,12654,32,182,182,0,100
4e8e9ca87b32986e7a6940d53e49714918320d2f,0,0,0,0,0,0,0,0,0,0,0,0,0,0,150,3,0,0,0,0,0,0,0,0,0,100
92cdc6a9c2e29c6cdb6ae75614cf13b3fac390e0,0,0,0,0,0,0,0,0,0,0,0,0,0,0,28,5,0,0,0,0,0,0,0,0,0,100
4582d4a455984962bf46dfbac3e5006172403c05,6,71,7,64,0,0,0,2,15,24,1,2,2.069119054,1987,29,6,449,435,14,14217,13896,321,203,197,6,100
ad4db42ef409d4283741906e22b657bab59f3d58,3,6,2,4,0,0,0,10,34,178,1,1,1.561278124,1624,30,7,426,424,2,13758,13717,41,112,112,0,100
e545c9ffdda84f566981e069f84bc4c47f4c3b51,0,0,0,0,0,0,0,0,0,0,0,0,0,0,31,8,0,0,0,0,0,0,0,0,0,100
ad6b07a981510408d0627a7260a6de2aae771f57,20,822,175,647,0,0,0,3,63,226,2,6,3.710098312,6155,151,2,1787,1643,144,49020,45371,3649,582,561,21,99.8994301
154dda0e5b03020b405faed8fd37f15654f492f4,8,461,384,77,0,0,0,3,55,70,3,4,1.896926484,4106,152,3,1057,1033,24,32082,31759,323,291,294,3,100
9cd28bbedd2726187b02c7199ecc0f315f0f7afa,0,0,0,0,0,0,0,0,0,0,0,0,0,0,1,0,0,0,0,0,0,0,0,0,0,100
5618ad4ce3b608a5c6ab98dc794d231fb7a3673e,1,144,130,14,0,0,0,6,13,279,1,1,0,153,4,0,19,19,0,1545,1464,81,8,8,0,100
a69496427df2da9f66392b115b8a938fe26f4bf1,1,4,4,0,0,0,0,6,14,1,1,1,0,150,153,3,19,19,0,1565,1545,20,8,8,0,100
3635e8e245cfa4a5b74ebdd2d986b45fb96a5680,0,0,0,0,0,0,0,0,0,0,0,0,0,0,8,0,0,0,0,0,0,0,0,0,0,100
a0c85e5aa0966303a3dda250956f2528af83678e,0,0,0,0,0,0,0,0,0,0,0,0,0,0,9,1,0,0,0,0,0,0,0,0,0,100
4119f431ebb7c948fbe6ea031338d918acb30919,1,25,0,25,0,0,0,1,2,339,1,1,0,111,3,0,34,28,6,991,826,165,12,10,2,100
3ec37cae8d8297258334f4489605ff44bffd6f5c,4,303,9,294,2,0,2,1,59,94,2,4,1.53327043,744,89,0,152,112,40,8013,6578,1435,63,53,10,99.83260797
a2ccdf12c2b901744aa8b54fe08654d72490b23c,5,93,69,24,0,0,0,4,16,181,2,3,1.166050027,1722,32,5,348,344,4,12123,12005,118,157,156,1,100
19d67a13206a68c49ce92926f9513e833c423c83,1,56,0,56,0,0,0,2,4,48,1,1,0,642,4,1,125,114,11,5050,4489,561,33,33,0,100
340f8637ded4789be2620d7fdbfde7edf6ffcee2,2,8,3,5,0,0,0,9,16,580,1,2,0.684038436,208,49,0,56,54,2,1420,1379,41,22,22,0,100
4152bc6d5247e6abf11d9e5d7b34e26f6da3511e,2,77,3,74,0,0,0,2,2,422,1,2,0.830495523,231,33,5,51,41,10,1937,1392,545,14,9,5,100
c2be0646d95b7b38ea3b06382091e0e5bcf9988a,4,22,9,13,0,0,0,1,77,47,2,4,1.924126653,2208,90,1,296,291,5,20084,19988,96,157,157,0,100
8a57e6571c0079c25c147732ad3a6994be8e14ea,212,54135,14,54121,208,0,208,1,2,0,2,42,6.310905246,581,1,0,3247,70,3177,114559,2165,112394,2085,33,2052,87.03394546
c3a684fd5f5486772ad918e5896a2e27fc8cffb2,1,1,1,0,0,0,0,3,5,4,1,1,0,692,3,0,125,125,0,5050,5050,0,33,33,0,100
745b520b25e0f733a7a7c6d8fea49b2a7b1573b8,0,0,0,0,0,0,0,0,0,0,0,0,0,0,4,1,0,0,0,0,0,0,0,0,0,100
3fd57d75309c8dffb070fa5be8ed06932596d6b6,1,1,1,0,0,0,0,3,6,3,1,1,0,692,5,2,125,125,0,5050,5050,0,33,33,0,100
92b966573227e85a7739afc6d707d88c1b428607,2,38,14,24,0,0,0,2,7,28,1,2,0.995727452,889,6,3,168,154,14,6799,6663,136,47,47,0,100
9c58d30c7d9ff48307e097bf57cb75d614ab214a,1,45,2,43,0,0,0,1,2,192,1,1,0,253,7,4,51,45,6,2619,2098,521,17,17,0,100
a3374c747fb900ed44358b8b2c643e439820d2e6,38,2649,356,2293,5,0,5,4,64,258,5,22,4.12102555,9702,109,0,2379,1941,438,91227,78020,13207,773,649,124,93.01503095
48b2eaa99f91ec615f67fcde3183b262c765d698,6,202,10,192,1,0,1,4,38,0,4,5,1.839108736,2856,154,3,682,652,30,25083,24015,1068,194,178,16,99.91764464
d74f0ce9da0960192c9a7bae9e2e42f82a038a76,0,0,0,0,0,0,0,0,0,0,0,0,0,0,10,2,0,0,0,0,0,0,0,0,0,100
5e496e5e1daab6e25c0208dbcd17f784cd54e63a,1,1,1,0,0,0,0,10,39,0,1,1,0,1275,155,4,347,347,0,10962,10961,1,65,65,0,100
8d86dd2c61af199045289b6f94ff794ded16d5d3,5,44,27,17,0,0,0,4,40,0,4,4,2.036875557,2908,156,5,662,664,2,24608,24556,52,182,181,1,100
bf4bf7fea74e429473b3f2104f2327d5c93cf414,1,5,0,5,0,0,0,2,7,73,1,1,0,393,157,6,84,83,1,3079,3046,33,30,30,0,99.85641026
be9b39bf53f0f3951c5c69a8d124c6727573b568,4,80,26,54,0,0,0,4,16,79,3,4,1.738384912,969,158,7,233,207,26,7384,7212,172,90,88,2,100
afbc6975b3eb0ece492f26f508792cf363ad2211,60,1844,2642,798,9,0,9,6,65,478,5,24,5.083047684,10187,50,1,1709,1772,63,76828,80634,3806,625,598,27,98.66227619
860258d383fd0ef3799b75aa4c9f5c141d25c492,0,0,0,0,0,0,0,0,0,0,0,0,0,0,91,1,0,0,0,0,0,0,0,0,0,100
ff605a20ac61ec987b6f8cfcf3ec2224620faa2b,1,10,2,8,0,0,0,3,23,112,1,1,0,627,92,2,203,203,0,4828,4772,56,29,29,0,100
45e38e8526eafe08e4450c4dc07e5be732123670,0,0,0,0,0,0,0,0,0,0,0,0,0,0,92,0,0,0,0,0,0,0,0,0,0,100
eecff698c04e52387a6e53d90b0c7de43397c6f3,0,0,0,0,0,0,0,0,0,0,0,0,0,0,11,1,0,0,0,0,0,0,0,0,0,100
6770091aa172576d398e4980f0dacbea65f733ea,7,54,25,29,0,0,0,3,17,149,1,4,2.515584557,2239,110,1,468,465,3,15987,15635,352,163,162,1,100
ef36a262a17d7cdc3b255ebb257e61d7726f014c,3,61,45,16,0,0,0,10,57,51,1,2,1.223776666,2800,111,1,731,730,1,22371,22235,136,183,182,1,100
c8bf6907396c6a95d2879d7b85a19b57c5b6de35,1,1,1,0,0,0,0,1,2,246,1,1,0,68,8,0,15,15,0,505,505,0,5,5,0,100
a6b3521e04c9d65b148500c5858e74027df289c1,0,0,0,0,0,0,0,0,0,0,0,0,0,0,12,1,0,0,0,0,0,0,0,0,0,100
e96b1accc2d2de4c00edb78afefcc66862f48790,0,0,0,0,0,0,0,0,0,0,0,0,0,0,51,1,0,0,0,0,0,0,0,0,0,100
8b6715be66e6786b503806a27bfb08c2603c6fb4,0,0,0,0,0,0,0,0,0,0,0,0,0,0,13,2,0,0,0,0,0,0,0,0,0,100
02f382a27c31dd6556dd8dcfe71f5a9ebe92d7ba,0,0,0,0,0,0,0,0,0,0,0,0,0,0,14,3,0,0,0,0,0,0,0,0,0,100
ec00aed1ee08fc7e0b430a8964b6afa1f86b4d84,23,745,434,311,0,0,0,3,66,286,4,13,3.241237586,6593,112,2,1607,1574,33,52975,51261,1714,464,450,14,97.52895753
5ebd7070ec767c0f27ae4240bfd1481190f38d0d,1,27,9,18,0,0,0,6,19,69,1,1,0,289,159,0,43,40,3,2590,2522,68,18,18,0,100
b32e547e4ae5825bcbe31aefa5e87cd9622a7054,3,71,41,30,0,0,0,5,13,145,2,3,0.988449396,390,93,2,98,92,6,3015,2734,281,38,35,3,100
ebe99f1d210f3cf4fb95d99dbb77ed09fdca782e,0,0,0,0,0,0,0,0,0,0,0,0,0,0,93,1,0,0,0,0,0,0,0,0,0,100
0120003a039b9007b8802432342efd8b6dc1ff60,0,0,0,0,0,0,0,0,0,0,0,0,0,0,94,2,0,0,0,0,0,0,0,0,0,100
2735f96fc70f06eba4672538376c6df8f0dc30dd,0,0,0,0,0,0,0,0,0,0,0,0,0,0,95,3,0,0,0,0,0,0,0,0,0,100
8120947b4e0081ae09b5da0fb4732630a6501441,0,0,0,0,0,0,0,0,0,0,0,0,0,0,52,1,0,0,0,0,0,0,0,0,0,100
ac2c1a779b24aca4c6cfacbb854cc35219013cbe,0,0,0,0,0,0,0,0,0,0,0,0,0,0,96,4,0,0,0,0,0,0,0,0,0,100
60789da3b95366a256ae1020241bb9a9ec0817de,3,15,5,10,0,0,0,4,11,284,2,3,1.054015773,795,160,1,95,94,1,7082,6998,84,45,44,1,100
c8b96d339f4d04f6add7cddb5a3e319b762219f5,0,0,0,0,0,0,0,0,0,0,0,0,0,0,97,5,0,0,0,0,0,0,0,0,0,100
3b074d9ceb20d512edb04569d9ae54215b94134d,0,0,0,0,0,0,0,0,0,0,0,0,0,0,161,2,0,0,0,0,0,0,0,0,0,100
5f71cad0d19dfdaff5ddbaf1d9b29ff32ed60f3e,0,0,0,0,0,0,0,0,0,0,0,0,0,0,15,4,0,0,0,0,0,0,0,0,0,100
242733c0b292f729269fe43d26e3189472d04545,0,0,0,0,0,0,0,0,0,0,0,0,0,0,16,5,0,0,0,0,0,0,0,0,0,100
809a99c8a7601b7ede3f6d5da4bfd68d970a38e6,0,0,0,0,0,0,0,0,0,0,0,0,0,0,98,6,0,0,0,0,0,0,0,0,0,100
1927b32b95017ee49629978c85523bd02a0085f9,2,7,0,7,0,0,0,3,21,291,1,1,0.985228136,994,53,2,219,219,0,6883,6829,54,32,32,0,100
b161859ee9edaf5336a632a5455c933e514b2189,1,10,0,10,0,0,0,4,4,140,1,1,0,340,3,0,68,66,2,3590,3496,94,59,57,2,100
dee8a2da438963c4ed535cb3c207165277bb1e4e,2,42,2,40,0,0,0,4,13,426,1,1,1,538,54,3,127,122,5,4717,4313,404,30,30,0,100
6e02ec5b3a97ee2bfaf16ef5e875c14e383d5823,27,3996,2712,1284,11,0,11,7,78,479,1,10,3.428126821,4364,9,1,866,681,185,44183,39229,4954,351,293,58,97.44218641
6ad7a5a86b9877d8f5958d3a6b696b2f07a9282d,0,0,0,0,0,0,0,0,0,0,0,0,0,0,17,5,0,0,0,0,0,0,0,0,0,100
65c6f9c8ed36d77c9a1e673da6e07a066414a1e5,0,0,0,0,0,0,0,0,0,0,0,0,0,0,18,6,0,0,0,0,0,0,0,0,0,100
60c05eb753b0437679de3996e512f7378e4d78f1,0,0,0,0,0,0,0,0,0,0,0,0,0,0,99,6,0,0,0,0,0,0,0,0,0,100
ae23e78369ce765c5353923754374bbd74c1bd47,8,57,19,38,0,0,0,2,2,8,1,1,2.829147205,966,162,3,227,213,14,8204,7961,243,59,59,0,100
729d92386ed833ef743f1cee707a473fffdcf6c0,1,39,23,16,0,0,0,7,16,12,1,1,0,151,5,0,23,19,4,1704,1571,133,8,8,0,100
31eb3664ce8722f4323fa4a5369ebec26959aa1f,3,15,5,10,0,0,0,7,18,78,3,3,1.360964047,314,55,3,72,70,2,2452,2357,95,39,37,2,100
bd39a509a20ff7860fdfdcab67e46cc503038f1e,3,164,106,58,0,0,0,5,68,18,1,3,1.296412286,912,10,1,188,181,7,8399,7997,402,67,66,1,100
59673d48ccbaa224fc6129016ed3235f8ea341c5,1,1,1,0,0,0,0,6,19,216,1,1,0,268,163,3,29,29,0,2993,2993,0,18,18,0,100
45d3872b6d5cb58615894541f3ad7f6aa01480b3,2,33,11,22,0,0,0,8,43,50,1,1,0.632130278,2111,113,0,555,551,4,17922,17813,109,114,113,1,100
c26e9bcd7427dfb0e7b14714d394de7b4667ace2,2,14,8,6,0,0,0,1,8,110,1,2,0.994030211,997,11,2,188,188,0,7807,7759,48,50,50,0,100
14d5a8e6ad7f0dd7edb4f8d95866916abbc6a99d,0,0,0,0,0,0,0,0,0,0,0,0,0,0,19,4,0,0,0,0,0,0,0,0,0,100
67d489530a59e9c55a72621ea0c3a4dfbeac2c8e,3,61,24,37,0,0,0,3,59,341,1,2,1.426410973,1669,114,1,421,412,9,12777,12557,220,133,128,5,100
9931803090d187cb2a92cf88e4d111329121c503,3,307,0,307,3,0,3,1,1,0,1,1,1.322285174,0,34,0,28,0,28,1340,0,1340,21,0,21,98.05672269
0f689faaa5ef6433ecb39d9f0ee8c4cf8a48b8eb,13,315,121,194,0,0,0,9,67,55,4,9,2.541645297,6180,115,2,1497,1461,36,48917,47610,1307,453,447,6,100
295595db4828f4f85977fa809ba53d723d18c668,1,4,2,2,0,0,0,10,45,1,1,1,0,1357,116,3,365,364,1,11580,11569,11,64,64,0,100
9ffaaabaaf692a07ea74f929515659fa425feff8,1,15,2,13,0,0,0,9,52,4,1,1,0,551,56,3,130,128,2,4392,4340,52,27,26,1,100
f42c1d9ff3b8bba53431520845ae371361b7e735,3,69,29,40,0,0,0,2,3,26,1,2,1.363615268,790,164,2,191,181,10,6878,6607,271,61,58,3,100
7f5a665e4d93322511813e58fde6175af27834f2,4,704,521,183,1,0,1,12,63,32,1,3,1.484138466,929,12,2,195,172,23,9341,8215,1126,67,63,4,99.72747093
3ded3ee2f96d4bd44755792436e6c43865821e87,41,2847,135,2712,20,0,20,7,53,176,5,23,4.583795127,5229,35,1,1242,887,355,57242,42695,14547,539,366,173,95.8492003
9368c8a05f34d9bbe4a34cd8aa531bfb36a70a44,3,59,88,29,0,0,0,1,2,0,1,1,1.578801763,231,36,2,29,32,3,1868,2143,275,17,19,2,99.80127186
da8581e90aca74d1b3b04ee2efd5901b87b8d77d,6,541,122,419,3,0,3,3,17,124,2,3,2.162586489,503,0,0,117,85,32,6493,3895,2598,51,34,17,99.62465429
e86fc944edff263c38b17741a68b9966050030af,2,26,1,25,0,0,0,5,6,35,1,2,0.380946586,671,1,0,148,147,1,5787,5605,182,42,41,1,100
519314f0a1911cfd5fc46196e5f031a83c5bb09e,1,6,2,4,0,0,0,3,5,0,1,1,0,621,165,3,147,145,2,5107,5054,53,39,39,0,100
5bccaa64da045bc576d47a1d89ef7c1766128f5f,2,1,13,12,0,0,0,3,9,2,1,2,0.985228136,198,37,3,38,41,3,1223,1316,93,19,19,0,100
a70d73f83e38a76e393ab12ab12553159fd9d729,0,0,0,0,0,0,0,0,0,0,0,0,0,0,20,1,0,0,0,0,0,0,0,0,0,100
354162d4e35a69d870a3394f8cc0162d18130efe,1,3,3,0,0,0,0,6,20,30,1,1,0,542,117,4,147,147,0,3622,3623,1,83,83,0,100
a1fd406821e1178a7937641386684c46d16ce63e,205,48745,6639,42106,46,0,46,1,3,15,4,55,4.607121902,28554,2,0,4914,3098,1816,250172,105887,144285,2700,1938,762,95.78768417
37d7b8b8f72b906cb2c133f9b3d843009c92e408,1,51,10,41,0,0,0,12,64,7,1,1,0,600,13,3,124,112,12,5519,5330,189,44,41,3,100
dc71d3d42fec60c5bd763054591a6c25a1d01862,1,28,0,28,0,0,0,1,2,15,1,1,0,478,14,3,92,83,9,4153,4011,142,29,26,3,100
cd686f6fc97cf2de4fe0c152476444d3544e4dd1,0,0,0,0,0,0,0,0,0,0,0,0,0,0,100,0,0,0,0,0,0,0,0,0,0,100
d093ed399b2728b8f3fb2c07e63e828d3fd5ea68,0,0,0,0,0,0,0,0,0,0,0,0,0,0,38,4,0,0,0,0,0,0,0,0,0,100
8ef6a4364d51597a0f4e0d36f6713291cc3ce733,1,1,1,0,0,0,0,2,2,12,1,1,0,191,39,5,23,23,0,1531,1535,4,10,10,0,100
bc57e15e548af88987ab7d3870aa5ae874c09830,1,30,36,6,0,0,0,6,18,14,1,1,0,570,118,3,144,146,2,4304,4337,33,38,39,1,100
8d1e72234bdf24ba5fef9921dd827823b59884ad,4,37,23,14,0,0,0,3,18,107,1,2,1.602598874,1817,40,5,392,388,4,12838,12721,117,172,169,3,100
0cde9f92136979c58ebb0bc282e9f74a247f4b50,1,5,0,5,0,0,0,5,21,41,1,1,0,459,119,4,123,123,0,3845,3817,28,17,17,0,100
0dcd68906fcdfc9d55069d37800353c497faed7e,2,23,7,16,0,0,0,8,37,234,2,2,0.468995594,902,94,0,229,226,3,7615,7521,94,66,64,2,100
6812a7d577556d6b73bfc2d275bc3736d07ecd0d,0,0,0,0,0,0,0,0,0,0,0,0,0,0,3,1,0,0,0,0,0,0,0,0,0,100
75415862cc2708ee866d2d29ca603a4e6306f408,46,5644,179,5465,21,0,21,1,68,96,4,26,4.192335928,4735,95,1,1940,1068,872,66908,37599,29309,820,459,361,89.23023818
54c31d5c8e601757e19e26d3c30f2414532e2f8f,1,201,201,0,0,0,0,8,21,66,1,1,0,302,6,0,44,43,1,2687,2596,91,18,18,0,100
bf5f8ef05c650f49061d391c5f2606a394370f19,2,1,14,13,0,0,0,2,4,4,1,2,0.566509507,1064,96,2,262,266,4,8366,8455,89,72,72,0,100
15534f235dea3cc5e993b461b8ee72f3efabee55,1,50,17,33,0,0,0,2,2,19,1,1,0,29,41,6,6,1,5,440,252,188,3,1,2,100
71965e31a2d50fcddb04e36fd473cc199baa875f,1,8,12,4,0,0,0,6,7,18,1,1,0,66,3,0,3,3,0,671,733,62,3,3,0,100
8ae61e0f5f66a33f1226913d1782413fb9a0bbae,6,211,36,175,0,0,0,8,69,39,3,5,1.897172874,3047,120,3,756,718,38,25363,24294,1069,242,232,10,98.47204161
96a348a9a0e43112ca90661baf4b29d5af335506,1,22,0,22,0,0,0,8,25,23,1,1,0,380,166,2,98,92,6,3102,2967,135,36,35,1,100
0adfa8f459453b789e55071db2da1758aebd4c0e,1,8,1,7,0,0,0,7,19,8,1,1,0,563,57,0,145,144,1,4340,4304,36,38,38,0,99.88724227
79eed8c23ee123f95b596d3ea93ed607a8c450d5,0,0,0,0,0,0,0,0,0,0,0,0,0,0,21,1,0,0,0,0,0,0,0,0,0,100
b7f623663b2d9299956d1a699b16ea38f965d0ff,0,0,0,0,0,0,0,0,0,0,0,0,0,0,22,2,0,0,0,0,0,0,0,0,0,100
d88223bc1ac62ef29ff4d056ce91aae3215f5ac8,0,0,0,0,0,0,0,0,0,0,0,0,0,0,167,3,0,0,0,0,0,0,0,0,0,100
b1907a332e3cd0eeab0520e1d93cf8605eae4f8c,1,12,8,4,0,0,0,2,3,2,1,1,0,58,42,7,7,6,1,449,440,9,3,3,0,100
7515915f6b52cdfd0f7e5e32a17f6f6cfae6b37d,2,51,14,37,0,0,0,4,8,784,2,2,0.751649946,142,58,1,29,24,5,1038,882,156,10,9,1,100
15967a9309b1fe8ca3645d82abd4749017c5553a,31,1194,156,1038,10,0,10,1,14,0,2,9,4.134894885,2513,43,8,533,460,73,25417,19540,5877,312,247,65,97.14333725
0dad95296daa5ee4ae38904eb211af0165503fb0,15,1483,706,777,3,0,3,1,70,12,4,11,2.719320355,5048,97,3,1273,1123,150,44194,39862,4332,328,308,20,95.28254709
f622751dbbc01aab5f0398bfd65674e9bcb92e72,5,202,3,199,1,0,1,7,71,273,3,4,1.474668408,939,168,3,200,172,28,8150,7072,1078,98,90,8,97.85982683
8063de4ad4d5cc70d15a648080bdc9e5004a1446,7,341,150,191,0,0,0,5,62,49,1,3,2.318307267,4611,121,4,1211,1189,22,38419,36973,1446,287,279,8,100
7f20ffbaf4bad3245a547714a8f355f730363cc1,1,5,4,1,0,0,0,5,17,1,1,1,0,574,122,5,147,145,2,5228,5202,26,29,29,0,100
4ba39dcad7c9d46f9838aa5aa75162cddc5f2b6a,0,0,0,0,0,0,0,0,0,0,0,0,0,0,23,3,0,0,0,0,0,0,0,0,0,100
3709842a0711b9aef51c0c6c6727015c63379931,0,0,0,0,0,0,0,0,0,0,0,0,0,0,101,1,0,0,0,0,0,0,0,0,0,100
19abdf68ea227cb329ed90228d990cee5a5c16c3,0,0,0,0,0,0,0,0,0,0,0,0,0,0,102,2,0,0,0,0,0,0,0,0,0,100
8a3795b8297566fd4429a6522379b0a92aae0a90,2,23,4,19,0,0,0,7,47,74,1,2,0.99107606,1517,44,9,388,383,5,12886,12788,98,88,86,2,100
9a4ca16d77aabdccc4988146f062933249d6d529,6,116,52,64,0,0,0,7,16,163,2,4,1.104419381,1130,45,10,260,245,15,8476,8079,397,85,77,8,100
f57fd7f0f0b5cd5617a897b950030e92b2beb746,182,30407,3897,26510,97,0,97,1,3,0,6,57,5.871402365,47202,4,2,5408,3897,1511,280413,212110,68303,2869,2005,864,93.96804695
710a507de38b4dead7042ac42ec9ef0299ef9959,0,0,0,0,0,0,0,0,0,0,0,0,0,0,123,6,0,0,0,0,0,0,0,0,0,100
fc17b38eef28afef41d9f5bf87130b79eaec3898,1,594,0,594,1,0,1,1,1,0,1,1,0,0,124,7,51,0,51,3733,0,3733,29,0,29,99.81030667
6d999b0aa6ded46d678b5880da05b80e37d4b124,0,0,0,0,0,0,0,0,0,0,0,0,0,0,103,3,0,0,0,0,0,0,0,0,0,100
85aef3c0543632358cb1b01085369bbf31b6404a,0,0,0,0,0,0,0,0,0,0,0,0,0,0,24,4,0,0,0,0,0,0,0,0,0,100
4a938d873d63280d06678596af0a4f6c3f0a8255,7,202,178,24,0,0,0,13,38,246,3,5,1.93144358,876,98,4,161,160,1,6084,5708,376,36,36,0,99.376
cabc1e55059b70cfab49e1ca960d2cdee6a3828f,8,278,138,140,0,0,0,1,72,7,3,5,2.18351609,3596,99,5,757,742,15,29071,28013,1058,200,189,11,100
6c49542b8e95b248c4a4062f13e499e2ebea93bf,2,36,21,15,0,0,0,5,11,29,2,2,0.219297308,165,169,4,47,43,4,1338,1273,65,7,7,0,100
d55405955d58417c263d964238c79c981d7fa9fe,1,1,1,0,0,0,0,9,50,10,1,1,0,717,46,11,185,185,0,5591,5591,0,28,28,0,100
b03c248405b51a905a117ab60ab533c3ce892539,2,19,5,14,0,0,0,5,7,474,1,2,0.811278124,203,59,2,16,15,1,1892,1790,102,12,12,0,100
fa98991998efa9e18628c76a58ed37f6abbf2e99,3,16,9,7,0,0,0,4,48,84,3,3,1.12385619,2028,125,7,446,443,3,17274,17234,40,122,122,0,100
f11c180169b0da1015176126eae6977e9f7cc423,1,6,6,0,0,0,0,5,18,12,1,1,0,574,126,8,147,147,0,5231,5228,3,29,29,0,100
801aea9a8173a4856ce7f812d6790475d99a3b94,2,381,0,381,2,0,2,1,1,0,1,2,0.406970088,0,15,1,46,0,46,2118,0,2118,17,0,17,99.91910694
c76afbe26283a887bbec230c17ba12c54480d36f,12,173,136,37,0,0,0,1,63,117,2,5,2.306152383,4771,100,6,1142,1133,9,36942,36783,159,328,326,2,97.90802213
7b14cfac504e2bd0de3ceae6454894e221ccfb97,12,112,70,42,0,0,0,1,20,26,3,6,2.953688672,1629,47,9,324,312,12,12752,12531,221,153,150,3,100
45bf48e6e549c6f8a377512aa32607021cf927e0,0,0,0,0,0,0,0,0,0,0,0,0,0,0,25,4,0,0,0,0,0,0,0,0,0,100
57c7e85ec126f7f4cb6df0edcd6076dd2266667a,1,18,11,7,0,0,0,6,8,258,1,1,0,548,1,0,121,119,2,4188,4130,58,61,61,0,100
fe1c7a3b48a751c20e51ee7d97c30da84af21b85,1,36,25,11,0,0,0,8,22,39,1,1,0,279,7,1,48,44,4,2739,2687,52,18,18,0,100
db6d783a80c2d85597043fcca0f751091c7d52a1,3,31,1,30,0,0,0,4,7,19,1,3,1.162817587,1024,101,5,161,156,5,8281,8050,231,53,53,0,97.81147682
e6625a6c3af827435a786ba3ce8b6ee03ad7a71c,0,0,0,0,0,0,0,0,0,0,0,0,0,0,16,1,0,0,0,0,0,0,0,0,0,100
620943ed86bf787a3aa5421809276ba2fac689da,1,1,1,0,0,0,0,2,4,1009,1,1,0,42,102,6,11,11,0,299,294,5,4,4,0,100
c9924fdc7bc9717455e8fb484332a24af062c302,0,0,0,0,0,0,0,0,0,0,0,0,0,0,17,2,0,0,0,0,0,0,0,0,0,100
540129f5c39181d347a3f85d85715186c8a8f066,0,0,0,0,0,0,0,0,0,0,0,0,0,0,18,3,0,0,0,0,0,0,0,0,0,100
65f7da17e444dff86ecbcbcab17251b66c067aa2,3,57,14,43,0,0,0,7,19,179,1,2,0.620611413,619,48,7,141,137,4,5069,4769,300,61,56,5,100
30dd2f5b80cab252a217d486558d9384ba3bfeb6,3,119,11,108,0,0,0,7,49,79,1,2,1.542614345,1666,49,7,440,423,17,14626,13983,643,115,107,8,94.71997558
2237a895bb259a10440829bd348460b6eb5b7b59,19,466,261,205,0,0,0,5,50,112,6,10,3.148120641,5992,127,6,1474,1431,43,50816,49399,1417,374,365,9,99.97093868
6d51ddec5b413ec46e45a7fe7e154a4e4db4fb09,0,0,0,0,0,0,0,0,0,0,0,0,0,0,104,3,0,0,0,0,0,0,0,0,0,100
b93c29c39bba308962332a0729494442f3b269f8,5,203,31,172,0,0,0,2,45,180,3,4,1.839972556,1793,128,7,461,426,35,16114,15130,984,142,125,17,100
3f7c5811faa9c9c9b61f9e6760904aeafb221224,1,46,5,41,0,0,0,7,25,35,1,1,0,358,170,2,62,56,6,3021,2782,239,18,18,0,99.98547778
810aceb5dc212ec68b598227677aa9c5683db8e9,1,30,1,29,0,0,0,3,3,108,1,1,0,136,0,0,40,35,5,1316,1165,151,6,5,1,100
5cfb0228eceae7b626c7ff14d9580d5067056274,21,1525,1289,236,0,0,0,1,4,27,2,12,3.363355186,27451,5,1,2377,2349,28,114943,114158,785,818,809,9,98.06263656
b243a3637a460b273d31037cb6f703b2172748dc,2,81,34,47,0,0,0,5,11,36,1,2,0.970950594,275,103,5,43,38,5,2784,2380,404,12,11,1,100
814c1fdb051323fd1c4efaa66c851b3e46b7ef91,0,0,0,0,0,0,0,0,0,0,0,0,0,0,129,6,0,0,0,0,0,0,0,0,0,100
e4205b3b8047ee084419419a6c0b37a3ae9acad3,2,49,19,30,0,0,0,7,51,14,1,2,0.672294817,1650,50,5,416,408,8,14066,13852,214,100,97,3,95.14429684
e7aec3354168de2720f2435bee3febe002cef5f2,1,14,3,11,0,0,0,6,25,14,1,1,0,642,130,7,181,180,1,5464,5399,65,25,25,0,100
20d4f4d8b3089be1922d15a4254ef6ce502cb384,6,718,26,692,2,0,2,1,5,21,1,5,1.67484174,14917,29,0,643,598,45,78339,74577,3762,537,523,14,99.8562989
145ba98979f8e6201b83a19283c91c9484d9fb01,0,0,0,0,0,0,0,0,0,0,0,0,0,0,4,0,0,0,0,0,0,0,0,0,0,100
efe0935eb2affc2358f4298d20b7c3952cdba20c,0,0,0,0,0,0,0,0,0,0,0,0,0,0,5,1,0,0,0,0,0,0,0,0,0,100
b6bbe7d8a57ded52e9116730d10bb2c1453d413e,1,9,1,8,0,0,0,2,4,16,1,1,0,144,131,7,34,32,2,1271,1176,95,12,12,0,100
db0f67667c61337d1d34c8d613bce09d0fe9d584,0,0,0,0,0,0,0,0,0,0,0,0,0,0,132,7,0,0,0,0,0,0,0,0,0,100
d8d9b127042c67e89b04656574badcf9f7800672,18,477,155,322,0,0,0,1,73,40,3,10,3.531815069,4523,104,6,999,958,41,35838,34074,1764,393,382,11,99.98404595
57c0cffae9eb918d5ae851f155585085c100b104,3,0,474,474,0,0,0,6,10,458,1,2,1.022711109,485,51,5,11,32,21,1190,4389,3199,6,24,18,99.85620706
11c540d2495e4d7e241341ad17d6c602d01143f4,1,2,4,2,0,0,0,4,4,511,1,1,0,125,52,6,15,15,0,1400,1410,10,8,8,0,100
7b694adc15a0446b60e740dbef7d65c6420d938a,0,0,0,0,0,0,0,0,0,0,0,0,0,0,105,1,0,0,0,0,0,0,0,0,0,100
e311bdc2a03d4726a303e1c4c2d59b6901b2b469,1,2,2,0,0,0,0,11,74,2,1,1,0,195,133,8,6,6,0,1681,1681,0,4,4,0,100
1e60ca4d98d174e5f000ef9ace38fb32238dd742,4,126,36,90,0,0,0,2,52,42,2,4,1.203126463,2670,53,6,511,502,9,24717,23963,754,142,136,6,100
3a002db4df348393aacbf5d49077ede37a6b1095,4,199,1,198,0,0,0,5,54,130,2,4,1.375082401,1265,8,1,235,221,14,11738,10423,1315,71,64,7,100
08c49867480f189d9518e2d90300a36dbd62b7bc,0,0,0,0,0,0,0,0,0,0,0,0,0,0,106,2,0,0,0,0,0,0,0,0,0,100
4c9d8cba8ce680f7c4f69ad67e56390f33880729,0,0,0,0,0,0,0,0,0,0,0,0,0,0,107,3,0,0,0,0,0,0,0,0,0,100
b7f353b2a458984de30bf8e8cda89427cb524586,0,0,0,0,0,0,0,0,0,0,0,0,0,0,54,7,0,0,0,0,0,0,0,0,0,100
8b65aed037d7df30f96151af459f370d6b166c7f,1,4,4,0,0,0,0,5,5,1522,1,1,0,215,171,1,11,11,0,1656,1636,20,6,6,0,100
effb7537f06883a868734dd4d25ec97410af60be,49,5,8172,8167,0,0,0,2,44,1084,4,17,4.815558592,7564,134,9,410,1377,967,13928,56722,42794,104,547,443,96.14427861
bdf16a5f8fd2daa9084ad0f7b83a9acf414c19fc,0,0,0,0,0,0,0,0,0,0,0,0,0,0,135,10,0,0,0,0,0,0,0,0,0,100
967bf67eb6858c91c97b13e2b1c60caa1d51299c,7,97,33,64,0,0,0,6,64,28,1,3,2.205107341,2772,136,11,719,701,18,22050,21601,449,188,184,4,100
015b8bf38f04fdab91afcafb402a68a1a8ff1230,1,1,1,0,0,0,0,6,28,1,1,1,0,685,137,10,196,196,0,5820,5818,2,27,27,0,100
f29a2b7bb2b555e68d7f5e2b43221f85877aa39c,3,109,5,104,0,0,0,7,26,375,2,3,1.210810026,785,55,8,136,123,13,6350,5824,526,56,48,8,100
1617b6716d66f0876b8c013fddb43abc2c2a91d5,0,0,0,0,0,0,0,0,0,0,0,0,0,0,108,4,0,0,0,0,0,0,0,0,0,100
94d0c0ab21aa139e8c984e7f652f31b141fdbd45,1,2,2,0,0,0,0,1,6,11,1,1,0,761,105,4,182,182,0,5718,5718,0,45,45,0,100
1fc88ce30110729a6a5ad34aaf0c043b5c5969f7,13,43,47,4,0,0,0,7,46,41,3,9,3.010314449,2421,172,2,492,493,1,19168,19211,43,195,193,2,100
880ea4b693d79be6072da5e64153e4c97f21ea02,0,0,0,0,0,0,0,0,0,0,0,0,0,0,173,3,0,0,0,0,0,0,0,0,0,100
bb82e0df3e6aa613b4ded0f6802880f6dfdd4eda,9,6,169,163,0,0,0,10,65,15,3,5,2.685928979,6070,138,11,1468,1494,26,46880,47953,1073,421,427,6,100
c0bf0b8afa08b73f5052f4a78b0964caac065878,1,2,2,0,0,0,0,11,66,0,1,1,0,1329,139,12,334,333,1,9739,9728,11,124,124,0,100
3f9fc5c919afde048e32a9b6fbcfe3f61a0d1346,3,45,20,25,0,0,0,1,75,25,2,3,1.230626728,940,106,5,207,203,4,7311,7153,158,80,78,2,100
9e3af41bf87f4c1b1c6181fd28ac219edbf49883,5,31,14,17,0,0,0,2,76,4,2,2,1.722006708,1790,107,6,411,409,2,14298,14158,140,96,96,0,100
5fed48d969764ae72e8b87c204a2f481cb089716,1,35,12,23,0,0,0,1,5,2,1,1,0,391,108,6,118,107,11,3411,3191,220,23,23,0,100
570f24231b69b119fd79b8481d65e3e122cdc51f,14,256,283,27,0,0,0,2,48,209,3,12,2.643790478,6342,174,4,1032,1027,5,55061,54881,180,407,408,1,98.85875204
a8fab3e77fd9374595b08f72d21a06b6543ba28d,0,0,0,0,0,0,0,0,0,0,0,0,0,0,109,5,0,0,0,0,0,0,0,0,0,100
6e7aa6ed312f381c478c9f5e535a7c86ae80d51e,13,1298,737,561,2,0,2,1,77,65,3,8,2.891412287,7418,140,13,1534,1514,20,66692,62489,4203,475,461,14,99.92740999
479b9ab1c0d461e89d14d2d3426af64f3cb9acb9,1,83,19,64,0,0,0,7,16,536,1,1,0,189,109,6,51,37,14,1452,1097,355,19,16,3,100
f85ff28e05f92e75be3d663dd1a8c1c75f6130dd,0,0,0,0,0,0,0,0,0,0,0,0,0,0,110,5,0,0,0,0,0,0,0,0,0,100
f15995cc8471e498e2a86c3e4790889ccccac84e,2,20,2,18,0,0,0,1,78,4,2,2,0.574635698,612,110,7,129,124,5,5276,5119,157,28,27,1,100
f62ed0926dc5a116729d4cb4d2f6d97fac3e8232,2,117,7,110,0,0,0,2,6,124,1,1,0.756022857,686,19,0,180,161,19,6267,5616,651,50,42,8,100
b7641e74239f8fcd339b8226f0f40f6d69502b69,0,0,0,0,0,0,0,0,0,0,0,0,0,0,6,2,0,0,0,0,0,0,0,0,0,100
cbca591dea186b88f752f4b66b7fb27f06477f7e,10,289,142,147,0,0,0,1,68,19,3,6,2.481740468,6511,141,12,1344,1352,8,55847,54680,1167,387,385,2,99.98549884
3b75d56d9e151f9ad946da0ff1bb081a784703b7,0,0,0,0,0,0,0,0,0,0,0,0,0,0,111,6,0,0,0,0,0,0,0,0,0,100
fccfe919d49ca39d111ade8bb2f2688db5e854e7,1,5,2,3,0,0,0,1,3,107,1,1,0,502,20,1,92,92,0,4181,4153,28,29,29,0,100
f756e9b36fa27ce6a01e081636884106990e936a,0,0,0,0,0,0,0,0,0,0,0,0,0,0,60,0,0,0,0,0,0,0,0,0,0,100
fa712590e929d0c8c3ee7c048687bd1fe4ddd59e,0,0,0,0,0,0,0,0,0,0,0,0,0,0,112,7,0,0,0,0,0,0,0,0,0,100
a6f9b9beda46b388742971ab39e609c18e88e948,2,2,2,0,0,0,0,2,5,36,1,1,1,83,142,10,5,5,0,774,764,10,5,5,0,100
0eaefe38f2c650d098e943dd1614c633f16e7481,1,1,1,0,0,0,0,10,56,3,1,1,0,1292,143,10,352,352,0,10962,10956,6,58,58,0,100
801db28bf772b111b776a0dda0d305344c2eef4d,4,29,26,3,0,0,0,2,51,31,2,3,1.698976449,2230,144,11,503,503,0,19139,19106,33,167,167,0,100
66f8ae16045b79d8839ee2088fc5cc64ffa2fa5d,11,523,250,273,0,0,0,1,79,25,3,5,2.299907393,3830,111,6,820,791,29,30338,28580,1758,273,270,3,96.54698243
f65aeceeb97156ff9e26f1352a6da4100845cb7a,2,4,2,2,0,0,0,2,4,84,1,2,1,319,112,7,60,60,0,2594,2556,38,33,33,0,100
024484407290ad664141c1a8c52012c3e7708c3c,0,0,0,0,0,0,0,0,0,0,0,0,0,0,145,12,0,0,0,0,0,0,0,0,0,100
2ff71e308ed86c44830f9f5dd48bf5450815abc6,2,6,2,4,0,0,0,1,80,0,2,2,0.543564443,947,113,8,184,183,1,7457,7416,41,46,46,0,100
e48a4864ac3a3f52191a0f3c14e4151e31e75665,3,29,1,28,0,0,0,1,81,0,2,3,0.560825177,1705,114,9,285,278,7,13436,13262,174,72,71,1,100
8119492fc6b6475bdb6e09a2e04572c6e185f5f0,2,21,16,5,0,0,0,1,11,0,1,2,0.494182935,1525,115,10,281,279,2,11721,11692,29,68,68,0,100
4d28dc241568010192f55a3d34cb7f7f1f88a9b2,0,0,0,0,0,0,0,0,0,0,0,0,0,0,113,8,0,0,0,0,0,0,0,0,0,100
2798234dfb8e7a6781b28cc1dbb8d3547591e336,2,145,6,139,1,0,1,1,2,39,1,2,0.545883902,263,21,2,54,45,9,2724,2084,640,24,16,8,99.95159729
c2d927e0b1a5fb8203d6fea4ded653060cd8acf3,1,39,24,15,0,0,0,6,32,7,1,1,0,644,146,12,187,186,1,5552,5496,56,28,27,1,100
8f9813307c79ff27113dca6adb3bf47c51a23fc1,1,4,1,3,0,0,0,10,57,5,1,1,0,1292,147,13,352,352,0,10987,10962,25,58,58,0,100
e4ffcf248ee066f0c823bca2a65f00bdc3836411,1,25,6,19,0,0,0,12,27,22,1,1,0,65,2,0,5,1,4,662,547,115,2,1,1,100
6bacbe946bbc5ca72118304770d5ad920695bd52,3,19,0,19,0,0,0,7,26,341,1,3,1.383807735,954,61,1,135,133,2,8271,8189,82,55,54,1,100
9044e0375cea58641b0f54c1732980f1401fd845,4,22,9,13,0,0,0,2,82,11,2,3,1.210908408,1624,116,11,373,371,2,13131,13010,121,77,77,0,100
63a0be2621c3bc77ac879f8545e9bc0f3c53bb89,0,0,0,0,0,0,0,0,0,0,0,0,0,0,114,6,0,0,0,0,0,0,0,0,0,100
4dc6284eb63eb68e3985d1d34542a5ff9818c38b,1,2,2,0,0,0,0,6,33,5,1,1,0,652,117,12,187,187,0,5552,5552,0,28,28,0,100
0b9d7113cb83af04f0c093e428494771b1e895b8,1,5,1,4,0,0,0,2,7,0,1,1,0,197,118,13,52,51,1,1642,1613,29,6,6,0,96.48425558
eaf067bc1bfb5797c0396143995b58f959472a41,2,15,15,0,0,0,0,2,9,68,1,1,0.918295834,252,119,14,67,65,2,1934,1934,0,26,26,0,95.79373734
026595501fc3de37f3993d4bb9c0e52f0f23c8d9,0,0,0,0,0,0,0,0,0,0,0,0,0,0,115,6,0,0,0,0,0,0,0,0,0,100
65338c4ded5fbfe43e7e645b62010b8c4218b8f6,0,0,0,0,0,0,0,0,0,0,0,0,0,0,116,7,0,0,0,0,0,0,0,0,0,100
541c11020c628763b4b2770eb4c1cf0268a783b0,1,0,4,4,0,0,0,6,34,9,1,1,0,652,175,1,187,187,0,5538,5552,14,28,28,0,100
d218fb4f2fe1551f8f9eb5fba69e38e0d25b10dc,0,0,0,0,0,0,0,0,0,0,0,0,0,0,120,12,0,0,0,0,0,0,0,0,0,100
96e5f1cbda1ce2d645cf4159d0f02051005437a9,1,43,22,21,0,0,0,1,13,11,1,1,0,789,121,12,193,189,4,6120,6031,89,43,43,0,100
a0269b9ce8c1ebbe056b786f4bc1e3a522ca0e50,5,35,41,6,0,0,0,6,35,25,1,3,2.082729457,2175,122,13,589,587,2,18487,18756,269,106,105,1,100
47ec9f7a8cc02346ac167849374bf088f55be74a,32,1673,709,964,7,0,7,2,30,52,4,12,4.134396875,3972,56,0,693,553,140,39580,33829,5751,356,289,67,94.28920713
d343a4860df49e767eeefd46ab5fa2b147cc5cd3,9,299,86,213,0,0,0,8,22,87,2,5,2.501168046,2016,148,8,491,447,44,16777,15695,1082,151,139,12,100
2bb7f778443d3a0fdceb4e5bb7a434f1fd3cdc45,1,2,4,2,0,0,0,2,2,0,1,1,0,64,176,1,7,7,0,560,578,18,3,3,0,100
1616b3f9ea5f22968cf195b3327a59be8d26db64,4,7,7,0,0,0,0,2,7,23,1,1,1.842370993,159,177,2,11,11,0,1338,1338,0,10,10,0,100
c950c9bdefc258d83dfbaed2087fb3e3cc062e62,0,0,0,0,0,0,0,0,0,0,0,0,0,0,117,7,0,0,0,0,0,0,0,0,0,100
bcd5bb60732833f000e8e50f1f16b2cf3dbc32c7,5,79,81,2,0,0,0,1,65,169,2,5,1.661020007,1774,123,14,373,373,0,14980,15091,111,114,117,3,100
1deb8c16ec8eca68962eff7f8e4d6dac81fd37aa,13,292,34,258,0,0,0,5,23,34,6,9,3.331143702,3133,149,8,818,768,50,24552,23212,1340,261,247,14,96.58037094
4c121c4dc6a49a93f3946785da917d4691841136,0,0,0,0,0,0,0,0,0,0,0,0,0,0,118,7,0,0,0,0,0,0,0,0,0,100
633f37b68e0f39a06a4de6b8619d56eb18e32fb1,0,0,0,0,0,0,0,0,0,0,0,0,0,0,62,2,0,0,0,0,0,0,0,0,0,100
6820cb7859da7ae4d9583de68e5d2df2eb757442,0,0,0,0,0,0,0,0,0,0,0,0,0,0,150,9,0,0,0,0,0,0,0,0,0,100
85e08c28b460b2439ef2fe06ee6cfb24d2307b2e,0,0,0,0,0,0,0,0,0,0,0,0,0,0,124,13,0,0,0,0,0,0,0,0,0,100
3d5b4880f3e3a35e9c441010096ede729204af43,84,483,484,1,0,0,0,4,69,116,4,27,5.597007236,25663,125,14,5214,4679,535,211629,161041,50588,1589,1806,217,90.87388449
84196cfc5cf9ef18db52caa16ebca8542da89acf,0,0,0,0,0,0,0,0,0,0,0,0,0,0,57,1,0,0,0,0,0,0,0,0,0,100
54f5e16a74ed83e841c0eb573c79ec5a190e3676,13,75,75,0,0,0,0,1,83,16,2,6,3.162263983,4724,126,15,1033,1033,0,36912,36912,0,309,309,0,100
9aca852b0b05d7792b420143f64b29c6418e4034,0,0,0,0,0,0,0,0,0,0,0,0,0,0,178,3,0,0,0,0,0,0,0,0,0,100
5dfbd08ba60cc191da5adc941f2001fb7d68e30f,0,0,0,0,0,0,0,0,0,0,0,0,0,0,0,0,0,0,0,0,0,0,0,0,0,100
76a201708127de1e13d536fe9fba1208dde00ba2,22,686,140,546,5,0,5,1,15,9,2,8,3.533015723,2236,58,2,442,386,56,22653,19235,3418,227,199,28,96.909257
5f503c157cb626b24be99e87648f7efd0d50d2e5,0,0,0,0,0,0,0,0,0,0,0,0,0,0,1,1,0,0,0,0,0,0,0,0,0,100
c2df13c5947787f8642c03a1ac3b3d35749adb78,0,0,0,0,0,0,0,0,0,0,0,0,0,0,179,4,0,0,0,0,0,0,0,0,0,100
82bf78ccacfe10e11b191f225bd184872820b455,0,0,0,0,0,0,0,0,0,0,0,0,0,0,2,2,0,0,0,0,0,0,0,0,0,100
bb2e57379bd7bfefbecca3b81c72552a49ed1f69,0,0,0,0,0,0,0,0,0,0,0,0,0,0,180,5,0,0,0,0,0,0,0,0,0,100
f1bfe5644e18ffb54571de3603fc580491a14dd2,6,107,37,70,0,0,0,2,47,74,2,4,2.175087113,1642,181,6,383,374,9,13766,13337,429,103,102,1,100
cb2e23b649f2449b19be5c0e7cb5e00452fc9fd6,0,0,0,0,0,0,0,0,0,0,0,0,0,0,182,7,0,0,0,0,0,0,0,0,0,100
69ea3348670e4f1710dc3661fa24ba072ac272ba,1,2,0,2,0,0,0,1,3,12,1,1,0,332,59,3,79,79,0,2654,2631,23,28,28,0,100
72cc566a7f23bef86c00afb6c7ef136c1d01b424,9,87,15,72,0,0,0,2,70,47,3,6,2.665527306,5708,11,0,1471,1459,12,46087,45761,326,484,479,5,100
52d5e474214041993db50818a8fb3609adf486fb,0,0,0,0,0,0,0,0,0,0,0,0,0,0,119,5,0,0,0,0,0,0,0,0,0,100
92f3a91ec56538305043ba0980d3f7a8b477ec96,2,35,1,34,0,0,0,3,19,20,1,1,0.88797632,620,183,8,176,170,6,4862,4565,297,38,38,0,100
870259f42a21a15e48d225f16836fc2e8c30883e,0,0,0,0,0,0,0,0,0,0,0,0,0,0,184,9,0,0,0,0,0,0,0,0,0,100
c8058eee21d05303b7db061d462d669b7ada416b,0,0,0,0,0,0,0,0,0,0,0,0,0,0,185,10,0,0,0,0,0,0,0,0,0,100
78a3cd0a27b36d9fcfc6adbe7e9e5cbf4a92975b,0,0,0,0,0,0,0,0,0,0,0,0,0,0,186,11,0,0,0,0,0,0,0,0,0,100
c1f56324c34cf77e8a311577e4c1ed3b77164f80,0,0,0,0,0,0,0,0,0,0,0,0,0,0,187,12,0,0,0,0,0,0,0,0,0,100
86af9e3b79a261332f6fd6ec47d464e71ffc3ffe,0,0,0,0,0,0,0,0,0,0,0,0,0,0,188,12,0,0,0,0,0,0,0,0,0,100
e73a80998ee39aab54eee637aee7ccb99e4156c1,4,124,3,121,0,0,0,2,84,287,2,4,1.186317662,1267,63,1,271,246,25,10915,10158,757,77,74,3,97.94918886
b57420cd0f4af242caed81d8b69c2438794f1fd9,0,0,0,0,0,0,0,0,0,0,0,0,0,0,0,0,0,0,0,0,0,0,0,0,0,100
f93da20b3fc8a4853c4c7d991cac375cb3a6ad6a,0,0,0,0,0,0,0,0,0,0,0,0,0,0,22,0,0,0,0,0,0,0,0,0,0,100
595c87808a737374236bc63e0e5ed3c907969f7d,1,1,1,0,0,0,0,3,9,212,1,1,0,61,151,3,5,5,0,313,313,0,3,3,0,100
ef4044273b28855d1fcd2e67afb50d5dc3c7be34,1,6,6,0,0,0,0,3,19,171,1,1,0,450,152,4,112,112,0,2779,2779,0,48,48,0,100
ecc4e4d2ed6442c16fba9598ef2a733113dc247d,0,0,0,0,0,0,0,0,0,0,0,0,0,0,1,1,0,0,0,0,0,0,0,0,0,100
7a1d3dc5e315d5c82a58bdc67533e7deb324db07,3,29,44,15,0,0,0,1,17,42,1,1,1.015287564,1728,127,0,440,444,4,13838,13941,103,91,91,0,99.98561979
9e762c095f00e0d281ebc6f47b951856f3c097b8,3,93,2,91,0,0,0,4,85,9,1,3,0.89523549,808,64,1,146,141,5,7152,6569,583,52,50,2,100
7174257bf131f531a5f86ccb574ddb512af69623,4,32,28,4,0,0,0,1,4,39,2,3,1.063337679,752,60,2,132,133,1,7036,6998,38,56,54,2,98.68537666
ce5ffeb710721b78135e8b3c3ebe593bd70d2cdf,1,25,17,8,0,0,0,2,2,46,1,1,0,215,12,1,52,52,0,1875,1813,62,14,14,0,100
fff94633dcd4b80f903fdee0fb86ef021bbb5f5a,1,22,3,19,0,0,0,8,22,111,1,1,0,187,153,2,33,29,4,1472,1393,79,18,17,1,100
cbc4b8a3fea2529c79f3a6addd273feae6c41433,0,0,0,0,0,0,0,0,0,0,0,0,0,0,2,2,0,0,0,0,0,0,0,0,0,100
d7b4d5852afd7279b9fd3d1ce5aba073680b909b,0,0,0,0,0,0,0,0,0,0,0,0,0,0,3,3,0,0,0,0,0,0,0,0,0,100
399468e6d758550d1af1ad329e9a2bc38a8b17b3,0,0,0,0,0,0,0,0,0,0,0,0,0,0,0,0,0,0,0,0,0,0,0,0,0,100
75da039043f61c33330686e362de5c8c35996906,1,10,3,7,0,0,0,2,2,261,1,1,0,61,189,5,11,10,1,571,542,29,2,2,0,100
f787bcc2b00224db35667d77de77d1f7b220631d,0,0,0,0,0,0,0,0,0,0,0,0,0,0,3,0,0,0,0,0,0,0,0,0,0,100
88ac0fa62186a59ed08a950385c5a1e3c84e517e,2,64,17,47,0,0,0,2,8,100,1,1,0.167026804,773,190,1,186,180,6,6588,6243,345,51,50,1,100
f3f4fbfa4e869424560193a26709c8c6beafbedf,2,22,8,14,0,0,0,3,4,139,2,2,0.881290899,926,4,2,218,215,3,7902,7803,99,70,68,2,100
f37f3de7531d6ea3dcb4a5853ae7d12b5dfd8237,1,2,0,2,0,0,0,14,39,194,1,1,0,358,5,3,50,50,0,2634,2608,26,15,15,0,100
80f556a704ee21b78598e87de36777f03ebe7368,1,4,0,4,0,0,0,3,4,166,1,1,0,159,191,2,41,40,1,1329,1316,13,6,6,0,100
eb895a62fde263ecf84da3a476594ca75a23022b,8,186,3,183,1,0,1,3,52,165,2,5,2.496768226,2475,192,3,657,624,33,19781,18907,874,138,125,13,96.86261559
bae327559d12f94b617e7321c7e334152e5388ce,0,0,0,0,0,0,0,0,0,0,0,0,0,0,6,3,0,0,0,0,0,0,0,0,0,100
78cfd718444e81426334ef2e3fdae9b467e60cd1,1,67,3,64,0,0,0,3,5,193,1,1,0,42,154,0,23,11,12,611,299,312,8,4,4,99.96380746
eb22be8c36769d88c7ec342bf7f6195849dc13b2,1,24,9,15,0,0,0,2,2,113,1,1,0,373,193,3,100,98,2,2743,2685,58,21,21,0,100
25bae4fe321194d27d205aa01ac49ab7a014013c,1,12,5,7,0,0,0,10,24,376,1,1,0,209,155,1,25,23,2,1436,1405,31,19,19,0,100
74dc605d453697c3830a726498eff3232dbba60f,0,0,0,0,0,0,0,0,0,0,0,0,0,0,7,3,0,0,0,0,0,0,0,0,0,100
15388229741b19c4567527da11bbb1daf2f9399f,5,73,26,47,0,0,0,3,19,133,2,2,1.961369887,1007,156,2,234,222,12,8416,7872,544,81,81,0,100
a2c26bfc2dd46e7fe6666231eabaed8976a916ab,0,0,0,0,0,0,0,0,0,0,0,0,0,0,8,4,0,0,0,0,0,0,0,0,0,100
9d4678e41502c23abb3ad1d5e2cd0c9760679034,3,48,4,44,0,0,0,3,17,150,1,1,1.195621782,863,157,3,248,238,10,6531,6247,284,96,96,0,100
cc629d7091468d1857c4ebbbf70a5b7a00d6ff36,0,0,0,0,0,0,0,0,0,0,0,0,0,0,9,4,0,0,0,0,0,0,0,0,0,100
ec396b931b21df05ce52d4b323370ac9e64b426b,2,57,18,39,0,0,0,2,3,548,2,2,0.447499255,146,128,0,33,24,9,1265,1056,209,13,11,2,100
59ae59dbaf8ce4a35886d5a9e5af7020666b1763,1,7,0,7,0,0,0,3,3,14,1,1,0,383,158,4,101,100,1,2765,2743,22,21,21,0,100
12ca5c97aa3d8ef0b35fb32e4f7f44cedaf1d620,1,24,2,22,0,0,0,12,66,143,1,1,0,631,23,0,131,124,7,5632,5508,124,45,44,1,100
89fc835764c28e2f1e6e60ec9337e175bc0c0707,1,10,4,6,0,0,0,3,5,1733,1,1,0,131,129,1,31,31,0,904,879,25,17,17,0,100
d1b3f21c1c788c00edb75d7b092d08aeb936876c,0,0,0,0,0,0,0,0,0,0,0,0,0,0,1,0,0,0,0,0,0,0,0,0,0,100
50c3adf1519cb3d4d01ea86c2e90e1bba4df3c46,1,2,0,2,0,0,0,6,9,283,1,1,0,554,194,0,121,121,0,4214,4188,26,61,61,0,100
b02238491e451bda71e399725ea4a4d021ec766f,2,18,5,13,0,0,0,3,10,38,2,2,0.666578358,610,195,1,134,131,3,4612,4548,64,68,66,2,100
a7119179e7972b799b476b1866e3fe23f64be42e,4,20,22,2,0,0,0,2,9,512,2,3,1.719025657,1012,13,0,228,229,1,7356,7385,29,122,124,2,100
d5ecfee50037cbfccaf7ad708af7f73902600887,2,20,5,15,0,0,0,3,10,38,2,2,0.795040279,608,14,1,134,131,3,4612,4522,90,68,66,2,100
da967ea8be923102c3485a4cbf55c958f57e23fd,10,431,61,370,1,0,1,3,6,255,2,3,2.838921616,1432,65,0,443,373,70,13161,11233,1928,173,131,42,99.9276411
651ecd9e857660801e16edc1bea80109a671a378,0,0,0,0,0,0,0,0,0,0,0,0,0,0,24,0,0,0,0,0,0,0,0,0,0,100
fbb244c2e4feb90949c7e3c1cbbf4bd2fe729a68,7,342,179,163,0,0,0,6,37,213,3,5,2.316476099,2918,10,0,643,617,26,24441,23858,583,204,191,13,100
68b47923e2567bd1451fb5b05a559bd8080c697c,442,0,138022,138022,0,0,0,2,6,132,6,80,7.05011249,83503,15,2,0,7400,7400,0,355429,355429,0,4288,4288,71.53439153
7bf4bf4902b72b42ed4ee22da43890e7cee2a85a,0,0,0,0,0,0,0,0,0,0,0,0,0,0,66,1,0,0,0,0,0,0,0,0,0,100
e8a777807bebe6e35bbbbd67285408f6533dd024,0,0,0,0,0,0,0,0,0,0,0,0,0,0,61,0,0,0,0,0,0,0,0,0,0,100
42d801f756da0c3ff1bd4c433a15ff28373b9ea7,2,6,0,6,0,0,0,3,6,2,1,1,0.918295834,1463,130,0,343,343,0,11909,11894,15,91,91,0,100
2f5eac0b234bbbba14c42880eeb10090067b5541,1,14,0,14,0,0,0,4,6,2,1,1,0,591,131,1,139,137,2,4646,4507,139,31,31,0,100
e0ac86961146af217696493f170b4b20836cd6ce,0,0,0,0,0,0,0,0,0,0,0,0,0,0,159,0,0,0,0,0,0,0,0,0,0,100
54d623c31f5d3fb8ff40b6ef8f25b99449aecb63,16,309,88,221,0,0,0,6,86,155,4,11,2.922280037,8015,160,1,1678,1638,40,69180,67886,1294,471,454,17,100
4c901bd07e6dae969b152f885ff2d6211c4b3e84,1,49,5,44,0,0,0,11,32,8,1,1,0,477,132,2,82,76,6,3862,3544,318,26,25,1,99.36012286
1099f1ba1169ce670fbdcf29803f8169f2ca9df4,0,0,0,0,0,0,0,0,0,0,0,0,0,0,11,1,0,0,0,0,0,0,0,0,0,100
4ddceacb0dc4add848a97a445a3091624aaaff7e,1,12,17,5,0,0,0,5,11,240,1,1,0,349,133,3,66,66,0,2616,2667,51,45,45,0,100
f022990949e60e3b82e867bfc3845b3bb80859ca,0,0,0,0,0,0,0,0,0,0,0,0,0,0,62,1,0,0,0,0,0,0,0,0,0,100
bc093ca893eea6a84fceba1588fa48842cbe69e5,8,121,13,108,0,0,0,4,72,50,4,6,2.340381604,5525,161,2,1284,1270,14,46028,45437,591,388,383,5,100
1179aff80497d971b578b1b143789b2bb8c869a2,0,0,0,0,0,0,0,0,0,0,0,0,0,0,134,4,0,0,0,0,0,0,0,0,0,100
52ef9e7f3962da2bf77a15ab1a1bcef8d47b2877,7,184,405,221,0,0,0,3,69,572,2,7,1.886827116,1728,196,0,311,332,21,12359,13529,1170,92,97,5,99.71715094
24830e6bc8624ae6d4abbe4f9037f0de8ad57cd0,2,27,16,11,0,0,0,5,9,125,1,2,0.820363643,1051,0,0,249,247,2,8951,8904,47,70,69,1,100
5332f2e591d45c5e37492e7b4a441a0578446069,6,77,44,33,0,0,0,4,38,88,3,3,2.388733796,1657,197,1,478,463,15,13460,13199,261,154,151,3,100
02ec8b99199569676f69ee1f723ab137307e03b4,1,150,0,150,1,0,1,1,1,0,1,1,0,0,67,2,15,0,15,699,0,699,4,0,4,99.63814939
5b9348f9e9b150592c2a7e41079700672fd53b06,0,0,0,0,0,0,0,0,0,0,0,0,0,0,12,2,0,0,0,0,0,0,0,0,0,100
064c5767c8436cd9c16446f7ae7bbb1e6ca1d082,0,0,0,0,0,0,0,0,0,0,0,0,0,0,120,0,0,0,0,0,0,0,0,0,0,100
69fe4ab73bcab9ee118f1575ee476dd55fb44319,1,24,23,1,0,0,0,3,5,6,1,1,0,1342,135,5,370,366,4,11262,11412,150,61,61,0,100
5b406348cb51a871fdf388f676c68102f647afac,5,50,10,40,0,0,0,5,73,48,3,4,1.533775616,4284,16,1,1099,1093,6,33870,33672,198,348,345,3,100
27e8b2a40c718314aa0d8f114f5f7170e6c2a2dc,1,12,1,11,0,0,0,5,12,260,1,1,0,161,136,6,31,29,2,1194,1114,80,12,12,0,100
4b2324f360b212d7495ce72e1b24075d04d05f6b,2,28,16,12,0,0,0,3,74,12,1,2,0.684038436,2754,162,3,733,730,3,21845,21769,76,198,197,1,100
a7cd9ac38dd5dcd105a7d5a28c50e851ee0d29a0,1,2,2,0,0,0,0,8,23,19,1,1,0,207,198,2,35,35,0,1401,1396,5,13,13,0,100
be05196b317227d7032cd7295060ca1985056acc,0,0,0,0,0,0,0,0,0,0,0,0,0,0,13,2,0,0,0,0,0,0,0,0,0,100
36080c33790c3d363212c374d4e6e88c5c1cf98f,0,0,0,0,0,0,0,0,0,0,0,0,0,0,137,7,0,0,0,0,0,0,0,0,0,100
35561d4ec0c92b5976b0cd4b241962833c96587b,1,3,0,3,0,0,0,6,39,23,1,1,0,660,163,4,196,196,0,5495,5490,5,29,29,0,100
70e10cc049f82243be0a3ace452c19b42476af6c,1,6,0,6,0,0,0,7,21,369,1,1,0,567,138,7,145,144,1,4335,4310,25,38,38,0,100
b6a664df305d18918ea84ec1351307fcefeec53c,15,239,188,51,0,0,0,5,75,142,3,5,2.962080719,7967,164,3,2038,2026,12,65344,64852,492,531,524,7,100
0ed9f0e25d2b064bb7728b2d8481968ba4375ba2,5,43,45,2,0,0,0,2,76,52,2,3,1.98547162,3518,165,4,913,916,3,27189,27179,10,305,306,1,100
9c45d2e8e88b8845330632ad2a164448c13840fd,5,33,139,106,0,0,0,2,77,112,1,3,1.45651404,3845,199,3,949,971,22,30507,30979,472,268,274,6,100
b9637b9a87376353c821606b5d3894a0fc1c7993,2,11,2,9,0,0,0,6,78,3,1,2,0.89049164,2012,166,5,535,532,3,15592,15541,51,160,159,1,100
6de9428f447b669d44874a951faa9081bb4b3fda,1,2,2,0,0,0,0,6,42,0,1,1,0,665,167,6,198,198,0,5531,5528,3,29,29,0,100
37c753bdde22b6d9307855a13ad79d8deeece936,0,0,0,0,0,0,0,0,0,0,0,0,0,0,121,1,0,0,0,0,0,0,0,0,0,100
65d42c16fa910bb0d98a743937d823821b5baf99,1,2,2,0,0,0,0,6,43,1,1,1,0,665,168,7,198,198,0,5528,5531,3,29,29,0,100
b14736c907b63905b51153b241f5a8262be1f94a,0,0,0,0,0,0,0,0,0,0,0,0,0,0,122,2,0,0,0,0,0,0,0,0,0,100
f86603a8a93dea35bd22bdd1824db8cd7feb50c1,1,1,1,0,0,0,0,4,4,552,1,1,0,174,0,0,35,35,0,1279,1279,0,12,12,0,100
3654f9fc36dee5355b7aa46d07adaef0abcc4f4f,1,4,1,3,0,0,0,3,19,171,1,1,0,248,169,7,39,39,0,2289,2243,46,3,3,0,100
01b195a9607d0134bb114ab5427097ccb5dd56ef,1,1,1,0,0,0,0,11,87,60,1,1,0,208,63,0,6,6,0,1798,1798,0,4,4,0,100
56eefb2a9806265df997dda2ef70274eede72675,4,165,45,120,1,0,1,5,14,152,2,2,1.518466902,699,200,2,188,173,15,5964,5440,524,56,47,9,99.84435798
96f2c2996e6e3ccfd26e0297be5f29640a2ec781,2,17,2,15,0,0,0,3,9,172,2,2,0.485460761,289,201,3,66,63,3,2397,2306,91,32,29,3,100
f31a7c6310c68a76916cea0e1dc735f5bfb4e305,1,1,0,1,0,0,0,14,40,224,1,1,0,360,68,0,50,50,0,2650,2634,16,15,15,0,100
5496b7af9aa1a106f475457181d4fdc355b64e0b,1,1,1,0,0,0,0,4,7,76,1,1,0,31,0,0,5,5,0,234,234,0,3,3,0,100
4c6f1d167e4b41dab62f2f0fa9e153e6ceac8621,5,53,9,44,0,0,0,8,28,367,4,3,1.509312273,2030,202,3,514,505,9,16280,16057,223,119,115,4,100
eae9761871af9aeecc0fdc2248b7c8555407d0a6,5,46,33,13,0,0,0,8,29,79,3,3,1.649009349,2595,203,4,650,642,8,20641,20450,191,145,141,4,91.7270195
3176d1a1e4eab9916b7fa0498d8c5a99a7a1382d,4,18,9,9,0,0,0,4,11,475,3,4,1.682500341,1157,64,0,213,212,1,8645,8618,27,96,95,1,100
48e522497f960ac9cc54853c3cb0e9af3e0111f3,1,17,14,3,0,0,0,8,30,34,1,1,0,494,204,2,83,83,0,3440,3432,8,23,23,0,100
a064e09242a0b1259d7b1227913786d2fb98f695,6,90,38,52,0,0,0,5,18,147,2,5,2.29905253,2733,205,3,741,734,7,22089,21913,176,162,158,4,100
ece78ba0933e9f868647689a888b3080568d015c,2,111,63,48,0,0,0,12,70,320,1,1,0.841629523,258,206,2,96,90,6,2123,1883,240,31,27,4,100
4128f5d2aa1462b5462a94886fbd26c24cbb5a91,1,38,14,24,0,0,0,3,4,419,1,1,0,298,170,0,51,46,5,2631,2549,82,12,11,1,100
d5f46e3f51753dfd85ddc76ffb6f227eb83285fc,5,155,5,150,0,0,0,8,71,270,3,4,1.609856211,1026,207,3,269,239,30,8263,7449,814,73,67,6,100
8cc12be185d388798a9de4e1d798e69de9795374,5,60,35,25,0,0,0,6,88,322,2,3,1.131211642,636,171,1,110,105,5,4599,4390,209,17,17,0,100
7f3da2c9e01a3946f91a42bfdf2fea3e4fb785e5,2,20,7,13,0,0,0,7,21,220,2,2,0.918295834,601,208,2,116,115,1,4739,4680,59,37,36,1,100
5a96f057c594a7362923bc92f40c24c935dae548,0,0,0,0,0,0,0,0,0,0,0,0,0,0,1,0,0,0,0,0,0,0,0,0,0,100
6d0c5c8c7162f720aabe4c57e1d4bbaf8ddb4d9a,4,90,2,88,0,0,0,2,24,1128,1,2,1.896845929,618,65,0,116,103,13,5705,5075,630,69,62,7,100
871f02bb3f1d5e74788066fc0bb6644eff2ef0c2,7,462,9,453,4,0,4,7,16,182,2,6,2.409054877,395,66,1,118,70,48,6127,3653,2474,70,33,37,94.39704209
06ff0752f8ea447b4c1f04a1461f6cd61b758b90,15,528,18,510,4,0,4,7,41,210,3,8,2.636018538,1024,67,2,171,123,48,11299,8479,2820,99,58,41,99.62546816
41997f648b27aa523bcf6c30b2184041e02898b4,2,153,4,149,1,0,1,1,12,31,2,2,0.995048585,557,68,3,137,121,16,5178,4225,953,70,61,9,93.601359
90958e83d93a59eb71eb633b5625960f04b9402e,15,301,39,262,2,0,2,7,42,191,3,7,3.054944231,2314,69,4,419,398,21,19884,18362,1522,225,211,14,93.63274588
1d8b81d88f48d1ddc3362784353a885c95c89b76,1,2,0,2,0,0,0,5,13,61,1,1,0,1357,70,5,374,374,0,11377,11367,10,61,61,0,100
831ad014210484341a9bdea0c26a2e066586e988,13,552,188,364,3,0,3,14,43,10,3,6,2.625467463,1828,71,6,381,338,43,17264,15072,2192,154,131,23,92.75479859
4ff572815318772be6842ec93331f07c7e006bbd,10,445,90,355,3,0,3,7,16,140,2,4,2.552342248,1253,72,7,310,260,50,12498,10433,2065,128,109,19,91.2404468
b37154f87cebd630060760df1042a80489255020,4,10,9,1,0,0,0,2,17,0,1,2,1.400258233,488,139,0,93,92,1,4359,4353,6,43,43,0,100
a2397c152af066a2769b84bd3225661cadbf405f,7,291,23,268,1,0,1,7,18,0,2,3,1.598092264,1278,73,8,321,287,34,12160,10529,1631,143,125,18,89.01238488
21fcc7e12b954680c95e5685d1646a7fd16f9dbe,0,0,0,0,0,0,0,0,0,0,0,0,0,0,25,0,0,0,0,0,0,0,0,0,0,100
ab2043a8005f6b4048f825bdae75a140c17d6a3e,0,0,0,0,0,0,0,0,0,0,0,0,0,0,14,0,0,0,0,0,0,0,0,0,0,100
44763bf9d29772a4ffde5e8e8b1850b719c87e81,6,396,48,348,1,0,1,1,22,191,2,3,1.889874036,3249,74,9,897,842,55,28908,26755,2153,250,231,19,94.17502032
c8439f4c3d45caac0232765267c224fcfa694faa,0,0,0,0,0,0,0,0,0,0,0,0,0,0,75,10,0,0,0,0,0,0,0,0,0,100
561cdc91ad0b721e0fae2900d6c621ddcfeab156,2,2,2,0,0,0,0,1,3,1,1,2,1,233,76,11,16,16,0,2209,2204,5,15,15,0,100
03f2754d158e445faafe253bf232057a0c591c82,24,811,269,542,0,0,0,1,44,101,4,8,3.885243246,6197,77,12,1394,1313,81,52887,49890,2997,536,497,39,98.09616793
ca33b1bf9805ea72f13ce86d92a90b7b4dbe14a9,1,2,2,0,0,0,0,1,3,0,1,1,0,85,78,13,9,9,0,698,700,2,7,7,0,100
0c3080152d64062306349cc5007daf4d09d8b8b4,9,351,58,293,2,0,2,2,27,92,1,4,2.66087074,1299,79,14,270,230,40,11663,10125,1538,147,129,18,99.89919355
c0a91c7e1859c62b6fcb7eced5aed9679df12323,4,134,90,44,0,0,0,1,14,1,3,4,1.135191957,1029,80,15,206,199,7,8355,8118,237,109,104,5,100
116fb62c9a26efeff389d280f26e3c172ef98cf8,15,282,240,42,0,0,0,1,45,0,5,9,3.204378118,2382,81,16,363,319,44,19002,19014,12,208,185,23,99.59697733
708e4865ca51dd11bc8163c81a730773b5f84cb0,2,47,1,46,0,0,0,5,16,126,2,2,0.896038233,831,209,2,83,77,6,8392,8158,234,53,49,4,100
8903c9a642001b8aa75e744c741415beb735f241,10,98,112,14,0,0,0,2,19,270,2,3,2.135066954,1770,82,17,339,342,3,13555,13743,188,184,188,4,100
b08b7b49a23db9c60ccb7f1bfe657c5ffdb12f6d,4,98,9,89,0,0,0,2,16,0,1,2,1.495720401,684,83,18,160,141,19,5930,5275,655,66,61,5,99.03943377
c6466004619f4e84a2940b0e55022f888fa030b2,3,221,3,218,2,0,2,1,20,0,1,2,1.209471826,611,84,19,172,153,19,6205,5026,1179,60,47,13,99.87338567
dc6be8e29353d454732f571a0d410b7871eaff4b,6,354,94,260,2,0,2,1,21,1,2,4,1.957423173,853,85,20,228,198,30,8120,6789,1331,91,74,17,99.8989899
8746b306358637c2a81bb66a8c0d8d82b031286d,13,1816,1,1815,12,0,12,3,5,0,2,4,3.426131969,310,172,1,372,92,280,10521,2026,8495,139,29,110,94.91803279
4b3c078c0efe41d8a5a3fe073bd24c87622a409a,3,89,13,76,0,0,0,4,17,141,2,2,1.0696165,413,173,2,105,86,19,3470,3029,441,51,46,5,100
afa314cb520774e6417339f3180d292a6b0c13d6,4,147,0,147,0,0,0,1,2,0,1,2,1.393737304,616,174,3,165,141,24,5499,4644,855,61,53,8,100
9d4f972892cc4248e4e1b0cb5f2933806a4e0fbc,9,426,76,350,2,0,2,4,18,0,2,3,2.785851688,1174,86,21,323,270,53,10534,8843,1691,130,107,23,99.7332543
31c3bea1316d49fe233a061965cef248a97f1168,13,474,382,92,1,0,1,3,4,0,1,2,3.188769884,1503,210,3,354,349,5,11240,10525,715,133,133,0,99.61606615
8639ada6a74cdaa32b0b493aaff1168733487eef,5,40,24,16,0,0,0,1,6,0,2,3,1.320031873,616,87,22,106,103,3,4754,4669,85,52,51,1,100
b04c5bd28c9a1685d42bd2294478ab0f350ac608,1,10,28,18,0,0,0,1,7,0,1,1,0,161,88,23,22,27,5,1084,1158,74,13,15,2,100
f4dac18468b94f56fbe482853982d064fc561cd2,4,76,0,76,0,0,0,11,33,585,3,4,1.755606214,1584,89,24,290,280,10,12173,11748,425,93,90,3,96.90777091
84c6fb2bc3c6ec68315ed522027a566bfed8f678,3,29,8,21,0,0,0,1,10,0,2,3,1.557148965,401,90,25,63,57,6,3239,3101,138,34,33,1,100
5fe6d8306da60bc20dbd8c6e51a9040ea32e9ebb,5,40,20,20,0,0,0,2,89,292,2,3,1.877098247,1191,91,26,200,196,4,9848,9710,138,119,117,2,100
678714134342f749465c61ec70a4c3ba672e7379,1,1,1,0,0,0,0,2,7,0,1,1,0,136,92,27,20,20,0,1174,1167,7,14,14,0,100
6f74720332d1dfb98c2b3da79516a17a37b5db1c,2,6,12,6,0,0,0,1,9,0,1,1,0.764204507,273,93,28,47,48,1,1954,1980,26,22,23,1,100
f6acb086146976ea2a63d93648be8a39d7acbc53,4,18,14,4,0,0,0,3,29,45,1,2,1.64939747,1310,94,29,160,160,0,11127,11115,12,117,117,0,100
7763fd0d329e5995ff9dc4c1f7bf73099eb85c27,4,37,22,15,0,0,0,14,46,0,2,3,1.681629364,1262,95,30,223,218,5,9884,9791,93,104,103,1,100
8a26c79e2f9ecfc14052c0954cb6e66308af09c6,2,9,1,8,0,0,0,2,3,0,1,1,0.468995594,119,96,31,28,26,2,834,809,25,9,9,0,100
016eaffae5518b86bba7bfdda4fc720749362a93,2,8,5,3,0,0,0,4,13,0,1,1,0.391243564,347,97,32,79,78,1,2320,2310,10,39,39,0,100
7ffbec1a2a16f5288fff27d5bb81254d3280a900,1,4,11,7,0,0,0,7,18,0,1,1,0,314,98,33,36,36,0,2487,2528,41,27,27,0,100
1eb995434cb00d228eb403f47799fadc8dd58c08,4,9,11,2,0,0,0,6,19,104,2,4,1.814979821,1013,99,34,214,213,1,7674,7676,2,107,106,1,100
614415e0a7941e70cc4211ed2213b19057f02ec7,1,8,3,5,0,0,0,1,5,0,1,1,0,114,100,35,23,22,1,845,832,13,10,10,0,100
ab801ff27101c80a553e58a1209b14b492b7435f,0,0,0,0,0,0,0,0,0,0,0,0,0,0,175,4,0,0,0,0,0,0,0,0,0,100
2036751244aa2c0c79275022e7f0a32c3206a617,1,1,1,0,0,0,0,3,6,31,1,1,0,181,211,4,49,48,1,1485,1477,8,6,6,0,100
e9869cfe669e39962dd52061004689562e7af082,2,0,2,2,0,0,0,7,15,3,1,2,1,1061,101,36,244,244,0,8571,8593,22,76,76,0,100
105d6b7f8e03ff5cc7d1c7c62baa352f856cf8d4,0,0,0,0,0,0,0,0,0,0,0,0,0,0,15,1,0,0,0,0,0,0,0,0,0,100
82e04037220a82ab985928221bc72ade80fc3be2,3,17,26,9,0,0,0,8,72,22,2,3,1.191464644,949,212,5,205,211,6,6786,6808,22,48,48,0,100
9e9f024b4cda210d407bbde43071546d31ca969b,0,0,0,0,0,0,0,0,0,0,0,0,0,0,123,0,0,0,0,0,0,0,0,0,0,100
a98d1bf0b3c6a354535dc4900869bcb1b2dd90ca,2,1233,6,1227,1,0,1,1,13,82,1,2,0.228959508,172,176,5,296,31,265,10378,1194,9184,52,12,40,99.60639606
85a01e180528ab18b31f633aa27932cf748e6ef9,1,0,4,4,0,0,0,1,2,0,1,1,0,1011,177,6,263,263,0,8938,8938,0,39,39,0,100
3b2924096c1349da4ca1a942f4c136499ac2f110,0,0,0,0,0,0,0,0,0,0,0,0,0,0,69,0,0,0,0,0,0,0,0,0,0,100
c6aaef08efbbcf97c49ac08d85560b5798e16ae0,4,29,11,18,0,0,0,4,33,675,2,4,1.044681579,900,102,37,224,220,4,7985,7850,135,110,108,2,100
2fbea9f2b52283a82a2769e8e389db4729317e78,5,76,41,35,1,0,1,3,34,205,2,5,1.890624526,1501,103,38,383,386,3,12382,12267,115,163,161,2,99.92647059
fdab2efd718573a014f445cd54f7d8c477407958,1,6,2,4,0,0,0,3,6,0,1,1,0,432,178,6,99,99,0,3909,3885,24,20,20,0,100
7217f6781dfe74d49531cd16a4d80285a8552dac,0,0,0,0,0,0,0,0,0,0,0,0,0,0,0,0,0,0,0,0,0,0,0,0,0,100
78e41ac25d6dba65a52d61c43f4f98c5956d1e7d,2,63,2,61,0,0,0,2,4,22,1,2,0.961236605,234,104,39,50,38,12,2208,1783,425,37,29,8,100
f5fd57475d8aec1a41d694f9f8bd6337ab9a8560,1,1,1,0,0,0,0,4,6,344,1,1,0,90,0,0,23,23,0,609,611,2,8,8,0,100
3b8a34c51eeadb54adeed78bea1e1ec3b03e279f,0,0,0,0,0,0,0,0,0,0,0,0,0,0,0,0,0,0,0,0,0,0,0,0,0,100
46b9b7c85835b1c4285eddce6c9773024a1b2114,2,52,30,22,0,0,0,5,17,56,1,2,0.461216041,304,179,7,70,68,2,2466,2361,105,12,12,0,100
93bd535eb66562ea8aadf5219d09a7893fff724e,0,0,0,0,0,0,0,0,0,0,0,0,0,0,16,1,0,0,0,0,0,0,0,0,0,100
756c272ef0db175b3b6aca09d86b8a4acafd27ca,6,26,114,88,0,0,0,11,33,489,1,1,2.319749148,1828,140,0,265,265,0,12720,13286,566,102,102,0,100
927753159b12d7415bd891a67b94c39cbc133689,0,0,0,0,0,0,0,0,0,0,0,0,0,0,124,1,0,0,0,0,0,0,0,0,0,100
0cf62fd8002b68d0e11479752d3d2630a4bdfd38,6,404,17,387,3,0,3,3,14,270,2,3,1.885975792,404,141,1,118,69,49,4891,3111,1780,71,48,23,99.82914328
572c5d6480ed4e4d3b8da4084798c7740acd0ae3,4,43,14,29,0,0,0,7,22,44,1,3,1.51651233,1127,105,3,228,224,4,9163,9032,131,100,97,3,100
da78c48314c67f2998eab2190324ca3786b3bafc,2,4,3,1,0,0,0,5,18,14,1,2,0.985228136,325,180,4,70,70,0,2477,2466,11,12,12,0,100
7d27b68537a315e409c5e63d8b35de66a9087a34,0,0,0,0,0,0,0,0,0,0,0,0,0,0,17,1,0,0,0,0,0,0,0,0,0,100
3051df25409401db304f3e042db295b7a402619d,0,0,0,0,0,0,0,0,0,0,0,0,0,0,18,2,0,0,0,0,0,0,0,0,0,100
2f896628645b584f6e70651facb54ee5dc985fb6,3,30,17,13,0,0,0,1,11,57,2,2,1.54264875,339,106,2,68,63,5,2538,2470,68,36,34,2,100
9eedb2d1dcdd661fe8f16c2a4519a65a17033982,8,810,14,796,3,0,3,7,47,72,3,5,2.068808168,2072,213,0,559,428,131,20391,16444,3947,174,117,57,99.82972513
e8f5c4d942c15bf440d2a5adfcde963f8a9b8749,0,0,0,0,0,0,0,0,0,0,0,0,0,0,125,1,0,0,0,0,0,0,0,0,0,100
75947444baceff7ed84baee10da7b56c86f86ab9,0,0,0,0,0,0,0,0,0,0,0,0,0,0,126,2,0,0,0,0,0,0,0,0,0,100
7e4788ed00c6a0ef4e8c89f0486b8073a56409e4,7,134,72,62,0,0,0,8,79,172,3,4,1.775817185,5389,0,0,1398,1387,11,43258,42895,363,443,438,5,100
fb7e9eaf9c4453a1dcba9f7597b6ab67d3637a0e,1,4,0,4,0,0,0,6,17,0,1,1,0,1403,17,0,396,395,1,11839,11812,27,65,65,0,100
ba2b1449195cb79e464e14e6fedca4a8df50fa6b,5,42,29,13,0,0,0,8,33,864,3,5,1.664514722,1137,214,1,156,156,0,8408,8293,115,65,65,0,99.8306315
a2dc0ba871d2d0504309630130ce3583f93c87b4,0,0,0,0,0,0,0,0,0,0,0,0,0,0,107,2,0,0,0,0,0,0,0,0,0,100
e7b9131dbfb143cc9690d0952c21134c79a43bfb,0,0,0,0,0,0,0,0,0,0,0,0,0,0,19,3,0,0,0,0,0,0,0,0,0,100
243a43218fa8a72ff653bf0b61af9ac1c5b1ef85,2,10,9,1,0,0,0,3,13,1704,2,2,0.831474388,117,181,1,16,15,1,867,883,16,8,8,0,100
e272a28e861ee3926266e018b388ac6798dcd306,1,9,8,1,0,0,0,9,24,235,1,1,0,207,0,0,36,35,1,1403,1401,2,13,13,0,100
85280ddf073a6e930b7b076730c362271437429a,4,203,247,44,0,0,0,5,12,879,2,4,1.163958556,379,182,1,43,49,6,2805,3363,558,22,18,4,99.87948903
854208c1ebc2a8a643dfaef190c76a13041cc1ad,4,33,6,27,0,0,0,4,73,250,1,3,1.549746207,1697,215,2,408,400,8,13952,13835,117,130,128,2,100
62cdbdc6d45c32fc3b135b4c6100f1ed02c6390a,3,245,135,110,0,0,0,6,23,1601,1,2,0.052677618,749,70,0,148,136,12,5899,5436,463,22,19,3,100
d003ddb33b16a0a67e6b7f7eae29c1638a4d0971,24,479,138,341,3,0,3,1,21,212,4,8,3.541860949,5801,216,2,1051,1013,38,53365,51869,1496,349,326,23,96.41234155
40329046a1d67059409c02396d696153bb2de653,5,124,5,119,0,0,0,3,31,218,2,3,2.285289197,3735,183,2,473,461,12,34932,34022,910,175,170,5,100
b96c6b7a9127021c5e3624048bc0d21b0e1e24e3,1,1,3,2,0,0,0,14,48,46,1,1,0,461,184,3,60,60,0,3424,3424,0,18,18,0,100
945de013f5466ffcf71d16c6ec1772fdee83e2f6,0,0,0,0,0,0,0,0,0,0,0,0,0,0,0,0,0,0,0,0,0,0,0,0,0,100
8129bade53d1f2ad7a5de07c8254612b5c7a1f1f,2,4,1,3,0,0,0,8,19,11,1,1,0.721928095,1591,18,0,389,389,0,13614,13573,41,97,97,0,100
36656ea75eb2f3ad43a7bdf78f8ba9a471fce1b6,13,150,98,52,0,0,0,3,49,512,3,6,2.977590599,5315,0,0,1445,1430,15,38850,38381,469,549,540,9,100
84371bccc6bcfe8dec61508b4d52e28796d85370,1,5,1,4,0,0,0,4,4,0,1,1,0,396,217,2,99,98,1,3135,3120,15,35,35,0,100
ed795dc4c10ef56999ff57fa67739a1e126a2ccb,2,39,9,30,0,0,0,8,34,84,2,2,0.842657877,742,218,3,147,144,3,5602,5437,165,31,31,0,100
2b9aa84d627ffec63a36ba345244703a8f4d557a,0,0,0,0,0,0,0,0,0,0,0,0,0,0,20,0,0,0,0,0,0,0,0,0,0,100
618cf361201828faba3b7cf1f47dad2e348db634,2,2,2,0,0,0,0,8,22,360,1,1,1,610,0,0,102,102,0,4885,4889,4,33,33,0,100
5da376483b37ffe56bc23f5db54149e1e0534a36,1,19,2,17,0,0,0,3,5,1124,1,1,0,91,0,0,25,21,4,742,629,113,17,14,3,100
18350777ed1137412609ceb420d8e6fa342737fc,1,1,1,0,0,0,0,8,24,39,1,1,0,560,71,1,129,128,1,4233,4221,12,15,15,0,100
5ebb16901040c22a717de29f962ca53941ba4078,7,28,21,7,0,0,0,6,19,246,3,4,2.651458818,2726,219,2,726,724,2,22116,22004,112,181,180,1,99.8330949
18a4984a4f6d28cd03c0e2fed194b1f129a5a9ec,2,7,6,1,0,0,0,15,49,315,2,2,0.619382195,731,0,0,105,105,0,5543,5525,18,34,34,0,100
9a5553731b3ace19b2bca05f91676ec61b33f338,1,4,2,2,0,0,0,5,20,2,1,1,0,167,220,3,32,32,0,1475,1464,11,11,11,0,100
e4921452ebea5b338c07bbc6f886c44c8843f64b,3,55,0,55,0,0,0,2,23,605,1,1,1.104163025,815,221,4,217,204,13,7018,6617,401,72,68,4,100
b919d3d0964efbe1eda40724545d5fa506100a02,1,3,2,1,0,0,0,3,3,222,1,1,0,218,222,5,26,25,1,1467,1458,9,8,8,0,100
a5e5cec61e0af17710da229073a033e7b9cae4a9,0,0,0,0,0,0,0,0,0,0,0,0,0,0,127,0,0,0,0,0,0,0,0,0,0,100
97e131a58849d17145d9ccc0997c050866e532c3,0,0,0,0,0,0,0,0,0,0,0,0,0,0,128,1,0,0,0,0,0,0,0,0,0,100
2068d7ddc08c66307a90a6a925d131fe19ce3756,2,20,5,15,0,0,0,1,50,105,1,2,0.40217919,544,108,0,71,69,2,4188,4083,105,27,25,2,100
5307e498a3ecef5d4d24ad7ad9518052b212914a,1,9,1,8,0,0,0,8,35,84,1,1,0,581,109,1,101,100,1,4120,4077,43,25,25,0,100
bd0c5a8a8895b0ab52222e47beeefaab994a1099,1,13,2,11,0,0,0,8,36,2,1,1,0,589,110,2,104,101,3,4144,4120,24,25,25,0,100
beb34506a15379af4a306902da049f37b445a2f5,16,361,25,336,1,0,1,8,37,250,6,8,3.110157403,5667,223,0,1449,1416,33,45873,43985,1888,383,369,14,99.42238267
9300924fd4de98e3400105e78ddb18111c065702,1,26,4,22,0,0,0,2,7,169,1,1,0,537,72,0,83,81,2,3866,3806,60,33,31,2,100
6ed883b3dfc74fd86b81f1bb0325a05a88e9e5b2,0,0,0,0,0,0,0,0,0,0,0,0,0,0,21,0,0,0,0,0,0,0,0,0,0,100
e04c857d4da79eade201ea07a287bb2fef19bea2,0,0,0,0,0,0,0,0,0,0,0,0,0,0,129,0,0,0,0,0,0,0,0,0,0,100
2a3b8830241a6bec7093bacfd91de44655adc28f,0,0,0,0,0,0,0,0,0,0,0,0,0,0,22,1,0,0,0,0,0,0,0,0,0,100
83fbe467bf5d80032ee3b5f1279589a3710f45e3,0,0,0,0,0,0,0,0,0,0,0,0,0,0,130,1,0,0,0,0,0,0,0,0,0,100
22041f51ce9a52f2c7b2634024e20765347a794a,0,0,0,0,0,0,0,0,0,0,0,0,0,0,23,2,0,0,0,0,0,0,0,0,0,100
a5f971a322b75a7cc2bd9e8bdf021be46e03b63d,2,34,24,10,0,0,0,3,12,223,2,2,0.479832024,271,1,0,69,67,2,2090,2027,63,27,27,0,100
4003858919bfff58d55479cbb2f2a79b5f4e9826,0,0,0,0,0,0,0,0,0,0,0,0,0,0,131,2,0,0,0,0,0,0,0,0,0,100
1123f512cd4ba98f8e1cfecb7f9deff23cbb4949,9,963,113,850,3,0,3,1,74,212,2,4,2.70413389,1860,224,0,608,424,184,18934,14332,4602,172,119,53,99.83095871
e05ed85fece9c6c3956a0e3f666f59e01a7b668c,0,0,0,0,0,0,0,0,0,0,0,0,0,0,24,2,0,0,0,0,0,0,0,0,0,100
3871be8b1e5496214b6d6adf1ee4c334d54f54b6,0,0,0,0,0,0,0,0,0,0,0,0,0,0,25,3,0,0,0,0,0,0,0,0,0,100
665f8311e45477ffdf951b7f9d9eb304badfaab8,0,0,0,0,0,0,0,0,0,0,0,0,0,0,132,2,0,0,0,0,0,0,0,0,0,100
e8b32778cad16a61bcb6341b32fee90301028f71,0,0,0,0,0,0,0,0,0,0,0,0,0,0,133,3,0,0,0,0,0,0,0,0,0,100
b455040d06be2c6330dfb0b11e34c6ea480a0b7c,0,0,0,0,0,0,0,0,0,0,0,0,0,0,134,4,0,0,0,0,0,0,0,0,0,100
b7d113dc8eb1525e03e4497346db5da54350370b,1,1,1,0,0,0,0,4,7,76,1,1,0,31,2,0,5,5,0,234,234,0,3,3,0,100
96bdc802cc0b94819f1c02b9ed4b911ce05c947d,0,0,0,0,0,0,0,0,0,0,0,0,0,0,26,4,0,0,0,0,0,0,0,0,0,100
6435f75db312e2944e8eaf72537e87491cd7af1a,0,0,0,0,0,0,0,0,0,0,0,0,0,0,185,0,0,0,0,0,0,0,0,0,0,100
cb2421bc0eb4f6a9c2d9f6dadf3b9ba0080e3e82,13,785,6,779,3,0,3,12,34,387,4,7,2.421906729,3259,111,0,763,667,96,31440,26563,4877,289,238,51,97.39108409
cd51cefb56d481db136237143f87f43c6df46229,0,0,0,0,0,0,0,0,0,0,0,0,0,0,112,1,0,0,0,0,0,0,0,0,0,100
fa7d167537dfcdc48401e810519615723a4c664e,1,7,7,0,0,0,0,1,2,0,1,1,0,240,113,2,50,50,0,1899,1899,0,23,23,0,100
de7fe47a2b714a023c5aa3d4f3b5648306ae7af1,2,8,1,7,0,0,0,1,3,0,1,2,0.99107606,417,114,3,74,71,3,3603,3553,50,38,38,0,100
a9aa5b0e1b0a7c2867aef16358e3c3c1977bb140,3,78,84,6,0,0,0,6,21,345,1,2,0.876039692,2047,186,1,546,548,2,17778,17861,83,95,95,0,100
4985b9f2a64a0f16f323bcbac600457215636852,1,510,0,510,1,0,1,1,1,0,1,1,0,0,115,4,77,0,77,2968,0,2968,31,0,31,99.94666667
2341d58a6ef14de410b75abdbc1378c6f81db6fa,4,219,88,131,0,0,0,8,44,372,2,2,1.831019275,3080,225,0,863,832,31,26516,25653,863,168,161,7,100
05e845f5b5178849f6fd53e589f9deaebd498f85,0,0,0,0,0,0,0,0,0,0,0,0,0,0,27,1,0,0,0,0,0,0,0,0,0,100
b84ed999303abdeb8615393bb807f062cce76424,14,166,77,89,0,0,0,2,39,241,4,6,3.123778131,5840,226,1,1451,1437,14,44932,44350,582,449,448,1,100
7527ca06db3f82c981d61df855fd2ebe0ac96094,9,398,18,380,1,0,1,4,23,199,3,7,2.326975072,2725,1,0,728,659,69,24503,22372,2131,217,178,39,99.54276493
0e0f217af2b7c142ebc1445b86ba5570a3b69684,5,153,75,78,0,0,0,6,50,80,2,3,1.342772367,3757,227,2,1073,1051,22,31079,30448,631,244,241,3,100
a9a095e1d87ee515b85ba281c96dabb78e2c415f,12,227,140,87,0,0,0,2,80,242,4,5,3.05478202,7021,228,3,1874,1853,21,54820,54326,494,576,571,5,97.87175235
d561404b0a93282a4dd9b0296f5c91b4230146a3,0,0,0,0,0,0,0,0,0,0,0,0,0,0,2,0,0,0,0,0,0,0,0,0,0,100
b7dcfc60db30ed7a8d6e8e490e2b4936d8fd8412,2,66,4,62,0,0,0,1,4,52,1,2,0.985228136,424,116,0,82,74,8,4002,3603,399,42,38,4,100
9735643c6965accf367c1b8e8c39e6fae83da6b6,1,73,30,43,0,0,0,1,2,47,1,1,0,414,117,1,86,77,9,3258,2968,290,33,31,2,100
d24929978f987fffc68199b83829a9b18f6f821e,1,8,1,7,0,0,0,1,3,9,1,1,0,452,118,2,88,86,2,3315,3258,57,33,33,0,100
ef752a1825a26cc9cf443489beca75ab2de88deb,1,1,5,4,0,0,0,1,4,1,1,1,0,459,119,3,87,88,1,3297,3315,18,33,33,0,100
a0e4cd1aacb2047ff5af075a43ff9e38c49e2b85,8,86,22,64,0,0,0,6,47,476,2,5,2.344217686,2487,229,0,717,706,11,19630,19173,457,209,207,2,97.22712377
ee99930f5203ac321a5da41b9e3ab63df98e2faf,3,73,98,25,0,0,0,16,51,276,2,3,0.251518215,720,0,0,90,96,6,5467,5635,168,32,33,1,100
fe1c299ce4387138ec82b0824415949daa93fa6f,3,18,1,17,0,0,0,8,39,80,3,3,1.236386411,2334,230,1,601,598,3,18646,18574,72,133,131,2,100
74b32a17f1b2449c841da3eaf482b6272ffcc6d7,0,0,0,0,0,0,0,0,0,0,0,0,0,0,0,0,0,0,0,0,0,0,0,0,0,100
3841a1bfd41b485f3cdeaad05abba2b14289c9d6,3,77,25,52,0,0,0,1,40,319,2,3,1.437965703,928,231,2,213,201,12,7036,6724,312,64,61,3,100
18019733f28448458e2cad94f5e67aabd18316be,7,138,49,89,0,0,0,6,41,189,2,4,2.196065562,3761,232,3,1018,999,19,30304,29748,556,260,256,4,100
f103e1438bbfc0c61912ded3551e22578876fbbe,3,197,9,188,1,0,1,1,41,48,1,2,1.228881918,808,233,4,189,161,28,6823,5914,909,47,36,11,99.86310746
b9642b62bca574bda897b199c5beb722238f3201,0,0,0,0,0,0,0,0,0,0,0,0,0,0,135,0,0,0,0,0,0,0,0,0,0,100
fe22a652c1a29c6df24bd906f6f62c9a76c2ddc0,2,6,1,5,0,0,0,2,4,18,1,1,0.863120569,155,234,5,22,22,0,1359,1316,43,13,13,0,100
1cb155a2548f7f415132d229043f9f6bdce755c2,0,0,0,0,0,0,0,0,0,0,0,0,0,0,136,1,0,0,0,0,0,0,0,0,0,100
d030b525fa280eac9355302e9996d2a534769a47,0,0,0,0,0,0,0,0,0,0,0,0,0,0,137,2,0,0,0,0,0,0,0,0,0,100
546bc22f211351e479a65cfc401254ead2d86889,0,0,0,0,0,0,0,0,0,0,0,0,0,0,138,3,0,0,0,0,0,0,0,0,0,100
786a0eaab8053693d16f731d09e7667de5d697df,0,0,0,0,0,0,0,0,0,0,0,0,0,0,139,4,0,0,0,0,0,0,0,0,0,100
be84c4d8332e8f779516c61527a6de776a8a6897,0,0,0,0,0,0,0,0,0,0,0,0,0,0,140,5,0,0,0,0,0,0,0,0,0,100
efb6a36563103f6908c0e16c87990412b4d869ac,0,0,0,0,0,0,0,0,0,0,0,0,0,0,187,0,0,0,0,0,0,0,0,0,0,100
5c8445627891f67c806d7dbdd26e8f856c87a106,6,168,15,153,0,0,0,6,90,402,3,4,1.933337704,1932,235,6,450,425,25,16302,15330,972,149,142,7,100
18ac31dbd2e5ab546f04281fa9a754e253618553,0,0,0,0,0,0,0,0,0,0,0,0,0,0,0,0,0,0,0,0,0,0,0,0,0,100
ffa96f75355466d0daf14f9ebf3e5563ca40f1c6,3,16,2,14,0,0,0,4,37,106,2,2,1.194173734,897,236,7,187,186,1,7951,7877,74,39,39,0,100
5651f934f42c40933d668b2d6f00fb9f8d9d1d89,18,303,209,94,0,0,0,9,81,275,2,8,3.142971879,9812,237,7,2585,2563,22,79399,78665,734,714,713,1,92.14015152
5d99c40a51d910d3858d4d25e321afad5f12996d,6,108,50,58,0,0,0,1,42,212,3,5,1.867548886,2232,238,7,530,513,17,17097,16700,397,153,148,5,100
24715256558bed6f89d4bec25c6eada0c9db2075,6,146,40,106,0,0,0,1,43,42,2,4,2.10014279,2260,239,5,557,535,22,17763,17109,654,146,143,3,92.16568047
10f34ed8adc41929dcdcbaf8ac5fc23e712ae46d,24,323,121,202,0,0,0,2,82,443,4,15,4.082472594,12234,240,6,2906,2860,46,101615,100256,1359,808,803,5,92.99001815
0f79c344adc6d56e509c486e384dd380180e6cf0,0,0,0,0,0,0,0,0,0,0,0,0,0,0,241,7,0,0,0,0,0,0,0,0,0,100
df44a5cb2a48eae7bdb79d27f45f10aeb8c97d0c,2,35,41,6,0,0,0,9,27,4,1,2,0.97538179,1134,188,1,278,280,2,9369,9410,41,73,72,1,99.25208975
50ff27c7e687670893f4f0320908de4c60d54adc,2,8,0,8,0,0,0,9,35,229,1,2,0.811278124,1361,0,0,265,264,1,10286,10223,63,74,74,0,100
fc2a926cc7d0f0070c25f9afc68bf6a5a1bb6df2,12,305,61,244,0,0,0,1,54,14,3,7,2.549440692,6497,242,8,1809,1758,51,50806,49051,1755,424,415,9,99.93566374
4493653e07cb5a2ed6e564ea817c82ade2d95995,0,0,0,0,0,0,0,0,0,0,0,0,0,0,1,1,0,0,0,0,0,0,0,0,0,100
2e1c563418afbe4c1ac61b44b18d02c02c17235d,42,2734,5185,2451,13,0,13,7,79,669,6,24,3.225608867,12297,189,2,1982,2521,539,83357,93731,10374,648,945,297,95.80779118
4925ec35933b8be6a75e758654629f55bb12ee60,8,541,45,496,1,0,1,16,52,53,4,7,1.874505153,3124,190,3,800,723,77,28200,25117,3083,286,244,42,96.76216641
3ed1f5a082ed665ce54f7dffc683b0f7b191e44d,1,250,0,250,1,0,1,1,1,0,1,1,0,0,2,0,33,0,33,1593,0,1593,15,0,15,96.28107262
ca22400ebf425088097b20b33873c15a71d5f908,2,18,6,12,0,0,0,10,45,172,1,1,0.543564443,1521,0,0,479,477,2,11152,11073,79,170,169,1,100
9e2d326688a093c7d361063f24fc7bd5affd4e01,0,0,0,0,0,0,0,0,0,0,0,0,0,0,120,0,0,0,0,0,0,0,0,0,0,100
debbc0ae8c012482e1401ab5699acf448d0205e2,1,5,1,4,0,0,0,1,4,4,1,1,0,230,243,8,68,64,4,1624,1568,56,15,15,0,100
770b82746fafcc4455eb52db3e0cdc4f2ff8236d,0,0,0,0,0,0,0,0,0,0,0,0,0,0,2,2,0,0,0,0,0,0,0,0,0,100
3d266b08c10139652e76daae603c4a44a7b08eeb,0,0,0,0,0,0,0,0,0,0,0,0,0,0,191,4,0,0,0,0,0,0,0,0,0,100
8fc70a32303def4d85755cbf6466ab6e4c0e72e6,0,0,0,0,0,0,0,0,0,0,0,0,0,0,3,3,0,0,0,0,0,0,0,0,0,100
3addc237de36c9319577bba339138aadd8570d72,0,0,0,0,0,0,0,0,0,0,0,0,0,0,1,0,0,0,0,0,0,0,0,0,0,100
fa2c3e2cc6afc8d06a943a589502d0e1004cdd62,1,21,13,8,0,0,0,3,10,20,1,1,0,511,192,4,132,131,1,4537,4513,24,54,54,0,100
4c7c911c3d64ede6bbb2d8cafb9cbc50c399cbc1,3,10,11,1,0,0,0,6,13,699,1,1,1.556656707,332,73,0,31,31,0,2506,2508,2,14,14,0,100
f92e06cda0833d5840015a18ec8f5c5f30b582a3,0,0,0,0,0,0,0,0,0,0,0,0,0,0,4,3,0,0,0,0,0,0,0,0,0,100
27916dd49f854678b84bde8023aee6e47cbeb7ce,0,0,0,0,0,0,0,0,0,0,0,0,0,0,5,4,0,0,0,0,0,0,0,0,0,100
2c0a8bcc1afe1588a1ffc3ea175bb29055c55894,1,22,3,19,0,0,0,4,14,28,1,1,0,865,193,5,77,74,3,8006,7907,99,41,40,1,100
67a681f2b36637ce691f2bec9d4296b674c6c92e,1,13,3,10,0,0,0,5,16,25,1,1,0,565,194,6,137,135,2,4340,4290,50,60,59,1,100
c7e42427f0320a2874ceee8eb4859cdd140f7b33,0,0,0,0,0,0,0,0,0,0,0,0,0,0,6,5,0,0,0,0,0,0,0,0,0,100
cd15f768d6c0378925457f4447386a341c84f171,8,475,69,406,3,0,3,16,53,12,3,6,2.418723577,2534,195,7,607,566,41,22120,19968,2152,213,193,20,99.05178702
b2a77d0f657e321c6e2d54f73ac9b6a0fec59cad,10,105,494,389,0,0,0,16,52,257,4,8,2.719025137,3521,0,0,741,780,39,25575,27590,2015,279,296,17,99.05178702
d5f7cc46cdae050db5d1ee810a2a2ed10c52c15f,15,499,110,389,3,0,3,16,53,170,4,9,2.833344647,3458,196,8,793,754,39,29326,27311,2015,308,291,17,99.05178702
6aaab22160a214b303f2f2d9ff1b2e5be48db8b3,1,8,9,1,0,0,0,1,2,157,1,1,0,145,3,1,35,35,0,1039,1040,1,23,23,0,100
5b9430daa7463a6328ba7a0175c8e15b5378131f,0,0,0,0,0,0,0,0,0,0,0,0,0,0,0,0,0,0,0,0,0,0,0,0,0,100
af1719a3472d1d436d0fc685fe9f88d8a754ef94,2,131,2,129,1,0,1,1,6,92,1,2,0.194768782,364,0,0,78,71,7,4458,3774,684,66,61,5,99.92720655
dcf0404e0efaa710bb5c0bd649cde57b8edca706,1,33,6,27,0,0,0,5,10,1427,1,1,0,146,3,0,40,36,4,1317,1130,187,27,23,4,100
3ba4a3fe670c36b71f42d3579264a0f060af1090,7,18,23,5,0,0,0,1,5,262,2,3,2.409480144,506,121,1,88,112,24,3466,4994,1528,54,63,9,99.61797344
01ea65c2153c6541f479c6f4f527aa4883e9fbe2,5,379,232,147,0,0,0,4,38,490,3,5,1.076034333,1722,197,9,356,346,10,15965,15240,725,171,165,6,100
ee4189124cb647dce8afadb3e3ec1a7c959f5554,1,27,41,14,0,0,0,6,8,38,1,1,0,240,198,10,42,44,2,1659,1731,72,14,14,0,100
9b6a1e6c6e3c8ad68aba2270f1eaef7f7b72364e,1,72,4,68,0,0,0,6,10,2,1,1,0,154,1,1,32,30,2,1120,1006,114,20,18,2,100
92c0c3e52967d4c9139a87b01c7e5b812d2894cf,0,0,0,0,0,0,0,0,0,0,0,0,0,0,141,0,0,0,0,0,0,0,0,0,0,100
727e6e0312f99c2ca91d3909ece47ae2604acd08,2,3,1,2,0,0,0,6,13,192,1,1,1,502,2,2,107,107,0,3389,3377,12,55,55,0,100
ba5e6b244cec8601403b3a96e3ac3391e1c282f5,1,16,3,13,0,0,0,5,6,1668,1,1,0,236,26,0,67,65,2,1518,1450,68,17,17,0,100
4551dcd7af36662c4df8a83af9f599ed1a3a39d4,0,0,0,0,0,0,0,0,0,0,0,0,0,0,7,5,0,0,0,0,0,0,0,0,0,100
a9fc73a45903aac0e04793a4e9681159ee0a0b03,0,0,0,0,0,0,0,0,0,0,0,0,0,0,8,6,0,0,0,0,0,0,0,0,0,100
8dc4041c69083292d7d5f9996b10f42e33874077,5,28,10,18,0,0,0,3,15,191,2,4,2.296902106,1140,199,8,233,231,2,9662,9582,80,116,114,2,100
14037eed5c380006b0d622842677e362057a433a,8,182,83,99,0,0,0,3,83,331,3,6,2.235940155,6475,0,0,1338,1335,3,55345,54625,720,418,415,3,100
07192bc82c213896dec29d219056633ef56c13f8,4,126,2,124,0,0,0,8,46,41,1,2,0.885895158,1749,244,0,552,527,25,13523,12873,650,184,170,14,100
2b29e4a4460eb6de86904ff2517ee572cd88d3ee,8,51,29,22,0,0,0,2,35,348,3,6,2.56006809,2413,0,0,433,430,3,21027,20745,282,180,177,3,100
66f57da82afd1d348eca4e0c9deccc3838ebe114,2,26,13,13,0,0,0,4,15,16,1,2,0.995727452,639,200,7,151,149,2,5609,5502,107,60,59,1,100
984445e9111c743f3f255fc4653fc02555a8f095,8,404,35,369,2,0,2,5,45,709,3,7,1.986675029,1807,4,1,319,271,48,16816,14690,2126,115,93,22,92.7337081
d234de2d7ef4a935db313a852ce80b8aab126c3b,8,70,34,36,0,0,0,2,84,518,2,5,2.419901737,4546,201,8,1152,1147,5,37143,36831,312,333,331,2,100
3e4fb5cd84262c6c675e434628e607d7afd518f4,13,552,330,222,0,0,0,1,47,225,3,6,2.473584016,4454,245,1,1271,1213,58,34886,33435,1451,367,354,13,97.24064739
d6fe41d4c6e014de1fb1eb7a2a618c0d93be6c48,2,36,15,21,0,0,0,1,2,6,2,2,0.95260921,244,5,2,53,48,5,1997,1850,147,23,22,1,100
37eb276563fc69ae532acdc63845d20990e2de3f,8,34,70,36,0,0,0,2,85,8,2,5,2.419901737,4574,202,5,1147,1152,5,36831,37143,312,331,333,2,100
f029a4e024aab36cac60f32c75079357376918ef,6,75,2,73,1,0,1,1,15,1009,2,4,1.935242299,691,122,1,136,127,9,5472,5187,285,74,70,4,99.94169096
572c0b80da5a2290b3e1f2614e348b0d1d158990,6,383,35,348,2,0,2,1,6,28,2,3,2.189234673,320,123,1,106,59,47,3916,2109,1807,71,39,32,99.76723887
c477a6f6d1899211e7a7d9b67090b20757e28578,1,2,0,2,0,0,0,6,10,2009,1,1,0,106,74,0,23,23,0,622,606,16,6,6,0,100
f1071310cbb941a420d4c819c49ed4004e488372,0,0,0,0,0,0,0,0,0,0,0,0,0,0,142,0,0,0,0,0,0,0,0,0,0,100
fbabb8ba324e573cdcc5b914b1631417a6256283,1,10,3,7,0,0,0,11,30,35,1,1,0,1024,2,0,249,247,2,8619,8570,49,68,68,0,100
1a5009ea7ec589e5809aae5ead8fac2467394f25,12,866,536,330,2,0,2,6,47,109,3,9,3.122114054,2305,246,2,393,360,33,20905,18641,2264,167,133,34,91.00785945
39b059e03d3cc728745e7b1c90a7be774ebca0fa,0,0,0,0,0,0,0,0,0,0,0,0,0,0,143,1,0,0,0,0,0,0,0,0,0,100
f070d924ddee55259ea1d74c7a0b8e87cea2a75d,1,11,1,10,0,0,0,8,13,91,1,1,0,634,0,0,159,157,2,5866,5806,60,32,32,0,100
9d4380e0f32ab47ba51eba89d514be3968a3bd86,6,220,26,194,0,0,0,5,36,28,3,5,2.318714959,2897,0,0,645,611,34,25591,24583,1008,221,212,9,100
e6deb3378dfb19371f42077c7520187f75e61564,2,7,6,1,0,0,0,1,6,4,2,2,0.89049164,311,247,3,44,44,0,2700,2700,0,23,23,0,100
d61bfcfb03a116203df6280924eb9df94194026a,0,0,0,0,0,0,0,0,0,0,0,0,0,0,144,2,0,0,0,0,0,0,0,0,0,100
06a3fd3f8beb50e10db11edd1c8607b3bbe977a3,0,0,0,0,0,0,0,0,0,0,0,0,0,0,248,3,0,0,0,0,0,0,0,0,0,100
a910609d43b252526cf15337f891fc04c6dc4154,2,23,10,13,0,0,0,8,14,127,1,2,0.32984607,660,249,4,162,159,3,6141,6058,83,32,32,0,100
9c9eed274532391ceb57a0e17d0b2f8611530f8a,3,18,4,14,0,0,0,12,55,45,2,3,1.572623664,2450,250,5,647,644,3,19274,19206,68,163,163,0,100
2af5eedeee0a53422b9652eb44f9d7315a79f6aa,0,0,0,0,0,0,0,0,0,0,0,0,0,0,145,3,0,0,0,0,0,0,0,0,0,100
011e854660a08a6eed014d4fc5b56f55d8ca6cdd,0,0,0,0,0,0,0,0,0,0,0,0,0,0,146,4,0,0,0,0,0,0,0,0,0,100
93e629fa839f30f2641b284c874485fbe3505b27,0,0,0,0,0,0,0,0,0,0,0,0,0,0,9,0,0,0,0,0,0,0,0,0,0,100
efc4bebc1623c9d00fe4fdf0df424918654a73df,19,943,578,365,6,0,6,7,54,122,4,9,3.405244646,4531,124,2,990,950,40,36810,35595,1215,331,301,30,98.5770751
0bb18f08e6b63ce344d6b01b744d6ce492e16f50,10,301,176,125,0,0,0,1,30,422,3,7,1.984090025,1686,125,3,365,345,20,13757,13044,713,133,130,3,98.75910971
0174bac0b3fc6547441fbb6a8e64a8e8ae990050,15,956,160,796,3,0,3,3,75,575,1,3,3.448326034,1772,203,1,584,434,150,18173,14283,3890,190,121,69,99.86674281
5389b9bd3c9dd4bfbd1fbd881a6b4fc5fd7788cc,2,47,28,19,0,0,0,9,49,12,2,2,0.634309555,1075,251,6,238,235,3,8163,8028,135,67,67,0,100
24c9556c969eaa294e5c8537d98227c6bd6978e0,0,0,0,0,0,0,0,0,0,0,0,0,0,0,10,1,0,0,0,0,0,0,0,0,0,100
3def7682de67e1a37c9fa34b3232ded56f7583ed,6,7,7,0,0,0,0,4,12,75,1,2,2.521640636,613,126,4,27,27,0,6390,6396,6,22,22,0,100
f234ed1d4958c247dfeb99c996bbbea746ad83b1,2,2,2,0,0,0,0,10,80,97,1,2,1,1963,204,2,297,297,0,17511,17510,1,160,160,0,100
2c9376f8cbc15c20b02bfd6b227e7063d29b23bd,1,11,2,9,0,0,0,9,9,25,1,1,0,403,0,0,81,80,1,4305,4233,72,68,67,1,100
75bdf79100e5ae75cbb8150547dc48e35902970a,0,0,0,0,0,0,0,0,0,0,0,0,0,0,11,2,0,0,0,0,0,0,0,0,0,100
c756690365053037fad0afd794523162c9508a8a,0,0,0,0,0,0,0,0,0,0,0,0,0,0,147,4,0,0,0,0,0,0,0,0,0,100
1c6201559f3575f8f023b7a760259ebc4ef43ddd,0,0,0,0,0,0,0,0,0,0,0,0,0,0,12,3,0,0,0,0,0,0,0,0,0,100
4d6169f51e024645fca2213e21c1398c99420b4e,0,0,0,0,0,0,0,0,0,0,0,0,0,0,148,5,0,0,0,0,0,0,0,0,0,100
0a81c2505d91156742050f45634d9a72c0d7d7a2,7,103,46,57,0,0,0,6,68,506,3,6,2.395092924,3136,75,0,520,505,15,26250,26050,200,213,208,5,99.98099582
5c9a699ab2afa4de9dddc53e3b50407635e6fc79,9,496,85,411,0,0,0,7,81,324,2,6,1.756181792,4042,0,0,780,765,15,37624,34188,3436,319,309,10,100
fea30b881330c4be59cfea4192081779ba805117,6,60,25,35,0,0,0,6,56,235,3,6,1.740574956,1961,52,0,426,420,6,14998,14828,170,132,127,5,99.90496103
982123e46f88b6777ba07bc9d6b21068f9495863,5,51,43,8,0,0,0,6,32,270,1,4,1.538577198,1175,127,3,229,229,0,9206,9160,46,91,91,0,100
04bd64be7bbb0c97939629edaf8f827ce1a40b4b,0,0,0,0,0,0,0,0,0,0,0,0,0,0,1,0,0,0,0,0,0,0,0,0,0,100
2cb36b90d0c1fa550e5459e1f87294ecd5a505be,1,5,1,4,0,0,0,4,6,1156,1,1,0,138,149,5,9,9,0,973,936,37,6,6,0,100
eaee02fef4d2fa6186af5e3d754886507b5fada3,0,0,0,0,0,0,0,0,0,0,0,0,0,0,205,2,0,0,0,0,0,0,0,0,0,100
e050bc06b43909aaf5bcf001d4b0d922487b89ab,0,0,0,0,0,0,0,0,0,0,0,0,0,0,150,6,0,0,0,0,0,0,0,0,0,100
c37656cc64b1c41c8188ec92c24907e84ae05a06,3,449,52,397,1,0,1,1,82,4,1,2,1.119313985,2204,206,3,327,306,21,22333,19994,2339,182,165,17,99.35959635
0a5eb916e48d514fadd802bf5c4ed671d4de91cc,1,4,11,7,0,0,0,6,12,93,1,1,0,167,3,0,32,32,0,1092,1118,26,20,20,0,100
b7af1096af451aa640315d0139897bff627eff72,0,0,0,0,0,0,0,0,0,0,0,0,0,0,252,4,0,0,0,0,0,0,0,0,0,100
ed288a759c556c704c824eb921c81b563a32f3e9,1,26,1,25,0,0,0,6,14,1542,1,1,0,66,207,4,14,10,4,619,538,81,6,5,1,100
aaf0ba23b418d1b5b128ec4b8854287e878e2b4e,1,46,28,18,0,0,0,12,34,49,1,1,0,1050,253,1,261,256,5,8745,8726,19,72,69,3,100
0323ce3825c63b06d7b0032edd10b73b84078a4a,3,54,4,50,0,0,0,7,77,24,1,2,1.518850916,1321,76,1,366,355,11,10452,10169,283,122,116,6,100
8b58a326197e897a937d28f53076f385bb6710a7,2,90,33,57,0,0,0,3,5,608,1,2,0.620918136,530,128,1,94,87,7,4855,4425,430,41,36,5,100
fcca791b60364eb0fd5ca3b74c0f52f8f781cf64,3,45,9,36,0,0,0,5,14,8,1,2,1.202430894,1234,208,3,341,327,14,9885,9814,71,104,99,5,100
bd7f5eecf8cadae392adb948e3492ce6c1c97bbf,1,1,1,0,0,0,0,4,7,22,1,1,0,142,151,4,9,9,0,973,973,0,6,6,0,100
dfc346d3b87d1dce2268904fec6c26a36be7f2f0,0,0,0,0,0,0,0,0,0,0,0,0,0,0,152,5,0,0,0,0,0,0,0,0,0,100
5892de67cc9a0419bd8b6ccf72a0f67278c810f1,0,0,0,0,0,0,0,0,0,0,0,0,0,0,2,1,0,0,0,0,0,0,0,0,0,100
fad2822fdf2ff20673bd587866f187184e46bffb,10,470,127,343,2,0,2,1,57,200,2,6,2.375879861,3234,129,2,741,720,21,28582,26513,2069,266,248,18,98.95662848
55ef909cbc132945f9de65a6d00e22a1dead8ee1,1,30,30,0,0,0,0,10,29,168,1,1,0,895,254,2,284,284,0,6631,6631,0,109,109,0,100
d5437734fa15de763dc33bcd83e22f61ae172d51,5,113,7,106,0,0,0,12,83,41,1,2,1.676009549,2757,0,0,456,447,9,25653,24887,766,184,182,2,100
3137bb2151abcc362008d7449f1e9a80d57b17a7,19,2659,0,2659,19,0,19,1,1,0,1,6,3.734340442,0,0,0,269,0,269,12894,0,12894,135,0,135,99.07834101
2d23b037be339748e82b895075d22d93fdc22e0b,0,0,0,0,0,0,0,0,0,0,0,0,0,0,1,1,0,0,0,0,0,0,0,0,0,100
73d2134ac773c6428e0d59647fb7721fbc014f31,0,0,0,0,0,0,0,0,0,0,0,0,0,0,0,0,0,0,0,0,0,0,0,0,0,100
49db4cacbb07dd018876e77b872f483ef941a152,4,23,175,152,0,0,0,2,26,252,2,2,0.526232254,1052,130,2,209,250,41,7135,8134,999,86,99,13,97.05561614
f75d7f409f3323e799bb33e6ae1da89526fc475c,1,27,25,2,0,0,0,8,16,8,1,1,0,875,209,2,220,218,2,7041,7022,19,62,62,0,100
4e6339d8721e23bec7aabaafd28412497df2bb17,5,98,33,65,0,0,0,2,84,21,1,2,1.825833394,2335,1,1,303,297,6,22539,21906,633,140,140,0,99.42422847
b445dd1bc071bc5fbbe2addbc909f83770ecc6dc,0,0,0,0,0,0,0,0,0,0,0,0,0,0,210,2,0,0,0,0,0,0,0,0,0,100
8fef5353cf533531ce9d66f7ab525beea80fcc5f,0,0,0,0,0,0,0,0,0,0,0,0,0,0,211,3,0,0,0,0,0,0,0,0,0,100
b0063fa54e59088a5ef72604113c55c6284ab337,22,886,127,759,6,0,6,8,58,146,4,12,4.028425925,6534,0,0,1673,1576,97,57414,53868,3546,490,447,43,95.43634908
f4574531cd950001966f245ebe4fd96b54bbd6e2,4,74,67,7,0,0,0,3,23,637,2,3,0.69508809,1283,131,2,290,288,2,9691,9669,22,73,74,1,99.17780062
ff7415d8e45e5955764e522c28d9a914dfcc35f3,0,0,0,0,0,0,0,0,0,0,0,0,0,0,0,0,0,0,0,0,0,0,0,0,0,100
0c9bb699110386174deaa0c63d83efd4f609617e,0,0,0,0,0,0,0,0,0,0,0,0,0,0,13,0,0,0,0,0,0,0,0,0,0,100
8d30f75b0785a2704fe20dd8be5ff3afb8752ceb,0,0,0,0,0,0,0,0,0,0,0,0,0,0,14,1,0,0,0,0,0,0,0,0,0,100
fce87e338ad3d7a9425f41c09f73968308e8ce83,0,0,0,0,0,0,0,0,0,0,0,0,0,0,1,0,0,0,0,0,0,0,0,0,0,100
732b730c9e6242f7713af630269390171d169a28,0,0,0,0,0,0,0,0,0,0,0,0,0,0,1,1,0,0,0,0,0,0,0,0,0,100
4e4038f6e1dff1e5900a14cf306ea64817647b0a,0,0,0,0,0,0,0,0,0,0,0,0,0,0,153,0,0,0,0,0,0,0,0,0,0,100
1ca6ee125529a033252bf74baafcf49685fc20ae,5,268,13,255,0,0,0,1,2,35,1,4,1.6952874,468,2,2,119,83,36,4721,3468,1253,41,36,5,99.95016611
25c3bf9abc4ac893e67318855387be7c15a33fcc,0,0,0,0,0,0,0,0,0,0,0,0,0,0,77,0,0,0,0,0,0,0,0,0,0,100
045c0c07180f320223ccf60caf7249fbe6d824bf,12,580,50,530,5,0,5,1,3,12,1,6,3.3772615,990,3,3,232,182,50,9448,7629,1819,92,68,24,99.75153222
37b489ffc0e7af98cf478cf064243f11bef8ae8c,17,0,0,0,0,0,0,1,1,0,1,4,0,1586,4,4,291,68,223,11634,2958,8676,127,68,59,99.19884634
da13d53a049eebd6de2fa34283f5ac01f184708d,0,0,0,0,0,0,0,0,0,0,0,0,0,0,15,2,0,0,0,0,0,0,0,0,0,100
cc7d72dff2501589e3fb3619c0e84e69871a0452,0,0,0,0,0,0,0,0,0,0,0,0,0,0,16,3,0,0,0,0,0,0,0,0,0,100
51c377da6d8d51b7ccfc6f524ebfca1be4c93709,0,0,0,0,0,0,0,0,0,0,0,0,0,0,1,1,0,0,0,0,0,0,0,0,0,100
75ee78bfe66c8d2d64fd062bfe3db3629ae2fe53,0,0,0,0,0,0,0,0,0,0,0,0,0,0,212,3,0,0,0,0,0,0,0,0,0,100
512906934b1907441e1648f36d18d87f91d6db82,1,3,1,2,0,0,0,11,30,46,1,1,0,895,4,0,285,284,1,6650,6631,19,109,109,0,100
5196fd7122d09ccc3b0b65fb7bd0aab99379bf76,8,157,100,57,1,0,1,1,2,0,1,5,2.175505267,734,5,3,154,154,0,5428,5430,2,49,49,0,99.87562189
14eb91a7d9638d6659d801e702b3f277cec2427d,0,0,0,0,0,0,0,0,0,0,0,0,0,0,213,3,0,0,0,0,0,0,0,0,0,100
10e7be0fca1be50d750f484ecb0e23a35bcdf24b,0,0,0,0,0,0,0,0,0,0,0,0,0,0,214,2,0,0,0,0,0,0,0,0,0,100
87075f8af69bb32a3521e6b8fad58dea05df76b2,0,0,0,0,0,0,0,0,0,0,0,0,0,0,215,3,0,0,0,0,0,0,0,0,0,100
60b44a93c4033991d160b8d4ac1af7723b10d564,9,329,32,297,0,0,0,1,4,20,1,5,2.301774509,1778,6,4,304,272,32,15568,13634,1934,114,101,13,98.64756078
93d51399a00759a4c225f06448c1211807afd9cf,0,0,0,0,0,0,0,0,0,0,0,0,0,0,2,0,0,0,0,0,0,0,0,0,0,100
356017ef7da13daf64f2fb20e779d3862e9fe608,0,0,0,0,0,0,0,0,0,0,0,0,0,0,216,4,0,0,0,0,0,0,0,0,0,100
4b6380feb454b0cc2f0186820b6f10f42b47e119,0,0,0,0,0,0,0,0,0,0,0,0,0,0,78,1,0,0,0,0,0,0,0,0,0,100
64c7a3befcc90566f59cb805d51df34bdc7edc74,7,372,177,195,2,0,2,9,34,80,1,2,1.812672168,1806,0,0,475,456,19,15864,14959,905,112,95,17,93.84892807
e21f569f21736237dab8cb2bc8e34a232ee5fa9d,3,70,2,68,1,0,1,1,91,366,2,3,0.365098985,454,0,0,64,61,3,4046,3799,247,23,20,3,99.70141826
be9df1c3f8895bdcc9949c97ab032b0051edd612,2,98,9,89,0,0,0,12,85,52,1,2,0.447907859,1860,2,0,223,219,4,18470,17759,711,109,108,1,100
a92ddec05d0ae0d2fe87d931e3dcfa287c60e7f6,2,42,10,32,0,0,0,5,11,1773,2,2,0.779349837,203,5,1,54,50,4,1532,1376,156,24,23,1,100
e4f0b09e216360022f004126efcc2670c1038136,1,36,56,20,0,0,0,11,59,51,1,1,0,645,255,0,157,167,10,5066,5204,138,42,43,1,100
2f461b4217df7e1f6fcded17c83fc9ff7670a6d5,7,153,15,138,0,0,0,1,17,24,1,5,2.209537809,2210,7,4,454,437,17,18532,17528,1004,146,137,9,100
eced9a6945934a9930de137976b744ca2aeacec3,0,0,0,0,0,0,0,0,0,0,0,0,0,0,17,2,0,0,0,0,0,0,0,0,0,100
af25456d7a2110d27295c1249cec3795bfb5b51e,0,0,0,0,0,0,0,0,0,0,0,0,0,0,18,3,0,0,0,0,0,0,0,0,0,100
2968ad86de1de9e70c9c852ab55935129d38ab40,1,3,2,1,0,0,0,9,18,1,1,1,0,879,3,1,220,220,0,7062,7058,4,62,62,0,100
c34e2411e9341871405f1520df99e88616362372,0,0,0,0,0,0,0,0,0,0,0,0,0,0,217,5,0,0,0,0,0,0,0,0,0,100
8b722eb87128660d3810535e206b693fc8f9419f,1,0,0,0,0,0,0,1,1,0,1,1,0,74,6,2,7,7,0,682,682,0,5,5,0,100
17803eed8adfaa3c68b7de806085797b751eeec9,8,320,91,229,2,0,2,1,60,36,4,5,2.051363794,1685,1,1,409,391,18,14152,13188,964,194,181,13,99.87657369
ebeb0c9882b844c71382f2a1193dbf0e10c876db,1,4,2,2,0,0,0,9,26,254,1,1,0,560,79,1,130,129,1,4242,4233,9,15,15,0,100
ab8b75640d5a7c28b1d048a569c43d9192a024de,0,0,0,0,0,0,0,0,0,0,0,0,0,0,19,2,0,0,0,0,0,0,0,0,0,100
40081d4853ae9923e601f62c150c165f1cea902d,3,48,4,44,0,0,0,2,20,997,1,2,0.773228349,1533,256,1,334,326,8,12160,11965,195,96,95,1,100
b9481410bb667c0297ec9fe84c4693f7aec8c4be,19,490,345,145,2,0,2,8,61,262,3,9,3.449409681,4837,257,2,1194,1166,28,38998,39241,243,304,303,1,97.12941176
5d77aba316842976da13290431592fea249b7151,0,0,0,0,0,0,0,0,0,0,0,0,0,0,218,5,0,0,0,0,0,0,0,0,0,100
cad4f87f60cae95623cf1805d5f3cc24f9850a06,0,0,0,0,0,0,0,0,0,0,0,0,0,0,20,3,0,0,0,0,0,0,0,0,0,100
c24029bfba137503bbe19c0a3d79446709ceecb8,0,0,0,0,0,0,0,0,0,0,0,0,0,0,21,4,0,0,0,0,0,0,0,0,0,100
c8f525bf1b1d2dfbab6ddd9afbb19015e175aa34,0,0,0,0,0,0,0,0,0,0,0,0,0,0,154,0,0,0,0,0,0,0,0,0,0,100
e230aad8736ffed966915403821d7c3d2f29cc9b,1,2,2,0,0,0,0,13,92,30,1,1,0,210,4,2,6,6,0,1816,1816,0,4,4,0,100
f2cb641e36678c508ed2e952f9d35040b80ec12b,2,73,16,57,0,0,0,4,6,12,1,2,0.988952577,1136,2,2,294,286,8,10223,9791,432,50,49,1,100
13675409773a666cd04047e0be6dc4759db4a6c0,18,1145,118,1027,8,0,8,8,56,153,5,10,3.375357847,2824,3,3,737,626,111,27923,23161,4762,176,120,56,98.05194805
6e5bbc5090fdc2831ab2b7e37a39cf9fc9122850,0,0,0,0,0,0,0,0,0,0,0,0,0,0,80,2,0,0,0,0,0,0,0,0,0,100
6e2d15d963b434426b62ac371fc25bdfcfffece2,0,0,0,0,0,0,0,0,0,0,0,0,0,0,22,5,0,0,0,0,0,0,0,0,0,100
a097bed3f927d040cbdc9327511b8b1c5d9c7a9b,3,75,1,74,1,0,1,1,4,10,1,1,0.534202842,80,4,4,13,10,3,958,657,301,7,5,2,99.95831596
2bd6f4691dd733b4c204f3f1df4e3de0e31fdb42,3,82,22,60,0,0,0,2,13,127,2,3,0.968656191,669,219,2,114,106,8,5536,5345,191,43,39,4,100
9f71b529f0c600374bf4b3590ebf87cafec2fd31,0,0,0,0,0,0,0,0,0,0,0,0,0,0,6,0,0,0,0,0,0,0,0,0,0,100
66c2964e05f8421d8dfb395f1f0cf61d1f33a8e4,2,76,24,52,0,0,0,12,36,106,1,2,0.40217919,1308,220,3,334,321,13,11072,10751,321,88,83,5,100
3f67eb3cd73d445b5d35b29df697564ecf32a345,0,0,0,0,0,0,0,0,0,0,0,0,0,0,23,6,0,0,0,0,0,0,0,0,0,100
4e1eeb4cdcd8bc0601564434176eb200b2811c2e,3,10,19,9,0,0,0,13,86,79,1,3,0.999699949,2231,1,0,310,309,1,20532,20621,89,138,138,0,100
9062e2c861628d227f0c2616c5c84f2f90af9214,0,0,0,0,0,0,0,0,0,0,0,0,0,0,155,1,0,0,0,0,0,0,0,0,0,100
59648d289ee8a8c36c1f8e4ba7f3807418a64639,2,90,77,13,0,0,0,4,13,16,1,2,0.223300745,728,258,2,204,194,10,5533,5451,82,38,38,0,100
63779893e14f71233eb3d1f1ebec40db5ee33319,0,0,0,0,0,0,0,0,0,0,0,0,0,0,2,0,0,0,0,0,0,0,0,0,0,100
1c399cc7121fc2f68f50675f804e6cc21b7a5bf5,4,98,2,96,0,0,0,1,6,52,1,3,1.222966195,944,8,0,170,163,7,7895,7399,496,70,68,2,100
08b76391cfb8fd231218e5788261e5f2310703cc,8,821,197,624,5,0,5,1,27,203,1,2,2.417974443,603,7,1,197,120,77,8170,4744,3426,95,45,50,98.35903519
8cd7496566ddbeb843018a039e46e4de38402f7d,6,17,16,1,0,0,0,8,31,497,1,1,2.26961741,1093,8,2,164,165,1,9220,9204,16,103,104,1,100
ea0f6d275a8b35a5d37c297653fc2d8d7ae3c24b,0,0,0,0,0,0,0,0,0,0,0,0,0,0,0,0,0,0,0,0,0,0,0,0,0,100
37e441c11ba55b4c71650ade63d996334b3c8d37,0,0,0,0,0,0,0,0,0,0,0,0,0,0,156,2,0,0,0,0,0,0,0,0,0,100
4ce1e370d3ac07f24e956e15ac140a49cae499ad,0,0,0,0,0,0,0,0,0,0,0,0,0,0,5,1,0,0,0,0,0,0,0,0,0,100
1d2aad52f1053ac03edad78f9568d62010617a97,1,7,2,5,0,0,0,9,35,66,1,1,0,1468,259,1,399,399,0,12579,12556,23,64,64,0,100
c5b06aaa4207dd4337a7d9fb56352602b71c611d,1,1,2,1,0,0,0,6,6,308,1,1,0,398,0,0,99,99,0,3128,3136,8,35,35,0,100
bf1fa0a13b0e6e637a4224e541bca75aa0bb5b78,0,0,0,0,0,0,0,0,0,0,0,0,0,0,0,0,0,0,0,0,0,0,0,0,0,100
eb205d2798b24ffd3056b691f2ffb27d1eb50967,0,0,0,0,0,0,0,0,0,0,0,0,0,0,157,3,0,0,0,0,0,0,0,0,0,100
569d55968ec3f31bfa32fcd4492fbb201aa8e35d,1,1,1,0,0,0,0,9,19,61,1,1,0,880,221,2,220,220,0,7066,7062,4,62,62,0,100
66390fe8467b1c199d3769800703fb99f676cf22,0,0,0,0,0,0,0,0,0,0,0,0,0,0,158,3,0,0,0,0,0,0,0,0,0,100
f82e42f011be43b57e8980f5870af785b4c51307,0,0,0,0,0,0,0,0,0,0,0,0,0,0,159,4,0,0,0,0,0,0,0,0,0,100
ab7c8cd514bf3f911113d20b8b45dc4609401435,1,3,3,0,0,0,0,5,9,321,1,1,0,501,0,0,63,63,0,4471,4471,0,37,37,0,100
004b7e784f5a1bb3bbad0a86cb557b766287288f,0,0,0,0,0,0,0,0,0,0,0,0,0,0,160,5,0,0,0,0,0,0,0,0,0,100
2a2c4a5e3e83bf0eaae1d82e1746fc5c8b0b78b3,0,0,0,0,0,0,0,0,0,0,0,0,0,0,161,6,0,0,0,0,0,0,0,0,0,100
2c375b08a52ac8d1039abb4b612a41cb9d89b420,0,0,0,0,0,0,0,0,0,0,0,0,0,0,0,0,0,0,0,0,0,0,0,0,0,100
645bc94e59969d08b81e7af7a5a2db78207ab3fe,3,258,15,243,1,0,1,5,11,148,1,1,1.315154004,250,0,0,59,32,27,3150,1595,1555,24,12,12,99.90597969
e7071476aaba064d0967531cda6d9221f918db4e,0,0,0,0,0,0,0,0,0,0,0,0,0,0,81,0,0,0,0,0,0,0,0,0,0,100
eb513c315607946825831f2f80542b02b9476213,1,4,0,4,0,0,0,4,5,1218,1,1,0,96,0,0,25,24,1,838,793,45,19,19,0,100
ce5b6d7fea167b880b279076b2498c0786a5b4fd,1,3,0,3,0,0,0,6,17,83,1,1,0,225,53,0,37,37,0,1675,1665,10,15,15,0,100
a7d8044920a81f3dbb0b8e688ddecf68505998f8,25,1471,286,1185,4,0,4,8,62,203,5,13,3.699979447,6459,5,0,1684,1516,168,55030,49581,5449,584,494,90,97.23111697
d17307e431d4644cbb9a7770bc2faeca5d131714,0,0,0,0,0,0,0,0,0,0,0,0,0,0,260,1,0,0,0,0,0,0,0,0,0,100
4749e7a1c04ab08ffc5f8d582ca5de3c35b81ecb,0,0,0,0,0,0,0,0,0,0,0,0,0,0,82,1,0,0,0,0,0,0,0,0,0,100
d1262e995190834cca069ea365472fc61f17494f,0,0,0,0,0,0,0,0,0,0,0,0,0,0,3,0,0,0,0,0,0,0,0,0,0,100
5c0025177e6520564921c46d9a442e7da6f162c5,5,89,48,41,0,0,0,12,40,188,2,3,1.438471314,1886,1,1,501,500,1,16083,15812,271,165,162,3,100
8188a96e2aa3114502098eced91edfe3b1fb3674,2,54,14,40,0,0,0,3,18,798,1,2,0.997502546,528,132,0,70,65,5,5286,5011,275,35,33,2,100
d59c0d08fbc1f815608807d8dc76dbf8c8b3372d,0,0,0,0,0,0,0,0,0,0,0,0,0,0,24,0,0,0,0,0,0,0,0,0,0,100
47d4d588f2ed70396bb64b80c6362d8115350339,14,374,160,214,0,0,0,10,50,662,4,8,2.622776515,2807,0,0,499,457,42,24227,22836,1391,227,209,18,97.35990462
5a443e17fb81def5dd41eaf62ab0f0ee9676cc14,0,0,0,0,0,0,0,0,0,0,0,0,0,0,25,1,0,0,0,0,0,0,0,0,0,100
25e2e461a663418fa97aa3413fd4efdf798b1acc,0,0,0,0,0,0,0,0,0,0,0,0,0,0,162,0,0,0,0,0,0,0,0,0,0,100
ef4025160dd456f3ac67ef39551ba280925a6a94,19,334,316,18,0,0,0,10,79,386,3,15,3.690259957,6423,222,0,1282,1276,6,51953,51882,71,480,474,6,100
519fc2bf495c89fef7d2eb20403c436456e1cbc3,0,0,0,0,0,0,0,0,0,0,0,0,0,0,1,1,0,0,0,0,0,0,0,0,0,100
49aa29d54a3475c6ab26fe6254268c7138daaa7b,0,0,0,0,0,0,0,0,0,0,0,0,0,0,6,1,0,0,0,0,0,0,0,0,0,100
549dee6b6a488da4e5aa75b0927855889e1eb59f,3,24,22,2,0,0,0,8,70,3,1,2,1.301574289,1792,2,2,421,420,1,14833,14800,33,119,118,1,100
ad7e0401277bcd3f0126a15bc2593d56fd8683e2,1,7,3,4,0,0,0,3,4,1670,1,1,0,41,223,1,7,7,0,275,265,10,4,4,0,100
2c612bb8bebf5fd5f5e574385336d45acb17a154,1,2,2,0,0,0,0,5,12,7,1,1,0,15,224,2,1,1,0,107,99,8,1,1,0,100
3ad9016cd6f8fba0426262c90e5a97fe795d3843,2,11,10,1,0,0,0,8,55,149,1,2,0.863120569,919,83,2,141,141,0,6859,6858,1,41,41,0,100
c1f95d172db383c865a6d70bb5d1d1af3f329c50,0,0,0,0,0,0,0,0,0,0,0,0,0,0,225,3,0,0,0,0,0,0,0,0,0,100
23eacbafcea2e58378271fa6dc7b56be08b7cac7,4,219,23,196,0,0,0,1,51,231,1,2,1.587644777,1553,261,1,445,398,47,12746,11623,1123,108,100,8,100
85f9b502e883d3d4870dd201c98aee257a3efa1a,10,466,48,418,4,0,4,5,48,542,3,5,3.000117564,2954,0,0,653,601,52,25357,23414,1943,239,215,24,99.86061639
36459c7829c02d92a2af76bc1ea7de31e34bbd67,1,18,13,5,0,0,0,12,63,33,1,1,0,685,262,2,175,172,3,5424,5365,59,50,51,1,100
d52369ef11adce09a2585777cdda39dca447d202,1,7,6,1,0,0,0,5,16,3,1,1,0,882,263,3,77,77,0,8050,8024,26,41,41,0,100
8ada5d400ea994a0ffd3c67fa0f66719de1e4138,4,118,2,116,0,0,0,2,28,80,1,2,1.172284289,630,9,0,129,112,17,5794,4958,836,60,51,9,100
9f2e57f0d2717c8fd5e32fceab3edf64ce921fa8,0,0,0,0,0,0,0,0,0,0,0,0,0,0,226,4,0,0,0,0,0,0,0,0,0,100
93addf064bf1bbfc1c847b7801845a9c7e39bc7c,0,0,0,0,0,0,0,0,0,0,0,0,0,0,227,5,0,0,0,0,0,0,0,0,0,100
7fcf04159887d4719631e8e3d54f4297e17f4c4d,2,35,8,27,0,0,0,9,21,295,2,2,0.99022469,923,0,0,253,250,3,8170,8111,59,50,50,0,100
ca62d8659db632954ed28e35f3a5e7d27d3fe8b4,7,80,61,19,0,0,0,12,71,15,2,5,2.246390638,3585,3,3,795,792,3,30433,30218,215,257,256,1,98.14510834
bd31c50539c7b4df5fb43065844a007ce68a0106,1,15,18,3,0,0,0,5,17,3,1,1,0,883,264,4,77,77,0,8067,8050,17,41,41,0,100
709db096badfad3c17cf3adf9d65585bf1c0bc04,2,29,5,24,0,0,0,4,18,506,1,1,0.997502546,1456,265,5,138,134,4,13192,13042,150,84,82,2,100
74bfe9478ed26d917d5da77e02309d8b7b4299f9,2,17,9,8,0,0,0,10,26,20,1,2,0.995727452,454,4,3,71,71,0,4484,4398,86,26,26,0,100
c9becac21d60b0056dbebc4a1335151619be6d81,1,2,0,2,0,0,0,12,64,17,1,1,0,689,228,6,175,175,0,5437,5424,13,50,50,0,100
243e1562d2e695d7ff7614d1e5e4af4b6c6734ed,0,0,0,0,0,0,0,0,0,0,0,0,0,0,0,0,0,0,0,0,0,0,0,0,0,100
c9af474a4d141c4214e1d7bf4b891b033890bb98,1,2,2,0,0,0,0,15,37,312,1,1,0,573,10,1,100,100,0,4401,4401,0,30,30,0,100
a876e697c3c0c936e7efc33cecbe1e1c32a6be20,0,0,0,0,0,0,0,0,0,0,0,0,0,0,0,0,0,0,0,0,0,0,0,0,0,100
6d71f14a6e099ce8f4e2a2f16d8e5d5bc4579995,2,32,8,24,0,0,0,3,8,40,2,2,0.286396957,383,2,2,70,62,8,3349,3167,182,42,36,6,100
f54cff2fddd4ea24547ded204f80ce4af49bca3b,7,45,39,6,0,0,0,9,87,276,2,5,1.965807828,3478,229,6,430,430,0,31513,31471,42,241,241,0,100
7054e2b1adb928ee9180a71990f1e33a11c77883,2,4,2,2,0,0,0,2,88,0,1,2,0.918295834,1987,230,5,176,176,0,19341,19330,11,109,109,0,100
854a8a012fac73b68c2458cd92ca7026aef1f03d,6,113,35,78,0,0,0,8,86,245,3,5,2.002263064,3934,6,0,984,980,4,33312,32673,639,252,250,2,99.9300577
620861e313478faa9966fbbd89ff26b3fdd41deb,2,95,2,93,0,0,0,5,10,569,2,2,0.445693178,464,1,0,96,84,12,5331,4732,599,74,70,4,100
6598c749f18a7bcd40d1c0a434d8c06a68deaa72,8,510,38,472,0,0,0,3,19,2565,1,2,2.640075189,1028,5,2,378,247,131,11005,7269,3736,90,83,7,100
7b0a0e1294f9ee91e269aa4bd970e54ab42df779,2,17,0,17,0,0,0,3,5,578,1,1,0.873981048,177,133,0,48,43,5,1638,1509,129,19,18,1,100
b5189194952c73ce77d4c935b4d00a9a2d16684d,1,3,0,3,0,0,0,11,35,77,1,1,0,795,134,1,181,181,0,6085,6070,15,55,55,0,100
84be259863b4447f2bb898cc431bfb55e059b805,1,4,4,0,0,0,0,3,6,430,1,1,0,340,135,2,26,26,0,3236,3240,4,16,16,0,100
f0b0b951059c7ea792060498e3933852ac2094ab,1,7,5,2,0,0,0,5,13,1355,1,1,0,529,136,3,65,65,0,4887,4896,9,27,27,0,100
fb54a29db5a3a454f237341e7be60fb2f12de5fc,1,27,2,25,0,0,0,9,22,21,1,1,0,194,231,3,28,24,4,1656,1579,77,17,16,1,100
f912aa89901d748df0f31d5c7d411b69a709670d,1,1,8,7,0,0,0,3,10,895,1,1,0,187,137,4,34,38,4,1340,1402,62,12,13,1,100
8127189c4eff04fb9ffcf96c0e2989b51052fa0b,8,113,49,64,0,0,0,8,87,61,3,5,2.244395646,4935,7,1,1238,1227,11,41197,40755,442,313,310,3,100
5b8b16eb78a79e53450fc88d04a40530d2fd8731,4,34,15,19,0,0,0,3,10,910,2,2,1.160433323,525,1,0,125,121,4,4246,4068,178,37,35,2,100
add9fac419addf164fcfe1a35535080ca8b67543,2,132,6,126,0,0,0,6,49,70,1,2,0.974240833,1083,1,0,275,260,15,8661,7881,780,92,86,6,100
9afe462295b4cfb246d3dea19d4b7837ac09fe5d,0,0,0,0,0,0,0,0,0,0,0,0,0,0,163,0,0,0,0,0,0,0,0,0,0,100
ae4305d624ba82d7cd2af607c1c229177ededfc2,2,2,3,1,0,0,0,5,19,351,1,2,0.970950594,877,8,1,133,135,2,8587,8598,11,63,63,0,100
b8af8c90abe96e5921f0c54ac383a0cb448b1426,1,9,9,0,0,0,0,5,9,100,1,1,0,129,232,1,28,28,0,1235,1243,8,8,8,0,100
921f487b043f801e70427e98e2d4ae9a8ff877dd,2,68,6,62,0,0,0,2,11,508,1,2,0.534004273,294,138,5,46,36,10,2722,2290,432,25,21,4,100
5ee49fde2a1ec31e587c2123b823e3464bbada5e,1,4,0,4,0,0,0,4,6,88,1,1,0,308,233,2,83,82,1,2406,2375,31,21,21,0,100
0a6d098c8f88bc6e51632901674b4d45dd472d5d,2,12,0,12,0,0,0,7,24,377,2,2,1,1020,3,0,270,266,4,7816,7760,56,84,83,1,100
4b7b1a998085303a98cde198476679f5b27b0917,4,69,33,36,0,0,0,2,66,97,3,3,1.790669351,2083,266,0,564,552,12,16044,15748,296,188,188,0,100
2223c82c60b791ae2b66f6d78e1289ebe519cfa4,20,307,140,167,0,0,0,3,67,597,3,14,3.758883683,6878,139,3,1819,1789,30,53022,51913,1109,697,688,9,100
d1109efefd062613556d8bac47498ad0925b01b0,1,40,42,2,0,0,0,2,3,363,1,1,0,161,234,3,30,33,3,1506,1542,36,13,13,0,100
8c136a86fc125672e054bc5bcfdd65f8230ae07c,1,4,3,1,0,0,0,10,58,134,1,1,0,775,140,2,195,195,0,5953,5945,8,35,35,0,100
b96ce272d42283a3ee67e984d919c21bb65b587d,2,4,1,3,0,0,0,8,27,305,2,2,0.970950594,734,235,3,189,189,0,5323,5301,22,99,99,0,100
6fbda5bcee4d9a06fc83cd80533a9971b88bb417,2,7,5,2,0,0,0,10,38,145,1,2,0.41381685,1680,141,3,436,436,0,14089,14078,11,84,84,0,100
fdbc36e803cd85bfcb987991654351d76071a273,0,0,0,0,0,0,0,0,0,0,0,0,0,0,164,1,0,0,0,0,0,0,0,0,0,100
6677c80d71c1fedda535e5e6cd8f11b31126d2ff,0,0,0,0,0,0,0,0,0,0,0,0,0,0,165,2,0,0,0,0,0,0,0,0,0,100
a310bc2984b40acede1b8c346da0098591f7a61c,0,0,0,0,0,0,0,0,0,0,0,0,0,0,166,3,0,0,0,0,0,0,0,0,0,100
952d069645342cbde63a66eaafd34af59dd9420f,0,0,0,0,0,0,0,0,0,0,0,0,0,0,167,4,0,0,0,0,0,0,0,0,0,100
0d5c22298cacdf95531757048fd4b1596ed3b044,1,3,1,2,0,0,0,10,39,2,1,1,0,1507,142,4,409,408,1,12949,12918,31,67,67,0,100
7cf19213f9faf208dae7320f9c54012dcc6caeec,1,5,1,4,0,0,0,4,8,215,1,1,0,1044,7,0,275,274,1,9066,9025,41,42,42,0,100
235acae0a040dac438c77e137f6f3e62b2e7e49e,1,1,1,0,0,0,0,4,9,165,1,1,0,78,236,0,21,20,1,622,616,6,7,7,0,100
ec7b8245c14654c5f1dc4e6f412564d3b527c3e0,0,0,0,0,0,0,0,0,0,0,0,0,0,0,168,0,0,0,0,0,0,0,0,0,0,100
b24f88ecd70d73a8ca8752417317537eb3207343,16,175,86,89,0,0,0,8,88,347,5,7,3.466878667,8401,237,1,2094,2072,22,66373,66101,272,643,633,10,100
f36fecdfb0d3f40c6863068237e2812f15a5b23f,1,4,1,3,0,0,0,5,9,199,1,1,0,261,169,1,22,22,0,1955,1947,8,14,14,0,100
331fb430e86d27e30f8640f54e9774f6600761c9,9,87,14,73,0,0,0,9,26,981,3,3,2.396102331,866,11,0,229,219,10,6936,6404,532,139,131,8,100
b823084aadd870f8f14df8f01838fac8347e72bb,1,1,1,0,0,0,0,14,89,2,1,1,0,1335,238,2,338,338,0,9769,9768,1,132,132,0,100
c9446eec8ca3d048682703a2980504e66160a47f,0,0,0,0,0,0,0,0,0,0,0,0,0,0,170,2,0,0,0,0,0,0,0,0,0,100
8bad6b0b6724f15ec6173769bccd33184d842f8e,18,656,119,537,1,0,1,16,56,421,3,7,2.761851476,3512,143,0,639,554,85,31317,28632,2685,360,309,51,99.38218637
e6b9e9ad25b3b0538c0f864ab534cd16e9dd91b9,1,2,1,1,0,0,0,8,33,5,1,1,0,368,144,1,46,46,0,3102,3074,28,42,42,0,100
8792f162dfea3d471c7a0f5672984462ee434fba,3,36,4,32,0,0,0,4,21,488,1,2,1.399110835,1173,1,0,312,311,1,8346,8022,324,128,128,0,100
314f49372d913532e29d8a3ec0494bb1f2f2d2fc,1,1,1,0,0,0,0,7,20,84,1,1,0,399,239,3,80,80,0,3073,3073,0,54,54,0,100
3eadf7e875f810713b3a11a8e49ab2054128ac93,2,6,3,3,0,0,0,11,41,13,2,2,0.764204507,1615,2,1,436,435,1,13806,13783,23,79,79,0,100
5ab09475e097af72f70694518bb65bb6ac0d868d,8,41,2,39,0,0,0,3,59,725,2,2,2.830643239,2356,3,2,619,609,10,18821,18628,193,130,123,7,100
660b91af5854ea09582a56662e0361f5af6ab759,1,35,6,29,0,0,0,5,14,284,1,1,0,116,240,4,23,18,5,1209,983,226,6,5,1,100
71d9c6f35a69a0b3752ce5ca04edb588ec3d319e,0,0,0,0,0,0,0,0,0,0,0,0,0,0,171,3,0,0,0,0,0,0,0,0,0,100
43a5068429ae7da48f09ba1f124b4acbb53e3901,0,0,0,0,0,0,0,0,0,0,0,0,0,0,172,4,0,0,0,0,0,0,0,0,0,100
b6f35bf9151bbd92c3c47679945e4d1628220af0,4,28,10,18,0,0,0,4,72,242,1,3,1.626874823,1853,241,5,447,443,4,15165,15048,117,151,150,1,100
d16e960bea9cd17b3fe45231bec82cdaf023912e,0,0,0,0,0,0,0,0,0,0,0,0,0,0,84,0,0,0,0,0,0,0,0,0,0,100
b98aa7338b96ce0b37be310c345ef2cfc3aca86d,0,0,0,0,0,0,0,0,0,0,0,0,0,0,85,1,0,0,0,0,0,0,0,0,0,100
94118657d697b36a69a1f40c919f6f05b8631d8c,0,0,0,0,0,0,0,0,0,0,0,0,0,0,86,2,0,0,0,0,0,0,0,0,0,100
15e5bedbe470677ab8a8de4ecfa76c55f852c4e7,2,73,38,35,0,0,0,6,25,194,1,1,0.854466918,1018,8,0,257,250,7,8370,8175,195,68,68,0,100
6b1004105c29717cca1d1f38fd77d2e28ceff24c,0,0,0,0,0,0,0,0,0,0,0,0,0,0,173,4,0,0,0,0,0,0,0,0,0,100
1c781deb40c23c79c2cf201b70b79a34b0b2acbe,6,461,12,449,2,0,2,1,34,197,2,3,2.020369981,828,12,1,178,130,48,9284,6576,2708,113,87,26,97.89418726
c31f14408a614d85eb381ad7eea0458d7747de35,9,151,14,137,0,0,0,3,31,645,4,7,2.883366326,2688,4,3,636,613,23,22883,21940,943,176,169,7,99.94607226
91134031c5024527a1f4e975f1e24ef6da245fe6,1,184,0,184,0,0,0,6,13,2252,1,1,0,102,4,0,42,10,32,1967,961,1006,9,4,5,100
53e8825096394572aa41c9b40a4ccdd2a4e981ea,2,17,18,1,0,0,0,9,27,38,2,2,0.660962335,1055,4,0,274,275,1,8014,7992,22,88,88,0,100
5bffc7cfb4fe322b7ef9275906bc24cd61a2c759,0,0,0,0,0,0,0,0,0,0,0,0,0,0,174,3,0,0,0,0,0,0,0,0,0,100
05130e83a1f376e72ab565dcf3748dae0658483b,0,0,0,0,0,0,0,0,0,0,0,0,0,0,175,4,0,0,0,0,0,0,0,0,0,100
f31db4c397ea035259a21666551a381ef747ba1d,0,0,0,0,0,0,0,0,0,0,0,0,0,0,176,5,0,0,0,0,0,0,0,0,0,100
9d432d5db2ce2e3469b0e00bfb5685982ef59f85,11,527,200,327,1,0,1,7,33,163,4,7,2.374804699,4391,9,0,923,870,53,39764,37729,2035,249,232,17,99.83769161
ea02e10c2f025510158d13e1ab68b5581abaae80,0,0,0,0,0,0,0,0,0,0,0,0,0,0,3,0,0,0,0,0,0,0,0,0,0,100
6d907bd0094d7637a72479bb6fabfe2c0650109d,0,0,0,0,0,0,0,0,0,0,0,0,0,0,177,6,0,0,0,0,0,0,0,0,0,100
a6552f2100f402669fc9ae965bb9d66a8e828324,0,0,0,0,0,0,0,0,0,0,0,0,0,0,178,7,0,0,0,0,0,0,0,0,0,100
74bf4cdaae598bebd3f7956495b93d4e0b1242f6,3,242,3,239,1,0,1,1,42,26,1,2,0.903160778,2333,1,0,635,609,26,20979,19506,1473,120,108,12,99.85525602
bebe746bab27fb53ac2785720965ce897f6ecb62,11,243,11,232,0,0,0,3,93,139,3,6,2.10945402,7554,242,0,1750,1722,28,63035,61630,1405,532,520,12,100
cc6c2668992a92ef03a20a85ae74d441c1eff3be,1,1,1,0,0,0,0,1,2,610,1,1,0,644,243,1,118,118,0,5264,5264,0,29,29,0,100
929e505a8c2292d82f303e33561360c75a94c5d3,1,9,3,6,0,0,0,3,6,144,1,1,0,98,145,0,24,23,1,853,837,16,6,6,0,100
ddd0c9ca3f97e8eecc3d0cdf259ddc13a1daf8ed,0,0,0,0,0,0,0,0,0,0,0,0,0,0,0,0,0,0,0,0,0,0,0,0,0,100
b0ab2ffeb43a3e3c4aa66bf8fecd6ee836e6d359,0,0,0,0,0,0,0,0,0,0,0,0,0,0,179,6,0,0,0,0,0,0,0,0,0,100
4b8db750d10dd9145912de71f5a31a08c85ebe4b,0,0,0,0,0,0,0,0,0,0,0,0,0,0,0,0,0,0,0,0,0,0,0,0,0,100
678043f80e064248352cb073fd7385a82deebe9a,0,0,0,0,0,0,0,0,0,0,0,0,0,0,1,1,0,0,0,0,0,0,0,0,0,100
cacf361ebd5a79d2c3609da8e5a69e9428fe5af2,14,262,7,255,0,0,0,15,94,71,4,8,2.964999885,8537,244,2,1932,1896,36,70900,69402,1498,609,592,17,100
bdcb82077f9ad09d5632c411260eae310245d4b4,0,0,0,0,0,0,0,0,0,0,0,0,0,0,180,3,0,0,0,0,0,0,0,0,0,100
f9463baf0c0106ce23f8fbfffbd09893b54d4cac,0,0,0,0,0,0,0,0,0,0,0,0,0,0,181,4,0,0,0,0,0,0,0,0,0,100
4767af19731412e4bbc630bae1706eab320d167a,0,0,0,0,0,0,0,0,0,0,0,0,0,0,182,5,0,0,0,0,0,0,0,0,0,100
7ba3213eca2ad9be9dde97502c2d56896870d9d6,0,0,0,0,0,0,0,0,0,0,0,0,0,0,183,6,0,0,0,0,0,0,0,0,0,100
adfc526e386128dc8f572aae6093720d7954bd31,0,0,0,0,0,0,0,0,0,0,0,0,0,0,184,7,0,0,0,0,0,0,0,0,0,100
5dffddd005827137e35b72d837fdd51cd1ce4d5b,2,118,0,118,1,0,1,1,15,34,1,2,0.357646706,140,13,0,30,23,7,1943,1209,734,11,6,5,99.92768035
7435801a5043fcf4b1f80dfc4bef6ae554e0e711,0,0,0,0,0,0,0,0,0,0,0,0,0,0,185,8,0,0,0,0,0,0,0,0,0,100
503a572d8d4fce5866100fb38ed51fbd0f90ba71,0,0,0,0,0,0,0,0,0,0,0,0,0,0,2,2,0,0,0,0,0,0,0,0,0,100
4952a560ccb84278cc3b6b03cfd52deebfcdc304,0,0,0,0,0,0,0,0,0,0,0,0,0,0,186,9,0,0,0,0,0,0,0,0,0,100
715845523fed2e96bdbeba31a8f68db1d80c79f1,0,0,0,0,0,0,0,0,0,0,0,0,0,0,3,3,0,0,0,0,0,0,0,0,0,100
a2de206015949b9b19e38058234a42d42ff0f0a1,0,0,0,0,0,0,0,0,0,0,0,0,0,0,187,10,0,0,0,0,0,0,0,0,0,100
2c3b41f4b2c027f5553f5c248df13c8ecd9d2005,0,0,0,0,0,0,0,0,0,0,0,0,0,0,188,11,0,0,0,0,0,0,0,0,0,100
75858947f5a26f8760872dc7449724c12f750671,0,0,0,0,0,0,0,0,0,0,0,0,0,0,4,4,0,0,0,0,0,0,0,0,0,100
289c87a67a2307ea3d1b3bdceee7bc322f35a291,2,114,30,84,0,0,0,2,3,224,1,2,0.993170925,345,14,1,79,63,16,3515,2846,669,48,43,5,96.96491228
596b74b0a8cad4d7aad473e0e6e502c3fbce150f,0,0,0,0,0,0,0,0,0,0,0,0,0,0,245,3,0,0,0,0,0,0,0,0,0,100
c3da6d5ff3519f3f39cd34d578b91341a417d402,0,0,0,0,0,0,0,0,0,0,0,0,0,0,5,5,0,0,0,0,0,0,0,0,0,100
57b52a2921f5d8fc06a4d4ac27eaf2259fc96df8,0,0,0,0,0,0,0,0,0,0,0,0,0,0,189,10,0,0,0,0,0,0,0,0,0,100
e04acda4868a8db9b41f6b55d33b25c66bccebe3,0,0,0,0,0,0,0,0,0,0,0,0,0,0,190,11,0,0,0,0,0,0,0,0,0,100
9ba321760e03148bcf59049888a42b69a3286541,0,0,0,0,0,0,0,0,0,0,0,0,0,0,191,12,0,0,0,0,0,0,0,0,0,100
b064d8c3aad588c4975ddd0ad5bc24e12806e171,2,49,6,43,0,0,0,7,25,62,2,2,0.892121281,560,10,0,81,79,2,5106,4803,303,21,20,1,93.90243902
f9b483175a0a54c2cde417cde42a04f0e4e4cf44,1,14,9,5,0,0,0,6,11,83,1,1,0,135,246,2,38,35,3,1103,1051,52,8,7,1,100
d57f5d8a43395767c03a086907a63aedef3c3e29,0,0,0,0,0,0,0,0,0,0,0,0,0,0,192,12,0,0,0,0,0,0,0,0,0,100
e0afb12d49a65d38d340a283a20c0657729c8f48,3,117,0,117,3,0,3,1,1,0,1,1,1.57023235,0,6,0,4,0,4,382,0,382,3,0,3,99.84350548
85a5eeba1701abf6ff8f852174194307f4a892ae,3,85,31,54,1,0,1,6,27,131,3,3,1.34922377,503,87,0,90,88,2,4248,3996,252,29,29,0,97.48311848
c88ea51103367ee28c0bb03ce1aac04dfaaf2df5,3,50,12,38,0,0,0,7,26,389,2,3,1.27694356,679,11,1,118,117,1,5697,5367,330,23,22,1,100
848c799e31591e1ac82471fc564689173b6bb522,0,0,0,0,0,0,0,0,0,0,0,0,0,0,193,6,0,0,0,0,0,0,0,0,0,100
f7df0f1b8173a509c0342928710ad2036759fe5c,2,200,13,187,0,0,0,3,10,359,1,2,0.666119294,318,0,0,28,30,2,3870,2900,970,14,10,4,100
14a6b65d8160e278c4c5d6822025eceafa99663a,0,0,0,0,0,0,0,0,0,0,0,0,0,0,0,0,0,0,0,0,0,0,0,0,0,100
6ad08536043d6192de3b91b7799efbc60461222f,3,53,11,42,0,0,0,3,71,173,1,1,1.157705185,832,9,0,215,206,9,6925,6707,218,61,57,4,100
c04c0ab3e8e8147226337990f73f147d89cdf5a8,3,27,16,11,0,0,0,7,29,34,2,2,1.154522162,1259,12,2,288,290,2,10299,10246,53,50,50,0,100
f687fb7d12d5ed752b85f813fbd550e26105daeb,2,91,10,81,0,0,0,9,45,72,2,2,0.962262396,1922,267,0,557,533,24,16443,15934,509,135,129,6,100
8f80735197915e4e49eba2798ee595e530067468,0,0,0,0,0,0,0,0,0,0,0,0,0,0,6,1,0,0,0,0,0,0,0,0,0,100
c6ee27790db7905f8d9b5b02f2961d59cc76b5cb,2,36,1,35,0,0,0,8,35,86,1,2,0.303374836,1256,146,0,261,255,6,10492,10238,254,88,86,2,100
f8cb6f76cc8851848225ea35417bebdbc85ad6f7,1,49,27,22,0,0,0,12,46,10,1,1,0,1696,268,1,471,467,4,14593,14489,104,80,80,0,100
7aca24fb75beb48e9682cdc4988e5b6ac2ea1e90,0,0,0,0,0,0,0,0,0,0,0,0,0,0,1,0,0,0,0,0,0,0,0,0,0,100
25044cee5d945985aaadfc68e3da992eb4cc688e,4,85,8,77,0,0,0,4,9,2862,1,4,1.810135379,443,88,1,67,56,11,3320,2839,481,27,23,4,100
0ce149e877ed17a4b3876bf9012071ccf3e5f603,0,0,0,0,0,0,0,0,0,0,0,0,0,0,7,1,0,0,0,0,0,0,0,0,0,100
f93b37025e656a098e01bcf3e50647f0ca50fb80,6,268,4,264,0,0,0,16,47,52,2,4,2.07463018,4505,13,2,972,941,31,40310,38879,1431,249,238,11,100
94933c432f9562ab97f15d509fcd810f0514a890,0,0,0,0,0,0,0,0,0,0,0,0,0,0,10,1,0,0,0,0,0,0,0,0,0,100
5ae7fbecb3b02abe9aaa07e25e3b06073fd0c306,1,9,5,4,0,0,0,7,7,12,1,1,0,148,5,0,21,20,1,995,963,32,5,5,0,100
15d5b34305eb5b048316f1c658b8b910e2a0a188,0,0,0,0,0,0,0,0,0,0,0,0,0,0,194,1,0,0,0,0,0,0,0,0,0,100
9115e7d2da68a4d05d63415c6e691740c1cabed3,6,130,24,106,2,0,2,6,27,849,1,2,1.963597161,1464,7,0,291,283,8,10694,10310,384,70,63,7,99.88677109
f6e252f8bba84da7f46f69c5fe264e6d48eec017,2,15,0,15,0,0,0,5,19,921,2,2,0.996791632,1641,15,0,329,327,2,13411,13319,92,75,75,0,100
dca71ddfba883b57718c344cb97d45c52fe9482a,1,2,1,1,0,0,0,8,17,585,1,1,0,629,0,0,135,135,0,4804,4797,7,68,68,0,100
d528d27574ee1affbf615f7a537b160459297458,2,8,1,7,0,0,0,12,40,61,1,2,0.503258335,1211,247,0,301,301,0,9850,9768,82,85,85,0,100
10a1105351b03decf532255c84e6fbf7b166a14f,0,0,0,0,0,0,0,0,0,0,0,0,0,0,8,2,0,0,0,0,0,0,0,0,0,100
6050a8e6f7d572174d36946b9bee6968777e2850,10,143,29,114,0,0,0,5,92,679,4,9,2.8447615,5750,14,2,1354,1336,18,47628,46944,684,393,387,6,100
d5c8bf40dc92ff538daf7da1ad9bac0dbb7a26fd,0,0,0,0,0,0,0,0,0,0,0,0,0,0,195,1,0,0,0,0,0,0,0,0,0,100
98163440590852fa9d142c23e596e8975a322349,2,19,19,0,0,0,0,3,6,296,1,1,0.561752608,192,147,1,48,48,0,1656,1638,18,19,19,0,100
24fb2b066bcff11a8b667b0f90d43cb482fb0e81,1,1,1,0,0,0,0,14,72,45,1,1,0,746,16,1,189,188,1,5974,5967,7,53,53,0,100
1b5ca4c5346c1b2fad0d276b509a56f78489755d,8,41,21,20,0,0,0,9,60,331,4,5,2.754881628,1727,248,1,357,353,4,13247,13112,135,87,85,2,94.24517146
72243644900495436975161bf797bc53f4cf0d0e,0,0,0,0,0,0,0,0,0,0,0,0,0,0,196,2,0,0,0,0,0,0,0,0,0,100
a9672da056cfda5bda29fb9589498d652aad46d9,0,0,0,0,0,0,0,0,0,0,0,0,0,0,197,3,0,0,0,0,0,0,0,0,0,100
714423c9135653fd3351cfe9282f05ae1fa0870b,0,0,0,0,0,0,0,0,0,0,0,0,0,0,9,1,0,0,0,0,0,0,0,0,0,100
09118ca750208afc8f01638531555aada33e9648,16,319,34,285,0,0,0,5,57,362,6,12,3.488059005,5596,0,0,1348,1294,54,46875,45274,1601,473,455,18,99.83481313
e3e7f2e070674d00eba8171123ffe0b7d58751b1,0,0,0,0,0,0,0,0,0,0,0,0,0,0,10,2,0,0,0,0,0,0,0,0,0,100
5932b1af358288b07f382b40939b48150f844fd6,17,562,290,272,1,0,1,7,50,350,3,8,2.624284849,7900,15,1,1769,1741,28,64506,62585,1921,631,617,14,94.78224279
bdd110dfe7481815d3a19ebc6acb4fdefacc93ed,1,9,8,1,0,0,0,8,21,206,1,1,0,399,0,0,80,80,0,3083,3073,10,54,54,0,100
d1f341864ee026c0ea30c7f76f1fa5acad25dc09,3,16,3,13,0,0,0,9,51,394,2,3,1.359992492,2195,249,1,509,506,3,16487,16401,86,147,146,1,98.8372093
df85aa7a6efbadf5fba73655b6ab36327d8770da,11,239,72,167,0,0,0,7,52,0,3,6,1.665877313,4828,16,1,1173,1152,21,38285,37248,1037,345,336,9,100
7be3a6f7499970dbb026cbe1bd92e04c1865ebf0,3,14,3,11,0,0,0,4,22,156,1,2,1.522189872,1719,148,0,356,354,2,12244,12189,55,157,156,1,100
e607ba1a8bc45d671fb76bf0c9c4059cda99d36d,1,1,1,0,0,0,0,5,23,10,1,1,0,477,2,0,116,116,0,3064,3064,0,49,49,0,100
d0c1b30c05a587839015db1c3ff1dafc959294fd,7,150,20,130,0,0,0,7,35,46,3,4,1.647941229,3432,17,2,591,577,14,30816,29916,900,182,175,7,99.97914929
af203374232bc1ba6f7c42731619416b40b1db1c,2,6,4,2,0,0,0,12,53,18,1,1,1,1263,18,3,364,364,0,9263,9231,32,115,115,0,100
c6661ff15c15856ae030c95ffbbf808ff0850d5a,2,9,1,8,0,0,0,5,26,210,1,1,0.970950594,974,8,0,237,235,2,7888,7848,40,65,65,0,100
9f5b7861e6bf4975b84cd9db0f3397d128cb3157,1,17,1,16,0,0,0,2,2,677,1,1,0,136,2,0,31,28,3,1047,961,86,12,11,1,100
d9ebc242be55be0d898d95e02283a84cc887807b,1,40,33,7,0,0,0,8,52,47,1,1,0,750,269,0,231,231,0,6304,6320,16,31,31,0,100
48df6544f92df81dc49820b8cd2900666cb14e0a,1,57,0,57,0,0,0,12,53,250,1,1,0,951,0,0,216,205,11,7494,7137,357,38,36,2,100
5955fcd1390910b714b13716b8c2ffc8fc5932d8,3,5,2,3,0,0,0,5,24,125,1,2,1.556656707,1375,3,1,379,378,1,9603,9568,35,164,163,1,100
8ca94c8de23c2453385656862244b268ea6482fe,0,0,0,0,0,0,0,0,0,0,0,0,0,0,11,0,0,0,0,0,0,0,0,0,0,100
c95aba218b9318ce44abf574faff62908f24916d,2,41,18,23,0,0,0,12,49,85,1,1,0.572580466,2861,250,1,762,756,6,23963,23863,100,160,160,0,100
1e0962d70008cccfb9d4f1db624963faa74d0c19,4,120,0,120,0,0,0,9,40,147,2,4,1.674246724,1939,9,1,362,353,9,16869,16194,675,102,97,5,100
65a62b05369a2dbb75d26971dc071b28b1119331,1,4,0,4,0,0,0,13,34,1,1,1,0,925,89,0,222,222,0,7330,7286,44,44,44,0,100
e202e9e483e41b00dc5309395e5daaa710fb6765,0,0,0,0,0,0,0,0,0,0,0,0,0,0,12,1,0,0,0,0,0,0,0,0,0,100
6435223d8687423d8e6ff1c35248a368c9720879,0,0,0,0,0,0,0,0,0,0,0,0,0,0,198,0,0,0,0,0,0,0,0,0,0,100
cf455a527d6df8c98e788073628fc35fcd46758a,2,144,17,127,0,0,0,5,19,718,2,2,0.133697961,330,251,1,96,63,33,3602,2830,772,29,20,9,100
7423addb220330cceadbf690d3bf4e4e5fcde99f,12,292,257,35,0,0,0,5,95,650,3,8,2.631503201,7391,252,2,1863,1845,18,59820,59615,205,485,480,5,100
67a7367a786b93e596ab64b6036b6be21a11b459,1,8,4,4,0,0,0,13,35,38,1,1,0,927,10,1,222,222,0,7330,7330,0,44,44,0,100
c789f2d7e5efa3d7c85829016541097319006651,2,16,2,14,0,0,0,2,7,470,1,1,0.503258335,323,5,0,94,90,4,2499,2380,119,27,27,0,100
e2ba3051d6c18d84b79d803490227d612e0e7858,3,139,104,35,0,0,0,3,5,381,1,1,1.540597435,352,270,0,58,55,3,2762,2532,230,31,33,2,98.47726325
343b7832fcb1ce201f0000339cd5b63ac1f6f54b,0,0,0,0,0,0,0,0,0,0,0,0,0,0,0,0,0,0,0,0,0,0,0,0,0,100
fb9f1e96e2dbd1588b2be4f8a63854a2e913dc1e,6,222,52,170,0,0,0,7,51,69,3,4,2.058211843,3902,6,1,1047,1014,33,32887,31985,902,213,204,9,100
f5dcc7b7036414f3e382d172dbe10ed83be90bda,1,7,6,1,0,0,0,13,52,0,1,1,0,1778,7,2,481,481,0,15048,15035,13,84,84,0,100
bb10c16ffe1b3911af3161c74b45069fa8add94d,1,5,0,5,0,0,0,12,43,16,1,1,0,1211,253,2,310,309,1,9885,9854,31,87,87,0,100
72389767ab1094e96e07f284be3bb0f3199e3e2a,0,0,0,0,0,0,0,0,0,0,0,0,0,0,199,0,0,0,0,0,0,0,0,0,0,100
b5fe0896d630dbdf5a48452930ad1023f3a0d2cb,2,31,1,30,0,0,0,7,33,128,2,2,0.337290067,1272,19,0,271,269,2,11009,10807,202,64,63,1,100
6d94f39cf3b6207bc095310eebbe3292071be68b,24,1486,67,1419,5,0,5,12,96,672,3,16,3.544464989,8334,2,0,2180,1984,196,73400,65094,8306,811,728,83,93.19754795
7be35c3fff13a6ed9996860c081d9760bfa07e4d,0,0,0,0,0,0,0,0,0,0,0,0,0,0,200,1,0,0,0,0,0,0,0,0,0,100
7526a69d5a62e7b7839576c757ff00cfb8a8748e,0,0,0,0,0,0,0,0,0,0,0,0,0,0,201,2,0,0,0,0,0,0,0,0,0,100
bbbadeaaabf46270f5f3d3185752280a65955ee7,0,0,0,0,0,0,0,0,0,0,0,0,0,0,1,0,0,0,0,0,0,0,0,0,0,100
2d4edf87728b45b6498e2d7772d87829d7079ef8,2,8,8,0,0,0,0,5,13,540,1,1,0.954434003,1035,0,0,206,206,0,8514,8562,48,59,59,0,100
f484b205013f6e256a45a55c5a2b2b54efcc0769,0,0,0,0,0,0,0,0,0,0,0,0,0,0,149,0,0,0,0,0,0,0,0,0,0,100
eed7817efc9fb961379a8f47d76a78a3bd201848,0,0,0,0,0,0,0,0,0,0,0,0,0,0,17,0,0,0,0,0,0,0,0,0,0,100
ea653e0388aa45a1eeeb016592ca155cda8eb480,2,37,11,26,0,0,0,8,34,34,2,2,0.979868757,1294,254,0,279,271,8,11179,11009,170,65,64,1,100
cb0fe79e3f41e1b7bf9a52202f71b23fe1326800,1,2,0,2,0,0,0,6,8,700,1,1,0,119,11,0,29,28,1,888,874,14,6,6,0,100
0ac9534915e55f21bb44e7a4da2439055d0620a8,1,2,2,0,0,0,0,11,27,161,1,1,0,909,255,1,223,223,0,7342,7334,8,61,61,0,100
47f2e77bf798547e652e16cf10adaa818ded1e3e,3,14,7,7,0,0,0,8,80,379,1,2,1.35666952,1420,256,2,371,369,2,11208,11159,49,96,96,0,100
4d44690a79478e6a0eb5793a815215c131e4f896,0,0,0,0,0,0,0,0,0,0,0,0,0,0,202,2,0,0,0,0,0,0,0,0,0,100
e04c4f5c332322e191e1d8abdadc250bf03e2840,0,0,0,0,0,0,0,0,0,0,0,0,0,0,203,1,0,0,0,0,0,0,0,0,0,100
b3563fd319fa530021cb7358c1cc232f06bda24a,0,0,0,0,0,0,0,0,0,0,0,0,0,0,204,2,0,0,0,0,0,0,0,0,0,100
121ccbd8549a0ead4ab8e0258024317ba8b75a14,1,8,1,7,0,0,0,6,19,591,1,1,0,890,0,0,79,79,0,8214,8142,72,42,42,0,100
a6cdb608b21d8c4d1c843ca7d2d974fc2b65b93c,3,21,8,13,0,0,0,13,53,184,2,3,1.124259237,2186,257,3,583,581,2,18304,18218,86,114,113,1,100
984b359cf9cf0e951af274c8319ace2f4e2a3a74,1,5,4,1,0,0,0,3,3,207,1,1,0,147,150,0,32,31,1,1059,1047,12,12,12,0,100
d3a08b6eabcc50536c468db2d1328df54ee27fce,10,455,44,411,0,0,0,17,97,161,4,7,2.670784602,6767,12,0,1724,1643,81,56364,53680,2684,500,484,16,93.82477808
4229cb3c7a9e7109c883431bc5fb502339d077ec,0,0,0,0,0,0,0,0,0,0,0,0,0,0,205,2,0,0,0,0,0,0,0,0,0,100
cc2e6af70586ade872181e51792577934a2141eb,2,95,5,90,0,0,0,13,56,520,1,2,0.989587521,1108,271,0,327,312,15,8765,8262,503,117,115,2,100
98b54160c5d2fd308a2f2be9269695a675a287f8,3,22,5,17,0,0,0,11,81,188,1,2,1.427765505,1438,90,0,389,386,3,11133,11027,106,129,127,2,100
015577ecf4976a4b15e0e86d57b786cd21b2e86b,2,26,0,26,0,0,0,7,11,1168,1,2,0.235193382,371,4,0,50,46,4,2818,2678,140,24,22,2,100
3e035c45a9dd695471d0927bbcdd72108094c828,4,271,6,265,2,0,2,1,8,982,2,2,1.512628441,198,5,1,70,33,37,2610,1349,1261,33,16,17,99.84145858
5e7f8949fd220533510c7ef92e38ac204612a509,3,5,35,30,0,0,0,2,98,51,2,3,1.5,589,13,1,60,64,4,4611,4770,159,33,34,1,100
10bcaa8091b548efd82e993d6844623f93f1e1f8,6,75,19,56,0,0,0,10,54,381,2,4,2.098335797,3017,272,1,708,698,10,24225,23801,424,193,191,2,100
ac808af07c69191e34a279be169b8f01e5d35240,10,199,133,66,0,0,0,3,57,142,2,4,2.493792705,7607,273,2,2063,2050,13,60065,59666,399,580,574,6,100
695480e9367ef6cb86fb18cb552e94b82f106b45,0,0,0,0,0,0,0,0,0,0,0,0,0,0,206,1,0,0,0,0,0,0,0,0,0,100
8f6cb0e9afa07feb0fe615663650c4ee580fd657,0,0,0,0,0,0,0,0,0,0,0,0,0,0,207,2,0,0,0,0,0,0,0,0,0,100
bcb9ea240614299280d8051b6b43a9927dcbb2de,0,0,0,0,0,0,0,0,0,0,0,0,0,0,208,3,0,0,0,0,0,0,0,0,0,100
9b89a3fda36af8b78146cc4dd914c7985739e10b,0,0,0,0,0,0,0,0,0,0,0,0,0,0,209,4,0,0,0,0,0,0,0,0,0,100
8fe3edd2a7d480408ec3d43762cfb43887d5fa19,8,346,33,313,0,0,0,13,56,785,2,4,2.432262028,4931,274,3,1341,1288,53,41591,39723,1868,344,321,23,100
47ccfaf7cf2301f65ff1bcf1121bb0b232bc9692,0,0,0,0,0,0,0,0,0,0,0,0,0,0,210,5,0,0,0,0,0,0,0,0,0,100
70ebb22829a4dae8f06031b045f4848a4c22fc05,0,0,0,0,0,0,0,0,0,0,0,0,0,0,211,6,0,0,0,0,0,0,0,0,0,100
3680ab428969bcc23606537d1dab49171bcc37ab,0,0,0,0,0,0,0,0,0,0,0,0,0,0,212,7,0,0,0,0,0,0,0,0,0,100
fd1aad38fb762b07ee225ffae002e980658e85fd,0,0,0,0,0,0,0,0,0,0,0,0,0,0,213,8,0,0,0,0,0,0,0,0,0,100
cd177f83d24dbce0a992e3c2cf7c2f3001f0f806,0,0,0,0,0,0,0,0,0,0,0,0,0,0,214,9,0,0,0,0,0,0,0,0,0,100
b0c85dd99aaabe296875847fdab0e0d5fe6cd846,0,0,0,0,0,0,0,0,0,0,0,0,0,0,215,10,0,0,0,0,0,0,0,0,0,100
e159f767820b3e25a5cf9f351586126201cda387,0,0,0,0,0,0,0,0,0,0,0,0,0,0,216,11,0,0,0,0,0,0,0,0,0,100
a2ccfb9f3577e911103041d8d4b91c169697f6a1,29,1698,235,1463,11,0,11,9,57,335,3,12,3.887002911,6315,151,0,1645,1450,195,59793,51885,7908,528,426,102,93.2016711
54042d35b29f91b46fd033a6378dedf1ff47c5d9,8,354,24,330,3,0,3,1,8,2,2,6,2.374488639,523,152,1,127,90,37,5848,4229,1619,72,42,30,99.87251867
c652dd4d926e6dfbb4b0cd5c75e66fc76f1558ac,0,0,0,0,0,0,0,0,0,0,0,0,0,0,217,11,0,0,0,0,0,0,0,0,0,100
6eb72fa456e527baeb144245421e29bffa98592b,1,8,4,4,0,0,0,2,9,18,1,1,0,224,275,4,66,66,0,1617,1596,21,16,16,0,100
624583882eddc1a8a5adf2fb674b31dcfe468333,0,0,0,0,0,0,0,0,0,0,0,0,0,0,218,12,0,0,0,0,0,0,0,0,0,100
6b503eeb8866b67d0cb09d60c389230a28c1efbc,0,0,0,0,0,0,0,0,0,0,0,0,0,0,0,0,0,0,0,0,0,0,0,0,0,100
75e678da7595420a729226e9ce2b575facb7bbb5,5,20,13,7,0,0,0,7,35,281,1,1,2.268641957,1598,0,0,461,454,7,12861,12773,88,80,80,0,100
c99e15b3711e0aebb4c1db086553f915ecd471d1,1,1,1,0,0,0,0,3,4,1932,1,1,0,112,1,1,20,20,0,750,742,8,12,12,0,100
b02443ec117458254f919ec60d2dee5fdf3ef058,8,24,354,330,0,0,0,2,9,16,2,6,2.374488639,746,91,0,90,127,37,4229,5848,1619,42,72,30,99.87251867
024f5d52d0a972616362ac9b15ed7a417384026f,29,235,1698,1463,0,0,0,9,58,0,3,12,3.887002911,7340,92,1,1450,1645,195,51885,59793,7908,426,528,102,93.2016711
3c9a437094f800467fa80cdccefefb6538839496,0,0,0,0,0,0,0,0,0,0,0,0,0,0,219,13,0,0,0,0,0,0,0,0,0,100
ec3c6dba44edc353adddb4f2d30decff2446e401,4,80,10,70,1,0,1,8,16,97,2,3,1.35746633,376,0,0,51,45,6,3193,2792,401,28,26,2,99.92083911
91d2b8ea5b7b968d243717205903f31e3a2d574f,0,0,0,0,0,0,0,0,0,0,0,0,0,0,220,14,0,0,0,0,0,0,0,0,0,100
58a58956e30c2d0699ead083aca6f27803394555,0,0,0,0,0,0,0,0,0,0,0,0,0,0,221,15,0,0,0,0,0,0,0,0,0,100
43c134ddf859d7c06be18937d9daf3b26089968f,0,0,0,0,0,0,0,0,0,0,0,0,0,0,222,16,0,0,0,0,0,0,0,0,0,100
69d403e8ca6b22648457e1df51b7e549b6882f3e,0,0,0,0,0,0,0,0,0,0,0,0,0,0,223,17,0,0,0,0,0,0,0,0,0,100
6a49d94faf9613d3b10c33373500ca5e09b8dc7f,0,0,0,0,0,0,0,0,0,0,0,0,0,0,153,2,0,0,0,0,0,0,0,0,0,100
ed2755dcce37318ffce21e5ecd7692416aa49a1d,2,169,0,169,2,0,2,1,1,0,1,2,0.990863141,0,154,3,23,0,23,766,0,766,13,0,13,99.9012053
30a099551210b7f5ec6d5cffa39561439278afea,1,1,1,0,0,0,0,3,4,42,1,1,0,288,14,0,63,63,0,1886,1886,0,63,63,0,100
e8661ecbc49e750b3e962aa999f11b2a94d8fe27,8,474,10,464,2,0,2,2,38,262,2,5,1.534586258,1228,155,4,298,222,76,12054,9845,2209,160,117,43,99.82252021
cc601d7371fae1dbc16b55d1ca84f06b745700dc,2,9,11,2,0,0,0,2,7,16,1,1,0.992774454,171,156,5,36,37,1,1153,1158,5,20,20,0,100
371f967f605ec72e1d1a4fc2030d008cbede27fa,40,1354,340,1014,7,0,7,8,58,586,5,23,3.923540244,8652,2,0,1414,1316,98,78590,73294,5296,751,684,67,99.54760031
668addac196bafcea7f10f19ef74428f74f778fd,1,13,5,8,0,0,0,2,2,498,1,1,0,130,157,6,21,19,2,1121,1079,42,10,10,0,100
e50372820f146636ba606695ea4bd8ae91d82e55,4,123,5,118,0,0,0,3,36,293,2,3,1.208706301,2328,2,2,639,618,21,18087,17464,623,185,182,3,100
0e947170b60b2903a4217216a65edded07b90c52,40,1318,1320,2,3,0,3,12,99,83,4,22,4.198047647,16140,276,1,3853,3834,19,126883,127103,220,1298,1292,6,96.28621427
7de3579343aecff08a8507cb7a131855929ca828,0,0,0,0,0,0,0,0,0,0,0,0,0,0,277,1,0,0,0,0,0,0,0,0,0,100
30a275d4704ec82a3a860fd239274972ecec41af,3,125,27,98,0,0,0,11,82,71,1,2,0.413888922,1454,278,2,404,389,15,11722,11128,594,133,129,4,100
aa4bbb08f0b18cfbfc7e0f54e5021bf702445bec,1,9,0,9,0,0,0,17,59,20,1,1,0,533,224,6,73,72,1,3988,3932,56,21,21,0,100
3d0fcedb025b5a2669fa7f32af826323a3c1d58f,0,0,0,0,0,0,0,0,0,0,0,0,0,0,225,7,0,0,0,0,0,0,0,0,0,100
765ea583b23d25ecc919d520092747c4158466a5,24,1233,209,1024,10,0,10,8,60,53,3,11,3.620281557,6226,158,5,1623,1517,106,55825,50256,5569,435,374,61,93.03454715
6ecad6e57be5f880c98fc7fa7179fe3e61226382,3,58,7,51,0,0,0,3,32,23,1,2,1.370737568,1641,3,2,376,369,7,12597,12389,208,103,100,3,94.47822514
c6cac0301707e0d5ac983902a0c2aeefb148c872,1,36,2,34,0,0,0,8,37,17,1,1,0,754,3,0,254,244,10,6019,5818,201,35,35,0,100
ba5b2dba53387b11707a073538e7b804be19e0b3,3,10,2,8,0,0,0,15,61,587,2,3,1.459147917,2121,279,3,571,570,1,17766,17735,31,120,119,1,100
e1b205c61583e0624286d83e539d9b06702a4388,0,0,0,0,0,0,0,0,0,0,0,0,0,0,280,4,0,0,0,0,0,0,0,0,0,100
72910c4f98fcc2d9a315aaea909196e30b55e821,1,81,52,29,0,0,0,6,16,464,1,1,0,148,4,1,30,23,7,1514,1297,217,6,6,0,100
2e69f922364285eda332b2da208ce1adb7fa8281,3,29,3,26,0,0,0,2,9,2715,1,1,1.291100275,443,93,0,69,65,4,2508,2359,149,24,24,0,100
506ffc97ca641f86da4e90b821061162f15c0fef,0,0,0,0,0,0,0,0,0,0,0,0,0,0,226,5,0,0,0,0,0,0,0,0,0,100
ffd2e2b5df934f5266e362e6b8ad1a6d4dfa6501,0,0,0,0,0,0,0,0,0,0,0,0,0,0,227,6,0,0,0,0,0,0,0,0,0,100
1ccb7c715cb0ff0f60f27d21c77a810e6640e01c,0,0,0,0,0,0,0,0,0,0,0,0,0,0,228,7,0,0,0,0,0,0,0,0,0,100
14b57dbdff26005af674d331d86604c2999c32e5,0,0,0,0,0,0,0,0,0,0,0,0,0,0,15,1,0,0,0,0,0,0,0,0,0,100
f1df13dc72501d5e4001c72aca2ee2733a047347,0,0,0,0,0,0,0,0,0,0,0,0,0,0,13,0,0,0,0,0,0,0,0,0,0,100
5783b701c16df944c7472380828db4e643e6a3b6,4,194,95,99,0,0,0,5,10,408,1,4,1.610306188,510,281,5,87,68,19,3694,3352,342,31,27,4,100
9d6f1f6baec75a393d2effa7359ae7ac028fa6b5,0,0,0,0,0,0,0,0,0,0,0,0,0,0,0,0,0,0,0,0,0,0,0,0,0,100
721fcb413ce7720772c4b14d5cdf07bfd0537c57,0,0,0,0,0,0,0,0,0,0,0,0,0,0,1,1,0,0,0,0,0,0,0,0,0,100
60f878e599a37a4befaa21b89fa8982a8d1ace90,0,0,0,0,0,0,0,0,0,0,0,0,0,0,229,5,0,0,0,0,0,0,0,0,0,100
3d0c98779f16c7f0c6faa2b441877458ea152675,12,548,27,521,3,0,3,1,28,185,2,9,2.750679756,925,159,2,248,180,68,10109,7196,2913,126,89,37,99.76008397
2c86bcac2acbde694d1f98e47eb7a3c7bbd0dbce,1,5,10,5,0,0,0,6,31,16,1,1,0,258,4,2,58,59,1,2129,2144,15,4,4,0,100
97ecfc7eb2b78d19fc125076e1e3961be230f83f,0,0,0,0,0,0,0,0,0,0,0,0,0,0,2,2,0,0,0,0,0,0,0,0,0,100
9647c913c1ae7c175c45933a51fd96c0fb168897,0,0,0,0,0,0,0,0,0,0,0,0,0,0,230,6,0,0,0,0,0,0,0,0,0,100
a30c6d4e9c3855c15978bf1e50f287831bbae8bc,0,0,0,0,0,0,0,0,0,0,0,0,0,0,3,3,0,0,0,0,0,0,0,0,0,100
784b606ddfa2149535b437483051a68859689a9d,9,540,14,526,1,0,1,3,100,965,4,7,2.355519433,3001,5,2,614,527,87,26969,23421,3548,169,147,22,99.88025745
dff690a00e3ef690ffd584b07d243586d64b31b7,5,23,26,3,0,0,0,1,7,19,1,4,1.772721634,745,160,2,154,155,1,5214,5272,58,77,77,0,100
df8502ea4962e95ad02a7e05b5bb1ae50ccd0bcb,3,51,2,49,0,0,0,5,75,442,2,2,1.50970456,927,16,1,247,231,16,7573,7271,302,75,71,4,100
cfee9cefab5b97696449ad6c2977b1f379fdae2f,1,2,2,0,0,0,0,3,14,9,1,1,0,824,6,3,106,106,0,6232,6232,0,31,31,0,100
a78e208ddaf249134a6e3ab0df14cb9f609b40c2,0,0,0,0,0,0,0,0,0,0,0,0,0,0,231,5,0,0,0,0,0,0,0,0,0,100
2a9b1ff1740ff18aa7dc53d434e5576ee8101d6c,2,54,5,49,0,0,0,8,12,440,2,2,0.998134178,387,0,0,77,66,11,3103,2712,391,20,19,1,100
27dc446db963dea71d7db559646d3a7385b83a6f,2,5,54,49,0,0,0,8,13,0,2,2,0.998134178,435,94,1,66,77,11,2712,3103,391,19,20,1,100
f30fd67f053e62035a7edc3a1126c369850c3bfa,2,53,4,49,0,0,0,8,14,0,2,2,0.999777967,387,1,1,77,66,11,3103,2712,391,20,19,1,100
76011077145d0eb6c8d683ffc7ceee6614ba2573,1,1,1,0,0,0,0,8,12,0,1,1,0,168,282,3,28,28,0,1151,1152,1,5,5,0,100
00fb162d880489dfdd744c136d128bfaeaadde24,7,633,9,624,0,0,0,9,44,183,3,5,2.207282909,4377,17,2,654,593,61,45232,39854,5378,286,248,38,100
0d0a3899443f7e701aa4c5c152ad601e9f913e52,0,0,0,0,0,0,0,0,0,0,0,0,0,0,283,2,0,0,0,0,0,0,0,0,0,100
5c9cb78154da808debd1fa9d8d4cacbcc4a3f7bf,0,0,0,0,0,0,0,0,0,0,0,0,0,0,232,6,0,0,0,0,0,0,0,0,0,100
60b7d2ac75828a806b64322599e09fe3376ce7b6,0,0,0,0,0,0,0,0,0,0,0,0,0,0,233,7,0,0,0,0,0,0,0,0,0,100
c06221ae636babeabdeff042853286051f46cf07,1,1,1,0,0,0,0,13,45,3,1,1,0,1099,95,2,266,266,0,8840,8840,0,48,48,0,100
d0147981ceb9a0afdef58ee53fea6c5d2379b0f3,0,0,0,0,0,0,0,0,0,0,0,0,0,0,234,5,0,0,0,0,0,0,0,0,0,100
22ca98b04cb8c66c60ca1f688029d2fe9682e7af,0,0,0,0,0,0,0,0,0,0,0,0,0,0,235,6,0,0,0,0,0,0,0,0,0,100
ef20f8ff337519166ae837d8a884ef5f875ea84b,1,2,1,1,0,0,0,10,27,759,1,1,0,281,284,3,46,46,0,2692,2684,8,16,16,0,100
e58e7d42b47326feb97779f4e4147c78cefc866c,0,0,0,0,0,0,0,0,0,0,0,0,0,0,236,7,0,0,0,0,0,0,0,0,0,100
9e2a49bcce4bedf0fcf932e05917b205ea569b92,0,0,0,0,0,0,0,0,0,0,0,0,0,0,237,8,0,0,0,0,0,0,0,0,0,100
d727cef743bf78293c3affed5f003fab3d1b02de,3,24,7,17,0,0,0,1,6,21,1,3,1.469064052,389,161,1,75,73,2,3048,2959,89,35,34,1,100
fc0ae7713acfe0b24e0c56325a0e9b92283ea3a5,1,20,16,4,0,0,0,9,15,18,1,1,0,267,285,3,50,49,1,1962,1951,11,15,15,0,100
61c2fe3ebeb7a71620bc9d0a231710d2b42aa800,2,67,35,32,0,0,0,8,38,60,1,1,0.430551867,1048,5,0,309,308,1,8341,8156,185,39,39,0,100
4d0f5ce213a49fcd8509a2ea5f6a0bb733c0c186,1,41,45,4,0,0,0,8,39,0,1,1,0,785,6,1,253,254,1,6068,6093,25,35,35,0,100
37d64be5c3f88de935919b806baafa5d8e250f5b,2,3,3,0,0,0,0,16,62,36,1,1,0.918295834,2994,2,2,784,784,0,24938,24933,5,135,135,0,100
521118c82585d959cd22262d0012eb8c6b17c05a,2,18,1,17,0,0,0,2,12,351,1,2,0.74248757,833,286,4,152,152,0,7574,7461,113,50,50,0,100
f5cd728d561a3e58a6b69c8b635e04769103a67f,5,168,21,147,0,0,0,6,63,207,2,5,1.725653935,4343,287,5,829,816,13,39318,37979,1339,271,269,2,100
6b7837028c671334dd2e44f03e6d464b9812778b,0,0,0,0,0,0,0,0,0,0,0,0,0,0,1,0,0,0,0,0,0,0,0,0,0,100
36956bc0c4747c93d1b0c6e234168f18bdbaebb2,1,21,29,8,0,0,0,16,64,0,1,1,0,1910,6,0,527,528,1,16233,16290,57,87,87,0,100
2ac034253386ca8d173f67317505076783cedbf7,0,0,0,0,0,0,0,0,0,0,0,0,0,0,238,8,0,0,0,0,0,0,0,0,0,100
6ece28fd957ca2e90936914bdfd26c7c35c1f306,0,0,0,0,0,0,0,0,0,0,0,0,0,0,239,9,0,0,0,0,0,0,0,0,0,100
2fbfb5572e3ae7e71e71b70e391844d98293599a,0,0,0,0,0,0,0,0,0,0,0,0,0,0,240,10,0,0,0,0,0,0,0,0,0,100
95923fba04e99c9bcf4af70fe8faf834c802fdf9,0,0,0,0,0,0,0,0,0,0,0,0,0,0,241,11,0,0,0,0,0,0,0,0,0,100
e0eb318c247ba68e3b570feb7298f488bcaf8bf3,1,4,4,0,0,0,0,18,43,81,1,1,0,761,3,0,125,125,0,5746,5746,0,41,41,0,100
159afa8044fac64436268e1f64bfe43beff65096,1,11,33,22,0,0,0,15,94,319,1,1,0,1235,162,2,314,317,3,8847,8899,52,127,127,0,100
076d83c3face54b53159faa066e398f622d836b0,6,118,13,105,0,0,0,7,59,305,3,5,2.078347697,3887,288,6,841,822,19,31793,31185,608,290,285,5,100
73bf850fd77ef550aaffaa6c034c4fe4dc29b7af,0,0,0,0,0,0,0,0,0,0,0,0,0,0,242,11,0,0,0,0,0,0,0,0,0,100
64b24351c6fb45d04f927b6cfd6f61e486e7fe23,0,0,0,0,0,0,0,0,0,0,0,0,0,0,243,12,0,0,0,0,0,0,0,0,0,100
d485860937e0fb40dfd69566754a637fb1c0c132,1,154,19,135,0,0,0,11,32,86,1,1,0,987,258,0,259,239,20,8726,7949,777,66,63,3,100
683e267bdf2e9461fbfdefe514e1856e32ce8e4b,1,1,1,0,0,0,0,10,20,84,1,1,0,681,163,2,170,170,0,6036,6028,8,32,32,0,100
ec48c09a847db001fba6f2ef909d4f5d20ff25b9,0,0,0,0,0,0,0,0,0,0,0,0,0,0,244,10,0,0,0,0,0,0,0,0,0,100
3ff785a8950303cc9c33ff20c1caffecc5b464e5,5,25,11,14,0,0,0,18,60,106,3,5,1.762014135,963,1,0,136,134,2,7453,7344,109,64,62,2,100
1e8fa7e59b332e3543d797618879510f70ff8fe4,4,52,57,5,0,0,0,5,76,65,2,3,1.625116278,1932,18,0,547,551,4,14730,14787,57,191,192,1,100
fa2e5b49aa0d71464e850d631bef2640b2e4ef55,10,746,45,701,1,0,1,19,101,83,4,9,2.611726477,5030,7,0,762,655,107,48826,44480,4346,291,244,47,98.20577961
c135962b8340444943223a33fce67a06fda55b5b,1,4,2,2,0,0,0,17,65,30,1,1,0,1906,2,1,528,527,1,16244,16233,11,87,87,0,100
80135a8dbedfbaff444267681aa13d958e867c7e,8,155,52,103,0,0,0,8,66,218,3,6,2.000767572,3494,19,1,952,938,14,29229,28552,677,213,208,5,100
eef89a77f8400f32009c226021ec869f427066b6,2,5,2,3,0,0,0,9,55,122,2,2,0.863120569,1431,3,2,410,409,1,10804,10753,51,133,133,0,100
490e37ec35fe6671396029a40a006a0be521eaf8,2,15,10,5,0,0,0,5,77,14,1,1,0.970950594,874,289,1,218,218,0,7047,7049,2,61,61,0,100
ad226ddd9c4c13b0f9e5a3e3d8fe6de2299957aa,0,0,0,0,0,0,0,0,0,0,0,0,0,0,245,1,0,0,0,0,0,0,0,0,0,100
ff1a9dc2fcc6d45e2965848379bdca8e605cdd12,0,0,0,0,0,0,0,0,0,0,0,0,0,0,246,2,0,0,0,0,0,0,0,0,0,100
c1779231cfff4a6f6d934a38a5094defed1e07e6,1,14,10,4,0,0,0,3,4,734,1,1,0,163,96,0,30,30,0,1549,1506,43,13,13,0,100
b866e48f1ecd3d66d5383585a6c88093a374c065,14,184,47,137,0,0,0,9,61,635,3,6,3.041374157,3321,4,3,621,593,28,26282,25391,891,237,230,7,100
750646e75f870be1f5d1c67aa23933c6bb453c40,3,160,157,3,0,0,0,6,12,575,2,3,0.428032053,1517,290,1,369,370,1,12925,13036,111,79,83,4,100
e6de42b7a3da6ebc6326813108d2b0cbcacac0f1,2,17,2,15,0,0,0,2,102,73,2,2,0.831474388,463,20,2,68,64,4,4056,3947,109,19,18,1,100
318c645fb555b17b9fdd8c2f1b642a3065e337fc,2,8,0,8,0,0,0,17,67,72,2,2,0.811278124,2017,164,1,554,552,2,17176,17135,41,97,97,0,100
8ed641a785d42ea4d7fa2872486a6bac08b473a3,1,1,1,0,0,0,0,2,2,623,1,1,0,77,7,0,25,25,0,832,832,0,6,6,0,100
5afa572376ec0204371903263ba43073ee12ea1b,2,3,2,1,0,0,0,18,62,79,2,2,0.970950594,1034,5,4,169,169,0,9129,9120,9,95,95,0,100
7b650f7ab8c67a34c4f577dbd8ead6fcf78d13a6,0,0,0,0,0,0,0,0,0,0,0,0,0,0,247,3,0,0,0,0,0,0,0,0,0,100
21e9f2f9f43edfdbb3ce1b550a81e721f6453ccd,0,0,0,0,0,0,0,0,0,0,0,0,0,0,248,4,0,0,0,0,0,0,0,0,0,100
c5464da3d53a8ad9cc73dd83bf27240cecedd4f1,0,0,0,0,0,0,0,0,0,0,0,0,0,0,249,5,0,0,0,0,0,0,0,0,0,100
8baade2486b5ee5d41f8a00c19011a9484bf63be,0,0,0,0,0,0,0,0,0,0,0,0,0,0,250,6,0,0,0,0,0,0,0,0,0,100
16621dfc0ba93ab0b5e59d88b01165fab321834d,0,0,0,0,0,0,0,0,0,0,0,0,0,0,251,7,0,0,0,0,0,0,0,0,0,100
862ba9baed7af208456e59a42466aa0894cd8a6d,2,50,5,45,0,0,0,3,40,98,1,2,0.81840333,1927,8,1,525,516,9,14624,14384,240,133,130,3,100
1f871efb128e2e4ff2927f0196617bb278049a70,1,1,1,0,0,0,0,9,16,70,1,1,0,270,3,0,50,50,0,1962,1962,0,15,15,0,100
718b42d9b351dfecdbb62d06ab8a47e5b9697a40,0,0,0,0,0,0,0,0,0,0,0,0,0,0,252,7,0,0,0,0,0,0,0,0,0,100
40fa099cc52eb7e5646be43986da5ed2b4d08a99,0,0,0,0,0,0,0,0,0,0,0,0,0,0,253,8,0,0,0,0,0,0,0,0,0,100
2b38550b88ea201a3bd9169c44c0ede900ec1dd8,36,545,354,191,0,0,0,1,95,499,2,12,4.302023689,15033,165,1,3410,3387,23,126923,125251,1672,962,947,15,96.47651007
f304f59f6a9b57d93af27d76c9d3875c5efac09a,0,0,0,0,0,0,0,0,0,0,0,0,0,0,254,9,0,0,0,0,0,0,0,0,0,100
b4246817251429ec986e9f4a37adca7cf334a2a4,0,0,0,0,0,0,0,0,0,0,0,0,0,0,255,10,0,0,0,0,0,0,0,0,0,100
204275cc2d7fc520e1f9ea2b0f2ad6161af706c5,1,4,7,3,0,0,0,6,6,189,1,1,0,113,0,0,22,24,2,888,916,28,4,4,0,100
25f3002e0e84927eb39cebb5708d77ef81755d79,5,111,20,91,0,0,0,10,96,169,2,4,2.16129141,2339,166,2,579,567,12,19076,18368,708,226,220,6,99.60139512
861f8f23bc086fa8be0ebee82848dd2c883acdb0,1,9,0,9,0,0,0,9,17,20,1,1,0,270,97,1,50,50,0,2007,1962,45,15,15,0,100
dfd3ff643916c4a5ab27b45177009aee62b80bc1,0,0,0,0,0,0,0,0,0,0,0,0,0,0,0,0,0,0,0,0,0,0,0,0,0,100
a43b5488fbd10c874d181bf27e076fd502693a93,1,37,6,31,0,0,0,4,8,196,1,1,0,125,167,3,27,20,7,1260,1012,248,11,9,2,100
1c07f93b577d156ccf7c9adb75c447359002ed38,0,0,0,0,0,0,0,0,0,0,0,0,0,0,256,9,0,0,0,0,0,0,0,0,0,100
0e53c3ee3a135f86641e5ba6d4bf64502b1645ed,4,83,49,34,0,0,0,17,69,915,2,3,1.808405047,2901,259,0,812,807,5,24402,24260,142,144,142,2,100
de6965341d357fde05c002572cdde6115888f7cc,0,0,0,0,0,0,0,0,0,0,0,0,0,0,257,10,0,0,0,0,0,0,0,0,0,100
f467229294baa5550f4101d1e8ea59e82fdf3e3b,3,18,31,13,0,0,0,1,9,119,1,2,0.388508824,354,168,3,54,59,5,2576,2713,137,31,31,0,100
23aea76fff6c8f530816319649218583f4dfd091,4,34,35,1,0,0,0,10,97,240,2,4,1.924547199,2360,169,4,560,564,4,18604,18676,72,214,214,0,100
f20f8bae023360f0f577342f8aea5ff0026b87e8,0,0,0,0,0,0,0,0,0,0,0,0,0,0,258,6,0,0,0,0,0,0,0,0,0,100
b7b7c840c033d7d2553e804d0388e63d9cbc8e0f,1,2,2,0,0,0,0,9,18,22,1,1,0,275,98,1,50,50,0,2005,2007,2,15,15,0,100
9bddab89e1e06fc4f6955afbf1b10b6f8bb0e7ac,5,152,10,142,1,0,1,6,32,362,2,5,0.956181107,1396,1,1,186,179,7,12050,11182,868,75,70,5,97.18843785
103e867cc126ddb84e64bf262791a01a55bee6e5,4,168,9,159,1,0,1,1,41,29,1,2,0.992398556,1156,2,1,349,336,13,10152,9169,983,53,44,9,98.94470868
1c034cbaaeeda50224b77fae63ca617221b49f6c,3,272,37,235,1,0,1,1,34,49,1,3,0.915194968,626,9,0,96,81,15,6917,5530,1387,35,20,15,99.97075168
c08c9f382b88570d3bea1fb66937142b2f719f56,6,50,5,45,0,0,0,6,25,339,1,2,2.290920287,2198,4,0,496,487,9,15883,15534,349,216,213,3,100
d8cb94ac65dde5e1585ffe6d547450f647b65d76,0,0,0,0,0,0,0,0,0,0,0,0,0,0,0,0,0,0,0,0,0,0,0,0,0,100
935d0ab6465775e16db62896375d96f6a567b884,2,12,1,11,0,0,0,1,3,180,1,2,0.779349837,150,170,2,33,31,2,1138,1080,58,20,18,2,100
214f2a760a1a4c8c3a83b5afaa42fdc36055ff98,2,14,5,9,0,0,0,1,13,590,1,2,0.74248757,251,171,3,43,42,1,2073,2038,35,25,24,1,100
3de30f55d808df6245f60fe01fed4b6cf894a31d,1,5,20,15,0,0,0,2,8,62,1,1,0,226,172,4,37,40,3,1653,1708,55,18,19,1,100
0571fa42897e33a29baf4d1bd10ee04ae222dc70,2,27,14,13,0,0,0,15,98,30,2,2,0.978869851,1617,173,5,397,394,3,12044,11962,82,183,182,1,100
574e20a0cbc5a34c53e08fd43052ee539404af24,1,2,1,1,0,0,0,5,14,11,1,1,0,253,5,1,74,73,1,1683,1659,24,38,38,0,100
e29abf1294c241c96645781645caf4fff89c6180,0,0,0,0,0,0,0,0,0,0,0,0,0,0,1,0,0,0,0,0,0,0,0,0,0,100
887087d9b9de0e2cf932c4ddd337693efbbd3ddd,0,0,0,0,0,0,0,0,0,0,0,0,0,0,259,0,0,0,0,0,0,0,0,0,0,100
2228d752714b8edeea2ccf0aba660f69e765e6fa,0,0,0,0,0,0,0,0,0,0,0,0,0,0,260,1,0,0,0,0,0,0,0,0,0,100
2dd41162b1832a1f574a28567289772fa21d65af,0,0,0,0,0,0,0,0,0,0,0,0,0,0,261,2,0,0,0,0,0,0,0,0,0,100
62451d62a01bf62e2bc50ec7d9585365329086a6,0,0,0,0,0,0,0,0,0,0,0,0,0,0,262,3,0,0,0,0,0,0,0,0,0,100
b9f4ae790accee9fa0e97d963038165742f88a72,0,0,0,0,0,0,0,0,0,0,0,0,0,0,263,4,0,0,0,0,0,0,0,0,0,100
7718c5eb4955818befefcd7d9768f1cdb202cff2,4,172,39,133,0,0,0,2,10,44,1,3,1.652087344,1776,10,1,344,317,27,15098,14049,1049,147,133,14,100
6248e361fc01256ba263a6f4523c50541f6fc86b,2,64,26,38,0,0,0,8,13,354,1,2,0.67519144,1474,3,1,359,354,5,12382,12139,243,66,65,1,100
61abecac22ef3e9341a07be6d5354bf246544a3b,4,258,34,224,0,0,0,5,28,656,2,4,1.46309849,907,0,0,173,148,25,8206,6827,1379,63,58,5,100
56ecce625f89e2339d1467587f7a8ae134139160,0,0,0,0,0,0,0,0,0,0,0,0,0,0,291,0,0,0,0,0,0,0,0,0,0,100
d6ba8569f11cd1803bb0d335122111d9153552ae,0,0,0,0,0,0,0,0,0,0,0,0,0,0,264,5,0,0,0,0,0,0,0,0,0,100
1a971463d74320dcf093598cd456b1c369a5cb75,0,0,0,0,0,0,0,0,0,0,0,0,0,0,265,6,0,0,0,0,0,0,0,0,0,100
e58c98ec65008280182472c4e63d7206393c99a9,0,0,0,0,0,0,0,0,0,0,0,0,0,0,260,0,0,0,0,0,0,0,0,0,0,100
00bef883c5561596ccc2b7b1075e8379bf8ac6bb,1,2,1,1,0,0,0,6,9,312,1,1,0,81,174,4,19,18,1,587,572,15,7,7,0,100
ac0cd87ad4818020d012ae5265759891c3860a9a,2,8,13,5,0,0,0,17,70,129,2,2,0.702466551,2188,6,0,614,614,0,18183,18236,53,124,124,0,100
7a8ca51f83bdd15bf5290f718bd6a79e16eca61b,2,90,9,81,0,0,0,5,29,10,1,2,0.859275981,612,1,1,96,90,6,5384,4838,546,37,35,2,100
3c3eed082d99f5f509b80aecacbaa9531e37eb25,0,0,0,0,0,0,0,0,0,0,0,0,0,0,6,0,0,0,0,0,0,0,0,0,0,100
ceec7d746c6c510a35f2279f2149eaa16728dc44,1,0,3,3,0,0,0,9,42,60,1,1,0,807,11,1,263,263,0,6299,6312,13,39,39,0,100
2ed6a48d092da5ebaaf23390f48011193a980265,0,0,0,0,0,0,0,0,0,0,0,0,0,0,292,1,0,0,0,0,0,0,0,0,0,100
86ba342fe6baee08c6aaa20e50de4c3b8e2ae873,2,118,122,4,0,0,0,15,49,141,2,2,0.122291597,1412,293,2,330,333,3,11113,11477,364,75,78,3,100
cc185c13c6a310ad34a243fd467890d6c8bf9c79,0,0,0,0,0,0,0,0,0,0,0,0,0,0,266,7,0,0,0,0,0,0,0,0,0,100
21b15842fd74bc91910b2d8901dbea57769065d0,0,0,0,0,0,0,0,0,0,0,0,0,0,0,267,3,0,0,0,0,0,0,0,0,0,100
931d6efdc97f742370df334761673af70f240837,5,9,9,0,0,0,0,8,60,140,2,4,2.197159723,3395,261,1,996,996,0,26001,26001,0,295,295,0,100
985264e129687e4d2c6bfaaa92f6a6550a106e89,2,6,8,2,0,0,0,2,30,469,1,1,0.749595257,471,12,1,128,128,0,3346,3419,73,46,46,0,100
0df34884deb73237cfb5ecb367a5e4510a080357,0,0,0,0,0,0,0,0,0,0,0,0,0,0,268,4,0,0,0,0,0,0,0,0,0,100
f4e1e6b0ec58febac3d72d20d4a40a8f218d74e1,0,0,0,0,0,0,0,0,0,0,0,0,0,0,269,5,0,0,0,0,0,0,0,0,0,100
8092d6b5fda19ba523742444123bdbbe9b428914,0,0,0,0,0,0,0,0,0,0,0,0,0,0,270,6,0,0,0,0,0,0,0,0,0,100
e590092c47ab18f904dd7974f834bf05045e5ee4,0,0,0,0,0,0,0,0,0,0,0,0,0,0,271,5,0,0,0,0,0,0,0,0,0,100
a3fd6441b872c000ea523d433fca7d076fb173d9,0,0,0,0,0,0,0,0,0,0,0,0,0,0,272,6,0,0,0,0,0,0,0,0,0,100
5e8b7f34a75e7b433ff9404fbb973cea04d8f2d4,0,0,0,0,0,0,0,0,0,0,0,0,0,0,273,5,0,0,0,0,0,0,0,0,0,100
79caa79ad72fca25cecaebdcfcdf5be095852933,0,0,0,0,0,0,0,0,0,0,0,0,0,0,274,6,0,0,0,0,0,0,0,0,0,100
c8cf4765bb519fbe4cd4962ce9ab22999fdfaa4b,0,0,0,0,0,0,0,0,0,0,0,0,0,0,21,0,0,0,0,0,0,0,0,0,0,100
474d73c5822183ba8e810615eb195d559ef9589a,1,3,0,3,0,0,0,21,46,197,1,1,0,795,7,0,128,128,0,6027,6020,7,43,43,0,100
992b8b47cc332efe71f82c5ecbbee94d3e2774e5,2,2,9,7,0,0,0,14,79,178,1,2,0.684038436,2068,13,0,525,525,0,16698,16766,68,147,147,0,100
aa86d62c057d56f858dc7962aa158d23c82f972b,3,62,12,50,0,0,0,16,38,785,2,3,1.531887389,1392,14,1,402,389,13,10720,10442,278,161,159,2,100
177b01bc61828cd03e7ee6bcd76d336d7d7d3f54,0,0,0,0,0,0,0,0,0,0,0,0,0,0,275,3,0,0,0,0,0,0,0,0,0,100
b5c4a56f1ece7e10e7a2da15de466899021da254,0,0,0,0,0,0,0,0,0,0,0,0,0,0,276,4,0,0,0,0,0,0,0,0,0,100
ab9f973123192e0711f67f707cb118525b19993f,0,0,0,0,0,0,0,0,0,0,0,0,0,0,277,4,0,0,0,0,0,0,0,0,0,100
25ba9b30b916269bc20a5b99b9bc326f5b9e18d3,0,0,0,0,0,0,0,0,0,0,0,0,0,0,18,0,0,0,0,0,0,0,0,0,0,100
eb641d560e1537808df172aad11f1338cc0e5e7f,2,3,22,19,0,0,0,10,99,141,1,2,0.855450811,1935,262,0,537,539,2,14658,14768,110,159,159,0,100
e105576ba955a41e51a6e11f67eefd7b11a0571e,0,0,0,0,0,0,0,0,0,0,0,0,0,0,278,5,0,0,0,0,0,0,0,0,0,100
e691a32c2d3888c99757e6aa31694ec8d14c2d48,0,0,0,0,0,0,0,0,0,0,0,0,0,0,8,1,0,0,0,0,0,0,0,0,0,100
8b5cb9d9aa9f977ba5dfc455dfe440dd55eace06,14,730,376,354,0,0,0,2,62,299,2,5,2.869235342,3893,15,2,995,945,50,32810,30561,2249,233,218,15,99.00696606
9d597f249bc222d362dd96921ed3254579e8fc1b,1,33,33,0,0,0,0,8,19,261,1,1,0,557,9,2,42,42,0,5301,5171,130,24,24,0,100
0221e3dd297057dab344b8d9b6672a37adafabbc,1,42,8,34,0,0,0,12,63,2,1,1,0,782,16,3,204,196,8,6244,6034,210,35,35,0,100
ce95c6299986eae212f6861ab423f32aa8f7f7d0,2,6,1,5,0,0,0,5,12,198,1,1,0.863120569,84,263,1,14,14,0,746,723,23,6,6,0,100
8b50ac0c7d8eba8efa0deb97f1fee68d382f11ad,6,763,302,461,3,0,3,1,83,154,2,4,1.818182277,1624,7,0,473,424,49,15052,12499,2553,162,136,26,95.71041031
f932e52c687479c77b9967165353b0fffa6f2fa0,3,16,12,4,0,0,0,11,64,460,2,2,1.224488378,1274,17,4,280,280,0,9915,9891,24,57,57,0,100
e72aa1076a5a1272935fed4dedaf9e29e41fa30b,1,250,31,219,0,0,0,1,2,3,1,1,0,122,8,1,40,12,28,2564,1088,1476,20,7,13,100
337575c81b993e2cdcd6dc462dcf614940c783c2,0,0,0,0,0,0,0,0,0,0,0,0,0,0,99,0,0,0,0,0,0,0,0,0,0,100
0c3d2ed350507db12a8884bb209467185d4723a5,0,0,0,0,0,0,0,0,0,0,0,0,0,0,279,6,0,0,0,0,0,0,0,0,0,100
3d559d0195c3a93890a0b4c303b5ee99f71dd4de,0,0,0,0,0,0,0,0,0,0,0,0,0,0,4,0,0,0,0,0,0,0,0,0,0,100
cea851c5513cede054bc7704ac24c04cc498cd32,1,6,8,2,0,0,0,13,73,874,1,1,0,673,100,1,138,138,0,5841,5824,17,48,48,0,100
5f956110f719bcf8a3cb76d11551ce895e0ded9f,2,123,41,82,0,0,0,1,3,21,1,2,0.901170196,651,9,2,118,109,9,5847,5483,364,37,34,3,100
d604085efe18963f39020e62cd03a5e4fcb20b2b,0,0,0,0,0,0,0,0,0,0,0,0,0,0,280,5,0,0,0,0,0,0,0,0,0,100
16ced369e741a00cd31da4d6fd5d4fa3dc05ec1a,3,34,4,30,0,0,0,21,59,61,2,2,1.021455466,2814,7,0,668,662,6,22882,22679,203,128,127,1,99.94167963
682d16dd19cb72d36af9798811ed701ecdc0dacf,1,5,5,0,0,0,0,8,18,1068,1,1,0,237,101,2,18,18,0,2257,2237,20,14,14,0,100
06cd0cb35a285b3c4a7b0b3c662ce7263848f7b6,3,60,22,38,0,0,0,10,51,431,3,3,0.66046212,1712,10,2,425,417,8,13874,13673,201,124,122,2,100
f690755f79f9696e3214b9a3f158977b3bd5f4a7,3,32,23,9,0,0,0,11,35,28,2,3,0.935340085,1039,18,3,211,211,0,8518,8460,58,76,76,0,100
d9d0e8c2abe293a520f89b85015d9c52985e28cb,1,11,0,11,0,0,0,7,23,3,1,1,0,368,19,4,118,113,5,3045,2986,59,37,37,0,100
cec7aa851e6befa6d32f3dfd80cc79cc8c3c799a,1,26,36,10,0,0,0,14,74,21,1,1,0,672,10,3,136,138,2,5820,5841,21,47,48,1,95.58001693
a42f0c1cba87623a9553718a75a844cfadb24218,0,0,0,0,0,0,0,0,0,0,0,0,0,0,294,0,0,0,0,0,0,0,0,0,0,100
8827bfb4dab5f19cf0dab5c3fc1e5a4d4a4abbe8,9,2147,255,1892,2,0,2,4,18,1044,2,4,2.301598862,2724,0,0,639,428,211,38834,23713,15121,393,241,152,94.84398465
7e06f55fc952f7fbbd18eb717f70ae211085068d,0,0,0,0,0,0,0,0,0,0,0,0,0,0,281,1,0,0,0,0,0,0,0,0,0,100
ec314fdeb871a479194af5b543a72df76472cb4c,0,0,0,0,0,0,0,0,0,0,0,0,0,0,282,1,0,0,0,0,0,0,0,0,0,100
9a067d38e27fc2255647133373b952a6a64ed1a4,8,791,316,475,2,0,2,2,45,78,2,4,2.37700247,2186,20,1,512,491,21,21449,19511,1938,148,134,14,93.31355094
500ea95c3e2fbaa231026959304fa6f7ade055be,1,11,1,10,0,0,0,2,5,272,1,1,0,203,175,0,39,36,3,1744,1676,68,12,11,1,100
05eba3fdb9fedf3483cdb1cef938f7a2cbf7933e,4,98,1,97,1,0,1,1,13,831,2,3,1.365707032,264,176,1,55,46,9,2512,2081,431,27,23,4,99.49895616
80efe92630a9198ed4b4c564f6e78c8079045930,3,18,18,0,0,0,0,1,19,177,3,3,0.902248991,400,4,0,72,71,1,3138,3102,36,38,37,1,100
38d7b91e4aa205f89d71f85328a513cc61516266,0,0,0,0,0,0,0,0,0,0,0,0,0,0,283,2,0,0,0,0,0,0,0,0,0,100
ce2ba123a2b9ce43503d5e101400b93fa5b6267e,0,0,0,0,0,0,0,0,0,0,0,0,0,0,284,2,0,0,0,0,0,0,0,0,0,100
ba1b40f0426e5ff0e621eab5184d916a6f506f59,0,0,0,0,0,0,0,0,0,0,0,0,0,0,285,3,0,0,0,0,0,0,0,0,0,100
4a57f92f649e389b8f5ef653394a5f091f1a36de,6,351,78,273,3,0,3,10,20,107,2,6,1.943870148,773,177,2,228,199,29,7228,5878,1350,86,65,21,95.62058946
aa441de4f62947b96f6ff387f4d140a2b83c99dc,7,222,221,1,0,0,0,11,65,118,3,5,1.35138344,5423,21,1,1411,1414,3,41698,41676,22,377,375,2,99.91737244
fb374763988d869fa8ce1b18bf4d438a64f4bb06,40,13,16,3,0,0,0,2,60,341,5,11,3.754532719,6266,295,0,1268,1246,22,50437,53811,3374,461,530,69,89.01187362
b7255ec7e24f87da6f2dba47965a4e22e94c2250,7,1025,0,1025,7,0,7,1,1,0,1,1,2.563538648,0,0,0,106,0,106,5923,0,5923,50,0,50,99.64871194
83e9c21f7805b7badc9390a15fd747e1e6a7f8e2,7,73,79,6,0,0,0,1,2,0,1,1,2.556490137,709,1,1,108,106,2,5884,5923,39,51,50,1,100
1b41b980415961419bb4af8710bd82f34395779c,5,468,15,453,0,0,0,3,52,194,3,5,1.487698693,2783,11,0,740,685,55,25384,21372,4012,240,222,18,100
41eebcf4cf435d37c5e67aea916513eac36e3ee5,0,0,0,0,0,0,0,0,0,0,0,0,0,0,286,3,0,0,0,0,0,0,0,0,0,100
f077bbbf3b2df2e44df833017a307c565897a74e,6,178,1,177,1,0,1,14,41,780,2,3,2.130685884,1480,102,0,429,403,26,12358,11219,1139,96,87,9,99.96114996
41e1039bd66829683e9b24f10186bde53a83d7ad,0,0,0,0,0,0,0,0,0,0,0,0,0,0,8,0,0,0,0,0,0,0,0,0,0,100
892df24289d583028e74e78f7b86f6fde785e909,5,176,4,172,1,0,1,9,39,337,2,4,1.413110185,1700,22,0,444,421,23,13522,12394,1128,133,122,11,99.92237532
813bab6439d5e6be135cb178ac846056c446fd9b,0,0,0,0,0,0,0,0,0,0,0,0,0,0,287,1,0,0,0,0,0,0,0,0,0,100
250c2eaf249fd115f71b11019bfc4b153810bde8,0,0,0,0,0,0,0,0,0,0,0,0,0,0,288,2,0,0,0,0,0,0,0,0,0,100
3468c2b4ac1175849ce119dcd69f5518b1d9a342,2,24,2,22,0,0,0,12,55,935,2,2,0.961236605,1121,178,0,252,246,6,8746,8582,164,58,57,1,100
92c2ae30d27efcafbfea710f8e246cfb7487f35d,0,0,0,0,0,0,0,0,0,0,0,0,0,0,103,0,0,0,0,0,0,0,0,0,0,100
61b7a077bc541aad27ceadb8c55b4d568b376e3c,0,0,0,0,0,0,0,0,0,0,0,0,0,0,289,2,0,0,0,0,0,0,0,0,0,100
3d69114fb8fbd604394d6d6c3124d906dce625ad,0,0,0,0,0,0,0,0,0,0,0,0,0,0,19,0,0,0,0,0,0,0,0,0,0,100
c688af0957da5930cfeb97de1cc655a0e13ad936,0,0,0,0,0,0,0,0,0,0,0,0,0,0,11,0,0,0,0,0,0,0,0,0,0,100
01e9ccef466643a01f97900b97e69772dd8c4ea9,1,29,1,28,0,0,0,19,63,425,1,1,0,583,23,0,86,82,4,4653,4364,289,23,22,1,100
d555c02ba283312e2d9b014b5d68a17da3661525,0,0,0,0,0,0,0,0,0,0,0,0,0,0,0,0,0,0,0,0,0,0,0,0,0,100
1bfaf7add99e30130cabe20e9cedf2f90ca96e0d,1,21,5,16,0,0,0,14,42,98,1,1,0,919,296,0,225,222,3,7115,7042,73,52,50,2,100
e6c382680d1a3fa3284b5c9a9026264fc5bd3957,0,0,0,0,0,0,0,0,0,0,0,0,0,0,0,0,0,0,0,0,0,0,0,0,0,100
ee80e6a675317f15a99429d509ffd49670d5df0d,0,0,0,0,0,0,0,0,0,0,0,0,0,0,1,1,0,0,0,0,0,0,0,0,0,100
62c682b344c245015bca4e3d6bf7f55b5394a5e2,0,0,0,0,0,0,0,0,0,0,0,0,0,0,0,0,0,0,0,0,0,0,0,0,0,100
eccc37623e7c3d43e1aa494f88a5ad155fe9c123,1,6,0,6,0,0,0,1,2,146,1,1,0,29,179,0,3,2,1,250,218,32,2,2,0,96.32714072
7690e51d10f008c1e13a4c85f9aa8821fee33f4a,0,0,0,0,0,0,0,0,0,0,0,0,0,0,297,1,0,0,0,0,0,0,0,0,0,100
9b1d4c387fb56d08bfc86150b0cff7d071540109,0,0,0,0,0,0,0,0,0,0,0,0,0,0,298,2,0,0,0,0,0,0,0,0,0,100
4bc1c04adeba25254fce924e318c26fc9b72a8dd,2,72,41,31,0,0,0,8,17,595,2,2,0.176776697,432,104,0,55,52,3,3662,3446,216,21,20,1,99.76230093
74229d87043bc55a4dd83cad37db59031d624af5,1,2,0,2,0,0,0,14,43,12,1,1,0,930,105,1,225,225,0,7121,7115,6,52,52,0,100
b8956dfd00b788ef90b79612a36669f5c6106855,0,0,0,0,0,0,0,0,0,0,0,0,0,0,290,0,0,0,0,0,0,0,0,0,0,100
d0e246a7096d870b1bc6ee3dd46428bd3bf4b1e6,0,0,0,0,0,0,0,0,0,0,0,0,0,0,299,3,0,0,0,0,0,0,0,0,0,100
23c33d14d0d8e11977c38377668030ae2bbe257b,0,0,0,0,0,0,0,0,0,0,0,0,0,0,291,1,0,0,0,0,0,0,0,0,0,100
ec39c1e6207d2f875b3dc9d5a8a9818c3c9c46a5,3,37,23,14,0,0,0,12,66,150,2,2,1.44064545,1267,0,0,277,276,1,10003,9899,104,57,57,0,100
86e9149b031d62536fce6bb6fa815536d57144bc,2,20,9,11,0,0,0,4,39,872,2,2,0.578794625,1237,106,2,370,367,3,9466,9374,92,136,135,1,100
7ae0bea9680d78605e1362dfbea288518f0e50ff,1,5,0,5,0,0,0,14,45,564,1,1,0,579,107,3,163,161,2,5171,5132,39,72,72,0,100
d4a50aadfc2e7076d8e5281f9be60fad4c5c232d,6,88,14,74,0,0,0,6,13,1269,1,1,2.045310322,1662,12,0,400,385,15,14741,14183,558,92,89,3,100
545afb53d0eb4154162f3887cea2bf4a4d26e752,0,0,0,0,0,0,0,0,0,0,0,0,0,0,1,1,0,0,0,0,0,0,0,0,0,100
9a605b6671b1719eebce04605f100e34c8f5afb0,3,8,63,55,0,0,0,2,5,2144,1,2,1.06280104,376,180,1,55,65,10,2580,2924,344,40,47,7,100
ac573f33c72f5cf9b75b50453ad85dd3abadcb15,0,0,0,0,0,0,0,0,0,0,0,0,0,0,300,3,0,0,0,0,0,0,0,0,0,100
877e2b1729f3628d844c32769c30a3c948d567a6,1,4,5,1,0,0,0,15,52,175,1,1,0,1264,2,1,322,323,1,10306,10314,8,91,91,0,100
45bb769f60ae2f23a4b260dd6e64d76149cd39d0,1,20,18,2,0,0,0,14,44,43,1,1,0,932,108,2,225,225,0,7108,7121,13,51,52,1,100
4f95ee8cc199d17ec954f81d8af9d0152af142f4,0,0,0,0,0,0,0,0,0,0,0,0,0,0,3,2,0,0,0,0,0,0,0,0,0,100
8bb3e853ea128e1eb2b181e8db869bf7d8050181,6,109,43,66,0,0,0,10,61,272,2,2,1.32011395,3666,301,1,1117,1097,20,28232,27952,280,299,294,5,100
54bab3f88ed580e54074fc0f26b01f6d103fde60,2,6,4,2,0,0,0,3,5,878,1,1,0.970950594,248,181,1,38,38,0,1780,1750,30,22,22,0,100
8098bc5643cd45f53d2d9284785693a406d8a270,1,2,1,1,0,0,0,4,4,24,1,1,0,265,109,3,66,66,0,2236,2236,0,15,15,0,100
f5ffd06486f6ef3c28236c6c70e74561542d30c1,0,0,0,0,0,0,0,0,0,0,0,0,0,0,292,0,0,0,0,0,0,0,0,0,0,100
70c1087a121feb3fe88cc67681b470109443ff81,0,0,0,0,0,0,0,0,0,0,0,0,0,0,293,1,0,0,0,0,0,0,0,0,0,100
4ab4962314a80d9e0ac766f81018e22995c8e83d,0,0,0,0,0,0,0,0,0,0,0,0,0,0,294,2,0,0,0,0,0,0,0,0,0,100
f5db98b3ba5a6bdf851b1319abab5f953d6ff0f4,3,20,3,17,0,0,0,3,19,1639,2,2,1.474041717,745,4,3,155,152,3,5900,5793,107,84,82,2,100
39ff496f129b64352e91b462c7882491a3929981,2,7,2,5,0,0,0,3,15,1018,2,2,0.503258335,219,182,2,35,34,1,1672,1628,44,17,17,0,100
3c0b2746d0065b1d95b4511c46a8655d4167096e,0,0,0,0,0,0,0,0,0,0,0,0,0,0,295,3,0,0,0,0,0,0,0,0,0,100
74c9394148d175950615f82455dc1e302000c01b,0,0,0,0,0,0,0,0,0,0,0,0,0,0,296,4,0,0,0,0,0,0,0,0,0,100
5aab626e5a0436028389ba6b10734a323260cd66,1,1,1,0,0,0,0,1,3,184,1,1,0,70,2,0,11,11,0,493,493,0,6,6,0,100
080e4843480743558bc4b61d9c2860b414786ccc,1,4,1,3,0,0,0,4,9,496,1,1,0,150,183,3,28,27,1,1290,1260,30,11,11,0,100
94d43c63c6021450845ff17c5bd952dbf5f8958a,0,0,0,0,0,0,0,0,0,0,0,0,0,0,297,5,0,0,0,0,0,0,0,0,0,100
39892854ffb696df70ecbc0f3e965c5a8261f621,0,0,0,0,0,0,0,0,0,0,0,0,0,0,298,6,0,0,0,0,0,0,0,0,0,100
fd24e652b5e2f607cad0d665c88d770479832263,2,8,2,6,0,0,0,6,15,2210,2,2,0.721928095,249,110,2,40,40,0,2122,2032,90,9,9,0,100
d0de38970e1289cf726f8952dd3e2e93b0a158a3,0,0,0,0,0,0,0,0,0,0,0,0,0,0,13,0,0,0,0,0,0,0,0,0,0,100
b4e4f604b46805ade02413da6ef1a68b2f28da71,2,247,12,235,0,0,0,13,75,282,2,2,0.470218309,1559,1,0,354,306,48,17658,16392,1266,201,194,7,100
bd9d1213b48721f269f32db1ee388e2beb9a7d3d,0,0,0,0,0,0,0,0,0,0,0,0,0,0,302,1,0,0,0,0,0,0,0,0,0,100
3f1cf185200206827d309ab76f3ad729ad7a5e3b,0,0,0,0,0,0,0,0,0,0,0,0,0,0,299,7,0,0,0,0,0,0,0,0,0,100
de87bc5022627d82cb8e6048b6728e7028a4af25,30,2991,45,2946,21,0,21,1,84,722,2,9,4.274783392,987,184,2,584,203,381,21693,7077,14616,321,83,238,98.85057471
f959d84adf8108386f513b5bd1601a4ef73749ad,1,1,2,1,0,0,0,19,64,128,1,1,0,606,24,0,86,86,0,4637,4653,16,23,23,0,100
7dec8f538b6f3f52a4803b63efd3c5b0b41e966c,4,133,3,130,1,0,1,4,11,1604,2,3,1.722202421,265,25,1,59,47,12,2392,1693,699,43,39,4,99.9306198
f3faad547380ac786427d84c95244de502781360,1,4,1,3,0,0,0,2,3,587,1,1,0,100,14,1,23,22,1,902,873,29,5,5,0,100
8f9ef44660230030a69bfc7c488edf8f11cfe933,0,0,0,0,0,0,0,0,0,0,0,0,0,0,15,2,0,0,0,0,0,0,0,0,0,100
e45cd453a4abf9d0bf254ee127e62f0235039a69,1,2,1,1,0,0,0,2,4,0,1,1,0,103,16,3,23,23,0,915,902,13,5,5,0,100
7925946adeeddeb878e2bdf3c0894b312a50f639,0,0,0,0,0,0,0,0,0,0,0,0,0,0,17,4,0,0,0,0,0,0,0,0,0,100
82cdd700b2133e74ca8bce9aa55d93e76c8ec6fc,1,6,2,4,0,0,0,16,76,13,1,1,0,838,18,5,183,182,1,7081,7042,39,53,53,0,100
90f5b4add36b8a006393d8fa92fa4ba93f49f309,1,13,2,11,0,0,0,19,65,0,1,1,0,605,26,2,86,86,0,4731,4637,94,23,23,0,100
709598a3b6fd067327c922979a22071ff50fd1a6,33,282,186,96,0,0,0,7,80,899,4,19,4.656011137,9509,303,1,1321,1319,2,82279,82024,255,627,616,11,97.30487279
5b3da223ffa611a66e6fd3ade2cb2d5a2345c733,0,0,0,0,0,0,0,0,0,0,0,0,0,0,304,2,0,0,0,0,0,0,0,0,0,100
24bb6b084d6c13d7ac94277ae6d730b8e7fcd67d,3,13,11,2,0,0,0,7,16,130,2,2,1.241010693,767,305,3,127,127,0,5937,5898,39,36,36,0,100
2f766f5c78d8c0b01e2c6c4a3cc5798ad7e06d3a,0,0,0,0,0,0,0,0,0,0,0,0,0,0,300,5,0,0,0,0,0,0,0,0,0,100
91926971551767abd9d2d34fff202d9df3c72f9b,0,0,0,0,0,0,0,0,0,0,0,0,0,0,301,6,0,0,0,0,0,0,0,0,0,100
8f5ba447ff2880804c2a1d820dc5f245c66075a6,0,0,0,0,0,0,0,0,0,0,0,0,0,0,302,7,0,0,0,0,0,0,0,0,0,100
a22495b9b5942b7bf3c845f13e248c64908268d9,5,53,44,9,0,0,0,7,26,708,1,2,1.303980005,1988,2,0,417,424,7,13859,13895,36,200,201,1,100
c7f930068bc672f85a42eae232d3d232112b84b5,0,0,0,0,0,0,0,0,0,0,0,0,0,0,306,4,0,0,0,0,0,0,0,0,0,100
34709f229b62ce054ae819917dff9aad4cc976b8,0,0,0,0,0,0,0,0,0,0,0,0,0,0,307,5,0,0,0,0,0,0,0,0,0,100
d4b15c7a2ab47d64a49070fab766a95497db4f0f,11,576,628,52,2,0,2,3,30,1427,5,11,2.676427383,1976,3,1,230,224,6,15777,16139,362,117,119,2,99.89909183
7c68048fcc314d83100c7a5fc0a5b8294f62e2cd,5,157,8,149,0,0,0,8,100,504,1,4,1.548603864,3695,12,0,696,671,25,32885,32026,859,249,235,14,97.6400614
53ae712a095930ebf008e70ece4a7a351030acf3,0,0,0,0,0,0,0,0,0,0,0,0,0,0,303,4,0,0,0,0,0,0,0,0,0,100
a0474d142c702e75f1820bffa542dc8cf39ba79d,2,5,1,4,0,0,0,16,103,346,2,2,0.918295834,1491,19,5,329,328,1,12329,12293,36,95,95,0,100
e6fff74807c24a06aea1cb7666bd07da9d1100ed,0,0,0,0,0,0,0,0,0,0,0,0,0,0,4,2,0,0,0,0,0,0,0,0,0,100
801d40c3c62161a2bf8ae9fd0b1fea46d04eb7af,6,58,2,56,0,0,0,3,32,1190,1,2,2.261070021,931,185,0,212,203,9,7914,7483,431,88,85,3,92.07746479
b7c219a52363c378832536b8f00e003a5b0bbe5a,2,5,1,4,0,0,0,19,66,160,2,2,0.918295834,647,27,0,88,88,0,4898,4878,20,25,25,0,100
dc9e268966fa27df400e827fd6e57a5098d7d478,6,278,5,273,1,0,1,1,21,219,3,4,1.244630506,544,186,1,133,97,36,5576,4022,1554,67,50,17,99.95800084
06106fe92d597c012c01057724621b2d487ae46f,0,0,0,0,0,0,0,0,0,0,0,0,0,0,0,0,0,0,0,0,0,0,0,0,0,100
a0a3c3183e2cc794eb35392d43008d0937616ffc,2,9,7,2,0,0,0,1,22,6,2,2,0.543564443,235,187,2,43,43,0,1702,1679,23,24,24,0,100
4ab95b9adafd3d845b626d2d82bd2b3aa23be691,1,5,2,3,0,0,0,17,71,501,1,1,0,1941,188,3,538,537,1,16567,16544,23,89,89,0,100
dda50429d35e2bd8b56ee01aa91727285258d5c9,0,0,0,0,0,0,0,0,0,0,0,0,0,0,1,1,0,0,0,0,0,0,0,0,0,100
1b540056eaffd5406ed01f99119fa433322b4551,0,0,0,0,0,0,0,0,0,0,0,0,0,0,20,1,0,0,0,0,0,0,0,0,0,100
fb996d55f81d8fb371405145bf56e693340d389b,0,0,0,0,0,0,0,0,0,0,0,0,0,0,304,0,0,0,0,0,0,0,0,0,0,100
9a30dc6863b4c44f75cd2b8855110c91c9a69d81,0,0,0,0,0,0,0,0,0,0,0,0,0,0,2,2,0,0,0,0,0,0,0,0,0,100
dd4ba1b194e2157a0e4cd1c17fccf0b5ac010161,0,0,0,0,0,0,0,0,0,0,0,0,0,0,3,3,0,0,0,0,0,0,0,0,0,100
d12609bcd12e2cfe19a125da8e98e0d997adf3dc,0,0,0,0,0,0,0,0,0,0,0,0,0,0,4,4,0,0,0,0,0,0,0,0,0,100
cf232de6a1f71fdfbdc0b5d95309a1fe7ed4416c,0,0,0,0,0,0,0,0,0,0,0,0,0,0,305,1,0,0,0,0,0,0,0,0,0,100
0eb01b0edc618b8672fe0dc10f29a16ac31f385d,0,0,0,0,0,0,0,0,0,0,0,0,0,0,264,0,0,0,0,0,0,0,0,0,0,100
099324e801accaf3b4be24028a9d6db2c4b36ed9,0,0,0,0,0,0,0,0,0,0,0,0,0,0,0,0,0,0,0,0,0,0,0,0,0,100
f4b1c4294f37a53d2041fb925dc43dba5f166b67,1,4,3,1,0,0,0,12,56,238,1,1,0,1036,189,4,225,225,0,7895,7875,20,38,38,0,100
05d8dec6fea6ba7566a900e3a2caca1470c975fc,7,49,64,15,0,0,0,5,67,264,3,5,2.731981834,1764,5,0,351,354,3,13334,13477,143,157,155,2,100
389c25bcd05f05977750974db5cdc8dd44b581dc,0,0,0,0,0,0,0,0,0,0,0,0,0,0,6,1,0,0,0,0,0,0,0,0,0,100
5373cde5f4624e0989a41e9512e67f903d1fc26c,1,9,0,9,0,0,0,16,53,330,1,1,0,1294,190,3,314,311,3,10718,10652,66,52,52,0,100
97b5565d83be38e3c7e40c1cf949e0ffd89ede3c,1,18,0,18,0,0,0,15,55,147,1,1,0,849,5,0,292,274,18,6047,5993,54,88,88,0,100
7779388fb000122fc1ddd29c9f6c36f57b41f5b1,1,14,3,11,0,0,0,20,68,20,1,1,0,608,28,0,84,83,1,4702,4610,92,23,23,0,100
5037871ad95fd1d0a7596307b3f92e471cb84209,1,5,2,3,0,0,0,3,7,1525,1,1,0,465,21,0,98,98,0,3509,3495,14,33,33,0,100
cbc3427133bfc1f119685b33f6d61f8d34f9f3ab,1,6,1,5,0,0,0,2,2,105,1,1,0,205,7,2,44,44,0,1590,1542,48,9,9,0,100
420983d5841fb6de545e101329cf7e12de68f4a0,7,57,11,46,1,0,1,13,77,839,3,7,2.043561055,2133,8,3,403,399,4,17565,17370,195,131,128,3,98.87567568
294ca40d956615157dc49d1a30af4a5e68006429,0,0,0,0,0,0,0,0,0,0,0,0,0,0,13,0,0,0,0,0,0,0,0,0,0,100
8801ba6814abbd2c60c88d04cf1649efed2f3429,1,1,1,0,0,0,0,2,3,21,1,1,0,209,9,2,44,44,0,1590,1590,0,9,9,0,100
10b6d142e479e0b2a27be6a7dd8b9f82a4d3f723,2,5,2,3,0,0,0,7,11,2036,1,2,0.985228136,290,10,3,41,41,0,2450,2426,24,22,22,0,100
ff55b0a155bc1c6a0f150477998084de90da6cec,0,0,0,0,0,0,0,0,0,0,0,0,0,0,0,0,0,0,0,0,0,0,0,0,0,100
9cdc31d5851db61296c7ff07ecb9bc85c26939fa,1,52,27,25,0,0,0,20,69,30,1,1,0,614,191,0,96,84,12,4844,4702,142,25,23,2,100
31125c58c8a6d2edf0bd7de4e31c44e18adc9a7f,2,79,4,75,0,0,0,3,33,90,1,1,0.999057404,517,192,1,131,117,14,4631,4167,464,46,43,3,100
404652e851ccc1c264d89b4e983bed929be5bf91,0,0,0,0,0,0,0,0,0,0,0,0,0,0,5,0,0,0,0,0,0,0,0,0,0,100
cc333af6e8b567d5c7bb4073e9a72020e6a67bcf,0,0,0,0,0,0,0,0,0,0,0,0,0,0,6,1,0,0,0,0,0,0,0,0,0,100
77943a9489bd49e53b1e8572fa9ea32ae02e5b04,0,0,0,0,0,0,0,0,0,0,0,0,0,0,308,0,0,0,0,0,0,0,0,0,0,100
4fb6c7b4b1df3bdcd5c40cf65241bf2e42a07d22,0,0,0,0,0,0,0,0,0,0,0,0,0,0,309,1,0,0,0,0,0,0,0,0,0,100
af55c7f8799a95a1f26a38d51309bd9c5246bc77,0,0,0,0,0,0,0,0,0,0,0,0,0,0,0,0,0,0,0,0,0,0,0,0,0,100
6ed73d88374aacbf3bd2ed5ddf30717944db347e,1,3,7,4,0,0,0,5,20,808,1,1,0,833,8,0,198,199,1,6362,6385,23,46,46,0,100
321c6b8383812ea7b3a27c02544d513e89bcdc59,0,0,0,0,0,0,0,0,0,0,0,0,0,0,9,1,0,0,0,0,0,0,0,0,0,100
1907f6408c4c499a0cc7b4bf016571a4b752a7f8,1,2,35,33,0,0,0,3,4,1829,1,1,0,137,0,0,14,19,5,873,1011,138,7,11,4,100
ab92cf1e6db021e83d8b42ac559f077ab17afa65,2,99,92,7,0,0,0,2,8,1436,1,2,0.499758016,357,1,1,50,56,6,2995,2652,343,21,25,4,99.84416741
b5ce624f8f12fd0be0f4928cecd7aeb469f9a460,0,0,0,0,0,0,0,0,0,0,0,0,0,0,1,1,0,0,0,0,0,0,0,0,0,100
b1cc951d9c2dfeb971e342006fcf6680b982a8fb,0,0,0,0,0,0,0,0,0,0,0,0,0,0,2,2,0,0,0,0,0,0,0,0,0,100
de87800c19ea06f53904a2948fcde29a57d2f051,0,0,0,0,0,0,0,0,0,0,0,0,0,0,3,3,0,0,0,0,0,0,0,0,0,100
2e40de917083c7c5583a61537b6447ab3af41918,2,10,0,10,0,0,0,12,34,203,2,2,0.721928095,936,11,2,281,279,2,6470,6432,38,95,93,2,100
c1c28c12add6bf4b19a8218037b52409970d9857,5,52,8,44,0,0,0,12,54,1067,3,5,1.886832823,2382,12,3,624,607,17,18922,18635,287,186,182,4,100
433ae4470f3a2853ff2319c11571ef15d2319875,0,0,0,0,0,0,0,0,0,0,0,0,0,0,7,2,0,0,0,0,0,0,0,0,0,100
a4b72a00786a25e13a7453ccb199cc74cefd4aed,0,0,0,0,0,0,0,0,0,0,0,0,0,0,4,4,0,0,0,0,0,0,0,0,0,100
a88e912dcd910aa9d0602ffe17cb0e4807d32363,0,0,0,0,0,0,0,0,0,0,0,0,0,0,22,0,0,0,0,0,0,0,0,0,0,100
a11d59f7a7f0fad96f153c161525a05881c5bf66,0,0,0,0,0,0,0,0,0,0,0,0,0,0,0,0,0,0,0,0,0,0,0,0,0,100
b3793fbb05ebea4135f1cc0c5e5899f0fb3210bf,0,0,0,0,0,0,0,0,0,0,0,0,0,0,310,1,0,0,0,0,0,0,0,0,0,100
0f8b3353f9f972412bbc8b5ab3e53899d6a40f72,0,0,0,0,0,0,0,0,0,0,0,0,0,0,1,1,0,0,0,0,0,0,0,0,0,100
c60ba61f3f7af368c456c4446ecdf117c9355f64,0,0,0,0,0,0,0,0,0,0,0,0,0,0,2,0,0,0,0,0,0,0,0,0,0,100
eb36a7fdecbf433f4b689392d8d61daa5f4b8ec3,1,1,1,0,0,0,0,3,5,491,1,1,0,287,3,1,80,80,0,2197,2194,3,29,29,0,100
f9b786db65a4aa8002ade2c4ec45c2c31dbe3b71,0,0,0,0,0,0,0,0,0,0,0,0,0,0,306,0,0,0,0,0,0,0,0,0,0,100
c11361a1902cf74f70313c72f9c54cbc121be2da,0,0,0,0,0,0,0,0,0,0,0,0,0,0,10,0,0,0,0,0,0,0,0,0,0,100
f0bb4e94ca620919db8acd887fab5485d495b6f4,0,0,0,0,0,0,0,0,0,0,0,0,0,0,23,0,0,0,0,0,0,0,0,0,0,100
907eccdfb32d6394dd63917dcff03dacf80741fa,0,0,0,0,0,0,0,0,0,0,0,0,0,0,311,1,0,0,0,0,0,0,0,0,0,100
54c1a9f7038b55e5ccc2eca1aa3ddbe73bdf74fd,0,0,0,0,0,0,0,0,0,0,0,0,0,0,265,0,0,0,0,0,0,0,0,0,0,100
ec1a7cdc7dd813b9e2dc238192010d9e66f09ab7,1,26,9,17,0,0,0,6,22,1632,1,1,0,279,24,1,93,89,4,2323,2205,118,18,18,0,100
dfaad7d8350f2603e0d07c7cbcf36f55996ab8f6,1,5,2,3,0,0,0,2,2,3517,1,1,0,302,266,1,17,17,0,2660,2662,2,14,14,0,100
85c95078d5c02e17a0356bb7f1589c91b435508e,2,50,13,37,0,0,0,6,25,473,1,1,0.503258335,916,4,2,279,264,15,6998,6697,301,117,114,3,100
8045c7841216974cafa8b04aa14fbd5aa893ba55,0,0,0,0,0,0,0,0,0,0,0,0,0,0,29,0,0,0,0,0,0,0,0,0,0,100
2742ba4b776377d7ebdc166214531788e8294776,12,1583,578,1005,1,0,1,8,27,1567,1,6,2.113098881,5338,5,3,1208,994,214,41244,36508,4736,661,558,103,99.44382647
d27790dfdde09a58db15064bbdaf77d224f61ecc,2,6,6,0,0,0,0,2,4,570,1,2,1,710,11,1,118,118,0,5847,5847,0,37,37,0,100
f47334a7475cd80960c070b4b2204ea2ab3e42ca,0,0,0,0,0,0,0,0,0,0,0,0,0,0,5,0,0,0,0,0,0,0,0,0,0,100
6edd4bc110a3fdde42659f797c588fa75432cc79,1,23,1,22,0,0,0,2,2,3414,1,1,0,22,111,0,4,1,3,395,175,220,2,1,1,100
517bf28489ebbf44dc39acbac972b30bb02043ba,0,0,0,0,0,0,0,0,0,0,0,0,0,0,312,1,0,0,0,0,0,0,0,0,0,100
e06db7deaa4a013e7ee64ed52572f63b3f990037,0,0,0,0,0,0,0,0,0,0,0,0,0,0,1,0,0,0,0,0,0,0,0,0,0,100
e6ee5b43ee48f8d78ff84e222f50f36df4745c81,8,255,3,252,0,0,0,22,48,703,3,4,2.241593782,1992,13,0,385,353,32,17010,15181,1829,148,139,9,100
b5014c606e5ad63b4bd2334375217e2fa09c90bd,21,1926,656,1270,7,0,7,1,67,627,3,7,3.732808253,3945,193,0,1160,920,240,36948,28561,8387,436,361,75,96.52394107
810d70531467ccd49c09b79885e06dd00ba1b17d,13,431,284,147,0,0,0,2,28,0,2,4,3.232757298,3092,313,2,728,733,5,24292,24204,88,280,280,0,100
8d7ac77a74479263ce59b9e22bb3def91b8b9326,8,543,114,429,2,0,2,12,55,177,3,5,2.197491295,4514,14,1,719,686,33,42515,39687,2828,272,250,22,95.8497053
c48e4c393b747b25f1c399a2c37175e5004d1526,3,11,0,11,0,0,0,9,29,8,1,2,1.322179346,1333,15,2,341,339,2,9331,9276,55,148,147,1,100
ea4e32d0657cbe5f161aa992578b0983636810ae,2,19,5,14,0,0,0,9,21,1032,1,2,0.650022422,286,0,0,62,60,2,2126,2060,66,19,18,1,96.81174089
c2ab99037637b7a918678c2fc46697fda95bfac2,5,20,5,15,0,0,0,10,30,150,1,4,1.956929658,2295,16,3,429,426,3,18264,18143,121,181,181,0,100
ce1342dd6dd7cbc4d1e35bea3b26d08dc24bd67e,2,152,89,63,0,0,0,3,9,139,2,2,0.846947608,474,0,0,98,89,9,3797,3606,191,27,25,2,100
bb745b9e90c517517f88cd66ccca845bf73dfeca,3,26,7,19,0,0,0,1,20,816,1,2,1.096139159,330,112,0,55,54,1,2531,2447,84,18,17,1,99.8480628
39a067a215dc247ff787567e8f25ae52b83e010d,1,1,1,0,0,0,0,7,11,3009,1,1,0,169,267,0,11,11,0,1190,1190,0,6,6,0,100
f0bab76e8ec18ccbdf98c1d2fa8cc765ffb346e7,0,0,0,0,0,0,0,0,0,0,0,0,0,0,25,0,0,0,0,0,0,0,0,0,0,100
efcc31e8dcd5038eaa964386c3e123fb90f1b28b,3,17,5,12,0,0,0,9,30,26,1,2,1.544024096,1460,194,1,253,252,1,10314,10214,100,102,101,1,100
0b02bd9f21eab4354b7d8479e05a38db75e5e1a0,1,2,0,2,0,0,0,18,85,311,1,1,0,319,12,0,89,87,2,2208,2202,6,31,31,0,100
e873515f5c9bd4cbc6eda9609034779bcddaf3a4,3,439,27,412,0,0,0,3,56,207,2,3,1.04288112,2119,6,0,653,611,42,19615,16256,3359,163,150,13,94.90699734
7a3f512655bc450fc58a466301c6b3c511076c8c,0,0,0,0,0,0,0,0,0,0,0,0,0,0,6,0,0,0,0,0,0,0,0,0,0,100
15cd0378ef54720349f28ef3f2624f93b4f5b30e,1,17,12,5,0,0,0,20,70,167,1,1,0,637,195,1,100,96,4,4883,4844,39,25,25,0,100
960f9481e6914e6591687c13e084a90fec1c2d02,1,2,0,2,0,0,0,7,22,857,1,1,0,340,17,3,85,83,2,2673,2667,6,21,21,0,100
c2b24adc71d21f2874e10266b7272f82999bc793,6,323,15,308,1,0,1,14,89,735,2,4,2.227684955,3565,8,0,636,599,37,32876,31243,1633,246,228,18,97.91144528
58c5c61d6ff4dafe9e5d0a366e9cb599e5d84a4c,0,0,0,0,0,0,0,0,0,0,0,0,0,0,7,1,0,0,0,0,0,0,0,0,0,100
2152ae16a1464963de0ceda03a84263bfbbbca5e,0,0,0,0,0,0,0,0,0,0,0,0,0,0,8,2,0,0,0,0,0,0,0,0,0,100
2105d5a2d15502e00eda8b1c657952f5ee96cb94,1,3,1,2,0,0,0,1,2,569,1,1,0,55,196,2,14,13,1,412,402,10,7,7,0,100
e616779727e64d632b1414ecea08de3239ac3bac,0,0,0,0,0,0,0,0,0,0,0,0,0,0,9,3,0,0,0,0,0,0,0,0,0,100
a531e8c685a0758e13d2862a98284110bc8faf22,1,21,18,3,0,0,0,14,90,6,1,1,0,1744,9,1,169,167,2,17032,17000,32,107,106,1,100
f848c9761bd340c9cbb790254420506d97c8e6b4,1,8,1,7,0,0,0,14,35,6,1,1,0,894,18,1,222,221,1,7202,7136,66,61,61,0,100
ed2926ece4d1ba7a3fa773f527853253bd3352ba,3,13,18,5,0,0,0,9,31,31,1,3,1.30797636,837,197,3,191,191,0,5334,5346,12,64,64,0,100
d99ea4b3fb6dad2c076f073d5b64b2ac5748f70a,4,22,7,15,0,0,0,4,104,460,2,4,1.553752034,1987,26,0,335,333,2,15614,15505,109,87,86,1,100
e17ef54d0f701bd5b8521d0ecd2908db32f984f3,5,75,76,1,0,0,0,9,57,1721,2,3,1.600196791,1498,198,3,299,299,0,11806,11670,136,81,81,0,100
928d86864b6e4c9244cd77c18c1d3d54d6a6a836,1,4,2,2,0,0,0,17,56,83,1,1,0,1254,13,0,294,294,0,10318,10311,7,52,52,0,100
47c18b9419f825fd6a15bbf9f22196b4ef49aefe,2,13,4,9,0,0,0,6,8,1025,1,1,0.522559375,119,10,2,24,23,1,980,947,33,9,8,1,100
ea66c181ba0d592ce2aff998ed84e4afd30a3d41,3,285,85,200,0,0,0,2,7,898,1,2,1.085064028,800,113,0,248,221,27,7135,5825,1310,105,92,13,99.77683553
5d0eba4e7a92afd11fd47f47d7352a976af430e0,2,5,2,3,0,0,0,3,22,516,1,1,0.985228136,1428,30,0,369,368,1,11861,11839,22,76,76,0,100
c5c73250b48217c0cdcc706ac654f352938bea41,1,29,0,29,0,0,0,7,23,0,1,1,0,831,31,1,205,199,6,6602,6380,222,47,46,1,100
5aab9b0c6d1379d3751e0d13f06819f143617fe4,0,0,0,0,0,0,0,0,0,0,0,0,0,0,10,2,0,0,0,0,0,0,0,0,0,100
f84993293127c2036667c8fbec30469d85e52991,0,0,0,0,0,0,0,0,0,0,0,0,0,0,11,3,0,0,0,0,0,0,0,0,0,100
c551f66556e01d69f2918831b8b93b0397b04d75,0,0,0,0,0,0,0,0,0,0,0,0,0,0,12,3,0,0,0,0,0,0,0,0,0,100
33f7fcbb681bfb82c12272c95aafd715ec716d9e,1,1,1,0,0,0,0,3,6,171,1,1,0,287,7,0,80,80,0,2197,2197,0,29,29,0,100
d653cea3c26b025ad7d6c37a2df41fff745fd952,6,279,4,275,1,0,1,13,53,336,4,6,1.492943291,2063,11,0,489,452,37,17995,16341,1654,183,170,13,99.86556128
12e35d2f15578619b6375c37dc2087cc3e1e6cce,4,8,7,1,0,0,0,7,15,991,1,1,1.921928095,1316,27,0,301,301,0,11366,11366,0,67,67,0,100
8f820e68e6e52b2e8e24befd6601ab27a79ff92c,0,0,0,0,0,0,0,0,0,0,0,0,0,0,0,0,0,0,0,0,0,0,0,0,0,100
4880939d4fd1f48508b981de46d55db8e5bc02be,0,0,0,0,0,0,0,0,0,0,0,0,0,0,13,0,0,0,0,0,0,0,0,0,0,100
e71eee708538b054e4e42764992f5aef87eeb0d2,0,0,0,0,0,0,0,0,0,0,0,0,0,0,14,1,0,0,0,0,0,0,0,0,0,100
122be98b6f2348951e860aead8d7e0bf1b88de79,0,0,0,0,0,0,0,0,0,0,0,0,0,0,15,2,0,0,0,0,0,0,0,0,0,100
e5e4be43cdde92fa15ff8afcdf1909c49572ae51,0,0,0,0,0,0,0,0,0,0,0,0,0,0,16,3,0,0,0,0,0,0,0,0,0,100
62a295ad19a62ce45e005e55fed25c4e40fb4862,0,0,0,0,0,0,0,0,0,0,0,0,0,0,17,4,0,0,0,0,0,0,0,0,0,100
2c62f14e1b032f7e60551d405893012db8746601,0,0,0,0,0,0,0,0,0,0,0,0,0,0,2,0,0,0,0,0,0,0,0,0,0,100
7eab2cb8d53ca4c86366e896119a1d7906ccb5b3,0,0,0,0,0,0,0,0,0,0,0,0,0,0,0,0,0,0,0,0,0,0,0,0,0,100
5266d890db65d53c57312254a414b5f52b6f6225,0,0,0,0,0,0,0,0,0,0,0,0,0,0,314,0,0,0,0,0,0,0,0,0,0,100
80b305f827092f5e006d556aba3e02acee052c2d,0,0,0,0,0,0,0,0,0,0,0,0,0,0,315,1,0,0,0,0,0,0,0,0,0,100
9fbfd2a1e4bf88cfdfeb5ff19da89d0a9517c8df,0,0,0,0,0,0,0,0,0,0,0,0,0,0,316,2,0,0,0,0,0,0,0,0,0,100
c8b3f778c15c1780b809445389ad562104bb1404,0,0,0,0,0,0,0,0,0,0,0,0,0,0,3,1,0,0,0,0,0,0,0,0,0,100
c45ab520f7d94b27cd59b387cf14e9651b8e6766,0,0,0,0,0,0,0,0,0,0,0,0,0,0,317,3,0,0,0,0,0,0,0,0,0,100
80f0aa687faf4aea23937e5584e6469f28bd602d,0,0,0,0,0,0,0,0,0,0,0,0,0,0,18,5,0,0,0,0,0,0,0,0,0,100
56d0093e417e8ed51ee3a1b68cc226f59191b096,0,0,0,0,0,0,0,0,0,0,0,0,0,0,1,0,0,0,0,0,0,0,0,0,0,100
83aa1f45b9aebea50c9e6c0847d16a821978ddd5,1,3,2,1,0,0,0,3,3,169,1,1,0,177,8,0,52,51,1,1709,1685,24,9,9,0,100
5362594e981e2bcc322dba945eaa446601958882,0,0,0,0,0,0,0,0,0,0,0,0,0,0,19,6,0,0,0,0,0,0,0,0,0,100
acb9880fa0f24089f7e566cc69436a074814df6a,1,84,33,51,0,0,0,2,2,443,1,1,0,71,318,4,28,13,15,958,541,417,3,3,0,100
bc2c21898805da9e3c749a108b319c18f777ff2b,1,1,1,0,0,0,0,4,6,202,1,1,0,78,9,1,16,15,1,544,534,10,4,4,0,100
49576ba7dffa3403a2917d7a8fc0d477cd31bc1f,1,2,2,0,0,0,0,7,24,82,1,1,0,855,28,0,205,205,0,6606,6602,4,47,47,0,100
f4f095367344a8e3028b9cfe2ca60f0e8922ca6f,0,0,0,0,0,0,0,0,0,0,0,0,0,0,20,7,0,0,0,0,0,0,0,0,0,100
619a0a9dbbff626508f3185dfa3ec4357a078d30,0,0,0,0,0,0,0,0,0,0,0,0,0,0,21,8,0,0,0,0,0,0,0,0,0,100
1c2eedffcf51259b7855e5d1c032dc02322376e1,0,0,0,0,0,0,0,0,0,0,0,0,0,0,22,9,0,0,0,0,0,0,0,0,0,100
e6efbddf848282c4b2fcd5a4dba864992ef97c55,0,0,0,0,0,0,0,0,0,0,0,0,0,0,23,10,0,0,0,0,0,0,0,0,0,100
a27a15f902face47839aef7f5a65ecb1ad4cbc4f,0,0,0,0,0,0,0,0,0,0,0,0,0,0,319,5,0,0,0,0,0,0,0,0,0,100
3a59132a5fb05516d590f3061fd10c8af32a86f9,0,0,0,0,0,0,0,0,0,0,0,0,0,0,1,0,0,0,0,0,0,0,0,0,0,100
b5ef017400d390bd891296721387d66229d6f1e1,0,0,0,0,0,0,0,0,0,0,0,0,0,0,24,6,0,0,0,0,0,0,0,0,0,100
4be86b58732ede51c6e0228a4ee102f7283d9652,0,0,0,0,0,0,0,0,0,0,0,0,0,0,25,6,0,0,0,0,0,0,0,0,0,100
2aa448c110a175f74aa8c8e3bb338fefc71ae8b1,0,0,0,0,0,0,0,0,0,0,0,0,0,0,14,0,0,0,0,0,0,0,0,0,0,100
c03ee72ca557eab49f2e315fc17aefcce03176ef,2,155,4,151,0,0,0,2,5,228,1,2,0.979098167,710,15,1,140,118,22,6765,5847,918,43,37,6,100
842890d27bf739a0949e82b58d9db1f1dd6111ea,8,126,85,41,0,0,0,2,57,454,4,7,2.707477608,5539,9,0,1111,1105,6,47687,47391,296,405,403,2,99.84266127
ff662427e54f675200646f52eb13db6084ef4ef3,7,215,151,64,0,0,0,5,105,499,2,6,2.310348718,4294,16,2,926,906,20,34895,34466,429,231,225,6,100
404f8a1a2d1c6d965b66d4d25f7c84543dde8626,0,0,0,0,0,0,0,0,0,0,0,0,0,0,26,2,0,0,0,0,0,0,0,0,0,100
3ca9650ca51b7c63c2f4f4d2cf7ff889820548f4,1,2,2,0,0,0,0,5,16,13,1,1,0,618,29,0,173,173,0,5665,5671,6,32,32,0,100
2588540ebef16c6fa4890bb15c7841042b13ab3c,10,595,2,593,5,0,5,4,86,486,2,6,2.081984237,1960,199,0,599,506,93,18071,14844,3227,222,186,36,99.75330792
bbdae910545aeeb6bca31b51f5dcbacd1b2fa639,0,0,0,0,0,0,0,0,0,0,0,0,0,0,200,1,0,0,0,0,0,0,0,0,0,100
2cfdcb2d980c31b0d4e4a381e0380c62268f2fa8,6,353,5,348,1,0,1,1,50,358,3,5,1.070740856,3253,32,0,628,604,24,29746,27461,2285,207,196,11,93.01755048
af2cc7496ef4c856545a730b2e0859066b8dd4b5,0,0,0,0,0,0,0,0,0,0,0,0,0,0,27,2,0,0,0,0,0,0,0,0,0,100
7b0ecd1dcb92dad5b9a0659f7b5f2a7fa1d95f93,0,0,0,0,0,0,0,0,0,0,0,0,0,0,114,0,0,0,0,0,0,0,0,0,0,100
e6f2a8afe3877db2f63e50137926ffe73ae6a991,0,0,0,0,0,0,0,0,0,0,0,0,0,0,28,3,0,0,0,0,0,0,0,0,0,100
0751f16250220271ce63ab7523de37e1f85defda,39,2645,306,2339,14,0,14,9,81,406,5,19,4.343749184,11389,201,2,3056,2805,251,104419,91959,12460,1043,887,156,95.02469362
92fdf298b5cfeb8e3d4b265085f9783af9d79cf6,11,44,16,28,0,0,0,4,106,1188,2,6,2.821348614,6288,33,1,1089,1083,6,53072,52861,211,414,412,2,100
4d027b4bf1a0c6b4329422a75518f010c579133a,0,0,0,0,0,0,0,0,0,0,0,0,0,0,29,3,0,0,0,0,0,0,0,0,0,100
2e0caefdd3b37df8ff9322dc4c14306d2df9dac6,2,2,2,0,0,0,0,7,12,396,1,2,1,293,115,1,41,41,0,2454,2450,4,22,22,0,100
f6ec21dfb85401b775d82e2727b7d94ddb637f34,2,66,2,64,0,0,0,4,68,148,1,2,0.478250164,1240,10,0,208,204,4,11188,10826,362,65,63,2,95.88988721
d7382ea61569ed8d5492bea53f41b3c038b9b654,0,0,0,0,0,0,0,0,0,0,0,0,0,0,30,3,0,0,0,0,0,0,0,0,0,100
ca96653919c4ab21482cf332a7a17f25f97316b4,0,0,0,0,0,0,0,0,0,0,0,0,0,0,2,0,0,0,0,0,0,0,0,0,0,100
3a0612f58ad2c49c00541305de9b71b650907420,0,0,0,0,0,0,0,0,0,0,0,0,0,0,12,0,0,0,0,0,0,0,0,0,0,100
683e2a91db50850014aa92a2abfa668d14624f1a,3,113,4,109,1,0,1,1,59,30,1,2,0.981668981,2545,19,0,631,622,9,21486,20772,714,149,144,5,99.92931613
eddda699def908895f17384735bf90e08f02d6bf,13,137,29,108,1,0,1,20,82,22,3,7,2.890611952,7080,202,2,1730,1713,17,58786,58252,534,446,440,6,93.82032835
e5f6ce43cd13adefd94fe45bbd9267124f91f559,0,0,0,0,0,0,0,0,0,0,0,0,0,0,30,0,0,0,0,0,0,0,0,0,0,100
ad27e8b6a7e47d3fc080f8223efa3382e366b8b6,0,0,0,0,0,0,0,0,0,0,0,0,0,0,31,4,0,0,0,0,0,0,0,0,0,100
12aeec0391de47d33d0c27eb901c7e8761d9a2cf,0,0,0,0,0,0,0,0,0,0,0,0,0,0,32,5,0,0,0,0,0,0,0,0,0,100
8d3c4ab0e8844f04e29f66acb3577e9d40de9a16,0,0,0,0,0,0,0,0,0,0,0,0,0,0,33,6,0,0,0,0,0,0,0,0,0,100
183c076b78e6f7e25cae48f961cb2c40846de179,0,0,0,0,0,0,0,0,0,0,0,0,0,0,34,5,0,0,0,0,0,0,0,0,0,100
7d7d1f3e1b1be9ea585398eb337208250730bda3,5,261,96,165,1,0,1,5,107,39,2,3,1.799593928,2127,17,0,522,499,23,17867,17172,695,154,141,13,93.45703125
5673d72287d59aaf2685030a727998f040abdd72,1,12,12,0,0,0,0,1,2,1,1,1,0,49,18,1,13,13,0,322,322,0,10,10,0,100
7e73fc2591f8177630f1ffd82e774b490832650a,2,6,2,4,0,0,0,16,74,6,1,1,0.811278124,3437,268,0,918,917,1,28587,28559,28,193,192,1,100
1366a648d08a23d9ff3b3eb3c1e85d069800522f,4,156,21,135,0,0,0,4,51,101,2,4,1.56675925,2077,11,1,474,444,30,18451,17474,977,126,120,6,100
85e3c5cf64747432bd434bbf1573224988c37bf6,1,9,5,4,0,0,0,16,58,1,1,1,0,1311,269,1,339,338,1,10715,10679,36,96,96,0,100
8077863b2f5a9c7ee4bd140eb954e24fef684785,18,1351,5,1346,7,0,7,10,73,628,3,8,2.695090348,3677,10,0,712,549,163,34817,28565,6252,236,201,35,99.54652997
a3e3b9c02167e7832324b99c7c412bfaeeab52a8,1,6,1,5,0,0,0,22,74,1,1,1,0,674,35,6,105,105,0,5171,5124,47,28,28,0,100
77914a3a0dafc0975ed5654ea5394d4215e2d426,2,18,9,9,0,0,0,5,28,14,1,1,0.999010271,1543,19,2,396,395,1,12925,12863,62,86,85,1,100
21606bdc20e3890ddf9d26555fc71e4175310950,2,80,28,52,0,0,0,2,5,424,1,2,0.67108289,388,4,0,60,60,0,3593,3103,490,19,17,2,100
0384f4c0f428200bdd8cb46a7ae418b7acd6afdc,1,8,6,2,0,0,0,5,11,188,1,1,0,376,6,0,85,84,1,3196,3201,5,18,17,1,100
7605f7a6aee531ec82637edb2eec0aad3d24dc85,0,0,0,0,0,0,0,0,0,0,0,0,0,0,36,5,0,0,0,0,0,0,0,0,0,100
efb0ee1df75ec0b03990c7e56feaa926314d9226,0,0,0,0,0,0,0,0,0,0,0,0,0,0,7,1,0,0,0,0,0,0,0,0,0,100
e6f78f28c8167c0099c1493fee51aac39abeebea,1,4,4,0,0,0,0,2,2,600,1,1,0,152,13,0,33,31,2,1093,1081,12,10,10,0,100
ed1c4854ba05093ac9484b2c96e284520414dfc3,1,3,1,2,0,0,0,18,75,34,1,1,0,2129,8,2,580,580,0,17921,17908,13,97,97,0,100
c5ad5810856e465efa0cbb2d33c1614d52ff3b00,0,0,0,0,0,0,0,0,0,0,0,0,0,0,20,0,0,0,0,0,0,0,0,0,0,100
4100684fa3f63cb2a6267ab24051002ce38de017,1,8,2,6,0,0,0,2,2,605,1,1,0,357,14,1,82,79,3,2520,2468,52,49,49,0,100
81888a9c7772b83437d009071e91fbd2a13cc831,1,4,0,4,0,0,0,3,10,1336,1,1,0,227,15,2,66,66,0,1644,1617,27,16,16,0,100
bac159f46502233081bcdda1a75c9f71197b31dd,0,0,0,0,0,0,0,0,0,0,0,0,0,0,37,2,0,0,0,0,0,0,0,0,0,100
c0cf04f7ece4af3734d1285c4385b46f8e556020,0,0,0,0,0,0,0,0,0,0,0,0,0,0,38,3,0,0,0,0,0,0,0,0,0,100
821b4c441153505db7f0ba9c5670623c527af989,2,186,24,162,0,0,0,5,29,28,1,1,0.108023195,1551,20,1,437,396,41,14105,12925,1180,90,86,4,100
127ed22e7b50b7384f62abad47d8d1a175e395d3,0,0,0,0,0,0,0,0,0,0,0,0,0,0,21,2,0,0,0,0,0,0,0,0,0,100
64bea6a5e98fbb87a76d53f9e7e2f5ca01671426,2,22,14,8,0,0,0,5,20,34,2,2,0.503258335,1195,22,2,333,331,2,9815,9779,36,94,94,0,100
aba97b35393f1732eb30858e69fd5f489634afdc,6,43,96,53,0,0,0,1,76,59,1,4,1.897235128,2635,203,0,645,653,8,21529,21825,296,146,147,1,100
7e2e130901f9876d5448d1155714daceccc25872,1,2,2,0,0,0,0,22,75,62,1,1,0,679,11,0,105,105,0,5169,5171,2,28,28,0,100
4691650dfe26f13884483bba6025cb66f4f818da,3,75,15,60,0,0,0,3,76,2014,1,3,1.51076012,949,116,0,145,139,6,7577,7114,463,50,48,2,100
07037d2f5328a85be7e106cbbe82ffc91c3ea77d,0,0,0,0,0,0,0,0,0,0,0,0,0,0,14,0,0,0,0,0,0,0,0,0,0,100
c3df22605795b9bddcba547852c04461ee9b8203,26,579,43,536,5,0,5,12,83,703,5,12,4.215451253,5205,204,1,1194,1131,63,43904,41303,2601,435,398,37,99.40334129
f3afbdb3953e8ddbfcab6177083227b6cb89ecba,2,2,1,1,0,0,0,1,3,326,1,2,0.918295834,147,205,2,24,24,0,1073,1062,11,24,24,0,100
35419d6c5a8b1b2bbba60e2f6d6fdf19efd8949b,13,609,240,369,0,0,0,13,69,538,3,4,2.975758297,4773,12,0,1122,1060,62,40915,38604,2311,330,304,26,100
3bdc51ea1e1ed463f8c2c35c8bfc1fbb4b792cab,1,2,2,0,0,0,0,18,60,90,1,1,0,1255,16,0,295,294,1,10302,10282,20,53,53,0,100
6648af332a234d606145a0440ac94da00782acc9,2,94,11,83,0,0,0,22,50,1968,2,2,0.999934571,920,23,3,174,151,23,7354,6841,513,61,54,7,100
fd26e12f689161fd85676b4a3d81cf1fcbd4e10a,1,1,1,0,0,0,0,18,77,17,1,1,0,2092,206,3,570,570,0,17687,17687,0,96,96,0,100
076904fa2bcbcc2b2e2563f7f6738ee10df2ffd4,0,0,0,0,0,0,0,0,0,0,0,0,0,0,39,0,0,0,0,0,0,0,0,0,0,100
aa001dbf7c08c9de2bb9eae27ac0581b09b5c403,0,0,0,0,0,0,0,0,0,0,0,0,0,0,40,1,0,0,0,0,0,0,0,0,0,100
47cca6fc1efb7b5c4158c0262f1ef2c434719f0a,0,0,0,0,0,0,0,0,0,0,0,0,0,0,41,2,0,0,0,0,0,0,0,0,0,100
a098068614bac0902eb8ccc8ce297f3ac1f580c1,0,0,0,0,0,0,0,0,0,0,0,0,0,0,42,3,0,0,0,0,0,0,0,0,0,100
e2a0c10393558d2b4454e2da574cbfeedd043956,1,2,0,2,0,0,0,22,77,20,1,1,0,686,43,4,106,106,0,5281,5251,30,28,28,0,100
eec5d77f273ecbd10bfcfa3e10036a3f19994233,0,0,0,0,0,0,0,0,0,0,0,0,0,0,31,0,0,0,0,0,0,0,0,0,0,100
6ced16be4cc8c367a16fdfea3a11185c5a3206ef,2,12,0,12,0,0,0,1,2,94,1,1,0.650022422,675,12,1,120,118,2,4337,4271,66,7,7,0,100
4f74de1498ef9f191f2b6d21d963d6de6ca0c5f9,0,0,0,0,0,0,0,0,0,0,0,0,0,0,0,0,0,0,0,0,0,0,0,0,0,100
8f1bd684e4168c4cf6f0f05a8cb64acb18c90a5b,0,0,0,0,0,0,0,0,0,0,0,0,0,0,0,0,0,0,0,0,0,0,0,0,0,100
ab23b99c50ec355773da35da2af5a2c3d01c3cec,1,3,3,0,0,0,0,9,10,371,1,1,0,267,0,0,45,45,0,2034,2034,0,16,16,0,100
fac8349593a63a1578f9337712e4c1db055abcd8,1,1,1,0,0,0,0,10,21,126,1,1,0,552,0,0,42,42,0,5266,5266,0,24,24,0,100
3356dfc5f847f607d8dddef4eddda0f642dc6c76,0,0,0,0,0,0,0,0,0,0,0,0,0,0,1,1,0,0,0,0,0,0,0,0,0,100
36678ab1f331eb717578c3b2ed6677544ac3aa2a,5,54,10,44,0,0,0,1,4,159,1,2,1.76837518,758,207,4,169,161,8,5720,5446,274,103,99,4,100
6d8718483f9ef60906addd7c2bb94785039986ac,0,0,0,0,0,0,0,0,0,0,0,0,0,0,2,2,0,0,0,0,0,0,0,0,0,100
edf9936ce9692011a69be2cd58817e70942aa574,1,9,8,1,0,0,0,18,61,22,1,1,0,1255,17,1,295,295,0,10285,10302,17,53,53,0,100
e993f85d7b2c5e11914a328f4b3aee4392c4e106,3,12,9,3,0,0,0,15,91,839,1,3,1.312744353,3264,34,0,539,535,4,28971,28931,40,232,232,0,100
a9e528bca9277707a1847d110c33288188a8fff5,3,69,13,56,0,0,0,2,87,156,1,3,1.064388436,664,18,2,186,172,14,5419,5000,419,65,61,4,100
ff0c65a49fb4617b85a5b8a674be53305f5cf64b,1,3,3,0,0,0,0,4,4,2333,1,1,0,89,0,0,18,18,0,783,783,0,7,7,0,100
f96a6530c09a83e4f0d6613e558c4e2e5d5f236a,0,0,0,0,0,0,0,0,0,0,0,0,0,0,3,3,0,0,0,0,0,0,0,0,0,100
ef43a55fccf60bafd1ce1a5c0f2565d6da0e0620,3,138,0,138,1,0,1,1,27,151,2,2,0.123778468,156,208,3,42,30,12,1965,1177,788,22,16,6,100
005d8674e09338504278440658af3159c8e5a967,0,0,0,0,0,0,0,0,0,0,0,0,0,0,0,0,0,0,0,0,0,0,0,0,0,100
ae3f655872c3a114ef1b38e2de77d270530e8db6,0,0,0,0,0,0,0,0,0,0,0,0,0,0,44,5,0,0,0,0,0,0,0,0,0,100
f9d447d6ec0c6ac7a240b8965bac69fb4bf9c50d,0,0,0,0,0,0,0,0,0,0,0,0,0,0,45,6,0,0,0,0,0,0,0,0,0,100
8db2ccc5ec05c1b2eaeae29bed7951d53fd87443,0,0,0,0,0,0,0,0,0,0,0,0,0,0,270,0,0,0,0,0,0,0,0,0,0,100
0a43c1980c75f37a58fbb69347ec7a0e8f508126,0,0,0,0,0,0,0,0,0,0,0,0,0,0,46,7,0,0,0,0,0,0,0,0,0,100
f048f84e78840387822d5ab5a5678f17756aa0b1,0,0,0,0,0,0,0,0,0,0,0,0,0,0,47,8,0,0,0,0,0,0,0,0,0,100
e8832f0dbb203dc33475a49711463929b984a37b,0,0,0,0,0,0,0,0,0,0,0,0,0,0,48,9,0,0,0,0,0,0,0,0,0,100
1078f25e90134be4a7e9f35f9774c113909aba97,0,0,0,0,0,0,0,0,0,0,0,0,0,0,117,0,0,0,0,0,0,0,0,0,0,100
01f5eea5c60b710e16370b7e09a60a5353f8d17d,1,2,1,1,0,0,0,9,20,1518,1,1,0,210,19,2,63,62,1,1743,1730,13,7,7,0,100
2afbf4daa650f49674ca1c7481697b852cb6a446,6,41,5,36,0,0,0,9,32,399,1,3,2.054196738,2864,13,0,621,612,9,22318,21991,327,262,261,1,100
cf925b6821854a6d6accd1875a3b67805cae110c,0,0,0,0,0,0,0,0,0,0,0,0,0,0,49,5,0,0,0,0,0,0,0,0,0,100
817afa0a33d31a32f5ed94e30a8e6584eccf77a9,0,0,0,0,0,0,0,0,0,0,0,0,0,0,50,6,0,0,0,0,0,0,0,0,0,100
0ac4b12be7c38ba34951da6bdbe82d23968cce13,4,48,58,10,0,0,0,2,88,59,1,3,1.586274626,732,209,2,185,190,5,5498,5624,126,67,68,1,100
2eb2b868fb802d99ec1bde99fffcd1416e7f516d,9,445,268,177,0,0,0,9,33,199,1,4,1.825974888,6125,14,1,1332,1293,39,42823,41738,1085,689,678,11,100
ddf3bcff29b903f1efc6671285ddf8f3cc10c7c3,0,0,0,0,0,0,0,0,0,0,0,0,0,0,51,7,0,0,0,0,0,0,0,0,0,100
b0323398ff5e554b3818f18581651b140535ca88,1,1,1,0,0,0,0,13,28,443,1,1,0,556,0,0,97,97,0,4333,4337,4,27,27,0,100
244c5d519432754841709687aa008e544822dae3,0,0,0,0,0,0,0,0,0,0,0,0,0,0,52,6,0,0,0,0,0,0,0,0,0,100
fa044447f535f2b1f9315e8a7b75d9744c22fb9f,0,0,0,0,0,0,0,0,0,0,0,0,0,0,32,0,0,0,0,0,0,0,0,0,0,100
01082f1ea84d8c98cf4b7efc5bc88e0c71404e3f,3,3,1,2,0,0,0,9,34,24,1,2,1.5,1584,15,2,293,293,0,11148,11145,3,138,138,0,100
77b03aa1407ec6d78cc0fcaf9a06654191d42d73,7,30,21,9,0,0,0,7,89,759,1,2,2.460216717,1984,20,0,535,533,2,15253,15192,61,164,162,2,100
2f6f20474bc08c9706b26c0a09d6092b69e8590f,0,0,0,0,0,0,0,0,0,0,0,0,0,0,53,2,0,0,0,0,0,0,0,0,0,100
475a89b30864bd95909837a2b3480779fc7ee5e2,0,0,0,0,0,0,0,0,0,0,0,0,0,0,54,1,0,0,0,0,0,0,0,0,0,100
1868a2ddaf044fb1f5d4df5a7a3a765b213ad6ed,2,56,13,43,0,0,0,3,28,305,2,2,0.109285715,185,16,0,44,39,5,1718,1482,236,21,17,4,100
fbaaa59e36010a4358d069aec8eebb7f48d59d24,2,3,1,2,0,0,0,8,17,512,1,1,0.811278124,326,24,0,51,51,0,2721,2707,14,15,15,0,100
c1dc84cdeeb1b5c3a53f2bec01ae138e5f578dd1,0,0,0,0,0,0,0,0,0,0,0,0,0,0,21,0,0,0,0,0,0,0,0,0,0,100
4c7aea1a170a1173fa1bb13023c79d52f5f27799,2,9,6,3,0,0,0,9,20,847,1,2,0.918295834,396,35,0,60,57,3,3414,3388,26,26,26,0,100
8725f31af9821907ced99a829b9e0dbbf3f6de2b,5,102,12,90,0,0,0,4,78,698,2,4,1.743488908,3937,22,1,935,921,14,34061,33402,659,221,217,4,100
217067210012798f88067582efbf8432474758ca,1,1,1,0,0,0,0,2,2,139,1,1,0,90,23,2,12,12,0,770,770,0,6,6,0,100
e9c99739010b451638ad90773ca8d36e86fd2841,0,0,0,0,0,0,0,0,0,0,0,0,0,0,55,0,0,0,0,0,0,0,0,0,0,100
9a5c5c5a39bbc5167127e25bf243c8cf93d81971,0,0,0,0,0,0,0,0,0,0,0,0,0,0,56,1,0,0,0,0,0,0,0,0,0,100
b667943ff5217e8dc328dbd7f41c2c89199a78dd,0,0,0,0,0,0,0,0,0,0,0,0,0,0,57,2,0,0,0,0,0,0,0,0,0,100
98c6cea0140d64761542e603532d13127a0524b4,1,3,0,3,0,0,0,2,4,138,1,1,0,209,24,2,59,59,0,1553,1532,21,19,19,0,100
a7ac64d54954064be6b0f56c04f05bbe128772d5,1,8,6,2,0,0,0,10,21,540,1,1,0,276,271,0,51,50,1,2045,2021,24,15,15,0,100
cd4bb5497c28456c9a816eb7e6e37e1e1029c74d,0,0,0,0,0,0,0,0,0,0,0,0,0,0,0,0,0,0,0,0,0,0,0,0,0,100
2576a236913915a928e48edc186d25461dae5774,0,0,0,0,0,0,0,0,0,0,0,0,0,0,1,1,0,0,0,0,0,0,0,0,0,100
4405b6795d264c208d94f9dd7c592ef3516ade24,0,0,0,0,0,0,0,0,0,0,0,0,0,0,320,0,0,0,0,0,0,0,0,0,0,100
7917e548a9bf184fba9ed7b227bc153a7f11e949,0,0,0,0,0,0,0,0,0,0,0,0,0,0,58,3,0,0,0,0,0,0,0,0,0,100
e3cbaabfba4f0aeb606c696492747759a8d34423,3,82,3,79,0,0,0,4,101,433,1,3,1.354825352,2643,17,0,560,547,13,21427,20876,551,214,210,4,100
8edec03affcc9881a3d55f0f3cf9893829bed3bd,1,1,1,0,0,0,0,12,18,598,1,1,0,513,25,1,124,124,0,4254,4258,4,30,30,0,100
98b7118c1034c98ee403ab6083dc3c9670df5d1f,0,0,0,0,0,0,0,0,0,0,0,0,0,0,13,0,0,0,0,0,0,0,0,0,0,100
d160138d5e7d23cd8c4345dba55c140dc9bc84b2,2,29,2,27,0,0,0,2,11,1400,1,2,0.554778163,443,0,0,104,102,2,3706,3448,258,40,39,1,100
625bfd2064b36597eee795b51ed03b1d39190107,1,8,0,8,0,0,0,8,23,581,1,1,0,342,1,1,89,85,4,2713,2673,40,21,21,0,100
d7605a254626a97b247aecdd3964c1b80d296a2d,0,0,0,0,0,0,0,0,0,0,0,0,0,0,25,0,0,0,0,0,0,0,0,0,0,100
77d2c21b5f2c045c9e3ff47ed51641328f704489,0,0,0,0,0,0,0,0,0,0,0,0,0,0,0,0,0,0,0,0,0,0,0,0,0,100
3b477dc91ee8e40ec5f9c45278183b886f9ee6ce,0,0,0,0,0,0,0,0,0,0,0,0,0,0,1,1,0,0,0,0,0,0,0,0,0,100
31c0edb3fd0bf7480a5d7bf2eb9d3c05bdcfe987,0,0,0,0,0,0,0,0,0,0,0,0,0,0,2,2,0,0,0,0,0,0,0,0,0,100
d0d195cc0204e6c4fb1e87c9d758318eefb849e7,2,25,4,21,0,0,0,2,17,1439,1,2,0.735508582,975,33,0,180,179,1,11519,11295,224,154,153,1,99.81891348
b612a9458004ee6601a6ad58d7ec88f8b322a49e,1,4,0,4,0,0,0,2,5,89,1,1,0,212,26,0,59,59,0,1581,1553,28,19,19,0,100
d7547c493f25f3e1acc5572ce7159068d6b2d00e,7,364,9,355,2,0,2,1,59,252,2,5,1.734976066,2423,3,3,579,547,32,21381,19057,2324,155,139,16,99.89945707
097f50eae35e927411af3593fa401a335e61a0e3,1,86,127,41,0,0,0,8,29,295,1,1,0,667,272,0,169,166,3,5577,5646,69,81,77,4,100
fbbefce84eaa0e846faa01eb79b79a8f3184348f,5,170,7,163,1,0,1,4,78,1424,2,4,1.424633515,1374,118,0,290,258,32,11490,10476,1014,59,54,5,99.95983936
5deac6277cb5e0676e811f682da2a7692a9f628e,0,0,0,0,0,0,0,0,0,0,0,0,0,0,59,0,0,0,0,0,0,0,0,0,0,100
50203e025852eda970bc812d9ba5ed2e5ba4242b,0,0,0,0,0,0,0,0,0,0,0,0,0,0,2,0,0,0,0,0,0,0,0,0,0,100
38caee17c9a80ea6196ec3363e0f3d58c905c580,0,0,0,0,0,0,0,0,0,0,0,0,0,0,3,1,0,0,0,0,0,0,0,0,0,100
e962143866f69ad96a2207e07a5f0ce1d2e4797e,1,1,0,1,0,0,0,5,12,306,1,1,0,253,4,2,74,74,0,1805,1793,12,18,18,0,100
25dc63d69f37a13ddc3398dfbcacbf5bfd2b07a7,0,0,0,0,0,0,0,0,0,0,0,0,0,0,60,1,0,0,0,0,0,0,0,0,0,100
684b4a0b801c9c0ad4659a5a8521255d40c2e0c6,0,0,0,0,0,0,0,0,0,0,0,0,0,0,61,2,0,0,0,0,0,0,0,0,0,100
d6e84a80406ff13af4885ff02202b7447b728be3,0,0,0,0,0,0,0,0,0,0,0,0,0,0,62,3,0,0,0,0,0,0,0,0,0,100
9f270729eadeed0fcfc6aecf25b3afb130cac2e5,0,0,0,0,0,0,0,0,0,0,0,0,0,0,63,4,0,0,0,0,0,0,0,0,0,100
cdc73aeb7a55b484f31ed39913647703d66706d5,0,0,0,0,0,0,0,0,0,0,0,0,0,0,64,5,0,0,0,0,0,0,0,0,0,100
6e4d369fd8b1f1529af14261d084c877109b58c6,0,0,0,0,0,0,0,0,0,0,0,0,0,0,5,3,0,0,0,0,0,0,0,0,0,100
953f65b9c421432ebbf755214769b074d0847bae,5,56,23,33,0,0,0,4,25,3034,3,5,1.890512943,771,34,0,169,158,11,5543,5306,237,69,65,4,100
98b43fc9d70afce4cd226bd1e3439ee7a76a3467,4,79,7,72,0,0,0,13,71,743,3,4,1.661656428,2059,22,0,345,337,8,17140,16652,488,131,125,6,99.9397953
068d1fae3fffe9207e10a62c53f41dc38b9251d9,0,0,0,0,0,0,0,0,0,0,0,0,0,0,65,5,0,0,0,0,0,0,0,0,0,100
b9d4dd113a8ac12227b301daba3065f64d749d1d,0,0,0,0,0,0,0,0,0,0,0,0,0,0,66,6,0,0,0,0,0,0,0,0,0,100
3ad3f30ee5b74c1b231e82c4dd414da07b6a36c1,0,0,0,0,0,0,0,0,0,0,0,0,0,0,67,7,0,0,0,0,0,0,0,0,0,100
e57204bd55d27f258c19e7334c10cc4802cf14c7,1,10,2,8,0,0,0,2,2,477,1,1,0,167,6,1,29,27,2,1501,1475,26,14,14,0,100
926fb297c13574e761db4798763780715af2477e,0,0,0,0,0,0,0,0,0,0,0,0,0,0,68,6,0,0,0,0,0,0,0,0,0,100
60898d5888a7a6426680d70ae277a56401f096d4,0,0,0,0,0,0,0,0,0,0,0,0,0,0,0,0,0,0,0,0,0,0,0,0,0,100
909d9531ca8031144f82e2be963dc27b5e780b4e,4,39,14,25,0,0,0,5,79,64,2,4,1.107563603,1423,210,0,273,268,5,11021,10882,139,56,56,0,100
913d43b19125a1127364ba3cf365c1f0bdf90035,0,0,0,0,0,0,0,0,0,0,0,0,0,0,14,0,0,0,0,0,0,0,0,0,0,100
a2eaca4ed9a992b42bed18ba73c1da6ed414566e,1,27,18,9,0,0,0,4,9,346,1,1,0,64,211,1,10,10,0,559,514,45,6,6,0,100
5053f93744dfdde26ebcd7f1d40f037c108803ae,0,0,0,0,0,0,0,0,0,0,0,0,0,0,69,4,0,0,0,0,0,0,0,0,0,100
23d5ef44807b21c78673d8f18dca53951688e6f7,0,0,0,0,0,0,0,0,0,0,0,0,0,0,70,5,0,0,0,0,0,0,0,0,0,100
0aa45c8657a071bd4ee9e698abbeba81e1e542c6,1,6,3,3,0,0,0,18,78,902,1,1,0,844,7,1,183,183,0,7109,7094,15,53,53,0,100
a0e08b5ee8f3da1e3becd9e280d3e48bc6ffaff5,0,0,0,0,0,0,0,0,0,0,0,0,0,0,35,0,0,0,0,0,0,0,0,0,0,100
dbdc4225706ff40b0bc1a81a6d8cdc4a93fe53ae,0,0,0,0,0,0,0,0,0,0,0,0,0,0,71,3,0,0,0,0,0,0,0,0,0,100
71fd77129e91d05dd3ec582bc20968c1993ef905,0,0,0,0,0,0,0,0,0,0,0,0,0,0,72,4,0,0,0,0,0,0,0,0,0,100
028e3e0b85ee63619924a157f1bf790a2fd9f213,1,1,1,0,0,0,0,4,5,880,1,1,0,111,0,0,14,14,0,868,873,5,7,7,0,100
375a6e43f1cf3241172a7955028e11012f2c4dea,0,0,0,0,0,0,0,0,0,0,0,0,0,0,8,1,0,0,0,0,0,0,0,0,0,100
8b48f0183e5ae34da1a7bad33aa75c427d35d063,7,36,73,37,0,0,0,4,78,1342,5,7,1.97422444,2472,1,0,475,480,5,19363,19557,194,122,122,0,100
a8ecfdf8d735b56f35af9c0e6f47990b91910ba0,10,121,38,83,0,0,0,5,79,420,5,9,2.670269994,2775,2,0,542,531,11,22611,22097,514,137,136,1,100
11627e33d3b262d60ae0a3c6338f7963ffedaeab,2,136,21,115,0,0,0,4,10,1627,1,2,0.098446973,380,4,0,101,79,22,3184,2470,714,49,44,5,100
261331bbd1fa8e50517421ab834f01f89f4997e1,11,575,28,547,2,0,2,6,84,708,5,7,2.353103867,2237,27,0,503,434,69,20085,17464,2621,169,139,30,99.89977951
c7c6f3699ab2ffe3fbebfbb2885e3dd1c997c345,5,128,1,127,1,0,1,1,31,19,3,4,1.389402097,533,23,0,114,99,15,4825,4097,728,48,44,4,99.91990388
389cd417bb2741e306e9b12d6fee3e0db1bf59bf,0,0,0,0,0,0,0,0,0,0,0,0,0,0,24,1,0,0,0,0,0,0,0,0,0,100
fc60a07e4de4fcd7a4fc5d6659dc860f4f55b4fa,0,0,0,0,0,0,0,0,0,0,0,0,0,0,212,0,0,0,0,0,0,0,0,0,0,100
80b3c11d1f8b7deb4e35427635b15c1252fc40c7,0,0,0,0,0,0,0,0,0,0,0,0,0,0,73,0,0,0,0,0,0,0,0,0,0,100
f08003d136562f47ca93fe5b645cab2e235bb208,0,0,0,0,0,0,0,0,0,0,0,0,0,0,74,1,0,0,0,0,0,0,0,0,0,100
a5ffaae5cb8649a476b233db83ebe1f149991f5d,2,12,8,4,0,0,0,9,41,125,1,2,1,630,28,0,117,116,1,4837,4795,42,38,38,0,100
8ed4c5e7cb3c7efb6a39e5c8342b5ff90d5810be,0,0,0,0,0,0,0,0,0,0,0,0,0,0,5,0,0,0,0,0,0,0,0,0,0,100
680f23fab55f35cf65a5189ae3882ebe360b1b01,1,26,2,24,0,0,0,2,2,53,1,1,0,208,6,1,40,38,2,1445,1353,92,20,19,1,100
65bcd9f57354fd5e50435d299df8508c14108184,2,139,14,125,1,0,1,1,6,35,1,2,0.983636926,111,7,2,31,14,17,1471,868,603,10,7,3,99.3066561
88b7d336a99d7a64aaca565dbaf73910c7d54308,1,1,1,0,0,0,0,1,2,0,1,1,0,56,8,3,9,9,0,411,411,0,3,3,0,100
d9ce6089fee5749d69b525e49c2b446202b800ab,0,0,0,0,0,0,0,0,0,0,0,0,0,0,36,0,0,0,0,0,0,0,0,0,0,100
7581672b7a0d2ecd4588667bc225c9da90810937,20,274,42,232,1,0,1,2,90,1821,4,15,3.663416925,2841,37,1,537,513,24,24249,22736,1513,243,221,22,99.08578098
6721c0d949863931896e6e0737470d387f71431b,8,76,31,45,0,0,0,3,21,2048,2,7,1.808410008,2916,25,1,633,624,9,24237,23855,382,185,182,3,100
c0700e436afccc04e7f77480d6fb8aed8e293db4,3,25,1,24,0,0,0,2,108,1670,2,2,0.621904142,272,29,1,11,9,2,2482,2318,164,6,6,0,99.96137505
69d0873eb5893b154a1f149b1691a0b1d7218d00,0,0,0,0,0,0,0,0,0,0,0,0,0,0,9,4,0,0,0,0,0,0,0,0,0,100
a285f06ad8bc56890f0d796ec6b5eb4ef93b8071,0,0,0,0,0,0,0,0,0,0,0,0,0,0,75,2,0,0,0,0,0,0,0,0,0,100
041e7d737efbe243ebeb525ae4af1941b1008ee2,8,1258,116,1142,1,0,1,23,80,893,4,6,1.178872508,2119,10,5,578,398,180,23923,16785,7138,201,141,60,99.90345627
7ed56dbe6c0d38bbe3b3dc08228c6766768d5fb2,0,0,0,0,0,0,0,0,0,0,0,0,0,0,38,2,0,0,0,0,0,0,0,0,0,100
2be96918c89e54da15ce399f774a1938ab07f3db,1,31,7,24,0,0,0,2,3,146,1,1,0,173,9,0,36,29,7,1587,1501,86,14,14,0,100
10a7c76c8e07a60c65109391e76970714f2122e2,1,7,1,6,0,0,0,15,39,414,1,1,0,907,30,1,227,225,2,7271,7242,29,61,61,0,100
b4ee37b6d850baa0803deb39652e6f4ff6d665e7,4,632,28,604,1,0,1,3,11,1353,1,3,1.553797363,377,0,0,100,51,49,7383,3047,4336,40,22,18,99.15730337
dd0f137e80fce60bc7a9639985c540effe18b195,0,0,0,0,0,0,0,0,0,0,0,0,0,0,76,1,0,0,0,0,0,0,0,0,0,100
7211f4724fe827ebec1a6c1891a9b46b72f3553f,1,3,3,0,0,0,0,20,79,369,1,1,0,2121,11,1,580,579,1,17978,17974,4,98,98,0,100
dd2722599da8edd9ce22c8ba5153a15decfee230,1,1,0,1,0,0,0,2,6,249,1,1,0,216,31,1,59,59,0,1588,1581,7,19,19,0,100
14e81aa648a950043ec09d4221c1f8551d50860c,1,11,7,4,0,0,0,1,2,44,1,1,0,765,12,1,164,164,0,6500,6471,29,55,55,0,100
b7809ab39868af4d9446fa64a14422ee5609066c,0,0,0,0,0,0,0,0,0,0,0,0,0,0,39,0,0,0,0,0,0,0,0,0,0,100
1db78435f48f2f2f6cff5d1daf1fd8d3deea3068,2,161,69,92,0,0,0,5,30,596,1,1,0.704192094,1692,36,0,453,438,15,14487,14126,361,93,90,3,100
a4ee6c05ad6e8759cf2945024684bfbd1e7af8e1,11,958,18,940,3,0,3,24,109,451,3,9,2.696518336,2498,1,0,561,433,128,25477,20519,4958,188,138,50,91.03343465
bc2e13cd119663f3e827fb05e4a5d5d25026b411,0,0,0,0,0,0,0,0,0,0,0,0,0,0,77,0,0,0,0,0,0,0,0,0,0,100
2543b19b6efc85b5a92b3e3474898b7d9f0075b1,0,0,0,0,0,0,0,0,0,0,0,0,0,0,78,1,0,0,0,0,0,0,0,0,0,100
2df43c237c5a6f95b3cbe5004088bf41d6d49ff3,1,4,4,0,0,0,0,21,110,13,1,1,0,236,3,0,6,6,0,2050,2050,0,4,4,0,100
c53c1095c5895e086a9f0366225932b825ef37b9,0,0,0,0,0,0,0,0,0,0,0,0,0,0,0,0,0,0,0,0,0,0,0,0,0,100
11ed7f75c0473f2b8265db425400b749882d8ce4,3,45,6,39,0,0,0,15,92,395,1,3,1.413419523,2221,32,0,304,299,5,20720,20470,250,150,148,2,99.94034599
c90b4568e8854fcfbf2fda6453ad6fd0610b559a,0,0,0,0,0,0,0,0,0,0,0,0,0,0,0,0,0,0,0,0,0,0,0,0,0,100
9383be7e94d64d514372b270a1c2e79d27dc5a75,0,0,0,0,0,0,0,0,0,0,0,0,0,0,321,0,0,0,0,0,0,0,0,0,0,100
35627e5b191d6697b6fee6422067734620b78dad,1,3,3,0,0,0,0,7,8,990,1,1,0,199,13,0,25,25,0,1596,1594,2,12,12,0,100
8e5dbabd1b06e0d8e1594e456fe112e7514ee1d1,0,0,0,0,0,0,0,0,0,0,0,0,0,0,40,0,0,0,0,0,0,0,0,0,0,100
4226d82d860374681cd8657dcda5a856380b9bad,0,0,0,0,0,0,0,0,0,0,0,0,0,0,0,0,0,0,0,0,0,0,0,0,0,100
8b4ca740acf2b8e67dc89966fe4734b4c5d56b51,1,5,5,0,0,0,0,2,4,686,1,1,0,217,14,0,46,46,0,1378,1399,21,29,29,0,100
2eb180ca60d900f5fa3c00915a8d72666b5c55b4,0,0,0,0,0,0,0,0,0,0,0,0,0,0,1,1,0,0,0,0,0,0,0,0,0,100
f10c8482bd41da0acb514114068fcc014d39d242,0,0,0,0,0,0,0,0,0,0,0,0,0,0,2,2,0,0,0,0,0,0,0,0,0,100
be824ba8c567ca9f307dbc6ea2534b0751d5369d,1,3,10,7,0,0,0,11,30,331,1,1,0,614,322,0,142,142,0,4638,4680,42,16,16,0,100
fdb3ab85b695e119970db277ca2dbdec4d0f5e16,0,0,0,0,0,0,0,0,0,0,0,0,0,0,3,3,0,0,0,0,0,0,0,0,0,100
c0f318f18ff621a4fe88fd49f3d2fad8468d2de4,0,0,0,0,0,0,0,0,0,0,0,0,0,0,4,4,0,0,0,0,0,0,0,0,0,100
eb38d8f34715728e1859c0d7d5e11403c92885c5,3,4,4,0,0,0,0,10,35,1297,1,3,1.5,684,26,0,160,160,0,4021,4021,0,58,58,0,100
1b0dff89e26ff06f7b14456369975fe696f05ebc,7,90,8,82,0,0,0,5,111,881,3,6,1.542178442,4731,33,0,840,835,5,41273,40727,546,270,269,1,100
224f6ade1e438b930432fa1b461332f72dc4ca3c,0,0,0,0,0,0,0,0,0,0,0,0,0,0,5,3,0,0,0,0,0,0,0,0,0,100
fd55c6fe2695c62338c0cfa751d1e019a523e81f,1,2,1,1,0,0,0,3,8,1006,1,1,0,394,0,0,145,144,1,3227,3212,15,24,24,0,100
e1aa485dd44d0258a6077a713e19940e203f8c8f,0,0,0,0,0,0,0,0,0,0,0,0,0,0,323,0,0,0,0,0,0,0,0,0,0,100
23aacc831ca82178ecb4b26c4e373fb59c3dcbff,0,0,0,0,0,0,0,0,0,0,0,0,0,0,1,0,0,0,0,0,0,0,0,0,0,100
27f31c35121cbbfccc36de0c1974c95c00ebf2cd,0,0,0,0,0,0,0,0,0,0,0,0,0,0,6,1,0,0,0,0,0,0,0,0,0,100
fb4d43a50fe9acf30f379fda46dfe7e2e0fb4a24,0,0,0,0,0,0,0,0,0,0,0,0,0,0,7,2,0,0,0,0,0,0,0,0,0,100
4387d9795b60bfa0a01f81ba208030dadc9430bf,1,6,6,0,0,0,0,4,4,279,1,1,0,46,2,1,3,3,0,331,331,0,3,3,0,100
362f6c1b61247492367af1e5627960588bcc204b,1,2,2,0,0,0,0,16,40,255,1,1,0,911,15,0,229,227,2,7291,7271,20,61,61,0,100
e1726d6cb85aa5821176a149d7b9aa9d4abb4df3,0,0,0,0,0,0,0,0,0,0,0,0,0,0,0,0,0,0,0,0,0,0,0,0,0,100
8543adb69d57584f8c1ca6401410df04867f34fb,1,50,34,16,0,0,0,4,6,480,1,1,0,432,34,0,91,87,4,3667,3599,68,16,16,0,100
1c0ab9c93705bd7c302f1404794d0e798d1e9582,5,38,8,30,0,0,0,2,112,397,2,5,1.929501596,2831,35,1,658,653,5,23815,23599,216,147,145,2,98.34727607
5374b38f5551314205380ede28b730e33256ff23,0,0,0,0,0,0,0,0,0,0,0,0,0,0,79,0,0,0,0,0,0,0,0,0,0,100
7290ffbe9a2390464dc45fed633f15b051a9d64f,0,0,0,0,0,0,0,0,0,0,0,0,0,0,36,2,0,0,0,0,0,0,0,0,0,100
e49eb7ba2420e36c03db90cc8470fa6d5f26f550,0,0,0,0,0,0,0,0,0,0,0,0,0,0,324,0,0,0,0,0,0,0,0,0,0,100
0847d6c371a4482924ff642b525c633d7e0f5e6a,5,1355,10,1345,1,0,1,3,23,284,3,4,0.364963044,1260,0,0,542,223,319,19250,9012,10238,128,78,50,99.95812395
05b27be8b8bccddc2c2d0c4d11dca2c97bd7ee8d,0,0,0,0,0,0,0,0,0,0,0,0,0,0,8,0,0,0,0,0,0,0,0,0,0,100
e1b832cba15f81fe6544c642285f89fc8d9abcfd,2,56,18,38,0,0,0,4,7,298,1,2,0.877962001,837,37,0,153,144,9,7148,6833,315,43,43,0,100
f12b0cde76b9c17080f12a5be59e7ce8ee4dc881,6,51,27,24,0,0,0,5,33,621,1,4,2.049336029,2315,0,0,302,302,0,20266,20159,107,147,147,0,100
6dad2f6f35c97cb3fee82c5aee7aa932325e688a,1,12,2,10,0,0,0,3,4,60,1,1,0,224,37,0,42,40,2,1491,1445,46,20,20,0,100
ceb7f393e1fcd6032362ab78c86e7444fab4fc03,0,0,0,0,0,0,0,0,0,0,0,0,0,0,9,0,0,0,0,0,0,0,0,0,0,100
7360c2064dddda9e83bb67c7ccc8cc065b715692,0,0,0,0,0,0,0,0,0,0,0,0,0,0,1,0,0,0,0,0,0,0,0,0,0,100
a927f4740ed667c2e917e1baa8bb0849d6baea8a,0,0,0,0,0,0,0,0,0,0,0,0,0,0,3,0,0,0,0,0,0,0,0,0,0,100
6a9c072b8eab148bfc76dc957a68d256707424b2,0,0,0,0,0,0,0,0,0,0,0,0,0,0,10,0,0,0,0,0,0,0,0,0,0,100
13805035c2644c6e9122ccea9aef9fc43c1444eb,0,0,0,0,0,0,0,0,0,0,0,0,0,0,4,1,0,0,0,0,0,0,0,0,0,100
742eeba4021d1f9972e8bf572693474fd8d7b367,3,71,7,64,0,0,0,3,11,2400,1,3,1.268127344,969,1,0,119,119,0,8841,8077,764,46,46,0,100
cc47aca6cf9a7e05c9e81ab218a077f40af8d9fe,0,0,0,0,0,0,0,0,0,0,0,0,0,0,0,0,0,0,0,0,0,0,0,0,0,100
e95753f64aa26817c648726c307413d69730ff10,0,0,0,0,0,0,0,0,0,0,0,0,0,0,325,0,0,0,0,0,0,0,0,0,0,100
05716dc76a009e789177bc2b9419a7811c61a3f2,0,0,0,0,0,0,0,0,0,0,0,0,0,0,1,1,0,0,0,0,0,0,0,0,0,100
59480f3829b04d50a00fb62d763bb8438a2d433c,0,0,0,0,0,0,0,0,0,0,0,0,0,0,11,0,0,0,0,0,0,0,0,0,0,100
09a8282fa2578ddb71c300ec5853a00fceb1af0c,0,0,0,0,0,0,0,0,0,0,0,0,0,0,2,0,0,0,0,0,0,0,0,0,0,100
7ef1b45c978b55bdf792fa5ab3e747858a395047,4,40,12,28,0,0,0,17,60,2020,1,4,1.607996882,2563,38,0,626,621,5,20578,20349,229,174,172,2,100
719dcb2e7467282155d453bc12a5a29fdadbc138,1,4,0,4,0,0,0,12,64,1119,1,1,0,849,39,1,258,255,3,7160,7133,27,38,38,0,100
5bddf56a2b719adca5a43ce8ce307efaa6e023e8,1,4,0,4,0,0,0,17,61,103,1,1,0,1332,40,0,343,342,1,10913,10882,31,97,97,0,100
12438ff2a20c382307cc375478740e7108cd6a74,0,0,0,0,0,0,0,0,0,0,0,0,0,0,12,0,0,0,0,0,0,0,0,0,0,100
065a004e53776c8507d6aa87c927b899f69f6b47,0,0,0,0,0,0,0,0,0,0,0,0,0,0,5,0,0,0,0,0,0,0,0,0,0,100
bc49b631e9eb4f8e31feadb4b375b23a49aa9bdd,0,0,0,0,0,0,0,0,0,0,0,0,0,0,6,1,0,0,0,0,0,0,0,0,0,100
eaa6d1645e0f2215d9f210336d4be283f2bed05b,3,12,13,1,0,0,0,3,81,303,1,2,1.516147658,3085,0,0,851,851,0,26176,26128,48,142,142,0,100
bad730c76de50ae9b4682b1c0a357d70edccbcc9,2,41,0,41,0,0,0,6,9,2189,1,2,0.901170196,319,7,2,48,43,5,3086,2752,334,19,17,2,99.6442026
15fc887065da0b673049065178a8b23ad11cbf63,0,0,0,0,0,0,0,0,0,0,0,0,0,0,8,3,0,0,0,0,0,0,0,0,0,100
3415913d252597c24c6b5d19d315375a49e64152,2,59,8,51,0,0,0,2,113,1716,2,2,0.193642805,524,326,0,85,75,10,4124,3884,240,43,42,1,100
ff52f9c7c97f94e060e8362d68d992c0609b8811,0,0,0,0,0,0,0,0,0,0,0,0,0,0,9,3,0,0,0,0,0,0,0,0,0,100
307a3044faf52c3e6b9526994da1b1e0ab9cab2f,2,235,0,235,1,0,1,2,2,1817,2,2,0.14854949,193,27,0,69,33,36,2943,1593,1350,22,15,7,99.91631799
e5e63c150e6f656bd261aed69dc3c47fbd4cdda3,2,33,1,32,0,0,0,5,36,1563,1,2,0.322756959,702,0,0,98,96,2,7174,6904,270,38,37,1,100
bc41d132556dbb6dd7597ce92a130a01a503f2ee,0,0,0,0,0,0,0,0,0,0,0,0,0,0,0,0,0,0,0,0,0,0,0,0,0,100
e156bb56756aaa6ed23af41c4305b3f9d4bb5912,2,12,1,11,0,0,0,3,9,2665,1,2,0.961236605,261,0,0,32,32,0,2157,2045,112,15,15,0,100
2949b11627bc42dd32dc08737a970c31f0070c33,0,0,0,0,0,0,0,0,0,0,0,0,0,0,327,0,0,0,0,0,0,0,0,0,0,100
218dd81db9f3ea87f75833bee6acee1c70e2b1df,3,29,19,10,0,0,0,2,7,5181,1,2,0.97378373,349,328,1,92,89,3,2361,2264,97,24,23,1,100
7ba5f191c5701f6fa850d18895951df6d20ab812,11,711,35,676,1,0,1,2,114,1805,4,7,2.315048452,3342,0,0,644,531,113,34676,30848,3828,330,280,50,99.8328458
6a1f2ef5c1cdcbc001c6ea74f5cbcfdf9c98f448,0,0,0,0,0,0,0,0,0,0,0,0,0,0,13,0,0,0,0,0,0,0,0,0,0,100
28cf092a8afe15e55d3a3d73918437caab600bbb,0,0,0,0,0,0,0,0,0,0,0,0,0,0,14,1,0,0,0,0,0,0,0,0,0,100
c1daaa44c3833be31c006753a2cf2f6f2e476cdc,0,0,0,0,0,0,0,0,0,0,0,0,0,0,41,0,0,0,0,0,0,0,0,0,0,100
3c7d8c072055c246200a5617488ace5a1d64ae57,2,19,30,11,0,0,0,10,60,1208,1,2,0.999699543,1264,0,0,255,256,1,9760,9807,47,54,54,0,100
ba5cf4046472272ccf51077f8deff8977d7730f5,0,0,0,0,0,0,0,0,0,0,0,0,0,0,42,1,0,0,0,0,0,0,0,0,0,100
11ae43000008a148a355193514f8fd4e04baf712,0,0,0,0,0,0,0,0,0,0,0,0,0,0,43,2,0,0,0,0,0,0,0,0,0,100
7ee310bd34fc7cbe7899d42f4dc563ef676cd046,0,0,0,0,0,0,0,0,0,0,0,0,0,0,44,2,0,0,0,0,0,0,0,0,0,100
d034bad23188f4292ee9befb2414d621b5be8945,0,0,0,0,0,0,0,0,0,0,0,0,0,0,15,0,0,0,0,0,0,0,0,0,0,100
3a98f1fc98dfcfabf9a19b5d43c8d61e8e696390,2,163,6,157,0,0,0,10,80,1481,1,2,0.933272878,1143,1,0,217,210,7,11138,9774,1364,72,69,3,100
12fe912180ed9d98734a1ed1583c3e3f5f615b28,0,0,0,0,0,0,0,0,0,0,0,0,0,0,45,0,0,0,0,0,0,0,0,0,0,100
18aa87c0cffbe8e32483f8b88aae0cd9a11d2476,0,0,0,0,0,0,0,0,0,0,0,0,0,0,16,1,0,0,0,0,0,0,0,0,0,100
146835ef03158d87defa1ef082decf9e05becbb0,0,0,0,0,0,0,0,0,0,0,0,0,0,0,17,1,0,0,0,0,0,0,0,0,0,100
33a7b45f7e641810a4e03c56f8d6cad229a58392,0,0,0,0,0,0,0,0,0,0,0,0,0,0,46,1,0,0,0,0,0,0,0,0,0,100
e3a6d238e3e0358b1f397968b1db1355c4818768,1,1,1,0,0,0,0,22,82,299,1,1,0,2134,0,0,584,583,1,18151,18135,16,99,99,0,100
37c242755cdf5320c2eafce925d613061e584e6a,5,204,1,203,0,0,0,5,72,1157,2,3,1.760123152,2375,28,0,509,480,29,20609,19183,1426,219,205,14,100
43daa256dd04a2e9167de6749f34e262b8216de3,6,183,12,171,2,0,2,3,32,1630,2,6,1.493604405,1017,329,0,256,246,10,9228,8156,1072,131,122,9,99.89572471
25329ef10c7a373917636bc07fab9957edc25e9a,0,0,0,0,0,0,0,0,0,0,0,0,0,0,330,1,0,0,0,0,0,0,0,0,0,100
d2f8933843ebdb64f29d13212065e71a6d3df6cd,1,3,2,1,0,0,0,7,23,1911,1,1,0,293,41,0,94,93,1,2327,2323,4,18,18,0,100
956f1728bab8b8224554cb76a8810e2f3816662f,2,78,4,74,0,0,0,5,33,1203,1,2,0.736323027,1049,42,1,185,180,5,8680,8201,479,62,61,1,100
9e6fc31ce8450f784515e57c7df3d7fa57f216de,27,1619,15,1604,5,0,5,14,86,1307,5,15,3.959869363,10944,29,0,2663,2474,189,97921,89158,8763,929,833,96,91.91306051
392f8b4a38bcb18a684f21127594afa74e10ee47,4,8,5,3,0,0,0,5,36,894,1,2,1.884313528,2131,30,1,426,426,0,15452,15426,26,198,198,0,100
da257fd133efa7b930e9bede002bbcdaead56b1e,0,0,0,0,0,0,0,0,0,0,0,0,0,0,0,0,0,0,0,0,0,0,0,0,0,100
66ed196766ddfbca745acfe044118d4174d57206,3,37,3,34,0,0,0,1,54,15,1,2,1.519672414,1394,31,2,374,369,5,11750,11422,328,64,63,1,100
17c78bac3bfd9c8e7c12548b044b9d747704a973,1,2,0,2,0,0,0,4,5,376,1,1,0,101,10,0,10,10,0,874,862,12,5,5,0,100
d6b6e6f8b576b934fada8dc53a6f242e39f74d22,0,0,0,0,0,0,0,0,0,0,0,0,0,0,43,2,0,0,0,0,0,0,0,0,0,100
a5eb426263632034513ba7013913b57875ec7c5f,1,9,0,9,0,0,0,12,19,1306,1,1,0,513,44,3,130,124,6,4335,4254,81,31,30,1,100
cb0bde41d5b7a33e83d47e9f53aa24d53dd9a803,0,0,0,0,0,0,0,0,0,0,0,0,0,0,18,0,0,0,0,0,0,0,0,0,0,100
e98c398e622fa0d3bc57cb48ef77295d04b120b4,0,0,0,0,0,0,0,0,0,0,0,0,0,0,0,0,0,0,0,0,0,0,0,0,0,100
b3ebdd5021152703e2851893219b14c3c537b14d,0,0,0,0,0,0,0,0,0,0,0,0,0,0,2,0,0,0,0,0,0,0,0,0,0,100
f2293acf0d1ea720de17c345b518d64f324ba1f6,5,58,3,55,0,0,0,18,63,2786,2,4,2.138711527,2650,3,1,688,674,14,21125,20741,384,227,218,9,100
1c7e59478c8d2905f732c1d87da5e8fd940637b8,1,2,1,1,0,0,0,9,13,1653,1,1,0,135,9,0,28,28,0,946,944,2,10,10,0,100
5a55dbdf1c9d306ef4b1c0e6d8e846eb1a688bad,0,0,0,0,0,0,0,0,0,0,0,0,0,0,4,2,0,0,0,0,0,0,0,0,0,100
3022242bb00b27c298c953d63256f237e15f3256,0,0,0,0,0,0,0,0,0,0,0,0,0,0,19,1,0,0,0,0,0,0,0,0,0,100
e71708f5fbbf9fe518835a7c1e8cc4501810273c,0,0,0,0,0,0,0,0,0,0,0,0,0,0,47,0,0,0,0,0,0,0,0,0,0,100
a0a5c596f6a551c4612b3063ad96b000374f46ff,0,0,0,0,0,0,0,0,0,0,0,0,0,0,10,1,0,0,0,0,0,0,0,0,0,100
b9ff08fee7646f10083da2f8672b932a34aa4a7f,0,0,0,0,0,0,0,0,0,0,0,0,0,0,0,0,0,0,0,0,0,0,0,0,0,100
a43ed6c11d3ca3c8a63b86981c3241365eb60b79,0,0,0,0,0,0,0,0,0,0,0,0,0,0,0,0,0,0,0,0,0,0,0,0,0,100
4774ed61d5de579d3c9bad9162115e8c6cbb57a6,0,0,0,0,0,0,0,0,0,0,0,0,0,0,0,0,0,0,0,0,0,0,0,0,0,100
f497d7224f5dd1fcb73c8523a800e2b6ae26c274,1,1,1,0,0,0,0,19,62,1566,1,1,0,1256,0,0,295,295,0,10276,10285,9,53,53,0,100
f5555bdf7863d59d04f8437c07d5bfd20fe1cbf4,0,0,0,0,0,0,0,0,0,0,0,0,0,0,0,0,0,0,0,0,0,0,0,0,0,100
d40c1b09f533bce6fd27e97489885c10887fe4ec,0,0,0,0,0,0,0,0,0,0,0,0,0,0,331,0,0,0,0,0,0,0,0,0,0,100
953ce61db16457334e65c6f82bd49accaa649a00,0,0,0,0,0,0,0,0,0,0,0,0,0,0,20,1,0,0,0,0,0,0,0,0,0,100
2135188cc8a6f24e4a879b1783433c9945fe7ec2,0,0,0,0,0,0,0,0,0,0,0,0,0,0,1,1,0,0,0,0,0,0,0,0,0,100
d7a6242442085032a17bc60fd0b13bf62c3ebc1c,1,4,6,2,0,0,0,2,3,5560,1,1,0,49,2,0,4,4,0,422,422,0,4,4,0,100
567ffb4089f9f024049ad88a56faf3783ddd9258,0,0,0,0,0,0,0,0,0,0,0,0,0,0,332,1,0,0,0,0,0,0,0,0,0,100
4853487d9aa02a7121e4a01b39b6793819059aac,0,0,0,0,0,0,0,0,0,0,0,0,0,0,333,2,0,0,0,0,0,0,0,0,0,100
7f9e980f6aee26523450fc40f7bfeb01a42842ab,0,0,0,0,0,0,0,0,0,0,0,0,0,0,334,3,0,0,0,0,0,0,0,0,0,100
fcbc016451ae1a1dc996fbafe677a8a8806d764f,1,1,1,0,0,0,0,11,12,1099,1,1,0,462,335,4,76,76,0,3784,3784,0,24,24,0,100
d9a2c91aae5c6f0273da12b753a9c66b43c5e73e,0,0,0,0,0,0,0,0,0,0,0,0,0,0,2,2,0,0,0,0,0,0,0,0,0,100
1ba7e6d66a6a02952930e5643f85824b09d8285c,0,0,0,0,0,0,0,0,0,0,0,0,0,0,336,5,0,0,0,0,0,0,0,0,0,100
cf144656ebfdb6085581a6f16dfaafac1ba8a569,1,2,3,1,0,0,0,6,14,2265,1,1,0,497,273,0,63,63,0,4417,4430,13,37,37,0,100
e51e16aa3c93a5443cb223666aa188b6d70a22f4,2,43,1,42,0,0,0,5,64,941,1,2,0.266764988,2219,48,0,462,459,3,17972,17642,330,134,133,1,100
70ae8c4742157a2ef07ba8fd187139523429a9cf,0,0,0,0,0,0,0,0,0,0,0,0,0,0,337,5,0,0,0,0,0,0,0,0,0,100
51a3dee7eaf039a5fa1324212efcc25be1761df0,0,0,0,0,0,0,0,0,0,0,0,0,0,0,338,1,0,0,0,0,0,0,0,0,0,100
525b328071464312fa5a720d2f039b29f34aca4d,0,0,0,0,0,0,0,0,0,0,0,0,0,0,21,0,0,0,0,0,0,0,0,0,0,100
35c17989b6792c5a1b70b4167d45512e3b6f0d6d,0,0,0,0,0,0,0,0,0,0,0,0,0,0,5,0,0,0,0,0,0,0,0,0,0,100
a48c147672b8a9312d9e9f299b2dd8d008a2beb1,0,0,0,0,0,0,0,0,0,0,0,0,0,0,10,0,0,0,0,0,0,0,0,0,0,100
7a834be5e17aa1f914cdbc39b52193263d6f12d4,0,0,0,0,0,0,0,0,0,0,0,0,0,0,11,0,0,0,0,0,0,0,0,0,0,100
1943455c01fb405bc4795b5f5e29a0070ab2d3db,0,0,0,0,0,0,0,0,0,0,0,0,0,0,6,0,0,0,0,0,0,0,0,0,0,100
3cf04368f292482a1dbe539bcabe28ae71ad4ca9,0,0,0,0,0,0,0,0,0,0,0,0,0,0,12,1,0,0,0,0,0,0,0,0,0,100
bb656e41f90f278426068b571c92fe3bb772492f,0,0,0,0,0,0,0,0,0,0,0,0,0,0,13,2,0,0,0,0,0,0,0,0,0,100
8c1b1430a1fe21c2dc8cf30c619f93411cdac628,3,15,8,7,0,0,0,10,45,1778,1,3,1.264088612,1491,32,0,334,333,1,11987,11956,31,93,92,1,100
d1781a7c38e2da24cb023588dc91ef88b5cbb067,0,0,0,0,0,0,0,0,0,0,0,0,0,0,0,0,0,0,0,0,0,0,0,0,0,100
eff7880f4528b3eecf4940f62fbe515d933e836b,5,367,17,350,0,0,0,7,66,2450,1,2,1.559340599,2999,45,0,807,784,23,25192,22499,2693,262,250,12,100
2989e4c265c54eb5aa5cc3837e7742af578139eb,0,0,0,0,0,0,0,0,0,0,0,0,0,0,14,0,0,0,0,0,0,0,0,0,0,100
98900e3492c19d59c5cecbf8a440ae9f01578b31,0,0,0,0,0,0,0,0,0,0,0,0,0,0,1,0,0,0,0,0,0,0,0,0,0,100
c78f3cb1af4f5b15bbd092d45d0cb7b6cc763843,0,0,0,0,0,0,0,0,0,0,0,0,0,0,7,0,0,0,0,0,0,0,0,0,0,100
013c8623e919b9442b440df9a605be343632dc2b,1,6,5,1,0,0,0,10,22,1923,1,1,0,209,1,0,63,63,0,1742,1729,13,7,7,0,100
89bfa02062b3f7391f345b00ccd7dcf5f29ab014,0,0,0,0,0,0,0,0,0,0,0,0,0,0,0,0,0,0,0,0,0,0,0,0,0,100
b9ba02ef436c9b5b7fa1fddf61f159355aa4e1bf,0,0,0,0,0,0,0,0,0,0,0,0,0,0,339,0,0,0,0,0,0,0,0,0,0,100
92861ba9f3a12c7df364a8ae4c5ef378e9171424,0,0,0,0,0,0,0,0,0,0,0,0,0,0,340,1,0,0,0,0,0,0,0,0,0,100
7ab30522583167bb663b3ee7032a7b71a28025b5,0,0,0,0,0,0,0,0,0,0,0,0,0,0,341,2,0,0,0,0,0,0,0,0,0,100
c2ef4e2c250ec548ea5d8f4fbbb4f17edbe3cb5b,0,0,0,0,0,0,0,0,0,0,0,0,0,0,22,0,0,0,0,0,0,0,0,0,0,100
19dc92d604114095acab6e508ab967a93d0b533f,0,0,0,0,0,0,0,0,0,0,0,0,0,0,342,2,0,0,0,0,0,0,0,0,0,100
205b975cceee0e642fbeb4d5e9d6ffe5620c001c,9,829,31,798,3,0,3,15,115,592,3,6,2.447236964,2018,46,0,452,357,95,20611,15717,4894,148,106,42,91.91762192
721e62524a69e1afb8484f00cbaed2d7f631a66e,0,0,0,0,0,0,0,0,0,0,0,0,0,0,23,1,0,0,0,0,0,0,0,0,0,100
d9d4e17ae5e0a85b571985af8733796782b41d0e,1,2,0,2,0,0,0,4,5,30,1,1,0,212,0,0,39,39,0,1749,1736,13,15,15,0,100
b9ea823103bf4918e18fac64efd817818e1a6db8,2,52,41,11,0,0,0,3,5,2528,1,2,0.997913934,135,0,0,29,33,4,1454,1191,263,6,6,0,100
b19fba2ad96e3007af79d646ba17b6bd783d9156,0,0,0,0,0,0,0,0,0,0,0,0,0,0,24,0,0,0,0,0,0,0,0,0,0,100
ad24235f492066378842cb0c1fbf9bde43da0391,0,0,0,0,0,0,0,0,0,0,0,0,0,0,2,0,0,0,0,0,0,0,0,0,0,100
b7849aeb78856f2f8e205c5e784cee84409cbc72,0,0,0,0,0,0,0,0,0,0,0,0,0,0,3,1,0,0,0,0,0,0,0,0,0,100
75eb33f0fb3ac7baf6547bdd35bd65acdea0d8f9,2,38,1,37,0,0,0,8,14,1521,1,2,0.477071306,294,49,0,43,41,2,2714,2456,258,24,22,2,100
9f013a94999a191aca2e763e8eac9d48df1e0a0f,0,0,0,0,0,0,0,0,0,0,0,0,0,0,8,0,0,0,0,0,0,0,0,0,0,100
990bbfc25c2b9e5a288827ea7f9a5e648b1122de,0,0,0,0,0,0,0,0,0,0,0,0,0,0,2,0,0,0,0,0,0,0,0,0,0,100
8d8169e83ac4acfb7b152594eac96ddbc9bb8437,18,777,31,746,4,0,4,1,116,1508,5,10,3.274634,3413,3,1,705,618,87,34737,30170,4567,331,289,42,98.78450762
1443f25a46784dfa63892daa74744b19b5c2a71e,1,47,23,24,0,0,0,10,23,386,1,1,0,210,4,2,68,63,5,1888,1742,146,8,7,1,100
878853f1e5a9be785cd66f0a0c560ccba1759d70,0,0,0,0,0,0,0,0,0,0,0,0,0,0,15,0,0,0,0,0,0,0,0,0,0,100
4155466c16eac8dee92c2c652068d1ac86f85e6a,0,0,0,0,0,0,0,0,0,0,0,0,0,0,16,1,0,0,0,0,0,0,0,0,0,100
2452b42a47b84442f5c7eda54bedba725f61a7be,0,0,0,0,0,0,0,0,0,0,0,0,0,0,17,2,0,0,0,0,0,0,0,0,0,100
949cebe70a1ef105b29e08456b87a25549ad2e2a,1,2,2,0,0,0,0,17,20,45,1,1,0,915,0,0,175,175,0,10778,10778,0,151,151,0,100
c3d654b695823768b1b253a855898ebe6e6268bc,1,2,2,0,0,0,0,16,19,1111,1,1,0,915,25,0,175,175,0,10778,10778,0,151,151,0,100
530d60f0c5e9cc902e1b94d6d7f9e80995f664c0,1,2,2,0,0,0,0,17,20,45,1,1,0,915,343,0,175,175,0,10778,10778,0,151,151,0,100
adf3006b9411a80fb19d5264c67721480f43e33c,0,0,0,0,0,0,0,0,0,0,0,0,0,0,0,0,0,0,0,0,0,0,0,0,0,100
f6697507e9607b2e4bd9840b1349b474c2525f43,0,0,0,0,0,0,0,0,0,0,0,0,0,0,344,1,0,0,0,0,0,0,0,0,0,100
d67cd509e5c8f9779026bcf992549a1901c92229,0,0,0,0,0,0,0,0,0,0,0,0,0,0,345,2,0,0,0,0,0,0,0,0,0,100
dc5db3b6c1cf1929543d7c64c5b0d7d986f1cdd9,0,0,0,0,0,0,0,0,0,0,0,0,0,0,346,3,0,0,0,0,0,0,0,0,0,100
3786524112d02951ac6a059085d303de2649e835,0,0,0,0,0,0,0,0,0,0,0,0,0,0,347,4,0,0,0,0,0,0,0,0,0,100
33a2a55899109e2ebe82766d4ba1f3fd82962610,1,1,2,1,0,0,0,13,24,1716,1,1,0,286,0,0,52,52,0,2101,2115,14,15,15,0,100
4c0b47a476c563c4243e491e31d1da2fc04133c4,0,0,0,0,0,0,0,0,0,0,0,0,0,0,26,0,0,0,0,0,0,0,0,0,0,100
a2e05cdb9319f22876e761200c006a1e7ab09437,0,0,0,0,0,0,0,0,0,0,0,0,0,0,27,0,0,0,0,0,0,0,0,0,0,100
6b36c59a93b9963b7a9797f3f7fec25284f7af96,0,0,0,0,0,0,0,0,0,0,0,0,0,0,9,0,0,0,0,0,0,0,0,0,0,100
