CommitID,FileNum,TotalAddLines,TotalDeleteLines,LC,FileAdd,FileDelete,NAD,NDEV,NUC,AGE,NS,ND,Entropy,LT,EXP,REXP,CommitComplexity,LastCommitComplexity,CFC,CommitTokenCount,LastCommitTokenCount,NCC,CommitMethodNum,LastCommitMethodNum,NMC,a2a
a08e065c2214b5b0c60455a9839564729f746d09,5,591,603,12,0,0,0,1,2,0,1,3,1.774111047,4379,3,3,752,757,5,25665,25832,167,141,145,4,99.9229584
b999589da85ea8761e5e7a739c41dd281ebbafd3,13,937,30,907,4,0,4,1,2,0,1,4,2.317218112,1084,4,4,227,164,63,12661,7812,4849,125,83,42,96.62828947
44b628f41df75b9c53a09eaa53d9f5b627deaba4,1,3,1,2,0,0,0,1,2,0,1,1,0,75,5,5,11,11,0,585,570,15,10,10,0,100
2d4891dec7a640167d5be3f8a32d3a8a1940e753,2,10,3,7,0,0,0,1,3,0,1,1,0.391243564,398,6,6,60,60,0,2825,2793,32,32,32,0,100
99c8d59d1dbfc4bca4eaf7af6cac86bb9ac9e5d3,0,0,0,0,0,0,0,0,0,0,0,0,0,0,7,7,0,0,0,0,0,0,0,0,0,100
7938d2f16ba212f26ad59ff8e5cc7181be43f2e9,1,10,13,3,0,0,0,1,2,0,1,1,0,84,8,8,12,12,0,568,557,11,7,7,0,100
0d57e65d61baa7964e72da79a3b2868e8fd17c56,0,0,0,0,0,0,0,0,0,0,0,0,0,0,9,9,0,0,0,0,0,0,0,0,0,100
d179043c2cbc48c131907a3633513b5708c65283,0,0,0,0,0,0,0,0,0,0,0,0,0,0,10,10,0,0,0,0,0,0,0,0,0,100
94555dbc793dffd4c67d4533406aa24644dfbcd6,1,2,1,1,0,0,0,1,2,0,1,1,0,33,11,11,3,3,0,256,254,2,3,3,0,100
005888cce1029d53fa9f8359dfaa341d889f3057,5,87,9,78,0,0,0,1,3,0,1,3,0.908154912,4874,12,12,917,898,19,29283,28867,416,197,192,5,100
3ffe9b43290efd485e865d647e61ae7aace2f55e,0,0,0,0,0,0,0,0,0,0,0,0,0,0,13,13,0,0,0,0,0,0,0,0,0,100
3752f54a5d52f545eb05462187815edaa96e8933,2,40,2,38,0,0,0,1,2,0,1,2,0.453716339,419,14,14,76,74,2,3389,3286,103,40,40,0,100
5b19f1d6184fc5e86f6739846744e632d1308be3,11,92,28,64,0,0,0,1,3,0,1,4,2.904395259,1457,15,15,193,185,8,10967,10665,302,123,121,2,100
13fb7b577228ddbdf34350ff35ee20c3de07fa9c,11,125,62,63,0,0,0,1,4,0,1,9,3.099346884,1906,16,16,162,159,3,15182,14910,272,106,103,3,99.60035524
6d435838c9285021dcd2d57fa0b906d5014d5232,6,879,3,876,3,0,3,1,4,0,1,4,1.660395659,649,17,17,142,107,35,8629,4735,3894,66,39,27,96.41089109
10f91e143b91c53245b6c5022a0f61047ee519ab,1,7,2,5,0,0,0,1,2,0,1,1,0,174,18,18,12,12,0,1234,1234,0,6,6,0,100
442165f2cd2537829065f1a8bf31cc66cde6d57c,5,101,18,83,1,0,1,1,3,0,1,4,1.645263984,674,19,19,101,94,7,4908,4696,212,42,36,6,99.9235474
48ac27e5c1e40a07e477b5da0bac14371b4f6d67,0,0,0,0,0,0,0,0,0,0,0,0,0,0,20,20,0,0,0,0,0,0,0,0,0,100
b4f5b6a76784509d9a6bb0141ace65a968f21d62,0,0,0,0,0,0,0,0,0,0,0,0,0,0,21,21,0,0,0,0,0,0,0,0,0,100
9e07615ed4488b81e16a67d978c0b471cfac24f0,1,1,0,1,0,0,0,1,3,0,1,1,0,109,22,22,13,13,0,1028,1018,10,3,3,0,100
980e8e5fae6fca326a6fa5bf8c080b9ffade2c3a,65,474,129,345,0,0,0,1,4,0,1,26,5.243561294,8173,23,23,1377,1346,31,56840,54633,2207,656,637,19,99.4650363
28d230a9d0d4c9e20a4da9bf2deb328103b3b31f,6,161,89,72,0,0,0,1,5,0,1,6,1.725353796,1729,24,24,286,274,12,13090,12527,563,131,127,4,100
c22648960994211555570d9e62f6e38debcba090,11,40,31,9,0,0,0,1,3,0,1,7,2.49131605,1281,25,25,207,206,1,9033,9011,22,109,108,1,96.85658153
44cf843e8cd9999d6f17c8d19a1dc9a1b5d1d91c,1,1,1,0,0,0,0,1,2,0,1,1,0,27,26,26,7,7,0,167,165,2,5,5,0,100
77fbbb2122ecb83eb2d4a8fbeaea0a77ce2b3817,25,127,59,68,1,0,1,1,4,0,1,15,4.309221341,3161,27,27,289,285,4,25605,25304,301,181,179,2,97.10202461
2d61286c64f240878ace2ba8735385cfd414a7a9,1,3,0,3,0,0,0,1,3,0,1,1,0,187,28,28,7,7,0,1532,1515,17,7,7,0,100
59cc81c1d6e6fe79d6b046d2e049746eaeedf24d,2,71,6,65,0,0,0,1,3,0,1,2,0.922564137,636,29,29,83,79,4,5332,4962,370,36,35,1,99.84459984
47be1f8c83ebd26a090f55e1fd763dca93b3d824,7,15,9,6,0,0,0,1,5,0,1,3,2.615748962,1351,30,30,228,227,1,9750,9702,48,110,110,0,100
b8110ecb6d0f6f7c52809b436e8ae035d3791af0,1,4,1,3,0,0,0,1,3,0,1,1,0,220,31,31,45,44,1,1548,1535,13,27,27,0,100
d6c2a77b72c4611c9ca14e006d150636b916f879,5,86,9,77,0,0,0,1,4,0,1,3,1.967814036,806,32,32,68,61,7,7788,7307,481,38,37,1,99.92272025
21a191f871bc62da80dbed1c929422d88fd7786a,1,2,1,1,0,0,0,1,2,0,1,1,0,27,33,33,5,5,0,172,167,5,4,4,0,100
b4f1303607f8321be0c04c97b3afc0c99eeedbfd,1,17,8,9,0,0,0,1,3,0,1,1,0,394,34,34,76,73,3,2774,2732,42,31,31,0,100
00e70ddd07110090760e5cee40feac1aadeae395,0,0,0,0,0,0,0,0,0,0,0,0,0,0,35,35,0,0,0,0,0,0,0,0,0,100
055a8e84112e6bb44f048f7ed6fbdad390a0044b,3,82,4,78,0,0,0,1,4,0,1,2,1.04571898,1039,36,36,141,139,2,7983,7595,388,57,56,1,100
611d6f2b34b36721281084a114cf827dde1fb3a6,1,1,1,0,0,0,0,1,6,0,1,1,0,178,37,37,11,11,0,1297,1297,0,6,6,0,100
14923f8ebec54571d9f5d4843c838b26d2c94246,1,9,1,8,0,0,0,1,5,0,1,1,0,361,38,38,17,17,0,3022,2996,26,13,13,0,100
5ba4a44667f0914d9d9f735ce029b7f908b56ce0,0,0,0,0,0,0,0,0,0,0,0,0,0,0,39,39,0,0,0,0,0,0,0,0,0,100
4b96898ccd93668abd71e56c205ca3b226b9f82e,0,0,0,0,0,0,0,0,0,0,0,0,0,0,40,40,0,0,0,0,0,0,0,0,0,100
5a4142d7ad8dc454c2d212a929e23cd6a6bb483b,0,0,0,0,0,0,0,0,0,0,0,0,0,0,41,41,0,0,0,0,0,0,0,0,0,100
f58cb5eb43769298fe14b942da2af022ed761da4,0,0,0,0,0,0,0,0,0,0,0,0,0,0,42,42,0,0,0,0,0,0,0,0,0,100
02eb40e67ebf46aa503f0c354aada29a64efae79,1,21,6,15,0,0,0,1,3,0,1,1,0,191,43,43,31,27,4,1489,1424,65,17,16,1,98.53902345
c5e35262e70570931e24539443854043cdcc530d,0,0,0,0,0,0,0,0,0,0,0,0,0,0,44,44,0,0,0,0,0,0,0,0,0,100
6d01a16185eabde5c18765226c38b498f9f9495d,9,313,101,212,1,0,1,1,7,0,1,5,1.841639349,1445,45,45,224,213,11,11731,10623,1108,107,96,11,99.8467433
260460a62ea852d434292342a735b6382aa2cc90,0,0,0,0,0,0,0,0,0,0,0,0,0,0,46,46,0,0,0,0,0,0,0,0,0,100
d8937b0357a337115cc946e7fb3c4f4f8fd101a3,2,34,1,33,0,0,0,1,3,0,1,2,0.951762676,573,47,47,114,110,4,4104,3914,190,84,83,1,100
23eff6d2055a56f88b54022e5ee0f8068816fa37,3,51,17,34,0,0,0,1,5,0,1,2,0.791489087,762,48,48,99,96,3,7039,6768,271,48,47,1,100
caf7aa847d3c90b0b4dbd2d9feb9f9d265b5d158,0,0,0,0,0,0,0,0,0,0,0,0,0,0,49,49,0,0,0,0,0,0,0,0,0,100
eb55a98e7fe9fb644e3a18f16a8a5796af128713,9,899,20,879,7,0,7,1,5,0,1,5,2.695700604,373,50,50,118,62,56,6350,2662,3688,52,19,33,99.31584949
4d32423dadc1d1ee56a3395d1cdc0e4a83981cbe,30,773,172,601,2,0,2,1,5,0,1,14,3.344839373,4060,51,51,665,623,42,31051,28135,2916,334,314,20,96.19269619
569d193d3a08d15982e943df71e3ede63b521546,11,259,187,72,0,0,0,1,5,0,1,8,2.861781779,2412,52,52,243,235,8,18884,18387,497,108,106,2,100
bf8c8e22c3e2859ed89618d8b6bf5cbd752f0bd0,1,14,1,13,0,0,0,1,6,0,1,1,0,248,53,53,47,44,3,1875,1789,86,27,26,1,100
6adb91c2cf17df4267b9927bac0512730fbad5fd,5,61,7,54,0,0,0,1,7,0,1,2,1.692564583,1071,54,54,187,183,4,8048,7699,349,94,90,4,100
79162ec49881c53a279e7319dcd22c3ce8c12036,2,87,4,83,0,0,0,1,6,0,1,2,0.914589196,375,55,55,45,39,6,3000,2647,353,19,17,2,100
12ec07dae7cd4e821d3b79f819275f98373be493,2,59,15,44,0,0,0,1,3,0,1,2,0.84185219,104,56,56,16,13,3,871,679,192,11,10,1,100
f8766db497864fef2bf7df568b5cc5c5f4d05c6d,4,82,43,39,0,0,0,1,8,0,1,3,1.687147475,864,57,57,115,116,1,6848,6640,208,55,56,1,99.31146213
9df6a300da1732ee12f40a2e05e10fb528df10e4,4,71,11,60,0,0,0,1,3,0,1,4,1.531206127,346,58,58,56,53,3,2267,2096,171,38,35,3,100
cfdecd971f65cba5a8fd06042ec005a0d7ef40ab,0,0,0,0,0,0,0,0,0,0,0,0,0,0,59,59,0,0,0,0,0,0,0,0,0,100
366bed4595845c01075c0b164da731240f0d4105,0,0,0,0,0,0,0,0,0,0,0,0,0,0,60,60,0,0,0,0,0,0,0,0,0,100
6727dcded03a43985aa1f013efef6c75bcf703a2,4,29,9,20,0,0,0,1,6,0,1,4,1.496052513,1542,61,61,286,284,2,10922,10725,197,89,88,1,96.96969697
8794bb7b49f8c25750a7e07f71c9c7eb2fc7afcb,1,39,0,39,0,0,0,1,5,0,1,1,0,486,62,62,107,104,3,3548,3318,230,75,74,1,100
3da3bdd87236a42b0d863df1ff3b09ead01834d6,8,83,7,76,0,0,0,1,9,0,1,3,2.866310545,1256,63,63,172,165,7,10199,9867,332,77,70,7,100
abafa107bc806686a1182e23d9b3451b3c030f82,1,3,3,0,0,0,0,1,5,0,1,1,0,433,64,64,75,75,0,3391,3391,0,24,24,0,100
7d346a15008ff90d839008d741b4cdb62a8e28f7,21,146,76,70,0,0,0,1,6,0,1,12,3.74619943,3119,65,65,517,512,5,21630,21413,217,241,240,1,100
098a971455091627fc2ca2c1eb60496557613ebb,1,37,46,9,0,0,0,1,2,0,1,1,0,198,66,66,24,27,3,1374,1363,11,12,12,0,100
ddd3f1dae606703e9c4c1ee5bdb979c149435859,3,253,0,253,3,0,3,1,1,0,1,1,1.583504059,0,67,67,15,0,15,987,0,987,14,0,14,99.76744186
29bdae1a4652381593368319dcdb156c0bd801c1,0,0,0,0,0,0,0,0,0,0,0,0,0,0,68,68,0,0,0,0,0,0,0,0,0,100
559af521174b04451e42cdb4a3e7b694a22c6c0e,3,35,6,29,0,0,0,1,2,0,1,3,1.405156825,212,69,69,38,35,3,1564,1434,130,16,15,1,100
982c545c435bfa2b8cb637441bdcc5a0351093e7,0,0,0,0,0,0,0,0,0,0,0,0,0,0,70,70,0,0,0,0,0,0,0,0,0,100
0bb701daa4e84820f4c225ed03c934e7ba8f4d1e,1,17,0,17,0,0,0,1,2,0,1,1,0,215,71,71,20,20,0,1717,1717,0,10,10,0,100
9ca8a070fc8af1623aedae4e5e699b0b375ebc25,3,168,9,159,1,0,1,1,7,0,1,2,0.888058789,395,72,72,78,70,8,3221,2597,624,28,25,3,99.92272025
b3f2a3df257a65d6dc35022bd3a6713d86277351,9,38,23,15,0,0,0,1,8,0,1,7,2.935410073,1244,73,73,159,159,0,8721,8663,58,86,85,1,100
4e156a6684f47cfe12d54955f240b47548591616,1,4,6,2,0,0,0,1,6,0,1,1,0,515,74,74,107,107,0,3548,3548,0,75,75,0,100
80fd7c083d8e31f4807cc7990b8c19507cf39c52,0,0,0,0,0,0,0,0,0,0,0,0,0,0,75,75,0,0,0,0,0,0,0,0,0,100
3290afe533284fca0bc7be24547cc309ef3f6fd2,0,0,0,0,0,0,0,0,0,0,0,0,0,0,76,76,0,0,0,0,0,0,0,0,0,100
fa9686a62a0a4574ef8ec325eedf647e746b5c92,0,0,0,0,0,0,0,0,0,0,0,0,0,0,77,77,0,0,0,0,0,0,0,0,0,100
05917f825af692d2398aaf21cc7a28866cd971a3,1,20,15,5,0,0,0,1,5,0,1,1,0,717,78,78,132,132,0,5168,5153,15,28,28,0,100
c171e8f606372d6e4e91d5e6bceaf78b7d6cf260,1,14,3,11,0,0,0,1,2,0,1,1,0,255,79,79,47,46,1,1713,1683,30,13,13,0,100
039f779ab9c3db8a71f89af305afd595893520a9,0,0,0,0,0,0,0,0,0,0,0,0,0,0,80,80,0,0,0,0,0,0,0,0,0,100
bb3ead8ec3e5e162b5439087d938dc835d576e23,6,103,50,53,0,0,0,1,7,0,1,4,1.993167324,1441,81,81,199,196,3,10832,10566,266,120,119,1,100
316f8e3e0e48209a1b1a0fbdbabe55f4b991442e,3,101,7,94,0,0,0,1,8,0,1,3,1.22357052,719,82,82,131,125,6,5673,5170,503,88,86,2,100
c61f4bf44dcce8a49124c175150b27064da9ffc7,2,46,25,21,0,0,0,1,2,0,1,2,0.622040309,270,83,83,22,21,1,2089,2021,68,17,16,1,100
34fe7f039ac56827fa0f0dc8507f1c4e1e8c6bcf,0,0,0,0,0,0,0,0,0,0,0,0,0,0,84,84,0,0,0,0,0,0,0,0,0,100
76145e95bceb52a675efbff160fe32bc3c667020,0,0,0,0,0,0,0,0,0,0,0,0,0,0,85,85,0,0,0,0,0,0,0,0,0,100
48aa4616de672837f86a8dc63fdf3f0389c9a8f2,0,0,0,0,0,0,0,0,0,0,0,0,0,0,86,86,0,0,0,0,0,0,0,0,0,100
56c4053a2d5a072f3664194242b0e0b6b0169aa0,0,0,0,0,0,0,0,0,0,0,0,0,0,0,87,87,0,0,0,0,0,0,0,0,0,100
1d6b9fbe3e188b236b89427741d69859d2ce47b9,11,446,110,336,1,0,1,1,9,0,1,8,2.509832803,1241,88,88,197,185,12,9484,7940,1544,102,92,10,98.10177706
5c86dfe650107a7c8ee738f1d169a082e23736bf,7,340,72,268,1,0,1,1,5,0,1,3,2.216173979,1192,89,89,193,171,22,9855,8497,1358,82,77,5,99.91539763
e2091e1f81379b923b38b126122cd02b9e0aab08,9,216,58,158,0,0,0,1,6,0,1,6,2.364545145,2054,90,90,289,280,9,16471,15692,779,114,112,2,100
e738de200b2b01eb676a9dfb205406c9dbae8522,1,2,2,0,0,0,0,1,3,0,1,1,0,168,91,91,11,11,0,1273,1273,0,6,6,0,100
7ab227036953ef7e6e652ebb852ba7fb875c6215,4,42,64,22,0,0,0,1,7,0,1,4,0.763925354,864,92,92,150,156,6,5796,5922,126,60,62,2,96.90763052
502c8c82759ad4b181c3c967dcc86ffaf00e263d,2,15,1,14,0,0,0,1,2,0,1,2,0.543564443,320,93,93,71,70,1,2210,2125,85,14,13,1,100
68cb5d7c1b0b63a0ec61dc7822a977aa687b0beb,2,36,0,36,0,0,0,1,3,0,1,2,0.650022422,282,94,94,24,22,2,2277,2089,188,18,17,1,100
6e1a2a5c5c9a4698714551116cf357f3304d7174,2,84,38,46,0,0,0,1,4,0,1,2,0.715322053,231,95,95,38,35,3,1768,1541,227,25,24,1,100
e544e21ee3c46b3e56051301cd54d9d38dc177e3,5,103,4,99,1,0,1,1,7,0,1,5,0.969491283,1124,96,96,209,204,5,8041,7600,441,83,80,3,99.8853211
a6a6dbf8029436300dee63de02cce2928b828fbe,9,164,19,145,1,0,1,1,10,0,1,6,1.873271069,1633,97,97,296,283,13,11257,10751,506,172,167,5,99.92366412
b0d8195008213d3efd608b40daefab1994e8937d,73,2291,776,1515,12,0,12,1,11,0,1,21,4.627590682,27376,98,98,5686,5363,323,184965,173661,11304,2820,2687,133,95.6943367
e461b21d271c79882b86aec9b7c720e8f02c19cd,2,93,0,93,0,0,0,1,4,0,1,2,0.730447286,501,99,99,74,69,5,3786,3337,449,24,23,1,100
be5938801f60bac900ffe75554fa9f586f3d7095,3,35,3,32,0,0,0,1,9,0,1,2,1.267443804,1077,100,100,118,115,3,8461,8273,188,71,70,1,100
f2136b31ab955d27d40db8fe8cd1ec2679fccfc9,4,109,57,52,0,0,0,1,7,0,1,4,1.900940269,786,101,101,80,80,0,5525,5509,16,43,43,0,100
77d38ba1df6a783228f74f235b5b24d4afb9abe1,26,1278,218,1060,12,0,12,1,7,0,1,8,4.048827196,9162,102,102,1834,1486,348,63701,53665,10036,785,648,137,98.11616954
3593ec7af323736da13a2a71ed4b9a1e61776341,0,0,0,0,0,0,0,0,0,0,0,0,0,0,103,103,0,0,0,0,0,0,0,0,0,100
69efba42035f7d5a06ca207dc2413c97596b25d5,1,109,0,109,1,0,1,1,1,0,1,1,0,0,104,104,7,0,7,406,0,406,4,0,4,99.80506823
3a729006faaecaad77c797107d575efb00de61c6,14,920,4,916,0,0,0,1,8,0,1,6,1.789082091,4846,105,105,1129,976,153,36676,32075,4601,605,530,75,100
25a855c7c6003e2b1d0884122f313600d9090e5d,4,87,18,69,1,0,1,1,9,0,1,4,1.771481245,1450,106,106,272,266,6,10492,10255,237,77,76,1,99.84441851
c53fb9f07fa29585ba8ecd9304c6b55c1ab57d0a,4,18,87,69,0,0,0,1,10,0,1,4,1.771481245,1489,107,107,266,272,6,10255,10492,237,76,77,1,99.84441851
8e299a67ecf053ca5b14acc60265005b11910e23,4,87,18,69,1,0,1,1,11,0,1,4,1.771481245,1450,108,108,272,266,6,10495,10255,240,77,76,1,99.84441851
76566f504ba87031b984031e1124ad35be71ac53,1,2,2,0,0,0,0,1,12,0,1,1,0,273,109,109,48,48,0,1838,1846,8,14,14,0,100
c87d029037ae1ef201cc694356c78ad9b61ec79d,0,0,0,0,0,0,0,0,0,0,0,0,0,0,110,110,0,0,0,0,0,0,0,0,0,100
75b5cd8d18b86d16546e7e87d7504eceb11abe52,0,0,0,0,0,0,0,0,0,0,0,0,0,0,111,111,0,0,0,0,0,0,0,0,0,100
44b8a966cefe9dc63cd9dcc02ec8ab55ed4a0c04,3,263,71,192,0,0,0,1,11,0,1,3,1.146329628,800,112,112,148,135,13,6969,5778,1191,95,90,5,100
2627af0a7637fc1c4e0caee162c10663ee6e36c9,2,5,0,5,0,0,0,1,12,0,1,2,0.721928095,974,113,113,174,174,0,6960,6916,44,44,44,0,100
20ce903a135f4f56d21fa6f8d9162f3cd8d4621e,0,0,0,0,0,0,0,0,0,0,0,0,0,0,114,114,0,0,0,0,0,0,0,0,0,100
7882be62f5cae17be96973c3818e610c0847a1bb,0,0,0,0,0,0,0,0,0,0,0,0,0,0,115,115,0,0,0,0,0,0,0,0,0,100
d1003888dfabaa0a8a010b92e1befe234e286753,5,28,8,20,0,0,0,1,10,0,1,3,2.260784558,847,116,116,148,147,1,5998,5954,44,84,84,0,100
101ebb1d685bfaa70fe8235a1bcd21011e6e82cb,0,0,0,0,0,0,0,0,0,0,0,0,0,0,117,117,0,0,0,0,0,0,0,0,0,100
3fe937f746558813039dde8260422e09c4b4375b,0,0,0,0,0,0,0,0,0,0,0,0,0,0,118,118,0,0,0,0,0,0,0,0,0,100
587210ee9e9d0a51f8067ec81deefddfe2fbfd97,17,457,424,33,0,0,0,1,5,0,1,9,3.60743781,1643,119,119,262,262,0,13394,14016,622,136,136,0,100
196bb6d4753d5fca02648e5ea941529a7fe63826,0,0,0,0,0,0,0,0,0,0,0,0,0,0,120,120,0,0,0,0,0,0,0,0,0,100
eb3b63d83fefeff6cfb6594669314aab32607f2b,0,0,0,0,0,0,0,0,0,0,0,0,0,0,121,121,0,0,0,0,0,0,0,0,0,100
2338903df4d64889e1074f5c1f65a747b3316d0a,37,1964,87,1877,7,0,7,1,13,0,1,13,3.674633812,8932,122,122,1960,1726,234,68538,60890,7648,993,864,129,93.51701783
66a19122859733686a4e020be90b568334a43378,0,0,0,0,0,0,0,0,0,0,0,0,0,0,123,123,0,0,0,0,0,0,0,0,0,100
a021d4bda9b8ffc97e6744b0ec23696fec321ed1,27,1179,49,1130,10,0,10,1,13,0,1,14,3.402154167,2672,124,124,504,395,109,26302,20822,5480,282,233,49,88.48
b56a79101539899411a8a068dce3659b7f538cb4,0,0,0,0,0,0,0,0,0,0,0,0,0,0,125,125,0,0,0,0,0,0,0,0,0,100
1bd5768c7f6c56db64cbdce5c60c373f5d0cf22b,0,0,0,0,0,0,0,0,0,0,0,0,0,0,126,126,0,0,0,0,0,0,0,0,0,100
d4013bd366a519676f1b3bf92eb86bdd30088e95,2,56,1,55,0,0,0,1,14,0,1,2,0.831474388,1004,127,127,204,199,5,7161,6921,240,115,112,3,100
6e43440b4601df1fcf9c3a47c85cc29a1d4c4606,1,84,13,71,0,0,0,1,14,0,1,1,0,451,128,128,85,83,2,3340,3146,194,32,32,0,100
d6c7ca915e23013fdfc5f1f64ca161790f9339b9,2,62,1,61,1,0,1,1,2,0,1,2,0.20307393,81,129,129,18,16,2,777,563,214,12,11,1,92.80715397
309fe36d75f794b2ddfb5620396d090c39c048d5,3,81,12,69,0,0,0,1,8,0,1,2,1.025830412,280,130,130,15,13,2,2540,2178,362,13,11,2,100
96d62118346300fcf5f6020cc7633b8075a5eab5,6,185,9,176,0,0,0,1,5,0,1,3,1.365173026,790,131,131,93,84,9,6785,5861,924,55,52,3,92.89044289
04ad7edc431fb03db90927f3b5bc4b71b96c51a5,1,3,0,3,0,0,0,1,15,0,1,1,0,507,132,132,85,85,0,3347,3340,7,32,32,0,100
f29d418fb599e6c7cd0ab383b6e560970f9f472b,0,0,0,0,0,0,0,0,0,0,0,0,0,0,133,133,0,0,0,0,0,0,0,0,0,100
5e5b4bfbc60eb6f7278acfd9e4ec3200f7750784,1,1,0,1,0,0,0,1,14,0,1,1,0,768,134,134,141,140,1,5529,5526,3,27,27,0,100
4c651d792417121318b1ba0afd410d2b614c01d0,0,0,0,0,0,0,0,0,0,0,0,0,0,0,135,135,0,0,0,0,0,0,0,0,0,100
981454fc81b2f2c582a2ecfa622d563e4fd2cccd,0,0,0,0,0,0,0,0,0,0,0,0,0,0,136,136,0,0,0,0,0,0,0,0,0,100
c514e99d0580ed6755faabe99762e3ef8382e079,0,0,0,0,0,0,0,0,0,0,0,0,0,0,137,137,0,0,0,0,0,0,0,0,0,100
c3ffaa7d5968ec7809ec68558f266ef06d3e4a40,0,0,0,0,0,0,0,0,0,0,0,0,0,0,138,138,0,0,0,0,0,0,0,0,0,100
01157db4052bf148608dad6bc2936366f302e150,2,179,153,26,0,0,0,1,10,0,1,2,0.91929658,771,139,139,89,89,0,6141,5881,260,40,39,1,92.8431756
572375c95af7f296f400bbf9eedaefd59454f1e1,1,1,1,0,0,0,0,1,4,0,1,1,0,12,140,140,0,0,0,288,288,0,0,0,0,100
bf1bcbfda9675f9a5d67db5f31f9a00e51cd71c3,2,117,1,116,0,0,0,1,5,0,1,2,0.123949868,573,141,141,84,74,10,4248,3786,462,25,24,1,100
6c9d6c393eac7ffe90c1afd4b8af60709b1591ea,6,7,7,0,0,0,0,1,13,0,1,2,2.521640636,749,142,142,149,149,0,4588,4588,0,56,56,0,100
f5a57ebbd2492c503dde8f114e15f09a2e339926,0,0,0,0,0,0,0,0,0,0,0,0,0,0,143,143,0,0,0,0,0,0,0,0,0,100
2c93a5a914f7039289e416494e3ad3b17db1ddff,0,0,0,0,0,0,0,0,0,0,0,0,0,0,144,144,0,0,0,0,0,0,0,0,0,100
cb383b3b92de27f17e0c719e75845d0fd4f23072,0,0,0,0,0,0,0,0,0,0,0,0,0,0,145,145,0,0,0,0,0,0,0,0,0,100
c7896b1d8fce881626e2d22ff11117839b203543,0,0,0,0,0,0,0,0,0,0,0,0,0,0,146,146,0,0,0,0,0,0,0,0,0,100
d14856f02abfcbdd126771a5426a266d71305fe2,0,0,0,0,0,0,0,0,0,0,0,0,0,0,147,147,0,0,0,0,0,0,0,0,0,100
6d1903d19f383ea5c0147891163444a10b628d94,1,11,3,8,0,0,0,1,16,0,1,1,0,508,148,148,86,85,1,3374,3347,27,32,32,0,100
4a44f2831903e1654d453e04584b6eab4f6497b8,0,0,0,0,0,0,0,0,0,0,0,0,0,0,149,149,0,0,0,0,0,0,0,0,0,100
ab05cdc6bfbc978ba4baa3ec22f254a0aff95d88,2,84,1,83,0,0,0,1,2,0,1,2,0.273769169,194,150,150,31,28,3,1770,1318,452,14,12,2,100
406b35c16d21e8a3eee0568035579e6b8aa4acd5,4,6,4,2,0,0,0,1,9,0,1,2,1.970950594,446,151,151,49,46,3,4063,3983,80,15,15,0,97.93336145
30249ed3e2b43e7bee1a9a4d7910c9c161723723,0,0,0,0,0,0,0,0,0,0,0,0,0,0,152,152,0,0,0,0,0,0,0,0,0,100
5c7ebea743a0a0a2f580e68c0030bb3bbc56bf43,1,4,4,0,0,0,0,1,3,0,1,1,0,111,153,153,19,19,0,636,636,0,7,7,0,100
32a0aa3ac008d0946e45685235bdd8fc2872ca11,10,0,264,264,0,0,0,1,5,0,1,2,3.136112599,194,154,154,0,61,61,0,2320,2320,0,15,15,90.41940789
5de4c487f1a0172d7df38f68ae01eae4cdd3d6b3,20,554,245,309,2,0,2,1,15,0,1,11,3.609111538,8356,155,155,1834,557,1277,55784,25244,30540,937,278,659,92.91119076
88b6f5def4065dd731d98e13040ff3dd638ab6f7,4,203,21,182,0,0,0,1,11,0,1,2,1.266537371,929,156,156,130,111,19,8379,7185,1194,60,54,6,100
e8e482ee4fa4a8a7b54bf411cb24b27c533c5893,7,112,86,26,0,0,0,1,3,0,1,4,2.35042524,5465,157,157,1323,1321,2,33776,33587,189,690,690,0,98.29614604
2d8833d7683abc5e3bb196244d283615c11f9f7a,18,4934,2415,2519,0,0,0,1,5,0,1,4,3.16837828,18125,158,158,4982,4496,486,123054,109339,13715,2676,2425,251,98.29614604
901d2a8e8a574ecdeb9a127795b946fb787956ea,0,0,0,0,0,0,0,0,0,0,0,0,0,0,159,159,0,0,0,0,0,0,0,0,0,100
8dcc8640ae04c5717298dfbfd3c103bad65eb029,0,0,0,0,0,0,0,0,0,0,0,0,0,0,160,160,0,0,0,0,0,0,0,0,0,100
dfb1545e4df044d664064f302b13e8ebd9812b8c,2,7,7,0,0,0,0,1,3,0,1,2,0.863120569,274,161,161,48,48,0,2100,2077,23,37,37,0,100
cfbdfeeaca0055cc35ef4811617a19c248a98647,3,65,9,56,0,0,0,1,17,0,1,3,0.946458061,1230,162,162,228,220,8,8503,8316,187,129,126,3,100
a28de2e9cde7cd8e75a9864d06edf98d2ca9ac0e,56,612,401,211,0,0,0,1,5,0,1,23,5.420937824,3953,163,163,359,359,0,33183,32156,1027,195,195,0,100
6372174ebc66cf1328f19c57fd9dd664ee86960f,0,0,0,0,0,0,0,0,0,0,0,0,0,0,164,164,0,0,0,0,0,0,0,0,0,100
f1342a1662badce034d15f2c3b410f6fe4ec7de8,2,23,9,14,0,0,0,1,3,0,1,2,0.928362072,353,165,165,61,59,2,2285,2236,49,20,20,0,100
eaf28044070a641e1be678e386a0ed8ab44e67b5,5,275,2,273,3,0,3,1,10,0,1,4,1.653678623,169,166,166,44,21,23,2475,1442,1033,25,10,15,88.59577922
2438f48f2e9d9a368a0558a0f4447377d21f4af4,9,212,88,124,0,0,0,1,16,0,1,4,2.82504642,1622,167,167,256,243,13,12761,11880,881,109,102,7,99.24242424
97be11a9c6ec1c5d76e378316900c459f36fd939,2,1254,0,1254,1,0,1,1,6,0,1,1,0.995942929,3753,168,168,1138,876,262,28804,22870,5934,629,510,119,99.64171975
26d342d569ae8e5e64eb08a2788b7137204e1295,3,90,4,86,0,0,0,1,6,0,1,3,1.393695566,324,169,169,53,45,8,3060,2433,627,37,34,3,100
fc8537436521d7d45cbfe9d50dada7f3a6113934,3,137,5,132,1,0,1,1,3,0,1,3,1.012960042,119,170,170,21,13,8,1630,921,709,16,11,5,94.54995871
396de2f095753afec35c69cc2ae364be58999609,0,0,0,0,0,0,0,0,0,0,0,0,0,0,171,171,0,0,0,0,0,0,0,0,0,100
9432ea6fc9076ef5648b80d21b4fe1dbd6c1c208,2,1,23,22,0,0,0,1,2,0,1,2,0.543564443,68,172,172,8,10,2,407,457,50,8,10,2,100
91e3972fa35048fa87a642fc2551647ad15a71a4,9,9,11,2,0,0,0,1,7,0,1,7,3.121928095,1406,173,173,182,182,0,10510,10525,15,99,99,0,99.74326059
303d1353eeee4af01448c0f2883b8f82223946a4,3,10,16,6,0,0,0,1,18,0,1,3,1.273650919,1613,174,174,282,282,0,10951,11041,90,78,78,0,94.68479604
8ebd90e38a3d1bec6dcb2d49f7812ab2be415dc4,2,89,33,56,0,0,0,1,3,0,1,2,0.995148096,271,175,175,42,40,2,2442,1974,468,20,18,2,100
ed73bc364e56209542ef95b21a89df2a7c3f9481,0,0,0,0,0,0,0,0,0,0,0,0,0,0,176,176,0,0,0,0,0,0,0,0,0,100
7570ac24155e276e50b3035388a231a1cd470a53,0,0,0,0,0,0,0,0,0,0,0,0,0,0,177,177,0,0,0,0,0,0,0,0,0,100
70a6a9aca5081dc21be5c213851a8a045469186e,165,497,341,156,0,0,0,1,18,0,2,62,7.353895052,21667,178,178,3134,3134,0,153364,152676,688,1531,1531,0,100
cdf8ad09329bb32087a0e140895439b9c29b6027,0,0,0,0,0,0,0,0,0,0,0,0,0,0,179,179,0,0,0,0,0,0,0,0,0,100
a283ed3fd56c9046013fa72a1cd66b12f574c329,12,50,44,6,0,0,0,1,19,0,1,5,3.551012498,3326,180,180,551,552,1,22619,22602,17,213,213,0,100
e9b72752e334ca3a20f65fada279647a2ee09e84,6,804,206,598,1,0,1,1,7,0,1,4,2.007702893,1195,181,181,177,125,52,11573,8460,3113,70,55,15,89.37784522
f8c824e9a2b69ce60faa18931e755b8d494058ac,2,68,1,67,0,0,0,1,8,0,1,2,0.375051406,729,182,182,105,98,7,5232,4771,461,30,29,1,100
1b719f2806ee61b8c5da6fc882ed59c09658f84d,3,22,7,15,0,0,0,1,18,0,1,3,1.201146431,897,183,183,173,172,1,6221,6153,68,107,106,1,100
f0d738c012c6c2681e4507515f93444e7be704f4,13,358,24,334,0,0,0,1,20,0,1,7,2.657802342,1922,184,184,328,303,25,14711,13264,1447,182,172,10,99.85475672
955bebf791232165f0f3e23af5b0c955cfeaa224,15,157,136,21,0,0,0,1,7,0,1,6,3.492053959,1111,185,185,128,135,7,7925,7904,21,71,79,8,93.54037267
a8396ad939896460e6739907370b06d332ef0bf4,0,0,0,0,0,0,0,0,0,0,0,0,0,0,186,186,0,0,0,0,0,0,0,0,0,100
d41e89c92faa980cc667917a0b6da352a6f560a5,6,1244,15,1229,2,0,2,1,12,0,1,4,1.333257728,689,187,187,199,93,106,11001,4946,6055,76,36,40,99.86460872
f6fd853070dc725c75f86c698742f642cd951b5e,0,0,0,0,0,0,0,0,0,0,0,0,0,0,188,188,0,0,0,0,0,0,0,0,0,100
994cccfcd5f5f2918f24f8b88d1243b01701ff29,0,0,0,0,0,0,0,0,0,0,0,0,0,0,189,189,0,0,0,0,0,0,0,0,0,100
05ad75d483b5ffc4b592db7253cefc0fabe38a89,40,308,352,44,0,0,0,1,13,0,1,25,2.206588133,5470,190,190,622,624,2,40809,41063,254,333,335,2,99.97295836
639c3a82202da3936aa8397c815a08b167fb3006,0,0,0,0,0,0,0,0,0,0,0,0,0,0,191,191,0,0,0,0,0,0,0,0,0,100
40efa57738ff8aeaa6afd211ce1f7243c85be373,0,0,0,0,0,0,0,0,0,0,0,0,0,0,192,192,0,0,0,0,0,0,0,0,0,100
c1385a45d9d6268eb4fbce8cf44b0d31389e29d7,1,3,2,1,0,0,0,1,4,0,1,1,0,130,193,193,22,22,0,882,869,13,10,10,0,100
f6b25ad5cb50e7ebfa5007c8ecdbcdc21f443fd2,3,4,7,3,0,0,0,1,13,0,1,3,1.309296668,437,194,194,39,39,0,3082,3082,0,24,24,0,100
82e45b4492649675c7dbf287e9e557e114f0516b,0,0,0,0,0,0,0,0,0,0,0,0,0,0,195,195,0,0,0,0,0,0,0,0,0,100
953023169320bbb264f703649994f0bb66b7c0ad,0,0,0,0,0,0,0,0,0,0,0,0,0,0,196,196,0,0,0,0,0,0,0,0,0,100
f99bf87206020a90092c100c4e279b4c58f48e27,0,0,0,0,0,0,0,0,0,0,0,0,0,0,197,197,0,0,0,0,0,0,0,0,0,100
46674b5ebc7decce566ca50ea94327f6974e7d59,0,0,0,0,0,0,0,0,0,0,0,0,0,0,198,198,0,0,0,0,0,0,0,0,0,100
3c8f8a7436310a50abdb55a572fc20cc25bf7f2e,0,0,0,0,0,0,0,0,0,0,0,0,0,0,199,199,0,0,0,0,0,0,0,0,0,100
175eca579c4b0a26c63a56a4e76b671e65fd4563,3,226,226,0,0,0,0,1,3,0,1,2,1.386703323,159,200,200,44,44,0,1147,1147,0,17,17,0,100
d210d44552daf339dbd9dafabd69d0ec0c00a49c,2,74,0,74,1,0,1,1,4,0,1,2,0.405977038,132,201,201,36,31,5,1239,910,329,18,15,3,99.94594595
e59eb6945258c6283736c22fb439ab08bd4b1cd5,3,44,24,20,0,0,0,1,5,0,1,3,1.538849584,456,202,202,43,43,0,3536,3413,123,24,24,0,100
b14951b9fe7a65be6cd5bdaecba59ae0b6a8ca2e,3,68,18,50,1,0,1,1,2,0,1,3,1.519456493,216,203,203,16,13,3,1981,1836,145,12,11,1,99.89203779
41adc8af6f179f1222edc79190accca3ca7dddc7,3,35,4,31,0,0,0,1,5,0,1,2,1.414164757,873,204,204,51,51,0,7301,7179,122,41,41,0,99.97303128
a5dc06c3767bee191144f047e7fd4f46b6a5826c,0,0,0,0,0,0,0,0,0,0,0,0,0,0,205,205,0,0,0,0,0,0,0,0,0,100
0b44b9b0a40e266b9c5ece53e9f85ab93ad2c3b9,2,161,21,140,1,0,1,1,21,0,1,1,0.987419731,541,206,206,105,93,12,3896,3579,317,38,33,5,98.64566059
ee3b31792bcef99feaf4f60c437b09cfbcace767,0,0,0,0,0,0,0,0,0,0,0,0,0,0,207,207,0,0,0,0,0,0,0,0,0,100
64ccdaf02beb34c81ecbda225d0435bbb3b42e46,0,0,0,0,0,0,0,0,0,0,0,0,0,0,208,208,0,0,0,0,0,0,0,0,0,100
266379679e7c1f3b2931ec97bbc950ca73856381,0,0,0,0,0,0,0,0,0,0,0,0,0,0,209,209,0,0,0,0,0,0,0,0,0,100
d35f8d17173ea4f68c5e5ce1c2766156bd3c955b,1,1,1,0,0,0,0,1,2,0,1,1,0,377,210,210,67,67,0,2360,2360,0,17,17,0,100
2fbe9ac4e150af5fb51099dcb02962aefe39fd87,0,0,0,0,0,0,0,0,0,0,0,0,0,0,211,211,0,0,0,0,0,0,0,0,0,100
512f3f6cc404da3d65105c3de290223fcbaae088,1,6,2,4,0,0,0,1,6,0,1,1,0,128,212,212,17,17,0,981,948,33,8,8,0,100
54ba3a27fb5cb8de8da545e6959fe5c11c23219d,3,114,6,108,0,0,0,1,9,0,1,2,1.436113431,710,213,213,107,94,13,5284,4746,538,42,38,4,100
61b47d97ec28ee22d7e24691d26ccd1670581f3b,5,191,2,189,2,0,2,1,11,0,1,3,2.037520192,663,214,214,74,65,9,5612,4893,719,46,37,9,99.88681381
05344cbdfb481ec47b860ff2e92fab50bc3a3fe7,3,52,6,46,1,0,1,1,4,0,1,2,1.125613206,204,215,215,44,43,1,1584,1460,124,29,28,1,99.94353473
09447f35e0d4569044ddcb0135bcb805675e3896,4,76,54,22,0,0,0,1,20,0,1,4,1.766743605,1069,216,216,211,209,2,7384,7306,78,126,124,2,100
99b8eed6dc42707ca19204184df82c424c75b0cb,1,0,7,7,0,0,0,1,21,0,1,1,0,630,217,217,131,132,1,4220,4259,39,88,88,0,100
402493183c04dc046055249431a95e9610268d26,145,910,708,202,0,0,0,1,15,0,2,52,6.260325583,15887,218,218,1843,1831,12,118976,118442,534,988,990,2,96.38705624
c490857c91ada618a4b533d5aef6282ccd96f3a9,4,178,35,143,0,0,0,1,8,0,1,3,1.213545726,1062,219,219,140,134,6,8808,8060,748,67,61,6,98.99549706
318d9c2322b46f1c674e5e33b9ec78a530773575,2,1295,825,470,0,0,0,1,6,0,1,1,0.905710156,3412,220,220,510,487,23,22596,20417,2179,119,108,11,100
7e39bc72782f1e87ff74c4cb83c475525bde4d50,2,61,4,57,1,0,1,1,7,0,1,2,0.829059069,79,221,221,15,12,3,825,562,263,9,7,2,99.62800135
a4e13214477e898bb653bc6a3aeeaced8d50f790,3,0,726,726,0,0,0,1,13,0,1,3,1.029394908,643,222,222,15,80,65,1198,4779,3581,5,28,23,99.8647735
2f76dc26833a97e115e31ca43f7d3be4ceb59d8c,2,0,135,135,0,0,0,1,9,0,1,2,0.546158204,516,223,223,74,93,19,3469,3950,481,26,36,10,99.93224932
556313934450c3032c8120825509a8ffb019d126,3,238,69,169,0,0,0,1,7,0,1,3,1.271710904,493,224,224,68,56,12,4508,3495,1013,33,30,3,100
55a96b19b57ef77ab09c426b84b3372b135e16d3,24,121,94,27,0,0,0,1,16,0,1,16,4.199352321,3727,225,225,518,517,1,25983,25929,54,233,233,0,100
50616d52f474d58fe3e6c1a7245b1cb65fb89c14,3,184,29,155,0,0,0,1,7,0,1,3,1.181241938,662,226,226,62,55,7,5984,5174,810,36,33,3,100
b0bc6f4654af1455e3a79ff11f2903d149f04ec4,1,3,1,2,0,0,0,1,13,0,1,1,0,278,227,227,50,50,0,1990,1974,16,29,29,0,100
9763088c84e6207124b2dbeca49105abd4cecbcf,24,344,137,207,1,0,1,1,22,0,1,14,3.879287949,3918,228,228,507,498,9,29440,28533,907,257,247,10,97.25408412
5f5c381d801e670cd38929923e7bd41fee8dec9e,1,1,1,0,0,0,0,1,5,0,1,1,0,264,229,229,47,47,0,1727,1727,0,13,13,0,100
c39f206042178707b01fd0b4664e7975a8d03161,0,0,0,0,0,0,0,0,0,0,0,0,0,0,230,230,0,0,0,0,0,0,0,0,0,100
02cb2d5f59dc64b1688ee66e661b6bc494e1e987,12,497,28,469,5,0,5,1,15,0,1,5,3.088430221,1030,231,231,174,147,27,8356,6855,1501,107,81,26,95.07562434
54a68e2cdb8ac2ef8e6ab929b2a5b566a865c214,3,101,1,100,1,0,1,1,15,0,1,2,1.071264462,412,232,232,65,60,5,3029,2712,317,28,23,5,94.29183018
cfc160208c8f4354d01368be715b89099d12f457,7,268,96,172,1,0,1,1,16,0,1,3,2.710600309,561,233,233,98,80,18,4894,3613,1281,47,43,4,93.74362462
908049dfddee3b79f65fdd2c2f315242a76f5208,4,221,9,212,2,0,2,1,23,0,1,3,1.629141144,842,234,234,164,150,14,6539,5587,952,59,49,10,99.81030667
23e5921c7ea1e2621a6d87ebb1a9da940a9d9dfa,3,165,2,163,1,0,1,1,17,0,1,3,1.580824196,388,235,235,80,65,15,3145,2459,686,32,27,5,92.71414506
b4ce8b477fdc074ea8e5fe0913424874f023be4e,6,113,42,71,0,0,0,1,10,0,1,3,2.036875714,1551,236,236,216,209,7,11803,11443,360,100,97,3,90.80297135
8261a41e9f49e8f92fedbf5eec3ecec1fe249158,1,1,1,0,0,0,0,1,4,0,1,1,0,82,237,237,15,15,0,470,470,0,7,7,0,100
d94091af2fdd4de3c288fbf94f55ec8d53009b80,4,7,25,18,0,0,0,1,5,0,1,1,1.789850554,455,238,238,64,66,2,2769,2846,77,45,47,2,99.889989
4efe095136eff545e47696ceea8316b0b25cda0c,1,7,15,8,0,0,0,1,8,0,1,1,0,169,239,239,22,22,0,1073,1100,27,13,13,0,100
d837e1271e7356a569162b66e4cfa4ec92c08db7,7,1,234,233,0,0,0,1,7,0,1,3,2.483953006,1210,240,240,100,114,14,7200,8126,926,74,86,12,100
f8ddb7b8a98317986719191150c1c00cd8e2688a,2,1108,1536,428,0,0,0,1,7,0,1,1,0.900607732,3746,241,241,486,510,24,20791,22596,1805,114,119,5,100
0b72b00774b44701ebeeb9e1278f6508aab60e85,2,16,8,8,0,0,0,1,18,0,1,1,0.41381685,902,242,242,151,150,1,6468,6422,46,54,54,0,100
a53629234040d9ed6c7631837aa1ee6cf4aef925,1,3,3,0,0,0,0,1,22,0,1,1,0,623,243,243,131,131,0,4220,4220,0,88,88,0,100
684b3d87fac246374bd70ce07370d1d649111a28,0,0,0,0,0,0,0,0,0,0,0,0,0,0,244,244,0,0,0,0,0,0,0,0,0,100
a73aebca8496b06c9a17c4ddfdc787c3784084c7,0,0,0,0,0,0,0,0,0,0,0,0,0,0,245,245,0,0,0,0,0,0,0,0,0,100
73a78166f5e760ca570495c61a65cc4f9d38d0e9,1,7,3,4,0,0,0,1,4,0,1,1,0,341,246,246,63,63,0,2257,2236,21,30,30,0,100
a78e3cb90075f4146f91b1014c16fce45999c446,2,44,16,28,0,0,0,1,6,0,1,2,0.90071968,157,247,247,22,25,3,1212,1078,134,13,12,1,100
096acff7e137d3178b04dbf83b3f04061ecaedf6,3,18,9,9,0,0,0,1,9,0,1,2,1.380094336,720,248,248,133,132,1,4972,4945,27,51,51,0,100
32896205ab5d47ec67700526676c711a059dc3a5,3,38,9,29,0,0,0,1,5,0,1,3,1.381415163,394,249,249,101,99,2,2533,2413,120,25,24,1,100
939a9d598aa2ebe2557d0c267959e08998040640,1,7,3,4,0,0,0,1,5,0,1,1,0,226,250,250,33,33,0,1527,1496,31,16,16,0,100
04a612a19e98f33e74c54a64ead735186cb1032d,44,245,150,95,0,0,0,1,18,0,1,22,4.733646037,5939,251,251,850,849,1,41772,41031,741,411,410,1,97.70803949
516e4dafd1e5b20f311ca1a2528660e85e5bf493,8,65,75,10,0,0,0,1,9,0,1,5,2.762769656,1687,252,252,178,178,0,13056,13159,103,85,85,0,100
3fb2d51bfef26337e81d517fa179bb9c2bbd0e37,0,0,0,0,0,0,0,0,0,0,0,0,0,0,253,253,0,0,0,0,0,0,0,0,0,100
1f6563480cde2437b8d1b33e3844a935b2b14d71,0,0,0,0,0,0,0,0,0,0,0,0,0,0,254,254,0,0,0,0,0,0,0,0,0,100
a81ff6450b1d365d49115a1079d40eede8d5cbef,2,34,2,32,0,0,0,1,7,0,1,2,0.764204507,706,255,255,47,46,1,5801,5620,181,29,28,1,100
b2d43e2bc4c7c860dc563ab1e6648b3cc41629fe,1,3,2,1,0,0,0,1,3,0,1,1,0,42,256,256,7,7,0,273,256,17,6,6,0,100
c937a8f0ffd1cddf5b953da72e36da63b7b1745f,2,5,2,3,0,0,0,1,16,0,1,1,0.985228136,582,257,257,100,100,0,4091,4063,28,55,55,0,100
e0553132004d431801a17fce74c59e7ee2fda853,1,29,11,18,0,0,0,1,5,0,1,1,0,87,258,258,10,10,0,746,587,159,5,5,0,97.73169151
3fbb2ee2b60d9d5b671d07cf42664549d4d2f94e,2,26,0,26,0,0,0,1,5,0,1,2,0.391243564,287,259,259,50,48,2,2327,2192,135,16,15,1,100
5a306282b7fb48b91ac3a9e2333e39fd73ef2700,3,21,18,3,0,0,0,1,1,0,1,3,0.760658477,202,260,260,23,6,17,1436,1149,287,14,6,8,99.50586782
e2536815c09644b19a25b64a03ed075275609dfa,2,12,5,7,0,0,0,1,8,0,1,2,0.977417818,116,261,261,22,21,1,763,720,43,10,10,0,100
fcd30abe5219a1ec1f514aa6670b414ea3b95468,0,0,0,0,0,0,0,0,0,0,0,0,0,0,262,262,0,0,0,0,0,0,0,0,0,100
b535045a10f738d1a582c90ff88f8fd4f1bcf603,107,1529,321,1208,2,0,2,1,24,0,1,43,6.107259787,14599,263,263,2040,1946,94,111570,104855,6715,1086,1008,78,87.79612347
d5c7e811196e261554983c4e9fd11a24e3c86a2b,6,171,22,149,0,0,0,1,7,0,1,3,2.18430928,616,264,264,91,83,8,5596,4639,957,58,51,7,100
6d131a96f1220be5e4c7318a7a8e8dac33a218ac,2,119,122,3,0,0,0,1,11,0,1,2,0.711857106,855,265,265,95,97,2,6201,6204,3,43,42,1,100
c9fab864321dcc46590627e945e81017a5fc808a,9,236,58,178,0,0,0,1,12,0,1,5,2.681406548,2368,266,266,305,286,19,18778,17731,1047,149,138,11,89.71562135
5b8c02fc7fac89f8f7d6bd06d86e0c3fdcabdbcc,4,167,0,167,1,0,1,1,7,0,1,3,1.443171065,429,267,267,57,46,11,3945,3046,899,33,26,7,94.21164773
38bfc598380c9a376af997774f3962052fe6e4e0,0,0,0,0,0,0,0,0,0,0,0,0,0,0,268,268,0,0,0,0,0,0,0,0,0,100
69682ffa8849f88f87e7d84ae8792f8ed2d1f88c,3,5,3,2,0,0,0,1,6,0,1,2,1.5,248,269,269,48,48,0,1728,1729,1,24,24,0,100
95c993f83e6089d7fa84eb2796a13c7f3a5d1497,14,790,1352,562,0,0,0,1,7,0,1,4,2.951486645,21233,270,270,5061,5205,144,124569,128269,3700,2562,2780,218,100
177aa8b7c511f9b5e168bb2847a0f6c6720fea11,0,0,0,0,0,0,0,0,0,0,0,0,0,0,271,271,0,0,0,0,0,0,0,0,0,100
e00ed93307b574b20af4fdcc24d412477f525d60,2,7,4,3,0,0,0,1,4,0,2,2,0.845350937,93,272,272,11,11,0,673,630,43,7,7,0,98.30449827
74b0870319712e672f2d60edbcbf9f34f295e83b,2,25,30,5,0,0,0,1,8,0,1,2,0.869892686,125,273,273,15,14,1,811,848,37,10,9,1,99.86463621
12a8cccd3741443d6ff699f482d62bbf7b4cea50,13,0,1066,1066,0,0,0,1,2,0,1,1,3.410783813,593,274,274,0,102,102,0,4950,4950,0,62,62,98.93799246
1a88df19de8bb66ecbbd8326f07a242a9c05e06b,7,285,34,251,0,0,0,1,11,0,1,6,0.980166015,926,275,275,126,119,7,7315,5950,1365,78,71,7,100
970a1bd7ca8dcf0fb410fad113ddcbfeb2c0d82b,3,219,0,219,2,0,2,1,11,0,1,3,1.062944021,242,276,276,43,25,18,3263,2339,924,21,8,13,99.82716903
780dcf86248199f06954f2fee6aa7d8ccd079105,0,0,0,0,0,0,0,0,0,0,0,0,0,0,277,277,0,0,0,0,0,0,0,0,0,100
97c03eafa8213ddaaeee6e1c8091f3bbe65d8f64,0,0,0,0,0,0,0,0,0,0,0,0,0,0,278,278,0,0,0,0,0,0,0,0,0,100
a890e656363878882454a5102eed18793cf4588b,0,0,0,0,0,0,0,0,0,0,0,0,0,0,279,279,0,0,0,0,0,0,0,0,0,100
bfa7afeee29e2c2d70145c12bef672cbbbba2e48,0,0,0,0,0,0,0,0,0,0,0,0,0,0,280,280,0,0,0,0,0,0,0,0,0,100
c46b90380cfe25f6c0fcb3d72fc6d3fc840f773f,0,0,0,0,0,0,0,0,0,0,0,0,0,0,281,281,0,0,0,0,0,0,0,0,0,100
238c22134b6fb731e5a2a5af49209539b80b814e,2,1064,863,201,0,0,0,1,8,0,1,1,0.936159133,3479,282,282,496,486,10,21670,20791,879,117,114,3,100
6252198f1b9808fecac98acc8e94b84d1069cc2d,0,0,0,0,0,0,0,0,0,0,0,0,0,0,283,283,0,0,0,0,0,0,0,0,0,100
5de35da054a0bbdedab0023edfa262d0b28a38a8,1,2,0,2,0,0,0,1,20,0,1,1,0,394,284,284,65,65,0,2513,2507,6,25,25,0,100
dfd1dcde6e4d5638b58ca288f7a07f6cd30a28c6,0,0,0,0,0,0,0,0,0,0,0,0,0,0,285,285,0,0,0,0,0,0,0,0,0,100
c7de0cc38931fddd3a448aa07f0482968af897f5,57,100,100,0,0,0,0,1,25,0,1,24,5.545720814,9842,286,286,1672,1672,0,68057,68057,0,728,728,0,100
f5aafaeeac7728e15fe06d6747ac8d8ac6e74bf7,6,0,133,133,0,0,0,1,9,0,1,3,2.510131892,696,287,287,86,110,24,4144,4867,723,56,62,6,100
7b7dc089bbbfacbe7b13a1cd9fbe78c4667e77d2,0,0,0,0,0,0,0,0,0,0,0,0,0,0,288,288,0,0,0,0,0,0,0,0,0,100
e0ccbc8c39f2c4261ecd86e58db5ce6c1e760f1b,2,108,2,106,0,0,0,1,6,0,1,2,0.952743171,110,289,289,26,8,18,1419,841,578,11,4,7,99.34210526
17c4adf93823f6d860a46806ca034daf3864c0cf,0,0,0,0,0,0,0,0,0,0,0,0,0,0,290,290,0,0,0,0,0,0,0,0,0,100
0f2bc3ca0503c2160a4b2c313fdfbcea7e46db9f,0,0,0,0,0,0,0,0,0,0,0,0,0,0,291,291,0,0,0,0,0,0,0,0,0,100
6763dddb12c7eb58a5e20ce43c0dc6b82c6acca3,3,151,0,151,1,0,1,1,13,0,1,3,0.745578599,297,292,292,38,27,11,3595,2909,686,15,10,5,98.69442484
e6ace378fbd33cf6c127a1870f488588be532777,2,24,2,22,0,0,0,1,12,0,1,2,0.619382195,385,293,293,35,33,2,3218,3167,51,16,16,0,100
84ad1cb0c34c4535221837a67c62f601606d41e7,2,27,21,6,0,0,0,1,6,0,1,2,0.249882293,332,294,294,15,15,0,2621,2535,86,14,14,0,100
ec7db1365e181bf411930a33659ead6d350a484b,19,3848,2693,1155,0,0,0,1,8,0,1,4,2.939692454,20982,295,295,5400,5100,300,164570,125288,39282,2725,2577,148,100
8fe6ac5d19018acee1bfa54f301a37684c777579,8,7,323,316,0,0,0,1,15,0,1,5,2.10839811,1097,296,296,96,125,29,7094,8505,1411,49,61,12,99.45984876
a383795e420c80f2df6500fd625bb0637fd1ad38,1,0,1079,1079,0,0,0,1,6,0,1,1,0,1597,297,297,166,374,208,5952,12250,6298,108,216,108,99.85522982
6a0ed1539e6ebf9f529da685bdb656292db7f17b,0,0,0,0,0,0,0,0,0,0,0,0,0,0,298,298,0,0,0,0,0,0,0,0,0,100
02dfdb242ebe60a3fbce04b52176190f186a3f47,1,3,4,1,0,0,0,1,3,0,1,1,0,111,299,299,8,8,0,1061,1037,24,8,8,0,100
ebc86437b23ed28e1402fbcb22b3ffaefb157db9,5,398,366,32,1,0,1,1,13,0,1,2,1.184635376,1439,300,300,154,154,0,10437,10360,77,62,62,0,99.81903728
4328379179568b6afa278cb528687df550f3f027,4,1070,16,1054,2,0,2,1,14,0,1,2,1.467569984,366,301,301,127,54,73,8167,2448,5719,55,21,34,99.85549133
801676390b620db205ad44cf9e6267613949a199,3,215,4,211,1,0,1,1,15,0,1,3,0.911438666,315,302,302,41,28,13,4312,3041,1271,17,11,6,99.92790195
6da9f592e778e47d9905575738ed1cd44a9b7614,5,150,117,33,1,0,1,1,26,0,1,5,1.964094845,1409,303,303,200,200,0,9300,9202,98,86,86,0,91.70616114
b0ab95edb7bdde6999290dc5ad5e6cd072f4a6bb,0,0,0,0,0,0,0,0,0,0,0,0,0,0,304,304,0,0,0,0,0,0,0,0,0,100
e4308cff2fc09a0fff676b8b67f66ee0c72fafbc,13,35,29,6,0,0,0,1,10,0,1,9,3.397368359,1703,305,305,214,214,0,12892,12796,96,131,131,0,100
6e292d3b86c2413be6ad03189b601955c5ae9096,4,404,55,349,0,0,0,1,11,0,1,3,1.361597046,948,306,306,154,130,24,9198,7529,1669,77,64,13,92.05894392
06be3b5f66c141da0809bd89ac54ac6098e7e037,0,0,0,0,0,0,0,0,0,0,0,0,0,0,307,307,0,0,0,0,0,0,0,0,0,100
3b59d705170e4510a6389e1e4723aff700a32546,0,0,0,0,0,0,0,0,0,0,0,0,0,0,308,308,0,0,0,0,0,0,0,0,0,100
517426d8aaeddec3bace226aaf6ff8a50702c61e,2,53,3,50,0,0,0,1,13,0,1,2,0.371232327,392,309,309,37,35,2,3492,3218,274,17,16,1,100
f5add088c9945d3dbc8c2afa65d357de8580cf78,1,3,1,2,0,0,0,1,8,0,1,1,0,258,310,310,14,14,0,2316,2305,11,9,9,0,100
54f874f71ae3845b2853174d6554ce1011bb4cee,3,3,80,77,0,0,0,1,23,0,1,3,1.175135156,1048,311,311,163,168,5,7298,7723,425,103,105,2,100
a8c2419fcc6293b64abea250dcf9086e1804b7f0,0,0,0,0,0,0,0,0,0,0,0,0,0,0,312,312,0,0,0,0,0,0,0,0,0,100
26ef9cfd48091abfd4686ee284b53b77c8e4ee94,0,0,0,0,0,0,0,0,0,0,0,0,0,0,313,313,0,0,0,0,0,0,0,0,0,100
2c9ef4e593c1e545b813679de1f7f1c2c3776f1e,0,0,0,0,0,0,0,0,0,0,0,0,0,0,314,314,0,0,0,0,0,0,0,0,0,100
471206064259c3016a9f6fd732cbeae7d22ce776,2,74,33,41,0,0,0,1,4,0,1,2,0.921379645,432,315,315,35,29,6,3199,3007,192,13,13,0,100
d3a90d463b149f964a8ec4607dbb1110536f394a,2,60,59,1,0,0,0,1,5,0,1,2,0.212201328,220,316,316,31,32,1,1635,1630,5,11,11,0,100
235e154a49c4fa9c79430e64d181392327f0eaba,521,573,33900,33327,4,0,4,1,9,0,4,101,3.642605244,76447,317,317,6553,9411,2858,371319,419840,48521,3560,4249,689,20.47904192
3c87e454b19841535011bd816c08ca2636d6316d,2,3,2,1,0,0,0,1,2,0,1,2,0.970950594,90,318,318,6,6,0,809,779,30,3,3,0,100
bf5f40554bb8841a8a30421539fdda6f6081ce91,3,515,1,514,2,0,2,1,2,0,2,3,1.025389443,134,319,319,75,32,43,2643,941,1702,35,16,19,99.79313198
0eed26fafad22f071542f70d3d68d13b69498316,7,710,14,696,3,0,3,1,2,0,2,6,1.450777188,1209,320,320,242,191,51,11577,7977,3600,101,78,23,99.71181556
05ecef5320ae4d82bead685e71b80b7883a4963b,3,581,0,581,3,0,3,1,1,0,1,2,1.493197673,0,321,321,34,0,34,3364,0,3364,23,0,23,99.67253377
0948ca70471b6bdd147fd6c74c9f1d59bd59369c,20,353,450,97,0,0,0,1,2,0,1,13,3.055621297,4243,322,322,587,590,3,28917,29563,646,303,307,4,99.83653453
feb66308e00e116aae2ad21a712f002c3cefec8d,17,216,153,63,0,0,0,1,3,0,1,8,2.981228894,3183,323,323,360,357,3,23639,23344,295,192,192,0,100
9b726222422d5f415bbb737e8636e44cb1a0ec95,9,482,626,144,0,0,0,1,4,0,1,7,2.564211942,1769,324,324,198,219,21,11500,12458,958,99,98,1,97.8013349
cc126a42c0a53b938ff2cf636caba84c03a127a1,8,190,43,147,1,0,1,1,3,0,1,4,2.67553324,1137,325,325,121,105,16,9090,8584,506,65,57,8,99.81153411
39ad1c065c78767f69400a6c45e550f56a6a5fed,3,82,25,57,0,0,0,1,4,0,1,2,1.049976448,485,326,326,92,85,7,3606,3291,315,38,33,5,100
2a134d6eec8bb97c6b9c87ec34667b11c81b4679,6,74,29,45,0,0,0,1,3,0,1,2,1.949921298,1249,327,327,235,223,12,8567,8277,290,85,85,0,100
fdbd1d3876c3afd00ac454c035875fb11ac9b985,6,26,13,13,0,0,0,1,5,0,1,4,2.369883443,1810,328,328,309,305,4,13215,13181,34,107,107,0,100
678393188a8e2e7194d4498d3f2db759516b5412,3,0,0,0,0,0,0,1,1,0,1,1,0,141,329,329,15,18,3,1015,1011,4,14,15,1,99.54819277
7b76c1c5e45ca0817647b866fbbf957b0c67f4ba,6,2,1,1,0,0,0,1,1,0,1,2,0,825,330,330,87,30,57,6987,3366,3621,47,30,17,99.05838041
bfaf05f7506a60c082c4d2c40d716448b5fc3cfc,0,0,0,0,0,0,0,0,0,0,0,0,0,0,331,331,0,0,0,0,0,0,0,0,0,100
3bd67cd2de701555bd37fd1d19274c1d1380e02d,2,44,2,42,0,0,0,1,2,0,1,2,0.965636133,230,332,332,67,64,3,1401,1252,149,10,7,3,100
e554cdb54d0104ba861dd5f5113f834527f3bd75,1,55,5,50,0,0,0,1,3,0,1,1,0,475,333,333,28,27,1,4022,3774,248,17,16,1,100
7815dcf785e96f53e43c90d3595c504ee19aae6e,0,0,0,0,0,0,0,0,0,0,0,0,0,0,334,334,0,0,0,0,0,0,0,0,0,100
f0c9621186d65c2aa7ae95724309563536b7d613,2,7,8,1,0,0,0,1,5,0,1,2,0.836640742,353,335,335,45,45,0,2338,2338,0,21,21,0,100
cce366e144a7f64149328d24492f14cc8dd50030,2,111,2,109,1,0,1,1,2,0,1,2,0.400930682,82,336,336,21,12,9,1025,568,457,9,7,2,93.06335204
1ddebd20ba6061f81e8b0b6291a7a0a1b2e8e524,17,200,90,110,1,0,1,1,2,0,1,11,3.410734821,3412,337,337,287,278,9,27178,26744,434,162,156,6,98.72286079
037bec2898fdad70d0f49da6adaf9f467e5f585a,4,85,27,58,0,0,0,1,4,0,1,4,1.483036005,1009,338,338,99,92,7,7713,7429,284,57,54,3,99.91539763
a98c9fe5edab6847937ff886aa24aa7338ed05dd,0,0,0,0,0,0,0,0,0,0,0,0,0,0,339,339,0,0,0,0,0,0,0,0,0,100
2e84d1d09fcfe0bed77f3beca1148bb0e1e77a79,0,0,0,0,0,0,0,0,0,0,0,0,0,0,340,340,0,0,0,0,0,0,0,0,0,100
dc16ef89575cf96d669ba6b2cf940178f3117b70,1,9,0,9,0,0,0,1,2,0,1,1,0,329,341,341,24,23,1,2183,2135,48,21,20,1,100
41d38ac0b9170905b173946505fa3b69dd476979,0,0,0,0,0,0,0,0,0,0,0,0,0,0,342,342,0,0,0,0,0,0,0,0,0,100
9f2efb9785d5053628ef29b496466b40bfa6fa78,3,1,149,148,0,0,0,1,2,0,1,1,1.300717693,730,343,343,117,127,10,5205,5826,621,32,37,5,99.91532599
6d6be2de4b7ecd3e065ec3d179d7bea7e3570b0d,10,229,53,176,1,0,1,1,4,0,1,5,2.964023353,1467,344,344,208,186,22,12457,11845,612,99,86,13,94.98102067
eb7f9efbd7f31eaf49d651e506e7660c3fbe3bcb,0,0,0,0,0,0,0,0,0,0,0,0,0,0,345,345,0,0,0,0,0,0,0,0,0,100
7f71158ab787a4c982fa3df35bb32c297cb6886a,4,274,26,248,2,0,2,1,3,0,1,4,1.571193686,317,346,346,63,47,16,3360,2126,1234,30,21,9,96.82746632
9dc1824f8efd5e3f55a8395e87adfd0196189c48,3,1,75,74,0,0,0,1,3,0,1,2,0.8304289,120,347,347,9,17,8,380,785,405,8,12,4,94.15204678
85330742ab2d635cfec4424ca01972adac294cb1,0,0,0,0,0,0,0,0,0,0,0,0,0,0,348,348,0,0,0,0,0,0,0,0,0,100
d30487112cfb501f13a3bff70c9d6874e0e8aafe,5,33,20,13,0,0,0,1,3,0,1,5,1.760760119,835,349,349,93,93,0,5910,5782,128,53,53,0,100
24c5b636ff804fe3662f72a3b4db71c293a047ee,2,67,4,63,1,0,1,1,3,0,1,2,0.922919288,153,350,350,30,23,7,1372,1109,263,12,9,3,99.84441851
a10a4d73f2c6008295b98e98015bce6abf371703,3,81,0,81,0,0,0,1,4,0,1,2,1.535041442,752,351,351,140,128,12,6393,5942,451,50,43,7,100
40b908fea512fe6cdd52d7c28338c9a6737da477,3,8,1,7,0,0,0,1,3,0,1,3,1.435520504,184,352,352,10,10,0,1493,1464,29,8,8,0,100
9a823dbcb36a7dd4183f51beb5a220301a3cb963,12,315,272,43,0,0,0,1,5,0,1,8,2.505686153,2402,353,353,305,292,13,18745,18710,35,153,144,9,100
41cab512888cba841668ae27ac11d1d6cd581f80,0,0,0,0,0,0,0,0,0,0,0,0,0,0,354,354,0,0,0,0,0,0,0,0,0,100
9224b9764cb61e0cdab36d398e133c5b3ba4a55a,0,0,0,0,0,0,0,0,0,0,0,0,0,0,355,355,0,0,0,0,0,0,0,0,0,100
d688ceafb68f847126424a693215e55a8543b4b0,0,0,0,0,0,0,0,0,0,0,0,0,0,0,356,356,0,0,0,0,0,0,0,0,0,100
94b035fff601bb7a79531c9eeb88a57e64a6afa7,0,0,0,0,0,0,0,0,0,0,0,0,0,0,357,357,0,0,0,0,0,0,0,0,0,100
cbc2173413a88ace9b863f9fd79f833290c02a8b,0,0,0,0,0,0,0,0,0,0,0,0,0,0,358,358,0,0,0,0,0,0,0,0,0,100
0cde426c49a5e3a46b04f28ec403a5baffe08472,0,0,0,0,0,0,0,0,0,0,0,0,0,0,359,359,0,0,0,0,0,0,0,0,0,100
f28e51be156cd02052191f84dd98b94783df72f1,0,0,0,0,0,0,0,0,0,0,0,0,0,0,360,360,0,0,0,0,0,0,0,0,0,100
93095b4cbc1bbeb6757f1542b3ac2886fa36d671,4,71,16,55,0,0,0,1,3,0,1,4,1.742711491,1727,361,361,325,318,7,11507,11136,371,175,172,3,100
3afb1a023685a1b0d34145e93d1d21a409bd1c4e,15,621,359,262,3,0,3,1,4,0,2,5,3.244397187,1523,362,362,217,191,26,12359,10362,1997,102,101,1,99.41724942
f9a4d9b1b84ffffef2bc09ac5f1c87f3a6875838,1,0,22,22,0,0,0,1,2,0,1,1,0,3,363,363,0,0,0,0,14,14,0,0,0,99.9222395
1706da1f0b6bcfbf1e7cb66087889905d98d4f62,3,86,10,76,1,0,1,1,3,0,1,3,1.163500285,140,364,364,16,11,5,1486,1086,400,14,11,3,99.9222395
308ba7eaea4f8aebffb561576ba060e27656cc1f,4,117,6,111,1,0,1,1,4,0,1,3,1.207657787,789,365,365,162,156,6,5772,5306,466,106,103,3,99.92236025
7badd2dfa340e493ab40a82f33c314f9a96af520,3,66,3,63,1,0,1,1,4,0,1,2,0.573523605,216,366,366,38,31,7,1431,1241,190,22,17,5,99.84502131
1019390875a01a8969f4c99bd53ad52b27934b7a,4,260,55,205,0,0,0,1,4,0,1,4,1.371078301,777,367,367,105,85,20,6493,5385,1108,54,51,3,93.02050473
98b64ed9a756351a2137108aba0d854be63b700f,4,130,5,125,0,0,0,1,6,0,1,2,1.104232277,920,368,368,85,79,6,7359,6738,621,46,43,3,100
150cb81a660e6555c40d8935f6cff1dbb6186b99,4,72,8,64,0,0,0,1,3,0,1,2,1.21807329,1152,369,369,135,129,6,8665,8385,280,50,49,1,100
5986a60ff7bdf7ab2fc78791c043ae088d768cf5,3,40,5,35,0,0,0,1,7,0,1,3,1.046214256,1144,370,370,121,120,1,8109,7939,170,63,62,1,100
d7b487d8661bee041af83c4fe001f71bed0e1d18,4,171,16,155,1,0,1,1,6,0,1,3,1.961757545,1060,371,371,170,149,21,8626,7879,747,72,61,11,99.43729904
d3408dbf0c0362274ffdb27b90df98abc95cb91f,0,0,0,0,0,0,0,0,0,0,0,0,0,0,372,372,0,0,0,0,0,0,0,0,0,100
89f2770cf7656d8b8f72cdae960edae3b1c25c5f,13,0,0,0,0,0,0,1,1,0,1,4,0,949,373,373,87,156,69,7080,6175,905,41,78,37,97.54625905
48bca31a072e903e30a842f5e8b0ac98405e1e2a,31,1090,474,616,5,0,5,1,8,0,2,13,4.011129278,3695,374,374,365,309,56,31770,28949,2821,218,185,33,98.44497608
f1d714eda950a32da3645c98247c72f42a553aff,1,1,1,0,0,0,0,1,2,0,1,1,0,178,375,375,37,37,0,994,993,1,10,10,0,100
9cfcc21f9517aced5cbf8b91abb48ba934d54bc4,3,375,7,368,2,0,2,1,5,0,1,3,1.212424343,176,376,376,48,28,20,2535,1244,1291,23,10,13,99.76340694
f6e4045a55bc80f3dc6d2f428f3e6543efd5e03b,1,2,1,1,0,0,0,1,2,0,1,1,0,378,377,377,67,67,0,2381,2380,1,17,17,0,100
5109d266fa3674ae0d15f7895fbb618b2a503534,1,12,7,5,0,0,0,1,2,0,1,1,0,114,378,378,21,21,0,941,919,22,16,16,0,100
9387f1d015fc3730ce5729af802ee39fa3cd4be8,1,1,1,0,0,0,0,1,3,0,1,1,0,119,379,379,21,21,0,941,941,0,16,16,0,100
24ad7e8f858ac4f367f53767c8084b55f881f43b,0,0,0,0,0,0,0,0,0,0,0,0,0,0,380,380,0,0,0,0,0,0,0,0,0,100
843307a91f01b5211fd14394aa07e93024f029b1,0,0,0,0,0,0,0,0,0,0,0,0,0,0,381,381,0,0,0,0,0,0,0,0,0,100
67d68d756dc61c9f52dbee7c61952f30119596fa,0,0,0,0,0,0,0,0,0,0,0,0,0,0,382,382,0,0,0,0,0,0,0,0,0,100
0d877129d365a24e9b417a20934836e1ab770093,0,0,0,0,0,0,0,0,0,0,0,0,0,0,383,383,0,0,0,0,0,0,0,0,0,100
71f516d9751dc8d9169c5d3ccbaa28fef752ce07,0,0,0,0,0,0,0,0,0,0,0,0,0,0,384,384,0,0,0,0,0,0,0,0,0,100
6a0b722adadc9b535c58959ed0a9f5c412d3dfd2,4,34,3,31,0,0,0,2,2,20,1,4,1.6255788,371,0,0,69,67,2,3240,3075,165,30,28,2,100
f043631ee3070a8d958024b9657943b1f89b4bd3,1,4,2,2,0,0,0,2,5,22,1,1,0,638,1,1,135,135,0,4316,4316,0,90,90,0,100
db03246df073b2413d334e591b4c060fa1998b3f,1,5,0,5,0,0,0,2,3,22,1,1,0,769,2,2,141,141,0,5564,5530,34,27,27,0,100
5a873225d654b4964889e0855f863b58983b2fe3,2,3,2,1,0,0,0,2,2,22,1,2,0.970950594,178,3,3,14,14,0,1633,1611,22,8,8,0,100
0069050706acb4abbc3045a581404d440c121c22,0,0,0,0,0,0,0,0,0,0,0,0,0,0,0,0,0,0,0,0,0,0,0,0,0,100
f449b534b646296e666eb931d121dc6297d0cb77,11,271,0,271,11,0,11,1,1,0,1,5,3.340665791,0,1,1,27,0,27,1117,0,1117,26,0,26,98.98832685
84dd22203bc0b183387accc2362cbc01b4a0fff9,26,1086,17,1069,17,0,17,1,2,0,1,10,3.921857453,144,2,2,118,21,97,5463,896,4567,87,20,67,98.85189437
88fcc345807a1d9aa79fcfd9ddf7e98f112c3035,6,291,0,291,6,0,6,1,1,0,1,2,2.208586058,0,3,3,30,0,30,1293,0,1293,27,0,27,99.46969697
29527d3a6ff827f400f7a12d5568422d622e6a3a,1,22,0,22,0,0,0,1,2,0,1,1,0,127,4,4,25,21,4,742,636,106,15,15,0,100
cd6ca9064adfca5cec38fb24056388150f8f90b9,2,106,0,106,2,0,2,1,1,0,1,2,0.993570476,0,5,5,16,0,16,444,0,444,15,0,15,99.81195938
6a8329351069d180a6fda5c4fb3bd328b850076f,1,77,12,65,0,0,0,1,3,0,1,1,0,147,6,6,33,25,8,1012,742,270,17,15,2,100
5df4c816923866315fd208f08531fbdfa52612df,1,222,0,222,1,0,1,1,1,0,1,1,0,0,7,7,3,0,3,1114,0,1114,3,0,3,99.73753281
6b7ade14750fb58394900384f86a39e8428dce8f,2,350,9,341,0,0,0,1,4,0,1,2,0.536682605,358,8,8,45,36,9,3811,2126,1685,23,20,3,100
4c29fefccc6837e564a1632f378cc9222e8f54eb,1,14,16,2,0,0,0,1,2,0,1,1,0,43,9,9,11,11,0,254,253,1,10,10,0,100
13aa634ca1cf65e35a22a1a8216dabb4b3b7b1a8,1,12,21,9,0,0,0,1,2,0,1,1,0,53,10,10,8,5,3,284,228,56,4,2,2,100
5673231de7abca4f87c3c998495923571b2bd5d9,1,4,2,2,0,0,0,1,2,0,1,1,0,8,11,11,0,0,0,63,59,4,0,0,0,100
b0a0357554add1f61fd76a004e4e5ce48be6dab3,1,33,5,28,0,0,0,1,5,0,1,1,0,227,12,12,40,37,3,1202,1112,90,17,17,0,100
2c5b2e3b474cceba14130df97112770f6688fbde,1,215,0,215,0,0,0,1,3,0,1,1,0,371,13,13,10,8,2,3731,2699,1032,8,6,2,100
f267f194b0a3552dd30e8c31fe25a21c65eb3223,1,4,2,2,0,0,0,1,2,0,1,1,0,84,14,14,14,14,0,462,462,0,12,12,0,100
1e73cc7576965d6583b2bc05a77f1c4e76ea935e,7,6,44,38,0,0,0,1,6,0,2,5,2.164024129,586,15,15,80,89,9,3067,3217,150,53,59,6,100
ed716e88cb3477157bc35a2e1e9cd93b835a5e93,1,7,0,7,0,0,0,1,7,0,1,1,0,245,16,16,39,39,0,1191,1191,0,16,16,0,100
99db78355b257d3cadffb0aeb10fc207f586cc02,2,3,2,1,0,0,0,1,1,0,1,1,0.970950594,57,17,17,10,8,2,334,238,96,10,8,2,99.70037453
b0d5ae6d1c452774479376a33a060c6b3afce28c,1,1,0,1,0,0,0,1,3,0,1,1,0,66,18,18,6,6,0,489,476,13,6,6,0,100
72c549423ba07f840439170edfbac27b57816640,1,70,0,70,0,0,0,1,8,0,1,1,0,251,19,19,40,39,1,1220,1191,29,17,16,1,100
962d59f1637810c75b0e23cb8518e0a1bfd7f097,1,91,0,91,0,0,0,1,4,0,1,1,0,9,20,20,0,0,0,55,55,0,0,0,0,100
7694c17009a11867af9c56401d6c438540ec123d,1,4,0,4,0,0,0,1,9,0,1,1,0,257,21,21,40,40,0,1234,1220,14,17,17,0,100
b604941853aab8402fbe6f400dad119d1fd440ae,1,2,4,2,0,0,0,1,10,0,1,1,0,261,22,22,40,40,0,1214,1234,20,17,17,0,100
765e9429783f01fe1aa5e91274b4539effe13a92,1,68,10,58,0,0,0,1,4,0,1,1,0,82,23,23,15,13,2,527,451,76,11,11,0,100
57cc79e9b76dc359d2862677c9e2f1e82afa7a3a,1,23,2,21,0,0,0,1,2,0,1,1,0,83,24,24,7,6,1,773,640,133,4,3,1,98.88930026
c6dd94bd22cb9ac83faf352c9cf98c63732f219a,1,79,42,37,0,0,0,1,5,0,1,1,0,96,25,25,19,15,4,587,527,60,11,11,0,100
3e45560581cbc68734e0e8be9140623c5e01faf0,1,0,22,22,0,0,0,1,3,0,1,1,0,99,26,26,6,7,1,629,773,144,3,4,1,100
d6ff497318c65e7037208dc8b8636d1018f2556c,1,107,2,105,0,0,0,1,4,0,1,1,0,517,27,27,11,10,1,4251,3731,520,9,8,1,100
67a64f9d5b1d0c2c9038d0dc206fe707ed8e770b,3,269,7,262,2,0,2,1,1,0,2,3,1.199117981,589,28,28,32,11,21,5555,4251,1304,18,9,9,99.12120103
c99a833b074d213fa803f55f6bad5682faebc271,0,0,0,0,0,0,0,0,0,0,0,0,0,0,29,29,0,0,0,0,0,0,0,0,0,100
fd83cdb60f8bf77328fc80917e7d37ea804a2172,2,215,387,172,1,0,1,1,11,0,1,1,0.940285959,259,30,30,23,40,17,789,1214,425,7,17,10,99.78030026
43bdc64900941ae219e05ca42ad71aab0437c250,1,3,37,34,0,0,0,1,6,0,1,1,0,126,31,31,17,19,2,506,587,81,11,11,0,100
a582c9d4441c16478141544705d5eb5048ff1848,2,2,2,0,0,0,0,1,3,0,1,1,1,20,32,32,0,0,0,127,127,0,0,0,0,99.81698389
386c97f4799f18fc4b54ffdc7b556484acd34a40,2,23,23,0,1,0,1,1,2,0,1,1,1,16,33,33,4,4,0,78,78,0,4,4,0,99.67057101
f084e4b640c4a3d8b42beec46a57796fef786943,2,0,217,217,0,0,0,1,2,0,1,2,0.999249248,144,34,34,0,18,18,0,822,822,0,6,6,99.81664833
088995121f5cd86f43951b12985158677db513ab,2,4,4,0,0,0,0,1,3,0,1,2,1,35,35,35,4,4,0,224,224,0,4,4,0,99.81624403
c7326a23905a37e3decd12bbdd84d3f617deb6a9,5,10,10,0,0,0,0,1,2,0,1,4,2.321928095,93,36,36,9,9,0,637,637,0,7,7,0,99.92668622
59d72f9dcd8bc14e257298f5f1cca25fbb08ffa5,1,0,858,858,0,0,0,1,2,0,1,1,0,590,37,37,0,11,11,0,4273,4273,0,9,9,99.52293578
94674565110a7f4f6d1764d4f59d9940e09d8338,33,69,56,13,0,0,0,1,5,0,2,13,4.841599937,1231,38,38,162,100,62,7636,8027,391,119,84,35,97.64185704
1a589962c70050abccc6bb0948f1beb89c665126,1,10,12,2,0,0,0,1,3,0,1,1,0,124,39,39,11,11,0,794,874,80,4,4,0,100
56c23b6da565683f2ac22563ae26285167f655f6,1,6,8,2,0,0,0,1,5,0,1,1,0,67,40,40,6,6,0,445,485,40,6,6,0,100
bbb74afe2692e683dcf29bae2bbc6ff427b7af17,2,31,0,31,2,0,2,1,1,0,1,1,0.999249248,0,41,41,0,0,0,116,0,116,0,0,0,99.22251018
8cb24591e553041a595f4d5575604924a4f2f200,2,170,0,170,2,0,2,1,1,0,1,2,1,0,42,42,22,0,22,736,0,736,16,0,16,99.85119048
c35547cc258687ae4abb12cd8251207a510c2b8f,2,141,0,141,2,0,2,1,1,0,1,2,0.999673426,0,43,43,8,0,8,800,0,800,8,0,8,99
c617631213f5ae503b8c7d3b8d00b8906d3d7abb,2,22,0,22,2,0,2,1,1,0,1,2,0.976020648,0,44,44,0,0,0,73,0,73,0,0,0,99.8159735
717705ca1e92027d25ad6dcb0ea512e89a367112,3,295,0,295,3,0,3,1,1,0,1,2,1.51057051,0,45,45,27,0,27,1348,0,1348,15,0,15,98.65356623
68973475c0f778c555f92f120ba712660ccf9a4d,1,3,1,2,0,0,0,1,2,0,1,1,0,110,46,46,15,14,1,627,610,17,5,5,0,100
51161660ba98b9c80a3ad1208cf15520c8287390,1,7,7,0,0,0,0,1,2,0,1,1,0,64,47,47,10,10,0,398,398,0,7,7,0,100
71f11f16f41d751c2a40a86f09783ec549d64b88,2,0,127,127,0,0,0,1,3,0,1,1,0.814383247,93,48,48,0,14,14,0,519,519,0,9,9,99.06238731
3bfe9f1540103eaae2423aa8bf9484db026809f2,2,4,4,0,0,0,0,1,2,0,1,2,1,124,49,49,22,22,0,740,736,4,16,16,0,100
3926cf7f84101023522f86d6869f2ded5fcbae13,1,1,1,0,0,0,0,1,2,0,1,1,0,96,50,50,17,17,0,506,504,2,11,11,0,100
49ec9a0406bc0bb7ffa731f4e9bfd00d700cde51,1,19,1,18,0,0,0,1,3,0,1,1,0,112,51,51,16,15,1,723,627,96,5,5,0,100
acd66c19e85cbbfbe509951dd2153219939d8b23,2,14,1,13,0,0,0,1,3,0,1,2,0.566509507,45,52,52,9,6,3,334,290,44,7,6,1,100
1b3e1cef572d63c1f9cd6600603b16021433bb2a,3,153,33,120,0,0,0,1,4,0,1,2,1.136096484,240,53,53,42,29,13,1984,1461,523,22,15,7,99.85575189
cd63ea78fb81d95f4d70ca2504ef94778889584c,0,0,0,0,0,0,0,0,0,0,0,0,0,0,54,54,0,0,0,0,0,0,0,0,0,100
b74b4724888a7406ccefd3a5c1401dbd9ccd0ed7,0,0,0,0,0,0,0,0,0,0,0,0,0,0,55,55,0,0,0,0,0,0,0,0,0,100
cffb903ffd7d98d62fe8f1fa9c2994a14f03c28a,2,61,0,61,1,0,1,1,3,0,1,2,0.984239989,79,56,56,12,7,5,854,544,310,6,4,2,99.13637999
4af10e9a5e2bd99e999d07a4c02067a647448acf,1,0,5,5,0,0,0,1,2,0,1,1,0,19,57,57,2,2,0,98,127,29,1,1,0,100
ca0ab3d2d5d0ae80410c905d27171f4275e35f3a,2,197,0,197,2,0,2,1,1,0,1,1,0.979662884,0,58,58,17,0,17,971,0,971,8,0,8,99.56973826
4f31b9365ae8187aa32bf9781946cd53b23494be,1,3,0,3,0,0,0,1,3,0,1,1,0,96,59,59,17,17,0,522,506,16,11,11,0,100
8bf077f7c014344f52838e89a53248c8abafb103,1,229,0,229,1,0,1,1,1,0,1,1,0,0,60,60,20,0,20,975,0,975,9,0,9,99.92846924
06e5a60206a87d64e3e8d2c0ca5cf51b2bcf2e54,1,108,0,108,1,0,1,1,1,0,1,1,0,0,61,61,5,0,5,498,0,498,5,0,5,99.85719386
9a240eab1ba2d2c67687de34002011f810b545b4,2,112,79,33,0,0,0,1,3,2,1,1,0.415324406,212,62,62,34,28,6,1415,1259,156,16,13,3,100
047157f909d3d8a7eedf0de1b776cdb0663cfc59,1,29,37,8,0,0,0,1,3,0,1,1,0,187,63,63,25,23,2,1054,1081,27,11,11,0,100
137b510e46812eb25b951380dbda98d7e663f16f,2,130,2,128,0,0,0,1,4,1,1,2,0.945660305,257,64,64,40,30,10,2194,1552,642,24,16,8,99.89297182
63ecebb7d6d95b0efb1b25bc09188d74b45a7d40,1,5,6,1,0,0,0,1,5,0,1,1,0,212,65,65,29,29,0,1282,1280,2,13,13,0,100
9f1a72ccafde0beb821cb850011e0870968989ed,1,41,32,9,0,0,0,1,5,2,1,1,0,180,66,66,21,24,3,921,1032,111,11,11,0,99.56989247
2db6abcb918f4c726537d7b47d1743313c619cd2,1,0,110,110,0,0,0,1,6,0,1,1,0,193,67,67,11,21,10,578,921,343,7,11,4,99.08094733
6c523bd372d093d8f68397fc71d14bf0c80e1964,60,497,3836,3339,1,0,1,2,4,0,4,19,5.302961028,3789,4,4,217,516,299,9708,24213,14505,101,306,205,95.5654102
fe87d7372f9068f927f4ec87355e587f898b1c78,3,37,6,31,0,0,0,2,6,29,1,3,1.395667413,1453,5,5,243,240,3,10313,10147,166,132,129,3,100
7027c0c104afa461b6fd919b971ccb7f20af7f2c,2,24,1,23,0,0,0,2,3,38,1,2,0.721928095,336,6,6,73,71,2,2369,2257,112,15,14,1,100
bad6c3756bc830659ff14300a5f2089fff7b3c40,65,3829,560,3269,52,0,52,1,6,0,4,24,5.370235247,3317,68,68,828,533,295,36590,22390,14200,450,248,202,95.5654102
d2ec84e944e15d593f22f2be7b9da21e8531b44f,1,1,0,1,0,0,0,1,4,11,1,1,0,98,69,69,17,17,0,524,522,2,11,11,0,100
40b2b7d6c465f574f7a34f5dcf7b0332fef1c479,1,0,5,5,0,0,0,1,6,8,1,1,0,212,70,70,28,29,1,1256,1282,26,13,13,0,100
57530df1716bb3da26879ba290b2164dba2650cb,1,0,1,1,0,0,0,1,7,0,1,1,0,208,71,71,28,28,0,1256,1256,0,13,13,0,100
1055307e9bccdb3f0ab5fd5ee785c13c0946e7d5,1,0,90,90,0,0,0,1,4,11,1,1,0,66,72,72,0,11,11,0,408,408,0,7,7,99.93045897
69ec7dc940a346e4fda09b2de473fe0e764eeb28,1,4,0,4,0,0,0,1,6,11,1,1,0,65,73,73,7,6,1,457,445,12,7,6,1,100
f0a7f448ed1eaccbdaf39febd49602d47b7be96d,1,8,0,8,0,0,0,1,7,8,1,1,0,103,74,74,11,11,0,578,578,0,7,7,0,100
fda9a97a9acefafb259dd03acefa80598a56f04f,1,12,2,10,0,0,0,1,4,11,1,1,0,52,75,75,9,8,1,351,292,59,9,8,1,99.11598303
ca378959c981dfbf81516f4c35f3a32d9ddc1325,1,49,8,41,0,0,0,1,5,3,1,1,0,99,76,76,21,17,4,729,524,205,11,11,0,100
b7dae8f730d5cc538f31552a22ffca0f41ccaafb,54,61,3234,3173,0,0,0,0,6,0,3,18,5.158980381,4006,7,7,316,593,277,12682,26413,13731,147,335,188,95.94290008
163b39e9c9ea76c4398902e0c4513409527e40ff,2,4,2,2,0,0,0,2,5,44,1,2,0.918295834,342,8,8,31,31,0,2493,2487,6,15,15,0,100
b5b509ec50c79c1c707b7fe6a42bdb7e7848bf6f,1,1,1,0,0,0,0,2,2,45,1,1,0,60,9,9,12,12,0,323,321,2,11,11,0,100
b19b0253b32b43a84f2411ae58a22800e6e2da03,58,3306,66,3240,50,0,50,1,7,0,3,21,5.212797898,2229,77,77,643,359,284,29537,15498,14039,365,173,192,95.87087087
8f21f9a7b254ad92e3aac2dfe88c6bba91c8cc41,1,14,0,14,1,0,1,1,1,0,1,1,0,0,78,78,1,0,1,49,0,49,1,0,1,99.85668219
240166f000f4a508681da3142e903e84cb242181,1,0,0,0,0,0,0,1,1,0,1,1,0,87,79,79,12,12,0,577,577,0,6,6,0,99.74955277
fca0ba10dd1959f6ee626dd43a9d6c8761d9866b,1,1,1,0,0,0,0,1,4,17,1,1,0,15,80,80,1,1,0,100,100,0,1,1,0,100
4ad6e6780070e800926504ba2181b987ae4264c5,1,89,1,88,0,0,0,1,2,0,1,1,0,50,81,81,16,7,9,884,316,568,7,4,3,100
23ef6266aabd58b36bf6a2a6df8f1fcb8fcd65de,0,0,0,0,0,0,0,0,0,0,0,0,0,0,82,82,0,0,0,0,0,0,0,0,0,100
08ba7ebd503efe377fd4701f0f4bdc8e344f18ff,1,46,0,46,1,0,1,1,1,0,1,1,0,0,83,83,8,0,8,140,0,140,8,0,8,99.92852037
7db502fa60dfd664d3aef383e30697152b2c52f5,0,0,0,0,0,0,0,0,0,0,0,0,0,0,84,84,0,0,0,0,0,0,0,0,0,100
10a7b553b58876feccb57f877c2996fedfcca9d6,0,0,0,0,0,0,0,0,0,0,0,0,0,0,85,85,0,0,0,0,0,0,0,0,0,100
dc1d679889619a16ae434e8e0ea805df019fa94e,1,4,0,4,0,0,0,1,3,5,1,1,0,144,86,86,25,24,1,777,760,17,9,8,1,100
51100ab6e95429a22cd924cd17bc295c19f52526,1,8,11,3,0,0,0,1,6,2,1,1,0,132,87,87,20,21,1,716,729,13,11,11,0,100
ffe81138c2915b9c8431ec0211dce34d0b49e15f,1,1,1,0,0,0,0,1,7,0,1,1,0,129,88,88,20,20,0,716,716,0,11,11,0,100
8fe63499955d7ddf5ae221c91dcf7a8309c56529,1,1,1,0,0,0,0,1,2,0,1,1,0,9,89,89,1,1,0,54,49,5,1,1,0,100
3dcba65cbe27af069ded07a53b3d5cd81a3b6711,17,39,37,2,0,0,0,1,5,14,2,7,3.776449962,542,90,90,67,67,0,3441,3416,25,39,39,0,100
5a166d9bde67aade758f8f852e4491f542d28680,1,0,3,3,0,0,0,1,8,0,1,1,0,129,91,91,20,20,0,700,716,16,11,11,0,100
abfe882b344d819f6dde60f0bac88ed87f0997a5,2,4,2,2,0,0,0,1,3,0,1,2,0.918295834,68,92,92,6,6,0,458,451,7,3,3,0,100
745f586e2f7cd0357d00a1f00e11e61a339721ef,1,11,0,11,1,0,1,1,1,0,1,1,0,0,93,93,1,0,1,55,0,55,1,0,1,99.64362081
fd4bf8337958b3efd09864a54f19d6ba08c46d7a,1,54,0,54,1,0,1,1,1,0,1,1,0,0,94,94,9,0,9,178,0,178,8,0,8,99.92892679
a9e3f2580f66205106c4f2c7a2e1de1eb7692200,2,260,0,260,2,0,2,1,1,0,1,2,0.861663629,0,95,95,25,0,25,1143,0,1143,14,0,14,99.39673527
9d616e3074a8701c61f11be736979ee6a674bd59,1,5,4,1,0,0,0,1,3,5,1,1,0,120,96,96,16,16,0,912,884,28,7,7,0,100
5c3f7acfe1d587149787893a818f9f9370ff0ead,66,326,3787,3461,1,0,1,0,6,0,3,24,5.405840747,5434,10,10,492,810,318,20925,35786,14861,227,442,215,95.1901566
e117229086f623d4efa0b7379783ea2cbc3ba0e5,2,668,243,425,1,0,1,1,5,0,1,2,0.9680551,640,11,11,162,119,43,5730,4146,1584,62,41,21,99.9214454
cb7665caf5f4a051c77d26eb77c3c8e53bf776fa,67,3993,956,3037,56,0,56,1,8,0,3,25,5.26730416,3283,97,97,810,535,275,35792,22509,13283,442,248,194,95.11922504
a891caaa9489232dc9b67f3effaabcce501a2380,2,14,2,12,1,0,1,1,2,4,1,1,0.988699408,7,98,98,2,1,1,111,55,56,1,1,0,99.85830677
cf6623a14c15316f0df6a442b8321538fba033cd,1,17,2,15,0,0,0,1,2,9,1,1,0,53,99,99,7,6,1,442,358,84,4,4,0,100
d7f00553ee262d97d1588beb3817dd45a7a83fd4,2,205,0,205,2,0,2,1,1,0,1,1,0.951232261,0,100,100,24,0,24,819,0,819,21,0,21,99.85865724
1ecb08248dc65981c28e5933b021862a8a36d283,3,189,0,189,3,0,3,1,1,0,1,1,1.547436201,0,101,101,16,0,16,908,0,908,10,0,10,99.12982945
ae11f2d8e79005f0331269eee29bd5d81bd2703d,4,50,49,1,1,0,1,1,2,0,1,2,1.14189717,197,102,102,29,29,0,1117,1128,11,24,24,0,99.48150709
33f5f177c751503ddc53e5067a4fdc2e896e104f,9,54,9,45,3,0,3,1,1,0,1,3,2.948292729,295,103,103,40,30,10,1942,1776,166,31,18,13,98.5177525
57e1da9d13dfc273c0ca2e844747c2c4fdfeaaf8,86,1067,4518,3451,2,0,2,0,6,0,3,31,5.606825489,7679,12,8,796,1113,317,36200,51184,14984,381,604,223,92.22868881
a590c31189bc55fd6696fab54fb493bb897c40df,6,143,24,119,1,0,1,2,9,55,1,4,2.040662138,1671,13,9,210,204,6,13185,12728,457,94,92,2,99.86287281
03aaccfea821e685ff1a23a8330c2f47449d656e,10,497,563,66,1,0,1,2,7,18,2,6,2.580130022,1539,14,10,216,228,12,9719,10054,335,101,110,9,99.65706447
c9db94fc17c9b440469498867c15a6796c239d0f,101,5113,1712,3401,68,0,68,1,8,0,4,38,5.819891472,7876,104,104,1453,1130,323,70242,55365,14877,768,538,230,91.81506849
19aafa645ace7b708aac99278b3af78b92d49bef,1,4,3,1,0,0,0,1,3,8,1,1,0,147,105,105,19,19,0,804,791,13,10,10,0,100
ebb623cfd1f90bcee3d7b6b79bebde44fce319b6,2,38,0,38,2,0,2,1,1,0,1,1,0.789749254,0,106,106,2,0,2,93,0,93,1,0,1,99.82952608
23d20c3df4fe6e7f7f7ede3c8814ee5d56b380ef,1,1,0,1,0,0,0,1,2,8,1,1,0,98,107,107,12,12,0,538,531,7,9,9,0,100
27f6cd7730c1a52666cb79b125fb820f037c9dfc,1,61,7,54,0,0,0,1,2,8,1,1,0,42,108,108,13,8,5,453,230,223,10,8,2,100
049646dc5aca1b4386b6489a978f4e7b4b9e2adb,1,60,3,57,0,0,0,1,3,22,1,1,0,87,109,109,20,12,8,859,579,280,9,6,3,99.89792446
bd07818f9357dc4772333a2b12872c14f8a360f6,1,77,1,76,0,0,0,1,4,22,1,1,0,59,110,110,9,5,4,775,397,378,3,2,1,100
c81c25494bd3219c92de1d15a1136717eb1c5c7a,0,0,0,0,0,0,0,0,0,0,0,0,0,0,111,111,0,0,0,0,0,0,0,0,0,100
70a675c1da9cc3511648413aaf9f4a2c5f518e72,3,8,14,6,0,0,0,1,3,2,1,2,0.865856617,225,112,112,28,30,2,1268,1302,34,22,22,0,100
f760dfd9cdaf7621ebcacc83a6b0d6a88d31e7e3,2,27,5,22,0,0,0,1,4,4,1,2,0.954434003,212,113,112,28,26,2,1382,1246,136,15,14,1,99.27810244
51952df1c8888aad333d4c5b3b46b2e817b6010c,4,1,74,73,0,0,0,1,2,40,1,2,1.746662341,99,114,113,9,18,9,278,554,276,8,17,9,99.82596589
940dd59e0492402e26089a55f76112901904d663,1,6,5,1,0,0,0,1,5,0,1,1,0,160,115,53,21,21,0,912,898,14,11,11,0,100
5f6ebafb5aea78ca8390546b219adfe0c7aed368,1,3,3,0,0,0,0,1,4,0,1,1,0,68,116,54,7,7,0,492,484,8,4,4,0,100
4c800d1dd946debd64077656380953ee977dfb89,1,40,5,35,0,0,0,1,4,18,1,1,0,123,117,55,18,16,2,1136,912,224,7,7,0,100
c87ba4e0f0bb11ac82ff5f2be1a34ecb10db4e5d,1,2,2,0,0,0,0,1,4,0,1,1,0,134,118,56,20,20,0,864,859,5,9,9,0,100
15610186d8b80bad7dd9af00022cbec6c2b3dcf9,0,0,0,0,0,0,0,0,0,0,0,0,0,0,119,57,0,0,0,0,0,0,0,0,0,100
4104d0b6b6d5d9b8dea37969bf5cd3670f807ab4,0,0,0,0,0,0,0,0,0,0,0,0,0,0,120,58,0,0,0,0,0,0,0,0,0,100
b61abeb712952578bcb1f54237696fe0aa84a742,1,2,5,3,0,0,0,1,5,1,1,1,0,110,121,59,9,9,0,763,775,12,3,3,0,100
fb89179dd4c234c26a191f10745101d21296b13f,1,1,0,1,0,0,0,1,3,44,1,1,0,62,122,59,11,11,0,370,370,0,8,8,0,100
80bfe9ba2071153764a5c478f71730d47a28d731,0,0,0,0,0,0,0,0,0,0,0,0,0,0,123,60,0,0,0,0,0,0,0,0,0,100
cabb75146b8539ef198edb43867a49ffe7d7ec82,3,89,10,79,0,0,0,1,5,17,1,2,1.296234401,160,124,56,42,23,19,1420,1031,389,18,11,7,99.61672474
54182fe69706c936d41b79f607069d7ab2b0ec05,1,5,0,5,0,0,0,1,5,34,1,1,0,28,125,57,3,3,0,221,192,29,2,2,0,100
2785c6b30ef4d486d314aaeeed1533413304dd06,2,25,0,25,2,0,2,1,1,0,1,1,0.989587521,0,126,50,0,0,0,76,0,76,0,0,0,99.21205892
e362b1ff1303d1dc4c478b3c7a9008934fe34e0c,103,1707,5421,3714,4,0,4,2,9,0,4,39,5.847445056,10541,15,3,1130,1484,354,55365,71795,16430,538,774,236,91.69785641
d97717b2f6a92f33f58d7d2107b1c5b1d379a780,105,5539,1712,3827,72,0,72,1,8,0,4,41,5.881743949,7876,127,23,1496,1130,366,72231,55365,16866,785,538,247,91.61879013
7ffb54112c080a6d19d9a23a1444efb9c4338898,1,22,21,1,0,0,0,1,3,71,1,1,0,133,128,24,11,11,0,839,914,75,11,11,0,99.96679947
c937a7254e417d554da01965d229adfcfa671b79,0,0,0,0,0,0,0,0,0,0,0,0,0,0,129,25,0,0,0,0,0,0,0,0,0,100
27002139c456869744f28e1b14aa5ba1ccf55fe8,0,0,0,0,0,0,0,0,0,0,0,0,0,0,130,26,0,0,0,0,0,0,0,0,0,100
f608204077c8ab01addd948b07079dec5a2392a0,45,998,1268,270,10,0,10,1,9,18,2,14,4.77584928,2315,131,27,248,281,33,13330,14473,1143,146,160,14,97.67520216
02dcc961d51617fa2a73c70759163f7a19f707cf,0,0,0,0,0,0,0,0,0,0,0,0,0,0,132,28,0,0,0,0,0,0,0,0,0,100
6b9f1fd533ad4674b4383db8e82251bd86366fa5,0,0,0,0,0,0,0,0,0,0,0,0,0,0,133,29,0,0,0,0,0,0,0,0,0,100
7168d12463e3a66334c3e3c3154cbbda795daf6d,104,1707,5265,3558,4,0,4,2,9,0,4,38,5.827920607,10440,16,4,1130,1463,333,55365,71013,15648,538,771,233,91.4922813
eabdf294ddce606c4acd129993a4178c8a2c888a,104,5217,1712,3505,71,0,71,1,10,0,4,38,5.823888759,7876,134,30,1463,1130,333,70556,55365,15191,771,538,233,91.37038315
0b590246af6319d2142fb70b845965c530fd52be,17,43,54,11,0,0,0,1,10,21,2,7,3.712760803,804,135,31,96,96,0,5200,5239,39,56,56,0,99.72241499
bf7ac13ea9065ed6679e688ea02e4acd5786f9d5,4,5,5,0,0,0,0,1,8,0,1,1,1.921928095,256,136,32,32,32,0,1448,1448,0,19,19,0,99.86120749
4e29cb51a141b82e92a6383ebe2c252cf9a80cb5,2,4,2,2,0,0,0,1,8,0,2,2,0.918295834,197,137,33,25,25,0,1449,1427,22,13,13,0,99.86120749
d2eb3b127d82746b2d6dde504f814f5c8c80e606,7,47,38,9,0,0,0,1,9,0,2,5,2.120005975,474,138,34,61,59,2,3066,3028,38,38,36,2,99.40910671
852b524a7dfb7f38d5f9f5a8d02913f4ec7bbc2f,1,28,1,27,0,0,0,1,7,0,1,1,0,25,139,35,5,2,3,261,161,100,4,1,3,99.19241573
bcee895beef3cd9d289d4e5744a3108c3afcf52f,1,5,0,5,0,0,0,1,4,0,1,1,0,82,140,36,13,13,0,436,424,12,7,7,0,99.85840708
e4e430eb5a38db58267afa270b038d7aae6c88c2,8,341,39,302,2,0,2,2,9,6,2,4,2.929831654,305,0,0,47,39,8,1963,1698,265,31,25,6,99.61103253
3f696afcc929c108c669117e56fb5162184d27de,107,1712,5557,3845,4,0,4,2,9,1,6,40,5.928399323,10638,17,2,1159,1504,345,56121,71724,15603,552,796,244,91.77986764
e776fb8230f6d9c0aff1300723b07d406f8d2a8e,107,5562,1717,3845,73,0,73,1,10,0,6,40,5.923175266,8039,141,14,1504,1159,345,71724,56121,15603,796,552,244,91.77986764
078299cf23912a5ffe3bbd0c08a0514991694f3e,0,0,0,0,0,0,0,0,0,0,0,0,0,0,142,15,0,0,0,0,0,0,0,0,0,100
166d3f990726a7a4cf17cddcc3158303161f153c,2,100,0,100,2,0,2,1,1,0,1,2,0.609840305,0,143,16,11,0,11,428,0,428,8,0,8,99.57537155
d76628101d2ea4671f70bd844632e90e28756e98,0,0,0,0,0,0,0,0,0,0,0,0,0,0,144,17,0,0,0,0,0,0,0,0,0,100
10cd470410a340163e862c686344e1049d4c3fd9,0,0,0,0,0,0,0,0,0,0,0,0,0,0,145,18,0,0,0,0,0,0,0,0,0,100
cdc29c3a84381039b84411d349b535a6438a27db,3,368,0,368,3,0,3,1,1,0,1,2,1.211884222,0,146,19,41,0,41,1839,0,1839,28,0,28,98.2492276
6b6b9e36954b96ea346ad2a584ad46ebfdfa11a3,5,26,34,8,0,0,0,1,5,35,1,3,2.304104143,229,147,13,32,34,2,1213,1223,10,20,22,2,99.70149254
e8ff87a7468d3af88de68ce8e249041b37ce69ef,2,52,29,23,0,0,0,1,2,0,1,1,0.930149732,225,148,14,41,39,2,1625,1465,160,26,26,0,100
034d0d69c0fa4ff853c277f54be79c088a3e9683,2,2,4,2,0,0,0,1,3,0,1,2,0.918295834,256,149,15,35,35,0,1735,1744,9,20,20,0,100
afc6f1ba8c341e0da4ccd33a878cb681911e7cc9,3,17,0,17,0,0,0,1,6,0,1,2,1.579863401,173,150,16,26,23,3,981,919,62,17,14,3,100
df8aa00e67249457e35b529e9027adc4e265fc76,2,9,3,6,1,0,1,1,4,0,1,2,0.979868757,208,151,17,33,33,0,1395,1368,27,18,18,0,98.99125757
7e50bc61180297e456f73390d4ac89a2fa6ad676,1,0,5,5,0,0,0,1,2,116,1,1,0,3,152,18,0,0,0,0,14,14,0,0,0,99.86296677
062ae44bbb0f3499a92ad6a1f86ef54a71d21907,2,41,2,39,0,0,0,1,10,38,1,1,0.952265625,203,153,19,28,25,3,1711,1487,224,18,16,2,98.73544093
0f4dfad3e63032957e0de835764909ba93a7caa6,1,1,1,0,0,0,0,2,9,36,1,1,0,48,154,20,5,5,0,289,298,9,4,4,0,100
f52b8a905e3fa3130c75a848085d07bcfc4e883b,0,0,0,0,0,0,0,0,0,0,0,0,0,0,155,21,0,0,0,0,0,0,0,0,0,100
98191b3b1c430e642b9b3c5c52f1cfb1ab5d48b1,6,70,181,111,0,0,0,1,11,41,1,3,2.12550876,568,156,22,64,78,14,3080,3719,639,42,48,6,98.18601583
f5127cd6d14fa15739ac209fe61c85841b16a0d2,111,1712,5984,4272,4,0,4,2,9,1,6,42,5.99850334,10960,18,1,1159,1548,389,56121,73783,17662,552,829,277,91.43148589
9b1a6a144995bece5522eb9ac9af22bb7c818db9,111,5992,1717,4275,77,0,77,1,11,1,6,42,5.993753749,8039,157,16,1548,1159,389,73800,56121,17679,829,552,277,91.43148589
0e103c98079e510fea081ef49a9be2207c03a222,8,40,291,251,0,0,0,1,12,48,2,5,2.313067421,605,158,17,47,71,24,2721,3763,1042,29,49,20,99.00752909
d4cbc1b1cf87dbacdb9c96c37da1232759af4432,2,4,5,1,0,0,0,1,9,42,2,2,0.99107606,263,159,18,28,28,0,1692,1697,5,8,8,0,100
2f7b4893fa2a23530941313103972aaa9c7ccaa3,0,0,0,0,0,0,0,0,0,0,0,0,0,0,160,19,0,0,0,0,0,0,0,0,0,100
e7a256265e6e8547c6e566388a88c5f80f516761,2,60,1,59,0,0,0,1,6,2,1,2,0.912734156,264,161,20,38,37,1,2130,1784,346,22,22,0,100
05b833f05a8e76cbe978d31718f91f0822040812,6,36,3,33,0,0,0,1,9,34,2,4,1.661923099,310,162,21,35,34,1,2254,2061,193,22,22,0,100
9acfe8d2bc7fc67396ffe5bdffdc75c09d65e127,1,4,0,4,0,0,0,1,7,0,1,1,0,231,163,22,36,36,0,1528,1510,18,20,20,0,100
56a6c8a92908d18498a61eccf9fc7cff188f1fab,10,110,44,66,0,0,0,1,10,26,2,4,3.012216304,520,164,23,66,58,8,3230,2917,313,33,33,0,99.10375733
c3b69e880cab8b1cb598545ed9953a782439adc2,109,1712,5897,4185,4,0,4,2,9,1,6,42,5.962872275,10908,19,2,1159,1534,375,56121,73623,17502,552,809,257,91.54109589
424a4d89bf067d1af6875ee6649424eee18a994a,109,5931,1717,4214,75,0,75,1,12,3,6,42,5.962860819,8039,165,24,1536,1159,377,73746,56121,17625,811,552,259,91.58145876
68296ecd1f18970044420137e185bdf00fba0e9b,2,350,0,350,2,0,2,1,1,0,1,2,0.937837432,0,166,25,36,0,36,1576,0,1576,19,0,19,99.83113813
04b0bc8a8249a35603ad96f1ed326562649ba037,1,33,0,33,0,0,0,1,2,0,1,1,0,163,167,26,26,26,0,939,939,0,14,14,0,100
26dd4aacaceabe9175a59ef9fb67f153acf63e32,1,11,0,11,0,0,0,1,2,135,1,1,0,41,168,27,13,11,2,318,252,66,11,10,1,100
a8d951f9899678c6b46fdb601571c5e75fe96cc6,1,132,32,100,0,0,0,1,3,7,1,1,0,170,169,28,41,26,15,1207,939,268,19,14,5,100
795ea3812f6635befcae7098c72f92574f01d00b,2,78,3,75,0,0,0,1,4,3,1,2,0.635489638,318,170,29,54,51,3,2188,1844,344,25,24,1,100
8a20286a2ae9d9f797a86f58511ec86f95473f7f,1,1,1,0,0,0,0,1,3,0,1,1,0,143,171,30,13,13,0,937,937,0,6,6,0,100
a4d60ca46e9e76adc7375f690dc6eb1c16fd38e4,14,1293,171,1122,8,0,8,1,8,12,3,7,2.672677737,562,1,0,196,93,103,7091,3321,3770,85,51,34,98.92364615
6c04ea3080df685459b949149bebd1673d8a8e48,123,1954,7626,5672,5,0,5,2,9,4,6,48,6.09877407,12422,20,2,1242,1752,510,60577,83331,22754,599,905,306,90.81044422
ea1626aa3b28d0e2519e7b8b78e0bf8acbc73953,2,51,2,49,0,0,0,2,6,176,1,2,0.386018901,644,21,3,76,73,3,4749,4504,245,36,35,1,100
00229e537c3a018e59a9d60c7a45ed624ac5978c,5,80,12,68,0,0,0,2,7,104,1,4,1.952902885,1245,22,4,204,198,6,9212,8889,323,128,125,3,100
49296715e19050191e9075d6540cc1876df55abb,126,7644,2089,5555,85,0,85,1,12,1,6,51,6.138773595,9561,172,7,1839,1338,501,88806,66620,22186,951,649,302,90.81044422
d2ea62e9dc353b366c0a422c3a79be47dee75e80,12,1408,0,1408,12,0,12,1,1,0,1,4,3.173373634,0,173,8,170,0,170,5693,0,5693,55,0,55,98.8173456
f6167ec7a99a7a439807b0b67b0f14473e118dfe,2,10,3,7,0,0,0,1,12,22,2,2,0.619382195,387,174,9,57,57,0,2619,2594,25,15,15,0,100
d6b2d4f82b1df505aabf05ca7c08dc3e4a10e0bd,138,2084,9054,6970,5,0,5,2,9,6,6,53,6.314024844,14105,23,4,1338,2009,671,66620,94524,27904,649,1006,357,90.07633588
3331e7832bf78068645c29ba82feb1110bd46aa7,138,9063,2089,6974,97,0,97,1,12,0,6,53,6.311187742,9561,175,10,2010,1338,672,94547,66620,27927,1007,649,358,90.07633588
98157734a53503162599358caf4b472ccc4bd0de,1,23,2,21,0,0,0,1,7,44,1,1,0,82,176,11,11,11,0,495,453,42,6,6,0,100
a777c598685811a6d16915cdab0c838353ad061f,2,137,0,137,1,0,1,1,13,1,2,2,0.109929122,134,177,12,19,10,9,1489,845,644,11,7,4,99.5210728
6349d1f1efdb8406d7cc7e51c3430d15c48e9569,1,3,0,3,0,0,0,1,4,45,1,1,0,77,178,13,2,2,0,627,620,7,2,2,0,100
277c6c99596b98cfd26ac9f34aa252295f3931bf,2,251,0,251,2,0,2,1,1,0,1,2,0.992832009,0,179,14,17,0,17,1376,0,1376,8,0,8,98.80142533
03ebe992bf26afd4f397034f949971c0c21b5c9b,2,115,0,115,1,0,1,1,14,1,2,2,0.126531592,136,180,15,18,10,8,1567,867,700,10,7,3,99.93377483
71b53d644b26c2a7a34dc73b25f733f3508390de,0,0,0,0,0,0,0,0,0,0,0,0,0,0,181,16,0,0,0,0,0,0,0,0,0,100
6c99a70cd3f41189ab630beddc9c2527ccb84555,1,15,0,15,0,0,0,1,2,1,1,1,0,85,182,14,11,8,3,741,678,63,3,3,0,100
38bab7df4cb3259605a6c375ae2b7bfef80a1b2f,0,0,0,0,0,0,0,0,0,0,0,0,0,0,183,15,0,0,0,0,0,0,0,0,0,100
72e3ee024e86c01c339ab0f3fdfa5960a0a7e01e,1,12,1,11,0,0,0,1,2,2,1,1,0,86,184,16,9,8,1,668,619,49,6,5,1,99.33355548
78bf38cfe8e3b439715a243f13a1cb995285a68b,2,67,9,58,0,0,0,1,3,0,1,2,1,190,185,17,27,20,7,1725,1409,316,10,9,1,100
e64c6deced911bf4317a3fc6b3fd5e5da52c9eec,1,9,1,8,0,0,0,2,5,33,1,1,0,74,186,14,16,15,1,427,376,51,11,11,0,100
4d97460bee599695ce4e489c0e346ac6513f0e0f,3,303,0,303,2,0,2,1,15,4,2,3,1.038636451,138,187,15,35,10,25,2545,889,1656,18,7,11,98.49246231
a1248eed03d6f271f6b244abbe20782e4983274b,1,47,0,47,0,0,0,2,6,1,1,1,0,81,188,16,16,16,0,427,427,0,11,11,0,100
f7b3f6b624c231016d141fdf051ea54308458da5,18,1455,22,1433,13,0,13,1,3,10,2,4,3.469541066,501,2,1,229,94,135,8734,3278,5456,76,28,48,98.90909091
681d72c461ee94f3220c95e676fc977396d1f1cf,1,1,0,1,0,0,0,2,3,104,1,1,0,7,3,2,0,0,0,49,36,13,0,0,0,100
aec2fbd8621539059336b54588e5b080b8057b17,2,451,0,451,2,0,2,1,1,0,1,2,0.854603489,0,4,3,43,0,43,1762,0,1762,27,0,27,98.87784546
b9dd2cff450824d404f061b0348c5786a668d093,3,137,2,135,1,0,1,2,2,14,1,2,1.210811953,122,5,4,20,9,11,1361,717,644,13,6,7,99.90583804
a5a60fd7ea3c8708bdf286475eda313047085972,11,0,0,0,0,0,0,1,1,0,1,2,0,825,6,5,125,99,26,5342,11110,5768,57,55,2,98.77319912
a175402e2e1e543c9f8c38fe7a478e608f5ec70e,0,0,0,0,0,0,0,0,0,0,0,0,0,0,7,6,0,0,0,0,0,0,0,0,0,100
97c5f4b41c3f68f08c802530c46f3b8d3ccdbfe4,9,348,43,305,3,0,3,1,2,0,2,3,1.512254557,804,8,7,156,129,27,6818,4850,1968,64,57,7,99.40307886
664b0c2780a650fed8c1725b2982c75ddf9f66f7,9,605,54,551,2,0,2,1,3,0,1,3,2.618710069,731,9,8,144,105,39,6947,4266,2681,43,24,19,99.84409105
e58f89916f1880d92d05e18caacb9dc7e81d68bd,10,548,132,416,2,0,2,1,3,0,1,2,2.605921011,1016,10,8,193,144,49,8432,6618,1814,59,43,16,99.65817278
fd853150450cf9d7f645815984656a07923abc36,7,596,43,553,0,0,0,1,4,7,1,2,1.716438048,1108,11,9,245,160,85,9975,7286,2689,70,45,25,99.78334881
8ad534b896d5e933eba491897df4c5417043971e,3,111,2,109,0,0,0,2,11,58,1,1,1.404981258,223,189,17,27,26,1,1457,1420,37,10,10,0,100
9fc7fc6c7c982022fd34a9d982121617e1600e1b,11,484,429,55,1,0,1,1,10,35,3,5,1.891959327,1144,12,10,129,123,6,8234,7907,327,66,66,0,98.9260897
e47e8f72f316b9a41871dec43cb4bb81926cf104,526,0,87206,87206,0,0,0,2,9,0,4,99,8.61182059,53906,190,15,0,6903,6903,0,392331,392331,0,3737,3737,35.0656168
635fdaf6379c1e1aba10f35f7c55d480c42c135d,0,0,0,0,0,0,0,0,0,0,0,0,0,0,191,16,0,0,0,0,0,0,0,0,0,100
5314aea8806f3693d36c17e1d8a02cf897820d40,0,0,0,0,0,0,0,0,0,0,0,0,0,0,192,17,0,0,0,0,0,0,0,0,0,100
51b06ddcd7df68a37b0d28ee6fd9a1ebf0006b37,0,0,0,0,0,0,0,0,0,0,0,0,0,0,193,18,0,0,0,0,0,0,0,0,0,100
3d4245961352539da5608a78ca0fb5273fd134a4,0,0,0,0,0,0,0,0,0,0,0,0,0,0,194,19,0,0,0,0,0,0,0,0,0,100
872ef2dc0e2ac9ef5f5ce210592c70fdaeabe687,1,25,33,8,0,0,0,1,16,25,1,1,0,140,195,17,13,10,3,1006,911,95,7,7,0,100
0dcd83be2140150e42e14e14686be47f17ebcfae,10,375,194,181,0,0,0,2,17,57,2,6,1.585447911,1266,196,17,209,191,18,9231,8325,906,87,77,10,98.7534626
775268f9b1aa54ee0613a702b4729e6c5cf78b58,7,230,37,193,0,0,0,1,5,10,1,2,2.146840367,1328,13,11,211,201,10,9395,8662,733,68,66,2,99.17695473
5e88a023abfc4edc5e3738f74ee51405fad66ac6,1,54,51,3,0,0,0,2,8,6,1,1,0,224,197,18,40,40,0,1276,1259,17,24,24,0,100
3da73ebd982fbb9ca5f09192c253f1b6a017038a,7,76,68,8,0,0,0,2,11,18,3,5,1.627690798,914,198,19,71,71,0,6719,6637,82,29,29,0,94.97126437
8f9e4ad5481d5c42c8aac5e30b930ed6507854b2,1,1,1,0,0,0,0,2,3,2,1,1,0,104,199,19,15,15,0,852,852,0,4,4,0,100
7caffc020a268ed4e9c7d8b9e3d716a28fe00cfb,1,74,50,24,0,0,0,1,4,38,1,1,0,112,200,20,18,14,4,963,855,108,3,3,0,100
eb8152eb14225e222780206993a83a0d94674376,1,0,3,3,0,0,0,1,5,0,1,1,0,131,201,21,18,18,0,952,963,11,3,3,0,100
74f2098c651bcd60777f81f642629008437e1028,8,0,568,568,0,0,0,2,5,232,1,4,2.900021872,277,202,22,0,39,39,0,1850,1850,0,22,22,97.20496894
4a74cdfe659a4f84bee170b841a29f92f1d8299f,2,158,11,147,0,0,0,2,9,5,1,2,0.507190523,320,203,23,60,49,11,2901,2011,890,30,27,3,100
cd778b745705f0c17f2503de2ed8f3dcc246703b,2,154,2,152,0,0,0,1,6,2,1,1,0.172036949,195,14,12,42,23,19,2574,1682,892,15,9,6,100
d7c56b3bdcf1469a2adacd8be43fdba5c5f4ccf7,4,168,3,165,0,0,0,2,12,15,2,2,1.645667424,494,204,18,50,50,0,3297,3260,37,19,19,0,100
44af542e80edad3552f32538bb8b53493d76e840,0,0,0,0,0,0,0,0,0,0,0,0,0,0,205,19,0,0,0,0,0,0,0,0,0,100
ad45ef83e11014913dbce8b2aa9028ed73861873,1,4,2,2,0,0,0,2,4,8,1,1,0,104,206,20,15,15,0,856,852,4,4,4,0,100
9a0b72ce8c838d0a8ae2da2b114bae2b555c65da,1,2,0,2,0,0,0,1,18,11,1,1,0,131,207,21,13,13,0,1050,1026,24,7,7,0,100
119978df1afcd20f2722b107933bc0db04451cd8,6,121,50,71,0,0,0,2,7,69,2,4,2.369442213,637,15,4,110,99,11,4509,4218,291,38,32,6,99.67948718
98f851b7052c977fa9d7a51f72df956147883e7c,2,85,6,79,1,0,1,1,3,10,1,2,0.815603451,103,16,5,14,9,5,1102,631,471,6,4,2,92.85714286
3534264c2ddea9f1254cd0b456e058691f76f836,1,13,10,3,0,0,0,2,2,11,1,1,0,55,208,18,3,3,0,395,422,27,2,2,0,95.4887218
78ede1803daa5bda7afb429061f44ecf05d4340d,0,0,0,0,0,0,0,0,0,0,0,0,0,0,209,5,0,0,0,0,0,0,0,0,0,100
def4b93f1a3aed7c3bd4f0a184b44a5deb02c2c3,78,1481,0,1481,0,0,0,2,19,126,4,25,6.28537645,4341,210,2,536,536,0,28282,28282,0,324,324,0,100
b799580e6ed7b29f40bd98c1b8cef3e8ed5e0013,1,19,3,16,0,0,0,2,3,95,1,1,0,130,211,3,28,27,1,802,680,122,13,12,1,100
572322b4f29096c5e56a8fddac8843948cd109f6,1,1,1,0,0,0,0,2,5,73,1,1,0,337,212,4,27,27,0,2519,2519,0,8,8,0,100
f8b362e010555914bb04be030025b9a1bd542e31,1,3,3,0,0,0,0,1,5,62,1,1,0,46,17,0,8,8,0,269,264,5,8,8,0,100
5b590e290456b6af7f1ac782a04fb8d48ae601d8,663,88971,15665,73306,537,0,537,1,9,0,10,133,8.913911173,10866,0,0,7067,1360,5707,400137,61454,338683,3823,643,3180,20.88218872
2a0ce92502756b377ae4103f08370a8a65b946fe,4,116,5,111,0,0,0,3,10,291,1,4,0.969970011,1159,0,0,111,108,3,8905,8332,573,63,61,2,100
ca209d7df9bd5a62fde720a06406ae14199d5fec,5,256,11,245,1,0,1,1,8,143,1,3,1.087933038,1447,1,1,240,222,18,11339,10003,1336,148,136,12,99.93150685
1515b1dc1bf3a7733e66f3e170231192de0f1749,664,15749,89327,73578,125,0,125,2,19,0,10,133,8.913468367,55394,18,1,1348,7088,5740,61198,402250,341052,629,3837,3208,20.85889571
a2a08111a0fe16a5acf9db16fca688a6d00e3dee,2,45,0,45,1,0,1,2,20,25,2,2,0.938932011,151,19,2,17,13,4,1166,1050,116,8,7,1,99.6996997
1abdf1e79367cde21a7ae974a17d95c4d1006114,3,14,12,2,0,0,0,2,13,130,1,2,1.389674919,435,20,3,50,50,0,2524,2509,15,18,18,0,100
54ecb8084799effaf66f69647bb8598d1c91035c,0,0,0,0,0,0,0,0,0,0,0,0,0,0,21,4,0,0,0,0,0,0,0,0,0,100
08ae7f9d7310cb2a121d885706f858f50dc42006,8,148,9,139,0,0,0,1,8,27,1,3,2.440780298,1634,22,5,235,217,18,10799,10196,603,42,38,4,100
8f4d094b6b1ee4f74ee3fb9136320249caf2af32,7,314,4,310,2,0,2,3,21,66,2,5,1.602390673,597,0,0,128,85,43,5261,3752,1509,63,44,19,98.10495627
4276a7a76b62c6db90da76acfb0a97d90ae149a2,2,87,19,68,0,0,0,2,5,56,1,2,0.983501899,277,213,0,33,25,8,2050,1689,361,14,11,3,100
6a0e62ada53e1c252c3d2def43e5296099e4b82a,13,38,2055,2017,0,0,0,2,3,308,3,7,3.306999496,1506,214,1,39,184,145,1268,10995,9727,18,98,80,86.73621461
f0834f3a9277f1c57c826014ae179b45a58fa459,0,0,0,0,0,0,0,0,0,0,0,0,0,0,215,2,0,0,0,0,0,0,0,0,0,100
f7e3c2a487ed80ef3b8bfe41ec4ca45aeaa65032,0,0,0,0,0,0,0,0,0,0,0,0,0,0,216,3,0,0,0,0,0,0,0,0,0,100
340345d76a035cc751c39443b8724ffb873c7bd6,0,0,0,0,0,0,0,0,0,0,0,0,0,0,217,4,0,0,0,0,0,0,0,0,0,100
cb5ad449d9e57575ab2a83ccc64669867bb7305c,2,10,4,6,0,0,0,1,9,66,1,2,0.863120569,211,218,5,24,24,0,1007,965,42,12,12,0,100
fde0a699dbd9b47bb459b67b34b94a4ae58f4610,1,0,1,1,0,0,0,2,12,15,1,1,0,39,219,6,4,4,0,235,241,6,1,1,0,100
66f3078af505211192f58b3d39f1197578e4f11c,4,291,2,289,0,0,0,3,6,96,1,2,1.150199045,669,1,1,108,80,28,6312,4554,1758,24,19,5,100
91d8f50e48006f173ef8d38e3637095b7cd731b3,1,3,3,0,0,0,0,2,3,168,1,1,0,20,2,2,5,5,0,128,119,9,2,2,0,100
02d08c526274ac75dc11b14da8b12ef306df3d11,0,0,0,0,0,0,0,0,0,0,0,0,0,0,220,7,0,0,0,0,0,0,0,0,0,100
cba39f878ad2f9f2cca2fe0b75ba7338ba97436b,4,38,0,38,0,0,0,2,9,57,2,4,1.764496491,707,23,0,113,107,6,4769,4548,221,32,30,2,100
e1becc503b7ce43bc7fb067f75625d109e3b50e6,0,0,0,0,0,0,0,0,0,0,0,0,0,0,3,2,0,0,0,0,0,0,0,0,0,100
e8913351c6bc27dd184ec8a7d02a4b716e592e50,677,91467,16681,74786,549,0,549,1,11,0,11,137,8.942255034,11526,2,0,7210,1441,5769,411421,65708,345713,3905,663,3242,17.75280899
b23d35255ab58ff6d6614be641f736ea91fda9c7,677,16681,91467,74786,128,0,128,2,21,0,11,137,8.942255034,56585,24,1,1427,7210,5783,65071,411625,346554,649,3905,3256,17.75280899
81b2e7c0b9b8de3e90970b925910f2d2f20d90eb,677,91472,16681,74791,549,0,549,1,11,0,11,137,8.942258894,11526,3,1,7211,1441,5770,411459,65708,345751,3905,663,3242,17.75280899
d06c3c3a9ce9e053e2803550f98ed214c7b5e85b,677,16686,91472,74786,128,0,128,2,21,0,11,137,8.942242178,56590,4,3,1428,7211,5783,65097,411663,346566,649,3905,3256,17.75280899
f47da696785b58d328cba9f097c140a4bfc0ca0e,0,0,0,0,0,0,0,0,0,0,0,0,0,0,5,4,0,0,0,0,0,0,0,0,0,100
d14a80c0b4fffb8c251b2a5e4cfd83cfe41310e3,0,0,0,0,0,0,0,0,0,0,0,0,0,0,221,1,0,0,0,0,0,0,0,0,0,100
cf3a582e2b259581e182179f684479a5a2f1c812,0,0,0,0,0,0,0,0,0,0,0,0,0,0,222,2,0,0,0,0,0,0,0,0,0,100
583ecfa15fdcceebdedf1310f5b70b78f1ac2aaf,1,5,5,0,0,0,0,2,2,208,1,1,0,18,223,3,4,4,0,118,108,10,2,2,0,100
f161736c9a4bbf70868a82a92e9f6ef8b59cd459,0,0,0,0,0,0,0,0,0,0,0,0,0,0,6,5,0,0,0,0,0,0,0,0,0,100
33e9c9a7ba5f1b8e152b1ceb1732b0e07b410254,0,0,0,0,0,0,0,0,0,0,0,0,0,0,7,4,0,0,0,0,0,0,0,0,0,100
b7b3cd3deab304fe26b5b704eb43e00c3f23c573,0,0,0,0,0,0,0,0,0,0,0,0,0,0,224,4,0,0,0,0,0,0,0,0,0,100
3fc56f6b61f7fa3ef595daea8eeeaa8419491c1f,2,5,2,3,0,0,0,3,7,81,1,2,0.863120569,558,225,5,46,46,0,4006,3981,25,18,18,0,100
7e2d0ed01932cfdcc4532256fcd0aa379daea170,0,0,0,0,0,0,0,0,0,0,0,0,0,0,226,6,0,0,0,0,0,0,0,0,0,100
0f4f62a41a7776dd289fe4f9607c8b41d40cc4e1,0,0,0,0,0,0,0,0,0,0,0,0,0,0,227,7,0,0,0,0,0,0,0,0,0,100
0c1f9628a4d227931fe80a4bd2e0054255895afd,0,0,0,0,0,0,0,0,0,0,0,0,0,0,228,8,0,0,0,0,0,0,0,0,0,100
9b9e0d326716369b1b49338ec7e512547e7a75e5,1,9,9,0,0,0,0,2,5,133,1,1,0,132,229,9,11,11,0,686,680,6,4,4,0,100
47745e15c2099a97b188281206501a79b0bbc493,0,0,0,0,0,0,0,0,0,0,0,0,0,0,230,10,0,0,0,0,0,0,0,0,0,100
3996e774993c06fff6053beb5084e85f94716e52,0,0,0,0,0,0,0,0,0,0,0,0,0,0,231,10,0,0,0,0,0,0,0,0,0,100
601b428f0417e13235f6e6dde272f79af8536e6d,1,10,4,6,0,0,0,3,11,83,1,1,0,239,232,11,44,44,0,1362,1350,12,25,25,0,100
307f09103b3e1a8245b33f791871b405f5e4449d,0,0,0,0,0,0,0,0,0,0,0,0,0,0,233,12,0,0,0,0,0,0,0,0,0,100
7c4ac5fec6166baa4996cb0068dc10b0f21f7037,0,0,0,0,0,0,0,0,0,0,0,0,0,0,234,13,0,0,0,0,0,0,0,0,0,100
3a8afac54c20d40103626ee8438d0904e69e350d,0,0,0,0,0,0,0,0,0,0,0,0,0,0,235,14,0,0,0,0,0,0,0,0,0,100
fc4edc2b0df76602aefdfad3051b84484e0397d8,0,0,0,0,0,0,0,0,0,0,0,0,0,0,236,15,0,0,0,0,0,0,0,0,0,100
c00c04694592e3b45c102dbb74b8dfa609c042ea,0,0,0,0,0,0,0,0,0,0,0,0,0,0,237,16,0,0,0,0,0,0,0,0,0,100
966f2f5924cac666a44a7517de0539b3586719d8,0,0,0,0,0,0,0,0,0,0,0,0,0,0,238,17,0,0,0,0,0,0,0,0,0,100
671dd470cb6e2dd46c15e8e0669a15868ae56e89,0,0,0,0,0,0,0,0,0,0,0,0,0,0,239,18,0,0,0,0,0,0,0,0,0,100
6d3bd08995feebf3024d90bc95b2971ea6c0af39,0,0,0,0,0,0,0,0,0,0,0,0,0,0,240,19,0,0,0,0,0,0,0,0,0,100
a9dde29138e6eae723c5ee8e7c34081f10286b32,0,0,0,0,0,0,0,0,0,0,0,0,0,0,241,20,0,0,0,0,0,0,0,0,0,100
c5665f2f0d9779d6de07be41dd8703d858c9c888,0,0,0,0,0,0,0,0,0,0,0,0,0,0,242,21,0,0,0,0,0,0,0,0,0,100
d51b06c692aa94f008d100d75e35605132591293,0,0,0,0,0,0,0,0,0,0,0,0,0,0,243,22,0,0,0,0,0,0,0,0,0,100
e6dd7b02d093b6ac92493cc6ce73dd17b7585271,0,0,0,0,0,0,0,0,0,0,0,0,0,0,25,0,0,0,0,0,0,0,0,0,0,100
6d2f1c323b43839c75bf7dc906aa822d61bae445,43,1003,513,490,7,0,7,2,22,137,3,14,4.85715727,3908,26,1,519,486,33,23681,21832,1849,247,237,10,90.88145897
b9af5023991c24cd28306a6c75702a77e8c851a4,0,0,0,0,0,0,0,0,0,0,0,0,0,0,8,0,0,0,0,0,0,0,0,0,0,100
ee7c7e22926596df54d73b22b22e917d293f4805,0,0,0,0,0,0,0,0,0,0,0,0,0,0,244,0,0,0,0,0,0,0,0,0,0,100
fe6f94a14b6dfde028b2bdd9cc7183deac86e838,684,91509,17185,74324,549,0,549,1,11,0,11,137,8.955019752,11900,4,0,7216,1475,5741,411647,67636,344011,3907,673,3234,18.22222222
2cf3d5d6741dcf58418597bd28fc81a995de8293,685,17445,91509,74064,136,0,136,2,23,0,11,138,8.957902615,56621,9,1,1497,7216,5719,68140,411885,343745,685,3907,3222,18.22222222
fb75666c2705e8af9e7b2dd50b2efde5872aca60,0,0,0,0,0,0,0,0,0,0,0,0,0,0,10,2,0,0,0,0,0,0,0,0,0,100
38686ec52f71aca103628fc2096adf8e92f756e3,0,0,0,0,0,0,0,0,0,0,0,0,0,0,27,0,0,0,0,0,0,0,0,0,0,100
468158e75ecca8ed75e4e2d5138dc4c24d1a5715,685,91557,17445,74112,549,0,549,1,11,0,11,138,8.957943232,12082,5,1,7224,1511,5713,412052,68777,343275,3908,699,3209,18.22222222
533bd39b3e12117d3a1f8891c3d471b4f5a81774,696,18414,91557,73143,147,0,147,2,23,0,11,138,8.980645415,56666,28,1,1567,7224,5657,72315,412290,339975,723,3908,3185,18.19178082
ae09f9bb6936f962ec732561cf155377025d5956,6,1,637,636,0,0,0,2,11,109,2,5,2.070300355,538,29,2,3,60,57,245,3190,2945,3,26,23,93.3908046
c1805ed2bbef3e3af80f00201309a4b7e7d376a5,14,137,214,77,0,0,0,2,13,148,3,8,2.270923555,2117,30,3,246,247,1,13385,13603,218,95,95,0,95.50224888
dfc60fe187e105021422d00dd2c3d871ef795c45,0,0,0,0,0,0,0,0,0,0,0,0,0,0,11,0,0,0,0,0,0,0,0,0,0,100
6b877b272fafb45eed308785b1e56e4a70f6c84e,8,2708,0,2708,8,0,8,1,1,0,1,5,2.315511109,0,12,1,432,0,432,14792,0,14792,195,0,195,94.88859764
af6f8291cd2dbf088ad43825599bf9b9c28ecaac,1,19,0,19,0,0,0,2,2,3,1,1,0,83,31,4,8,8,0,659,659,0,5,5,0,100
4d3a868285a4d759202ac0b1e3f5a2dad71eed76,0,0,0,0,0,0,0,0,0,0,0,0,0,0,32,5,0,0,0,0,0,0,0,0,0,100
c396c90f16e7fd433c4b114f43b7debb378d82c1,0,0,0,0,0,0,0,0,0,0,0,0,0,0,33,6,0,0,0,0,0,0,0,0,0,100
5efd17079f5664e9833081f5b574ae7f62803dd6,0,0,0,0,0,0,0,0,0,0,0,0,0,0,34,7,0,0,0,0,0,0,0,0,0,100
70fb8cbf61679ccda83db4d087852af6c658bc5d,18,21,32,11,0,0,0,2,13,111,4,10,3.63645375,2959,35,8,392,392,0,17900,17976,76,140,140,0,96.2628866
ec0aae00d30a66f686c5f001eefcfbb68abb2732,1,2,0,2,0,0,0,2,7,28,1,1,0,156,36,9,12,12,0,1059,1045,14,7,7,0,100
5295a119a49fdc4890df0501cc74a3795a20a0d4,7,1725,2,1723,6,0,6,1,2,68,1,3,2.291427914,13,37,10,137,3,134,6794,66,6728,89,3,86,98.02816901
cb97b04fb4a62247dde6d87090dcf564580f2fdd,1,109,102,7,0,0,0,3,9,32,1,1,0,495,13,2,42,39,3,4034,3693,341,15,12,3,100
9ebc576c63a780b0464d4214d5db9c59c08b6bad,2,54,27,27,0,0,0,1,3,24,1,2,0.764204507,206,38,9,17,16,1,1766,1570,196,7,6,1,100
609ce6d7ddceb3614bc3485c2a4d207ef3e74ba8,0,0,0,0,0,0,0,0,0,0,0,0,0,0,39,8,0,0,0,0,0,0,0,0,0,100
0f332582c9ddf3daeedcf7c8aab09856c357e5a0,3,382,0,382,3,0,3,1,1,0,1,2,1.402730123,0,40,9,22,0,22,1474,0,1474,15,0,15,96.54747226
78604c95a42a1ff088da945a590b1e8579ded4f9,4,269,63,206,0,0,0,2,12,54,2,3,1.525248484,865,41,10,170,140,30,6983,5682,1301,51,44,7,100
91fa6e9bb108b725abc6ff30957be020f85d1fdc,7,661,0,661,7,0,7,1,1,0,1,3,2.565149663,0,42,11,52,0,52,2620,0,2620,31,0,31,98.35526316
179ca1231ecd3267e2ba067c9840f1be08070f71,6,683,307,376,1,0,1,3,16,123,2,3,1.611614195,693,14,1,107,69,38,7164,4231,2933,29,34,5,96.44087256
b1255740454903d3b46a63ba373cea21acf33131,0,0,0,0,0,0,0,0,0,0,0,0,0,0,43,5,0,0,0,0,0,0,0,0,0,100
1de6e4b4d9bef82904c35f80022e2a8d5bb134df,20,261,118,143,0,0,0,2,16,69,4,12,2.707697545,2888,44,5,394,381,13,17996,17653,343,163,153,10,100
a7b8991c782b3f3c17f1a3cd8b9e050f24c32a0a,4,456,0,456,4,0,4,1,1,0,1,2,1.993694876,0,45,2,35,0,35,2137,0,2137,12,0,12,97.40740741
36a5fe4e79a9dc10e644b59eab5f9790dea9cbe0,0,0,0,0,0,0,0,0,0,0,0,0,0,0,46,3,0,0,0,0,0,0,0,0,0,100
9c59861615cbb41b489278cf49d815fb9e31b877,13,160,16,144,0,0,0,2,7,227,1,3,3.240643767,692,47,4,91,91,0,2822,2811,11,55,55,0,98.86792453
be2cf80393eef6f3ed57b128a56cde7534836ef4,4,77,19,58,0,0,0,1,5,53,1,2,1.665897321,107,48,5,7,7,0,599,599,0,4,4,0,100
fc6c76799f5dbf17f7e2529231c0cc0134fc3e1a,2,23,2,21,0,0,0,3,10,56,1,2,0.970950594,835,49,6,104,102,2,6333,6209,124,26,25,1,100
adc7fee32ea3243d9b38714cd56fca81a9dca135,1,24,0,24,0,0,0,2,8,11,1,1,0,110,50,7,24,24,0,570,570,0,18,18,0,100
3f0f224b7e22910f7899eaeabda9f3fee7feaa67,2,30,8,22,0,0,0,2,10,152,1,2,0.949452015,224,51,8,31,27,4,1166,1023,143,15,15,0,100
63176284258d65a576b7c794b5a592964c67d07f,20,1295,208,1087,6,0,6,1,11,22,4,13,3.210747685,1303,52,8,211,115,96,11420,8709,2711,112,55,57,86.95652174
bb1c4a35c66920c52bfc9966b89958cf9c53ff11,0,0,0,0,0,0,0,0,0,0,0,0,0,0,53,9,0,0,0,0,0,0,0,0,0,100
ccdadbab6f0ee7914d16470ba4fd798c4afa9fba,5,33,8,25,0,0,0,1,12,0,3,5,1.685710094,745,54,10,85,81,4,4766,4599,167,38,36,2,100
1df76fcedcbc01dacfb4ac6ca24d109355a98845,0,0,0,0,0,0,0,0,0,0,0,0,0,0,55,11,0,0,0,0,0,0,0,0,0,100
bf39831edffa8b7381be37b4ede2508ef8c3e3a3,0,0,0,0,0,0,0,0,0,0,0,0,0,0,56,11,0,0,0,0,0,0,0,0,0,100
e85b89cf731747a38e80d51529942439f76716dd,3,4,0,4,0,0,0,2,3,101,1,2,1.5,1650,57,12,387,387,0,11897,11883,14,176,176,0,100
7730e13e8132e5ae180b165b2869ee4b1d3fd587,2,26,26,0,0,0,0,2,2,20,1,1,0.98285869,311,0,0,35,35,0,1954,2018,64,25,25,0,100
9f3f1db9c8345e7d528572ed3a5b5dc37437750a,0,0,0,0,0,0,0,0,0,0,0,0,0,0,58,13,0,0,0,0,0,0,0,0,0,100
a40a2a4bcf8607f2975042a5196bb8ca7938cb9b,1,17,7,10,0,0,0,1,2,89,1,1,0,102,59,13,21,20,1,725,659,66,7,7,0,100
f9c4635c990cb275e7b52974236ad4e2098d7a3e,3,229,39,190,1,0,1,3,10,49,1,2,1.305899556,207,60,13,32,14,18,1900,1131,769,11,6,5,88.92215569
11e1c276e0c43f4312b0e00a8a18f7ec89dfdf36,2,77,1,76,1,0,1,1,2,13,1,2,0.995727452,50,61,14,14,6,8,611,168,443,8,6,2,96.17304493
0495d6b414615817588b997745e5e1c189e34147,7,66,4,62,0,0,0,2,6,149,1,2,2.569305032,126,62,15,0,0,0,378,356,22,0,0,0,100
162723ba4ef359a01dfcb5c3ef9536c46df52651,2,195,3,192,1,0,1,2,7,15,2,2,0.672954626,335,63,16,76,61,15,2825,2198,627,13,10,3,99.3344426
f535148942de9be8413bea8b0fa85689222130ec,0,0,0,0,0,0,0,0,0,0,0,0,0,0,64,17,0,0,0,0,0,0,0,0,0,100
2244ec4412e77b73c59ec0cefb3978bbd93468b5,0,0,0,0,0,0,0,0,0,0,0,0,0,0,65,18,0,0,0,0,0,0,0,0,0,100
fa1a1a8756f495649b439f54ddc7f8af29360d0f,0,0,0,0,0,0,0,0,0,0,0,0,0,0,66,19,0,0,0,0,0,0,0,0,0,100
5d9e51c4d41f6d7ac77b653bd663352410c089c3,0,0,0,0,0,0,0,0,0,0,0,0,0,0,67,19,0,0,0,0,0,0,0,0,0,100
229ab2ac33bb4da9fd1a255643ccd004a51b4e3f,2,107,27,80,0,0,0,1,3,37,1,2,0.4094994,268,68,19,47,38,9,2185,1810,375,26,19,7,100
fb952cddcb235cd067096bac8b6bf16518736db2,0,0,0,0,0,0,0,0,0,0,0,0,0,0,69,20,0,0,0,0,0,0,0,0,0,100
7a74f6d7704ded7dbe91293e23d7f47cb5c4ab78,4,44,13,31,0,0,0,2,17,236,2,4,1.839834429,719,70,21,91,87,4,4621,4457,164,31,31,0,100
85f3a595ed036342fdd4d500aa8e6717eea107c9,6,353,234,119,0,0,0,3,11,269,1,2,1.595682983,1245,71,22,153,158,5,9130,8348,782,53,49,4,100
417fedb4d65f72874b21ee2e4d8babc1fe414c0c,1,2,2,0,0,0,0,2,15,0,1,1,0,117,72,23,14,14,0,583,579,4,7,7,0,100
9ed3af31d25566d885ab9a7f987fd2ee41bf91fb,1,13,2,11,0,0,0,2,9,6,1,1,0,465,73,23,62,59,3,2796,2758,38,13,13,0,100
85fd99a045af939629c4a45582b187d74e678266,0,0,0,0,0,0,0,0,0,0,0,0,0,0,0,0,0,0,0,0,0,0,0,0,0,100
9d9b4088d28d1605c0d65982f397d1cbc6e4b27b,4,87,44,43,1,0,1,2,14,42,2,3,1.580689151,157,1,1,21,18,3,961,835,126,11,9,2,82.13296399
4793cbdea2b42652ee5fde2f5936e89f7d8e94ea,12,756,123,633,3,0,3,1,10,25,3,5,2.470967078,1098,74,18,208,143,65,9652,6369,3283,84,69,15,98.82075472
4bc8dfe6506ab5ead6f88ee0cbbcd8c74d58e135,4,246,61,185,1,0,1,3,18,29,2,3,1.105149316,377,75,19,48,36,12,2715,2228,487,14,10,4,99.53434226
e7045e5a5a67461c257fd5494a57ddd45ee277af,0,0,0,0,0,0,0,0,0,0,0,0,0,0,76,20,0,0,0,0,0,0,0,0,0,100
4d75539f3c4cabbbeda1991a63c495510e603b43,1,22,8,14,0,0,0,2,16,18,1,1,0,117,77,20,18,14,4,683,583,100,7,7,0,100
3fdb53d9af0d7e388705f0a8d669f0f174364b9f,2,4,2,2,0,0,0,1,3,263,1,1,1,90,78,21,15,13,2,689,675,14,11,11,0,100
01683613d313dcb4cc8ba0e8da3e387f88ba4da6,0,0,0,0,0,0,0,0,0,0,0,0,0,0,79,22,0,0,0,0,0,0,0,0,0,100
428660c2bee07b01e27f986fb0b190ad17e25530,2,57,0,57,0,0,0,1,3,10,1,2,0.98909344,185,80,23,29,23,6,1304,1045,259,13,9,4,100
72fb734a22d1c119ef3d0217a5e8f70de5cc9b28,10,1985,0,1985,10,0,10,1,1,0,1,4,2.992807798,0,81,24,226,0,226,10644,0,10644,102,0,102,89.77135981
989b3c68428c7df0583b5e0dfd247729c36a4b0c,1,7,3,4,0,0,0,2,10,19,1,1,0,472,82,25,63,62,1,2813,2796,17,13,13,0,100
c421be4848a0b75b674ed0e3ba09fa9a656297dd,1,1,1,0,0,0,0,3,12,26,1,1,0,180,83,26,24,24,0,1497,1497,0,5,5,0,100
bcd27a6d9b34f552d4ba4a9df7ec69f829f97e84,2,9,0,9,0,0,0,2,11,40,1,2,0.918295834,298,84,27,46,44,2,1626,1576,50,12,12,0,100
a48bbb4d7c749468111814a67b220a4105189337,0,0,0,0,0,0,0,0,0,0,0,0,0,0,85,28,0,0,0,0,0,0,0,0,0,100
e534483642bd9c9ed31b23f85f4ceaf3813de0a2,2,2,3,1,0,0,0,1,2,0,1,2,0.970950594,692,86,29,92,92,0,4912,4912,0,31,31,0,100
f519f84ef3af1fb6cb9cc2782f8f53fe0edbbd77,0,0,0,0,0,0,0,0,0,0,0,0,0,0,87,30,0,0,0,0,0,0,0,0,0,100
a2ed12f270a6399c1cee7f091b62a96cade93db5,2,6,6,0,0,0,0,2,13,138,2,2,0.650022422,403,88,29,65,65,0,2450,2450,0,13,13,0,100
f4e38a4642850d91614ef838eefbb31428464e50,0,0,0,0,0,0,0,0,0,0,0,0,0,0,89,30,0,0,0,0,0,0,0,0,0,100
003dcffb0368aa167da2ea3cd8defd5986fdb44e,1,3,3,0,0,0,0,2,2,8,1,1,0,190,2,1,28,28,0,1177,1177,0,15,15,0,100
6ba8a46cc8177781de522492cf07f72391c8e665,1,13,10,3,0,0,0,3,5,36,1,1,0,145,21,0,29,29,0,908,880,28,13,13,0,100
68ea3e7cb1a1a9110a30f8db26f39d2ac86fcc50,2,197,0,197,2,0,2,1,1,0,1,1,0.965354179,0,22,1,17,0,17,943,0,943,13,0,13,98.88751545
ea5b677a798cee6271e52e2113fc235d83d7a1d3,1,13,1,12,0,0,0,1,2,249,1,1,0,33,90,22,2,2,0,114,92,22,2,2,0,100
3d2f813d2bded6e532a3da76efe142c2acea15ae,3,97,7,90,0,0,0,3,12,18,1,2,0.795635805,1201,91,23,142,136,6,8906,8392,514,45,43,2,100
112eceaf4fd59a4fec180e3d41b1ebb87f290a7f,6,129,44,85,0,0,0,2,12,272,1,3,1.841469299,1414,23,2,194,192,2,8451,8147,304,27,27,0,100
c33a8bacb07c17fa003adc3f4c8b282c12cd9f1e,5,429,54,375,1,0,1,1,2,72,1,2,1.527489474,387,92,19,68,35,33,4657,2137,2520,26,12,14,97.9616307
a342a3170f86a8431d72f5d9a782d6e1cb1bf4f2,2,81,29,52,0,0,0,3,14,281,1,2,0.984684157,275,24,3,36,30,6,1815,1549,266,16,15,1,100
e8164f06654c01e5782b981e89aea1c2a30418da,3,191,48,143,0,0,0,2,13,62,1,3,1.06138901,678,25,4,108,101,7,4868,4506,362,22,21,1,100
7533f68dd8545cc931b62a264c63c351da478137,1,1,2,1,0,0,0,2,9,84,1,1,0,129,93,19,18,18,0,599,599,0,9,9,0,100
7a4de908c5d99c10356ef79ea21e2f40f345523e,2,27,2,25,0,0,0,3,13,80,1,2,0.216396932,268,3,1,24,22,2,1788,1663,125,11,11,0,100
4c4fb8d53bf2b14593a08181179decb59af5c4ee,3,18,1,17,0,0,0,2,3,6,1,1,1.236386411,384,26,5,48,45,3,2146,2069,77,19,16,3,100
abfda140ccb3d36b5faa230de52fd0c6853b46c9,1,9,0,9,0,0,0,2,4,4,1,1,0,171,27,6,29,28,1,843,827,16,10,10,0,100
9a33ad32cda37e0dc2f11cdf94e96049f2e4ec50,2,8,6,2,0,0,0,2,4,4,1,1,1,227,28,7,20,20,0,1332,1319,13,9,9,0,99.88235294
abc3468f53db38648f8978965719be5d528ff032,7,512,369,143,2,0,2,4,14,63,2,3,1.751554465,969,29,8,158,148,10,6579,6182,397,42,37,5,99.06542056
67089038d277803458f35e6842e11ae8505e5fe6,0,0,0,0,0,0,0,0,0,0,0,0,0,0,94,14,0,0,0,0,0,0,0,0,0,100
6ed355b961cf1686a25026d2a03fae6996573a0b,22,1271,31,1240,10,0,10,3,15,102,2,6,3.693754537,1815,30,9,294,207,87,17248,12158,5090,135,86,49,96.40449438
46373970315f012af53f54051319fee850d18e55,0,0,0,0,0,0,0,0,0,0,0,0,0,0,31,10,0,0,0,0,0,0,0,0,0,100
8b3acf702dd106ad3fda0b92fc9466050bf0cfc1,0,0,0,0,0,0,0,0,0,0,0,0,0,0,4,2,0,0,0,0,0,0,0,0,0,100
3e630426520cfbb929ed3fe4b6500e4f454c152e,0,0,0,0,0,0,0,0,0,0,0,0,0,0,5,2,0,0,0,0,0,0,0,0,0,100
6ddc6a434b70a25281e3fb7f0ddbcdcb382f8ce4,1,16,24,8,0,0,0,3,12,77,1,1,0,240,6,3,28,30,2,1289,1313,24,13,13,0,100
1b15ba8150a156fbb3ade8cf7414a7a1bc2a9165,0,0,0,0,0,0,0,0,0,0,0,0,0,0,7,4,0,0,0,0,0,0,0,0,0,100
be625be7fa576b4a8abaa230a82824675a9d6fea,0,0,0,0,0,0,0,0,0,0,0,0,0,0,32,9,0,0,0,0,0,0,0,0,0,100
448170db726401179687c22b55a23bb3f6425d09,1,27,7,20,0,0,0,4,13,2,1,1,0,235,33,10,30,28,2,1381,1289,92,14,13,1,100
d32b5382ef40ded549a7bec7fa4b7e113a82d134,0,0,0,0,0,0,0,0,0,0,0,0,0,0,8,5,0,0,0,0,0,0,0,0,0,100
a363ca5e26c41249c08a4aa0f45a284d1b16a033,32,2388,977,1411,14,0,14,3,13,84,3,9,3.463215661,1582,95,2,400,224,176,15257,9378,5879,163,79,84,91.6751269
a45c29e13a389b366243c33211edc0b9b63f78be,0,0,0,0,0,0,0,0,0,0,0,0,0,0,96,3,0,0,0,0,0,0,0,0,0,100
04310c93e59f551a7a2e44580784b7e53522daf7,4,124,8,116,1,0,1,2,2,15,1,2,1.779005944,229,97,4,20,13,7,1793,1389,404,15,10,5,98.56596558
fe162fb5bfebf925c56f79e8f20e76026af0b6b2,1,51,2,49,0,0,0,2,10,79,1,1,0,137,98,4,25,17,8,1149,866,283,5,3,2,100
ed0b3270bae5d09da162fa80351672c43d4c8bdb,2,9,8,1,0,0,0,1,2,2,1,2,0.936667382,240,99,5,39,38,1,1301,1315,14,15,15,0,99.71126083
bb08f3189bc8f4c7355fb6de868392826896618e,0,0,0,0,0,0,0,0,0,0,0,0,0,0,100,6,0,0,0,0,0,0,0,0,0,100
266c7f99e0a93183b25346bb7cafbff421801f9e,1,1,1,0,0,0,0,3,14,5,1,1,0,203,101,7,24,24,0,1677,1677,0,5,5,0,100
2f33c14c4c1671747499f5d58401cafd282fd6f0,4,91,14,77,0,0,0,1,3,2,1,3,1.247522019,1100,102,8,212,195,17,7212,6715,497,62,59,3,100
6c15ab5df3dcfd22b75c332e7d6ad7db1ab069eb,1,2,1,1,0,0,0,3,3,26,1,1,0,52,9,5,8,7,1,386,379,7,6,6,0,100
fbec810c7fa5ff7460cd3f41d294b8905188ae79,4,325,4,321,0,0,0,1,5,51,1,2,1.315596444,627,103,9,112,70,42,6244,4226,2018,44,27,17,100
6397389ba6f5fe7f67cc976b1c976876789e6ec8,1,18,2,16,0,0,0,1,3,6,1,1,0,790,104,10,152,149,3,5289,5193,96,31,31,0,100
df9ee4586929d4973a5613ca5d18677d9c7101aa,0,0,0,0,0,0,0,0,0,0,0,0,0,0,105,11,0,0,0,0,0,0,0,0,0,100
b0e017b0e396242c76d49453b2fb5c426325ed96,1,0,2,2,0,0,0,2,2,17,1,1,0,71,10,6,10,11,1,351,361,10,1,1,0,100
b611c51ef1f0715373edb300776f281519c5c022,20,362,108,254,0,0,0,2,17,164,4,11,3.043333372,3751,106,11,504,475,29,23552,22357,1195,202,195,7,99.43074004
437d8b48b97560b89bf54d9743ec0d342e2c8526,1,2,3,1,0,0,0,2,3,587,1,1,0,145,107,12,23,23,0,781,783,2,19,19,0,100
5affb1f9c86bb5dd6c714c1ecda45e9830945a92,1,10,7,3,0,0,0,2,13,47,1,1,0,483,108,13,65,65,0,2840,2849,9,13,13,0,100
bfbfc1ed627328a0d2cb4b8a1043e9413ea12462,1,2,2,0,0,0,0,1,3,99,1,1,0,260,109,14,29,29,0,2053,2053,0,14,14,0,100
6fe6db96816d831f6fb52864b55ad2aaf6914ac7,1,1,1,0,0,0,0,1,4,0,1,1,0,260,110,15,29,29,0,2053,2053,0,14,14,0,100
6e2173d13cbfbbeab2002564e2f977ac213505e3,1,1,1,0,0,0,0,3,15,30,1,1,0,203,111,16,24,24,0,1679,1677,2,5,5,0,100
c891d62bc596d842476f1d9f34fb7cb4585fb7b2,2,2,2,0,0,0,0,2,7,10,1,1,1,246,112,17,22,22,0,1448,1448,0,11,11,0,100
31a1d81b682b26855ee0aafa947bbd59e61d4d4c,31,4287,533,3754,27,0,27,1,8,27,3,6,4.360967999,597,113,18,529,83,446,22689,3153,19536,258,40,218,84.2676311
2dec46af90a7e6b6f7574b78cb41b5569ef05b58,14,226,83,143,2,0,2,3,16,43,3,8,3.40179763,2222,11,3,367,363,4,14314,13930,384,122,118,4,94.92753623
12f6ad9ea1c554a64cd6757d21ac939a7a2bc6a4,2,39,20,19,0,0,0,2,6,4,1,2,0.974778547,898,114,16,133,127,6,6084,5948,136,45,45,0,100
143f0fd2e548d1643f554fe0babbc0bbb4d2d297,2,28,15,13,0,0,0,1,4,18,1,2,0.271389588,725,115,17,102,99,3,4907,4805,102,32,32,0,100
60b239d6522fc95ef11f7dfd181a91c6662a3158,1,5,0,5,0,0,0,1,2,44,1,1,0,52,116,17,9,9,0,286,281,5,5,5,0,100
1fb41088309afb11dc9f6c494635a89a9124f5eb,0,0,0,0,0,0,0,0,0,0,0,0,0,0,12,3,0,0,0,0,0,0,0,0,0,100
4576b9550fd5cb337e6a47ac2978a863d0f5b747,0,0,0,0,0,0,0,0,0,0,0,0,0,0,13,4,0,0,0,0,0,0,0,0,0,100
72a930d3746b00c796443c88c8089a120f3d703a,4,24,6,18,0,0,0,3,18,142,1,3,1.903795668,434,117,14,51,49,2,2974,2942,32,17,15,2,100
f80780dd1909450667f4b232122abb5d96e10abd,3,71,5,66,1,0,1,1,5,38,2,3,1.184270692,107,118,12,12,10,2,866,566,300,5,4,1,95.87628866
97e5682fb6492ddf436c6f97e597664bd1073abc,5,621,0,621,5,0,5,1,1,0,1,2,2.108505181,0,119,13,47,0,47,2718,0,2718,20,0,20,98.88475836
2945f7461b67b5c7c7fdf7a34001858bdb835a48,5,113,13,100,0,0,0,4,18,162,2,4,1.400416252,622,120,13,81,70,11,4319,3685,634,26,22,4,90.76406381
e5bb0091a50ccb13afa66ce26d5908bb323ff65a,4,308,0,308,4,0,4,1,1,0,1,2,1.982694611,0,121,14,22,0,22,1021,0,1021,14,0,14,90.14308426
870a8653ffb57c7ce536efa47d040ba66b407f26,0,0,0,0,0,0,0,0,0,0,0,0,0,0,122,13,0,0,0,0,0,0,0,0,0,100
f9af6065905abefa8d97d7ad854a28f8e3f5cf98,8,1010,30,980,5,0,5,1,4,25,2,3,2.062579927,249,14,3,109,33,76,5559,1372,4187,62,17,45,98.46402587
e67482a6f1377be44190616b985a7a18d34d44d2,4,503,189,314,2,0,2,1,14,124,1,2,1.24188048,505,123,12,112,69,43,4453,2958,1495,27,15,12,99.68253968
63e0704a803f646d050ea4af0c7e3fea2efcc0e6,5,419,8,411,3,0,3,2,15,10,2,5,2.242087239,702,124,10,174,140,34,6146,4164,1982,36,20,16,99.29245283
269ac8e02500dfd69ba74b796f09464ec60773ce,4,251,263,12,0,0,0,3,16,79,1,2,1.81552411,1543,125,11,183,185,2,11047,11199,152,49,53,4,100
825d98373b44f99df0da7c77ce0f1fef67028aea,1,4,0,4,0,0,0,1,2,85,1,1,0,72,126,11,10,10,0,315,310,5,7,7,0,100
897b33befa1fdee8631dab23877cc04048dca988,2,4,4,0,0,0,0,2,5,55,1,2,1,705,0,0,110,110,0,4566,4566,0,37,37,0,100
ca04449e395dac56202463dea77e3e387be0ca78,2,7,13,6,0,0,0,2,9,53,1,1,0.468995594,828,15,1,130,130,0,4962,4986,24,40,40,0,100
95798ae444d44248f8ccb09ebb77b0dddcaf77b9,1,6,2,4,0,0,0,4,9,24,1,1,0,168,0,0,30,30,0,1048,1047,1,10,10,0,100
fc3229d7b0aa6dd5a4d97ed23ada6f885d0c6295,1,1,0,1,0,0,0,4,10,0,1,1,0,169,1,1,30,30,0,1048,1048,0,10,10,0,100
dbf3557853d0ab0af802c60db002ecf0e6fdc0bf,2,43,33,10,0,0,0,2,4,276,1,2,0.443458145,292,0,0,26,26,0,1883,1826,57,16,13,3,100
50e584754425256fd992e68348ddf654ee99577d,1,10,11,1,0,0,0,4,11,1,1,1,0,169,127,5,30,30,0,1040,1048,8,10,10,0,100
6b4a64a2f1e3b8350e0fdd54e1807beb66845d53,1,17,0,17,0,0,0,2,19,61,1,1,0,160,128,6,26,23,3,998,908,90,8,8,0,99.84350548
2ebebf3dee699bfb3c0c5b2328ca49c19aaf5501,2,159,111,48,0,0,0,5,19,56,2,2,0.666940213,1016,1,1,187,176,11,7173,6965,208,40,36,4,100
a172920132b41f0da46c6fc3823661f772b244af,1,1,1,0,0,0,0,3,17,29,1,1,0,515,2,2,90,90,0,3276,3273,3,16,16,0,100
1651bc5e56a08969904c8d43f4195cd2bce90418,2,86,2,84,0,0,0,1,4,73,1,2,0.214509834,163,129,6,22,18,4,1706,1219,487,11,10,1,100
db6965f121f467c0e3c31d79c5375dd097939c2d,5,309,8,301,4,0,4,1,5,9,1,3,2.023034793,204,2,2,53,35,18,2288,1211,1077,22,8,14,99.22239502
56fcafed2f47e44f5ecccef8eaf682b608a17281,1,1,2,1,0,0,0,2,2,197,1,1,0,224,3,3,40,40,0,1214,1215,1,11,11,0,100
d26948e8196ca470fae46a1beaaee64557778712,0,0,0,0,0,0,0,0,0,0,0,0,0,0,0,0,0,0,0,0,0,0,0,0,0,100
dd9bd1b0e8c49a60518083395b694034ef52596f,0,0,0,0,0,0,0,0,0,0,0,0,0,0,1,1,0,0,0,0,0,0,0,0,0,100
0cb4d241858940f8807f2f703b5aff94dffe0c0a,8,316,92,224,1,0,1,2,13,119,2,4,2.295902501,1074,3,3,165,151,14,6785,6250,535,58,53,5,94.29223744
d561b80bf4486481d74c7fdd907fcd446bdcb3cc,4,325,175,150,0,0,0,2,18,59,1,2,1.518714844,850,130,3,151,137,14,6000,5325,675,47,39,8,100
f832cd85657567dc4fea69b94f04bb489194e988,13,975,142,833,4,0,4,3,16,55,2,5,2.826406946,1390,4,4,307,208,99,12486,8094,4392,124,89,35,93.69300912
5b223459c36f4b0a1cc56fb3e36447072dbd4a0f,0,0,0,0,0,0,0,0,0,0,0,0,0,0,5,5,0,0,0,0,0,0,0,0,0,100
23b48af5db4200428972630755bff32cb5d56707,1,8,8,0,0,0,0,3,5,109,1,1,0,165,2,2,28,28,0,975,975,0,9,9,0,100
633a6aff0ec2f1ba4b96970438a995761c0ce1b5,0,0,0,0,0,0,0,0,0,0,0,0,0,0,6,5,0,0,0,0,0,0,0,0,0,100
33eb463b7d3255f9b5943bd778780df044deff08,0,0,0,0,0,0,0,0,0,0,0,0,0,0,3,3,0,0,0,0,0,0,0,0,0,100
06ae36678c5dbbfce866bb0c3c60f4b825039db7,0,0,0,0,0,0,0,0,0,0,0,0,0,0,7,5,0,0,0,0,0,0,0,0,0,100
dfa8462144970624b094c1f8a95cabf5644ad235,2,53,0,53,0,0,0,4,19,43,1,2,0.698700353,1249,8,6,152,148,4,9638,9325,313,38,37,1,100
624390f7c1af65014448ee45119d3b0728401bf3,3,588,0,588,3,0,3,1,1,0,1,2,0.932623662,0,9,7,75,0,75,2813,0,2813,19,0,19,99.46442234
5463244bcc300a2cb392567ceeea3b771e542b46,6,653,6,647,4,0,4,1,2,28,1,2,1.965208677,148,1,0,78,21,57,4043,760,3283,32,10,22,96.81303116
12e958d668fa219649ea40019fc4488567055cbb,4,77,12,65,0,0,0,1,2,0,1,2,1.577344928,568,2,1,54,54,0,3220,3224,4,21,21,0,100
282e986667e36238849c85a19b48381b3468dfd4,2,328,0,328,2,0,2,1,1,0,1,2,0.999758608,0,4,1,19,0,19,1797,0,1797,11,0,11,99.6039604
d5dfaa83d1146d48988368e7ef10d16b6bc00273,1,1,1,0,0,0,0,2,2,265,1,1,0,14,10,7,4,4,0,108,104,4,1,1,0,100
fb598ba170144895da880e35c6981152f8087338,1,3,0,3,0,0,0,3,4,142,1,1,0,144,3,2,24,23,1,799,781,18,19,19,0,100
850b8f4be873eebea244fcb62a1ab3a84d639f32,4,91,29,62,1,0,1,1,3,31,1,1,1.905934732,490,4,3,50,50,0,2621,2569,52,18,18,0,98.48171153
afee9248e0984996623ab0342a1b18a45da4e608,3,328,1,327,2,0,2,1,2,18,1,2,1.08256339,11,5,4,19,2,17,1390,81,1309,14,2,12,99
2b41fd3214f6fc0709b129e64ee2e6c34b0fdf35,1,3,3,0,0,0,0,3,4,586,1,1,0,20,5,1,5,5,0,128,128,0,2,2,0,100
502944d1418f3b970192fccde477e15747306eb6,0,0,0,0,0,0,0,0,0,0,0,0,0,0,6,2,0,0,0,0,0,0,0,0,0,100
c6cc3470b44b00c6fc6d9837a2f15b4e9ed54a7b,12,792,459,333,0,0,0,3,15,132,2,3,2.585020272,2429,16,0,397,359,38,16896,15279,1617,155,140,15,99.22151451
e6e0c3a87133aa32cde21383b7a6166938ab4a76,0,0,0,0,0,0,0,0,0,0,0,0,0,0,7,3,0,0,0,0,0,0,0,0,0,100
77fb706412105191ed325c5187b963590ec2389a,0,0,0,0,0,0,0,0,0,0,0,0,0,0,8,4,0,0,0,0,0,0,0,0,0,100
7be9e77044740212e5dec1998e2c1021af100da3,3,120,14,106,1,0,1,2,5,42,1,2,1.364678806,225,9,5,25,22,3,2174,1706,468,12,11,1,99.71550498
137832d5c84fecdd59b5a6bc4a253a848a94d9cb,1,30,0,30,1,0,1,1,1,0,1,1,0,0,131,0,1,0,1,25,0,25,1,0,1,99.85815603
a0520ed28fe5458ff06420e2a1d9d5acc0e09ab7,1,14,0,14,0,0,0,3,20,27,1,1,0,525,11,6,97,94,3,3461,3405,56,17,17,0,100
5e997cea7fc207cf7b80aaa1e0c1b7992b651e29,0,0,0,0,0,0,0,0,0,0,0,0,0,0,0,0,0,0,0,0,0,0,0,0,0,100
5b7f0480b679b1489287d61a62bf9a347d27ce18,2,53,23,30,0,0,0,2,2,10,1,2,0.868040399,178,12,7,19,17,2,1477,1291,186,13,12,1,100
8d482af7fbc75e8dc75e3af71e79a3f71e4395cc,0,0,0,0,0,0,0,0,0,0,0,0,0,0,13,8,0,0,0,0,0,0,0,0,0,100
c3ea359332a11b11c3a809e7d50784dd5f41481c,2,241,4,237,0,0,0,1,4,23,1,2,0.512709142,422,6,5,60,34,26,4159,2476,1683,19,14,5,94.62647444
939096d56f8fb1e059a951a653f77129d1d7dd7c,1,214,4,210,0,0,0,2,2,121,1,1,0,112,7,6,28,5,23,2324,798,1526,8,3,5,100
cc7c96e424af2d05875071efc15cacd5ed5017ec,4,52,21,31,0,0,0,3,14,239,4,4,1.104194755,633,14,8,72,69,3,4191,3954,237,29,27,2,92.53058596
f2cb0d75f3108ae7e7e44f6b8bbbe964198a83a9,3,25,15,10,0,0,0,3,3,12,1,2,1.449185586,556,15,9,75,74,1,3421,3418,3,42,42,0,99.79550102
dac6f0d8f2a64069f0f7491c1e381fff4ce1a79e,1,16,5,11,0,0,0,3,3,13,1,1,0,326,16,10,65,63,2,2125,2063,62,25,25,0,100
1af4ebd73c86a63b188f56b2f8181fe8afa73c64,2,31,8,23,0,0,0,3,5,6,1,1,0.821280942,952,17,11,162,159,3,5612,5506,106,64,64,0,100
fc577dcbf7d8ddbf285c432bf6bc4fcffdf4c3f2,7,133,67,66,0,0,0,3,11,8,1,2,2.264041936,2283,18,12,358,356,2,14576,14216,360,141,139,2,100
e93a1d47f15cc3335b8d3e8a24b979c9850bc5e9,2,15,4,11,0,0,0,2,12,38,2,2,0.297472249,569,132,1,89,86,3,3364,3294,70,23,23,0,100
1c37965e9a9e23a8916d7b465fc4aa82011d6450,2,45,12,33,0,0,0,3,7,0,1,1,0.366578013,983,19,13,167,163,4,5877,5684,193,66,65,1,100
ae3c892cf4e8e6892264c17e3986038d68b1b614,1,1,1,0,0,0,0,2,2,56,1,1,0,215,10,6,32,32,0,1257,1257,0,12,12,0,100
fb17bea2390343d9712c501dd0727e5faa773604,1,10,37,27,0,0,0,5,13,2,1,1,0,368,11,7,48,52,4,1958,2103,145,16,15,1,100
6e8c93b44ae63aad3dfe64707e54a23975c508ce,3,47,36,11,0,0,0,5,15,142,1,3,1.126741171,461,12,8,65,65,0,2891,2808,83,20,20,0,100
c76c9bb7956604eb14731cf3b6f4d3fba19f0b79,0,0,0,0,0,0,0,0,0,0,0,0,0,0,20,10,0,0,0,0,0,0,0,0,0,100
7266f2f7071fabce4704ca2b23e29783d7d7dbd5,1,3,2,1,0,0,0,3,20,86,1,1,0,176,13,9,26,26,0,1002,998,4,8,8,0,100
bcc6b8b40c3dbf2e28d47be75d9fafe377f510d6,3,137,64,73,0,0,0,3,14,62,2,2,0.673549661,589,14,10,109,92,17,3768,3364,404,34,32,2,100
3aaef3d68b6f0afe78451ad677bddef8fb81929d,3,63,12,51,0,0,0,3,14,2,1,1,1.161160693,1045,133,2,160,155,5,6166,5999,167,52,51,1,100
b239190c0f9c641ad645ae5b281642487ff4735d,3,261,0,261,3,0,3,1,1,0,1,3,1.526139401,0,15,11,18,0,18,729,0,729,11,0,11,99.52542373
7de8f323dd29776ea8d576a066e05b1d548e77e7,0,0,0,0,0,0,0,0,0,0,0,0,0,0,21,11,0,0,0,0,0,0,0,0,0,100
80af387521a3a1aaa558df2741aa0fa92e34a9f1,0,0,0,0,0,0,0,0,0,0,0,0,0,0,1,1,0,0,0,0,0,0,0,0,0,100
7ead0f695b9fca88bef425fd9f7439aa37d65167,0,0,0,0,0,0,0,0,0,0,0,0,0,0,22,12,0,0,0,0,0,0,0,0,0,100
f29b409e6da41f374f8730fb31498043afa42bd6,0,0,0,0,0,0,0,0,0,0,0,0,0,0,23,12,0,0,0,0,0,0,0,0,0,100
6b5d21a13f0f30f677b0dcd19f825ff8ea0b4f1c,1,19,12,7,0,0,0,3,4,139,1,1,0,234,16,9,66,66,0,1231,1241,10,9,9,0,100
a397a9cafa160ebbf5cecf3f81df9982e42485c0,7,259,88,171,0,0,0,4,15,91,2,4,2.283886625,1221,17,8,183,168,15,8161,7185,976,80,75,5,99.52798382
90182e307a76144529e523cfac74b9313f0adc17,17,1321,64,1257,10,0,10,3,21,18,3,8,3.351184679,1768,24,13,388,262,126,15987,10823,5164,166,78,88,92.86199864
851235755de06bda588574d950d51b1a2e622be4,2,42,4,38,0,0,0,4,21,128,2,2,0.347816914,428,25,14,63,56,7,2552,2383,169,23,22,1,100
71c01c119c84207702583eee6410a28cdd092edc,1,3,1,2,0,0,0,3,3,220,1,1,0,106,1,0,9,8,1,631,627,4,6,6,0,100
6da647173efb6f83141a11dbef9298a5487212e4,0,0,0,0,0,0,0,0,0,0,0,0,0,0,18,8,0,0,0,0,0,0,0,0,0,100
999dda2d1fcb3332eadb6531c64787c5f112efd3,1,2,1,1,0,0,0,4,17,2,1,1,0,195,26,14,27,27,0,1113,1107,6,8,8,0,100
a87e4d2fcea8e6fdccff0867aa04ffa29f353876,0,0,0,0,0,0,0,0,0,0,0,0,0,0,27,15,0,0,0,0,0,0,0,0,0,100
829d289a1f90b4876d7b890d9efab69e66f4594c,1,1,1,0,0,0,0,1,2,71,1,1,0,376,28,15,67,67,0,2357,2357,0,15,15,0,100
92a7a0e1cff3b7e4297dd1856ec190904a99a722,0,0,0,0,0,0,0,0,0,0,0,0,0,0,29,16,0,0,0,0,0,0,0,0,0,100
c736fe92f2923390f960760634cf05bd1637c934,0,0,0,0,0,0,0,0,0,0,0,0,0,0,0,0,0,0,0,0,0,0,0,0,0,100
56c0c721a59df382c988b67cf6d899a035c40fe6,0,0,0,0,0,0,0,0,0,0,0,0,0,0,134,2,0,0,0,0,0,0,0,0,0,100
0efbeb7c08b9506f9377b456d7de434a14cd6076,0,0,0,0,0,0,0,0,0,0,0,0,0,0,19,9,0,0,0,0,0,0,0,0,0,100
9aacbd077bbabcf556abcdc5a85e87b3d1488c15,0,0,0,0,0,0,0,0,0,0,0,0,0,0,135,3,0,0,0,0,0,0,0,0,0,100
9f61713342d1e3fa71bc7ae2cc6006b6aa235e42,0,0,0,0,0,0,0,0,0,0,0,0,0,0,30,16,0,0,0,0,0,0,0,0,0,100
caf617344e63231f0f5a9780edd8a3c681505f4f,0,0,0,0,0,0,0,0,0,0,0,0,0,0,31,17,0,0,0,0,0,0,0,0,0,100
3953bb90b0fbf481c533be0df429a45b601e42bf,0,0,0,0,0,0,0,0,0,0,0,0,0,0,32,18,0,0,0,0,0,0,0,0,0,100
efe5bf033b6de360f9ec90209f9cecc5cf2efbd4,0,0,0,0,0,0,0,0,0,0,0,0,0,0,33,19,0,0,0,0,0,0,0,0,0,100
e03a4e3c08a150f4b362acbe468fd7b4b62780bc,1,6,0,6,0,0,0,4,5,138,1,1,0,267,34,20,43,43,0,1654,1652,2,16,16,0,100
19c770e365ee165d76166dc66ef7679abae6143d,8,109,85,24,0,0,0,2,8,122,1,2,2.998841715,970,35,21,120,120,0,5737,5737,0,56,56,0,100
b4740e05ad0b3de48f22d66a8e34e1f0853d199a,0,0,0,0,0,0,0,0,0,0,0,0,0,0,36,22,0,0,0,0,0,0,0,0,0,100
2bcc1d469bda0ada1358e66db3692ba2a69d51c9,0,0,0,0,0,0,0,0,0,0,0,0,0,0,37,23,0,0,0,0,0,0,0,0,0,100
33c05d2f7440e948ead1e9dd5b93436550bbac91,0,0,0,0,0,0,0,0,0,0,0,0,0,0,2,1,0,0,0,0,0,0,0,0,0,100
ce8527267f14ea59dffabdde6fc113385c2924af,0,0,0,0,0,0,0,0,0,0,0,0,0,0,20,10,0,0,0,0,0,0,0,0,0,100
30bdddb2944419e442e50e951e8b52a28c9e1f1c,3,26,1,25,0,0,0,1,3,52,1,2,0.725375928,478,38,24,79,75,4,2953,2813,140,20,19,1,100
e5cd28c80f4d0d69962ec1357308296636f7dae9,0,0,0,0,0,0,0,0,0,0,0,0,0,0,39,25,0,0,0,0,0,0,0,0,0,100
2f9604bf681af058bd0a308590f637fb9d7548e4,3,272,0,272,2,0,2,1,3,20,1,2,1.01932968,13,21,11,16,2,14,1208,99,1109,13,2,11,99.31271478
4d01c814b2321bad986b0aba177f849f93b0710e,0,0,0,0,0,0,0,0,0,0,0,0,0,0,22,12,0,0,0,0,0,0,0,0,0,100
fe90d425cd677ad5cc726883ceaaf8da821d293b,1,37,5,32,0,0,0,2,4,46,1,1,0,334,40,20,30,28,2,2822,2598,224,8,8,0,100
6dba9f74476438a0608e79077a99b6df0042d817,2,31,4,27,0,0,0,2,11,332,1,1,0.591672779,235,23,11,29,27,2,1297,1167,130,8,8,0,100
16bc151bde9806fa1986615855325f45a5d75a30,0,0,0,0,0,0,0,0,0,0,0,0,0,0,41,21,0,0,0,0,0,0,0,0,0,100
9aa0c23845f9b87cfc21d1c1e1e7690e839f5682,0,0,0,0,0,0,0,0,0,0,0,0,0,0,42,22,0,0,0,0,0,0,0,0,0,100
6641c324d39c98c6353168e942aad993bf009054,0,0,0,0,0,0,0,0,0,0,0,0,0,0,43,23,0,0,0,0,0,0,0,0,0,100
9f52b5f991b7d79fca92fd6c4e87cdf346ceab2e,2,4,3,1,0,0,0,3,5,126,1,2,0.985228136,300,8,0,26,26,0,1902,1883,19,16,16,0,99.79423868
2c486a309235120d197c8b36f93c15a51d97a8cf,2,3,4,1,0,0,0,2,4,276,1,2,0.985228136,301,44,24,26,26,0,1883,1902,19,16,16,0,99.79423868
bd098cee15e867f87f83656fe76a78f2fe61deb3,4,22,14,8,0,0,0,4,19,218,3,4,1.622070157,684,9,1,67,64,3,4226,4146,80,28,28,0,99.79423868
7606cdaaee2da69861a780570a4d1dc526412441,2,3,4,1,0,0,0,2,4,276,1,2,0.985228136,301,24,9,26,26,0,1883,1902,19,16,16,0,99.79423868
5929cc2dec7234372c39c7c9263a4093071ca849,0,0,0,0,0,0,0,0,0,0,0,0,0,0,3,2,0,0,0,0,0,0,0,0,0,100
acf02618c4413587de7182cc9d0299b46a9ff3b8,2,4,3,1,0,0,0,3,5,132,1,2,0.985228136,300,4,3,26,26,0,1902,1883,19,16,16,0,99.79423868
17509e2a28fa8db1a15c111a95c22ca489742f2c,0,0,0,0,0,0,0,0,0,0,0,0,0,0,5,4,0,0,0,0,0,0,0,0,0,100
61491f82974760ac5342861b31a9cd30c6a4c5d5,2,2,2,0,0,0,0,2,3,45,1,1,1,149,6,5,23,23,0,860,860,0,14,14,0,100
ea961c31f7d544552fec8d0da0a36518fa4a7adf,4,493,0,493,3,0,3,4,22,8,2,2,1.189680289,177,45,21,75,27,48,3045,1010,2035,27,8,19,93.98395722
5c22b171d65e236636f01b5c8d5d7a1b9b49a14a,1,1,1,0,0,0,0,2,3,1,1,1,0,69,25,9,10,10,0,403,403,0,7,7,0,100
3ddf4d783e582e168eaa7e36740d8b3fe98ba881,3,91,6,85,1,0,1,1,17,32,1,3,0.775472133,376,26,10,56,52,4,2668,2284,384,17,15,2,99.86928105
d81ffde48552cd3b3750a0b1b308513578040f52,1,8,4,4,0,0,0,4,7,67,1,1,0,345,27,11,60,60,0,2005,1976,29,31,31,0,100
a459732c0bf4af251c2e14189143acaf72bc0d0b,10,12,594,582,0,0,0,4,21,5,3,7,1.923732189,1468,10,2,162,214,52,6130,8578,2448,68,89,21,93.85847797
154b206820b22af1e963170777889c2762ee8aec,10,594,12,582,4,0,4,4,22,25,3,7,1.923732189,1047,11,3,214,162,52,8578,6130,2448,89,68,21,93.85847797
df3280bd03104a6bcfa544744ef09fd90227a647,0,0,0,0,0,0,0,0,0,0,0,0,0,0,28,12,0,0,0,0,0,0,0,0,0,100
93d2dde53218a02173053d6718d709295d2c0d28,5,16,8,8,0,0,0,2,16,107,1,2,2.134431504,1685,7,6,254,252,2,10147,10096,51,105,105,0,100
70e8262552e03fd2baf484a12661aa1e152c484f,1,1,2,1,0,0,0,4,22,40,1,1,0,554,8,7,101,101,0,3575,3570,5,17,17,0,100
b5f7b0b71e13e869b36041e2f1768e3fb97c7a6e,1,5,2,3,0,0,0,2,2,10,1,1,0,276,29,10,39,39,0,1693,1656,37,16,16,0,100
7c5fa8985ce4812c71a2f34aac5ddec11ef3a94b,1,5,3,2,0,0,0,2,3,0,1,1,0,279,46,18,39,39,0,1705,1693,12,16,16,0,100
165d99a8677a96760336b00d852c6451bb215ab7,1,2,1,1,0,0,0,4,23,6,1,1,0,554,9,7,101,101,0,3579,3575,4,17,17,0,100
d6e5a2dcb6b67db665eba95b4a99bcd34f58ba70,3,281,1,280,2,0,2,1,4,13,1,2,1.024925797,14,10,7,17,2,15,1120,115,1005,12,2,10,94.82220836
24f2d3858da37b6f6823bf29fb1effd0f334d15a,0,0,0,0,0,0,0,0,0,0,0,0,0,0,12,2,0,0,0,0,0,0,0,0,0,100
57fe281125c8c11ba9c17892946ce13de875fd89,1,139,74,65,0,0,0,2,5,97,1,1,0,301,11,6,36,32,4,1911,1561,350,11,11,0,99.7005988
81797b23ce3b9815ebc3b33b9c443da7e55af2c6,1,12,2,10,0,0,0,4,6,176,1,1,0,819,4,0,158,156,2,5356,5288,68,35,35,0,100
8cf91191a760e59e454b54a0d8f736fdcea1fdcd,0,0,0,0,0,0,0,0,0,0,0,0,0,0,12,6,0,0,0,0,0,0,0,0,0,100
5c3d966a7923b983271de882363cb1258460978e,2,64,50,14,0,0,0,2,6,66,1,1,0.175565026,389,17,0,40,36,4,2061,1969,92,12,11,1,100
a0a55703c875b79f7851fbc91ab22c96b27b6162,5,124,113,11,0,0,0,5,24,65,3,4,1.255263636,1519,0,0,246,242,4,9201,9133,68,81,81,0,100
dd1880231b7f8f64e2a0d4a43ebf7e95e0196562,1,1,1,0,0,0,0,3,5,317,1,1,0,53,13,6,9,9,0,400,400,0,7,7,0,100
1c84ab3e4b1ed63d0578e1f439fba38a0b841d33,1,5,0,5,0,0,0,2,9,40,1,1,0,218,30,4,38,37,1,1316,1290,26,8,8,0,100
40738b30296758b707ce7e496b20ba6ececd9186,0,0,0,0,0,0,0,0,0,0,0,0,0,0,47,1,0,0,0,0,0,0,0,0,0,100
e261fd905942b0f4bd86013fbe7f8251b44cf483,1,0,4,4,0,0,0,2,2,99,1,1,0,54,48,2,17,17,0,337,375,38,10,10,0,100
d389b50c2d145edd1d0a14f850d473c31f2a88f2,1,9,2,7,0,0,0,3,3,2,1,1,0,50,0,0,19,17,2,366,337,29,10,10,0,100
eaee4225a0cc8fa4c22f40cf6a47f282c3498865,1,2,0,2,0,0,0,3,12,236,1,1,0,125,31,2,13,13,0,655,622,33,6,6,0,100
73e5364b6683a5bbc4b1b93c5fab30be6ac66cc7,0,0,0,0,0,0,0,0,0,0,0,0,0,0,13,1,0,0,0,0,0,0,0,0,0,100
be6c13bdd3384d04001b234b2bb5d1e1e28aec52,0,0,0,0,0,0,0,0,0,0,0,0,0,0,14,5,0,0,0,0,0,0,0,0,0,100
b9960ab5ff33086c9923abe6d03700cd11146ffc,2,33,17,16,0,0,0,4,10,86,1,1,0.826746372,1049,18,1,177,176,1,6287,6274,13,61,61,0,100
17ba20b3f5293b74a887020fa12fee944e3f0e8d,0,0,0,0,0,0,0,0,0,0,0,0,0,0,14,2,0,0,0,0,0,0,0,0,0,100
2a55d67f5bf16a296c019c6b27b89943d356c8b4,1,4,1,3,0,0,0,4,11,4,1,1,0,695,19,2,113,112,1,4038,4014,24,36,36,0,100
303076f2c4e87e5b37c84e6fe9c666eeb60dbf49,0,0,0,0,0,0,0,0,0,0,0,0,0,0,49,2,0,0,0,0,0,0,0,0,0,100
525fb2336a6ccf049b9297384fa8bc90146f130f,2,18,10,8,0,0,0,4,9,128,1,1,0.749595257,625,32,2,69,69,0,4510,4434,76,29,29,0,100
25796ec1eefa69c3614d3e944bd7a18bdbef8ae9,0,0,0,0,0,0,0,0,0,0,0,0,0,0,15,2,0,0,0,0,0,0,0,0,0,100
cf474b4d5eaad8ee045b3eadcd0ebb19c1c55f9c,23,926,129,797,6,0,6,3,17,100,2,3,3.620998947,3610,33,3,564,482,82,27191,22571,4620,237,200,37,98.51720047
b5ac9b8f4679a812924d46c6b7a02348167094df,0,0,0,0,0,0,0,0,0,0,0,0,0,0,34,4,0,0,0,0,0,0,0,0,0,100
d656fae3f492b40281b875ba36793a8e488b5e8d,10,103,53,50,0,0,0,2,18,128,2,3,2.433414902,1268,1,1,171,169,2,6752,6621,131,80,75,5,99.5335277
1e414de8c5624f9585d86c8cf8e93b9e92b7fac3,10,53,103,50,0,0,0,2,19,0,2,3,2.433414902,1292,2,2,169,171,2,6621,6752,131,75,80,5,99.5335277
716b1e2d3e928bde9ddaf75f958bea06f4707824,15,570,53,517,5,0,5,1,20,0,2,7,3.082879958,1268,3,3,196,169,27,9206,6621,2585,91,75,16,93.43493552
e01403004af5aa5964f1df3312549c7bb9e2c686,1,12,7,5,0,0,0,2,2,358,1,1,0,67,20,2,10,10,0,354,310,44,1,1,0,99.94138335
5434b68c6de9434bfd468fd69e81204f496e2bcf,0,0,0,0,0,0,0,0,0,0,0,0,0,0,16,3,0,0,0,0,0,0,0,0,0,100
cf50359bd72aa1f5c54a5140009eb3bb7a0d2c02,4,1525,0,1525,4,0,4,1,1,0,1,1,1.500062562,0,17,4,268,0,268,8246,0,8246,129,0,129,99.47521866
5da69a2ca8560b6dec660e927d0d7e0b062207ed,3,120,3,117,1,0,1,1,13,302,1,2,0.736839647,155,5,0,23,11,12,1425,844,581,12,8,4,99.76838448
d25ef4242a5914e0cb1d5d4b2578fa77c3b20ce7,8,909,126,783,0,0,0,4,21,35,1,2,2.215285477,2807,21,1,475,401,74,23796,18406,5390,163,145,18,100
eb7eab6593e241d9f67308298871f5586734b657,2,206,259,53,0,0,0,5,22,0,1,1,0.962900415,1126,35,3,164,168,4,6161,6340,179,57,53,4,100
0c73dc7e784bd4bc67c1e1d3a91470769ac0473e,1,7,3,4,0,0,0,5,12,3,1,1,0,916,22,2,91,91,0,7267,7214,53,33,33,0,100
89308fa8da2525bcdbd81949c7286443db5f558f,2,22,44,22,0,0,0,5,15,1,1,2,0.195909271,1549,36,3,186,194,8,10810,10997,187,75,74,1,100
720b885352b5db56d470c7720c1b075287956f74,0,0,0,0,0,0,0,0,0,0,0,0,0,0,37,4,0,0,0,0,0,0,0,0,0,100
fc5d3f684861b49e54e7e81a7d393232d10d9e0a,2,222,12,210,1,0,1,1,4,66,1,2,0.629792143,397,50,0,81,71,10,3389,2475,914,21,16,5,99.65337955
0c0dbb878a273d194d7ff8075b7f999636f36f27,0,0,0,0,0,0,0,0,0,0,0,0,0,0,51,1,0,0,0,0,0,0,0,0,0,100
208f4e96b1dba1baef01c3a3ff2843ed789c2725,2,141,63,78,1,0,1,1,14,1,1,1,0.91331568,899,38,5,90,83,7,7473,7080,393,36,34,2,98.34757835
2c3bbb7c1f164ff94cc2c4d8d3bcb0edf0dd8431,0,0,0,0,0,0,0,0,0,0,0,0,0,0,4,3,0,0,0,0,0,0,0,0,0,100
0a9924bb4eb6af86a247ff671bc3f219654c655f,1,33,25,8,0,0,0,5,16,5,1,1,0,629,23,3,104,103,1,3757,3730,27,42,41,1,100
f90f1fbaa219b1f003ede09c96cf9591edfe7138,0,0,0,0,0,0,0,0,0,0,0,0,0,0,24,4,0,0,0,0,0,0,0,0,0,100
5289ccc566a02b7ca59e0f5ae39dd0a4369f48cb,2,45,1,44,0,0,0,5,15,5,1,2,0.858981037,1443,25,5,184,180,4,10981,10674,307,72,70,2,100
0dba90a42b8eb672d58e862fad8c498f71831717,1,3,3,0,0,0,0,5,17,9,1,1,0,637,26,6,104,104,0,3756,3757,1,42,42,0,100
8759c3b1533bf676f289fbb8a2bacb73deb19ff5,1,9,0,9,0,0,0,2,2,164,1,1,0,389,39,4,47,47,0,2617,2596,21,31,31,0,100
73e77a410a1a5b2ad9c0d202a0308d7c29f92fa7,0,0,0,0,0,0,0,0,0,0,0,0,0,0,40,5,0,0,0,0,0,0,0,0,0,100
c9ad851e5e37a42f3b4afde76b0d1bc372508c73,0,0,0,0,0,0,0,0,0,0,0,0,0,0,41,6,0,0,0,0,0,0,0,0,0,100
82aa5fc16dac3751b78f85fbe21b8c805dbffbcc,2,188,293,105,0,0,0,2,16,183,1,1,0.796971017,924,27,6,82,81,1,5858,7057,1199,39,36,3,96.23188406
63e0f43c5281a643af5709d4b09c15d03c142c77,1,2,1,1,0,0,0,3,5,27,1,1,0,342,42,7,61,61,0,2349,2349,0,5,5,0,100
6a188276d463e524f6c544c47aaaa85c16c65d5e,6,323,10,313,1,0,1,5,23,13,1,2,1.29267454,2118,28,7,333,289,44,15432,13585,1847,104,93,11,99.88052569
93c598fe9cc83338bbd36896aa54d2dca603af2d,0,0,0,0,0,0,0,0,0,0,0,0,0,0,43,8,0,0,0,0,0,0,0,0,0,100
cbd12b63f1000c93ffd719a1b96c9a4a7895fbcc,0,0,0,0,0,0,0,0,0,0,0,0,0,0,6,0,0,0,0,0,0,0,0,0,0,100
2379006bccd4b90e161d6a2c57f87755711354c8,1,17,2,15,0,0,0,2,2,6,1,1,0,236,7,1,38,35,3,1622,1534,88,8,8,0,100
01a81121b8a028c06201a022b50f537af7a8de44,0,0,0,0,0,0,0,0,0,0,0,0,0,0,15,0,0,0,0,0,0,0,0,0,0,100
873b032faa5d154bbc2869be16fe550ca1211c69,1,1,1,0,0,0,0,5,10,65,1,1,0,411,44,9,70,70,0,2490,2490,0,32,32,0,100
80699c46275fd8ad4be30de3cd1e3cd746b3ac26,4,50,4,46,0,0,0,5,25,215,2,4,1.419459096,1634,45,9,235,230,5,11944,11658,286,55,52,3,100
d36861bcea4e3afeb08bfddd46ce0f7533186f00,3,353,11,342,0,0,0,2,3,290,1,2,1.056180275,550,52,0,111,66,45,5858,3729,2129,46,36,10,100
680c2d7cd25d6b58d6d4b1a403bcc5ee196c568b,31,2358,708,1650,11,0,11,3,19,42,1,2,4.321621162,4441,46,7,786,611,175,37660,28893,8767,379,268,111,93.57569721
d3c85b1d77584205b82b13126330cf17ce0f5ed9,27,1616,97,1519,14,0,14,1,24,0,1,4,4.277784946,3931,53,1,697,546,151,32442,24810,7632,295,222,73,93.16529326
fb2ec005a779591338e2c1cb0c949a0a911e0e80,0,0,0,0,0,0,0,0,0,0,0,0,0,0,47,8,0,0,0,0,0,0,0,0,0,100
b9f36d12f57d7cd3ba8294b63002a3f40d40601b,2,24,7,17,0,0,0,2,2,0,1,1,0.962900415,212,48,9,27,24,3,1215,1136,79,16,16,0,100
f269c69bc26fcd81417bf499ccef4778030eaf46,0,0,0,0,0,0,0,0,0,0,0,0,0,0,29,3,0,0,0,0,0,0,0,0,0,100
f26c79f6d32b7893e0d60326e6992faa8ead0785,5,490,293,197,4,0,4,1,20,0,1,1,2.177477907,703,54,2,78,70,8,5705,5152,553,43,35,8,94.85495348
b6eae08eea4d1802ce6b72e99abb8c1122d2c55d,0,0,0,0,0,0,0,0,0,0,0,0,0,0,49,10,0,0,0,0,0,0,0,0,0,100
99708a1da0c7ae779511d28134f146747252d26a,0,0,0,0,0,0,0,0,0,0,0,0,0,0,16,1,0,0,0,0,0,0,0,0,0,100
17e65714b9ba83dbe856aad913d9efc9c72f7c61,2,94,8,86,0,0,0,2,3,70,1,2,0.95260921,168,30,4,28,18,10,1342,905,437,13,9,4,100
828e4e3dc206f94042ae1d1a085b850b65e8fb51,0,0,0,0,0,0,0,0,0,0,0,0,0,0,55,3,0,0,0,0,0,0,0,0,0,100
b77a758e1746e9adf7f184fcfa85924bf2e29f72,1,4,4,0,0,0,0,3,4,0,1,1,0,112,31,4,15,15,0,561,561,0,6,6,0,100
5c9091b55f6b20fe47967e95b60e81cb66fe0ed8,1,1,3,2,0,0,0,2,5,906,1,1,0,68,32,5,11,11,0,325,334,9,5,5,0,100
04c2de49522e6d66c3c2a199f8ed667b40a67534,3,12,0,12,0,0,0,3,8,593,1,3,1.554585169,177,33,6,26,23,3,674,590,84,26,23,3,100
3875a4b92178ee6407003c206a94713908ebeb41,1,11,0,11,0,0,0,4,15,230,1,1,0,75,34,7,10,9,1,588,501,87,6,6,0,100
52bd16ba965ce4c36498558dfe081350ec6736fb,6,22,51,29,0,0,0,2,21,6,1,2,0.894363803,1154,50,11,110,115,5,7456,7739,283,58,58,0,99.20339883
ff37f5a541769908f4b518c369590fd8685cea22,4,69,83,14,0,0,0,2,22,2,1,2,1.847235852,1032,51,12,105,107,2,6977,7056,79,57,54,3,97.2901169
31ca65cc0d2f14fac30163474aa1cdf79b5618f4,1,1,1,0,0,0,0,2,3,16,1,1,0,513,35,8,70,70,0,4093,4093,0,28,28,0,100
8f77db07ca58941bd64e40ad06d7d57ba4c79f01,8,6060,7,6053,1,0,1,1,6,7,1,2,0.030016343,975,56,4,1276,110,1166,42893,5478,37415,803,69,734,99.08944831
e6c64a8e3fd4d2ffe5d8505041738bdd4cc3f667,7,130,61,69,0,0,0,1,25,11,1,3,2.42164994,1123,57,5,126,126,0,7118,6485,633,48,47,1,100
c2bcda202e24c426329425a11623946c9df0b102,3,12,12,0,0,0,0,2,7,425,1,2,1.188721876,745,52,13,92,92,0,5357,5353,4,35,35,0,100
3080ce09ad2b730bee27bddd5a490de3855220e4,2,70,3,67,0,0,0,4,14,375,1,2,0.993357028,144,36,9,17,10,7,1162,763,399,9,7,2,93.42036554
fc86cd540d25cf43388cee01818d17cd8c30c5df,3,40,11,29,0,0,0,3,21,12,1,2,1.46182225,963,53,13,152,148,4,5816,5631,185,57,55,2,100
37b2b72ced3205aac04e683b2b7ae26e3043458f,2,121,11,110,0,0,0,2,5,1,1,2,0.967294779,526,58,6,68,57,11,4100,3367,733,34,31,3,100
23bfd9ed585911ebf769e90252430ed15e4d018c,2,12,0,12,0,0,0,2,5,88,1,1,0.650022422,112,59,7,15,13,2,400,348,52,14,13,1,100
960d03d8a5d3b56db15dd390435a3b359f3ac4fb,9,588,222,366,3,0,3,1,4,85,2,5,2.638986372,1407,60,8,235,197,38,11931,9957,1974,94,70,24,99.59349593
46659c7156565778068c012f07301aab426d0728,2,28,18,10,0,0,0,4,16,458,1,2,0.347816914,320,61,9,35,34,1,1919,1860,59,14,14,0,100
e38a3e636394687710b293d303813fe0df047fff,1,1,0,1,0,0,0,2,2,17,1,1,0,246,37,9,32,32,0,1721,1715,6,13,13,0,100
0e0e6346d77d6d55b29c2a87c35aaa7f4779f73f,4,23,5,18,0,0,0,1,26,8,1,2,1.811635142,671,62,10,76,73,3,3789,3693,96,22,22,0,100
f2960cd491c1ac499720fe468b1bb4f3330a726f,1,23,8,15,0,0,0,5,17,2,1,1,0,201,54,11,25,24,1,1222,1106,116,9,9,0,100
cc499166bc958bd11191a2d40d9d0cfde27a7bdc,8,89,62,27,0,0,0,1,27,2,1,4,2.730973131,1514,63,11,171,166,5,9439,9320,119,69,67,2,99.79746835
f54148a3f53e5c53bc3932b208f25373d3c6ccbb,6,146,48,98,1,0,1,4,22,9,1,2,2.218911675,1698,55,11,275,268,7,11169,10673,496,92,86,6,99.18533605
30293ea1e9421cc4684d8e997770fe6f171970eb,5,1360,0,1360,4,0,4,1,2,78,1,2,1.910678098,30,56,12,114,1,113,6705,77,6628,29,1,28,99.07834101
a78fc2663d705b28e6956b12e131f2df8a791359,0,0,0,0,0,0,0,0,0,0,0,0,0,0,64,12,0,0,0,0,0,0,0,0,0,100
466c519023028a4c72137c4a1063fd6296825e34,2,50,11,39,0,0,0,2,5,24,1,2,0.804717519,227,38,9,32,28,4,1582,1342,240,14,13,1,100
41a19a54f0d5e821621936783d06e0bc1397caf9,1,1,1,0,0,0,0,3,6,152,1,1,0,53,17,1,9,9,0,400,400,0,7,7,0,100
541b0c7e0baeeb5e53b5b630a38b60c68ffa2d81,5,103,36,67,1,0,1,3,23,23,1,2,1.614361014,1781,57,8,275,261,14,11182,11005,177,122,119,3,97.8974359
59f613b8580892fea4105c0ada09fb5f7916cec7,2,109,10,99,0,0,0,4,12,392,1,2,0.827506267,334,58,8,45,34,11,2458,1952,506,14,11,3,100
e4950a6d4dfe937436399c4527db08e276474168,3,22,36,14,0,0,0,5,28,36,1,1,0.938240048,1287,59,9,192,192,0,7255,7258,3,62,62,0,100
ddb789a459b2143331acd2b89f4606af5312069d,3,19,6,13,0,0,0,4,29,12,1,2,1.469182539,1163,39,4,134,134,0,7534,7508,26,48,48,0,100
2c3b3116e685078fc742d3d3aa5f498a5c9c3b52,2,58,22,36,0,0,0,3,7,22,1,2,0.848548178,457,60,9,59,55,4,2987,2750,237,24,22,2,99.38208033
79ff3adf0dfcd75b1a80261e6559a25eed1f3e08,3,71,4,67,0,0,0,5,30,17,1,2,0.740132231,1289,65,9,172,168,4,8693,8198,495,60,58,2,100
d1137017866f9c666f47b55452531e01a27fbdd8,3,71,11,60,0,0,0,4,26,157,1,2,1.043081728,942,40,4,156,153,3,6481,6143,338,37,36,1,98.67517174
3ae075b654ead86fadf3c58c0450c8b83fd7e6b5,5,56,4,52,0,0,0,4,8,36,1,2,1.853549921,758,61,9,93,85,8,5048,4558,490,52,49,3,92.00923788
33cbb41330717eca62ea04a5f3182bb7f2ce63d8,0,0,0,0,0,0,0,0,0,0,0,0,0,0,62,10,0,0,0,0,0,0,0,0,0,100
e068284b83858165b4d8a11cce0271c52dbbaa1f,1,3,1,2,0,0,0,3,4,0,1,1,0,56,41,5,7,7,0,272,269,3,3,3,0,100
3a43495035efbdd2e67124583827b3a5172bc284,0,0,0,0,0,0,0,0,0,0,0,0,0,0,42,6,0,0,0,0,0,0,0,0,0,100
bcf8e4324dc45141e63385e298f59854c62bc2e7,3,39,3,36,0,0,0,6,18,195,1,2,1.165784052,282,43,6,35,31,4,1579,1388,191,24,22,2,100
74d087d54e29286c5ee0216e8810ca7b5452d0ee,1,4,3,1,0,0,0,3,3,301,1,1,0,183,63,8,21,21,0,1059,1036,23,7,7,0,100
a76beeb61700f08bafeb625040379ebd56e000a6,1,1,1,0,0,0,0,7,31,8,1,1,0,497,44,6,64,64,0,2779,2779,0,16,16,0,100
246c1b0213a2089e6cb684d1d982cd03015fb09e,2,276,27,249,0,0,0,4,21,407,1,2,0.968586717,430,64,7,61,44,17,4185,2689,1496,23,18,5,100
0b59252e772e5d82067cb694285f6bf7f9cf41a0,1,1,2,1,0,0,0,7,22,17,1,1,0,278,45,0,41,41,0,1600,1599,1,12,12,0,100
d4dde03d1ff9e19796d9385e8f4a3e87311302f7,2,46,58,12,0,0,0,6,27,93,1,2,0.901429608,1326,46,1,164,159,5,9727,9838,111,38,38,0,100
781ec3fcd24e4165d3808f35a7228ba931ee29a0,0,0,0,0,0,0,0,0,0,0,0,0,0,0,47,2,0,0,0,0,0,0,0,0,0,100
dad3d735eb91cf89988dd6a6772fbecaa839315b,2,33,0,33,0,0,0,5,25,70,1,1,0.61361902,1238,65,1,227,222,5,7339,7122,217,99,98,1,100
d17c03019e1afd0e7e75522a46dcb12db0d71a97,0,0,0,0,0,0,0,0,0,0,0,0,0,0,48,3,0,0,0,0,0,0,0,0,0,100
9b3036074050271e53cccc3625b6b62545ed28b5,0,0,0,0,0,0,0,0,0,0,0,0,0,0,49,4,0,0,0,0,0,0,0,0,0,100
ab984d24babf80d502ee317c6337dc8b3d7d4163,0,0,0,0,0,0,0,0,0,0,0,0,0,0,66,2,0,0,0,0,0,0,0,0,0,100
ea17493a54b6340702f8d31d5d390403d8f423b9,0,0,0,0,0,0,0,0,0,0,0,0,0,0,66,0,0,0,0,0,0,0,0,0,0,100
bad9e9ab822068806c85c8857eca154d024a52db,2,18,16,2,0,0,0,1,3,104,1,2,0.908178347,596,67,1,90,90,0,4908,4927,19,23,23,0,100
250c4579033b36f2ea2e66a581e1c0834c627732,2,34,1,33,0,0,0,5,23,29,1,2,0.721928095,623,50,5,64,61,3,4360,4186,174,24,23,1,100
94f50ef9c37845964e515c489661df124d19aace,0,0,0,0,0,0,0,0,0,0,0,0,0,0,51,6,0,0,0,0,0,0,0,0,0,100
abf24bb0bd9ada7676a03f626004413d2a76b043,0,0,0,0,0,0,0,0,0,0,0,0,0,0,52,7,0,0,0,0,0,0,0,0,0,100
bc1928bc2e23293cb20f4bc2693a3bc262f507b3,9,1392,0,1392,9,0,9,1,1,0,2,3,2.791143517,0,68,2,130,0,130,6534,0,6534,106,0,106,94.24947146
5416e77e16bb1906ed3b64754301825c5aeea6b3,1,12,1,11,0,0,0,3,5,77,1,1,0,57,67,2,9,7,2,351,272,79,3,3,0,100
8f6d1a1df59fef97755ed5158b87bf723a2660f7,4,15,5,10,0,0,0,2,4,336,2,2,1.903701696,370,53,8,39,36,3,2579,2518,61,29,29,0,100
af34b7bf308779640b60a3508d9fb667f19c751c,1,5,8,3,0,0,0,3,6,13,1,1,0,68,68,3,8,9,1,335,351,16,3,3,0,100
6d083df627e7513307d328dd9c92748bd055de0b,10,1350,0,1350,10,0,10,1,1,0,1,2,3.01833563,0,54,8,98,0,98,6554,0,6554,49,0,49,98.91472868
cb6a35ce620f2e300546a001f4562ae881aa9045,6,153,29,124,2,0,2,5,28,105,2,3,2.27233469,1060,69,4,173,166,7,7228,6722,506,53,48,5,94.89115948
c27edd0e89bf7794c7fb69f1087fa2ce0191667e,1,10,1,9,0,0,0,2,2,32,1,1,0,77,55,9,12,10,2,476,394,82,5,4,1,100
babdb69a3eebdd4fca7f5edd30e6de1d0310d5bd,2,62,3,59,0,0,0,2,6,650,1,2,0.961236605,224,56,10,25,17,8,2195,1761,434,7,7,0,100
831a86fc5501a8624b184ea65e53749df31692b8,0,0,0,0,0,0,0,0,0,0,0,0,0,0,57,11,0,0,0,0,0,0,0,0,0,100
a8490fdb9b8e9216788d9e3d40f01fd5f4f33cda,1,4,1,3,0,0,0,3,5,235,1,1,0,116,58,8,16,16,0,684,678,6,11,11,0,100
e61e39597cb416b435b9e8c1bedda572f27f70d3,0,0,0,0,0,0,0,0,0,0,0,0,0,0,70,3,0,0,0,0,0,0,0,0,0,100
ab8dd8d570e4181e12de490bc26937f35349ff62,2,28,12,16,0,0,0,2,6,94,1,2,0.384311544,511,69,1,65,63,2,3347,3301,46,43,42,1,100
44c713f194da266a393a017e59093d6d1bb959b5,11,1620,37,1583,8,0,8,1,11,146,2,5,2.656619611,384,70,1,162,55,107,10139,2204,7935,68,16,52,94.85514486
d5ce8af76d40e75624a2efe88e5aeb58146bda10,1,8,3,5,0,0,0,2,2,1,1,1,0,472,59,6,32,32,0,3889,3880,9,18,18,0,100
c145b2b8c1ed7bc04e1b018085c519555cf61a21,2,11,4,7,0,0,0,2,3,0,1,2,0.566509507,734,60,7,74,73,1,5513,5479,34,31,31,0,100
e6ad27cb46704c798082a349c3801d8825eb8f32,19,224,2,222,2,0,2,4,32,414,2,12,3.292729715,2308,71,3,324,323,1,12829,12190,639,128,127,1,93.87048937
5c32ff30a186056bd5250d924b95a944aa9a03c9,1,1,4,3,0,0,0,3,4,9,1,1,0,474,72,3,32,32,0,3882,3891,9,18,18,0,100
a035a5d61495398da80d658a30a7cdb6c49300dc,0,0,0,0,0,0,0,0,0,0,0,0,0,0,73,4,0,0,0,0,0,0,0,0,0,100
107875af508541ab73311c875b6043b2eeab2da3,3,3,3,0,0,0,0,1,1,0,1,1,1.584962501,346,61,6,16,36,20,2494,3933,1439,12,27,15,99.37565036
ef6e5c7449e4b3c72786f08e6840e7fbb46b2785,0,0,0,0,0,0,0,0,0,0,0,0,0,0,74,4,0,0,0,0,0,0,0,0,0,100
2ebcda27f86189d492fc6947258f5a7a2656255d,2,45,20,25,0,0,0,2,2,620,1,2,0.937456171,123,62,7,11,11,0,781,542,239,10,10,0,99.84391259
4c6faee565518d154672210c6418bdad0bc42e85,2,42,32,10,0,0,0,3,8,176,1,2,0.877962001,661,71,2,91,90,1,4922,4816,106,34,33,1,100
ad5761289bab4c829e249ec4393b7773cc86491f,1,7,2,5,0,0,0,3,3,14,1,1,0,36,63,8,2,2,0,90,85,5,2,2,0,100
176168e93a8f04e473c01022fbe928f7e406cd27,0,0,0,0,0,0,0,0,0,0,0,0,0,0,64,9,0,0,0,0,0,0,0,0,0,100
ea638b868e0d20e2b047b3fc4681adebb29456cd,0,0,0,0,0,0,0,0,0,0,0,0,0,0,18,0,0,0,0,0,0,0,0,0,0,100
753387cbd137785e161a4adc06d26b91a61da4ca,0,0,0,0,0,0,0,0,0,0,0,0,0,0,65,10,0,0,0,0,0,0,0,0,0,100
fc5e35060e57838cbbc61855959e0a0b156e3fe1,0,0,0,0,0,0,0,0,0,0,0,0,0,0,66,11,0,0,0,0,0,0,0,0,0,100
cc585cc0416efc05201d4e785b94ff02ab2075bf,0,0,0,0,0,0,0,0,0,0,0,0,0,0,67,12,0,0,0,0,0,0,0,0,0,100
5a6a3b9b5557efdc306b4060313a26cac986e079,0,0,0,0,0,0,0,0,0,0,0,0,0,0,68,12,0,0,0,0,0,0,0,0,0,100
dbb39da97e3ee19fee393e49d7a9608d48a707ab,1,2,2,0,0,0,0,2,5,246,1,1,0,408,69,11,72,72,0,2584,2584,0,17,17,0,100
a085eb653768cbde4f89f9182c31ebc2074bca72,1,1,1,0,0,0,0,3,4,12,1,1,0,37,72,3,2,2,0,90,90,0,2,2,0,100
57695ffb93b99774fa3d8f627e97ccafa817fbc4,0,0,0,0,0,0,0,0,0,0,0,0,0,0,8,0,0,0,0,0,0,0,0,0,0,100
338630a681dc3c1a3bcf9f4ff7eef875ed2d00e7,0,0,0,0,0,0,0,0,0,0,0,0,0,0,73,3,0,0,0,0,0,0,0,0,0,100
d466e8cbc3f3c5a26e700b55732b1c059d23eb95,8,606,2,604,7,0,7,1,5,42,1,2,2.486192691,15,70,11,44,2,42,2365,132,2233,29,2,27,98.86714727
310e70ee3558f20422da3218d88342dffe6ad2cb,8,2,606,604,0,0,0,1,6,0,1,2,2.486192691,348,71,12,2,44,42,132,2365,2233,2,29,27,98.86714727
9f9c04813573d18c8055582c4cddbbba95c8693b,8,670,2,668,7,0,7,1,7,0,1,2,2.417192636,15,72,13,48,2,46,2667,132,2535,31,2,29,98.86714727
8e872bdca6ebf45449fe30e3dfdb08ce46ef717a,2,17,6,11,0,0,0,1,4,0,1,1,0.998635964,171,73,14,19,19,0,1365,1232,133,12,12,0,100
e559fe1a35314c399417aa01c04e3199264b0be8,0,0,0,0,0,0,0,0,0,0,0,0,0,0,74,15,0,0,0,0,0,0,0,0,0,100
b92359b51da4a5a0e0ea836fec8eb4e093d797fd,0,0,0,0,0,0,0,0,0,0,0,0,0,0,75,16,0,0,0,0,0,0,0,0,0,100
526a096b8e3c68bf3c34b05efd1021af0e2b7a90,0,0,0,0,0,0,0,0,0,0,0,0,0,0,76,17,0,0,0,0,0,0,0,0,0,100
84f4fa61b6607d8699bb28743b568f4a716b4288,0,0,0,0,0,0,0,0,0,0,0,0,0,0,75,4,0,0,0,0,0,0,0,0,0,100
881180b7efc929ead0085ba068cf1ac3c544c08b,0,0,0,0,0,0,0,0,0,0,0,0,0,0,74,4,0,0,0,0,0,0,0,0,0,100
d7747cfac8f64704fb39924c365a8ac343244b40,4,137,8,129,0,0,0,6,29,76,1,2,1.787727089,1797,75,5,236,224,12,13810,13056,754,62,61,1,99.1890522
f4a5e1345149cadca24598f15ddf203772b27f29,1,1,1,0,0,0,0,2,3,38,1,1,0,266,77,18,42,42,0,1622,1622,0,13,13,0,100
b5e29801a4f086fd413878b6df41205fdf1e31af,0,0,0,0,0,0,0,0,0,0,0,0,0,0,78,19,0,0,0,0,0,0,0,0,0,100
26b637a4994d0c835f5fbcbe8fd429d1b86d92ec,0,0,0,0,0,0,0,0,0,0,0,0,0,0,79,20,0,0,0,0,0,0,0,0,0,100
bf43d2e1884ae21d7a874dccce97c41444738dc3,0,0,0,0,0,0,0,0,0,0,0,0,0,0,80,21,0,0,0,0,0,0,0,0,0,100
48fbbd8e0da18123782e9f776bf3b7c352c8a79d,4,132,2,130,0,0,0,4,8,174,1,2,1.560949116,641,81,22,98,80,18,4696,3777,919,35,32,3,100
3501cdc6f645aec4922adc40c128bafe0777fc38,0,0,0,0,0,0,0,0,0,0,0,0,0,0,82,21,0,0,0,0,0,0,0,0,0,100
da84afe1013cab896fb1fcc11ea6e8e6dba87f3c,1,8,11,3,0,0,0,6,19,6,1,1,0,818,83,22,67,67,0,6568,6610,42,22,22,0,99.1890522
e257e3db054d8a8282bfb14187f2dadf8e3c13e4,3,40,3,37,0,0,0,5,20,525,2,2,1.338475092,417,76,2,45,41,4,2573,2370,203,14,12,2,100
ff75006dcea040f0013c77ed3823d1e5246014bf,1,9,0,9,0,0,0,4,7,70,1,1,0,166,84,10,28,28,0,985,980,5,9,9,0,100
0f0ae1e9a6b5054ef7d8f9b00969260946722874,0,0,0,0,0,0,0,0,0,0,0,0,0,0,85,11,0,0,0,0,0,0,0,0,0,100
87a451ef25fb3afc79d1d9ace0262f4128b5d2f0,0,0,0,0,0,0,0,0,0,0,0,0,0,0,86,12,0,0,0,0,0,0,0,0,0,100
a5d15473be529a5840122742d0669e7c7255b08d,0,0,0,0,0,0,0,0,0,0,0,0,0,0,87,13,0,0,0,0,0,0,0,0,0,100
2a72fb760ec2b3d4a29b3690248ff18d15e2ae8d,0,0,0,0,0,0,0,0,0,0,0,0,0,0,88,14,0,0,0,0,0,0,0,0,0,100
5bad32c7f65bb933405c418818a843e5dcbc57d5,0,0,0,0,0,0,0,0,0,0,0,0,0,0,89,13,0,0,0,0,0,0,0,0,0,100
930ac6461bd78992380d1eb7ca09ee2d341af3a4,1,1,1,0,0,0,0,4,12,71,1,1,0,194,90,14,27,27,0,1221,1221,0,5,5,0,100
261aa8d2bfdc06bff67c14f480c84126b850c764,0,0,0,0,0,0,0,0,0,0,0,0,0,0,91,15,0,0,0,0,0,0,0,0,0,100
59d0329a6ba0db46e012e41ebf695ac65fbf71f8,2,120,19,101,0,0,0,2,6,484,1,2,0.846274848,116,92,16,20,11,9,1522,888,634,10,7,3,97.92471042
97ed09e6f8255ee99ebb27cd10ef11a90830db24,40,1720,2296,576,8,0,8,2,33,514,4,17,4.544796632,4058,76,1,480,564,84,21814,24497,2683,163,226,63,88.36689038
aa549c4f27db848cb8900533fd0f16562d971aa2,1,29,2,27,0,0,0,7,18,40,1,1,0,302,93,16,57,55,2,1884,1831,53,16,15,1,100
2f5438dbdb0040e1d77d0fcc0cc12ba7705b4323,2,53,6,47,0,0,0,2,4,204,1,2,0.693965967,726,94,10,116,110,6,5877,5628,249,32,31,1,100
1c141029b13837be82b5cb79102f4197eb0cb5bc,3,193,13,180,1,0,1,1,4,199,1,1,1.059595596,212,95,11,39,21,18,1917,1135,782,10,7,3,99.43404441
e858adee407bf76cf2a036433ed4173714505924,1,6,5,1,0,0,0,6,18,254,1,1,0,218,96,12,25,25,0,1224,1222,2,9,9,0,100
aad551d3f45687193ef3323ba6a4584c15c6ad53,1,7,2,5,0,0,0,6,19,216,1,1,0,184,77,1,18,18,0,1198,1165,33,7,7,0,100
15af0ce125daf8b2383213bbc0294a39a37c4a07,2,161,17,144,0,0,0,2,7,116,1,2,0.239192619,269,97,13,29,25,4,3470,2195,1275,10,7,3,100
76ef54988701e405f37778b89092c1c2836f06fc,4,134,36,98,0,0,0,2,8,699,1,2,1.909609733,265,98,14,41,32,9,2112,1342,770,17,13,4,92.91564292
e4ed73c14e77877b7ce8d88ef4279cb9541e3a1a,11,633,96,537,1,0,1,4,27,199,1,2,2.73466123,2461,99,15,384,351,33,19113,15375,3738,179,155,24,97.30603448
8de68ea636c956b0fe7d2cc18ab21bc26d077405,1,20,5,15,0,0,0,6,16,398,1,1,0,285,100,16,42,37,5,1670,1561,109,15,15,0,96.97528587
5f12432514ccbdda51c8c03cafa9d4512e3a0594,1,3,3,0,0,0,0,2,3,0,1,1,0,98,101,17,14,14,0,509,513,4,4,4,0,100
eff07d2125b589d8a6915deb8d52ff53e9611337,3,80,15,65,1,0,1,1,8,235,1,2,1.290734467,908,77,1,173,171,2,6160,5778,382,38,37,1,99.71264368
e45d2fa33a23aee6d066bd0a4147cb215afa98c4,1,31,43,12,0,0,0,5,28,0,1,1,0,804,102,18,129,135,6,4623,4637,14,46,47,1,100
806a7b6ace9398de2645f073acc72de19913bfab,4,106,12,94,0,0,0,4,34,121,1,2,1.52965402,1593,78,2,230,220,10,10012,9463,549,81,77,4,100
52ac64d4d6a43b79d30d2215dab2fc4bae26e665,1,1,1,0,0,0,0,5,30,1,1,1,0,806,103,19,131,131,0,4678,4678,0,47,47,0,100
5b4a63983af262417b58c2e2b956f0b34d1b7070,9,122,8,114,0,0,0,5,35,159,2,5,2.63507824,2756,104,20,280,270,10,19331,18643,688,126,124,2,100
bdcad923e5f5aaf157c43a9f84e8c36c2f84171a,0,0,0,0,0,0,0,0,0,0,0,0,0,0,79,3,0,0,0,0,0,0,0,0,0,100
822e120aececa479cf9f5178d836cdc55852e23b,13,1438,3,1435,10,0,10,2,9,51,4,5,2.997763436,958,78,2,294,170,124,12958,6147,6811,105,38,67,90.88795909
d20c94ca61103632de2cd941a716dbd4d9c6d719,2,23,5,18,0,0,0,3,13,353,1,1,0.863120569,264,105,13,30,30,0,1428,1350,78,9,9,0,100
5b636c1237f51dc0a8a9c2b589747e0477dbb5fc,6,430,1,429,5,0,5,1,2,27,1,3,2.186890479,169,80,4,52,15,37,2440,879,1561,34,6,28,91.40271493
42bc88cc3373270a8db834d2586a6598ff0c86c6,13,1837,0,1837,13,0,13,1,1,0,1,2,3.338947985,0,81,4,159,0,159,9956,0,9956,89,0,89,95.06261181
278c85d9f93d545924e5d09068e0fcd7eb8b587a,0,0,0,0,0,0,0,0,0,0,0,0,0,0,106,13,0,0,0,0,0,0,0,0,0,100
03a68e5b2a4d557cebe34236ae9f71b827aa91ee,1,0,1,1,0,0,0,5,8,55,1,1,0,167,82,5,28,28,0,974,985,11,9,9,0,100
723de26ee207541417815835b1f59ebfac12419b,1,2,2,0,0,0,0,2,4,287,1,1,0,122,107,13,10,10,0,730,730,0,4,4,0,100
bc5d2908fe64c9f1a7b7d10c34144badb9befe77,1,1,0,1,0,0,0,4,4,481,1,1,0,163,108,14,13,13,0,1076,1069,7,8,8,0,100
3369b34320175fc9b1132ef3e1ac8551ae55492a,0,0,0,0,0,0,0,0,0,0,0,0,0,0,109,15,0,0,0,0,0,0,0,0,0,100
9040e49c0c95b66f3ff3a0c879d3a6ea0bf11443,9,145,15,130,0,0,0,4,10,211,1,2,2.062055348,1539,83,6,216,200,16,10245,9278,967,103,97,6,100
e320842da6d99bfe770045b4c44db284bd260fca,3,11,9,2,0,0,0,1,2,9,1,2,1.570950594,626,84,7,63,63,0,3987,3977,10,37,37,0,100
ae62279f8066b1e2728a579ce8384eca36180e9d,4,143,65,78,0,0,0,6,30,75,1,2,1.746058904,1917,110,16,243,238,5,14330,13821,509,65,63,2,100
df132ecd71abb7aee525191b09c807a69c3541e5,1,1,2,1,0,0,0,1,1,0,1,1,0,50,111,17,1,1,0,317,328,11,1,1,0,99.86807388
112e80a22a11f8a9dcee4cc13066c1615a4752c3,9,93,21,72,0,0,0,2,31,102,1,2,2.489859661,3060,85,8,429,422,7,20275,19823,452,204,199,5,100
0dacb250aab933abc077f8f72a616e5005a06135,20,450,239,211,5,0,5,1,31,408,2,3,3.94864792,1809,79,2,279,261,18,12259,11782,477,109,96,13,97.41935484
159f0bd26e80ca76bd6ff80901f9e6cc14efbc66,1,8,2,6,0,0,0,2,5,2,1,1,0,122,112,18,11,10,1,767,730,37,4,4,0,100
bd981bddd6b393d62512201b1fdfa8f29a0270d1,0,0,0,0,0,0,0,0,0,0,0,0,0,0,113,19,0,0,0,0,0,0,0,0,0,100
fad7251dbc13e74bb070691e7a5b643f2402b901,31,2652,768,1884,19,0,19,2,13,65,1,7,4.269893831,1525,114,20,279,169,110,16931,10260,6671,124,78,46,93.23076923
d66b877fd8d69a44ea22b8f146c2638cc234f511,0,0,0,0,0,0,0,0,0,0,0,0,0,0,86,9,0,0,0,0,0,0,0,0,0,100
e6ba1a418cde13999061a36b9cdb2111d8cffbf5,0,0,0,0,0,0,0,0,0,0,0,0,0,0,80,3,0,0,0,0,0,0,0,0,0,100
8522cfef78fe72d73f5127bd3fcdf00e7a9d383d,0,0,0,0,0,0,0,0,0,0,0,0,0,0,81,4,0,0,0,0,0,0,0,0,0,100
efd6d26c169d2f28d611c0b92b454b4a119432a6,0,0,0,0,0,0,0,0,0,0,0,0,0,0,87,10,0,0,0,0,0,0,0,0,0,100
88980d06b0b5b8af632055af104a4a6e03b32a62,1,39,13,26,0,0,0,5,14,0,1,1,0,193,88,11,33,27,6,1341,1192,149,4,4,0,100
123c7bf6dfff269a26a334af6fc8dd8c5786e758,0,0,0,0,0,0,0,0,0,0,0,0,0,0,89,12,0,0,0,0,0,0,0,0,0,100
5fdf673d1a9cbab9144286a3afc335f8fcf7cd6c,2,329,94,235,0,0,0,1,2,56,1,2,0.837329956,476,90,13,91,57,34,5046,3379,1667,38,25,13,95.2535497
1675d49a217a81753c67f48b56de543934ce117b,4,199,0,199,2,0,2,1,3,30,1,2,1.109733547,113,115,21,15,4,11,1572,641,931,14,4,10,99.28057554
9fba39cb9710b1cf87039acab9a84b29028d97ee,1,2,1,1,0,0,0,2,2,123,1,1,0,184,82,5,12,12,0,1337,1311,26,9,9,0,99.95454545
58173b8983027124a61783b4326dee3347ab7552,1,3,1,2,0,0,0,2,2,204,1,1,0,300,83,1,44,44,0,1911,1901,10,15,15,0,100
21c67ed590ff414c7bc1d821ca91cd7a9391468b,1,15,8,7,0,0,0,3,8,548,1,1,0,407,91,0,74,73,1,2532,2507,25,17,17,0,100
1a2e0d7a7629eb32821c780d48a2c17f4e76a59e,3,7,2,5,0,0,0,4,12,178,1,1,0.986426729,703,116,0,118,117,1,4507,4483,24,51,50,1,100
32fef9342caedcb243a32413473caec91becfa09,3,99,4,95,0,0,0,4,7,346,1,2,1.278785634,764,117,1,80,70,10,5553,4918,635,22,20,2,99.90909091
70fe963ecab62bebab76b9f97fbeb312b1176f9f,5,168,21,147,1,0,1,1,2,60,1,2,2.062103505,344,118,2,58,46,12,3111,2318,793,32,28,4,98.62511457
b447570ed990ef384c8940e1acc88742c55556ce,2,93,25,68,0,0,0,2,4,930,1,2,0.693965967,200,119,3,22,18,4,1671,1231,440,13,12,1,100
750809c70aa92225ed8df2ded0364d30a220405b,6,236,77,159,0,0,0,3,15,65,1,3,1.629319618,1272,120,4,172,151,21,9608,8937,671,63,49,14,98.90009166
11875237420eef3e47ad84e7998e2caff6fc2de6,6,174,6,168,1,0,1,1,21,70,1,2,1.876352081,1384,92,1,174,161,13,11011,10037,974,64,57,7,99.45454545
ab0894c7f014769a9b400e6b5cb2f5c055c6b065,2,2,77,75,0,0,0,2,2,106,1,2,0.937962644,441,93,2,39,54,15,2292,2729,437,21,26,5,100
11fada2026e34a704d9f710bdd24766c306d040c,3,120,20,100,0,0,0,4,8,18,1,2,1.088354181,850,121,5,94,80,14,6071,5553,518,27,22,5,100
960d7c4b053669d9eb7c24f032d55a2ff659820b,1,24,5,19,0,0,0,4,13,379,1,1,0,82,84,0,12,9,3,493,406,87,5,5,0,100
6d9ef1fd6c15748212b75daa628ae3a2a8654e30,2,1,2,1,0,0,0,4,9,18,1,1,0.918295834,205,94,2,29,29,0,1276,1287,11,12,12,0,100
4515117d56cff69accdf54ecbca0825ca6d71ab3,1,11,1,10,0,0,0,2,2,262,1,1,0,111,95,3,9,9,0,873,805,68,8,8,0,100
d95748ca7aa151f8f31dc5cbe9d431e8cf3f9a1e,0,0,0,0,0,0,0,0,0,0,0,0,0,0,122,5,0,0,0,0,0,0,0,0,0,100
07f4516f2d7d703cf1f79bc47624576bf8de9af2,2,17,3,14,0,0,0,3,9,159,1,1,0.992774454,203,123,6,30,30,0,1074,1064,10,11,11,0,100
c7a8ece37e443b54e2450815c4b3e03a011f3363,0,0,0,0,0,0,0,0,0,0,0,0,0,0,124,7,0,0,0,0,0,0,0,0,0,100
380588d0e3f5e95664053d921615bd3971cdf385,10,67,62,5,0,0,0,1,11,76,1,2,3.129557097,828,85,1,80,62,18,5334,5134,200,49,43,6,98.45594914
59c30364d8796a3806c8c2760682391d4eda1bae,1,16,12,4,0,0,0,4,8,490,1,1,0,263,86,2,38,36,2,1536,1557,21,16,16,0,100
d45af178e6f71bea4484fbb0e94d6449f88e0b86,2,36,3,33,0,0,0,1,25,164,1,2,0.477071306,360,96,4,46,43,3,2533,2283,250,14,12,2,100
3df65e12c8d480cd46f190a0bb4addfee4272062,4,79,39,40,0,0,0,2,3,102,1,2,1.117096231,507,87,3,50,42,8,3384,3154,230,33,27,6,100
04b21c0b01b356c46b6381df9714ac96e45e188b,0,0,0,0,0,0,0,0,0,0,0,0,0,0,88,4,0,0,0,0,0,0,0,0,0,100
c1e3d5041b065f46cfc78a02ae835ed3711d7955,1,3,0,3,0,0,0,4,10,399,1,1,0,348,89,5,63,61,2,2414,2389,25,5,5,0,100
001d4860e16e690d8135f63bf864200c24b04ee8,4,31,9,22,0,0,0,1,4,28,1,3,1.618080127,716,125,7,106,105,1,4418,4305,113,39,38,1,100
f32e8cd4c529b1b334d8adf0282647eac3472294,2,37,0,37,1,0,1,1,10,2,1,2,0.179256067,167,97,5,29,28,1,1083,979,104,10,9,1,99.54669084
ea5ac469ee31dafe0fb4d300afe9fc6774df278e,2,29,4,25,0,0,0,1,4,0,1,2,0.32984607,548,126,8,94,93,1,3693,3477,216,34,34,0,100
520de5153456a3a40da688f8e1b6bc5bbf46703f,0,0,0,0,0,0,0,0,0,0,0,0,0,0,90,6,0,0,0,0,0,0,0,0,0,100
f06a44bdc5533e233bf2672b68f23c2d8a44c8bb,0,0,0,0,0,0,0,0,0,0,0,0,0,0,91,7,0,0,0,0,0,0,0,0,0,100
40043fe2f5ebc74f55c2a50f3ac04bb4f887833d,0,0,0,0,0,0,0,0,0,0,0,0,0,0,98,6,0,0,0,0,0,0,0,0,0,100
dca895d80e68513ac2b6840d116824b4d6d0e182,0,0,0,0,0,0,0,0,0,0,0,0,0,0,99,7,0,0,0,0,0,0,0,0,0,100
f5d31f7a68e87c8bcc9ca5d43e5a29180d35b47d,1,0,2,2,0,0,0,7,22,35,1,1,0,330,127,9,59,59,0,1924,1942,18,16,16,0,100
001b3824020c5ad36a965d515061353627923bdc,1,5,1,4,0,0,0,2,2,166,1,1,0,97,9,0,13,13,0,544,510,34,2,2,0,100
d203236b21d350f13c8cb6bb1ef69f2aa5501dcb,3,77,6,71,0,0,0,3,36,140,1,2,1.204814623,1716,128,6,237,227,10,10898,10501,397,95,88,7,100
60da3d8606415202f966017a18084cb59d3e64d1,17,4446,595,3851,6,0,6,2,9,472,3,5,2.968905436,3058,129,1,1359,688,671,42265,20850,21415,646,318,328,99.41467807
c35b7c947915f7bce4da0b00938ec777d45fee31,4,511,2,509,2,0,2,1,11,26,2,3,1.21004744,206,130,2,77,30,47,4166,1084,3082,25,11,14,96.00928074
5294ee61e71e24b33ab3e4b94bd3b1c03a35475d,4,655,209,446,3,0,3,1,18,165,1,2,1.89566181,196,131,3,43,27,16,2462,1113,1349,15,8,7,91.38461538
d898d7efdf6b16554a07c55ede810ab930ec00c8,1,9,1,8,0,0,0,3,6,112,1,1,0,260,92,0,36,36,0,1778,1778,0,14,14,0,100
510f63ba39592e7912a85c35effb8be52699057a,3,36,0,36,0,0,0,3,9,127,1,1,1.328469066,706,5,0,85,80,5,4050,3852,198,24,24,0,100
ce05be585f1cb91a3a00ccdfdeaaf5800ada6c35,1,5,8,3,0,0,0,7,23,56,1,1,0,328,100,0,58,59,1,1904,1924,20,16,16,0,100
17e6f1af786fc37abc57c08bac3b81ccfc9bd765,0,0,0,0,0,0,0,0,0,0,0,0,0,0,101,1,0,0,0,0,0,0,0,0,0,100
7006510b89bbb8cde98fbfac0c2fc7d325c63162,3,420,1,419,2,0,2,1,5,38,1,2,1.001892354,110,102,2,51,16,35,2612,590,2022,28,9,19,99.74667511
6293146224a261d340b39824ce7dadcda9b1efd7,4,137,10,127,0,0,0,6,32,345,2,4,1.387122409,1729,93,1,250,242,8,13149,12378,771,61,58,3,98.00878477
ed4cae79f8ab66a71960dfa2bdb848f8141ca6bd,3,126,134,8,0,0,0,5,33,49,1,2,1.247778877,1147,94,2,170,173,3,7707,7623,84,41,44,3,100
17338bf303e617054576813b02d057b98753b6aa,9,376,21,355,1,0,1,3,25,96,1,2,2.109736126,1187,103,3,184,150,34,9459,7906,1553,72,63,9,98.00995025
d10a6bd1e3a2f948573ace346a37f1d14ee6d14f,0,0,0,0,0,0,0,0,0,0,0,0,0,0,19,0,0,0,0,0,0,0,0,0,0,100
e72e559baa589787bcba233e29882e28e0ff43ef,8,553,49,504,0,0,0,4,20,470,2,6,2.776375383,1606,95,2,247,196,51,12301,9811,2490,115,81,34,100
b28b87b58b2b08d31cac055cb3f9f8762f65b469,2,109,6,103,0,0,0,3,26,22,1,2,0.364299029,682,104,1,99,93,6,5000,4430,570,24,23,1,100
13b8252bdeb838c606f4453bdf757fb2a1101eb8,3,149,50,99,0,0,0,5,14,342,1,2,0.922315901,450,132,0,55,45,10,3259,2614,645,22,14,8,100
8ea3f0fb3d211b7bf18e061bfc3b2dc825285f90,1,6,4,2,0,0,0,4,13,193,1,1,0,381,96,2,73,73,0,2478,2477,1,28,28,0,100
082cfb498e95ae95e88d49d357839eab8ab3bf33,1,1,2,1,0,0,0,5,7,256,1,1,0,248,18,0,39,39,0,1575,1586,11,8,8,0,100
ce48a126e8ceebe0fb0eb4048c6b6601688e442d,2,101,0,101,0,0,0,5,11,18,1,2,0.968586717,532,19,1,66,60,6,4089,3404,685,29,27,2,100
9204456eee8522201649b31a949a5a77710c1b2e,4,21,19,2,0,0,0,5,37,123,1,2,1.256779649,2180,20,2,326,325,1,13462,13422,40,120,119,1,100
84fbbdecf95db1a88245f57eae0c4086ecca96ed,1,13,10,3,0,0,0,5,11,8,1,1,0,240,133,1,24,23,1,1711,1676,35,12,12,0,100
c470e9fd855e0dc9d2e97aad0651ab08ad10a450,0,0,0,0,0,0,0,0,0,0,0,0,0,0,97,2,0,0,0,0,0,0,0,0,0,100
fc0b9b8cd27ebe2ff764d10f441cc332a6629f52,2,2,0,2,0,0,0,4,4,92,1,1,1,1709,98,3,423,423,0,12541,12537,4,197,197,0,100
4d0814630b328f64f33627dcde12bf8d0b086ead,1,1,1,0,0,0,0,2,5,144,1,1,0,142,99,4,13,13,0,735,735,0,5,5,0,100
46dadc63e540bca52fe87557762506ed55cd5a3a,1,4,2,2,0,0,0,3,3,93,1,1,0,126,100,5,15,15,0,800,796,4,5,5,0,100
3b29a3c07cbd6e5ac70cc55e506ffaf7ceecfbe2,0,0,0,0,0,0,0,0,0,0,0,0,0,0,101,6,0,0,0,0,0,0,0,0,0,100
8feadf734e19952ced9aa9155e8e8f48a7d07f8c,1,4,4,0,0,0,0,5,10,279,1,1,0,840,102,7,161,161,0,5449,5449,0,36,36,0,100
4c5220bb7fe00fafcb203d230eb6edb2d1f2b660,1,1,1,0,0,0,0,5,26,147,1,1,0,269,103,8,40,40,0,1748,1748,0,9,9,0,100
2f6fea50965e5a8ae059d179b0b25be738696cef,3,35,5,30,0,0,0,5,34,47,1,2,0.975809392,1188,105,1,176,176,0,8039,7849,190,42,41,1,100
c0c4947b295013d051dad98c07b87deaa9427af2,0,0,0,0,0,0,0,0,0,0,0,0,0,0,106,2,0,0,0,0,0,0,0,0,0,100
30da63bd669b8089b65acde7c2bab3534bf1b583,0,0,0,0,0,0,0,0,0,0,0,0,0,0,134,1,0,0,0,0,0,0,0,0,0,100
3f4298cd5ffeb645c73585d0fc346ac9eb73deb7,0,0,0,0,0,0,0,0,0,0,0,0,0,0,104,0,0,0,0,0,0,0,0,0,0,100
44d899643a1a033d7aa002e243891f2c43ecbe1b,0,0,0,0,0,0,0,0,0,0,0,0,0,0,105,1,0,0,0,0,0,0,0,0,0,100
172355c0aa3cf488375739a106cd248637608cab,0,0,0,0,0,0,0,0,0,0,0,0,0,0,106,2,0,0,0,0,0,0,0,0,0,100
7c8e0bdabd7ee4af0b08e366baa282cb95fdbd69,0,0,0,0,0,0,0,0,0,0,0,0,0,0,107,1,0,0,0,0,0,0,0,0,0,100
612a5199a551fddeffcffa48cee9f3e679d5459a,2,16,2,14,0,0,0,2,5,940,1,1,1,137,108,2,17,17,0,617,607,10,10,10,0,100
35356530fd9fa8bc1fa3fd3a22692d5fac25d037,0,0,0,0,0,0,0,0,0,0,0,0,0,0,135,1,0,0,0,0,0,0,0,0,0,100
df7a197a51bdb326149255fdad4db01ca886ba57,1,1,0,1,0,0,0,4,14,232,1,1,0,101,136,2,12,12,0,506,493,13,5,5,0,100
6ca616800ec897551fbb14959ce3a5f0c1d69aed,16,1102,227,875,0,0,0,4,38,282,1,3,3.24455834,9849,137,3,1955,1818,137,69171,64616,4555,1059,996,63,100
c72a3b1a5a2548f9157fe7913611c4318ce5e64d,11,618,1502,884,0,0,0,3,5,147,4,4,2.604014411,5154,107,3,1080,1212,132,30510,36678,6168,508,585,77,96.44056414
4aaf4a3f86d8ede60dc85a69e8131d2bd8581fca,2,27,10,17,0,0,0,5,11,28,1,1,0.303374836,983,21,0,134,134,0,7270,7103,167,72,72,0,100
961b995a0432a58d43a01a3ca537ecb153d99b22,0,0,0,0,0,0,0,0,0,0,0,0,0,0,20,0,0,0,0,0,0,0,0,0,0,100
66e707fe8e38ac8a28058b845bc28164442d55f6,0,0,0,0,0,0,0,0,0,0,0,0,0,0,109,2,0,0,0,0,0,0,0,0,0,100
1074fd05bb9693561b17602bb1497b805d14fd7c,0,0,0,0,0,0,0,0,0,0,0,0,0,0,108,1,0,0,0,0,0,0,0,0,0,100
41ca44be52e65845b359307f637282d794a345e4,2,74,9,65,0,0,0,6,15,107,1,2,0.882758679,501,109,2,60,56,4,3641,3183,458,23,22,1,100
6662b34c03511be65cdad8ead04860f7b0ab5fa6,1,1,1,0,0,0,0,2,5,249,1,1,0,418,110,3,72,72,0,2501,2501,0,27,27,0,100
0a855488a152cf695e2e1e2f89b67ed2e3095422,2,90,8,82,0,0,0,3,7,164,1,2,0.876244167,357,110,1,81,77,4,2515,2200,315,21,18,3,100
496b7c2da4e3bcde836968f823c67c57b85f1ede,1,20,14,6,0,0,0,6,6,207,1,1,0,248,111,3,30,30,0,1467,1437,30,8,8,0,100
609a190e3f26462e540a0f25fdb56acd79af8ddc,3,136,18,118,0,0,0,6,16,58,1,2,1.115338083,586,111,2,74,60,14,4404,3752,652,26,23,3,93.38908801
ea87b1192a839cd376075eba351da7514cb66952,0,0,0,0,0,0,0,0,0,0,0,0,0,0,112,4,0,0,0,0,0,0,0,0,0,100
1da1e53248910efb18ad9207df963335da4d19de,2,15,3,12,0,0,0,3,4,992,1,1,0.99107606,204,113,5,15,13,2,1389,1313,76,8,8,0,100
215d75eb15362f34cd3246107cbea7ace247af10,1,116,5,111,0,0,0,3,7,528,1,1,0,126,114,6,19,18,1,879,712,167,12,12,0,100
1149740d0e34b7a2d7197c943e0be97009d93777,0,0,0,0,0,0,0,0,0,0,0,0,0,0,115,7,0,0,0,0,0,0,0,0,0,100
93f03ab440f8381bf940f1ddd41fdc2d91712fc2,4,143,2,141,2,0,2,1,6,38,2,3,1.901306043,139,112,3,23,17,6,986,617,369,16,10,6,96.85251799
2e1b7c23c4964b8860b876cc5c8c3642c4d74ab9,2,65,4,61,0,0,0,4,10,162,1,2,0.903116172,665,113,3,117,107,10,4554,4183,371,40,39,1,94.28455614
fac09aa5f543f251acbe3aa205b470562b93b344,4,56,7,49,0,0,0,5,11,200,1,1,0.604665149,407,114,3,72,63,9,2795,2528,267,27,26,1,100
821591f503d28b9d6cdc1fac39078006e00254f8,0,0,0,0,0,0,0,0,0,0,0,0,0,0,115,4,0,0,0,0,0,0,0,0,0,100
838135885e9382a36395eace89aa8cdb04926dbf,4,76,5,71,1,0,1,1,12,244,3,3,1.590178334,268,116,5,37,34,3,1657,1404,253,18,15,3,99.89090909
71df908d05c63095ad12082b9ecf1390ee98a400,3,36,18,18,0,0,0,2,3,545,1,2,1.071488098,443,117,6,38,37,1,2869,2760,109,25,24,1,100
3efb93f280d603aee4bbcf23ee130826af1c213c,0,0,0,0,0,0,0,0,0,0,0,0,0,0,118,7,0,0,0,0,0,0,0,0,0,100
7a6e3db005dfc7848eeb62b6e66b91dc00a7f726,4,74,6,68,0,0,0,4,39,89,1,2,1.349674337,2575,116,5,368,363,5,16556,16083,473,153,149,4,100
458a1a2f758fa03b56c46246f830354151089c16,2,15,16,1,0,0,0,2,4,2,1,1,0.554778163,209,117,6,16,16,0,1041,1029,12,6,7,1,100
d4c1bc07bc33e10cfdc5eca11b085e269dbea60d,1,16,1,15,0,0,0,3,4,167,1,1,0,224,118,7,31,30,1,1365,1283,82,9,9,0,100
cdb4766f1a907a8dfedc1f7a55b3b4edbe3cdaea,2,55,5,50,0,0,0,2,5,456,1,2,0.90071968,757,119,8,125,116,9,6208,5877,331,34,32,2,100
c2f559482f60cea4899dc0dc57a88c7087755823,0,0,0,0,0,0,0,0,0,0,0,0,0,0,120,9,0,0,0,0,0,0,0,0,0,100
6b910371268685122c2d9fbff8e7ed7f46acbcbb,8,619,30,589,4,0,4,2,3,212,1,2,2.559645662,637,121,5,104,65,39,6567,4221,2346,65,32,33,98.36879433
40040326763cdc655ea2707d8cb90a46791192c8,4,181,23,158,0,0,0,3,6,261,1,2,1.945770762,560,122,6,78,57,21,4449,3693,756,41,32,9,100
51da4db4daded80c3c2ce1a7d69ea8482c769199,1,1,1,0,0,0,0,5,13,11,1,1,0,170,119,7,28,28,0,999,999,0,9,9,0,100
e9719a8897b7cce196aabbac84c207a1c906886f,4,120,10,110,0,0,0,3,7,0,1,2,1.686018266,696,123,7,91,78,13,5047,4449,598,50,41,9,100
34621d7ea81b3472ffac4bf03c2cece5a86da30f,1,28,40,12,0,0,0,7,28,168,1,1,0,430,124,8,71,73,2,2428,2466,38,15,17,2,100
a13e9e6a8b78ae0ea4ac7794ad121d2a1f9b25ab,1,1,1,0,0,0,0,6,7,67,1,1,0,254,120,6,30,30,0,1467,1467,0,8,8,0,100
669e5d327720021391245949d6a947b4e963b728,4,83,8,75,0,0,0,3,8,850,1,2,1.429366465,988,121,6,110,108,2,7719,7116,603,35,33,2,100
8594feba3bca657887957613910dffe42b0f9221,0,0,0,0,0,0,0,0,0,0,0,0,0,0,138,0,0,0,0,0,0,0,0,0,0,100
1e66428c6414af8c83f24c810bd770c292f0fb5a,0,0,0,0,0,0,0,0,0,0,0,0,0,0,122,2,0,0,0,0,0,0,0,0,0,100
eefefa941a60c0982f0957804be0cafb4d83e46e,2,58,7,51,0,0,0,1,2,1048,1,2,0.961236605,259,123,3,23,19,4,2230,1797,433,12,11,1,100
d63c378b551bba338677d50a36d254dd8c62fe4a,2,25,11,14,0,0,0,2,3,6,1,2,1,301,139,1,23,23,0,2348,2230,118,12,12,0,100
e442c29a646723a75d67fe4dd189cc304dfd4af4,2,75,20,55,0,0,0,2,4,2,1,2,0.957295188,313,140,2,30,23,7,2730,2348,382,13,12,1,100
791f443fae173054cf29ac52fee8e9cf7fe70dc7,1,23,6,17,0,0,0,6,8,62,1,1,0,254,124,2,32,30,2,1553,1467,86,8,8,0,98.14876033
c57ebd1d2296fd1c0c8f84eecb16799de2a73e35,21,1601,619,982,7,0,7,1,40,201,2,5,2.836544931,10251,141,2,1953,1836,117,73229,68089,5140,1058,1015,43,97.29812711
a964e7ab3cfacbafb7e086d49ae2b94195b9c0df,5,720,21,699,0,0,0,3,21,253,2,4,1.814185128,1354,125,0,223,167,56,12771,8767,4004,85,62,23,100
a97c04657b4735d6759f7b66bc9b4df451ab3aab,1,2,4,2,0,0,0,7,29,89,1,1,0,422,126,1,71,71,0,2416,2428,12,15,15,0,100
7eb9acc503b01b8c298f457b6d95575022af821d,0,0,0,0,0,0,0,0,0,0,0,0,0,0,127,2,0,0,0,0,0,0,0,0,0,100
337e5fc3768af2d26a9a9dbfaa1e5afa30ae26bf,0,0,0,0,0,0,0,0,0,0,0,0,0,0,128,3,0,0,0,0,0,0,0,0,0,100
296fc9f92b51bbe9c674cede560ab7be8a03e161,1,9,7,2,0,0,0,2,3,200,1,1,0,180,129,4,20,19,1,1122,1114,8,5,5,0,100
cf6298415caca606d44fb8a1833337a23d6088d4,17,2413,0,2413,17,0,17,1,1,0,1,2,3.749250683,0,125,1,251,0,251,10987,0,10987,171,0,171,98.49023091
e048160e043e4aa57fc49cc33f2640e60677cbe5,5,616,9,607,3,0,3,1,8,312,2,4,1.957546686,207,130,5,83,31,52,4440,961,3479,48,17,31,99.59302326
b8cf789b8509b1e5be05dd0b0b16c5d9af9698ae,4,26,16,10,0,0,0,3,22,16,2,4,1.329401733,1842,126,2,222,222,0,12540,12495,45,84,84,0,100
cbd4c6580f83147511459fa7443f54ac4f1b847f,1,5,2,3,0,0,0,5,12,17,1,1,0,311,127,3,48,48,0,2144,2122,22,22,22,0,100
e60de9322fbd4bd7ae96034ef86af0b65a180da6,1,4,2,2,0,0,0,5,14,18,1,1,0,442,128,4,50,50,0,3226,3211,15,25,25,0,100
ad68350ffcc9a6cb47b7b555b9ebf6dacfa7c129,7,539,1,538,5,0,5,1,3,144,1,2,2.091550228,183,129,5,65,28,37,3451,1016,2435,40,14,26,93.35273053
b455486c283ed048f0fb2ebffe115c04a8f81894,0,0,0,0,0,0,0,0,0,0,0,0,0,0,130,6,0,0,0,0,0,0,0,0,0,100
862c83187a1ea443142b49df8e86671e55d927d6,1,17,8,9,0,0,0,2,6,296,1,1,0,142,131,6,14,13,1,800,735,65,5,5,0,100
7d131b6a0d123b7d7f515cc6a9da001626263a17,1,12,7,5,0,0,0,4,15,233,1,1,0,102,132,7,13,12,1,544,506,38,5,5,0,100
b22f0415c0e73ce5a98cbdbbaa23bcdd932f15af,0,0,0,0,0,0,0,0,0,0,0,0,0,0,133,8,0,0,0,0,0,0,0,0,0,100
139e95c9529d256e015d9edb32955832b7f5508e,1,2,1,1,0,0,0,6,19,588,1,1,0,220,131,6,25,25,0,1226,1224,2,9,9,0,100
9f3a530f6ec9dcaa297fe77d4ef8b648b8f5873d,1,84,13,71,0,0,0,2,4,23,1,1,0,182,134,9,25,20,5,1432,1122,310,5,5,0,100
a06a56085bd810929f27764925eb1b3f6006fb01,0,0,0,0,0,0,0,0,0,0,0,0,0,0,135,10,0,0,0,0,0,0,0,0,0,100
53649f06fef8852c28a87376cb1bfe365b4df8d8,0,0,0,0,0,0,0,0,0,0,0,0,0,0,136,11,0,0,0,0,0,0,0,0,0,100
5e53866c30388cb9abc8dc33307827f9e57f642b,0,0,0,0,0,0,0,0,0,0,0,0,0,0,137,12,0,0,0,0,0,0,0,0,0,100
1e2261ce04c9725256b5e99812e04cc1ceb3d636,1,1,0,1,0,0,0,3,4,130,1,1,0,131,138,13,11,11,0,931,924,7,10,10,0,100
4c9e85ab5582f50e2faba9ab1f01d60395c5fc90,0,0,0,0,0,0,0,0,0,0,0,0,0,0,139,14,0,0,0,0,0,0,0,0,0,100
83e4fe5f7a15ac0c4c8b5aee5e910169e189b051,0,0,0,0,0,0,0,0,0,0,0,0,0,0,140,15,0,0,0,0,0,0,0,0,0,100
171310fb1ab9316dd1d72126acbefd4ef4727043,0,0,0,0,0,0,0,0,0,0,0,0,0,0,141,16,0,0,0,0,0,0,0,0,0,100
15f280f75135f69778f04557ed67e230dea7e2bd,1,13,3,10,0,0,0,2,3,139,1,1,0,249,142,17,23,22,1,1893,1840,53,19,18,1,100
b8c4b003a8273b17e8641a9e5bcafd2357fbd370,3,106,8,98,0,0,0,4,37,30,1,2,1.361220667,1860,142,1,309,301,8,11810,11377,433,138,134,4,100
97170aebf4240e1f7c628650b621f3f4c3178dc0,5,294,31,263,2,0,2,5,13,256,1,2,1.499601293,623,143,2,109,88,21,4845,3974,871,53,47,6,99.92692729
2f90fd8b08bfda9c7b41d2f7a2ac03da10d6f057,0,0,0,0,0,0,0,0,0,0,0,0,0,0,143,18,0,0,0,0,0,0,0,0,0,100
c059c916e32e53215dbbe55f7163c5ce833a8909,1,13,1,12,0,0,0,2,5,137,1,1,0,180,144,19,17,16,1,1067,975,92,6,6,0,100
08843202f78e0539e7ebb48c1d1a3fe7986db899,12,2,2102,2100,0,0,0,2,8,1203,2,5,3.015220407,1856,145,20,11,258,247,346,11648,11302,7,115,108,98.48456501
5210b3163032e295d44416aa867cd5c5bbdb459a,1,1,1,0,0,0,0,2,2,18,1,1,0,167,146,21,25,25,0,929,929,0,9,9,0,100
2bb8d50231d654c335bacc32fcf041f210a30e97,0,0,0,0,0,0,0,0,0,0,0,0,0,0,147,22,0,0,0,0,0,0,0,0,0,100
8f62b779edb838799acb939d05ee7302ad410647,0,0,0,0,0,0,0,0,0,0,0,0,0,0,148,23,0,0,0,0,0,0,0,0,0,100
1d0e38ab444018d010e659051578942a8d421a92,0,0,0,0,0,0,0,0,0,0,0,0,0,0,149,24,0,0,0,0,0,0,0,0,0,100
3450859af11a63c25144f985cb88b5c38f13c883,0,0,0,0,0,0,0,0,0,0,0,0,0,0,150,25,0,0,0,0,0,0,0,0,0,100
cda3bd10c61514d4b489edb088b2be4c83cfd898,0,0,0,0,0,0,0,0,0,0,0,0,0,0,151,26,0,0,0,0,0,0,0,0,0,100
4cb3b6d8ee617138aba4e93ddc51aafe71209ada,0,0,0,0,0,0,0,0,0,0,0,0,0,0,152,22,0,0,0,0,0,0,0,0,0,100
d66bf94b1dd059bc7e4b1ff332be59a280498077,1,5,1,4,0,0,0,3,4,317,1,1,0,128,153,23,16,15,1,813,800,13,5,5,0,100
afc806f2eb01a78f9fa25dd38118df15ac6274d4,0,0,0,0,0,0,0,0,0,0,0,0,0,0,132,0,0,0,0,0,0,0,0,0,0,100
a34cdb0eaaa9f37732e19cf932219ef090ad2281,0,0,0,0,0,0,0,0,0,0,0,0,0,0,154,0,0,0,0,0,0,0,0,0,0,100
5b5470bd5d3e94842032009c36788d4ae346674b,7,340,3,337,2,0,2,1,12,197,1,2,2.079370454,545,133,1,118,77,41,4938,3381,1557,57,32,25,99.8847705
e25661041c2d478bf27d64d39241a9fce9a0d263,3,161,10,151,0,0,0,2,6,163,1,2,1.085857868,477,134,0,50,40,10,3850,3026,824,26,25,1,99.88494727
5bda4a70a1ee3fe45a19c90cb81b09ad1d2ec25b,0,0,0,0,0,0,0,0,0,0,0,0,0,0,155,0,0,0,0,0,0,0,0,0,0,100
41f1e8afbbc4854c516e1ffd0baf9d0de73d60af,1,51,12,39,0,0,0,2,5,11,1,1,0,331,135,1,32,27,5,2870,2462,408,21,20,1,100
5d49eeb734d1c55aaf48219699706851d9e820b5,2,8,78,70,0,0,0,4,10,372,1,2,0.21832103,947,136,2,94,96,2,5814,6311,497,28,28,0,100
99db32ccd163daf9d7685f0e8485941701e1133d,2,29,14,15,0,0,0,5,14,214,1,2,0.583019417,931,137,3,96,94,2,6604,6532,72,41,40,1,100
f9da62be22101b00b907be3a66a6ce8d823c2f8f,5,271,18,253,1,0,1,3,7,397,2,5,1.726398623,1091,138,4,184,164,20,8166,6603,1563,64,53,11,99.96168582
507ff137160021dda2c4a08199746228827c9432,2,37,5,32,0,0,0,2,8,584,1,2,0.998363673,542,139,5,68,66,2,3742,3514,228,44,43,1,100
37e56e85b08869e01dce98b95879a09f1bf57a92,0,0,0,0,0,0,0,0,0,0,0,0,0,0,140,6,0,0,0,0,0,0,0,0,0,100
088067cf41403978b262470a87b5dc094a568dd7,0,0,0,0,0,0,0,0,0,0,0,0,0,0,141,4,0,0,0,0,0,0,0,0,0,100
6e461f13c25a2a2e6c50c1dd06b38b600036ee9f,0,0,0,0,0,0,0,0,0,0,0,0,0,0,142,0,0,0,0,0,0,0,0,0,0,100
39b6b5282938b9429cee3acaac0763cedd8fa9f0,1,3261,1851,1410,0,0,0,3,4,273,1,1,0,5583,143,1,1265,1199,66,41719,38217,3502,792,752,40,100
629b7e6b888190ebd5b9931caeec90c5d1c2ba58,0,0,0,0,0,0,0,0,0,0,0,0,0,0,144,2,0,0,0,0,0,0,0,0,0,100
bb7fb11b6ad3945704a6511140538b998e5143d1,2,274,11,263,0,0,0,5,23,278,1,2,0.985019357,599,145,3,94,63,31,5331,3912,1419,36,31,5,100
0f4a66fb0f2946cd61dd8df31bd255fef7581cbc,2,445,0,445,2,0,2,1,1,0,1,2,0.813938498,0,146,2,29,0,29,2712,0,2712,19,0,19,99.90434284
ffa706429186df2cf8ad04fd9dcba37b6a35d7f1,2,54,1,53,0,0,0,2,4,534,1,2,0.64293835,378,156,0,54,51,3,3040,2814,226,29,26,3,100
49933493f53633fec5846edf88aca4dd0dfdd52a,2,143,137,6,0,0,0,5,24,22,1,2,0.991703308,806,157,1,94,94,0,5427,5331,96,36,36,0,100
b84d01615a47c8152cfa1119a52a1a1f1b445843,6,210,8,202,1,0,1,3,8,170,1,4,1.94578219,1044,147,3,163,142,21,7805,6700,1105,76,63,13,98.2901165
c4e2129fd12f97303a1b8120a2ecf7da456e1b77,4,271,14,257,1,0,1,4,11,261,1,2,1.639859901,919,158,2,124,94,30,7282,5957,1325,42,28,14,99.92613112
9c59a309764498c013ccd202926d86413da01078,0,0,0,0,0,0,0,0,0,0,0,0,0,0,136,0,0,0,0,0,0,0,0,0,0,100
20eed3fdcbee57b84504ec0e1adada46950c4f90,3,14,20,6,0,0,0,2,7,197,1,2,0.61800386,632,159,3,53,55,2,4204,4258,54,27,27,0,100
02fc1a8cf436dbc9327e96d21452b826978479f8,2,11,3,8,0,0,0,2,8,631,1,2,0.985228136,316,160,4,31,31,0,1873,1805,68,11,11,0,100
1f95219ea6f87173018bde126a3485575a8ee252,5,45,6,39,0,0,0,3,9,1179,1,2,1.917254506,929,161,5,111,106,5,6619,6399,220,46,43,3,100
c9ddf93701e16a93f3b69355bc56545effdc7230,0,0,0,0,0,0,0,0,0,0,0,0,0,0,148,1,0,0,0,0,0,0,0,0,0,100
68fe4d45123473adbef1077c5de20b4dd48d3a1d,1,0,45,45,0,0,0,4,9,498,1,1,0,242,149,1,25,30,5,1332,1598,266,20,21,1,99.83302412
c420fad5d03dc8d17dce7fe3e59bf3b742f3d22d,1,47,20,27,0,0,0,1,2,361,1,1,0,106,150,2,16,16,0,867,676,191,8,8,0,100
8db5de8f85f79d91818f85a241faec5d8eee9b54,0,0,0,0,0,0,0,0,0,0,0,0,0,0,0,0,0,0,0,0,0,0,0,0,0,100
730c822c8fd3c393558ee63b48c82bb5a0763266,1,136,0,136,1,0,1,1,1,0,1,1,0,0,162,3,12,0,12,734,0,734,5,0,5,97.97363762
603bcf2d0ef0d68357d0d40e34484fbdb96aa3f9,2,33,3,30,0,0,0,3,4,500,1,2,0.650022422,564,151,3,69,67,2,3839,3671,168,33,31,2,100
f017ce5aca00d280ad6ee94e63fe3b44c326c5cf,1,1,1,0,0,0,0,2,2,1573,1,1,0,38,152,4,7,7,0,207,207,0,5,5,0,100
3cc8cec0ec37e6575efdbe3badcc28eceee017c0,0,0,0,0,0,0,0,0,0,0,0,0,0,0,153,2,0,0,0,0,0,0,0,0,0,100
6dfe63cdcebaa5f8091b4789f4df5f679ccb3596,3,85,2,83,0,0,0,3,5,381,1,2,1.060068674,620,154,3,80,69,11,4647,3962,685,35,33,2,100
a89897bec4e7d6f3342ed966c61668e8a8139af5,1,11,7,4,0,0,0,2,3,1136,1,1,0,91,21,0,15,15,0,493,477,16,8,8,0,100
e026545183f577d21850162257152ba38a3f6f9f,0,0,0,0,0,0,0,0,0,0,0,0,0,0,1,0,0,0,0,0,0,0,0,0,0,100
d3f5123c4d6cdbe4e5cca6e7e141e507bb1103a7,2,64,26,38,0,0,0,6,27,992,1,2,0.852405179,689,2,1,70,67,3,4861,4627,234,25,25,0,100
e27ae5fdce48100a85e353f97ed8a150afe5a4aa,0,0,0,0,0,0,0,0,0,0,0,0,0,0,3,2,0,0,0,0,0,0,0,0,0,100
705abaf00fbf8ee69ac88cbccae47c1a33f4b4b2,1,21,0,21,0,0,0,8,30,440,1,1,0,421,22,1,75,71,4,2494,2416,78,15,15,0,100
c23448fc959844eece5a8ab2dbf091c2c4973a26,3,107,2,105,0,0,0,3,9,253,1,2,1.182601079,371,163,0,36,25,11,2670,2160,510,16,12,4,100
2ea4922025e6db25d8627b522146b8b29c40a62b,1,1,1,0,0,0,0,4,9,522,1,1,0,215,155,0,37,37,0,1267,1269,2,17,17,0,100
753e4137918b5bdf559dd50a21db2a832aa1dce3,3,144,27,117,0,0,0,4,13,409,1,2,1.182956474,817,156,1,134,122,12,5626,5069,557,46,43,3,100
67454a71a3aba308ff0d1b29ad3f184e5c37fee2,1,2,0,2,0,0,0,6,12,201,1,1,0,534,157,2,69,69,0,2965,2955,10,20,20,0,100
9790ca7587060285efa4ae64591cea17dd3f00cf,10,170,94,76,0,0,0,3,10,801,1,2,2.686993691,2068,164,1,256,245,11,14799,14397,402,86,83,3,100
d76118d729d2fe0888b934b0dc743f5f068f63dd,7,26,26,0,0,0,0,1,3,477,1,2,2.24607289,1019,158,3,119,119,0,6558,6610,52,66,66,0,100
6373032a620bdc687b6d03b12726713d08c71a10,12,210,55,155,0,0,0,4,41,796,1,2,2.13391738,4435,159,4,674,658,16,28275,27330,945,273,267,6,100
58f3f6fb18e18fbf67fbd1ae0044c337845eba8d,0,0,0,0,0,0,0,0,0,0,0,0,0,0,160,5,0,0,0,0,0,0,0,0,0,100
79dc97bddbf6602c5f375337b3261f33d5555775,0,0,0,0,0,0,0,0,0,0,0,0,0,0,161,6,0,0,0,0,0,0,0,0,0,100
90bb15383c9a6d0b376c3ff5c83adade5092f8c4,0,0,0,0,0,0,0,0,0,0,0,0,0,0,162,7,0,0,0,0,0,0,0,0,0,100
0d04373473e302a3155b12945e3350cee760c151,1,1,1,0,0,0,0,4,10,757,1,1,0,48,165,2,0,0,0,244,244,0,0,0,0,100
72b3b7889f1dcf6736f099b77c878efe891c6585,4,83,5,78,0,0,0,3,10,83,1,3,1.758891694,894,166,3,116,109,7,5786,5347,439,47,44,3,100
c10c7beced9cb39a675e82f6d86e8cd5b84485c9,0,0,0,0,0,0,0,0,0,0,0,0,0,0,163,8,0,0,0,0,0,0,0,0,0,100
8acd54bb1089cc7b620dfd0c9ef9c828de1cc89c,0,0,0,0,0,0,0,0,0,0,0,0,0,0,4,0,0,0,0,0,0,0,0,0,0,100
3b1034e8229eb9ad3e27ed0faab77c3f68f708c6,7,372,73,299,1,0,1,7,35,385,1,2,2.280183261,2215,23,0,278,257,21,17383,15535,1848,78,67,11,99.75026015
c3a9c80ab431f6ba670142c7ce6813692422f764,1,7,12,5,0,0,0,1,3,63,1,1,0,192,164,0,33,34,1,1068,1092,24,21,21,0,100
56027c2264fe1e2f4158f89c9f25f9a9521aa254,1,1,0,1,0,0,0,4,7,912,1,1,0,324,24,0,25,25,0,2536,2531,5,7,7,0,100
bfd8e508a7498cd70a76e2269b610d063d30c270,1,0,1,1,0,0,0,5,17,94,1,1,0,444,165,1,85,85,0,2885,2889,4,32,32,0,100
cf2ac371351812f333960604a3a8ad4a510307ae,3,173,59,114,1,0,1,3,9,462,1,2,1.465031594,600,166,2,67,61,6,4870,4165,705,20,17,3,99.93760399
9a4f047668eb56895fb4bf5c1ee3e5dd6add8601,1,1,3,2,0,0,0,4,5,1,1,1,0,401,25,1,33,33,0,3219,3230,11,11,11,0,100
68ba5cf7185f333ad8723c3af5bcefe868c783cd,3,898,0,898,3,0,3,1,1,0,1,2,1.263226825,0,167,2,58,0,58,4587,0,4587,29,0,29,99.65171072
b8c5501683244df156ff6d70a72a12bac131ed8f,1,1,0,1,0,0,0,4,6,7,1,1,0,399,26,2,33,33,0,3228,3219,9,11,11,0,100
7951c4e9b2f10fe25cac51c09f041d75f9122568,1,5,0,5,0,0,0,7,24,85,1,1,0,1026,27,3,79,79,0,8343,8322,21,27,27,0,100
492cd8d08cab347e02e43805b47435413d16937c,1,0,1,1,0,0,0,1,2,5,1,1,0,370,168,3,31,31,0,2699,2720,21,20,20,0,100
fa3fb3deaa1045d0c6ebbd18630fa268f5db7fc1,2,160,1,159,1,0,1,1,4,1048,1,2,0.096454829,192,169,3,52,36,16,1960,1220,740,35,26,9,96.4790263
044ba300311a4a3e682a946bd0821c2b52acc190,1,5,0,5,0,0,0,8,32,109,1,1,0,447,28,3,80,78,2,2578,2552,26,17,17,0,100
d9061a037662dd0a37c44ba5f9cf705d21c84987,5,122,0,122,1,0,1,3,9,540,1,5,1.759997147,819,29,1,79,68,11,6096,5537,559,43,35,8,85.97809077
e30cbd544e6ca0b8a19d2e9db491c679e9ca4ee8,8,97,35,62,1,0,1,2,3,1093,1,2,2.816800936,1134,144,0,117,113,4,7313,7017,296,58,57,1,91.01372289
e07a0a6883c84836e618d187c1381d47a26bfc71,2,63,8,55,0,0,0,3,10,176,1,2,0.838007851,253,170,1,30,23,7,1790,1524,266,13,11,2,100
ba0b2685b96747a60a3e318b1e2fc2c9c02bcea4,0,0,0,0,0,0,0,0,0,0,0,0,0,0,30,2,0,0,0,0,0,0,0,0,0,100
b4ddd5829897f758f869a5fc3b08dcbf4b55156a,3,38,153,115,0,0,0,6,42,176,1,1,1.286426834,1545,31,3,202,218,16,8128,8584,456,75,78,3,100
89470c6a62b54b5c1411d519ebc952e557dc5a9f,0,0,0,0,0,0,0,0,0,0,0,0,0,0,22,0,0,0,0,0,0,0,0,0,0,100
f32fe79c465d15e813bd54cf1bf5ac59157c1dca,1,2,2,0,0,0,0,8,33,63,1,1,0,451,171,1,80,80,0,2578,2578,0,17,17,0,100
ec40929596b06b4ec608a8199f6be2f807a865c6,3,41,96,55,0,0,0,1,3,115,1,2,0.335130943,653,172,1,54,58,4,4344,4566,222,29,29,0,100
6a50ec2ad33b8cbd057907c67030d855520c5f13,9,1768,10,1758,3,0,3,2,43,497,4,7,1.333945932,1170,173,2,354,144,210,15222,6465,8757,135,53,82,99.66457023
1fbb7c929ef33a4597de31ce271ae06aa8dbb9d2,0,0,0,0,0,0,0,0,0,0,0,0,0,0,32,0,0,0,0,0,0,0,0,0,0,100
c9b531e70a655e331f18012d3c24614ac2c66b75,1,12,0,12,0,0,0,4,10,231,1,1,0,396,33,1,63,59,4,2589,2534,55,19,19,0,100
e1ec22e4f24600006c20812f7e7362ac80a38656,1,3,4,1,0,0,0,3,4,234,1,1,0,167,34,2,25,25,0,926,927,1,9,9,0,100
7296e1a8b98706c990c4e6aa0deda1883c422be9,1,2,1,1,0,0,0,4,11,222,1,1,0,218,35,3,22,22,0,1157,1145,12,10,10,0,100
9688cad6faabfebf8ec9690abd4ba320dd795890,2,18,2,16,0,0,0,3,7,914,1,1,0.992774454,145,36,4,17,17,0,659,647,12,10,10,0,100
96f6b6284c6e8a645b122111059ee954e9bad7b5,2,129,2,127,0,0,0,4,10,126,1,2,0.947877407,670,37,5,84,65,19,5730,4781,949,23,19,4,100
ad5f286eafd0912e9db0b2c3d92d1dc408377b12,1,25,21,4,0,0,0,4,8,1,1,1,0,476,38,6,41,41,0,3814,3859,45,14,14,0,100
a6a6c4c2a0420f42924cc31f304f4bc3ca8348ea,1,23,19,4,0,0,0,4,9,1,1,1,0,480,39,7,41,41,0,3843,3814,29,14,14,0,100
674f4fcce2597e7e934ccc69eb04b426f5a9b8bb,4,548,53,495,2,0,2,4,11,1,1,2,1.622066745,795,174,3,137,84,53,8196,5714,2482,49,23,26,99.79140592
34836ce6cef7c0f0ae13b2e8d9a63ca838ce8ace,4,53,548,495,0,0,0,4,12,0,1,2,1.622066745,1168,175,4,84,137,53,5714,8196,2482,23,49,26,99.79140592
1dfcb4b0edd4e2fca43d37bc01896015c245e589,4,561,53,508,2,0,2,4,13,0,1,2,1.610976817,795,176,5,139,84,55,8298,5714,2584,49,23,26,99.79140592
47507bc40202c52e7156106642ffc0ab849fb96e,1,16,3,13,0,0,0,6,25,493,1,1,0,384,177,5,47,47,0,2560,2443,117,14,14,0,100
63d26c19adf250fdd4d3b98e2b049d2b5cefc698,2,6,2,4,0,0,0,7,14,151,1,1,1,992,178,6,141,139,2,5993,5977,16,35,35,0,100
96b090b5117c34bba9f5104b47d005fe1c10c775,3,204,2,202,1,0,1,1,3,24,1,1,0.703933343,238,179,7,46,23,23,2435,1659,776,15,9,6,99.83367983
1f21df7e11f5fe8a3dcd0bd34116289c02943a64,1,122,49,73,0,0,0,6,14,963,1,1,0,324,180,8,46,30,16,2729,2407,322,14,14,0,100
f4c6c7025e892ecf0d6fac1b72b5806fe7c9cd8d,0,0,0,0,0,0,0,0,0,0,0,0,0,0,181,8,0,0,0,0,0,0,0,0,0,100
1c8b8f5e9185d75c6b1cb06a617dfc08447935c9,0,0,0,0,0,0,0,0,0,0,0,0,0,0,182,8,0,0,0,0,0,0,0,0,0,100
e12f0a7a46752eff2ff3aaddfa0b93fb606074d7,24,1656,260,1396,16,0,16,1,6,292,1,4,4.163494349,1140,183,6,202,105,97,13425,7480,5945,123,57,66,98.10699588
09f0a513602c3b0bb2c9e19903ae6d5e052ab460,0,0,0,0,0,0,0,0,0,0,0,0,0,0,40,0,0,0,0,0,0,0,0,0,0,100
61b9bcbb69ae3d19f72276b3aaa78ff3679cecfc,5,329,94,235,0,0,0,3,12,451,1,4,1.618821977,1114,184,1,170,138,32,8499,6990,1509,69,54,15,100
62b383a00c3f678b0f504dc71bf36091ddd4067a,2,123,34,89,0,0,0,2,10,2,1,2,0.632477892,792,185,2,135,129,6,5830,5295,535,53,50,3,100
a94594dd2c5cb980bc6f82b1fa606a922986569e,13,592,291,301,2,0,2,2,36,491,1,2,3.234369247,3118,167,0,402,380,22,23127,21818,1309,144,121,23,99.43135662
6115e7d6d611d2b82dc2583b95a13d4c0886a93f,19,314,89,225,1,0,1,1,44,773,2,5,3.546284634,5726,145,0,811,783,28,37115,36114,1001,320,312,8,99.79740681
76b359b3fef1fade662388c8356e4a82c227c258,0,0,0,0,0,0,0,0,0,0,0,0,0,0,41,0,0,0,0,0,0,0,0,0,0,100
31d45f1b377826b8755d1479bda9e2d702206bf9,0,0,0,0,0,0,0,0,0,0,0,0,0,0,186,0,0,0,0,0,0,0,0,0,0,100
45abf412c31f85e1b35135df529a36d94aac694c,0,0,0,0,0,0,0,0,0,0,0,0,0,0,187,1,0,0,0,0,0,0,0,0,0,100
63bade24bbabbe9eeb887e3294d4d3727cbac25d,0,0,0,0,0,0,0,0,0,0,0,0,0,0,188,2,0,0,0,0,0,0,0,0,0,100
73fd7bddeff11ef7af91055db1148416dca9d0b1,0,0,0,0,0,0,0,0,0,0,0,0,0,0,189,3,0,0,0,0,0,0,0,0,0,100
fd448caa8144ad3ea54a836d4ff6e944f36cfac6,0,0,0,0,0,0,0,0,0,0,0,0,0,0,190,4,0,0,0,0,0,0,0,0,0,100
f99113042dad2a67d24068e30ed37e4b18e62a72,0,0,0,0,0,0,0,0,0,0,0,0,0,0,191,5,0,0,0,0,0,0,0,0,0,100
33cdcf0d4e85e68e6df9e1ca4be729889d480246,1,5,1,4,0,0,0,8,35,48,1,1,0,552,192,6,96,95,1,3119,3100,19,23,23,0,100
09472ba12278a0d3696b9d2e26d6d1b0d361c830,7,38,12,26,0,0,0,3,7,217,1,3,2.335912562,964,23,0,120,119,1,6060,5817,243,62,61,1,97.85202864
0cba73698dbba6b78d0a2cd7b469f4377723470a,2,22,7,15,0,0,0,5,14,495,1,2,0.216396932,1041,42,0,120,118,2,6947,6864,83,35,35,0,100
059795fb9aa890430555f3a4c02a73ec346e7092,0,0,0,0,0,0,0,0,0,0,0,0,0,0,193,0,0,0,0,0,0,0,0,0,0,100
38befa88c0c1004936079f9107a5b8600df5fdbd,0,0,0,0,0,0,0,0,0,0,0,0,0,0,194,1,0,0,0,0,0,0,0,0,0,100
c48c26a358966fdc4dd0ec73002269c13fbaf758,0,0,0,0,0,0,0,0,0,0,0,0,0,0,195,2,0,0,0,0,0,0,0,0,0,100
8bfc90c0e4042fd2273d0de23b377fdd69f4c049,0,0,0,0,0,0,0,0,0,0,0,0,0,0,196,3,0,0,0,0,0,0,0,0,0,100
3708063ef740803f62e61d52bd3ba6e2a94d7c3e,0,0,0,0,0,0,0,0,0,0,0,0,0,0,197,4,0,0,0,0,0,0,0,0,0,100
1c318366a630c457afe3b6f26d98bb6df9d973c1,0,0,0,0,0,0,0,0,0,0,0,0,0,0,198,5,0,0,0,0,0,0,0,0,0,100
f7e240ff3e376bac2dc0fb91e7c7ae32a933f899,0,0,0,0,0,0,0,0,0,0,0,0,0,0,199,6,0,0,0,0,0,0,0,0,0,100
b74e35aeb6aea87a29f062f55c79a499c6497abe,1,6,0,6,0,0,0,6,17,1243,1,1,0,324,5,0,44,44,0,1879,1879,0,12,12,0,100
d0d00c3711c88c4da942dafb34ef3ab8861afdcd,0,0,0,0,0,0,0,0,0,0,0,0,0,0,200,7,0,0,0,0,0,0,0,0,0,100
9940dcbfefbe1248f65aa83f2f84e352ce022041,1,11,2,9,0,0,0,6,14,177,1,1,0,115,43,0,18,16,2,787,717,70,6,6,0,100
f15f20785262ac3cb3e35c2a12e669b7a836d35f,1,11,3,8,0,0,0,3,5,1113,1,1,0,131,168,0,17,16,1,861,813,48,5,5,0,100
69fd6b3ad5e5b9ae6f1293b3d8e57ed57fd6701c,9,312,31,281,0,0,0,4,45,779,1,2,2.265749611,3208,201,0,465,437,28,21354,19871,1483,186,177,9,100
8410ad307187b19ca3a4330859815223d1e6b1e2,1,47,38,9,0,0,0,2,3,357,1,1,0,108,202,1,2,2,0,868,846,22,2,2,0,100
61e3b3881b406b4a75897342fa12e84ecb2bcd3c,4,227,1,226,2,0,2,1,8,1065,2,3,1.26153645,129,203,1,41,26,15,1681,748,933,33,20,13,99.53161593
49db6f59173bb9e9ae7ce671034d6562551cedf0,1,1,1,0,0,0,0,1,4,452,1,1,0,367,204,2,31,31,0,2681,2685,4,20,20,0,100
2ef2055d44986c4249bcf1e64aa39fbfc0c356df,1,7,1,6,0,0,0,3,8,542,1,1,0,394,205,2,36,35,1,3025,2993,32,24,24,0,100
0c5b87a5dfd53bcdcf8e2d8c570735573cd274ad,2,0,50,50,0,0,0,3,7,1612,1,2,0.680077046,558,169,0,78,83,5,3343,3521,178,21,23,2,100
75418384440fdd566649875f0c6cd61f6b841a5a,3,126,41,85,0,0,0,1,5,321,1,2,1.164044697,624,206,1,60,55,5,4958,4481,477,31,29,2,100
e3b9b09cca015728a16e1368b26188c10a35df09,14,632,71,561,2,0,2,1,11,563,2,4,2.955170395,2650,170,1,414,336,78,20864,17929,2935,133,107,26,99.72698908
9e28ea671cf1baf86e26f468643f94141dc94323,1,7,3,4,0,0,0,8,46,134,1,1,0,535,146,0,60,60,0,2987,2939,48,20,20,0,100
5c5b96a8c89d2fe58f1425a4ece8160b76f03f26,1,3,1,2,0,0,0,5,18,682,1,1,0,443,147,1,85,85,0,2897,2885,12,32,32,0,100
4e08bf7d38bea365d35a6d391d1507a129cc9ba9,1,15,11,4,0,0,0,7,37,410,1,1,0,576,207,0,95,95,0,3676,3664,12,19,19,0,100
59f0b4df97231acdc0b9769dccb3211c502b36d3,3,30,2,28,0,0,0,2,3,1837,1,2,1.061278124,506,208,1,64,62,2,3340,3138,202,36,35,1,100
dd466c7e4623d9f5fd459b59836274d852f58d36,9,669,64,605,6,0,6,1,27,608,1,2,2.89628158,786,209,2,152,109,43,7659,5269,2390,45,21,24,99.419055
72be82d301895c214a10dd875260ddc308048623,0,0,0,0,0,0,0,0,0,0,0,0,0,0,210,3,0,0,0,0,0,0,0,0,0,100
acc9651346fe5834cdf5cdf0eb417f624aab1d09,2,45,47,2,0,0,0,1,6,94,1,2,0.304586689,672,211,4,59,60,1,4783,4848,65,31,31,0,100
75f748cbd101d6efe8463a1c747fb87d2f668091,8,873,0,873,8,0,8,1,1,0,1,3,2.645472709,0,212,5,72,0,72,3525,0,3525,34,0,34,99.23547401
0bbd0ad7aaad2f592c596608d4e1981aa86eb53d,7,756,0,756,7,0,7,1,1,0,1,2,2.536847614,0,213,6,51,0,51,3402,0,3402,30,0,30,99.39668175
186a3b808b371cbf2c4b5a47325caa324c7c7a6e,0,0,0,0,0,0,0,0,0,0,0,0,0,0,214,7,0,0,0,0,0,0,0,0,0,100
bde2c28211a2d05a9930f1599cb15864ad3cdba0,8,195,110,85,0,0,0,1,2,19,2,4,2.71069856,768,215,8,74,76,2,4948,4806,142,36,34,2,99.96251874
26444fd7a8c804b6f2507ee3bf54e1c811ee5168,2,158,0,158,2,0,2,1,1,0,1,2,0.932360884,0,216,9,9,0,9,561,0,561,5,0,5,99.81287425
ef2b089ab70e04e67b70c23416ef7051e992122b,2,147,35,112,0,0,0,1,7,34,1,2,0.999651537,669,217,10,68,59,9,5335,4783,552,35,31,4,100
6d0243112fa1ff1cb796ebe158630ae681a2afc8,0,0,0,0,0,0,0,0,0,0,0,0,0,0,218,7,0,0,0,0,0,0,0,0,0,100
d2cb4ba7524b3dacbce9f19a524a56c786eb3e48,1,140,0,140,1,0,1,1,1,0,1,1,0,0,219,6,7,0,7,747,0,747,5,0,5,99.9253174
e1e5acea2fbb04699eba76ea930def38e34f328d,1,4,4,0,0,0,0,3,8,1978,1,1,0,339,220,6,31,31,0,2426,2408,18,18,18,0,100
9f75c40a69fa4404ea2c344fa29285a00eb082fa,2,37,33,4,0,0,0,1,3,28,1,2,0.927526588,324,221,7,30,31,1,2104,2034,70,13,15,2,100
e1cb6913f358e4de54d69d1f6f21edecf06a9da2,3,2,317,315,0,0,0,1,4,18,1,2,0.957637135,285,222,8,0,14,14,144,1714,1570,0,12,12,99.85052317
9b2c28d805b89b8b3eac8f082e580e313f44c384,2,305,0,305,2,0,2,1,1,0,1,1,0.883285599,0,223,9,14,0,14,1499,0,1499,12,0,12,99.85052317
9f0abea027c408669977aa34cd32f5e525bb508b,2,143,25,118,0,0,0,1,4,12,1,2,0.543564443,322,224,10,37,30,7,2741,2033,708,19,13,6,100
9968f0fb00f8d25245067242a48040229952e46f,2,31,3,28,0,0,0,2,4,373,1,2,0.733537929,401,225,8,47,43,4,2837,2656,181,17,16,1,100
35cf900017a797e5ff3aedb01f05c88bb3f86ca0,1,4,3,1,0,0,0,6,42,278,1,1,0,924,226,8,150,150,0,5241,5241,0,60,60,0,100
72b54c9909290fa5b98123b4b0c1332a425c5c64,2,8,6,2,0,0,0,3,12,168,1,2,0.749595257,810,227,9,120,120,0,5908,5870,38,40,40,0,100
7ffbd86bc01013ef0a0cbf855243aec5d772a386,0,0,0,0,0,0,0,0,0,0,0,0,0,0,228,10,0,0,0,0,0,0,0,0,0,100
f17c7d5022d3e9d112a3843909ad523535fe7e4f,33,86,45,41,0,0,0,2,28,1734,10,20,4.895550438,5044,229,10,745,745,0,30549,30218,331,242,242,0,100
84c526fedbf30f14bf80ac7bc40aa043f400ec98,0,0,0,0,0,0,0,0,0,0,0,0,0,0,44,0,0,0,0,0,0,0,0,0,0,100
8328bccd41077d457cab064541127fc993e97619,2,22,1,21,0,0,0,3,7,1389,1,2,0.426228657,411,230,10,42,41,1,2872,2738,134,33,32,1,100
aa6fb7fbd9273c905a242c045f99a5b114fb3dc0,2,11,3,8,0,0,0,2,3,2497,1,2,0.863120569,105,231,11,11,10,1,566,487,79,8,7,1,90.20070838
a582c100f5f0b368a6dcc77c2b29138ef4b28840,1,9,0,9,0,0,0,4,14,294,1,1,0,856,232,12,101,100,1,6380,6331,49,63,62,1,100
f979b2683fc48d85806ae7593ee0e393bd812260,2,97,17,80,0,0,0,2,12,309,1,2,0.981940787,873,233,12,144,135,9,6285,5833,452,56,53,3,100
622faa6f8812cd751dfad22deaa21bf0aa613111,2,41,27,14,0,0,0,1,5,30,1,1,0.110580845,187,234,13,21,21,0,1128,1071,57,5,5,0,100
f99adaabcf9d6c6b8f4c8fe5895fe478c8307694,1,5,9,4,0,0,0,6,15,652,1,1,0,389,235,14,45,46,1,2685,2729,44,14,14,0,100
375143493c79d8c1a05723ea16ccd25374fe7294,3,38,4,34,0,0,0,3,26,859,2,2,1.066485721,1051,236,10,154,150,4,6817,6526,291,38,38,0,100
77d56e95ead7a04499aa83d1a78fcfbd957b20c7,1,25,1,24,0,0,0,4,8,1658,1,1,0,303,237,7,77,74,3,1705,1574,131,16,14,2,100
ea2fcdaa5132bd4fe01bc00a7da2dddb29756b02,2,116,10,106,0,0,0,3,10,519,1,2,0.764204507,619,45,0,73,57,16,4900,4301,599,42,30,12,100
aef02df10a26a6b6911b771a506994f2069857cf,5,875,1,874,3,0,3,2,2,50,2,3,1.269533769,180,46,1,139,30,109,6078,1098,4980,57,17,40,94.61756374
fdd61e840b004ca1b5c23b28e8d9eeda300f56f7,0,0,0,0,0,0,0,0,0,0,0,0,0,0,238,2,0,0,0,0,0,0,0,0,0,100
7e21ad36c05e07c4c6b92aa489f08c3cb562cb28,1,71,6,65,0,0,0,3,10,27,1,1,0,472,47,2,56,48,8,3834,3490,344,43,35,8,100
efbf87fb6ddc0bbc736446a5a91cf6a83d34d2d4,2,32,0,32,0,0,0,2,13,64,1,2,0.448864489,944,239,2,150,144,6,6472,6285,187,57,56,1,100
543c4c43d5bb04f99ea89cbe9c7c9ab4174563cb,0,0,0,0,0,0,0,0,0,0,0,0,0,0,240,3,0,0,0,0,0,0,0,0,0,100
29e31bfb5fe2be5e3e73b0e02858d49603d6eff8,0,0,0,0,0,0,0,0,0,0,0,0,0,0,241,4,0,0,0,0,0,0,0,0,0,100
76ddc82fb829995f2c88976d4153de132edf0a20,1,4,2,2,0,0,0,3,8,6,1,1,0,465,48,3,56,56,0,3462,3442,20,23,23,0,100
534fe268d1d0ad197f6e4a867ab0ae0155d1a927,2,18,0,18,0,0,0,3,14,94,1,2,0.650022422,812,171,0,121,120,1,5995,5911,84,41,40,1,100
2c18533253be786b9c60bf687cdf38d2384d2625,1,0,1,1,0,0,0,4,14,94,1,1,0,223,242,4,22,22,0,1196,1203,7,10,10,0,100
8c7f6936045222026c93f34bda861acec79066cf,2,22,12,10,0,0,0,4,27,60,2,2,0.989992792,1028,49,2,157,153,4,6601,6525,76,37,37,0,100
94b25aebc6d90480bb00898de4b98257cc7d8cbb,3,23,80,57,0,0,0,3,11,420,1,2,0.841446118,795,50,3,73,81,8,5031,5334,303,42,50,8,100
293a8c0db2b3b2e696eab0e64bd83d140bfe56d8,0,0,0,0,0,0,0,0,0,0,0,0,0,0,243,5,0,0,0,0,0,0,0,0,0,100
2b2ac63b39734b084b1ed1ff884a9f0c3f7e3033,0,0,0,0,0,0,0,0,0,0,0,0,0,0,244,6,0,0,0,0,0,0,0,0,0,100
619e78fe68658db242808a18f41ee5137b127748,0,0,0,0,0,0,0,0,0,0,0,0,0,0,245,7,0,0,0,0,0,0,0,0,0,100
698f0ba2de9c697ea9fe52134e36a694abc28d88,1,10,2,8,0,0,0,3,5,1233,1,1,0,329,246,8,43,42,1,2806,2732,74,26,26,0,100
f20e0a9410481e874e5d4916ff3b32d7f893e780,0,0,0,0,0,0,0,0,0,0,0,0,0,0,6,0,0,0,0,0,0,0,0,0,0,100
35de8ff18d096bd41caf3dabbcadc70b7d90ac40,0,0,0,0,0,0,0,0,0,0,0,0,0,0,7,1,0,0,0,0,0,0,0,0,0,100
a73b6785332a55eeb82f4a915e09cee305714959,0,0,0,0,0,0,0,0,0,0,0,0,0,0,8,2,0,0,0,0,0,0,0,0,0,100
55a4666434d892f838208b315cd9ba06ea07659b,2,10,4,6,0,0,0,3,4,290,1,2,0.749595257,288,9,3,53,51,2,2225,2178,47,6,6,0,100
22cd3909bbc0d9dbdb42b845f36be133326eb67c,2,7,7,0,0,0,0,6,43,363,1,2,0.863120569,1368,10,4,200,200,0,8487,8487,0,85,85,0,100
ac999bebeaa59659960fe9e998a0c20b1d476564,2,51,4,47,0,0,0,3,16,2975,1,2,0.980597441,90,11,5,12,7,5,754,483,271,5,3,2,99.96062992
9dd7d95357f925134b0ef2aadd8636722f57533d,0,0,0,0,0,0,0,0,0,0,0,0,0,0,247,5,0,0,0,0,0,0,0,0,0,100
cec64a54abb8410a5e98cd2f815a5a839b49ce74,2,134,2,132,1,0,1,1,2,380,1,2,0.500802469,97,172,1,33,22,11,1312,635,677,11,6,5,91.38632163
d1227feb601f30d0c7ec2910b91e648ee410d179,1,19,4,15,0,0,0,2,2,738,1,1,0,125,51,3,8,5,3,1246,1076,170,6,5,1,100
1003d1f410bd5f9e94ebafe6df641d8ab3e90d3e,1,19,6,13,0,0,0,4,6,2395,1,1,0,116,12,6,16,16,0,590,590,0,6,6,0,100
34e9bda312506a118fad87fcbdecc48bf3918c95,6,85,19,66,0,0,0,2,5,1957,2,5,2.338475565,1193,248,0,163,154,9,7450,7021,429,54,54,0,100
84465664c21ed0a1261f015a010b94a98153c8d7,2,19,0,19,0,0,0,3,9,985,1,2,0.485460761,430,249,1,85,84,1,2788,2646,142,24,23,1,100
199684b62ec983b8f922b1d6d706479032a18e64,2,26,3,23,0,0,0,1,6,238,1,2,0.578794625,416,250,2,39,37,2,2942,2790,152,20,19,1,100
1d9bab6760df38e538705a74dd599de03129777b,12,423,1,422,6,0,6,1,7,707,4,5,3.224861217,923,251,0,169,142,27,6573,5140,1433,99,75,24,99.48006932
91c58804da51a551fcbbe290261810c7750ee749,1,18,13,5,0,0,0,3,9,207,1,1,0,467,252,1,58,56,2,3481,3462,19,23,23,0,100
82631f811a7c6a4d8e6ec886f80d1a21876947e5,1,69,5,64,0,0,0,6,15,690,1,1,0,551,52,0,82,72,10,3313,3050,263,22,20,2,100
0d6eccad2781884fe0f000f74b8f964cbdd7971f,5,83,95,12,0,0,0,7,36,811,1,2,2.162743526,2201,253,2,221,224,3,15925,15919,6,88,88,0,100
1d49ef704a8bb08280b4e653e6db94dc3d2c2475,11,1688,230,1458,8,0,8,1,8,110,1,4,2.865260536,763,254,3,159,68,91,10608,5455,5153,78,35,43,94.71473574
62a4cad223aebfa0aa0f9d20c1c37f04a8b918a9,0,0,0,0,0,0,0,0,0,0,0,0,0,0,255,2,0,0,0,0,0,0,0,0,0,100
990776427d0bb12e8775c31fc78d47bea8f6501f,4,56,5,51,0,0,0,5,15,796,1,1,0.893135822,486,53,1,88,79,9,3282,3045,237,32,30,2,100
a7f9255a83beb222e1f3e871dff2d44568fa3f43,15,2215,14,2201,9,0,9,4,8,696,5,7,2.903345228,2864,256,3,883,659,224,31903,20448,11455,462,373,89,99.25925926
6f6f69b8b3435385b578af4bfb7790f2984bfb35,1,2,2,0,0,0,0,2,3,856,1,1,0,130,257,2,19,19,0,793,793,0,2,2,0,100
a103a677145a43aa6fa78dfeeb34018879e24a94,5,528,100,428,0,0,0,2,6,590,2,5,2.021556749,1279,258,2,216,168,48,10843,7978,2865,66,52,14,99.89492119
4a91456a72276e19e1a63d6a4df214bccef2bac8,0,0,0,0,0,0,0,0,0,0,0,0,0,0,259,3,0,0,0,0,0,0,0,0,0,100
407874b9041b2073e3ccc8e0a18353f865d900ce,4,16,14,2,0,0,0,2,9,80,1,3,1.849712035,1191,54,0,125,123,2,8454,8419,35,63,63,0,100
3d03053615694ca638e5ddf314081826b8a5f1ac,2,41,0,41,0,0,0,3,10,208,1,2,0.801469893,447,260,2,90,85,5,3068,2788,280,25,24,1,100
542b1695033d330eb00ae81713fdc838b88332b6,22,982,666,316,9,0,9,3,38,234,4,9,3.95621406,4639,261,1,592,588,4,32072,31275,797,191,168,23,95.32643596
49150fe6d4fa11d07a19e3ed106ccb0453a18c84,1,11,5,6,0,0,0,1,2,13,1,1,0,99,262,2,12,11,1,554,543,11,5,4,1,100
39bc4da1ed286fa3690876dda741cadb35386d93,1,15,0,15,0,0,0,1,2,14,1,1,0,54,263,3,13,12,1,348,304,44,6,6,0,100
e60c22a318f7c4fe3868a3ad762e3998f61b49d7,2,13,13,0,0,0,0,2,8,20,2,2,0.995727452,893,264,3,129,127,2,5290,5315,25,33,32,1,100
e98bcd4529e462e17680053e9356a6280d807164,0,0,0,0,0,0,0,0,0,0,0,0,0,0,55,0,0,0,0,0,0,0,0,0,0,100
c9289c083c8dc66a103119f2ade1879e03acaed6,4,57,11,46,0,0,0,2,2,148,1,1,1.281988329,425,13,0,80,73,7,2889,2631,258,34,31,3,100
4e06f6fe7af751672925967ce45feb18a92c4888,0,0,0,0,0,0,0,0,0,0,0,0,0,0,14,1,0,0,0,0,0,0,0,0,0,100
4d2a34e931554baa1c1b255d95540a46354a521f,2,34,2,32,0,0,0,3,14,788,1,2,0.650022422,753,265,0,114,113,1,4926,4729,197,44,43,1,100
cfefda167ea42aa5d68e15ac55bc2d6394c2d48d,1,4,4,0,0,0,0,8,29,1211,1,1,0,305,266,1,45,45,0,1726,1726,0,12,12,0,100
91ec5794589bf3711cca2a251a511fa360e5ac30,5,306,2,304,3,0,3,2,4,236,2,4,2.232815395,361,267,2,73,48,25,3584,2343,1241,22,10,12,97.37387699
c77f1ac469aac712e533cce7748683f1d2cc131a,3,30,14,16,0,0,0,3,8,1010,1,2,1.579679908,560,268,3,54,53,1,3905,3803,102,43,43,0,100
c3eff4bffcaf6c952ba13efef456d6a1a40f89cb,0,0,0,0,0,0,0,0,0,0,0,0,0,0,269,4,0,0,0,0,0,0,0,0,0,100
b68f5991d45fd4f89471233c2e3318fe252b5788,0,0,0,0,0,0,0,0,0,0,0,0,0,0,270,5,0,0,0,0,0,0,0,0,0,100
fc03456a1e4b1059b7fc6f29d96f9d047e28badb,0,0,0,0,0,0,0,0,0,0,0,0,0,0,271,6,0,0,0,0,0,0,0,0,0,100
be4ae294ca549648f785e7eea7564ee95112130a,5,101,24,77,0,0,0,2,47,482,2,3,1.778501365,2255,272,7,309,299,10,14144,13702,442,122,120,2,100
a508d953162a2b5e771ce5c3c8ee40e02c3fe3c7,0,0,0,0,0,0,0,0,0,0,0,0,0,0,273,8,0,0,0,0,0,0,0,0,0,100
94f568b96afc79d7850de64e47dead1c7352cef9,0,0,0,0,0,0,0,0,0,0,0,0,0,0,274,9,0,0,0,0,0,0,0,0,0,100
4188e4dedb4af0792bfac3086e3b2a7d415f2248,0,0,0,0,0,0,0,0,0,0,0,0,0,0,275,10,0,0,0,0,0,0,0,0,0,100
275329ca6c5ebd5212879696fcd0d19f691c1b60,0,0,0,0,0,0,0,0,0,0,0,0,0,0,276,11,0,0,0,0,0,0,0,0,0,100
364752a43f8ad7f85fd232351a179db017cd2265,1,0,2,2,0,0,0,6,18,5,1,1,0,465,277,12,51,51,0,3426,3435,9,26,26,0,100
019ab5207f2d2f0e7b9113b855b37d20dce664bf,0,0,0,0,0,0,0,0,0,0,0,0,0,0,278,13,0,0,0,0,0,0,0,0,0,100
651559fbf1f353156753ecba12d14820a4d6eaad,0,0,0,0,0,0,0,0,0,0,0,0,0,0,279,14,0,0,0,0,0,0,0,0,0,100
b92fbdcf0ea34efe47749af872bb68dc98b0cad5,0,0,0,0,0,0,0,0,0,0,0,0,0,0,280,15,0,0,0,0,0,0,0,0,0,100
e1740c0568024570611fd42175f1c782e8093067,0,0,0,0,0,0,0,0,0,0,0,0,0,0,281,16,0,0,0,0,0,0,0,0,0,100
0b72ca223f412ae214395c60e381c99fb1fcc18a,0,0,0,0,0,0,0,0,0,0,0,0,0,0,282,17,0,0,0,0,0,0,0,0,0,100
8443062c8809e3ce4bee864e61d9837c5a243287,0,0,0,0,0,0,0,0,0,0,0,0,0,0,283,18,0,0,0,0,0,0,0,0,0,100
2f2c4984d1d6da5f34304fd201ddcf3c8e5173bd,0,0,0,0,0,0,0,0,0,0,0,0,0,0,284,19,0,0,0,0,0,0,0,0,0,100
848f8eef348eefa273ffc53386e2245e5de0113f,3,53,9,44,0,0,0,3,9,30,1,2,1.215082942,572,285,19,56,54,2,4155,3905,250,44,43,1,100
493976e20dfe14b0b611c92f3e160d4336d10af2,0,0,0,0,0,0,0,0,0,0,0,0,0,0,286,10,0,0,0,0,0,0,0,0,0,100
f7560038a25430378f09ea631b6e472979d7988c,0,0,0,0,0,0,0,0,0,0,0,0,0,0,287,1,0,0,0,0,0,0,0,0,0,100
f3b6ceb6a0d363c16e7b1f535d66b803b184b075,0,0,0,0,0,0,0,0,0,0,0,0,0,0,15,0,0,0,0,0,0,0,0,0,0,100
344e0accae5675fd3d14b8414531528607865aae,2,376,103,273,0,0,0,3,6,1201,1,2,0.903744647,526,288,0,93,75,18,5182,3952,1230,49,41,8,100
d6943a662f694d2f1d1a771a575e61f3fff0570b,0,0,0,0,0,0,0,0,0,0,0,0,0,0,0,0,0,0,0,0,0,0,0,0,0,100
b5e102bee4d4b2783f3f65aab403a53c1ae8e401,12,182,55,127,1,0,1,2,16,2374,3,5,2.994777839,1143,1,1,119,114,5,7053,6508,545,49,44,5,93.35443038
2ddc36652a781ba57e0f537effa36c3a3d89402e,0,0,0,0,0,0,0,0,0,0,0,0,0,0,0,0,0,0,0,0,0,0,0,0,0,100
48126c235c73c67d9c3c2084df122fc96fd2064d,2,12,3,9,0,0,0,5,16,1213,1,1,0.836640742,643,289,0,83,82,1,3517,3472,45,22,22,0,100
38f0b316ddcc834c6249c7179c4c1d23ab445a84,2,73,11,62,0,0,0,5,17,600,1,2,0.749595257,1112,290,1,137,131,6,7543,7239,304,39,37,2,100
5f6d6c3b1d0100c57c2656fcd014dc2ee8e0a607,0,0,0,0,0,0,0,0,0,0,0,0,0,0,56,0,0,0,0,0,0,0,0,0,0,100
4d7124700f678169756df81aa110bd979a4bcb93,3,390,2,388,1,0,1,1,21,1920,1,2,0.30793973,308,2,1,62,34,28,3589,1683,1906,23,10,13,100
baca45ae43756491ea71707635b151db5f928b2c,0,0,0,0,0,0,0,0,0,0,0,0,0,0,3,1,0,0,0,0,0,0,0,0,0,100
a4946111383b3dfdb4c128fe5390ff3983213cbb,4,118,2,116,1,0,1,1,2,321,1,2,1.432216886,271,291,0,59,42,17,2342,1798,544,25,17,8,99.84934087
fd32492ac7edf6b9b99cb6d2739739c37f4bc5a7,0,0,0,0,0,0,0,0,0,0,0,0,0,0,4,2,0,0,0,0,0,0,0,0,0,100
5239b618c2caf4c6351048c758ad84f0c67aaf86,1,1,1,0,0,0,0,3,3,502,1,1,0,280,5,2,31,31,0,2267,2267,0,10,10,0,100
32ef64dd6b4ee5457832324b3d401a6d724d92bd,2,16,3,13,0,0,0,2,2,1138,1,2,0.981940787,137,0,0,16,14,2,965,899,66,13,12,1,100
757a560db73c2e6fbec56deea4c753a45ccf9032,8,1686,2,1684,6,0,6,1,15,428,2,3,2.448399046,211,16,0,234,30,204,11444,1114,10330,91,11,80,99.21377761
fff13b5e0aa6cb2f81aaeeb46e440120662fffa8,0,0,0,0,0,0,0,0,0,0,0,0,0,0,6,0,0,0,0,0,0,0,0,0,0,100
318da208844d02ed7554724ae526cefe94dd894c,2,39,3,36,0,0,0,2,3,514,1,2,0.791858353,575,17,1,76,74,2,4001,3815,186,37,35,2,100
67189ca84d24154150fa2ca4194b3b8d79400bda,2,64,1,63,1,0,1,1,2,363,1,2,0.198234964,33,7,0,14,7,7,377,170,207,14,7,7,99.92553984
2cc93b777865195a9bb2329946a14f301213ea3d,1,11,0,11,0,0,0,3,5,1038,1,1,0,284,8,1,33,31,2,1708,1642,66,8,8,0,100
3fccd241d92bc5b70d216a2111e28897cf93c5df,1,9,0,9,0,0,0,2,2,114,1,1,0,291,292,0,45,44,1,2009,1942,67,16,16,0,100
bd80c5e67deda4ec146f19fc92ff0c3bff61a982,2,59,4,55,0,0,0,2,4,399,1,1,0.341153893,739,18,0,146,136,10,4939,4699,240,45,42,3,100
a2f55e180f80b1daa707df9269375e1a7c69e6b5,0,0,0,0,0,0,0,0,0,0,0,0,0,0,57,0,0,0,0,0,0,0,0,0,0,100
d8d97db4be954fc15e4632d6c9ae5dd8f46c189c,2,21,2,19,0,0,0,1,3,890,1,2,0.755375413,739,58,1,112,110,2,5143,5026,117,41,40,1,100
c8eb221c6bbeb24a6e5073eb89e69e7cd2a10366,4,108,44,64,0,0,0,4,15,1108,1,2,1.206312943,1114,19,1,157,149,8,8071,7663,408,58,56,2,100
67ed62aa18df3675b68369d0d00c8f0dcbdfb970,2,56,14,42,0,0,0,2,4,24,1,2,0.997643296,755,293,1,118,112,6,5441,5143,298,42,41,1,100
d6bf08b54e467a6bdc6a5fc0edd41c51200e9da1,2,7,1,6,0,0,0,2,4,1005,1,2,0.811278124,278,9,0,32,31,1,1980,1951,29,12,12,0,100
0e40e831108f34b5bc6d01bf1ffa9efae330ea82,2,24,1,23,0,0,0,4,7,444,1,2,0.40217919,657,10,1,96,93,3,5312,5182,130,50,49,1,100
8bb556604047974775eb2da4c5c1686d89fe62d2,2,125,96,29,0,0,0,1,10,3577,1,2,0.895716272,266,294,0,42,41,1,1984,1676,308,14,10,4,99.59107807
f38a52102cf7a09e9727aa7a1321a86dcbe84c0d,1,3,1,2,0,0,0,2,2,799,1,1,0,196,20,0,35,35,0,1376,1374,2,14,14,0,100
88b3fee10f1ec10dc33872710a4d4084c86b5e7d,0,0,0,0,0,0,0,0,0,0,0,0,0,0,59,0,0,0,0,0,0,0,0,0,0,100
0421fa2ab1eb9575b34bbb2f44e8c6d83842eaeb,2,101,32,69,0,0,0,1,2,364,1,1,0.194768782,436,21,0,104,89,15,3415,2978,437,44,38,6,100
a8dd873588a282bb832c923010a485ab39ccf37b,0,0,0,0,0,0,0,0,0,0,0,0,0,0,22,1,0,0,0,0,0,0,0,0,0,100
e6416a0707a8be539a163bec9d7b12f7afbc36cf,2,271,0,271,2,0,2,1,1,0,1,2,0.952717975,0,60,0,12,0,12,1274,0,1274,10,0,10,99.81488338
af63d38fada97a06c542ad875ef31ea3e74d53cc,2,8,4,4,0,0,0,4,15,1639,1,1,0.918295834,283,11,0,22,22,0,1534,1511,23,10,10,0,100
7962ce63bc1cfdfed6b54b8b211e785ccab350f5,7,432,44,388,4,0,4,5,20,1608,1,3,2.598946515,405,295,0,76,45,31,3872,2217,1655,34,22,12,99.70566593
de6ecf48568761de829c8d8caf9bc41f9bf9e64c,0,0,0,0,0,0,0,0,0,0,0,0,0,0,23,0,0,0,0,0,0,0,0,0,0,100
109ec30725a4c665a2ccf5f40af8a0e455cf4166,2,47,4,43,0,0,0,2,11,346,1,2,0.818955502,292,61,0,45,42,3,2281,1984,297,15,14,1,100
ffb52b9e656df51e5e6881cfc8ed851a89cdc2f1,2,4,4,0,0,0,0,2,5,2809,1,2,1,396,24,1,81,81,0,2848,2856,8,21,21,0,100
caa64a1a6d4bc97be5993cb468516e9ffe862794,2,98,105,7,0,0,0,2,12,44,1,2,0.820892661,325,62,0,49,45,4,2044,2281,237,11,15,4,100
5293eba9a418180b42b3138c0c0b5aac38361f7f,1,3,2,1,0,0,0,6,18,791,1,1,0,602,63,0,82,82,0,3312,3312,0,22,22,0,100
f8abaf78fb98e91b7a228aaa231f4164d8dcfc97,7,608,436,172,0,0,0,2,9,1481,1,2,2.278326955,775,64,1,96,64,32,6677,4748,1929,51,38,13,99.81631154
7f588e6a158f5d108e39f50a92f8d1d108b12c24,5,268,224,44,0,0,0,3,5,1183,1,2,2.040145693,421,65,2,60,41,19,3428,2676,752,21,17,4,99.77908689
e8c4a7bffc74f6ea10ae6cc45adbaf4919f45186,3,584,334,250,0,0,0,2,5,861,1,2,0.996851962,829,66,3,159,118,41,7484,5609,1875,62,42,20,100
4eb2a3bb510671fe92cec0ebb61d7e78adc8f526,8,307,15,292,0,0,0,2,10,274,2,4,2.368141003,1330,67,0,172,150,22,11996,9854,2142,76,69,7,100
e6df16d782ae8917b443be81d6a5ad755e02f5c3,3,104,9,95,0,0,0,4,16,469,1,2,1.33264761,1083,25,0,182,174,8,8527,8040,487,48,47,1,100
46ae5accd03e5b8b18d3e1fb52761c1df4e51e5a,1,5,0,5,0,0,0,6,22,878,1,1,0,291,68,1,35,34,1,1693,1668,25,10,10,0,100
37ddd1b27258f2c3095094b79cbd8852478de33d,0,0,0,0,0,0,0,0,0,0,0,0,0,0,173,0,0,0,0,0,0,0,0,0,0,100
f4f15bee1e4ba109c6a21f639668911a13241014,0,0,0,0,0,0,0,0,0,0,0,0,0,0,174,1,0,0,0,0,0,0,0,0,0,100
a619cc15748d76357f84bd3d0fa0a3e496ee61a1,2,32,1,31,0,0,0,2,6,218,1,2,0.532835063,962,69,0,165,159,6,7480,7205,275,64,62,2,100
f46bee03eb2c9094aa192dd6b82a494cb26eef35,2,69,15,54,0,0,0,2,7,0,1,2,0.276195428,990,70,1,168,165,3,7904,7480,424,66,64,2,100
ee4999bc23f42bc300ed87b0d46fd96418d6a185,1,6,5,1,0,0,0,6,19,219,1,1,0,602,175,0,82,82,0,3323,3312,11,22,22,0,100
9601f5bf0a5294d5ffd324010768fe0299044d6d,0,0,0,0,0,0,0,0,0,0,0,0,0,0,0,0,0,0,0,0,0,0,0,0,0,100
1b9e589152f0093b6ef7cea580c00ff52944d2cf,0,0,0,0,0,0,0,0,0,0,0,0,0,0,176,1,0,0,0,0,0,0,0,0,0,100
7d1e683fbd7d261fff9fcf17ad78fd8469c64905,7,531,46,485,2,0,2,2,3,535,1,2,1.558371404,1070,177,2,199,169,30,9512,7405,2107,84,66,18,99.81610886
4a7db4a363a7ed7391e11685bb6a0f47cbfa2328,0,0,0,0,0,0,0,0,0,0,0,0,0,0,178,2,0,0,0,0,0,0,0,0,0,100
2f731f0aaeb490ab72400d8c83074daac840ac44,1,1,1,0,0,0,0,2,2,1949,1,1,0,20,179,3,3,3,0,112,111,1,3,3,0,100
af4ea3fef1068c96b3c96e7915ddb12a8d9f94d9,0,0,0,0,0,0,0,0,0,0,0,0,0,0,180,4,0,0,0,0,0,0,0,0,0,100
4eacba1930c3abfddf4fb50c5a272798708df811,0,0,0,0,0,0,0,0,0,0,0,0,0,0,0,0,0,0,0,0,0,0,0,0,0,100
2fe393898f420d100117ca277cce198858e2c24f,4,235,49,186,0,0,0,3,16,916,1,3,1.414425443,1062,181,5,155,136,19,7293,6460,833,61,54,7,100
2252fb1938a4fd578f88c64eb444c74777c46212,240,3506,3441,65,0,0,0,2,48,2528,13,49,6.59128265,41279,182,6,6517,6517,0,247284,246888,396,2744,2744,0,100
c8c0f9b8404ef60222f49aa91f74f5a846b57ca7,0,0,0,0,0,0,0,0,0,0,0,0,0,0,183,7,0,0,0,0,0,0,0,0,0,100
cfbf1156858af9ae26975fefc94594d91c8cd3f4,137,3506,3404,102,0,0,0,3,29,2472,12,39,6.181450018,30860,184,5,3119,3119,0,223270,221973,1297,1692,1692,0,100
7013708baddc8ed7d861797d1fd8280a94b6025c,1,49,46,3,0,0,0,3,17,26,1,1,0,556,185,6,100,103,3,3334,3257,77,36,37,1,100
19664c3c559c7d0360f7bb5a64eff88b8f25a80d,0,0,0,0,0,0,0,0,0,0,0,0,0,0,0,0,0,0,0,0,0,0,0,0,0,100
188c3104ab6030c40d652595a2274527a4ad4105,0,0,0,0,0,0,0,0,0,0,0,0,0,0,186,7,0,0,0,0,0,0,0,0,0,100
209c1e2548080525919fe78a1a61cc8fc7ab306f,1,2,11,9,0,0,0,3,5,2,1,1,0,126,187,8,16,17,1,803,834,31,10,11,1,100
ba64b12670f7b2c9ce079f8898f4601689a51def,1,1,1,0,0,0,0,4,18,5,1,1,0,562,0,0,100,100,0,3334,3334,0,36,36,0,100
ec28b66246f1f165ccaf01abf7fb27adebc9e4bb,4,279,54,225,0,0,0,3,12,26,1,4,1.707374809,577,0,0,114,100,14,4834,3894,940,43,32,11,100
c7de4ba5ca70c42099a2f9bf4ad2de3fdcbb7d30,1,3,1,2,0,0,0,1,3,15,1,1,0,183,188,5,29,28,1,1106,1098,8,10,10,0,100
dbf2e989744a6b2921076be017102f75323a69f4,3,71,26,45,0,0,0,2,3,3323,2,3,1.241060205,318,0,0,43,34,9,2186,1893,293,23,20,3,99.8531032
0259d302730f94b99c1a84f8311d1abc0f635eb3,0,0,0,0,0,0,0,0,0,0,0,0,0,0,189,5,0,0,0,0,0,0,0,0,0,100
9965dae7bd384abd2e25fd1756dbe516e8acdb9b,0,0,0,0,0,0,0,0,0,0,0,0,0,0,190,6,0,0,0,0,0,0,0,0,0,100
358bb670029549ed4cff192c79307fd3e4d69972,2,96,0,96,0,0,0,8,29,46,1,2,0.083542888,1223,0,0,107,102,5,10264,9744,520,44,42,2,100
1ca0765aae795a41a43e39324f5f1c8bae57b751,4,75,6,69,0,0,0,3,5,53,1,2,1.716825238,860,0,0,128,121,7,6352,5925,427,46,43,3,100
c554ba3d9b8234b37ba0b5dde3657034d11acb0b,1,2,0,2,0,0,0,5,16,35,1,1,0,842,1,0,101,101,0,6402,6380,22,63,63,0,100
10639e80cc83c14213dcc78692ab8f78945ddf8e,0,0,0,0,0,0,0,0,0,0,0,0,0,0,26,0,0,0,0,0,0,0,0,0,0,100
5a083a30b603d7213b1d44a174400b6cd44db70c,0,0,0,0,0,0,0,0,0,0,0,0,0,0,0,0,0,0,0,0,0,0,0,0,0,100
988ede948ffaf6526c226323a6808922f38b625c,0,0,0,0,0,0,0,0,0,0,0,0,0,0,1,0,0,0,0,0,0,0,0,0,0,100
dff1505c1ed76358d3f6e84df95118e1d92ece8d,17,19,19,0,0,0,0,2,46,867,8,15,4.037401198,4995,0,0,787,787,0,31863,31863,0,267,267,0,100
4b74aa286b16916900854ccea95cf906d3fdda5d,0,0,0,0,0,0,0,0,0,0,0,0,0,0,1,0,0,0,0,0,0,0,0,0,0,100
1422f733007dbb78caae7e5135bc33470e88502a,3,71,44,27,0,0,0,4,18,222,1,3,1.530217535,807,0,0,96,90,6,5218,5093,125,34,32,2,100
c1fae53bf2c254f5cf1282f32116a7aedc5340ed,0,0,0,0,0,0,0,0,0,0,0,0,0,0,27,0,0,0,0,0,0,0,0,0,0,100
b6dede8c108e0d8e3516767de31e3a847c69cfe0,2,120,36,84,0,0,0,4,19,69,1,2,0.99703385,914,1,1,139,130,9,6437,5859,578,53,49,4,100
118d5a4bcf5371fb215e0f7393fadf26073643f8,2,4,0,4,0,0,0,3,3,131,1,2,0.811278124,1352,2,0,207,207,0,8783,8760,23,79,79,0,100
e0deb7281fce0f6937f20da305b58d52d9a67a94,0,0,0,0,0,0,0,0,0,0,0,0,0,0,2,2,0,0,0,0,0,0,0,0,0,100
9eb92dab0d24813e9a3871f0c7038920797c0466,2,7,3,4,0,0,0,4,11,2039,1,1,1,934,3,3,92,92,0,7583,7554,29,44,44,0,100
1e8f2651dacf5daef55d75c7b9b12492962e7921,3,229,25,204,0,0,0,4,9,160,1,2,1.057725868,1109,0,0,199,168,31,9494,8185,1309,76,66,10,100
25e4bc6d80cf475862a1686fb2c3c97fcea27278,14,171,53,118,1,0,1,3,29,147,6,11,3.132050224,4318,0,0,703,675,28,29472,29011,461,205,201,4,99.77949283
53fb37443eec3261b32f39cb363183988498e47f,0,0,0,0,0,0,0,0,0,0,0,0,0,0,191,0,0,0,0,0,0,0,0,0,0,100
330e572879c9903f5b1084d84b237685aa9970c6,6,336,23,313,0,0,0,4,13,89,2,4,1.254343098,2212,1,1,348,304,44,19057,17013,2044,140,127,13,100
a0a50849d5ad33e6e6903316a3bd3dbba8547843,2,84,1,83,0,0,0,5,14,124,1,2,0.991897742,524,1,0,104,95,9,4041,3525,516,32,29,3,100
d9c9a7dd9a6889ecf6b9dc88fb8e02ccc1cd5167,4,113,61,52,0,0,0,4,14,196,1,2,1.792632027,610,3,0,78,70,8,4033,3790,243,36,29,7,99.8527788
591b138321280cea1e7d61efcaf625a67202cb3d,2,25,1,24,0,0,0,3,3,251,1,2,0.706274089,271,0,0,31,28,3,1870,1740,130,16,14,2,100
fca8c5b970cf0bbae61bae08f2084dd4f3bd1143,0,0,0,0,0,0,0,0,0,0,0,0,0,0,1,0,0,0,0,0,0,0,0,0,0,100
27c725802b16915acaa3ea05cdac0236972af1f0,1,7,0,7,0,0,0,4,10,86,1,1,0,188,4,0,28,26,2,1309,1274,35,12,12,0,100
7d5ceacac49f5d15bf8f75e0209592c5524a3dda,4,176,47,129,0,0,0,6,20,198,1,3,0.584668347,1362,0,0,197,188,9,9347,8689,658,80,74,6,100
585c4c92ed65c529871765ab64a5b3637fbdb07d,9,700,10,690,3,0,3,1,12,119,3,5,2.352902645,1860,0,0,351,274,77,17253,14105,3148,124,100,24,99.66936076
2fd0d2572ceb2bc0138c880a3b763647349b64f4,0,0,0,0,0,0,0,0,0,0,0,0,0,0,2,1,0,0,0,0,0,0,0,0,0,100
d40abcbfbf31528dbbb1739118ddb1dc60bfbeeb,0,0,0,0,0,0,0,0,0,0,0,0,0,0,4,0,0,0,0,0,0,0,0,0,0,100
5e400ea8c471ef41c12dd8ad2079ac8a351ec509,0,0,0,0,0,0,0,0,0,0,0,0,0,0,5,1,0,0,0,0,0,0,0,0,0,100
bb0eba0b2000bbd0ec6602f6221279412cc208b4,0,0,0,0,0,0,0,0,0,0,0,0,0,0,6,2,0,0,0,0,0,0,0,0,0,100
05feab49bc75522cb76e906dbb88aef8e5c71584,0,0,0,0,0,0,0,0,0,0,0,0,0,0,5,1,0,0,0,0,0,0,0,0,0,100
14ab61ef199278a4f1f683baffc2084b471f6c64,0,0,0,0,0,0,0,0,0,0,0,0,0,0,3,2,0,0,0,0,0,0,0,0,0,100
87d4c2c13862144eb578b211bcf800b2206834ff,0,0,0,0,0,0,0,0,0,0,0,0,0,0,192,0,0,0,0,0,0,0,0,0,0,100
94f1fab85ab772ecb5af6cba0d4b15ffdb2f6315,1,11,14,3,0,0,0,6,19,331,1,1,0,322,193,1,44,44,0,1879,1879,0,12,12,0,100
d6a73c8e3ea6833de27b04e8e65a9868cac4a509,0,0,0,0,0,0,0,0,0,0,0,0,0,0,7,3,0,0,0,0,0,0,0,0,0,100
132063b93310b08d616037972aae2fcb9f919e3a,0,0,0,0,0,0,0,0,0,0,0,0,0,0,8,4,0,0,0,0,0,0,0,0,0,100
4b44dfc643c9ec94c7cd3071b3536ba6e37b377b,0,0,0,0,0,0,0,0,0,0,0,0,0,0,9,5,0,0,0,0,0,0,0,0,0,100
2399329ee2ca2d9fc4ec0ec8fc5d16fb213795b2,2,44,28,16,0,0,0,7,39,335,1,2,0.931562768,876,10,6,106,106,0,6096,6004,92,36,36,0,100
9b65219cca4dd68a06aecdd51e953c9e367c3826,0,0,0,0,0,0,0,0,0,0,0,0,0,0,11,4,0,0,0,0,0,0,0,0,0,100
7c4b2fd3e88f038dea3bdae01eb864547770ad48,1,4,5,1,0,0,0,4,4,212,1,1,0,705,4,0,76,76,0,5132,5129,3,40,40,0,100
beddc405b2cb529efdc99a55b1edff5c391caebe,0,0,0,0,0,0,0,0,0,0,0,0,0,0,12,5,0,0,0,0,0,0,0,0,0,100
68f955d86bc2bcd8d2776af63d8993e81511bb09,0,0,0,0,0,0,0,0,0,0,0,0,0,0,13,6,0,0,0,0,0,0,0,0,0,100
5bf1d9b7b06365d19ccc374f0ed58a3c97e96a7c,0,0,0,0,0,0,0,0,0,0,0,0,0,0,14,7,0,0,0,0,0,0,0,0,0,100
14fb4d84fd0e100253ca947bc96810c242e7a82b,6,94,0,94,0,0,0,5,14,88,3,6,1.829209998,3156,1,0,459,456,3,24971,24557,414,178,175,3,100
911de0078b14dafda8a5c64dfa7139d19dc198a0,0,0,0,0,0,0,0,0,0,0,0,0,0,0,15,8,0,0,0,0,0,0,0,0,0,100
f581f6ed0e820da370c4a83a4ff7b05278d09fc3,2,24,3,21,0,0,0,8,31,370,1,2,0.825626526,736,6,0,72,70,2,4998,4870,128,27,25,2,98.59415464
9868c4231362e5568a1675a604288d60cbadd7fe,1,31,19,12,0,0,0,8,15,209,1,1,0,361,0,0,87,87,0,1949,1909,40,18,17,1,100
72a68f0d4ce032c2973f711738e9f3f55ddacd4b,0,0,0,0,0,0,0,0,0,0,0,0,0,0,0,0,0,0,0,0,0,0,0,0,0,100
de941e7b85ed55bfbd804880f421be3889187d31,3,433,1,432,2,0,2,1,9,851,1,2,1.035251709,17,0,0,40,2,38,3147,166,2981,24,2,22,99.81350242
21a64db1b0ebcb812e5c510668b580e84ff37f35,4,103,6,97,2,0,2,6,49,209,1,3,1.916332894,1083,7,0,113,107,6,7423,7166,257,46,40,6,99.81412639
83632c614e784bb7b1039dd0b0a8aa57cbfce7e6,0,0,0,0,0,0,0,0,0,0,0,0,0,0,5,0,0,0,0,0,0,0,0,0,0,100
31c729e3cbfc1e5111318b1d1abed875807185cd,0,0,0,0,0,0,0,0,0,0,0,0,0,0,1,1,0,0,0,0,0,0,0,0,0,100
ed9f6ff6f7bde07f0d3d7ffead904b884e3142ae,0,0,0,0,0,0,0,0,0,0,0,0,0,0,6,1,0,0,0,0,0,0,0,0,0,100
fa1ee05af38bcf08ed18ff36d4284e68836a9054,1,81,50,31,0,0,0,7,14,116,1,1,0,638,2,0,116,111,5,4972,4768,204,36,34,2,100
2ff2dbbd13db5de747c654ef132c98941cdd45dc,2,121,116,5,0,0,0,7,18,465,1,2,0.645100644,218,7,2,24,21,3,1476,1298,178,10,9,1,99.88868275
5e52ac4ad18a7776f4c74499c1314fbfd3513160,3,141,1,140,2,0,2,1,4,161,1,2,1.346878531,43,16,0,16,5,11,802,252,550,8,2,6,99.81488338
a844914721f68282b6fce2b3b0006603bafd790d,6,1026,2,1024,4,0,4,1,10,461,2,3,1.800668027,150,0,0,86,17,69,5866,669,5197,52,10,42,96.5303141
18453d3ef182e92785d9fb74ff4fbdc244a4bc88,0,0,0,0,0,0,0,0,0,0,0,0,0,0,194,0,0,0,0,0,0,0,0,0,0,100
f215374bdf9a08b16fa7ccd3b40098024afe8677,3,95,13,82,0,0,0,8,21,523,2,3,1.33041605,547,8,0,45,41,4,4663,4247,416,30,26,4,99.89165764
630083228364f6cd5dc18839fbd4b167cb615b38,1,4,4,0,0,0,0,10,40,346,1,1,0,532,0,0,87,87,0,3065,3067,2,22,22,0,100
4b6b841ab79162151af8d5e162fcc963f8009c69,0,0,0,0,0,0,0,0,0,0,0,0,0,0,8,0,0,0,0,0,0,0,0,0,0,100
73d87444013a656f763feb38ce20c43670dc6230,0,0,0,0,0,0,0,0,0,0,0,0,0,0,195,0,0,0,0,0,0,0,0,0,0,100
e5c3e6aa76cf2b0bb0838ff6dcd3853656bff704,2,141,3,138,0,0,0,5,41,1858,1,2,0.61674826,857,9,0,124,112,12,6316,5601,715,33,29,4,100
03c8357dfeff9615d1590a5c980eb4cfe035f3be,0,0,0,0,0,0,0,0,0,0,0,0,0,0,0,0,0,0,0,0,0,0,0,0,0,100
c718dae09d10db640cb9eb59f8abb11bd385a799,2,7,2,5,0,0,0,7,15,452,2,2,0.99107606,990,0,0,176,174,2,7480,7464,16,49,49,0,100
dfa0627573b9a75a25dc7149a7d63c9bac953ff4,2,26,1,25,0,0,0,3,6,860,1,2,0.380946586,710,0,0,118,113,5,5537,5376,161,44,43,1,100
ed433ae1b12d40117ca3dca2ffd57389984ede72,2,90,9,81,0,0,0,9,40,908,1,2,0.705469041,1641,10,0,167,162,5,13036,12533,503,54,53,1,100
fdc53f338931b96addf06f3f2be59da128656ec0,7,412,26,386,1,0,1,7,50,928,1,3,2.027551218,2130,11,1,307,281,26,14313,12429,1884,138,118,20,96.57206045
83e25691dc5f32d020b122d679b6f124162e4aef,3,40,1,39,0,0,0,6,12,701,1,2,0.540365126,760,0,0,106,103,3,6172,5898,274,38,37,1,100
33d19046f0db66c3093f68716e4f6100301d3b49,0,0,0,0,0,0,0,0,0,0,0,0,0,0,2,0,0,0,0,0,0,0,0,0,0,100
f2996cca55bbb852dc10512ca3369ae7fd56c44f,5,27,2,25,0,0,0,4,12,1038,1,2,1.132397375,890,0,0,110,107,3,5806,5658,148,59,58,1,100
857df3fe9b211a0e34f17cc6d776a1296951134a,8,142,66,76,0,0,0,4,7,1380,1,2,2.617060524,1313,1,1,149,136,13,9043,8390,653,76,75,1,98.69985141
d01dfd321409e069b8f44f667c4f8b3fb70df607,0,0,0,0,0,0,0,0,0,0,0,0,0,0,9,0,0,0,0,0,0,0,0,0,0,100
b5e5ba50f4333272b9e2f2be2b32027e667f32e2,2,142,85,57,0,0,0,6,30,990,1,2,0.813019016,866,10,1,106,100,6,6109,5771,338,38,36,2,100
5e9cfef2b26f1960601d08d571e4c85c269503af,2,38,3,35,0,0,0,3,23,1165,1,2,0.659375881,589,1,0,65,63,2,3760,3580,180,24,23,1,100
ef54f9fd6372143adc8c6a66f174feba381fec95,5,382,2,380,2,0,2,1,18,1523,2,3,1.295672041,284,2,0,65,34,31,3388,1513,1875,27,15,12,97.98165138
b54f085ffa89b74c9e91e478e864424bfbe0a7a2,0,0,0,0,0,0,0,0,0,0,0,0,0,0,28,0,0,0,0,0,0,0,0,0,0,100
964bcf56a54d38595f0ec74c484aa40d39732d9d,2,20,18,2,0,0,0,6,31,10,1,2,0.998000884,912,11,2,106,106,0,6153,6109,44,38,38,0,100
c570a51b3c53e4899d16dd623e19a0d939518dd2,3,55,1,54,0,0,0,2,2,507,1,2,1.358455766,715,0,0,72,69,3,5563,5176,387,44,42,2,100
1e69fc7c29f104a2117a62de11cba9b2a2c740e1,4,67,26,41,0,0,0,9,31,947,2,4,1.800715759,7124,1,0,1355,1354,1,50221,49922,299,839,837,2,100
685b79a8718ea983b451ce88555248510efe84ea,1,2,2,0,0,0,0,3,3,1173,1,1,0,79,0,0,12,12,0,487,487,0,7,7,0,100
63aabc4dae977e1e46a76b0b259afb778f3d2754,0,0,0,0,0,0,0,0,0,0,0,0,0,0,0,0,0,0,0,0,0,0,0,0,0,100
1fcef1a3bef16bd0fe67cb7984c67e5fd600b520,1,2,2,0,0,0,0,4,6,1216,1,1,0,164,1,1,21,21,0,989,989,0,8,8,0,100
66327aa20207ca62cd7c7a4cf9e24724b5ee0dfc,3,235,48,187,0,0,0,2,13,528,1,2,1.567188626,626,12,0,88,64,24,5624,4186,1438,49,37,12,100
4d79aa003aa02e8d513a1ae1406795d758143397,13,220,74,146,0,0,0,5,48,1129,1,3,2.926512101,3149,0,0,405,401,4,20512,19657,855,183,179,4,91.68695652
a51ca18b77625055051e310a021c38a002ffe89c,0,0,0,0,0,0,0,0,0,0,0,0,0,0,0,0,0,0,0,0,0,0,0,0,0,100
aa1aea07b7e2bd25e28efdc262239ec501fbf086,0,0,0,0,0,0,0,0,0,0,0,0,0,0,1,1,0,0,0,0,0,0,0,0,0,100
3cd1b331308d8d312fae258d94cd64a69ceb1644,0,0,0,0,0,0,0,0,0,0,0,0,0,0,2,2,0,0,0,0,0,0,0,0,0,100
0cc7542ddc18239754befb19408dc3aca4337a66,0,0,0,0,0,0,0,0,0,0,0,0,0,0,3,3,0,0,0,0,0,0,0,0,0,100
be25c5e1142a8d8b637df18de62f1a0a8759ea82,0,0,0,0,0,0,0,0,0,0,0,0,0,0,2,0,0,0,0,0,0,0,0,0,0,100
a7d2a289a67f057a5cdb28dabbd3e651613dfa3e,3,53,0,53,1,0,1,1,22,823,1,1,0.887379598,1048,3,1,155,149,6,6462,6274,188,38,36,2,99.83503794
32c167dccd711f163221b374bf6a4af68e66f0df,1,5,6,1,0,0,0,6,9,443,1,1,0,414,4,4,33,33,0,3170,3179,9,10,10,0,100
2c3fe6dc60750185cd2cd149e3605760b1c6a8ca,1,1,1,0,0,0,0,9,19,190,1,1,0,174,0,0,28,28,0,1017,1019,2,9,9,0,100
d3552627869b45956181149f4b7ecf0e344080b7,0,0,0,0,0,0,0,0,0,0,0,0,0,0,0,0,0,0,0,0,0,0,0,0,0,100
773555c5c7d09650f8f4173ced232954b1a3a361,11,1938,800,1138,0,0,0,4,7,4175,3,3,2.501212962,4390,5,1,1256,1083,173,38927,30307,8620,619,513,106,100
13771c905316052d3e94aeb3b4a0d49a27c0f852,2,46,22,24,0,0,0,2,3,3551,1,2,0.969204095,118,13,0,14,13,1,1081,887,194,11,10,1,100
d434d23dadc411e5d7486447316172c495d70f22,0,0,0,0,0,0,0,0,0,0,0,0,0,0,4,1,0,0,0,0,0,0,0,0,0,100
4a3f3c76f01d8a2c204b94dec7d3c7b3c68e7136,0,0,0,0,0,0,0,0,0,0,0,0,0,0,14,1,0,0,0,0,0,0,0,0,0,100
54e2728a8e141ee63704018c4497bbe083c0f75f,6,221,12,209,0,0,0,5,15,764,2,4,1.890332415,1969,3,0,253,238,15,16558,15480,1078,98,93,5,100
1541f089a5dec9b21549f6a6e961ef835a8b68bb,0,0,0,0,0,0,0,0,0,0,0,0,0,0,15,2,0,0,0,0,0,0,0,0,0,100
b359f32e324fb815c0506f3bad016187a0b7765e,0,0,0,0,0,0,0,0,0,0,0,0,0,0,16,3,0,0,0,0,0,0,0,0,0,100
8b3fad52b2da1510fa066ded2816b9cfc35f22e1,0,0,0,0,0,0,0,0,0,0,0,0,0,0,6,2,0,0,0,0,0,0,0,0,0,100
0c4260801c6dfee0003e437b0a7ca5a6cc7391f3,0,0,0,0,0,0,0,0,0,0,0,0,0,0,17,4,0,0,0,0,0,0,0,0,0,100
2bdb8323eb1abb28d443471b19a3a5bdae58f0bb,0,0,0,0,0,0,0,0,0,0,0,0,0,0,18,5,0,0,0,0,0,0,0,0,0,100
7e6c3f1f4122648b2ed9ca5a77f57b7139a369cc,0,0,0,0,0,0,0,0,0,0,0,0,0,0,19,6,0,0,0,0,0,0,0,0,0,100
82e9f4d4845934ea77c26be491dc5a856970c7bd,0,0,0,0,0,0,0,0,0,0,0,0,0,0,20,7,0,0,0,0,0,0,0,0,0,100
5405fc68c657fe6f2aabe14aa5cd19c781a032ea,0,0,0,0,0,0,0,0,0,0,0,0,0,0,17,0,0,0,0,0,0,0,0,0,0,100
99f591994468633fc6f8701c5fc53e0214b6da4f,0,0,0,0,0,0,0,0,0,0,0,0,0,0,21,8,0,0,0,0,0,0,0,0,0,100
c7b95a746ba8ffd0337540e3233032d2b071c648,1,1,1,0,0,0,0,3,3,1360,1,1,0,283,7,0,40,40,0,2127,2127,0,11,11,0,100
ed288acba39bfd611c10b338e36224c1415c2c4c,3,131,1,130,1,0,1,1,23,884,1,2,0.850777716,647,5,0,88,83,5,4091,3528,563,26,22,4,99.90131579
580f781341b42672f234af069b9190ff1cc00dca,11,886,147,739,2,0,2,2,13,1923,2,7,2.748493693,1695,4,0,297,215,82,13642,10004,3638,240,174,66,99.83601181
e4312ad1acfd28e23405e6775374948fa35d5e40,21,301,317,16,0,0,0,4,21,1314,9,13,3.85003706,5124,2,0,500,513,13,36548,36379,169,254,240,14,100
69c66efefdcd74904986f2727bdf0d52dd9a75e5,1,3,2,1,0,0,0,3,3,593,1,1,0,256,2,0,33,33,0,1538,1525,13,9,9,0,100
5a70cd7b3773d322d15a6adb04811c121d1f3976,7,1074,897,177,6,0,6,1,12,195,1,1,2.356825349,720,0,0,112,114,2,6033,5431,602,51,52,1,99.57446809
e3a0f8b29243298541aaaa3fc51fdfa82623dbe1,0,0,0,0,0,0,0,0,0,0,0,0,0,0,6,0,0,0,0,0,0,0,0,0,0,100
93510c642a3ed6ee2280c3d9ab2688ddca5d620a,0,0,0,0,0,0,0,0,0,0,0,0,0,0,7,1,0,0,0,0,0,0,0,0,0,100
31d1a573f7fa9b65d8474794e318b63e8a109f62,2,86,37,49,0,0,0,5,18,1713,1,2,0.872161788,932,8,0,139,135,4,7119,6833,286,47,44,3,100
286c2442444c9ed3bcb07f330d9d06947163e0c6,0,0,0,0,0,0,0,0,0,0,0,0,0,0,9,1,0,0,0,0,0,0,0,0,0,100
7f85df9e473ee675d461d5b76650694c5a6c0088,6,15,16,1,0,0,0,4,6,2082,5,5,2.49810065,1037,22,0,128,128,0,6155,6181,26,63,63,0,100
beb11e5988b9306eb6e211e0149d65f96d481b0f,38,2096,331,1765,20,0,20,5,20,1257,3,20,3.919578106,2374,10,0,542,394,148,21890,13654,8236,248,146,102,91.7199222
d1f24f56ce9714bb3e1edc671da290c75a17dead,1,6,1,5,0,0,0,1,2,3,1,1,0,55,11,1,3,3,0,315,276,39,3,3,0,100
0d437810dc850192b48fa3b31608ffcd23b1f1e9,3,82,13,69,0,0,0,3,30,1842,1,2,1.331848018,533,3,0,67,63,4,3780,3384,396,22,21,1,100
62c59a68dad22b3ce6145c1a4ae26ffa3418fe32,1,1,0,1,0,0,0,7,31,165,1,1,0,325,0,0,46,46,0,2072,2068,4,9,9,0,100
30f6e39aa66cbf2e3a7c3c77aa4ea68228b7e257,2,61,18,43,0,0,0,5,8,1028,1,2,0.170330576,565,12,0,63,58,5,3980,3804,176,18,16,2,100
3ada170dd01c1cbdfc6b517403b56830366ae5e5,2,33,6,27,0,0,0,4,7,1210,1,2,0.779349837,728,13,1,120,118,2,5674,5537,137,45,44,1,100
719afe908d39a87cb046dcd974eebaa7886a00e8,14,2323,0,2323,12,0,12,1,12,44,2,3,2.850459235,154,14,2,213,17,196,13282,667,12615,92,11,81,99.35298347
a76e2e9f2cde18f3b7548b991535a3151425de12,2,92,2,90,0,0,0,4,5,1154,1,2,0.903453555,337,15,0,62,48,14,2609,2121,488,33,23,10,100
20338fc6710487fda541810cb717eaf4482c4e7c,7,2009,0,2009,5,0,5,1,9,654,1,4,2.518790643,260,5,0,212,32,180,8090,1584,6506,109,14,95,99.5498697
368776ff77be7939b5e84a431df052cece610a07,4,203,81,122,0,0,0,7,21,2024,1,3,1.097081187,1439,0,0,211,197,14,10140,9347,793,90,80,10,100
3a22cd4d8bc47f0e7c30bba93186ad0cf602c07e,47,910,229,681,0,0,0,4,41,1723,3,29,4.509280397,16065,1,1,1893,1831,62,118934,114025,4909,798,749,49,93.02265035
bb5e374dfc0664af3310ef042b5fcddc13856484,0,0,0,0,0,0,0,0,0,0,0,0,0,0,12,0,0,0,0,0,0,0,0,0,0,100
dad828acbe40b218dc9c5bc741f5a6c7fa8b338f,34,449,86,363,2,0,2,1,51,969,7,22,4.58227259,10198,2,2,1482,1451,31,65842,64149,1693,471,443,28,93.2183908
4f1268a14e4207c460f3ce95e245e4dd14f13ac8,0,0,0,0,0,0,0,0,0,0,0,0,0,0,0,0,0,0,0,0,0,0,0,0,0,100
e08ab04de3f71177a1cd0a36df9be353ebee6796,2,99,63,36,0,0,0,5,6,164,1,2,0.91199892,409,1,1,68,62,6,2768,2609,159,34,33,1,100
1b4378396a441629fa0332d4814e053345c58ffb,3,394,81,313,1,0,1,1,42,1152,1,2,1.110751188,931,3,0,153,113,40,7429,6452,977,68,38,30,91.71917192
c5168c902634e8ea1f25ec578ed0b7055b246d68,23,1076,315,761,10,0,10,1,33,148,3,11,3.852247132,5286,2,0,697,631,66,38528,36412,2116,286,217,69,99.21235035
327a43dbefab57dc5d2da3ca9b7bb36ae4f743b7,5,157,82,75,0,0,0,7,43,780,1,2,1.531493609,2024,4,1,270,259,11,13637,13089,548,112,107,5,100
965e13264a304d500540593288f65157cc6fdd55,19,897,320,577,7,0,7,1,34,231,2,6,3.932634957,3422,16,0,490,440,50,24265,21900,2365,180,129,51,96.09856263
493b53b6430c687f88c438e5883ef9120d7aedb2,5,258,0,258,2,0,2,1,18,408,4,5,1.158325021,1489,3,0,284,264,20,12233,11070,1163,89,74,15,99.86206897
fb16ffc076de9917be7585e5583344bf3fd1c62a,47,129,81,48,1,0,1,2,49,2632,11,32,3.450724102,10193,17,0,1312,1303,9,68211,68263,52,592,590,2,96.85236769
1e0c1d0796f0fe4ea2dfaf9f855bdbeeaa21daeb,0,0,0,0,0,0,0,0,0,0,0,0,0,0,18,1,0,0,0,0,0,0,0,0,0,100
5cfa8be4174084b41d9b14aaf468da79e7a1ea71,1,1,1,0,0,0,0,7,20,78,1,1,0,606,19,2,106,106,0,3852,3852,0,23,23,0,100
671fc3f1b6d6b2239b171f582b189d0fbadedb6f,9,352,31,321,0,0,0,6,20,678,1,2,2.982899353,2604,4,0,351,321,30,20101,18341,1760,145,126,19,100
d3a04c77da026a0835f43d2e2bee18f8834534b3,2,72,0,72,0,0,0,3,7,4072,2,2,0.61674826,189,20,3,36,30,6,1352,1102,250,28,24,4,100
af23980fb380fcd7ba53d28e5ce195f4b095804c,0,0,0,0,0,0,0,0,0,0,0,0,0,0,5,1,0,0,0,0,0,0,0,0,0,100
4b21230b4dc5a2971fe40d7808f78cdaad5ec1f0,2,35,1,34,0,0,0,10,44,176,1,2,0.964078765,1737,5,0,173,170,3,13575,13354,221,57,56,1,100
94b5ce49794968477898a3001d6a93dca7ce5883,5,15,11,4,0,0,0,2,12,2178,2,3,2.317811376,1058,21,4,151,151,0,6458,6446,12,49,49,0,100
5ec8bb6ad1f3d91355adcb3d44d63058d37dee23,11,394,339,55,0,0,0,2,19,743,4,8,2.935272699,3301,6,1,453,433,20,25335,24706,629,196,188,8,99.88722864
0d2a9f9c1b36ecb6f57370d0b32bc61242d87f51,0,0,0,0,0,0,0,0,0,0,0,0,0,0,6,2,0,0,0,0,0,0,0,0,0,100
1c8c5e671f29c7e01bf5fc46e4c3b0fe8662addd,1,1,0,1,0,0,0,11,17,71,1,1,0,343,22,5,60,60,0,2630,2624,6,13,13,0,100
dffe1dcbc79987099120108ffc0bb10a17a25ea2,2,5,0,5,0,0,0,6,20,655,1,1,0.721928095,531,23,5,88,87,1,3844,3806,38,25,25,0,100
b252267ed297b849a8c3d900f7263e4abe5101c9,3,74,0,74,0,0,0,5,8,1025,1,2,0.958366242,686,7,3,78,72,6,5530,4906,624,30,29,1,100
0602cb032b44cba1d660c3ff4405b3504e63118b,2,44,11,33,0,0,0,5,9,0,1,2,0.945660305,704,8,4,79,78,1,5541,5318,223,31,30,1,100
19fc3f41ea7ff6b7e12c69c75becb4080fbe613f,2,3,2,1,0,0,0,9,45,1319,1,1,0.970950594,664,7,2,113,113,0,4193,4193,0,28,28,0,100
23473e1d5b08e1f40be49d66da64f89c1d7a1c68,0,0,0,0,0,0,0,0,0,0,0,0,0,0,8,3,0,0,0,0,0,0,0,0,0,100
84b6263cbd4c771144186d4c561e12ff569e1887,0,0,0,0,0,0,0,0,0,0,0,0,0,0,9,4,0,0,0,0,0,0,0,0,0,100
7419f05ee19cee63b9a3faf876a139bd56894634,2,37,0,37,0,0,0,2,18,455,1,2,0.303374836,838,10,5,137,133,4,6498,6216,282,47,45,2,94.70127061
85e0b4e646b838e471c43d8bcb08d4cc724ff866,0,0,0,0,0,0,0,0,0,0,0,0,0,0,24,6,0,0,0,0,0,0,0,0,0,100
4ae19e8f9701399540501256ec0cce29254083fd,2,21,4,17,0,0,0,5,13,146,1,2,0.855450811,600,25,7,84,83,1,4164,3988,176,26,25,1,100
dd7bfb3c0742fa8fab43f4bc443147cc369c046a,0,0,0,0,0,0,0,0,0,0,0,0,0,0,26,6,0,0,0,0,0,0,0,0,0,100
7509ed2aae65c5d80e40cb6f0fd7200589784a64,0,0,0,0,0,0,0,0,0,0,0,0,0,0,27,6,0,0,0,0,0,0,0,0,0,100
9855f0680a7404820b0cd98dc6bd6af6e7b604e4,0,0,0,0,0,0,0,0,0,0,0,0,0,0,28,7,0,0,0,0,0,0,0,0,0,100
dd686b12040112f14113dad06575fccf1ff52104,0,0,0,0,0,0,0,0,0,0,0,0,0,0,29,8,0,0,0,0,0,0,0,0,0,100
3d7b9ff400521fba7b0ed30926c11138f44669bd,0,0,0,0,0,0,0,0,0,0,0,0,0,0,30,9,0,0,0,0,0,0,0,0,0,100
bf5d6eb618ed13ac1cb36d152f64d917e972b9c4,0,0,0,0,0,0,0,0,0,0,0,0,0,0,196,0,0,0,0,0,0,0,0,0,0,100
1dea936538c14e5de50302ddf01a633c7766197b,0,0,0,0,0,0,0,0,0,0,0,0,0,0,197,1,0,0,0,0,0,0,0,0,0,100
5d29402f8def1fd3bb3f24c9d30bebb1e3806619,0,0,0,0,0,0,0,0,0,0,0,0,0,0,23,0,0,0,0,0,0,0,0,0,0,100
41902ebc998ca31de4ddc0fb89136a2e70b236f9,1,3,5,2,0,0,0,9,21,234,1,1,0,493,0,0,93,93,0,2994,2995,1,20,20,0,100
606eabb09997fa939735b5600f526a99895c350c,5,73,15,58,0,0,0,7,21,232,2,4,2.051326026,2237,1,1,316,308,8,17711,17396,315,122,120,2,100
7d3396f26dc1541e9d2a540d50d15a15c38acb74,0,0,0,0,0,0,0,0,0,0,0,0,0,0,0,0,0,0,0,0,0,0,0,0,0,100
fcdd9e21c7ab9ab3d4007c802c12404d876e9e73,0,0,0,0,0,0,0,0,0,0,0,0,0,0,0,0,0,0,0,0,0,0,0,0,0,100
e7f8a1ed2deb00d6b14761aa77a55389655a2f63,1,1,1,0,0,0,0,6,8,997,1,1,0,303,0,0,64,64,0,1985,1985,0,23,23,0,100
6f33de9bfca7f6d4a30043c0387f2c534dac7440,0,0,0,0,0,0,0,0,0,0,0,0,0,0,9,0,0,0,0,0,0,0,0,0,0,100
e9dcdc310e33f8bf86a4569c40c477192cfc298f,1,1,1,0,0,0,0,6,9,767,1,1,0,176,0,0,28,28,0,985,985,0,10,10,0,100
04e7d8ebc4ba56023c032e9b1992dd7bef0de257,1,1,1,0,0,0,0,5,8,2,1,1,0,176,0,0,28,28,0,985,985,0,10,10,0,100
435057c758cafd0c7d6ee0852f19d17c29203c36,0,0,0,0,0,0,0,0,0,0,0,0,0,0,0,0,0,0,0,0,0,0,0,0,0,100
66fe19916736aee9d94b8e2de2b672fcd5e38e7c,0,0,0,0,0,0,0,0,0,0,0,0,0,0,0,0,0,0,0,0,0,0,0,0,0,100
adc7d81b1a154f009e94e4600e543806a61c7c36,0,0,0,0,0,0,0,0,0,0,0,0,0,0,3,0,0,0,0,0,0,0,0,0,0,100
a3c267854d5490348d6c566a339feea91258cace,1,1,1,0,0,0,0,4,6,3395,1,1,0,191,18,0,28,28,0,1139,1139,0,10,10,0,100
74dc4ef0f9de8a79a521de1ddff80ec0f81bc32b,0,0,0,0,0,0,0,0,0,0,0,0,0,0,19,1,0,0,0,0,0,0,0,0,0,100
e4af39b046537885551866463c56397ec0991a09,0,0,0,0,0,0,0,0,0,0,0,0,0,0,20,2,0,0,0,0,0,0,0,0,0,100
4270af5658758959b4436d2a1975b209d382b977,0,0,0,0,0,0,0,0,0,0,0,0,0,0,21,2,0,0,0,0,0,0,0,0,0,100
9dafe98972a652aa1a202c6df9c08139d2bea592,14,2639,0,2639,14,0,14,1,1,0,1,2,3.613574999,0,2,0,221,0,221,12714,0,12714,108,0,108,99.17695473
9e0bc5bf4865673e6989ba887d27f468991c1e27,0,0,0,0,0,0,0,0,0,0,0,0,0,0,0,0,0,0,0,0,0,0,0,0,0,100
bba1997705cb94393df69b793d75249ee689546f,0,0,0,0,0,0,0,0,0,0,0,0,0,0,1,1,0,0,0,0,0,0,0,0,0,100
867c0a2f62711abcb91c85c2c1c1dbcbbc1025b4,4,315,325,10,0,0,0,7,8,2412,1,1,1.132955102,1891,2,2,471,454,17,15036,13618,1418,222,216,6,100
f8269df561655f3488e0ef3503f0d30152c7d4a2,0,0,0,0,0,0,0,0,0,0,0,0,0,0,6,0,0,0,0,0,0,0,0,0,0,100
02bb8e6854c8e5d1850a07a7fe5e3338178d679f,4,5,5,0,0,0,0,8,22,1148,2,4,1.921928095,2137,0,0,294,294,0,16718,16678,40,109,109,0,100
5c9bfe6dc745d85f2459958b767e6e05550d8a81,2,57,13,44,0,0,0,8,24,1534,1,2,0.970950594,1243,0,0,193,186,7,8838,8603,235,81,78,3,100
7b3149071a19f4a51425128a276d69fd688a0b50,0,0,0,0,0,0,0,0,0,0,0,0,0,0,0,0,0,0,0,0,0,0,0,0,0,100
62c0c3df63d86c333548da1411e54e8e94686a02,1,0,1,1,0,0,0,6,8,1548,1,1,0,138,0,0,13,13,0,837,839,2,8,8,0,100
59ffd4f871171550e7b40d8193894549b97fe1f4,0,0,0,0,0,0,0,0,0,0,0,0,0,0,0,0,0,0,0,0,0,0,0,0,0,100
ce6db547b3d08a5a9b0c7c47080b304fe00e421d,19,136,70,66,0,0,0,6,21,3273,8,14,3.541492044,7790,0,0,1102,1086,16,56918,56497,421,486,485,1,100
2b4d546e41f1f8256633dfa3f62810aa2ebffdf3,27,1815,254,1561,19,0,19,1,33,1367,1,3,4.188764465,1183,4,0,292,150,142,14245,7902,6343,95,39,56,99.08906883
c48877d986dcbe4a67fa92df29324d9b79ec4ccb,0,0,0,0,0,0,0,0,0,0,0,0,0,0,5,1,0,0,0,0,0,0,0,0,0,100
89ddb2a18380af0576531af69d6a48ce44f264a8,3,18,3,15,0,0,0,3,3,1093,2,3,1.493709546,377,0,0,45,43,2,2659,2625,34,19,19,0,100
9b9c9bf7e54435bd5ac48eb9e51174e19e66802f,46,100,102,2,0,0,0,7,46,5475,9,25,4.866332737,7734,1,1,1134,1134,0,47549,47549,0,465,465,0,100
32a0295bee7c72ef9ebc8e6ea701f3f13413937e,0,0,0,0,0,0,0,0,0,0,0,0,0,0,7,0,0,0,0,0,0,0,0,0,0,100
1115f2a2338a8a2527b97e6a43ed6852b32a04b1,0,0,0,0,0,0,0,0,0,0,0,0,0,0,0,0,0,0,0,0,0,0,0,0,0,100
7063f83df16501fdd1b6f54b159787073354c07d,0,0,0,0,0,0,0,0,0,0,0,0,0,0,6,0,0,0,0,0,0,0,0,0,0,100
c228329522a967ee1180fdb2776d257780a092cc,6,25,17,8,0,0,0,2,23,2390,4,6,2.35821551,2789,7,1,382,383,1,21948,21885,63,143,143,0,100
c9d03dbc6cb49f82054b51a1bca5c40973a7eac1,0,0,0,0,0,0,0,0,0,0,0,0,0,0,8,2,0,0,0,0,0,0,0,0,0,100
1b9eb2513658bd64719c0a2a5e5a2626d4d6e5a9,0,0,0,0,0,0,0,0,0,0,0,0,0,0,9,3,0,0,0,0,0,0,0,0,0,100
a51d7a05e14381bcde73705d8c51df4bfd1919dc,21,125,2603,2478,0,0,0,8,35,5068,6,14,3.028873622,5130,10,4,450,599,149,25341,35770,10429,209,284,75,98.98631526
9be1c8ecbeb377ad9a2deba9310f4f73e100e800,0,0,0,0,0,0,0,0,0,0,0,0,0,0,11,5,0,0,0,0,0,0,0,0,0,100
41ea734a273e9e577670ddd266af33d354059f34,0,0,0,0,0,0,0,0,0,0,0,0,0,0,12,6,0,0,0,0,0,0,0,0,0,100
70ce9495ac57ae086332526a5fba412b8ffd6a28,0,0,0,0,0,0,0,0,0,0,0,0,0,0,13,7,0,0,0,0,0,0,0,0,0,100
763d12ed58f33a496f772a69c6eff7e38bc325c1,0,0,0,0,0,0,0,0,0,0,0,0,0,0,14,8,0,0,0,0,0,0,0,0,0,100
3ae856b529a85bd5b88b078c9e4d5b405dca8287,17,0,2580,2580,0,0,0,2,9,5447,1,2,3.70423881,2052,15,9,0,272,272,0,11786,11786,0,188,188,99.04368054
4e5a9643cb732d9d639040a1ecc4f7befa583e96,17,2580,0,2580,17,0,17,2,10,0,1,2,3.70423881,0,16,10,272,0,272,11786,0,11786,188,0,188,99.04368054
041f7c34a3a84704758f3e27bd17cacb376c1135,0,0,0,0,0,0,0,0,0,0,0,0,0,0,17,11,0,0,0,0,0,0,0,0,0,100
485a49c7a991058ee634900ccf4a6467678444ad,3,145,252,107,0,0,0,5,36,15,2,3,0.655913002,1225,18,12,184,188,4,7521,7945,424,62,63,1,100
2810811f66da74342d19854a23fcd498b12aea9a,15,637,808,171,1,0,1,13,37,2099,3,8,3.489389762,4923,19,12,656,659,3,33207,33967,760,259,274,15,99.89772437
d5045106272103d06b3a4bd15eed92123b31a38a,5,46,13,33,0,0,0,2,18,3636,3,3,1.560102211,1901,20,10,261,253,8,14362,14166,196,118,117,1,100
e6803b7953e5fbcf6e9ac427957f5ff0082ec632,4,4,4,0,0,0,0,8,17,965,1,2,2,1848,21,11,209,209,0,14826,14818,8,105,105,0,100
029649d35cf4a0bab521192e2fbac9a1f18cacaa,0,0,0,0,0,0,0,0,0,0,0,0,0,0,22,12,0,0,0,0,0,0,0,0,0,100
310285c3d985b6fd053446ad8f740cb23bb160b7,0,0,0,0,0,0,0,0,0,0,0,0,0,0,23,12,0,0,0,0,0,0,0,0,0,100
d3ea4ceff13bbbf2e0767e1d36ccce1c14ed6a54,1,1,1,0,0,0,0,2,3,264,1,1,0,122,24,10,19,19,0,779,777,2,8,8,0,100
21102bb17c2b9b97cc7e9bb383630a4a014b23f9,6,13,6,7,0,0,0,2,18,45,2,3,2.399537225,2236,25,9,255,256,1,17653,17607,46,126,125,1,93.49056604
547ac27355863ab672b998e0f3a4dd47dba58d00,0,0,0,0,0,0,0,0,0,0,0,0,0,0,26,10,0,0,0,0,0,0,0,0,0,100
85e0fff7f51971a980e9aa869dd2521929ae88c2,0,0,0,0,0,0,0,0,0,0,0,0,0,0,27,11,0,0,0,0,0,0,0,0,0,100
dcfc4a1f4c1ab1fa79761f7bf7708d5094e489c6,0,0,0,0,0,0,0,0,0,0,0,0,0,0,28,11,0,0,0,0,0,0,0,0,0,100
394db116f8e4571450ee6a0b5adbbb6993b987d5,0,0,0,0,0,0,0,0,0,0,0,0,0,0,29,11,0,0,0,0,0,0,0,0,0,100
5219982c9e1dca90cafd3a4f0ed663dc21f99abc,0,0,0,0,0,0,0,0,0,0,0,0,0,0,30,12,0,0,0,0,0,0,0,0,0,100
e54f925f5afb0bc5d393dc15380a313e2e4f08ff,1,29,22,7,0,0,0,2,2,3532,1,1,0,81,31,13,11,9,2,549,455,94,2,2,0,100
a1d405fc5f6cdd300144a95d2010fd67075760c8,1,6,3,3,0,0,0,2,4,3,1,1,0,132,32,14,13,13,0,963,919,44,5,5,0,100
0c892ebc7c8d9bfa559b1204c331c525fecce6d0,2,32,1,31,0,0,0,9,25,1057,1,2,0.945660305,1281,33,15,197,193,4,9046,8838,208,82,81,1,100
98c388076bcdd2f49bac1ad33c893e85d44fb2aa,0,0,0,0,0,0,0,0,0,0,0,0,0,0,34,16,0,0,0,0,0,0,0,0,0,100
ea6996884d661faaabf3773dde0052278bd2c230,2,7,2,5,0,0,0,2,5,145,1,2,0.503258335,229,35,17,30,30,0,1501,1449,52,9,9,0,100
2386e39cf8dc4c126909a4e9b53f19cec166e63d,1,33,30,3,0,0,0,2,4,11,1,1,0,122,36,18,19,19,0,791,779,12,8,8,0,100
93de0bf0bfe90304b52cbd6b1c557f6ec2d9565e,1,1,1,0,0,0,0,2,6,0,1,1,0,134,37,19,13,13,0,960,954,6,5,5,0,100
275338b962cd6354f902cae16abdc3dd09d89a1b,0,0,0,0,0,0,0,0,0,0,0,0,0,0,38,20,0,0,0,0,0,0,0,0,0,100
ddbf12ff6b8fcf6957297ad76ac904f630146350,0,0,0,0,0,0,0,0,0,0,0,0,0,0,8,0,0,0,0,0,0,0,0,0,0,100
7392c297eb7cbf12fddbb70a7196dfff232e5a78,0,0,0,0,0,0,0,0,0,0,0,0,0,0,0,0,0,0,0,0,0,0,0,0,0,100
fd05fcefd2065cd128adb79098ace2276424e577,0,0,0,0,0,0,0,0,0,0,0,0,0,0,0,0,0,0,0,0,0,0,0,0,0,100
0f13a9c96276aaca9d0c02478d0486de8e86cabb,0,0,0,0,0,0,0,0,0,0,0,0,0,0,0,0,0,0,0,0,0,0,0,0,0,100
6e4c04a33f3f331433c1e6eca0c695fd0e9d90d9,0,0,0,0,0,0,0,0,0,0,0,0,0,0,1,1,0,0,0,0,0,0,0,0,0,100
28fd8d3b547e383bacf90ba8cbbee6abfa27e075,0,0,0,0,0,0,0,0,0,0,0,0,0,0,1,1,0,0,0,0,0,0,0,0,0,100
3a7bc9c43b8cc5648f4d2c804edf8dde0155fd88,0,0,0,0,0,0,0,0,0,0,0,0,0,0,1,1,0,0,0,0,0,0,0,0,0,100
c178981cead922dfbf11023d32f8f17a7e3e3669,13,689,39,650,7,0,7,1,34,1986,3,8,3.221285152,816,39,0,161,107,54,7976,5238,2738,67,38,29,99.05494505
6869031c6eeca4fb533307626b05f729370ed465,0,0,0,0,0,0,0,0,0,0,0,0,0,0,40,1,0,0,0,0,0,0,0,0,0,100
a98f2921506537c0b156de2066a7241eaacea42a,0,0,0,0,0,0,0,0,0,0,0,0,0,0,41,2,0,0,0,0,0,0,0,0,0,100
7016f03f162d0bea22006914ec9350b1e4bab509,0,0,0,0,0,0,0,0,0,0,0,0,0,0,39,0,0,0,0,0,0,0,0,0,0,100
7ff6a5dcf4ff664a9c8748d9801ba59890a33eea,0,0,0,0,0,0,0,0,0,0,0,0,0,0,2,2,0,0,0,0,0,0,0,0,0,100
4a6cfdc14e6c6e9c6bb8c7ea7dfeff17ca623a9b,0,0,0,0,0,0,0,0,0,0,0,0,0,0,3,3,0,0,0,0,0,0,0,0,0,100
eb5936b9a4a12f7b704cb34633eb890890909c34,0,0,0,0,0,0,0,0,0,0,0,0,0,0,43,4,0,0,0,0,0,0,0,0,0,100
82461b34b144e1e7cd0c818c0c9575ea8f359098,0,0,0,0,0,0,0,0,0,0,0,0,0,0,44,5,0,0,0,0,0,0,0,0,0,100
b155e204959b33e73f14aa0e3d68d79afeed5755,0,0,0,0,0,0,0,0,0,0,0,0,0,0,45,6,0,0,0,0,0,0,0,0,0,100
abba25ac7f1a0be5669a780dadc0078903ad8793,0,0,0,0,0,0,0,0,0,0,0,0,0,0,39,0,0,0,0,0,0,0,0,0,0,100
c5c3c8159bf63538710227ef91385b6f604c19f2,0,0,0,0,0,0,0,0,0,0,0,0,0,0,0,0,0,0,0,0,0,0,0,0,0,100
2accecd66656e3e2232d81a809e7cdd54813d9b5,0,0,0,0,0,0,0,0,0,0,0,0,0,0,1,1,0,0,0,0,0,0,0,0,0,100
a05687685f4b638474dc44798a4e90159b65b300,0,0,0,0,0,0,0,0,0,0,0,0,0,0,2,2,0,0,0,0,0,0,0,0,0,100
f74a5cef1b2abb581363791e68be2f177df0ffb7,0,0,0,0,0,0,0,0,0,0,0,0,0,0,3,3,0,0,0,0,0,0,0,0,0,100
c405e76e74fa89fc807c66ba5e3a1dcaabd44076,0,0,0,0,0,0,0,0,0,0,0,0,0,0,4,4,0,0,0,0,0,0,0,0,0,100
4fe8ea24cc0403bd5301cef1054da31e78c18d6f,0,0,0,0,0,0,0,0,0,0,0,0,0,0,40,1,0,0,0,0,0,0,0,0,0,100
b7975d3b9ea33064e8a5da5127d0a22bb6d3b797,0,0,0,0,0,0,0,0,0,0,0,0,0,0,41,2,0,0,0,0,0,0,0,0,0,100
d357e3886dad8bed6bfca553a62c51697417f0e6,0,0,0,0,0,0,0,0,0,0,0,0,0,0,49,10,0,0,0,0,0,0,0,0,0,100
46e816aadd2a3796428c9393483384a90ea249e6,0,0,0,0,0,0,0,0,0,0,0,0,0,0,2,2,0,0,0,0,0,0,0,0,0,100
dfbdb688f23cb81a2f8f51910a390b8ee6b28ec0,0,0,0,0,0,0,0,0,0,0,0,0,0,0,50,11,0,0,0,0,0,0,0,0,0,100
dafb26ccb172141c6e14e95447e1b6ae38e9a7d0,2,22,0,22,0,0,0,7,11,2188,1,2,0.902393283,641,51,12,78,74,4,4374,4240,134,42,40,2,100
eaa1d29dd141c9db5bf6cfb8e689ca32b67859a2,31,0,3655,3655,0,0,0,2,11,7369,1,4,4.529733295,2787,52,13,0,259,259,0,16952,16952,0,160,160,90.86444008
c2179799ae8b911e93eba49e4953650fab7a2e56,33,3655,22,3633,31,0,31,6,10,1364,2,6,4.560821158,661,9,0,333,78,255,21192,4374,16818,200,42,158,90.86444008
f58f5421e1a6026dda02567030296474cea7c66f,0,0,0,0,0,0,0,0,0,0,0,0,0,0,9,0,0,0,0,0,0,0,0,0,0,100
019609c20a463aa6cd352f55b88125ebd58beeb7,0,0,0,0,0,0,0,0,0,0,0,0,0,0,10,1,0,0,0,0,0,0,0,0,0,100
f248a21b06471e8e8d4905aff5114bbdf4cd4d11,33,22,3655,3633,0,0,0,7,11,7052,2,6,4.560821158,3428,11,0,78,333,255,4374,21192,16818,42,200,158,90.86444008
50ad4df453d502072c635b7476c6bd47034b6bc1,0,0,0,0,0,0,0,0,0,0,0,0,0,0,53,1,0,0,0,0,0,0,0,0,0,100
15b797d9a855b6cde46bb54128e4fb5c34a4adfc,0,0,0,0,0,0,0,0,0,0,0,0,0,0,0,0,0,0,0,0,0,0,0,0,0,100
10f0bd3b5e40bc9eeefac34a1ff13a9b374b0db8,0,0,0,0,0,0,0,0,0,0,0,0,0,0,1,1,0,0,0,0,0,0,0,0,0,100
0172347bfe87e39f5302ee010b6dc62ffd5d45cc,0,0,0,0,0,0,0,0,0,0,0,0,0,0,12,0,0,0,0,0,0,0,0,0,0,100
ff389b5438c9f3c0ab3b31ebd40466895684ed86,0,0,0,0,0,0,0,0,0,0,0,0,0,0,54,0,0,0,0,0,0,0,0,0,0,100
67e41db152b6efd80959db53a5560c587b8f919a,0,0,0,0,0,0,0,0,0,0,0,0,0,0,55,1,0,0,0,0,0,0,0,0,0,100
e5ece9506907018ec06cae0926050ee27f634617,0,0,0,0,0,0,0,0,0,0,0,0,0,0,56,2,0,0,0,0,0,0,0,0,0,100
7669f5f46fb02a8dfe9119122fdfdc3c0805e222,0,0,0,0,0,0,0,0,0,0,0,0,0,0,57,0,0,0,0,0,0,0,0,0,0,100
35e5b4df2b5e28ff8ee4edc0e648ebeaddbdae65,0,0,0,0,0,0,0,0,0,0,0,0,0,0,58,1,0,0,0,0,0,0,0,0,0,100
dbe5da2f1c71ba3d7d865d69b96afc44e790c9be,0,0,0,0,0,0,0,0,0,0,0,0,0,0,59,2,0,0,0,0,0,0,0,0,0,100
4a5de09504dbb598e7754ded6123aaa1588aa448,0,0,0,0,0,0,0,0,0,0,0,0,0,0,60,3,0,0,0,0,0,0,0,0,0,100
1504a7720b6470cbdf0bc1e24cda7e772c6d1339,0,0,0,0,0,0,0,0,0,0,0,0,0,0,61,4,0,0,0,0,0,0,0,0,0,100
55206a891a7159af31243902a09aa05f1f45a138,2,8,4,4,0,0,0,2,35,284,1,1,0.918295834,603,62,5,104,103,1,4087,4061,26,19,19,0,100
36b5e267ee2bdef6a7a79ab6e82c681c42a5dc43,0,0,0,0,0,0,0,0,0,0,0,0,0,0,63,6,0,0,0,0,0,0,0,0,0,100
8b6ed2c80b0d1b62e1e6d54613c2316461344ae4,0,0,0,0,0,0,0,0,0,0,0,0,0,0,64,7,0,0,0,0,0,0,0,0,0,100
520260720db7fe9f797a17ce20a94219a26d275a,0,0,0,0,0,0,0,0,0,0,0,0,0,0,65,8,0,0,0,0,0,0,0,0,0,100
309002eb94e16fb42d8b3811a96cf93e55b3f585,0,0,0,0,0,0,0,0,0,0,0,0,0,0,66,9,0,0,0,0,0,0,0,0,0,100
4d43457f96035097b02b239cbd93d6c97c45043b,0,0,0,0,0,0,0,0,0,0,0,0,0,0,22,0,0,0,0,0,0,0,0,0,0,100
63477e03967ea2476b8ae7c4f3485073f6c56801,0,0,0,0,0,0,0,0,0,0,0,0,0,0,67,10,0,0,0,0,0,0,0,0,0,100
62a8d31fe1e012bb875c53c6bf8099261ead03c0,1,1,1,0,0,0,0,4,5,6503,1,1,0,57,23,1,19,19,0,366,366,0,10,10,0,100
b23a6d5a58cc61d6660551a26b07b24e8688866d,1,1,1,0,0,0,0,3,4,4283,1,1,0,57,23,1,19,19,0,366,366,0,10,10,0,100
ace9ae39f00abadbfd4b3655af2b2a9d11eaeed5,1,1,1,0,0,0,0,4,5,6503,1,1,0,57,68,11,19,19,0,366,366,0,10,10,0,100
ee54fadfe417a30d9941a4f3d8f7a787babebaa5,0,0,0,0,0,0,0,0,0,0,0,0,0,0,69,12,0,0,0,0,0,0,0,0,0,100
1a0722af42631508d9901bd33b4c445d84643f23,0,0,0,0,0,0,0,0,0,0,0,0,0,0,13,0,0,0,0,0,0,0,0,0,0,100
12564a6869c2407470778ec93c98a76e20f77659,0,0,0,0,0,0,0,0,0,0,0,0,0,0,2,0,0,0,0,0,0,0,0,0,0,100
bfbfcbb17aa541e15c943939160f2ec99a7213b9,0,0,0,0,0,0,0,0,0,0,0,0,0,0,70,0,0,0,0,0,0,0,0,0,0,100
7fe9af49c485756e1b618493a5bc00b70d7fbd2d,3,28,1,27,0,0,0,7,8,2404,1,2,1.47476948,574,71,0,83,78,5,3693,3536,157,45,42,3,99.91692052
b17bea649ba95cb54184301142e6edd070bf3f82,0,0,0,0,0,0,0,0,0,0,0,0,0,0,72,1,0,0,0,0,0,0,0,0,0,100
0bb40e9c8961fc22d5bf4d5d9e11bdb8671a29f0,0,0,0,0,0,0,0,0,0,0,0,0,0,0,73,2,0,0,0,0,0,0,0,0,0,100
e98013ffeca50ddd912a76d0ae94b0462152517a,3,208,1,207,2,0,2,1,2,285,1,3,1.438453547,34,74,3,23,5,18,1445,285,1160,10,3,7,99.50344828
2fcfcd0d4c1c8cb163ec107a55087d7c0df1bda4,2,38,4,34,0,0,0,3,6,4108,1,2,1,377,0,0,33,30,3,2905,2669,236,22,20,2,100
a9fbf57b522116bdf992eddd98dca8a429b8d48f,0,0,0,0,0,0,0,0,0,0,0,0,0,0,75,3,0,0,0,0,0,0,0,0,0,100
ba2176882946471e57796af38869fccab9689002,0,0,0,0,0,0,0,0,0,0,0,0,0,0,0,0,0,0,0,0,0,0,0,0,0,100
3cfd79168cc15cf82c32169c0aaee8d02da9e934,9,277,35,242,0,0,0,3,25,1526,4,7,2.734954087,3298,0,0,479,463,16,27185,25090,2095,184,178,6,100
0d7b74c0d7391369dcea8cfc3d37684f5d1a6e8f,2,15,0,15,0,0,0,7,12,526,1,2,0.996791632,661,76,0,81,78,3,4465,4374,91,43,42,1,100
dbc49b7b2ee663858317891d2dbf49fd00b55c3c,0,0,0,0,0,0,0,0,0,0,0,0,0,0,77,1,0,0,0,0,0,0,0,0,0,100
f9b6c25ac754267a7a0ed2b96df264aaafd0026d,5,46,46,0,0,0,0,7,13,3118,1,2,1.159896215,1207,78,2,146,146,0,7854,7841,13,61,61,0,100
fe756b381c72ee216f19e8303c63e1d9ee7083fb,0,0,0,0,0,0,0,0,0,0,0,0,0,0,79,3,0,0,0,0,0,0,0,0,0,100
38afaeb4cd987037d0acc44754fc98f43d10e0bc,0,0,0,0,0,0,0,0,0,0,0,0,0,0,80,4,0,0,0,0,0,0,0,0,0,100
4e4f5e562cb74654264b93667b8250433e957083,0,0,0,0,0,0,0,0,0,0,0,0,0,0,81,5,0,0,0,0,0,0,0,0,0,100
bbae4b8b7775bbc2051e6e2f8b5e9b1b9c13ea06,6,376,0,376,6,0,6,1,1,0,1,5,2.484257364,0,2,0,25,0,25,1626,0,1626,17,0,17,98.38799333
d9ff429a13f537cd68834b916f66042a30d07854,6,0,376,376,0,0,0,0,0,0,1,5,2.484257364,310,2,0,0,25,25,0,1626,1626,0,17,17,98.38799333
65644d9f6ba047d167ffb437a98050fa4589c17e,11,610,0,610,11,0,11,1,2,2,1,6,3.290479105,0,82,6,35,0,35,2547,0,2547,24,0,24,98.06094183
18356faa4721605f84bffb1d5149c6668d2da9ac,0,0,0,0,0,0,0,0,0,0,0,0,0,0,83,7,0,0,0,0,0,0,0,0,0,100
669ffba4e3b66076501aeabee04dd4c918df76a8,0,0,0,0,0,0,0,0,0,0,0,0,0,0,84,2,0,0,0,0,0,0,0,0,0,100
9036db906d6fee66feee058f13d45f427b2dbd4c,8,188,22,166,0,0,0,11,26,1464,2,4,2.206491051,2563,85,3,334,313,21,21609,20286,1323,132,127,5,100
8cc66fbc92ab64f8c7d82c8cc1a6d89a11311062,0,0,0,0,0,0,0,0,0,0,0,0,0,0,86,4,0,0,0,0,0,0,0,0,0,100
b9ef07d0e5d999b74fac4da9539d34d8126e03d6,0,0,0,0,0,0,0,0,0,0,0,0,0,0,87,5,0,0,0,0,0,0,0,0,0,100
93fbd74336e573b5add3b81760d57a459f8bc440,24,60,851,791,0,0,0,0,25,699,3,12,4.066778914,4411,0,0,456,515,59,28036,32010,3974,187,217,30,98.06094183
9f2807d5519f0ab25025f7a73bd1a8730fabba6f,2,15,0,15,0,0,0,7,12,572,1,2,0.996791632,661,76,0,81,78,3,4465,4374,91,43,42,1,100
34f372222248e2a1014c502b888e37f4c3d0f356,0,0,0,0,0,0,0,0,0,0,0,0,0,0,77,1,0,0,0,0,0,0,0,0,0,100
eee179a09df405c1ab55ae25a53b76ca1050bb97,5,46,46,0,0,0,0,7,13,3145,1,2,1.159896215,1207,78,2,146,146,0,7854,7841,13,61,61,0,100
7280aa75e7889b574097fe02087c3d18b8e08e6f,0,0,0,0,0,0,0,0,0,0,0,0,0,0,79,3,0,0,0,0,0,0,0,0,0,100
a01136861c6a993cb4a75f2883ea4aaa47dd797b,0,0,0,0,0,0,0,0,0,0,0,0,0,0,80,4,0,0,0,0,0,0,0,0,0,100
c3304b8c3f916a38bce5908f5849267bdf0ba9ff,0,0,0,0,0,0,0,0,0,0,0,0,0,0,81,5,0,0,0,0,0,0,0,0,0,100
1521f5c32e73b01faafec214a628bbf477deb8a4,6,376,0,376,6,0,6,1,1,0,1,5,2.484257364,0,2,0,25,0,25,1626,0,1626,17,0,17,98.38799333
37273bc677ca14692b48dc3c3460a6ef58318377,9,184,49,135,2,0,2,1,2,0,1,5,2.958075421,296,82,6,28,26,2,2083,1645,438,20,21,1,99.27130045
bf72ec6b343623ab3b2ef9029640128cdc4f655c,0,0,0,0,0,0,0,0,0,0,0,0,0,0,83,7,0,0,0,0,0,0,0,0,0,100
ac5ed049f96213e9b9b7f1c0a111781c19a411ff,8,188,22,166,0,0,0,11,26,1422,2,4,2.206491051,2563,84,8,334,313,21,21609,20286,1323,132,127,5,100
68a113dc4b72003931e54ad579552024e5865e88,0,0,0,0,0,0,0,0,0,0,0,0,0,0,2,0,0,0,0,0,0,0,0,0,0,100
ff744fa3c471b8e5a22b4b7ccc7dccc935c9355f,0,0,0,0,0,0,0,0,0,0,0,0,0,0,85,9,0,0,0,0,0,0,0,0,0,100
bda727be237a14f2957cfdb307286290d6b0b15b,0,0,0,0,0,0,0,0,0,0,0,0,0,0,98,16,0,0,0,0,0,0,0,0,0,100
fafd18ef4aea590d659f14a34e3f2cd862dfcca2,0,0,0,0,0,0,0,0,0,0,0,0,0,0,99,17,0,0,0,0,0,0,0,0,0,100
413fb919bf2a16b0ba1536c4304a2fa6e9e47ad6,1,1,1,0,0,0,0,6,9,767,1,1,0,176,100,18,28,28,0,985,985,0,10,10,0,100
7c3dedac789175f3ba1f728f500fdec3dee04a37,0,0,0,0,0,0,0,0,0,0,0,0,0,0,1,0,0,0,0,0,0,0,0,0,0,100
a0da8e3e8a60f4845333c5e43cbab7895f8fd943,0,0,0,0,0,0,0,0,0,0,0,0,0,0,101,19,0,0,0,0,0,0,0,0,0,100
c7817396899d7946710dbddbd61e1dd43561fe06,0,0,0,0,0,0,0,0,0,0,0,0,0,0,102,20,0,0,0,0,0,0,0,0,0,100
89640b2a1aeba000626c85500068bcbac120803d,0,0,0,0,0,0,0,0,0,0,0,0,0,0,103,21,0,0,0,0,0,0,0,0,0,100
cd57aaa0b57284af202c921a3fb0b1fa6af4f888,0,0,0,0,0,0,0,0,0,0,0,0,0,0,104,22,0,0,0,0,0,0,0,0,0,100
aafbdb6198248ac13873345bd4041e6a9eba3ff3,0,0,0,0,0,0,0,0,0,0,0,0,0,0,105,23,0,0,0,0,0,0,0,0,0,100
03317de0ab7c257e4ceeba8d2e52c7e659536c9d,0,0,0,0,0,0,0,0,0,0,0,0,0,0,106,24,0,0,0,0,0,0,0,0,0,100
137a9e4ea18011c8371704d689be12c92c5534d4,0,0,0,0,0,0,0,0,0,0,0,0,0,0,12,0,0,0,0,0,0,0,0,0,0,100
7bcdb6953e4fb5df11c22a810304f781e57fc363,0,0,0,0,0,0,0,0,0,0,0,0,0,0,5,0,0,0,0,0,0,0,0,0,0,100
e0c6e9de228dad6043789a609ea664985750f2ed,0,0,0,0,0,0,0,0,0,0,0,0,0,0,13,1,0,0,0,0,0,0,0,0,0,100
2d7c685617d533eb3fdd079d363f292e5bae9a13,0,0,0,0,0,0,0,0,0,0,0,0,0,0,14,2,0,0,0,0,0,0,0,0,0,100
1ce76b5f324c76d32b3cad3dda472b2729db9d02,0,0,0,0,0,0,0,0,0,0,0,0,0,0,15,3,0,0,0,0,0,0,0,0,0,100
3d8d59136c8a0f2b5e1125a995836e39ecdfea08,12,14,798,784,0,0,0,11,27,1605,3,7,2.856844347,3855,16,4,395,502,107,24953,30309,5356,165,190,25,99.94407159
6fd37343589b3b7bb5387100e45d9a7db7694527,1,1,1,0,0,0,0,15,22,0,1,1,0,330,0,0,56,56,0,2555,2555,0,12,12,0,100
1821a17e6fe8bf02d479daa10c47e357d1cc1b98,6,475,57,418,3,0,3,1,6,2985,1,3,1.785979291,279,17,5,66,22,44,3915,1740,2175,27,14,13,99.63656696
185b9513706cd5b6046f00c9821a83580e2c35da,9,244,83,161,0,0,0,8,26,1143,2,5,2.541167043,2126,2,0,333,303,30,16149,15596,553,124,115,9,100
7b552af0dd154497533d523f72b57905b3dd2150,1,1,1,0,0,0,0,4,6,4638,1,1,0,70,0,0,6,6,0,295,295,0,2,2,0,100
650f362b9df9f3d0b318c3c7cfabb28a44cf587f,2,3,2,1,0,0,0,4,5,1448,2,2,0.970950594,180,0,0,12,12,0,1057,1046,11,7,7,0,100
103ccaf53fc316e03289c0fedceef973ca67cbaf,2,1,7633,7632,0,0,0,3,7,5099,2,2,0.005012709,6120,0,0,6,1269,1263,751,42453,41702,5,797,792,99.21392476
d367cb9e0945207d11529be7572ca68fff5a8bdd,1,7631,0,7631,1,0,1,4,6,1153,1,1,0,0,107,0,1263,0,1263,41691,0,41691,792,0,792,99.21392476
9199565875a80a67d7aa8124d3dfc9459a055a35,1,0,7631,7631,0,0,0,5,7,6090,1,1,0,6009,108,1,0,1263,1263,0,41691,41691,0,792,792,99.21392476
9bcd2716d8ce8c12a1467fdaf844b4f1c86f70e0,11,0,610,610,0,0,0,1,3,490,1,6,3.290479105,502,109,0,0,35,35,0,2547,2547,0,24,24,98.03811659
0e4c38089d68b20f91969b41c74a448530432cd6,12,611,1,610,11,0,11,1,10,45,2,7,3.311417811,197,1,0,73,37,36,3642,1089,2553,31,7,24,98.03811659
5a4dd8bab83fae7f059cd3986573487d6bf484b5,11,0,610,610,0,0,0,1,3,490,1,6,3.290479105,502,110,1,0,35,35,0,2547,2547,0,24,24,98.03811659
65281d3d328f2e65e5b98970cc395b568fa27cf4,1,2,1,1,0,0,0,4,4,527,1,1,0,110,111,2,6,6,0,762,751,11,5,5,0,100
375ecb2d84f635dc2c5f62a16afb11c16bfd20b6,1,1,1,0,0,0,0,4,6,4638,1,1,0,70,112,3,6,6,0,295,295,0,2,2,0,100
0d191dee92af544be5ae1da744186242a0192b2b,0,0,0,0,0,0,0,0,0,0,0,0,0,0,0,0,0,0,0,0,0,0,0,0,0,100
a72ba04ca8e630c9c4a4468af763dfd7a2b7f5eb,0,0,0,0,0,0,0,0,0,0,0,0,0,0,113,4,0,0,0,0,0,0,0,0,0,100
88d2b95a638df7d2dd8f4bbed0f82d4f75cea88d,2,0,479,479,0,0,0,5,7,400,1,2,0.852245247,404,114,5,0,33,33,0,2916,2916,0,22,22,99.8049596
a95d957bb541ceab3607bcce3f1412d0772e5b35,25,0,5920,5920,0,0,0,3,28,1891,4,10,3.945035344,4539,115,6,0,588,588,0,33162,33162,0,248,248,94.91847826
b80a3e592261cdac1159efb53d16192d86b2466d,0,0,0,0,0,0,0,0,0,0,0,0,0,0,116,7,0,0,0,0,0,0,0,0,0,100
53b6e28040124f70b47d8595aab6a3b603590388,0,0,0,0,0,0,0,0,0,0,0,0,0,0,117,8,0,0,0,0,0,0,0,0,0,100
44a28c03fb4fb36ef9f64150adec0a8cf808fc03,1,37,9,28,0,0,0,8,12,1255,1,1,0,445,118,9,37,35,2,3928,3683,245,17,16,1,100
85477e513bcd740e8deba2c43286504a5e1634bb,1,9,37,28,0,0,0,8,11,5,1,1,0,472,2,1,35,37,2,3683,3928,245,16,17,1,100
8777347dbab84871fe3df5285c6511814ce60e88,25,37,4196,4159,0,0,0,8,17,8337,2,4,3.782847514,3197,119,10,37,430,393,3928,20791,16863,17,154,137,98.43834141
843b8c2f151b2af3fe220cac238f7e8c30b73521,0,0,0,0,0,0,0,0,0,0,0,0,0,0,120,11,0,0,0,0,0,0,0,0,0,100
8b3c16c94aa12c448d9c1f6578f304f4a25771ae,0,0,0,0,0,0,0,0,0,0,0,0,0,0,1,1,0,0,0,0,0,0,0,0,0,100
4b8b10f868b149cb6ffde9edca87f54c7bc2843e,0,0,0,0,0,0,0,0,0,0,0,0,0,0,121,12,0,0,0,0,0,0,0,0,0,100
3c27b3e0438af4744240b94ad57d251ce0d75024,0,0,0,0,0,0,0,0,0,0,0,0,0,0,2,1,0,0,0,0,0,0,0,0,0,100
4923efe906b355f25aa803bd8cd24e39f1d97e39,5,24,23,1,0,0,0,4,9,6091,3,3,1.951905075,1260,3,2,142,143,1,9754,9714,40,58,58,0,100
dafa94ef8cc111f40c608f71e8bad6bf6164f3ee,3,10,0,10,0,0,0,9,13,3205,1,2,1.485475297,1082,4,3,101,101,0,8586,8530,56,44,44,0,100
509ae573f3c87b0136f012964795a7a7f30a9587,21,10,4114,4104,0,0,0,4,25,6077,1,3,3.536640046,3827,122,13,49,421,372,3440,25198,21758,26,163,137,96.55457552
808c22125223346a214d49abf0c57ff5a3d1432e,0,0,0,0,0,0,0,0,0,0,0,0,0,0,123,14,0,0,0,0,0,0,0,0,0,100
fe138547d442d7028291f545903269f6bb50ac6d,0,0,0,0,0,0,0,0,0,0,0,0,0,0,124,15,0,0,0,0,0,0,0,0,0,100
1980bd4c132db834930cd595b6ffec7cfd6cbdd9,8,0,3026,3026,0,0,0,7,9,3888,1,5,2.220047359,2399,125,16,0,505,505,0,18389,18389,0,246,246,97.49852855
ad7638de257c57cf0faba329142bc6bde2a10674,1,1,1,0,0,0,0,11,33,4783,1,1,0,1308,126,12,102,102,0,10609,10609,0,39,39,0,100
f9dbb2de255d59e35e3668a5c6c66a268a055207,0,0,0,0,0,0,0,0,0,0,0,0,0,0,127,12,0,0,0,0,0,0,0,0,0,100
5a742cf464f928be26b32df629da119f847ad793,0,0,0,0,0,0,0,0,0,0,0,0,0,0,6,0,0,0,0,0,0,0,0,0,0,100
e1a540a05b2c24c37cdbc3804f260ea2d62ac620,0,0,0,0,0,0,0,0,0,0,0,0,0,0,6,0,0,0,0,0,0,0,0,0,0,100
2cb42b1f9eb001309100a5f40a0368d9a9cd5843,0,0,0,0,0,0,0,0,0,0,0,0,0,0,128,0,0,0,0,0,0,0,0,0,0,100
67bbb5d68e1189c9dbe9f2c17278b8d672fe9409,0,0,0,0,0,0,0,0,0,0,0,0,0,0,6,0,0,0,0,0,0,0,0,0,0,100
2c65eb3669ee42c15d7cdf8f71752386f6be8c07,0,0,0,0,0,0,0,0,0,0,0,0,0,0,129,1,0,0,0,0,0,0,0,0,0,100
2e61411726b91d7ccf43c486ff383807cf5de56d,0,0,0,0,0,0,0,0,0,0,0,0,0,0,130,2,0,0,0,0,0,0,0,0,0,100
