CommitID,NMF,TotalAddLines,TotalDeleteLines,LC,FileAdd,FileDelete,NAD,NDEV,NUC,AGE,NS,ND,Entropy,LT,EXP,REXP,CommitComplexity,LastCommitComplexity,CFC,CommitTokenCount,LastCommitTokenCount,NCC,CommitMethodNum,LastCommitMethodNum,NMC,a2a
3802e1db9e8ad7aa12facb0643840a1c722c19f8,0,0,0,0,0,0,0,0,0,0,0,0,0,0,0,0,0,0,0,0,0,0,0,0,0,100
6b653c71f2fc8e408edeca4e9081df3fb7463329,92,97,16854,16757,4,0,4,2,2,-792,1,12,5.577419451,12516,3,3,10,1708,1698,312,70399,70087,10,519,509,31.22923588
b82f832098344d3c38241ba9d5848b94c678bc55,5,103,0,103,3,0,3,1,2,2,1,2,1.911878872,30,4,4,10,3,7,415,141,274,9,3,6,74.07407407
20e3f4f2e1302fb517ec6fd28c936d702b9c018a,0,0,0,0,0,0,0,0,0,0,0,0,0,0,5,5,0,0,0,0,0,0,0,0,0,100
790761a8a9660d2097028b14472db66569218e1d,3,1,52,51,0,0,0,1,3,3,1,2,0.931007193,38,6,6,0,4,4,64,174,110,0,4,4,79.31034483
699287bbd92d3d832254916b2f358b34d88c372b,2,18,9,9,0,0,0,1,2,0,1,1,0.918295834,27,7,7,5,5,0,155,162,7,4,4,0,80.95238095
fc0585a7163d6bec473b2acc5d1c352fb8272fbc,1,20,0,20,1,0,1,1,1,0,1,1,0,0,8,8,1,0,1,63,0,63,1,0,1,80.95238095
9bf4077fc5dd301587f23a0f84b92ac1d2f4bece,7,217,6,211,3,0,3,1,4,1,1,1,2.23451338,63,9,9,30,9,21,1104,377,727,26,9,17,77.41935484
28014fc270784cd2c4955a5d8971475da5eb7d4f,9,474,8,466,6,0,6,1,3,3,1,1,2.306959046,123,10,10,59,18,41,2419,664,1755,29,14,15,71.15384615
b17c6eb89da8932d7bf389d512f3a91cf0e8dcf0,16,6104,0,6104,16,0,16,1,1,0,1,1,3.359749145,0,11,11,867,0,867,21954,0,21954,192,0,192,63.46153846
be7460d372f5831081dc7b908c4d69b395699f8c,5,315,72,243,1,0,1,1,4,0,1,1,1.414019426,321,12,12,73,42,31,2985,1797,1188,24,19,5,97.91666667
e74ad53c3ce15ba7788601ca909d8d9439a0dfbc,2,178,11,167,1,0,1,1,3,11,1,1,0.977895682,26,13,13,20,5,15,1178,155,1023,11,4,7,97.31543624
ce688fa32d12c794d66d62bd052d1c5d677b6f1c,5,94,41,53,0,0,0,1,5,0,1,2,1.902760949,586,14,14,82,80,2,3883,3505,378,33,31,2,100
e723f662b8e65da90e2274ff9f2ea2fe31d6de48,17,689,154,535,2,0,2,1,6,4,1,2,2.914001713,859,15,12,159,115,44,7569,5246,2323,76,54,22,94.19354839
638e38557b424c4860955b89321f18173b347e36,6,3,32,29,0,0,0,1,7,0,1,2,1.906337592,957,16,13,115,115,0,5807,6025,218,41,41,0,100
edec3a8a77bc39d1d364a22eb45e0c21e952a5fe,9,229,108,121,1,0,1,1,8,8,1,2,2.419320429,923,17,9,125,111,14,6181,5687,494,53,46,7,96.22641509
c2b577b7fdb8c0b4afb6b8392eb79fde605a2511,10,377,139,238,4,0,4,1,9,2,1,3,2.952091401,954,18,10,148,122,26,6767,5895,872,53,48,5,88.82681564
913ea4d0b914fa87edd5e4719eeb9d4a11de4320,5,324,0,324,2,0,2,1,10,0,1,1,1.119283746,790,0,0,134,104,30,6325,4730,1595,37,23,14,97.53694581
c2e211bc66d4055a55e6b3c637c7c9bf17fd7f22,6,77,17,60,0,0,0,2,11,1,1,2,1.460034644,1142,1,1,162,157,5,7557,7225,332,56,54,2,100
d1e8d87ca379679720fa03595dfb92149c30f916,3,17,11,6,0,0,0,2,12,0,1,2,1.148834854,345,2,2,46,46,0,2242,2224,18,25,25,0,100
97d87dfb664c691de2ff9833f9021e899558cd5a,9,639,93,546,1,0,1,2,13,0,1,3,1.577111467,1231,19,10,224,162,62,10387,7809,2578,59,50,9,97.6076555
565e84d7f51058da6dbcc5c9aecccf8047c43d94,0,0,0,0,0,0,0,0,0,0,0,0,0,0,20,11,0,0,0,0,0,0,0,0,0,100
d93b5525c4769595f4a2bf5fb4e0fde02908c04b,2,9,3,6,0,0,0,2,12,0,1,2,0.811278124,529,21,12,72,71,1,3223,3193,30,17,17,0,100
f01c4c502c3396f50ee4efe23650b94f6e62ed77,1,19,2,17,0,0,0,1,3,30,1,1,0,64,22,13,13,9,4,427,357,70,5,5,0,100
9de7ce118f3ac0de74799018f23ee69aaa1422f7,4,65,26,39,0,0,0,1,14,6,1,1,1.629834764,1293,23,14,178,172,6,7814,7582,232,36,36,0,100
1f19e8c99625f5326197032444dcbbcfd394d758,1,9,8,1,0,0,0,2,12,2,1,1,0,690,24,13,96,96,0,4006,4006,0,18,18,0,100
4f92d5e097ae75da60b7e96695fb92438d4c0717,13,330,148,182,2,0,2,2,15,5,1,3,2.853155559,1456,25,12,213,197,16,10116,9106,1010,76,72,4,95.30516432
8c8cb8b0132c2416279a52da47b0015120496a09,9,127,39,88,1,0,1,1,16,2,1,2,2.359496291,1348,26,13,191,184,7,8652,8277,375,70,65,5,98.17351598
80395c05fc5f830687d52d96bfb12730bdca179c,10,164,24,140,1,0,1,2,17,0,1,3,2.592133121,1900,27,13,263,253,10,12419,11707,712,81,75,6,98.66071429
6383eaf79b511997acdc1ba69119b9c90156a7db,1,32,22,10,0,0,0,2,18,20,1,1,0,228,28,11,28,25,3,1491,1446,45,7,7,0,100
b391321fbb36f60b37fb4821d9548d23d2cedcd0,2,43,1,42,0,0,0,1,6,20,1,2,0.266764988,441,29,12,67,63,4,2724,2569,155,14,12,2,100
6a88ba8bcf988f4ed3b26eece530bf24ce82e751,10,458,137,321,0,0,0,1,19,22,1,2,2.561400141,1894,30,12,288,249,39,12782,11375,1407,78,70,8,98.2300885
ef1f504ac1d53746f8abaf1ce7b3e53b022e9863,2,24,3,21,0,0,0,1,20,4,1,2,0.99107606,493,31,13,56,53,3,3379,3265,114,16,16,0,100
29b4f4d5d4173ab0288e42b6dd5a06a2392d486e,19,808,138,670,7,0,7,2,21,8,1,3,3.415521054,1792,3,0,307,240,67,15011,11289,3722,107,81,26,92.4
40d7371a16969b9b4b2de13671e1be32a0416d2b,1,50,52,2,0,0,0,2,4,0,1,1,0,279,4,1,25,25,0,1971,1982,11,9,9,0,100
ea0a8d9165630f99fa1b8cea066c39a19f21b1ff,0,0,0,0,0,0,0,0,0,0,0,0,0,0,5,2,0,0,0,0,0,0,0,0,0,100
07048640b08c4655cb3d3e94a246fc770a9f8440,11,288,293,5,0,0,0,1,22,0,1,2,2.71812166,1859,6,3,260,260,0,11801,11801,0,89,89,0,100
51499677db577eadf772dfcbe994913a19096105,5,21,34,13,0,0,0,1,23,11,1,1,1.566179186,883,32,5,124,124,0,5337,5402,65,30,31,1,100
b01812e7af9932e839e36e3c870653ca8357ec64,3,0,0,0,0,0,0,1,1,0,1,1,0,142,7,4,17,6,11,1075,789,286,10,6,4,95.62043796
f965d0207414d856cc6700475888cd9a8f068a21,3,3,3,0,0,0,0,1,2,0,1,1,1.584962501,142,8,5,17,17,0,1075,1075,0,10,10,0,100
a784ca5a1fada89fbdaead2ff3461354bcf722b1,15,633,173,460,5,0,5,1,24,8,1,3,3.36835035,2271,9,6,372,325,47,16343,14087,2256,107,93,14,93.79084967
9249661c91077205bdc2dc7808df9ea10b97b889,20,240,222,18,1,0,1,2,25,16,1,4,3.724607711,2452,33,6,337,339,2,15970,15922,48,112,112,0,96.1414791
2932af3b95acfee04e04befbf137983af22344a5,22,1110,582,528,6,0,6,2,26,7,1,4,3.035425695,2848,10,3,468,398,70,20910,18121,2789,128,116,12,92.30769231
f1226b7d8d0cd6f55151493be5fa90a06c64b43c,1,0,58,58,0,0,0,2,8,0,1,1,0,20,11,4,0,0,0,0,91,91,0,0,0,98.7012987
4675575bedae0b9df282c83bd9ed57eebd0615e2,1,8,2,6,0,0,0,1,3,0,1,1,0,41,12,5,3,3,0,379,361,18,2,2,0,100
a8c64fe62b8e4ae1f9393c9f66789eac6ea8ab56,10,0,717,717,0,0,0,1,6,6,1,2,2.945230634,543,13,6,0,71,71,0,4079,4079,0,25,25,91.51943463
5ed96f4fd93398ff74363e12004b1f6e5a29dc15,1,2,2,0,0,0,0,1,2,3,1,1,0,446,14,7,80,80,0,2925,2937,12,21,21,0,100
daabf948530d048ac5d200fbcb99a0b9a82fcf4d,0,0,0,0,0,0,0,0,0,0,0,0,0,0,15,8,0,0,0,0,0,0,0,0,0,100
7c162fff0837d77c9f981be0f10c8e15551e5dbd,50,5169,4121,1048,3,0,3,1,27,39,1,4,4.250895073,6873,34,2,1448,1331,117,47647,42780,4867,388,352,36,96.26865672
5b03ce3abefe99f7e2d8533fc4fa5134080ef1e7,4,92,42,50,1,0,1,2,23,0,1,1,1.682037359,1035,35,3,169,165,4,6595,6461,134,49,47,2,99.27007299
e08b8f97d3776f8c80ed3efdd8062b09fc50b5f2,1,15,13,2,0,0,0,2,4,0,1,1,0,449,16,9,80,80,0,2959,2957,2,21,21,0,100
afd12098e921f4f6c0834e47c88b9efc2182ed9b,1,1,5,4,0,0,0,2,3,0,1,1,0,14,17,10,0,0,0,80,114,34,0,0,0,100
c51001b0afd2764a9d08638f1f801f3ac7553bf9,3,69,54,15,0,0,0,2,28,0,1,2,1.283639488,1201,36,4,147,146,1,7967,7916,51,31,31,0,100
53526155e5995dfc023cc791935071af3c112a6f,13,653,11,642,5,0,5,2,29,32,1,4,3.242926586,2473,18,0,427,355,72,18361,15590,2771,141,107,34,93.56913183
3659e9ab52b7f6470830d07c535a025837e0e7ac,2,10,1,9,0,0,0,2,30,50,1,1,0.684038436,766,19,1,110,108,2,4703,4645,58,25,25,0,100
66b98781a2bf48ec6c71cf9e880531698fb4e540,33,1538,332,1206,3,0,3,2,31,51,1,3,3.686543889,4335,37,1,753,632,121,33372,27739,5633,224,190,34,95.84487535
7f19e47843d43aabd192683269b1d066784e907b,17,0,6105,6105,0,0,0,1,32,112,1,2,3.361495026,3882,38,2,37,904,867,1925,23886,21961,11,203,192,85.01628664
e0e3bd77e65f653d6392b682a622d05a3a9f1b4f,5,86,38,48,0,0,0,2,33,0,1,2,2.291191626,573,39,3,90,88,2,3904,3853,51,49,43,6,97.08333333
2a378903d878eaa0d7b1253f285decd9aacde071,8,60,47,13,0,0,0,1,34,0,1,3,2.460784096,3083,40,4,450,452,2,19507,19444,63,114,113,1,93.01310044
2ee8562cda6ecf832424075444ef375ebee9c8e1,4,56,19,37,0,0,0,2,35,2,1,1,1.753609801,2793,20,1,398,395,3,17454,17268,186,69,69,0,100
7a287df9212439f896cafc8cf48e5692ab1ec191,3,67,70,3,1,0,1,2,6,4,1,1,1.559737702,517,21,2,92,99,7,3394,3671,277,25,32,7,93.80530973
b1c245e36b797d6d3d515a46fdc5101e8ef806dd,7,215,14,201,1,0,1,2,36,8,1,3,2.446528044,3641,22,3,549,526,23,23878,22864,1014,131,125,6,98.32635983
fb284bb86acac6b467a0094a55c88e248980d0e3,13,868,742,126,4,0,4,1,37,10,1,1,2.696784233,3453,41,5,525,527,2,21935,21571,364,140,138,2,91.56626506
7aa3db4f2c0faf87acac71b984ece2bfcce85cc8,4,27,27,0,0,0,0,2,12,4,1,3,1.489722164,1653,42,6,214,213,1,10591,10606,15,37,37,0,100
33ebdedd889667cbbeec6bcab8072f1babd3b53d,3,12,2,10,0,0,0,2,13,21,1,2,0.734529921,2286,23,3,304,304,0,14687,14616,71,51,51,0,100
6046590933f7484ebc79be98ebfb4f0a5243f14d,1,3,1,2,0,0,0,2,38,23,1,1,0,323,24,4,40,39,1,2143,2133,10,12,12,0,100
c1337f2fac308ac34e2cd9bf9f776b927a10db71,35,2105,891,1214,6,0,6,1,39,31,1,3,4.03840077,5044,43,1,858,723,135,38738,32273,6465,261,216,45,86.50793651
459ffcf1c47792734b8a632658cc974afb4fffcd,0,0,0,0,0,0,0,0,0,0,0,0,0,0,44,2,0,0,0,0,0,0,0,0,0,100
599eb6e7924947bf4a51e30b74d339ae4cf6bf4d,7,26,19,7,0,0,0,2,40,0,1,1,2.519041491,3715,25,2,565,564,1,23049,22967,82,129,128,1,100
bf5d00836e1926eac6b052cc785455e6612ba9ac,1,1,1,0,0,0,0,2,13,0,1,1,0,974,26,3,144,144,0,6520,6520,0,24,24,0,100
78b69b7284d01b158ba115d17ac619349e662eee,18,141,130,11,0,0,0,1,14,9,1,3,3.363368544,2211,45,3,296,424,128,15552,18055,2503,91,128,37,68.99224806
277d8be7087ee7c889c562d832eeb6e82ed479f3,8,99,44,55,0,0,0,2,41,20,1,1,2.250697794,3788,27,2,570,561,9,24084,23820,264,129,127,2,100
b101155a23c9abd1c69e063aa81d5f09024726d1,1,0,3,3,0,0,0,2,17,0,1,1,0,16,28,3,0,0,0,97,104,7,0,0,0,100
73614f3091fad6fa7a90ed3d81d2116b18207a63,20,498,440,58,1,0,1,1,42,18,1,3,3.649930071,4779,46,4,693,687,6,30323,30853,530,196,196,0,98.51851852
a467f8b58519de0d7c422f3a366066c8fd6b47a2,0,0,0,0,0,0,0,0,0,0,0,0,0,0,0,0,0,0,0,0,0,0,0,0,0,100
999fb470fd47299f401347125e859dc5f7fc10ff,0,0,0,0,0,0,0,0,0,0,0,0,0,0,1,1,0,0,0,0,0,0,0,0,0,100
38fc0178e57a1f92939e764f308d7473f949fa45,0,0,0,0,0,0,0,0,0,0,0,0,0,0,2,2,0,0,0,0,0,0,0,0,0,100
04e2336d92881aaa5aba3d2985fc1e0a2f75e8b2,0,0,0,0,0,0,0,0,0,0,0,0,0,0,3,3,0,0,0,0,0,0,0,0,0,100
0358c02788cf16c78dc20f7a63fcc5ab1e8b8cfd,0,0,0,0,0,0,0,0,0,0,0,0,0,0,4,4,0,0,0,0,0,0,0,0,0,100
64127a100e51f75864d1fcb1251aab805dd14544,0,0,0,0,0,0,0,0,0,0,0,0,0,0,5,5,0,0,0,0,0,0,0,0,0,100
ad73a48489037f3f5d7049487b6693215e4e94fc,0,0,0,0,0,0,0,0,0,0,0,0,0,0,6,6,0,0,0,0,0,0,0,0,0,100
467358e8f191748521c6c4057874c06d2253fdd0,5,39,36,3,0,0,0,2,43,55,1,1,1.399759592,3761,29,0,554,554,0,23472,23400,72,95,95,0,100
de2bfb187d00668d4d35c23dba5f09aed2e2669d,1,1,1,0,0,0,0,2,18,0,1,1,0,974,30,1,144,144,0,6485,6485,0,22,22,0,100
a3c275fc6d299f7f03b4615877ac1b43a1e0b6ce,1,1,1,0,0,0,0,2,44,3,1,1,0,390,31,2,55,55,0,2381,2381,0,9,9,0,100
969a81b999ee5c46f2753d2fa10403bfdb1d8176,0,0,0,0,0,0,0,0,0,0,0,0,0,0,32,3,0,0,0,0,0,0,0,0,0,100
083662a120778820dca5d6f7c30a514c080b3dd1,1,4,3,1,0,0,0,2,45,8,1,1,0,390,33,4,55,55,0,2402,2381,21,9,9,0,100
ae04021c1c7c173e85e009e425556b63023290d4,1,9,4,5,0,0,0,2,46,0,1,1,0,391,34,5,56,55,1,2411,2402,9,9,9,0,100
ef7865d50d28487172e4357531dee1b8ef9641f6,4,310,2,308,1,0,1,2,47,38,1,2,0.545503356,1108,35,6,206,170,36,9047,7095,1952,43,39,4,94.94584838
9587d63012a9ca63dc0cf35b042bceb09e73eaaa,1,6,6,0,0,0,0,2,48,6,1,1,0,400,36,5,57,57,0,2438,2438,0,9,9,0,100
fb921be550516573b79da5c57d559d08800d354f,17,138,82,56,0,0,0,2,49,203,1,3,3.17016369,3327,47,1,457,447,10,22036,21573,463,107,105,2,98.93238434
443ffd7308eee17b44d5afa04647c22e881490f9,0,0,0,0,0,0,0,0,0,0,0,0,0,0,48,2,0,0,0,0,0,0,0,0,0,100
3645af5c33ee74588ba395c0de76a0633d7505c4,5,21,26,5,0,0,0,1,50,165,1,2,1.668524217,2640,49,3,369,370,1,16517,16537,20,52,52,0,100
7029c40c451c0a44ac25375c1027f3517555baef,8,185,130,55,0,0,0,1,51,61,1,2,1.457660618,3532,50,4,497,495,2,22350,22206,144,90,89,1,100
5292c383572442f772705ccb47a40f9c1e132061,4,64,20,44,0,0,0,1,52,9,1,2,1.14807152,2140,51,5,341,332,9,14122,13909,213,68,67,1,100
7a9158c416ede7ee7fe8fe0ae1feeb9203f16204,1,75,17,58,0,0,0,2,15,293,1,1,0,44,52,6,8,4,4,737,300,437,4,4,0,100
d87286c20aed61d8153fbbe9446cc337f9a48b63,0,0,0,0,0,0,0,0,0,0,0,0,0,0,53,7,0,0,0,0,0,0,0,0,0,100
cf8218adfd75ec77f3c503a89a723c5e1b8060e2,1,21,0,21,1,0,1,1,1,0,1,1,0,0,54,8,1,0,1,79,0,79,1,0,1,98.55072464
02712b5c5313b244d633b245a86db86396a20921,1,66,0,66,1,0,1,2,9,461,1,1,0,0,55,9,0,0,0,156,0,156,0,0,0,98.18181818
0b2ae8ac61188435d68defd2df2e85f15b87e12a,1,33,0,33,1,0,1,1,1,0,1,1,0,0,56,10,4,0,4,172,0,172,1,0,1,99.28571429
cfe104b77430640cea5eadd0f5561ee4fdc80fe5,16,275,224,51,0,0,0,2,53,94,1,3,2.567841221,5391,57,11,814,813,1,34294,34198,96,216,216,0,100
64d1772115943514281c3a1460c329b0ae03b37e,1,2,2,0,0,0,0,2,19,0,1,1,0,1233,58,12,167,167,0,7319,7317,2,19,19,0,100
298302e63283c77a99803de0971a50fd6286ddf7,1,6,7,1,0,0,0,2,10,24,1,1,0,22,59,10,0,0,0,156,156,0,0,0,0,100
52ffec9114f264da2f9a04e20a948cfe59577f0a,26,1263,582,681,2,0,2,2,54,165,1,3,2.75836995,5520,60,1,884,794,90,37940,35137,2803,249,229,20,95.27027027
d2e6f8b61fd410227e50f8ba98d7633e780b943b,28,233,184,49,0,0,0,1,55,127,1,2,3.838973443,5455,61,2,814,810,4,35005,34661,344,214,212,2,100
3023be9d79b40f0e1cd1c59bab5128f989f49c6a,32,1593,426,1167,7,0,7,1,56,78,1,4,4.20200629,6111,62,3,1056,929,127,43332,38319,5013,316,267,49,88.53503185
767ef9c1d9c4c3e3806674ea24e1cfa92e9a02cf,1,45,0,45,1,0,1,1,1,0,1,1,0,0,63,4,0,0,0,120,0,120,0,0,0,97.07602339
135aaa6fdf968827e72e95ddaaf47e128b2ccba4,7,21,70,49,0,0,0,2,57,4,1,1,2.209320569,3490,64,5,537,545,8,21310,21564,254,111,116,5,96.50145773
594798dc176216f10fc08aa21b324e08027bd56f,14,662,341,321,0,0,0,1,58,6,1,2,1.978352415,6272,65,6,1081,994,87,40704,39375,1329,267,264,3,98.13084112
60c1fe480fd8549668d55d8f57ba1f972fff3d8c,1,1,2,1,0,0,0,1,4,0,1,1,0,163,66,7,32,32,0,1121,1121,0,16,16,0,100
40169f816c5671850cac535d71b0c8e849d5d2c9,71,133,133,0,0,0,0,2,3,180,1,4,5.784096327,8996,67,8,1373,1207,166,57039,50268,6771,416,426,10,11.21495327
22f425e04e579f94fa96b5b822676756150a2f52,0,0,0,0,0,0,0,0,0,0,0,0,0,0,68,9,0,0,0,0,0,0,0,0,0,100
092fba02e06639507e420af7481ffd0ba92a5d7d,73,618,592,26,2,0,2,2,4,423,1,8,5.293409322,8996,69,9,1373,4552,3179,57837,172098,114261,416,894,478,33.01587302
959be9fa510a390e177442f647f80c83d82e6ada,17,718,718,0,0,0,0,2,5,0,1,5,3.350445582,5668,70,10,926,925,1,34188,34080,108,242,243,1,100
14d06fc1bb85eab4ac080fe04dc10e2682557c8c,0,0,0,0,0,0,0,0,0,0,0,0,0,0,71,11,0,0,0,0,0,0,0,0,0,100
2b3ed7f36ec79aa70637737cb84edb0ceb21710a,21,444,189,255,5,0,5,2,6,175,1,4,3.734909016,2692,72,11,398,379,19,18923,18054,869,115,101,14,89.48948949
692341d8ae8142302acd0c7315794ace4a659e08,74,1743,375,1368,1,0,1,2,7,10,1,7,5.786842615,9194,73,12,1406,1393,13,58581,58814,233,443,429,14,94.47368421
0990ee01b83a71cf07232d704d8d7bb9f29f1a73,73,247,210,37,0,0,0,2,8,0,1,7,5.76792393,10410,74,13,1412,1406,6,58722,58581,141,443,443,0,100
d25497a3612c07ac0b355d30f0f663535dde2a96,2,17,11,6,0,0,0,2,8,0,1,2,0.985228136,1147,75,14,180,179,1,7186,7158,28,33,32,1,100
4c3842bc6a4f383683f792e9b1148f42bb7fc41d,1,84,0,84,1,0,1,2,3,746,1,1,0,0,76,15,7,0,7,281,0,281,5,0,5,98.2278481
828c61581c9f63529664ae4648948d786e52c79a,38,1116,569,547,3,0,3,2,9,60,1,7,4.466239655,7268,77,16,1130,1049,81,45429,42473,2956,298,284,14,89.58837772
0085f978d15b2cce81a1bc95ac8b8977375d9239,1,10,9,1,0,0,0,2,9,0,1,1,0,707,78,17,119,119,0,4361,4383,22,21,21,0,100
9341781624ac9adda74d5bb9a6d2a4ddf58a2730,6,471,59,412,2,0,2,2,10,257,1,2,2.124729607,3726,79,18,659,610,49,23934,21991,1943,140,125,15,98.87640449
54f4654a8298aae874044c94ecb1db5e800720e9,11,453,176,277,0,0,0,2,11,4,1,5,2.81031552,6442,80,14,1095,1043,52,39832,38387,1445,233,232,1,100
9112ab1c1c8a1fa4a5896e341b6a9a119383d5c2,28,957,119,838,6,0,6,2,12,197,1,8,4.018855181,6973,81,8,1132,1064,68,45158,41682,3476,275,251,24,93.79844961
f18ae3f9b70cc9ef17487b3aed196383728d5ffc,2,3,3,0,0,0,0,2,9,9,1,1,0.918295834,247,82,9,32,32,0,1516,1516,0,14,14,0,100
2b4801a84254db61f76511b1f58acd622277db91,1,7,0,7,0,0,0,2,7,23,1,1,0,87,83,10,20,18,2,552,509,43,4,4,0,100
5041f04409079e8823313eb885139edfcdae21ae,18,997,916,81,1,0,1,2,13,53,1,6,2.465312798,7448,84,8,1228,1220,8,44110,44193,83,280,275,5,97.46376812
568b160360d303ceba0366df415079ad304ff2d1,1,5,2,3,0,0,0,2,10,0,1,1,0,637,85,9,100,100,0,3592,3582,10,17,17,0,100
bdf0ca1e0b7aa48234dcd0241ba95036030a5d0c,16,65,55,10,0,0,0,2,12,15,1,4,3.585941146,5066,86,10,816,812,4,29438,29392,46,157,157,0,100
7fc6783ee689472a614df5b354b9494559a93a36,13,217,141,76,2,0,2,2,14,131,1,5,2.877860767,4967,87,11,802,800,2,29786,29625,161,141,140,1,99.24528302
8cf047c71ebbf2bd72c324b2733f3ec8e7e77d9c,4,33,23,10,0,0,0,2,15,8,1,2,1.615988978,3686,88,12,607,606,1,21671,21636,35,104,104,0,100
2b711d06e8960d3313d9efca87f02771e98ee40b,1,4,2,2,0,0,0,2,6,30,1,1,0,539,89,9,116,116,0,3534,3513,21,10,10,0,100
70905bc0e29d99a11312c7f2c628f8998fa0427a,1,19,3,16,0,0,0,2,13,37,1,1,0,237,90,7,27,26,1,1319,1284,35,14,13,1,100
d3a3745435c0157f6dc4ea5f49b3300d2829dacd,2,215,19,196,0,0,0,2,10,41,1,2,0.449738087,269,91,8,46,30,16,2972,1747,1225,23,16,7,98.02867384
b46a71ae5c6fa016a2cef9cb72bc0b13607e6f9e,1,1,1,0,0,0,0,2,7,8,1,1,0,542,92,7,116,116,0,3534,3534,0,10,10,0,100
6f434710c5efe26b94da5915fbcbb699c150bd76,1,26,26,0,0,0,0,2,6,3,1,1,0,217,93,8,26,26,0,1457,1457,0,12,12,0,100
13e034ddc9180974eb96e9c312afbaee7a24c6eb,4,17,16,1,0,0,0,2,11,51,1,3,1.828844606,1050,94,8,160,158,2,6432,6431,1,38,38,0,100
231c5a3c24c37ba90935a66c194643afc94e3ac8,11,114,37,77,1,0,1,2,16,127,1,4,2.885313597,3853,95,7,572,570,2,22303,22227,76,110,108,2,99.48275862
759c1532dc7d4180fc136678f68a5953c89d04ed,3,32,12,20,0,0,0,2,16,33,1,1,1.219748493,2396,96,8,412,412,0,14002,13954,48,37,37,0,100
c3603e817d59ae2f3f05371bd03ea78e167d9fc5,5,5,5,0,0,0,0,3,11,117,1,3,2.321928095,700,0,0,89,89,0,4072,4072,0,53,53,0,100
fe5485ca454c1b157d89d55430374dac64eec72d,0,0,0,0,0,0,0,0,0,0,0,0,0,0,97,2,0,0,0,0,0,0,0,0,0,100
71d2a937dada4a1032a5ae848dd5d73b20ab349c,0,0,0,0,0,0,0,0,0,0,0,0,0,0,1,1,0,0,0,0,0,0,0,0,0,100
7400aa989d6faf83782eaad4cefb6e00d859a5f0,88,334,298,36,0,0,0,3,17,65,1,10,6.395318613,12530,0,0,1708,1708,0,70447,70447,0,519,519,0,100
5f7be716fe2a49b168a936774f1f0db02874d4c6,0,0,0,0,0,0,0,0,0,0,0,0,0,0,2,2,0,0,0,0,0,0,0,0,0,100
158fd55769c86a5b238b8b0a95febed5b4175787,1,11,8,3,0,0,0,3,13,4,1,1,0,640,98,1,101,100,1,3610,3592,18,17,17,0,100
012448179e513f641bec96bb9b9f8e60a4873072,0,0,0,0,0,0,0,0,0,0,0,0,0,0,2,0,0,0,0,0,0,0,0,0,0,100
5560a6d07b636828a013b22b5949946dc8712883,3,38,24,14,0,0,0,3,13,6,1,1,1.398715359,1107,99,2,162,162,0,6802,6802,0,39,39,0,100
91e6d264d71d5d5567f41c16a5410a6adf21131f,0,0,0,0,0,0,0,0,0,0,0,0,0,0,3,1,0,0,0,0,0,0,0,0,0,100
c1363f6d23839a65179e310e1415a368d65bdc59,1,287,195,92,0,0,0,4,18,7,1,1,0,1120,3,3,184,178,6,7279,6998,281,30,24,6,100
95b491e43ad9bf459f281158d9c152cc3b291dcb,1,3,1,2,0,0,0,4,18,8,1,1,0,1724,4,4,281,280,1,9653,9643,10,25,25,0,100
96c0e3db0037c492d738a10b85db5bb894476ebe,0,0,0,0,0,0,0,0,0,0,0,0,0,0,4,2,0,0,0,0,0,0,0,0,0,100
dfc210bf549d618124d4b9195bf7de37c4533c78,4,141,53,88,1,0,1,1,19,19,1,3,1.408438252,1909,100,3,302,297,5,10908,10607,301,30,27,3,99.14236707
ab9a2c89c5f39ac2cc5d3ca51714fccb10dbc00c,13,378,318,60,1,0,1,3,19,24,1,4,3.175016474,4576,101,3,780,771,9,28643,28166,477,232,223,9,94.16195857
d0bb2a9a377bd78990736f858d57504befc95421,1,3,3,0,0,0,0,4,14,8,1,1,0,158,102,4,27,27,0,876,867,9,17,17,0,100
ea0c721e8dbdcf88e5e36103f7da7f69ab4a8da0,1,15,0,15,0,0,0,3,14,43,1,1,0,641,103,4,103,101,2,3668,3610,58,17,17,0,100
183a812d509b0133f32941337e09ae3fa3d68cec,16,191,171,20,0,0,0,3,20,18,1,4,3.660995933,3680,104,5,550,544,6,22360,22602,242,164,160,4,97.00854701
34dcec58612d4c189815e41aef87b50058491ed4,1,18,0,18,0,0,0,2,2,13,1,1,0,58,1,0,10,10,0,319,319,0,10,10,0,100
7c637182d973e21d7feb136326a97b88f27c3827,0,0,0,0,0,0,0,0,0,0,0,0,0,0,105,5,0,0,0,0,0,0,0,0,0,100
9dd9af5294cca4ef0e4a19ec4829294b2a5d850f,5,52,27,25,0,0,0,3,16,18,1,4,1.874649353,1478,106,6,234,231,3,9190,9131,59,79,77,2,100
2ebee1e253707cecb80407a52fbf1125dab14fa4,0,0,0,0,0,0,0,0,0,0,0,0,0,0,0,0,0,0,0,0,0,0,0,0,0,100
ef4d6d4c86ada606ab3ac209762156b7fa148863,1,200,0,200,1,0,1,1,1,0,1,1,0,0,2,1,21,0,21,1052,0,1052,8,0,8,98.1981982
7bde967c89efe4b57b4409257b59938dccae8767,0,0,0,0,0,0,0,0,0,0,0,0,0,0,5,0,0,0,0,0,0,0,0,0,0,100
491c8e53e1a2b8f00085b502582f4e0694175fa6,0,0,0,0,0,0,0,0,0,0,0,0,0,0,6,1,0,0,0,0,0,0,0,0,0,100
70a811203df88e5afbe189aac2b0390449cf3341,1,1,1,0,0,0,0,3,12,52,1,1,0,568,107,0,117,117,0,3625,3625,0,11,11,0,100
cdd6422c6c252e7fbb2cd28128f2f1d9c4e57664,5,189,284,95,0,0,0,3,16,85,1,3,0.354473859,1441,3,0,192,215,23,8257,8619,362,66,66,0,100
1449d77c412289e555666967f368bb1e75930cf2,0,0,0,0,0,0,0,0,0,0,0,0,0,0,7,0,0,0,0,0,0,0,0,0,0,100
c69d5447806e9442fb7caa5fd8d652b652e84239,1,32,29,3,0,0,0,3,17,15,1,1,0,804,108,1,128,128,0,5337,5330,7,33,33,0,100
7226aba42f158a422ad77f38212ccfbda70a62c6,5,33,18,15,0,0,0,4,21,95,1,3,2.294565424,2307,109,1,346,339,7,14883,14813,70,79,79,0,100
5573a00919fe0a900a42492c0bd9f5c8d807e25b,4,369,1,368,3,0,3,1,8,43,1,3,1.75731344,77,8,0,35,11,24,2075,330,1745,25,9,16,98.62385321
9ca2d29f11aa98e6795f329b702f0f284bfd0e6e,0,0,0,0,0,0,0,0,0,0,0,0,0,0,9,1,0,0,0,0,0,0,0,0,0,100
33bd9c0ffbca05f40cdafe5f299b06bf94807c86,1,1,1,0,0,0,0,1,2,3,1,1,0,83,10,2,9,9,0,551,551,0,3,3,0,100
873a00cc383ef9a99c6e28bf4735db1c75f40473,2,207,0,207,2,0,2,1,1,0,1,2,0.968644929,0,11,3,9,0,9,1375,0,1375,7,0,7,98.88143177
9e30d2abae57fdaaaf21b710b77d9b52e587a88b,2,232,0,232,2,0,2,1,1,0,1,2,0.903252947,0,12,4,14,0,14,1375,0,1375,12,0,12,99.12280702
c63e2078ff7acd09bc35a6f639b431327b35c0c7,0,0,0,0,0,0,0,0,0,0,0,0,0,0,13,5,0,0,0,0,0,0,0,0,0,100
261d29d95d51eb9acbccff1df579208966c418f1,39,1077,453,624,2,0,2,2,22,98,1,9,4.419008116,9008,110,0,1419,1326,93,58090,54045,4045,447,385,62,95.08196721
3900b2fe9cf35846e6a996177e89cacc462a4781,1,17,0,17,0,0,0,2,2,0,1,1,0,59,14,6,8,8,0,476,476,0,8,8,0,100
975c3e1c81475ca506b2174ef396b22670a1268c,23,677,280,397,3,0,3,3,23,68,1,5,3.704212867,4992,111,1,796,764,32,31999,30578,1421,279,257,22,96.66011788
5acfb92b96614e93b00a62dcfb82bd6ef0e3b3ce,0,0,0,0,0,0,0,0,0,0,0,0,0,0,0,0,0,0,0,0,0,0,0,0,0,100
d9c9522c20b68a9d7e4171dbf4ffb82abfb79e40,2,2,2,0,0,0,0,3,9,10,1,1,1,321,15,2,36,36,0,1957,1957,0,10,10,0,100
096a16d387f87ced029d13a628794a935633d0cf,0,0,0,0,0,0,0,0,0,0,0,0,0,0,16,2,0,0,0,0,0,0,0,0,0,100
c6e1efc80ca7d2b02e60f2c86476013f93cbd7ae,0,0,0,0,0,0,0,0,0,0,0,0,0,0,17,3,0,0,0,0,0,0,0,0,0,100
3c869cc934ae7ee079aaaa89d8b1aacbe7171561,2,142,7,135,1,0,1,4,15,10,1,2,0.750492868,569,18,4,133,118,15,4480,3644,836,17,12,5,99.6031746
db028f58017bdeb1f2e9f7c2a441195db0056767,60,4460,3276,1184,27,0,27,3,24,31,1,9,4.871591839,8287,112,2,1277,1268,9,50133,48972,1161,458,366,92,84.81228669
0b4223997328a7a12ac809a4c0509126ec8d0a8d,0,0,0,0,0,0,0,0,0,0,0,0,0,0,0,0,0,0,0,0,0,0,0,0,0,100
9b047d403b799b6187ebcaf1aa635b67c64fbc8c,1,2,2,0,0,0,0,4,10,2,1,1,0,151,19,5,16,16,0,886,886,0,8,8,0,100
3e65823def5d984b4199d6e16eb1c556d1f180b7,4,10,15,5,0,0,0,1,25,0,1,3,1.910308333,1716,113,3,277,277,0,10424,10436,12,44,44,0,100
16a377981ce6c98deb436fde13dff77cb04b2256,1,0,1,1,0,0,0,1,4,5,1,1,0,252,114,3,41,41,0,1451,1460,9,24,24,0,100
539f2b864205eb52374844fbee1a019f4c276dab,9,583,30,553,2,0,2,1,26,27,1,6,1.976237604,2971,115,4,536,458,78,21191,18367,2824,131,99,32,99.10581222
aace0a237e41200b755c7411381491ef2caa6d1b,1,2,2,0,0,0,0,4,10,8,1,1,0,183,20,5,29,29,0,986,988,2,9,9,0,100
2915a7e50a27b816c1570b6422a841cd818255c9,3,147,1,146,2,0,2,1,3,15,1,2,1.088559432,61,21,6,14,5,9,1298,376,922,10,3,7,95.81699346
4351491c6c7d1e00492cc36438824b6340cbdc66,2,36,0,36,0,0,0,2,2,0,1,2,1,105,0,0,9,9,0,922,922,0,7,7,0,100
48d72c7fa9b6912afd71299ba8e49bf03f43ce8e,0,0,0,0,0,0,0,0,0,0,0,0,0,0,1,1,0,0,0,0,0,0,0,0,0,100
d6bfcc48eeeb6012f935601eb427e14c4673bf50,1,3,3,0,0,0,0,2,4,60,1,1,0,87,22,7,9,9,0,619,616,3,4,4,0,100
fe9d9dd7ca90ab7cebb8cbceea05695a135061f5,1,2,6,4,0,0,0,2,5,25,1,1,0,251,2,2,41,41,0,1427,1451,24,24,24,0,100
9d3d7e8fc94f45449a27f303406ca93d56e79bf6,1,8,15,7,0,0,0,4,7,265,1,1,0,61,3,3,8,8,0,210,210,0,6,6,0,100
517b8d4ddf9b8439dd853294509bcd7afa75bb0a,6,535,22,513,3,0,3,1,21,55,1,4,2.089420357,883,23,4,185,148,37,7835,5309,2526,52,29,23,96.58952497
a6ad0ca16a02b8cc82c5aeb53137f6a90a6cf3d3,11,563,247,316,1,0,1,1,27,59,1,7,2.620665742,4744,116,0,763,725,38,28992,27757,1235,180,176,4,91.91489362
46fcc38f3ef21506abb0ed92e1dc8f45b9667db4,9,419,10,409,3,0,3,4,23,58,1,3,2.78456565,2552,4,2,393,363,30,16383,14887,1496,111,98,13,98.41269841
f0641eba1caa1eff71b00f7ebf2872c52b67ccc6,7,384,116,268,1,0,1,1,28,91,1,5,2.095997746,2847,117,1,477,462,15,18585,17391,1194,108,98,10,99.21875
23155f73edba89045ac3fa118657fbe06429aab3,6,281,62,219,2,0,2,5,24,55,1,2,1.835374216,1280,118,2,199,180,19,8558,7798,760,72,60,12,99.22600619
55362a0288a233827dfae813df5df7151057c3f9,1,1,1,0,0,0,0,1,2,1,1,1,0,65,119,3,8,8,0,294,291,3,8,8,0,100
3864a3fda7b8bebe540de02f8ced15f84fb3841e,0,0,0,0,0,0,0,0,0,0,0,0,0,0,120,4,0,0,0,0,0,0,0,0,0,100
8d58aea002eed7d19bb182c18936e2ebf108116a,11,260,64,196,2,0,2,1,25,56,1,4,2.978590917,2439,121,4,448,428,20,15728,15033,695,156,138,18,99.23664122
ed6fa69f870c7ba9180a31c64df1becff2d81e81,1,4,3,1,0,0,0,5,24,38,1,1,0,1453,122,5,230,230,0,7960,7964,4,26,26,0,100
eef4edad2dbb0c81c9e18c05c7f52c8445ea63ea,9,30,19,11,0,0,0,4,29,12,1,3,2.768098753,3130,123,6,496,495,1,18811,18777,34,165,164,1,100
691ec3a822ae755663987f9f8025d9ab8db25607,2,68,63,5,0,0,0,3,16,140,1,2,0.556809796,874,124,7,128,129,1,5152,5137,15,30,30,0,100
19751e620885811bb74b0d216c498da20a20c9a6,0,0,0,0,0,0,0,0,0,0,0,0,0,0,125,8,0,0,0,0,0,0,0,0,0,100
1fad2e73ec10e8786bbef1808652ebabb759b5e2,1,1,2,1,0,0,0,3,27,4,1,1,0,927,126,9,147,147,0,5947,5958,11,37,37,0,100
e70cc4c292bf843c7de200890c1c6de268ccdd88,1,19,2,17,0,0,0,2,2,110,1,1,0,99,5,0,15,12,3,840,713,127,5,5,0,100
0d86f680efc8ac1495fa32e97994b6428cca6f48,1,1,2,1,0,0,0,3,28,1,1,1,0,926,127,10,147,147,0,5939,5947,8,37,37,0,100
2d2978e9372c4e82cf340a91a30cd1acafa4901e,1,88,51,37,0,0,0,2,8,7,1,1,0,263,128,11,47,48,1,1594,1471,123,31,31,0,100
9bdb6a1d6ec46be56f977e42de95fdfd161476b8,10,735,21,714,8,0,8,2,2,16,1,4,3.139745958,274,129,12,77,22,55,4672,1847,2825,43,12,31,93.42105263
6bccbeeabd8fda0b9a0e97181c9deafbf254322b,32,452,181,271,1,0,1,2,29,118,1,10,3.592139887,5060,130,5,705,676,29,33093,31618,1475,316,303,13,99.18699187
f42169304bc3d96441c47edab8ad48fe3db572f3,1,0,269,269,0,0,0,4,22,42,1,1,0,215,131,6,0,43,43,0,1268,1268,0,23,23,99.76744186
89c6c46d6bad15a15248984ca97f0ecde26194f2,4,8,10,2,0,0,0,4,9,205,1,3,1.836591668,275,6,0,41,41,0,1263,1281,18,12,12,0,100
435369964f72d8ac46d5ecb4c5005b8bedc00975,6,13,12,1,0,0,0,2,30,19,1,1,1.899721832,2173,7,1,354,354,0,12603,12603,0,130,130,0,100
ae26556d57519a204a3994dcb27e8de73cc7fd64,0,0,0,0,0,0,0,0,0,0,0,0,0,0,24,0,0,0,0,0,0,0,0,0,0,100
eb4c6dad6ca47dd43bf127f63870df8031fdfe72,1,1,3,2,0,0,0,2,11,33,1,1,0,275,132,0,43,43,0,1447,1459,12,27,27,0,100
1b2b416e0a85b7e04605f38a3e4b0826ceddba63,6,91,38,53,0,0,0,2,30,56,1,5,2.150153737,1231,8,0,196,189,7,7654,7332,322,50,50,0,100
17c1d5004cd37c6f9832853538a8d0fd71504fcb,1,45,0,45,1,0,1,1,1,0,1,1,0,0,9,1,4,0,4,88,0,88,4,0,4,97.59615385
abf8c09b0a75e59033e9b2515898256aeef8d369,0,0,0,0,0,0,0,0,0,0,0,0,0,0,25,0,0,0,0,0,0,0,0,0,0,100
26443ace2800fe9414b41000bda309221e57a75f,0,0,0,0,0,0,0,0,0,0,0,0,0,0,26,1,0,0,0,0,0,0,0,0,0,100
5e8567590610ebc074423acc01ae17ead3ef60f6,3,127,21,106,1,0,1,1,31,47,1,3,1.193073678,1243,133,1,188,183,5,8092,7640,452,55,53,2,99.75247525
782ce1ce8539d6f888b2bf129705fd8655086767,0,0,0,0,0,0,0,0,0,0,0,0,0,0,27,2,0,0,0,0,0,0,0,0,0,100
a7e2c4eda4e46f755e448f23861d27d2b1d924b3,0,0,0,0,0,0,0,0,0,0,0,0,0,0,28,3,0,0,0,0,0,0,0,0,0,100
d08d50c69bf11d0e8fcefe23f02a5d551769105d,0,0,0,0,0,0,0,0,0,0,0,0,0,0,29,4,0,0,0,0,0,0,0,0,0,100
bd4fd423b52d446ac1f014760edd19e5d21ca3f9,1,3,1,2,0,0,0,2,2,256,1,1,0,28,0,0,4,4,0,56,52,4,4,4,0,100
e1f3e226e8b83cada968c9038532a8a09935818a,0,0,0,0,0,0,0,0,0,0,0,0,0,0,1,1,0,0,0,0,0,0,0,0,0,100
25dd7bdb16783adad1a8c101c574b81672fdce29,0,0,0,0,0,0,0,0,0,0,0,0,0,0,2,2,0,0,0,0,0,0,0,0,0,100
3c42ffd6f0207ba4cfadb715bffc36d192496a21,0,0,0,0,0,0,0,0,0,0,0,0,0,0,3,3,0,0,0,0,0,0,0,0,0,100
31c069a2f2736a657ac5844e1d59816472168090,0,0,0,0,0,0,0,0,0,0,0,0,0,0,30,5,0,0,0,0,0,0,0,0,0,100
90c48cc779ced393082a227a15efe7302c3f101f,1,1,1,0,0,0,0,5,12,179,1,1,0,167,31,6,28,28,0,974,974,0,12,12,0,100
f1270e72ae19a75d912276a7d4d32ef582299f0b,1,28,36,8,0,0,0,4,12,96,1,1,0,183,32,7,21,23,2,1079,1123,44,7,6,1,99.87654321
29d426e85e5cc860309f55d603417e852d6dd566,8,10,11,1,0,0,0,2,26,135,1,4,2.92779897,706,33,8,55,55,0,3551,3538,13,27,27,0,100
f3e4ae4e0a3c30fe486a3794b272eb9ca2efecca,0,0,0,0,0,0,0,0,0,0,0,0,0,0,34,9,0,0,0,0,0,0,0,0,0,100
f0aafa835f6ca9e642c62042209db2264cefc2ba,0,0,0,0,0,0,0,0,0,0,0,0,0,0,35,10,0,0,0,0,0,0,0,0,0,100
8733950c1e0e0a8474219d60472f115375278e35,1,2,2,0,0,0,0,5,32,38,1,1,0,991,36,10,158,158,0,6243,6243,0,38,38,0,100
f93aef50a810c4a29cc9ce7dddbe8d2f08a4947a,4,87,14,73,1,0,1,1,27,94,1,3,1.495971937,1651,37,11,273,268,5,9611,9356,255,84,82,2,99.63054187
c04f0511019aae9153faf56144adfd48ab8756bd,3,9,1,8,0,0,0,4,28,50,1,3,1.521928095,1064,38,12,150,150,0,6158,6138,20,39,39,0,100
14ba88a5b9033589dab0d68847eb767251e5fec5,4,110,54,56,2,0,2,4,13,34,1,2,1.724269721,259,39,13,26,26,0,1756,1649,107,10,10,0,98.40881273
f415db5bfc2d652729b6b572b979d668b695db51,0,0,0,0,0,0,0,0,0,0,0,0,0,0,40,13,0,0,0,0,0,0,0,0,0,100
33572a5e2325c8b15b2ed133dca337abb7c2e94c,148,16990,15549,1441,12,0,12,2,33,148,1,17,5.827027674,16340,134,0,2124,2093,31,90637,89837,800,856,841,15,95.79929988
fcdfbb2d017afeda729d85e523617b977daeac6a,1,5,3,2,0,0,0,4,15,11,1,1,0,142,135,1,16,16,0,876,872,4,5,5,0,100
32cf1c6a4ea1ca4aabf0b13c8730a75877c68c4d,1,1,3,2,0,0,0,4,22,25,1,1,0,721,136,2,139,140,1,4232,4242,10,49,49,0,100
7898b0028d3d6dfdd099bc74e0d2ae351aa9790f,4,143,9,134,1,0,1,1,34,66,1,3,1.13449753,2485,137,0,391,385,6,15755,15095,660,90,88,2,99.77678571
43232b80ba830f85ade6ff39376bac69ed60baa8,1,30,5,25,0,0,0,4,5,91,1,1,0,116,4,0,22,15,7,1054,850,204,5,5,0,100
723f559efec395859f1036b53d4f0b2db2bc8ce2,1,11,7,4,0,0,0,2,5,99,1,1,0,139,138,1,28,24,4,791,759,32,14,14,0,100
7ccddfd21f6e097469f626a8bd0795c5306e7794,1,12,6,6,0,0,0,5,13,139,1,1,0,167,139,2,29,28,1,993,974,19,12,12,0,100
8f5d1297d51347f155ae4441a8d7eb66a93dfd59,1,8,4,4,0,0,0,4,6,10,1,1,0,140,140,3,22,22,0,1056,1054,2,5,5,0,100
1f412fe5c381de3bb19b3961dd9545b4d90272b9,0,0,0,0,0,0,0,0,0,0,0,0,0,0,141,4,0,0,0,0,0,0,0,0,0,100
0249063a03a27ed92a85e8c6a2faa1e3b1fcdae3,2,3,3,0,0,0,0,3,11,55,1,2,0.918295834,291,142,5,31,31,0,1850,1850,0,9,9,0,100
22279c37a201fbc184fdad6f535859662ccd0003,0,0,0,0,0,0,0,0,0,0,0,0,0,0,143,6,0,0,0,0,0,0,0,0,0,100
ec45adb6efc7b797c487bb88720fd1f8bf628b5d,0,0,0,0,0,0,0,0,0,0,0,0,0,0,144,7,0,0,0,0,0,0,0,0,0,100
ced64e2276f92ee15c5c2026c1073842523b21a2,7,253,223,30,0,0,0,4,31,75,1,5,0.883360103,1299,145,8,157,155,2,8275,8195,80,73,71,2,100
e88551eb26b4c5aedad3d21283c7ab1bb16e3fb9,1,2,2,0,0,0,0,3,13,148,1,1,0,153,146,2,19,19,0,892,892,0,2,2,0,100
08fe6f642571e4ffd86f8b8a03aa30ff2de24fdb,1,5,11,6,0,0,0,4,12,52,1,1,0,147,41,0,9,9,0,766,794,28,4,4,0,100
b9273dfe48dffbfa63381fdbb6895ead046a180d,5,95,65,30,0,0,0,4,35,107,1,3,1.779270962,1522,147,2,203,202,1,9636,9555,81,61,60,1,100
51e78870f494f08db5ae2a5448b0aeff64ed8861,1,2,4,2,0,0,0,5,18,164,1,1,0,213,42,1,21,21,0,1293,1299,6,15,15,0,100
e582c16613b7528d87f6c3a94756fd5375920833,1,1,5,4,0,0,0,5,26,164,1,1,0,1451,43,2,231,232,1,7978,7987,9,26,26,0,100
4f3001a9ba2010f87596a7d418a4b03fffa9c434,0,0,0,0,0,0,0,0,0,0,0,0,0,0,10,0,0,0,0,0,0,0,0,0,0,100
6861c185196d1fda862f7eae0753f018d9cbe853,0,0,0,0,0,0,0,0,0,0,0,0,0,0,148,2,0,0,0,0,0,0,0,0,0,100
6f8296d9e3f0e23fb69999f61a8161b1f5e8b13b,1,1,3,2,0,0,0,4,20,183,1,1,0,667,44,3,105,106,1,3745,3749,4,18,18,0,100
0e78d17ac0b2717f0afbb8799b16f255231eaea9,1,1,1,0,0,0,0,5,36,23,1,1,0,993,45,4,162,162,0,6314,6326,12,39,39,0,100
ce381c5eaf30a8b5d0c6afcf36bf5de83bf45936,23,270,193,77,0,0,0,2,19,316,1,7,4.399446644,2461,46,5,220,219,1,16902,16498,404,110,109,1,100
411be2144c438f64e4b0b8ab02d1c27f959aa9ef,0,0,0,0,0,0,0,0,0,0,0,0,0,0,0,0,0,0,0,0,0,0,0,0,0,100
72bea8133531511393feb204915a217912646824,35,3141,127,3014,20,0,20,2,37,52,1,7,4.533335615,4119,149,0,848,612,236,38378,24637,13741,309,199,110,94.14893617
27c3bfb325d7ca7da89aef1a11a3f4803b85f3cd,4,8,9,1,0,0,0,3,11,62,1,2,1.903967813,485,150,1,77,77,0,2962,2949,13,45,45,0,100
79962a3c8c5b9a29aa346e66959ad6b5ddd79022,15,683,598,85,1,0,1,3,23,73,1,5,3.168173745,2309,5,0,274,284,10,14460,14511,51,104,98,6,99.69512195
4d73db6a6e403c6254ba28ddaa35cb40184843a0,0,0,0,0,0,0,0,0,0,0,0,0,0,0,5,0,0,0,0,0,0,0,0,0,0,100
e0636b72747a3a7fa71e7c859fc1d780273bb8ec,1,3,2,1,0,0,0,2,4,308,1,1,0,76,151,0,8,8,0,475,476,1,8,8,0,100
69eb64da565bd736d4e29692f27efb8920c10ae3,13,1784,0,1784,13,0,13,1,1,0,1,7,3.465245494,0,152,1,110,0,110,6643,0,6643,70,0,70,94.03905447
60820434ddbbcc4f38c271c45bd65ac8b1f93bde,0,0,0,0,0,0,0,0,0,0,0,0,0,0,6,1,0,0,0,0,0,0,0,0,0,100
e2259af5de462b3850fd335751269f47b9ba7373,0,0,0,0,0,0,0,0,0,0,0,0,0,0,1,0,0,0,0,0,0,0,0,0,0,100
009d90d16e70c5cd0728e8ef030ddd4c60e142bc,0,0,0,0,0,0,0,0,0,0,0,0,0,0,47,0,0,0,0,0,0,0,0,0,0,100
1350d34c13ced2b5aa81da156c07256907561f02,1,2,1,1,0,0,0,5,21,185,1,1,0,665,2,1,105,105,0,3749,3745,4,18,18,0,100
d8837d9f27337778459e6b83a17ff1ea09335dbc,0,0,0,0,0,0,0,0,0,0,0,0,0,0,3,2,0,0,0,0,0,0,0,0,0,100
756d32f6c90fabd219f01d1d7b2737343b24574a,36,1743,100,1643,20,0,20,1,21,33,1,5,4.889537911,1694,48,1,318,141,177,14301,8268,6033,237,82,155,92.44917715
e9def7280d2240c411f18091234e1ac7fa8f4502,0,0,0,0,0,0,0,0,0,0,0,0,0,0,49,2,0,0,0,0,0,0,0,0,0,100
b47959581356066ed0bcd66777fb5481c7193948,5,210,213,3,2,0,2,1,22,51,1,4,1.676876678,628,50,3,49,54,5,4237,4480,243,24,28,4,99.09990999
5d1f4c015ee91de41e7375f12742346e8a2b2a60,0,0,0,0,0,0,0,0,0,0,0,0,0,0,51,4,0,0,0,0,0,0,0,0,0,100
eb26f966b36bfaf618bfde0d99405db2355b2099,0,0,0,0,0,0,0,0,0,0,0,0,0,0,4,2,0,0,0,0,0,0,0,0,0,100
dede2aa54fb55632ea38653722d9c46c0eb46a5b,0,0,0,0,0,0,0,0,0,0,0,0,0,0,52,5,0,0,0,0,0,0,0,0,0,100
b5a4862d8e7bd63a9c80f92939b9cc3ee50e175e,2,261,0,261,2,0,2,1,1,0,1,2,0.998718326,0,53,6,17,0,17,1102,0,1102,6,0,6,99.55197133
bdc87b192a8fef3d01b3715313a8be9cdfa67379,1,5,1,4,0,0,0,5,20,398,1,1,0,109,54,7,18,16,2,652,620,32,16,15,1,100
468732ef26f3be012efb3d819604f775cec49e85,13,532,56,476,3,0,3,6,34,161,1,5,2.781395396,4678,55,8,738,695,43,29006,27627,1379,188,151,37,96.87220733
14b7c4c0290434a298f0d24910068c7cf61db919,1,21,18,3,0,0,0,2,2,150,1,1,0,127,56,9,16,16,0,808,786,22,5,5,0,100
b5904debb8020df71e5d5f596c72ab9ae40a36c2,0,0,0,0,0,0,0,0,0,0,0,0,0,0,57,10,0,0,0,0,0,0,0,0,0,100
d1a480fb4ec62906eb925a8bba94e8f2ae3f2816,0,0,0,0,0,0,0,0,0,0,0,0,0,0,4,0,0,0,0,0,0,0,0,0,0,100
2e137a131cb9ebaa85e6357ad7cd93ee037125dd,0,0,0,0,0,0,0,0,0,0,0,0,0,0,5,1,0,0,0,0,0,0,0,0,0,100
87bec0be895b7bb2784090d883b8ace152b4bbf2,18,76,77,1,0,0,0,2,21,219,1,6,3.381121282,2497,153,0,320,320,0,15736,15726,10,169,169,0,100
751ca1471b674c0662faf62202e28859451287ec,2,59,24,35,0,0,0,6,24,20,1,2,0.776116266,591,58,7,77,73,4,4282,4052,230,41,40,1,100
257af8a5ab4e93c36c5b51c01d6dd52fe7ced3b2,7,29,19,10,0,0,0,5,14,217,1,5,2.25135618,932,6,2,124,123,1,4967,4921,46,55,55,0,100
91e272ef0b00bcde8d553063eea3f31744208b6c,5,89,5,84,0,0,0,3,22,18,1,1,1.632825628,981,154,1,182,172,10,6003,5537,466,104,98,6,100
3aa167ae49f6a93cc83ae27c59d65db79e5fe16f,2,89,2,87,1,0,1,1,8,0,1,2,0.307042889,147,155,2,31,29,2,1220,805,415,17,15,2,99.82206406
f4d17d98caff3231a6a6d13eca8d833d3a5d7fb1,1,4,4,0,0,0,0,2,2,184,1,1,0,259,7,3,31,31,0,1759,1759,0,15,15,0,100
4504b0ff32cedc68b9b9f532a98e622da20d8fd5,1,17,27,10,0,0,0,3,6,1,1,1,0,197,8,4,35,39,4,1043,1154,111,20,20,0,99.91119005
f8d65c3b5ccaa7c5dc2434f1067344b1b3e7750e,4,54,5,49,0,0,0,4,21,121,1,2,0.987166989,488,156,2,68,62,6,3349,3049,300,24,23,1,100
5346590fb3e8bea07c66095be00dfce1b582e307,2,295,0,295,2,0,2,1,1,0,1,2,0.581569305,0,157,3,33,0,33,1013,0,1013,16,0,16,98.76106195
8b35948a8342b859c977032109c2e3b6c2a4bf37,1,1,2,1,0,0,0,2,2,53,1,1,0,95,158,4,13,13,0,429,440,11,11,11,0,99.82363316
d89d1b84c928189cf0816864ddd4f6605620093f,0,0,0,0,0,0,0,0,0,0,0,0,0,0,159,5,0,0,0,0,0,0,0,0,0,100
69dce8a13234891802e353bf28465bef28790056,2,79,0,79,2,0,2,1,1,0,1,1,0.973835482,0,160,6,1,0,1,153,0,153,1,0,1,99.56101844
2e8756702497ab77fda32e33f6a881ce4b2204be,1,2,2,0,0,0,0,4,10,0,1,1,0,176,59,1,28,28,0,1335,1335,0,6,6,0,100
b5f9081408583e6294cb8f9b6f56e66bf81aa19c,1,12,2,10,0,0,0,4,11,0,1,1,0,176,161,7,29,28,1,1399,1335,64,6,6,0,100
3615939f51d619ba735ddc9b4fa64b669d22b1ee,5,79,39,40,0,0,0,1,3,200,1,2,2.258631742,643,162,8,67,62,5,4524,4343,181,26,24,2,100
042b8c7cb8ca2d63ea6c8a0a28dee69a7e15a668,0,0,0,0,0,0,0,0,0,0,0,0,0,0,163,9,0,0,0,0,0,0,0,0,0,100
f80321c838c96dc5200858f9684eda3d47171890,97,1892,1600,292,6,0,6,2,38,164,2,18,5.668992622,13972,164,8,1788,1793,5,85875,84552,1323,704,713,9,92.66666667
9cacb42aed327bc29be7ddaf738d64eef4a9afbc,4,0,178,178,0,0,0,2,2,100,1,2,1.570541143,278,165,9,10,26,16,1098,1604,506,10,24,14,98.46153846
cd49794abaf0a730c651756010e8b81f6d776742,6,64,83,19,0,0,0,4,36,247,1,3,2.173652894,3626,166,10,598,597,1,20665,20579,86,123,123,0,99.01719902
a39483e19ae2096c9075bb0f61c0bb6d69497aef,1,4,4,0,0,0,0,4,18,3,1,1,0,50,167,11,0,0,0,259,259,0,0,0,0,100
f8f16bd768557b66ba459b3f5ba7ccc437d2191a,33,2362,140,2222,13,0,13,2,39,30,1,8,4.031776941,4878,168,4,890,690,200,39402,30017,9385,297,197,100,92.66435986
3f2a1f79e156eb2d72c23da8ff0c22301560741a,0,0,0,0,0,0,0,0,0,0,0,0,0,0,169,5,0,0,0,0,0,0,0,0,0,100
c0aa0194374639be232e9b2de2725545dd8602c0,0,0,0,0,0,0,0,0,0,0,0,0,0,0,60,0,0,0,0,0,0,0,0,0,0,100
a44565d382c441463b26e1beb3b78b27872434c5,2,103,104,1,0,0,0,2,4,38,1,2,0.999983165,182,61,1,16,17,1,1018,1075,57,9,6,3,99.93983153
3993d429c7489fddc86888295ce65686e71ceca9,5,123,7,116,0,0,0,1,36,27,1,3,1.961880816,956,170,6,86,84,2,6673,6040,633,38,36,2,100
1c89d3ec1bd15f095186fcdd1382c6226c275149,3,13,10,3,0,0,0,3,40,101,1,2,1.421911507,1164,62,2,172,172,0,7256,7240,16,43,43,0,99.93983153
896da07fadf1bdbeb6ac42e7968d29fdffda0ba2,1,0,46,46,0,0,0,1,5,0,1,1,0,150,171,7,3,4,1,885,1150,265,3,4,1,100
14ace7ef646ada71740f5bc3c6f81b408f46b558,7,163,61,102,1,0,1,1,37,1,1,3,1.94480111,1291,172,8,129,120,9,8745,8417,328,55,52,3,99.87980769
18d8f811f1c1c93eaa893a25a0506ad6d1f2d40f,10,278,5,273,2,0,2,1,38,40,1,4,1.935828489,2525,173,9,413,386,27,16691,15605,1086,86,72,14,90.90909091
216180e613f5755977b74754a769dd4e30f8445f,3,43,19,24,0,0,0,1,15,15,1,2,0.677930938,549,174,10,70,68,2,3597,3496,101,41,40,1,100
364460890ccb8342ade951928510e28b619ac2b1,1,54,8,46,0,0,0,2,6,0,1,1,0,189,63,3,30,25,5,1326,1192,134,7,6,1,100
d759461350df4bc02a14b4136a93721b2deec39c,0,0,0,0,0,0,0,0,0,0,0,0,0,0,64,4,0,0,0,0,0,0,0,0,0,100
d656a10ca5f8d3f94194eb1f3c9cdd231c5ff6a9,0,0,0,0,0,0,0,0,0,0,0,0,0,0,0,0,0,0,0,0,0,0,0,0,0,100
0a25624ffaad21592546e3c5159d4fadba15fa8c,4,248,28,220,1,0,1,3,39,11,1,2,1.233004842,1752,65,5,264,249,15,11478,10767,711,72,61,11,99.76228209
4309753f2eddfa193ae8e8ab2dd5cc6b0b16410e,58,1152,1534,382,6,0,6,2,40,106,1,7,5.441674583,7976,1,1,1059,1140,81,43747,44280,533,381,446,65,97.06325301
568d82fa900790aac68d39858b6c3c46d6143b4f,3,3,3,0,0,0,0,2,25,0,1,1,1.584962501,332,2,2,58,58,0,1829,1820,9,48,48,0,100
4a2c0c038010ac6b925204e798a07bae719455eb,37,63,213,150,0,0,0,1,27,33,1,6,3.786038715,4006,66,6,333,499,166,24863,50320,25457,192,313,121,90.55374593
1b5912e9f4eca0b2aff13dae86aed0940117a625,5,326,205,121,1,0,1,5,29,115,1,4,1.606077656,1026,67,7,207,198,9,6984,6604,380,40,34,6,99.82142857
09b0ef68243614932ed70a1e64566b4e5663e5d3,4,174,2,172,1,0,1,7,41,8,1,2,1.496087988,3042,68,8,481,467,14,18998,18160,838,83,79,4,99.82185273
df3290be0847b9b8ecd86ffa858f0b27984d357c,3,107,38,69,0,0,0,6,42,7,1,1,1.089822871,3462,175,7,595,586,9,20517,20254,263,118,116,2,100
f9879fbab3f57754d2158347e2b11fb92ebf109a,2,49,12,37,0,0,0,6,43,0,1,1,0.853657673,2776,3,3,455,453,2,16306,16154,152,68,67,1,100
fb6987035225208e79345c6b3f338b6190964348,15,448,177,271,1,0,1,1,39,88,1,5,3.214378307,3271,176,8,461,433,28,20320,19200,1120,133,120,13,96.40644362
866856574e9bba3afa610b414e5d9a9c20a0cbb3,0,0,0,0,0,0,0,0,0,0,0,0,0,0,5,0,0,0,0,0,0,0,0,0,0,100
1a750491bb2cbe4c0403a5a8255a8e59d376aa6a,1,35,27,8,0,0,0,6,35,4,1,1,0,1517,4,4,248,247,1,8609,8598,11,34,33,1,100
31bed4312cc60099839a1a4548df6fff0c4bb79c,1,10,4,6,0,0,0,6,44,5,1,1,0,1289,5,5,209,209,0,7794,7774,20,35,35,0,100
3311f3f1d1c6d935601d88b5a857788f91e178b0,1,5,0,5,0,0,0,4,14,28,1,1,0,188,177,8,34,33,1,1484,1443,41,6,6,0,100
1d0f4e27c15a4d934ab20a00e63fe8bcaa9e612d,2,98,0,98,2,0,2,1,1,0,1,1,0.989157102,0,178,9,5,0,5,295,0,295,2,0,2,99.67658473
7c0c7335cd729e6cd007dd5037469e72fb152237,3,49,39,10,0,0,0,4,45,55,1,3,1.177022555,1481,179,7,236,232,4,8689,8611,78,47,46,1,100
6b47c3dec01632f2f152c272f2eed5003e3de35d,1,3,3,0,0,0,0,6,36,13,1,1,0,1520,6,6,248,248,0,8609,8609,0,34,34,0,100
58fdaa444775191afbcf75fa050803495307b417,20,1157,127,1030,6,0,6,1,46,21,1,3,3.604142047,4635,180,5,743,666,77,31614,27336,4278,191,160,31,94.46974626
c44a86e293d686f17e57bb0b101e90c3e9a5c3d0,21,985,260,725,4,0,4,1,47,46,1,7,3.447292286,4451,181,6,674,615,59,30847,27523,3324,206,174,32,94.35261708
23edee8700fd2f5e4b5dfb83b195611e6efd5ee8,0,0,0,0,0,0,0,0,0,0,0,0,0,0,0,0,0,0,0,0,0,0,0,0,0,100
4072c9480c7b8d196323d4f41865db2818e79582,32,766,352,414,11,0,11,1,48,17,1,5,4.646941395,5972,182,7,872,855,17,36391,36219,172,240,220,20,92.08053691
2f8aa86645722fee4a39eb83b7c806e214bbaf89,3,108,42,66,0,0,0,7,49,31,1,2,1.112388633,1722,7,3,254,249,5,10896,10758,138,58,54,4,100
5bfcb78f70eb607bd7e39e1202ebc8b64656f633,43,114,77,37,0,0,0,2,50,29,1,8,5.097609573,6371,1,1,853,857,4,36967,30015,6952,267,284,17,88.32518337
864b3bfdf8f5e73cc4150fd5ca931e335c0511a1,1,16,12,4,0,0,0,2,3,2,1,1,0,91,8,4,14,14,0,507,497,10,7,7,0,100
177ea65d125d14ca86c87190f3a84798c3872829,5,333,74,259,3,0,3,5,12,10,1,3,2.130426812,192,2,2,36,23,13,1553,856,697,25,12,13,99.45978391
416ace7a7bfa726487b6b3583363379c8ba580f2,2,6,6,0,0,0,0,5,42,12,1,2,0.650022422,477,183,6,45,45,0,2604,2606,2,23,23,0,100
a2fab36175cee7e8fb345f93f46b83d4e6515cae,0,0,0,0,0,0,0,0,0,0,0,0,0,0,3,3,0,0,0,0,0,0,0,0,0,100
7b91fd6f5ac11194fc8c4fcb77ed64fef7a4805c,1,4,2,2,0,0,0,3,4,25,1,1,0,92,184,3,15,14,1,519,507,12,7,7,0,100
4bfe0bd5618496e033c1639ca5b74626fbb90660,4,20,6,14,0,0,0,2,43,48,1,2,1.89049164,1699,4,3,277,276,1,10150,10072,78,91,91,0,100
65da98e0306c9cf6204fd4c658ce83672a601f0c,16,1622,16,1606,15,0,15,1,6,23,1,4,3.830182843,125,5,4,151,7,144,7065,870,6195,89,4,85,94.28571429
7373fba5c0e6fa072e3f5d333b11037d3266d050,2,15,1,14,0,0,0,2,19,100,1,1,1,274,185,2,32,30,2,1753,1683,70,10,10,0,99.28848642
299c3b1b36ae987c94c0b30683ab4ede6ea23906,3,9,3,6,0,0,0,6,44,122,1,3,1.384431504,1091,186,3,140,140,0,6125,6081,44,39,39,0,100
69c055a05f2c57b688b4e98786bab2662f1d629a,1,3,0,3,0,0,0,1,2,42,1,1,0,412,6,4,58,57,1,2683,2669,14,9,9,0,100
110afd23efc15fe382ba578ca84c93a13e13ed14,1,5,3,2,0,0,0,7,40,47,1,1,0,1546,7,4,252,252,0,8821,8792,29,34,34,0,100
29f4a3be5a70d2f63f8048583823ec9834e18fa4,0,0,0,0,0,0,0,0,0,0,0,0,0,0,187,3,0,0,0,0,0,0,0,0,0,100
d226157c639bd579e5e143c4643eb46765608710,0,0,0,0,0,0,0,0,0,0,0,0,0,0,188,4,0,0,0,0,0,0,0,0,0,100
aedfb1a168293077fb667691015c203227fe5bba,0,0,0,0,0,0,0,0,0,0,0,0,0,0,189,5,0,0,0,0,0,0,0,0,0,100
d788d7c2d2f927acbb82050c9702e801d13d3939,24,995,566,429,2,0,2,2,25,107,1,4,4.018023521,2004,190,6,169,150,19,13299,12873,426,126,110,16,95.20884521
76b83ccaad2b65fc728f2455625f7dd461a2eb33,1,0,170,170,0,0,0,2,2,126,1,1,0,93,191,7,0,9,9,0,634,634,0,4,4,99.88385598
59a3b2049135d09abc95aabbe29f410bf1a573fd,4,861,0,861,4,0,4,1,1,0,1,1,1.677042292,0,192,8,80,0,80,3652,0,3652,39,0,39,97.27810651
ae6bc82c39e137df78a9bfdaee2bc28e46ea5dd7,4,3,3,0,0,0,0,1,1,0,1,1,0,581,193,9,80,0,80,3652,44,3608,39,0,39,96.33786178
e44e176322e70a894bf901b77fd83ca15f397cad,0,0,0,0,0,0,0,0,0,0,0,0,0,0,194,9,0,0,0,0,0,0,0,0,0,100
b70b36bbfcd73f02fa27ef207b9b90d929d68822,91,2513,1500,1013,4,0,4,2,51,129,1,22,4.789268088,16864,195,10,2320,2238,82,106608,103622,2986,895,837,58,92.98874104
c15cd942833476119839600b48a962ece165bfa3,1,33,4,29,0,0,0,1,3,0,1,1,0,223,196,11,44,40,4,1821,1610,211,20,20,0,100
b34b8f3bb67d3c27b39219eecb2dc9bb8c442f3f,3,11,2,9,0,0,0,1,52,0,1,3,1.460484681,1544,197,12,248,248,0,9483,9404,79,53,53,0,100
6b9af86e2ca2d6be06e95a1e4f27b4cbaa4d8267,4,264,25,239,1,0,1,2,4,20,1,2,1.757974653,646,198,11,94,75,19,4824,4053,771,22,14,8,96.40998959
3921c3330f52f14928d04f3ff1e3818caccb396c,0,0,0,0,0,0,0,0,0,0,0,0,0,0,199,12,0,0,0,0,0,0,0,0,0,100
66f25d3f4938f905256a593adea53f830abf96ba,4,29,23,6,0,0,0,2,3,190,1,4,1.925864122,751,8,1,101,101,0,5093,5039,54,35,35,0,99.45880938
df9f4d7560d1a7cc34c5da43acaa909329f9c40a,0,0,0,0,0,0,0,0,0,0,0,0,0,0,9,2,0,0,0,0,0,0,0,0,0,100
f61ba4415235c701aedee799a6c4294f6b783ba4,4,863,0,863,4,0,4,1,3,16,1,1,1.676075085,0,200,13,80,0,80,3670,0,3670,39,0,39,98.55159928
fd1f6c63b8f108b59eb1b8f9353c10893d203d04,4,0,863,863,0,0,0,1,3,12,1,1,1.676075085,583,201,14,0,80,80,0,3670,3670,0,39,39,98.49124925
c9794891b074d994fc9ae05c4838da7f78913c05,18,421,78,343,1,0,1,1,42,44,1,9,3.361788715,3847,202,15,545,512,33,25515,23656,1859,162,142,20,95.85652443
fc643c597933e3b9f9df0892a9f33874f22f60de,1,1,0,1,0,0,0,7,53,11,1,1,0,1285,203,16,212,212,0,7662,7653,9,37,37,0,100
1545c3b0799a46819fa01926e91010a5799d0380,0,0,0,0,0,0,0,0,0,0,0,0,0,0,0,0,0,0,0,0,0,0,0,0,0,100
a4c30e61ebc8f6692b4f0ac5e7aaeb5f2d4568d9,2,192,52,140,1,0,1,1,43,6,1,2,0.943226155,1545,1,1,265,252,13,9258,8800,458,39,34,5,95.64660691
aeb4a0ce04db69bb07a8f032099c3f626068a494,1,21,10,11,0,0,0,2,3,13,1,1,0,126,10,2,21,20,1,861,794,67,11,11,0,100
48f70b414e691827ff8547752488fc2c36eb51ce,0,0,0,0,0,0,0,0,0,0,0,0,0,0,204,17,0,0,0,0,0,0,0,0,0,100
573a3fcde6104260e0ca58c3d9841b43f0a76cc5,11,85,59,26,0,0,0,1,54,10,1,6,3.298748671,2751,205,18,372,372,0,17816,17726,90,124,124,0,100
68afd1a4107d755149e41b058f3902ceab07cdd3,12,840,528,312,4,0,4,1,55,26,1,4,2.897306875,4378,206,19,745,736,9,27064,25842,1222,178,166,12,96.77002584
9ee46a6550e1bf4bdb5870c2522fddd163a35f6a,11,360,279,81,1,0,1,2,45,36,1,6,2.801389761,2699,207,20,392,381,11,17084,16430,654,110,109,1,88.35164835
42128d12a3ec4fe171ec36a30f1c3f89627affee,1,1,0,1,0,0,0,4,16,22,1,1,0,154,208,21,19,19,0,908,902,6,2,2,0,100
1b179b20e6c2eb7dd9d5061ce7bd05990feb2a2b,1,4,0,4,0,0,0,7,35,0,1,1,0,449,209,22,87,87,0,2863,2853,10,13,13,0,100
dcd12941432f3db9ea7226b00b5b538f96253c9a,5,256,123,133,1,0,1,7,56,11,1,3,1.556039156,2725,210,22,397,392,5,17419,16986,433,99,94,5,99.49706622
592c7527a474aa0f755cb5a6acf192923fa4f51e,1,9,0,9,0,0,0,8,46,2,1,1,0,1353,11,3,219,218,1,7749,7687,62,32,32,0,100
e6dd7d7c03b0eb591b05cecf770400e8beda09f9,3,45,7,38,0,0,0,5,47,89,1,2,1.006115584,2240,2,2,387,383,4,12982,12887,95,89,88,1,100
dd21f92a5e87853d18b304c96325858462e36329,5,217,69,148,0,0,0,5,48,15,1,3,1.921832823,3553,211,16,597,577,20,20903,20400,503,149,139,10,100
c4c3e70798f5bfee270b09c8cbc8b7fc63382f90,11,872,690,182,0,0,0,1,4,188,1,5,1.963799598,1253,212,17,133,139,6,7308,7384,76,80,86,6,99.66583124
67e6ca46912204d93a375081faf2ca199f7957a6,17,26,49,23,0,0,0,1,2,22,1,8,3.621596893,1648,213,18,155,64,91,9263,5867,3396,91,48,43,95.30201342
be1e3ddfe0b97359e90ea9f48870a17f58a5de04,3,42,37,5,0,0,0,8,57,4,1,2,1.431747649,1684,3,3,235,234,1,10436,10416,20,58,57,1,98.24267782
c62902469b36efa8d080dbc4ed5fb470c95d9096,8,74,38,36,0,0,0,3,14,34,1,2,2.75572882,1657,6,0,173,171,2,10924,10731,193,57,55,2,100
751b8ff8d4a26aca1a8f183dc45af928fd0ecd8a,1,3,50,47,0,0,0,2,2,12,1,1,0,304,9,0,41,48,7,1776,1994,218,13,15,2,100
048d4856f33b278f39ad746958f62a93a42b22db,2,98,0,98,2,0,2,1,1,0,1,2,0.931304369,0,10,1,6,0,6,327,0,327,3,0,3,99.41908714
06736467502bb8b879aa306eb82c809dfbfdfd1e,21,1672,77,1595,9,0,9,1,58,23,1,7,3.722304538,4076,7,1,692,548,144,30482,24409,6073,214,164,50,86.65749656
dd7ffe8e621dbcd780bfb1991b9584ff522555f5,1,3,4,1,0,0,0,1,2,0,1,1,0,158,8,2,27,27,0,869,869,0,8,8,0,100
f17f56e8a74f262808cd3a498174a8b0137b1b37,52,186,2818,2632,0,0,0,3,59,88,2,17,3.631001477,10093,11,2,1052,1319,267,49691,61210,11519,402,491,89,89.22155689
77f703efafaf095f555ad6eea34e625dcc7b2bf6,308,5,5,0,0,0,0,1,2,0,2,27,1.370950594,29534,214,11,3473,627,2846,163275,60673,102602,1649,322,1327,18.35853132
aad6916b8a1f2187194f93c6ae07990b124767ad,1,1,1,0,0,0,0,2,2,0,1,1,0,118,9,3,6,6,0,728,729,1,3,3,0,100
d2a4b71e157a8f0f2c94622687f5a6ee064dff92,1,1,1,0,0,0,0,1,2,24,1,1,0,81,215,11,9,9,0,400,400,0,7,7,0,100
87f3c4d8572ee8f7244af8a92dc3312ce24260e3,4,66,12,54,0,0,0,2,2,4,1,3,1.647750087,733,12,2,106,100,6,4604,4451,153,67,61,6,99.10958904
bc641521126fb4f5c415c7b0b268203b10ca022a,5,31,45,14,0,0,0,2,3,9,1,3,1.90186813,473,13,3,33,35,2,2698,2708,10,25,27,2,99.72318339
24d73a8c2ef6cff062e581195f1f9c840f44a38c,0,0,0,0,0,0,0,0,0,0,0,0,0,0,14,4,0,0,0,0,0,0,0,0,0,100
7cbb47170ef3921a9b5752ceae3a24a7e19da7e6,5,174,168,6,0,0,0,3,4,9,1,5,0.931840915,543,216,11,48,45,3,3086,3004,82,38,35,3,100
828b631f8d5bda788917766dde6305308e75faed,3,20,28,8,0,0,0,3,3,10,1,2,0.94056624,404,12,3,71,71,0,2385,2432,47,46,46,0,100
7d573acf9db6f40d2cf6ebb8d2f32647b7698d9b,41,2211,1192,1019,8,0,8,1,5,0,2,13,4.262176978,7246,217,7,1034,972,62,46554,42329,4225,354,343,11,91.51472651
aa52ecc8434b44e47f356f771b0bf784baabff39,1,1,1,0,0,0,0,2,2,13,1,1,0,323,4,2,30,30,0,1916,1916,0,14,14,0,100
4857a8211eb36f683c6fd67b1ac65b1c09d75772,20,395,354,41,1,0,1,2,4,0,1,6,3.723464594,5652,5,2,791,782,9,33354,33480,126,212,204,8,97.51420455
74bcafe6a7c5dbab64592fa8944e76374950f369,1,1,1,0,0,0,0,3,5,1,1,1,0,101,6,3,12,12,0,520,520,0,9,9,0,100
64446972ea442bbd15388e67cb64451e80dd2dd7,1,30,19,11,0,0,0,2,3,24,1,1,0,270,218,7,43,41,2,1826,1776,50,13,13,0,100
4e7f662c903bbc5a6b13bea400a612a571b1e7a3,1,11,2,9,0,0,0,1,3,6,1,1,0,475,219,8,84,83,1,3069,3048,21,12,12,0,100
93c1495fc5859480501c82bffaf17faf99f8e6d6,7,466,207,259,0,0,0,1,4,16,1,4,1.56867062,4143,220,6,670,649,21,24460,23674,786,197,190,7,100
54e155b2f9035e66b0d6e2bdf25328bc2a1821e7,4,20,279,259,0,0,0,2,3,44,1,4,0.782404824,506,221,7,23,54,31,2288,3231,943,7,21,14,96.914446
bbe4256ccf994d2759f303d0ae5ab00d0e13560c,0,0,0,0,0,0,0,0,0,0,0,0,0,0,222,8,0,0,0,0,0,0,0,0,0,100
ed67662833fbebac9424d6e0d6135b2d5f7df221,1,19,14,5,0,0,0,1,2,36,1,1,0,213,223,9,35,34,1,1600,1584,16,6,6,0,100
63faddcb4981ba306d5d3c3da3240fd9cf383ff9,1,22,2,20,0,0,0,1,2,26,1,1,0,37,224,10,5,4,1,143,121,22,3,2,1,100
7f7e0056cf4e40fd8ab4493cb5dd783928bd8b9a,38,2618,434,2184,19,0,19,2,5,10,1,11,4.605546481,4751,7,3,866,715,151,34254,27261,6993,274,176,98,88.093689
ea2198d1eaa3f85b67aeacf80c59ff6c2d6cae4b,4,63,133,70,0,0,0,3,6,24,1,1,1.201353961,1951,15,0,286,304,18,11486,11776,290,59,59,0,100
88720cfb0f6ce23e0e6b78e2399465b8dc6230ea,9,313,116,197,1,0,1,2,3,33,1,5,2.515010561,1418,225,9,185,175,10,10010,9617,393,92,79,13,99.50829748
34108c93341bbdc9e9d82cb131797e5d1b884725,1,2,1,1,0,0,0,3,7,4,1,1,0,980,226,8,144,144,0,5910,5903,7,31,31,0,100
3571d5b3ff969335d424b7759a6cf7dd211c65fa,22,1264,38,1226,11,0,11,1,8,8,1,7,3.834641335,4415,227,9,771,640,131,30296,26211,4085,308,186,122,90.46717172
123a36a306d67fb088a8933fbedfee9041a74c9b,1,1,0,1,0,0,0,1,2,57,1,1,0,148,228,10,25,25,0,775,766,9,11,11,0,100
566adfc6b2c571513039a255c4a2b170d3d6ca6b,0,0,0,0,0,0,0,0,0,0,0,0,0,0,8,1,0,0,0,0,0,0,0,0,0,100
1eaab3ff839e8eaa58a75a3ce4e2123041348007,46,3418,542,2876,22,0,22,2,9,14,1,10,4.833924203,6988,13,0,1177,1001,176,51541,42295,9246,440,342,98,90.33846154
0be4dcf3a7c9163bcf2cbf7565a34cd0daca58b0,1,3,4,1,0,0,0,2,3,0,1,1,0,210,14,1,16,16,0,1761,1772,11,12,12,0,100
d92a4cad9e875ba698fd8e9b930b4197eb0fc60c,1,4,3,1,0,0,0,2,2,15,1,1,0,111,15,2,17,17,0,754,754,0,13,13,0,100
2055232504b6928ff758b9bd4a01002dcdd2c582,0,0,0,0,0,0,0,0,0,0,0,0,0,0,16,3,0,0,0,0,0,0,0,0,0,100
3b07507460239a2816e325cd80b6f926207a34fd,1,17,0,17,0,0,0,3,8,9,1,1,0,1414,9,2,233,229,4,8152,8084,68,38,37,1,100
4c472217a18c1a1c669e5d96142214ac9f9cc097,11,169,29,140,1,0,1,1,10,19,1,2,2.63072054,3967,10,3,617,606,11,23882,23475,407,159,152,7,99.47337624
46dfe7cc1ff66c11968c704d153c5752ac9fbee1,1,9,3,6,0,0,0,4,9,0,1,1,0,530,11,4,90,89,1,3403,3380,23,14,14,0,100
577ece5d935520f3227a8e7ecce08fe20c645f6b,1,2,1,1,0,0,0,4,10,0,1,1,0,535,12,5,90,90,0,3408,3403,5,14,14,0,100
f7b5b43302d3b18ccedc1334539feb9bdde1a8f6,13,373,208,165,2,0,2,2,11,9,1,8,2.774710603,3155,13,6,443,432,11,20706,20246,460,149,142,7,96.93995381
86f4b433b8d54104e174a9c38fc4e6a3bd0f7b8e,28,950,417,533,5,0,5,2,12,20,1,9,3.857369577,5906,17,4,816,788,28,36866,35181,1685,287,259,28,93.55877617
c657f8152a42d6d075bcdb8f7ce79502a39331dd,0,0,0,0,0,0,0,0,0,0,0,0,0,0,229,4,0,0,0,0,0,0,0,0,0,100
47320b2a4c2ea5a3e180c96336f1c9a1a532076d,17,617,136,481,5,0,5,2,11,32,1,3,3.001541589,2734,14,6,457,422,35,16817,15841,976,200,162,38,98.8401412
89258478e6bff13c0915ab17bc9c8a0d6c2fef98,1,1,0,1,0,0,0,1,2,0,1,1,0,81,15,7,12,12,0,407,405,2,10,10,0,100
8175783992099f0fa863530917716ba870995a1d,1,9,3,6,0,0,0,4,13,15,1,1,0,564,230,4,93,91,2,3769,3722,47,15,15,0,100
fa5d468e0210ed8ca4d1813b16d57b2a8ebaa210,26,742,510,232,3,0,3,2,7,48,1,11,3.635063695,3806,16,8,501,473,28,24457,24138,319,255,230,25,90.46350559
e0af9d382f61ded5fc3bb6c14057cf50445458b6,3,3,3,0,0,0,0,3,3,0,1,1,1.584962501,391,18,5,50,50,0,2330,2333,3,30,30,0,100
d65c1e7d27b248ac33f06c2330aaec7ea2f335ea,28,358,349,9,1,0,1,2,13,34,1,7,4.038318391,6783,17,9,955,954,1,39807,39850,43,265,264,1,96.50776053
6fc0550bcd20e979bf5a5db88b05c4ef12559152,42,3494,662,2832,15,0,15,1,14,20,1,13,4.609505544,5143,231,2,992,654,338,43892,32575,11317,503,312,191,88.35790544
0d63f093f819d9b362343199abe0440780c79bba,0,0,0,0,0,0,0,0,0,0,0,0,0,0,0,0,0,0,0,0,0,0,0,0,0,100
6d697ae13c27757270b3ffb9b312e72e4afe3db5,13,612,19,593,7,0,7,1,13,0,1,7,3.406793268,2607,1,1,433,385,48,17253,15203,2050,167,135,32,92.24652087
dd7d960682415b6552ca70285964a11ef5fb2ead,2,7,12,5,0,0,0,2,5,31,1,1,0.899743759,211,19,2,37,36,1,1323,1323,0,12,12,0,100
a6f16e2ec3ea57ca3d060a35bff274eaffb3ec10,38,1268,384,884,8,0,8,3,15,4,1,9,4.234116209,7314,2,2,1109,1038,71,45412,43323,2089,430,371,59,97.96334012
766ca06258551d3b108e4bbea70328e5b94c4707,3,161,101,60,0,0,0,2,4,112,1,1,0.688874402,600,20,3,89,76,13,3878,3616,262,38,38,0,99.64592817
15a23a402adf4be317c1ac39704830c3fdb6e884,5,979,0,979,5,0,5,1,1,0,1,2,1.97850168,0,21,4,72,0,72,3677,0,3677,39,0,39,98.98836621
ccbe445866abf943c2f814b22ab46400ac410ca9,1,0,6,6,0,0,0,5,16,2,1,1,0,1084,16,0,161,161,0,6595,6601,6,40,40,0,100
782e00279caf1f9900cc8bb2179f0322ec56e6b7,0,0,0,0,0,0,0,0,0,0,0,0,0,0,3,3,0,0,0,0,0,0,0,0,0,100
49e59a232d3636f8e7dc5d85f1b35666e2a09f30,0,0,0,0,0,0,0,0,0,0,0,0,0,0,4,4,0,0,0,0,0,0,0,0,0,100
78b4fc4c24c61f7494c672ee50bc71eec61dfdf2,36,1639,795,844,6,0,6,2,11,29,1,10,4.327226911,5112,232,1,769,691,78,34010,31591,2419,408,371,37,97.61178862
b927dc60e7a0946cb6741e99f43d5f98518e78de,1,20,10,10,0,0,0,2,5,23,1,1,0,204,233,2,23,21,2,1228,1180,48,14,14,0,100
a922c732eab67b48f6b671de5e9a64cf24f22c2f,4,14,7,7,0,0,0,2,3,108,1,3,1.641153732,302,18,0,37,38,1,1574,1552,22,20,20,0,100
b4137fa542c53e2a76c9906ed9cf9396d1afe022,1,1,1,0,0,0,0,2,3,52,1,1,0,82,22,3,12,12,0,407,407,0,10,10,0,100
a695252af91206fa34edfcf33fa4f7a325fac4b9,9,256,98,158,0,0,0,2,15,37,1,4,0.936317561,2650,19,1,361,351,10,16344,15973,371,97,83,14,93.25301205
a1b88972d1a4167ad9b29e7f6f81adb23fed0252,7,68,16,52,0,0,0,2,12,92,1,5,2.023416094,2049,234,2,289,283,6,11929,11844,85,134,130,4,100
339bec76280dbc38f592f18bfb07d8d45a492ce5,1,9,7,2,0,0,0,2,4,0,1,1,0,163,20,2,31,30,1,830,825,5,19,19,0,100
394c119465fb29f2f5934d357970b500059286c8,3,68,4,64,0,0,0,2,6,12,1,2,1.293697716,1062,21,3,145,140,5,6437,6198,239,40,36,4,99.95462795
d2bfd395b2c19b07f1565fab43a2c3b1f78d43ab,1,3,6,3,0,0,0,2,4,15,1,1,0,98,235,3,12,12,0,520,526,6,5,5,0,100
c61fdac69e960babc0822eb6288cfbd407c3f0eb,9,88,5,83,0,0,0,2,6,76,1,3,2.883972649,729,22,4,107,96,11,4096,3808,288,77,69,8,100
59ae2b2c26be2b93370f955ccaeef3b9b7745f27,6,138,84,54,0,0,0,1,17,62,1,3,2.074785167,3483,236,4,523,519,4,20300,20214,86,170,166,4,100
10e6796438d6bf83517f6702a8cd1bd81e4bb232,13,364,227,137,2,0,2,3,14,58,2,6,2.718824102,2265,5,0,380,369,11,13773,13429,344,195,186,9,92.45657568
1c9b260295a7bd34d47f6a0c704bb76a36649f95,3,77,36,41,0,0,0,4,15,24,1,3,1.375816886,972,23,5,118,115,3,5922,5718,204,82,81,1,99.89059081
599f70e38a4f7c70736508b91a1545d1b9ba5c66,128,2867,2488,379,4,0,4,2,18,33,2,32,4.470876881,21005,6,1,2704,2598,106,129305,125277,4028,1208,1131,77,90.8764736
ed2daeef748155bf799ade0ba47bae3b53d61a6b,0,0,0,0,0,0,0,0,0,0,0,0,0,0,23,1,0,0,0,0,0,0,0,0,0,100
38d3b0ea75e32fa7269d1fdd0facda51eb146a9f,0,0,0,0,0,0,0,0,0,0,0,0,0,0,7,2,0,0,0,0,0,0,0,0,0,100
487d016f7fbd933ac990ee5cc5cfeb7bcd423e26,0,0,0,0,0,0,0,0,0,0,0,0,0,0,8,3,0,0,0,0,0,0,0,0,0,100
154c0c5e727ae2e5ca9f428aa62f9ecd30a9360a,0,0,0,0,0,0,0,0,0,0,0,0,0,0,9,4,0,0,0,0,0,0,0,0,0,100
8115a94f663084bea82b003cd8f41b53f4eeca39,0,0,0,0,0,0,0,0,0,0,0,0,0,0,10,5,0,0,0,0,0,0,0,0,0,100
8a8c9378c60bae24affc75e2931b2bc440aae569,50,1481,723,758,9,0,9,3,13,91,2,14,4.855085393,5180,24,1,654,608,46,34902,31978,2924,375,345,30,91.69246646
f0453d05dea972aa772c0056c19fc0870f64839b,9,52,66,14,0,0,0,3,19,48,1,2,2.197709169,3287,11,6,466,468,2,19641,19701,60,120,123,3,100
196238b0dbec0cacac02c86849731390c3a6adf2,0,0,0,0,0,0,0,0,0,0,0,0,0,0,12,7,0,0,0,0,0,0,0,0,0,100
4585139176e4f3051c2c345c30830b090e364e87,447,0,0,0,0,0,0,1,1,0,2,40,0,41725,13,8,5043,447,4596,229728,51405,178323,2661,447,2214,18.10132809
11dce4335e825b34870dbcbcc02603ad5ab3452c,1,2,2,0,0,0,0,2,2,10,1,1,0,397,10,0,27,27,0,2967,2954,13,14,14,0,100
0503b207524342c3df613b88e4d2943ffe04fd17,1,2,2,0,0,0,0,2,2,39,1,1,0,192,25,0,25,25,0,1316,1316,0,7,7,0,100
57ea5561025aa6277cd53ce0eb2d904c56709817,24,8,7,1,0,0,0,1,1,0,4,10,2.466247897,2388,14,3,244,24,220,13817,2760,11057,131,24,107,95.57326251
533d52159590f87e8e9996a853e7582e67ae8cd6,6,47,28,19,0,0,0,1,2,42,1,3,2.322053666,2305,15,1,366,364,2,13596,13560,36,68,66,2,96.59239843
e4e6af68f3577d5923a4cb0f71321e0ecd204aae,4,131,53,78,1,0,1,1,3,11,1,2,1.216628779,2365,16,2,431,414,17,14118,13868,250,146,123,23,99.78494624
1684891ecf471cc7d52c95b187fcf290f7e1ce14,266,745,771,26,0,0,0,1,4,0,4,44,7.203455656,28468,17,3,3345,3839,494,165461,187330,21869,1700,1661,39,72.47956403
7a04bfd29dff23604f465299e0ef0f262b0da931,1,124,0,124,1,0,1,1,1,0,1,1,0,0,18,4,6,0,6,398,0,398,6,0,6,99.56458636
bc056d1584dc402332a3160e8c15bbe681dd8750,3,32,16,16,0,0,0,2,3,45,1,3,1.291016446,896,17,0,97,96,1,5248,5199,49,14,14,0,98.02789803
8b7905cd12050a31251a28ecdf835597d1cd4192,0,0,0,0,0,0,0,0,0,0,0,0,0,0,18,1,0,0,0,0,0,0,0,0,0,100
9805d231ae762862912caf73233b34e7efdc41ef,0,0,0,0,0,0,0,0,0,0,0,0,0,0,19,5,0,0,0,0,0,0,0,0,0,100
a5bc5bb35a84a2c61623da9269842985e7cc9da5,9,44,28,16,0,0,0,3,4,18,1,2,2.473540684,2269,19,2,260,260,0,14252,14200,52,77,77,0,100
2b95451e16fb8e29636fc625fbcd817ec7b4adb2,1,66,62,4,0,0,0,3,4,18,1,1,0,192,11,0,26,25,1,1427,1314,113,7,7,0,100
e1a7f2905b7afc0d621f129a092b5c7fc14e97ab,5,81,37,44,0,0,0,3,5,3,1,4,2.071863229,2476,20,3,327,323,4,14915,14831,84,73,72,1,100
8c42e3f9b6844668c029778bcd97603459ec98fc,2,128,72,56,0,0,0,2,3,36,1,2,0.983708263,408,26,0,88,73,15,3208,2858,350,13,12,1,99.90503324
2d7c84c802f9981778882a70df3ea988b9c38d61,1,4,4,0,0,0,0,2,2,36,1,1,0,115,21,4,12,12,0,576,576,0,6,6,0,100
f630e3d4129fc39a3350c1dc2278fa9670111e8c,4,36,32,4,0,0,0,2,5,20,1,3,1.665047923,3234,22,5,521,521,0,19599,19599,0,122,122,0,99.81060606
bfc647368582b512945d86a48a8d5bc3b49ef930,1,11,3,8,0,0,0,1,3,42,1,1,0,156,20,2,11,10,1,1162,1101,61,3,3,0,100
9fe961d5cc3f628f4a24fe7aca20e5a28fc9114b,1,1,1,0,0,0,0,2,4,14,1,1,0,241,27,1,42,42,0,1756,1756,0,6,6,0,100
2ad6df94b79ff0b2c52e5df250601dc99a9fbade,0,0,0,0,0,0,0,0,0,0,0,0,0,0,11,0,0,0,0,0,0,0,0,0,0,100
4bc133632f325c3cbece4fd72035fe559be47647,0,0,0,0,0,0,0,0,0,0,0,0,0,0,12,1,0,0,0,0,0,0,0,0,0,100
bda0f8b95539ff5f84b72857c80eeebb5037acd6,1,10,5,5,0,0,0,2,4,38,1,1,0,110,23,4,18,18,0,655,631,24,10,10,0,100
0e1dd32911236db6a3e379141a4a59acaac0c00d,2,36,11,25,0,0,0,1,2,106,1,1,0.819600435,165,21,1,24,24,0,890,802,88,22,22,0,100
f8ee22a119366d7c48cbbfd5f985d4811c0b3794,7,154,17,137,2,0,2,1,4,44,1,3,2.437742921,1085,22,2,196,188,8,6185,5897,288,129,121,8,99.76381672
303386f75685e8133c20c213027d4e34ee580bc9,14,1004,758,246,1,0,1,2,6,49,1,7,1.642265029,5311,24,3,879,857,22,32514,31952,562,313,294,19,99.90583804
d3f4a4e0d4fdd78f5ba2f1bc907c67a68a6c518b,1,172,0,172,1,0,1,1,1,0,1,1,0,0,25,4,16,0,16,700,0,700,7,0,7,99.90601504
6fd9f12da217774f15d32deeaeda3a389d44ea34,10,163,56,107,0,0,0,3,5,50,1,6,3.009815775,3750,0,0,565,555,10,22700,22345,355,129,126,3,100
10ad3c025fb501a1c79d349de115f9605c5e1e0b,56,611,321,290,3,0,3,1,4,56,4,16,4.928903866,6595,23,3,766,751,15,42282,41345,937,474,458,16,98.64104967
b458bb0c707603dc8bdf28fcd999a3a21cf9b281,1,3,3,0,0,0,0,1,2,0,1,1,0,64,24,4,12,12,0,249,245,4,9,9,0,100
af1c39b43a0a65821ae697e36265effb80ea8ea4,1,4,4,0,0,0,0,1,2,0,1,1,0,74,25,5,14,14,0,315,311,4,10,10,0,100
62c12fa0b899ee76962d6e3fa05298e2a23d5e68,9,719,292,427,0,0,0,2,6,53,1,7,0.780154785,2339,12,0,329,284,45,17390,15511,1879,105,88,17,100
b022dce9f32f2f48015a2b1489e4d72f08916bab,1,72,51,21,0,0,0,2,3,80,1,1,0,604,26,3,92,89,3,3838,3760,78,13,12,1,100
1c967b8e0b282deb9a3d49231f410ffcabd9e9de,10,277,308,31,1,0,1,4,7,36,1,3,2.483942457,2612,24,0,335,339,4,15942,16011,69,141,143,2,97.20568026
f34e9b7c864b32dde6134e0ef2cfb26ab47195a5,1,2,3,1,0,0,0,5,8,0,1,1,0,1132,25,1,160,160,0,6963,6964,1,38,38,0,100
01b353334417fe9d511c239d013dedd822c8235a,6,90,105,15,0,0,0,1,4,45,2,5,2.37088899,598,26,5,62,58,4,3314,3337,23,41,38,3,97.95918367
0c77d52f3c7eee138f36eeb831b4afab45216b2f,30,37,51,14,0,0,0,2,7,57,4,15,4.412755532,5041,27,4,656,760,104,31570,34777,3207,294,300,6,98.71382637
e9187517541f29f162119a2d151d9bdd98e92f49,1,1,4,3,0,0,0,4,5,0,1,1,0,212,13,2,28,29,1,1200,1228,28,5,5,0,100
c1ef889142ae5e2526f8b83138d0dfee31fb7db6,8,228,26,202,2,0,2,1,9,6,1,4,2.760891894,2634,27,6,424,407,17,16199,15705,494,192,180,12,99.77032614
7b3b3a0997850d509da749b6ef0c8a740a19fdc7,0,0,0,0,0,0,0,0,0,0,0,0,0,0,28,7,0,0,0,0,0,0,0,0,0,100
02fb21d9311d6c7625b68534937b4bc7212a73ef,1,6,2,4,0,0,0,3,4,3,1,1,0,618,26,2,93,92,1,3848,3838,10,13,13,0,100
8ed06fe5f736d135ca4a7fb208a20f5844c15781,20,469,143,326,3,0,3,4,10,40,1,7,3.772658481,4994,29,8,729,718,11,31435,30490,945,240,229,11,94.07951599
a907471497be3b9bdbc2a88b9296c6fe923ae0ea,3,39,20,19,1,0,1,2,2,66,1,3,1.381558209,53,27,3,0,0,0,208,169,39,0,0,0,97.31071576
8c86fa656d1dafeaba3fe55ac184ff3cbaa3e324,6,158,10,148,0,0,0,2,9,80,1,3,2.420188852,736,28,4,146,128,18,4128,3483,645,110,103,7,100
86c2f657f5141f4d9f01934dddef8253b4277c21,1,1,1,0,0,0,0,1,2,8,1,1,0,174,28,4,30,30,0,965,965,0,11,11,0,100
a6cb05bcb4f0fcbf7477297f15237d3536b6d658,16,515,98,417,5,0,5,1,10,27,1,6,3.438325662,2188,29,5,382,362,20,14243,13098,1145,277,258,19,96.10220875
ab64a4d0e4487ad7093c5be89088980c1f22019e,49,45,3,42,1,0,1,1,6,0,2,6,0.685599851,4750,30,7,475,1740,1265,28188,46036,17848,226,577,351,90.53991694
c17a6483c437600b722a3107cdd473d9d2c551e4,5,23,7,16,0,0,0,2,11,69,1,4,1.982798115,2292,13,1,365,364,1,12913,12885,28,143,142,1,100
7fc9390d383799aee37917ac1050db19c89b8b98,2,26,10,16,0,0,0,2,8,18,1,2,0.581321499,794,14,2,90,89,1,4679,4570,109,34,34,0,100
329af80d6a05d8b79bd22a6459ad86e4e07a26c1,0,0,0,0,0,0,0,0,0,0,0,0,0,0,15,3,0,0,0,0,0,0,0,0,0,100
a47ca0b491489b4d28a435a5cdc3b218de0e0933,2,21,9,12,0,0,0,4,9,84,1,2,0.353359335,475,16,4,45,44,1,2558,2486,72,16,16,0,100
5142ead2d18fef9fe179215b8eac1fbadefa1b0f,1,4,1,3,0,0,0,4,10,0,1,1,0,213,17,5,0,0,0,942,942,0,0,0,0,100
ae3d29faac48338d3af8481f449db62bdf4d6c15,3,14,27,13,0,0,0,4,9,56,1,2,1.205952534,764,30,6,85,86,1,4253,4319,66,43,43,0,100
cbc5a26a44f410bcfc113528119f1910e252fda1,2,24,9,15,0,0,0,4,10,84,1,2,0.61361902,475,18,6,45,44,1,2558,2486,72,16,16,0,100
2afa961beebf69c9024ce928b2e5ec8b9dceda32,1,6,6,0,0,0,0,2,3,3,1,1,0,273,19,7,45,45,0,1638,1616,22,16,16,0,100
2123261537c3ccb041d067f5079533490db2d1ef,40,2017,500,1517,14,0,14,2,12,42,1,14,4.505462783,5959,28,0,908,794,114,41774,36769,5005,447,371,76,97.86740844
028b0c92fde92e131d79e0140a01c13044995f17,44,241,192,49,1,0,1,1,9,25,5,14,4.81606521,5613,31,5,638,633,5,35135,35276,141,407,402,5,99.50248756
2bdc238928b93e8b96bbcbb0794a3e76254a2a33,9,464,304,160,1,0,1,2,11,26,2,7,2.116789688,1484,29,3,225,210,15,9858,9357,501,63,56,7,99.72899729
88fc6a2542c1a5676b8e39962acd5ada1a7f6d3e,87,987,2713,1726,0,0,0,1,11,6,5,24,5.214079107,12631,20,8,1466,1600,134,71833,77192,5359,739,827,88,97.26851852
9b59a345f2100b943b188c58739d1ddff856935a,86,2701,960,1741,16,0,16,1,15,17,5,24,5.188263607,11305,21,9,1556,1421,135,75648,70189,5459,811,723,88,97.26851852
e5f1024d4d2d295763c96a566ef3f298fcfb3bc4,0,0,0,0,0,0,0,0,0,0,0,0,0,0,32,6,0,0,0,0,0,0,0,0,0,100
06d64a29dcea6e10d22165f80300e007eb9d000a,7,246,15,231,2,0,2,6,16,8,1,5,2.029678831,3844,33,7,627,602,25,23366,22624,742,205,189,16,99.77487618
89bba9534b092d85027c8de81bf7f174760bc24f,3,195,1,194,2,0,2,1,2,44,1,3,1.383736535,127,34,8,20,7,13,1614,899,715,16,6,10,99.7310623
2f55c9b711bacb536aad9296258ce35525092da2,10,16,441,425,0,0,0,1,15,5,1,7,2.738002086,4265,22,10,609,647,38,23523,24980,1457,195,221,26,99.50584007
5d005321187e632c489d3ce56dd3b6bd1c3c8652,10,441,16,425,4,0,4,1,16,19,1,7,2.738002086,3971,23,11,647,609,38,24980,23523,1457,221,195,26,99.50584007
c0ee023aaa3c7712c7f61c8a797460290c225d14,1,7,0,7,0,0,0,2,2,3,1,1,0,253,24,12,46,45,1,1810,1754,56,7,7,0,100
fc04335f61c4422a48fb4b61821cf921a29421ec,0,0,0,0,0,0,0,0,0,0,0,0,0,0,25,13,0,0,0,0,0,0,0,0,0,100
fd50af275210490bfff6aad85fa895362a5bbf1b,0,0,0,0,0,0,0,0,0,0,0,0,0,0,30,3,0,0,0,0,0,0,0,0,0,100
ea914c9c083f80184652ff1708c562d345030008,1,1,1,0,0,0,0,3,4,42,1,1,0,327,31,5,56,56,0,2099,2099,0,13,13,0,100
92517430e6c80d9de19aedf1aafc57367d5240f0,21,1727,9,1718,17,0,17,1,14,9,3,9,3.173586311,1351,35,5,365,238,127,13896,7995,5901,180,103,77,97.97713281
39c9add1537c46fe79a10f2456fa5829ccda64d3,3,47,6,41,0,0,0,2,3,144,1,3,1.496501955,517,32,3,79,76,3,3191,3014,177,32,31,1,100
2347627d5993f9c3ed9e26f244fac6e48f18a2a0,18,39,88,49,0,0,0,2,8,82,5,8,3.602094,3215,29,1,419,419,0,18429,18422,7,174,174,0,100
71eab655eea02b946fb88907650168d7c2d18bef,1,67,16,51,0,0,0,3,6,10,1,1,0,621,33,3,99,93,6,4170,3848,322,14,13,1,100
507959dcb4af9b5c5f26a97c237cdb7b6235e7a1,15,288,197,91,0,0,0,2,17,54,2,7,3.379508664,2313,30,2,219,214,5,13710,13286,424,92,90,2,92.72373541
c33ea10c40d0712352171b8f086dd4fcb70a43c3,6,517,0,517,6,0,6,1,1,0,1,2,2.514263031,0,31,3,32,0,32,1587,0,1587,23,0,23,98.08940159
549789aafbf39d47af371c00375cd5e5ecea232a,1,1,1,0,0,0,0,1,2,158,1,1,0,140,36,5,17,17,0,912,912,0,2,2,0,100
188f6ed7218120284e1ec9421be5f03b6582ef83,1,2,0,2,0,0,0,2,3,12,1,1,0,209,34,4,30,30,0,1249,1237,12,11,11,0,100
831e9eaada9dd5ce0a6b3e30150e707a1733110c,0,0,0,0,0,0,0,0,0,0,0,0,0,0,37,6,0,0,0,0,0,0,0,0,0,100
8cdcf541e095bdede5fd01bdb94f575a4d38a42f,1,41,27,14,0,0,0,2,3,182,1,1,0,115,35,3,12,12,0,677,599,78,11,11,0,100
3f5009aea0797563304dd8ba1aa6fb06ebaab83b,205,3820,5748,1928,20,0,20,2,18,9,6,37,6.401862859,22676,32,3,2602,2700,98,130085,136559,6474,1355,1429,74,90.22967554
85e7a4907248248a9df2857dc479a5d3a9a5b7f3,1,1,1,0,0,0,0,2,4,0,1,1,0,230,33,4,45,45,0,1393,1390,3,36,36,0,100
c14e524b6ac8829fae37eeedcbc78eaa5b9bedcc,12,80,97,17,0,0,0,2,11,0,1,5,3.36099132,1925,34,5,293,300,7,11834,11889,55,178,178,0,100
40e201df9bb32cb4d3ff0b02c7899f3e9bed2529,5,12,14,2,0,0,0,2,9,93,1,3,2.257756064,1742,38,2,275,277,2,9786,9786,0,65,67,2,100
0e52d19f132be6078526e8ebb3a4db8f0ef40cb1,12,261,186,75,1,0,1,2,3,9,1,4,2.933513604,885,39,3,130,114,16,5645,4723,922,72,66,6,99.17146974
c51e27dd5ed131e0ac3fcc96078e135f2657b0a4,1,2,1,1,0,0,0,2,4,0,1,1,0,451,40,4,87,87,0,2993,2993,0,37,37,0,100
7998240142c99311f7d51cde9bc102259c9bd937,0,0,0,0,0,0,0,0,0,0,0,0,0,0,41,5,0,0,0,0,0,0,0,0,0,100
ea831c80b8cfd33a233a34666537f840f2c104bf,1,3,0,3,0,0,0,4,6,14,1,1,0,172,36,2,21,20,1,1199,1178,21,5,5,0,100
1d9c7d3144d33c6248ae2cb4ec7d6f6349241e6b,1,1,1,0,0,0,0,4,7,0,1,1,0,175,37,3,21,21,0,1199,1199,0,5,5,0,100
a0433d21daeec7877e6f9a1567dd974dfdb64278,2,10,6,4,0,0,0,3,5,13,2,2,0.543564443,535,1,0,100,98,2,3407,3383,24,45,45,0,100
a2dfd6792db0c0232f56f29510111a0e213cc46b,5,63,19,44,1,0,1,2,2,4,2,4,1.837385528,107,38,3,2,0,2,524,400,124,2,0,2,99.85652798
905d5f60b9a4d25a69007dda6d82f153487d83f6,1,3,2,1,0,0,0,2,2,0,1,1,0,33,2,1,2,2,0,124,124,0,2,2,0,100
e709fda6bd42b7c34a258f6db53315a0810172a1,0,0,0,0,0,0,0,0,0,0,0,0,0,0,42,5,0,0,0,0,0,0,0,0,0,100
73d70bd8913a0fb8465138b1b3db2e2f384e7fe5,3,184,1,183,2,0,2,1,3,21,1,3,0.892348941,255,39,4,53,39,14,2017,1593,424,23,15,8,99.85683608
fc2026fa1ac5225a82e47c4968801d5140f6bfa4,27,602,697,95,5,0,5,2,5,22,3,11,4.275666658,1978,0,0,233,252,19,11397,11405,8,127,132,5,98.2869379
f31c62575453d6b4ae93ee20f8bd1d34f94a7217,18,504,193,311,4,0,4,2,7,6,2,9,3.360796715,1395,6,0,219,184,35,9399,7884,1515,110,94,16,99.04323175
40bc599b8a7e7caaeb0a284fd2d2103926b79288,11,307,168,139,2,0,2,2,4,173,1,5,2.646542418,889,40,4,123,123,0,5284,5065,219,68,66,2,98.84856943
5bb956cad2d9c4beded036553f715f0e3156d665,28,1000,160,840,5,0,5,2,12,30,2,7,3.995248248,2606,35,3,446,366,80,18700,15638,3062,286,236,50,96.11817245
974c30b7485b653ba37e11d43b474b458134c6ce,1,43,13,30,0,0,0,4,10,38,1,1,0,1504,43,5,252,249,3,8876,8810,66,45,43,2,100
a802fef1c25096ced056ffb67a75ffec3d2965a5,7,46,21,25,0,0,0,2,4,38,1,3,2.686951301,416,44,6,40,36,4,2374,2311,63,33,29,4,100
f4bd1996e66fbe3f4daf8aca1e7be1e9cead5dee,5,26,18,8,0,0,0,2,5,24,1,3,2.104952587,627,41,5,82,84,2,3695,3659,36,46,46,0,99.83004759
156682791504c2e433382551e1be301e1d9146cb,1,52,16,36,0,0,0,3,6,44,1,1,0,164,45,7,15,11,4,1337,1152,185,3,3,0,100
a4d33303969c060e02b9bc76b90c3ba06e9ba9e3,1,4,2,2,0,0,0,4,6,26,1,1,0,456,237,0,90,89,1,3029,3017,12,37,37,0,100
95ce243fd8be15aed3155ba8bd1791a846df8a32,11,280,21,259,2,0,2,3,19,39,2,6,3.075312769,2332,36,1,430,404,26,15274,14335,939,230,218,12,99.72982101
56fcb519aa56550bb5fdfa666eba275e0f1b0020,4,129,2,127,1,0,1,1,20,3,2,3,1.500546799,2118,238,1,347,338,9,12256,11821,435,127,122,5,99.19327731
2430ec5f231f572b780dc0cb0053f409358df155,9,253,38,215,0,0,0,2,21,2,1,5,2.389579993,2330,37,2,418,397,21,15481,14551,930,229,217,12,99.86608637
9cbbf99a339b639aabe32cd21fa8e2f9439022a4,1,1,1,0,0,0,0,3,7,14,1,1,0,191,46,4,15,15,0,1339,1337,2,3,3,0,100
460198af9da68e0e723ae9237031cfae2cf8bfc0,5,141,13,128,2,0,2,3,5,20,1,1,2.132441225,137,42,4,13,9,4,1009,711,298,12,8,4,99.83344437
01c527e225336d68a30e447889b37b6187f6286c,57,1531,949,582,9,0,9,3,22,70,2,21,4.477074548,12100,47,5,1787,1715,72,77342,74516,2826,706,643,63,88.40372226
95e1226766fb7df16e699cd54cf8ba0d043dc69d,23,825,379,446,10,0,10,2,7,5,2,7,4.229461939,1059,43,4,159,136,23,7225,5901,1324,102,74,28,98.49710983
f4deb5ca809e8b1663301589e3c0cc94e370cd3d,2,27,4,23,0,0,0,1,2,2,1,2,0.770629069,101,44,5,10,6,4,710,551,159,8,6,2,100
2a6c9d5630508439c9fc4cee175617ff63d59a7d,7,98,37,61,1,0,1,2,20,9,2,4,2.184188622,1683,48,5,357,354,3,10810,10697,113,244,241,3,99.84726995
a68f2badaa216125106bcc1e9397edf43623a9ec,18,143,91,52,1,0,1,3,9,10,1,5,3.452297982,1248,49,6,145,145,0,7413,7108,305,89,89,0,99.6952381
9c47b670a1972cb64e3a1d92ad376e6f0db10b1f,1,111,0,111,0,0,0,4,11,5,1,1,0,177,38,3,30,21,9,1854,1221,633,6,5,1,100
0e0414784b2ecd7b63dced8cf69aa0854106116d,3,474,0,474,3,0,3,1,1,0,2,2,1.528916201,0,39,4,28,0,28,2518,0,2518,21,0,21,98.33976834
da2a68708b69d984a3f91710cc6445845cc086b2,0,0,0,0,0,0,0,0,0,0,0,0,0,0,45,5,0,0,0,0,0,0,0,0,0,100
67f5f747578b0e67944da2fea9e4a3d3a22c4e09,14,519,15,504,6,0,6,6,23,21,1,6,3.32369225,3045,46,6,487,455,32,20789,19090,1699,232,215,17,99.41747573
b2dff2751d8d3d768f788b39089688c18f6c1750,14,2173,26,2147,6,0,6,1,24,12,1,9,2.789959585,4382,31,0,889,688,201,36000,26729,9271,297,219,78,99.27007299
f4f453db34c77d96fbe2407376fb36d496be8d09,1,24,11,13,0,0,0,5,10,16,1,1,0,439,239,2,86,84,2,3061,3004,57,34,34,0,100
1eca854291a34baf4e9bc1d6699784df0dd2aa7d,1,1,1,0,0,0,0,5,14,1,1,1,0,1524,40,5,256,256,0,8986,8986,0,45,45,0,100
0bb304002b0fa6076b72004384c81061fc84d07b,1,1,1,0,0,0,0,4,5,20,1,1,0,738,41,6,150,150,0,4491,4491,0,44,44,0,100
ab88282d173d0ae36bff9a06485fb8be158455d4,7,27,24,3,0,0,0,3,25,35,1,4,2.462174863,3318,42,6,508,506,2,19288,19276,12,175,175,0,100
c5c1c4c6131ee67265c4c322d53b689f9a52dc40,54,259,355,96,0,0,0,2,18,41,6,20,5.313612065,7181,47,6,869,876,7,43440,44909,1469,438,450,12,99.35015291
5d3f3c113aeb17fb4332668ffb24cb5571cbc24c,2,4,6,2,0,0,0,2,5,19,1,1,1,63,48,7,1,1,0,256,266,10,1,1,0,100
cd16dac76ba87780fa3195b73264fb050d079a9b,1,7,0,7,0,0,0,2,5,27,1,1,0,160,49,7,20,18,2,1076,1047,29,4,4,0,100
bf0d07420d50e816060fbcbc5c09f93b571a8947,6,468,471,3,2,0,2,4,10,22,1,1,2.544818123,899,50,8,81,102,21,4642,5554,912,45,37,8,92.15254859
84cdd9f839e1336f4ee92891a457b5d007920e4c,56,684,767,83,0,0,0,4,16,41,6,18,4.76435841,6037,240,2,612,611,1,35304,35378,74,349,345,4,98.07562458
b079e2ba8fb8961a73b1d1dc71b63de8116401c1,0,0,0,0,0,0,0,0,0,0,0,0,0,0,50,4,0,0,0,0,0,0,0,0,0,100
34abd6f5b253eda011f6fc180aa8e8d854866bc8,14,33,94,61,0,0,0,2,17,51,1,6,2.809595681,3298,43,7,517,521,4,19370,19481,111,214,218,4,97.9966611
81b837d36189a1d763bd1747ca0550107c155664,5,87,16,71,1,0,1,7,18,6,1,5,1.633096908,3511,241,3,564,561,3,21689,21476,213,126,124,2,99.89648033
e1352c8e4e48444e6dc6a3bed5c99975c396dc86,5,40,8,32,1,0,1,1,5,0,1,1,1.311278124,483,44,7,71,71,0,2788,2773,15,44,44,0,99.62108164
2353e1adf1bc9a54c4448cd521bf80c39fc55c62,3,19,2,17,0,0,0,3,5,6,2,2,1.448815636,175,51,9,20,18,2,1023,926,97,19,17,2,99.30651872
928c1092b90084e93cd2cfe61ca3ce392a6e8c01,6,110,36,74,0,0,0,3,11,150,1,4,1.912345317,1090,51,5,181,175,6,6837,6612,225,85,81,4,95.95898673
0f5d337d484700c6efdc95457344840f40d2e237,1,4,7,3,0,0,0,4,7,20,1,1,0,308,242,3,52,52,0,2089,2102,13,8,8,0,100
185b9ffc8621f4b47944d6c93b94fbdbb7c5af2e,1,10,6,4,0,0,0,4,8,0,1,1,0,305,243,4,49,52,3,2015,2089,74,8,8,0,100
621a022c0e910f38d961ec50a29e2686d7ae49a0,11,235,191,44,1,0,1,3,26,93,1,5,2.800737446,3188,52,9,458,455,3,19585,19588,3,204,201,3,94.4937833
96fd05385199460bb731270e8dc42a5408175ab9,13,776,156,620,7,0,7,4,11,13,1,5,3.211880228,649,53,9,117,68,49,6148,3774,2374,62,32,30,92.79731993
6cf79dbe2c4397732820c435df723fe50e9f3daf,8,229,59,170,0,0,0,2,10,52,1,5,1.848040835,2253,26,0,371,362,9,15402,14677,725,206,202,4,100
67e0f11d2bd98e0614b26d4ea6dd707e6f65a105,2,5,1,4,0,0,0,4,9,0,1,2,0.918295834,421,27,1,75,75,0,2697,2668,29,50,50,0,100
ff8d98e20a4b2475f5890ade5ee78dc8d804420c,2,5,3,2,0,0,0,3,8,0,1,2,1,513,28,2,69,69,0,3195,3178,17,35,35,0,100
228edbbd798f7718a5a7ccbcfd35c22e812be761,3,166,17,149,0,0,0,3,27,2,1,2,0.514282208,1282,29,3,205,190,15,8375,7747,628,135,128,7,99.86595174
39f3591365cbe15b74c82574787d0592681d8ba5,0,0,0,0,0,0,0,0,0,0,0,0,0,0,30,4,0,0,0,0,0,0,0,0,0,100
823ff1f8cb318f942700f6e495560c2a304def94,1,19,1,18,0,0,0,2,2,291,1,1,0,27,54,9,3,2,1,78,53,25,3,2,1,98.93653516
24c7044baca1801896927c88ac0504fc4cd4cd08,2,19,9,10,0,0,0,4,5,77,1,2,0.905928216,461,55,10,36,36,0,3499,3382,117,19,19,0,100
db077ec209ddc22946fb6060609d5a6529682356,31,529,622,93,0,0,0,3,26,35,2,10,4.477695016,4467,45,5,505,515,10,28539,29754,1215,321,312,9,96.56652361
7543752941da734e4d2b583e9ab3e86c6e18e107,0,0,0,0,0,0,0,0,0,0,0,0,0,0,244,5,0,0,0,0,0,0,0,0,0,100
a33d50b4a952b22270e9478af9e925deecddec1c,0,0,0,0,0,0,0,0,0,0,0,0,0,0,245,6,0,0,0,0,0,0,0,0,0,100
7e48523b520afee8e727d1e1aaab801a3bd80f06,1,2,2,0,0,0,0,2,2,30,1,1,0,206,246,7,22,22,0,1364,1364,0,9,9,0,99.90657116
b77acf2ef54d14b1566e2e471178f1f235130911,5,114,59,55,1,0,1,5,6,32,1,2,1.339502476,293,247,8,19,18,1,1821,1647,174,13,12,1,99.81325864
b408ed1f5ff54ac62fa073d5402515b3d892086d,0,0,0,0,0,0,0,0,0,0,0,0,0,0,46,6,0,0,0,0,0,0,0,0,0,100
38f1f179361105f925106c5a17e9cb54a068b682,1,3,1,2,0,0,0,4,13,8,1,1,0,215,56,9,18,18,0,1477,1466,11,7,7,0,100
158c0b1180fa8f01bffd119df49b982fdda22771,49,391,387,4,0,0,0,3,28,12,2,14,4.776000334,7428,47,7,1006,1006,0,46381,46357,24,576,576,0,97.64816557
82a86c2fea754e75e10e62be7dae009f23f343b8,0,0,0,0,0,0,0,0,0,0,0,0,0,0,248,9,0,0,0,0,0,0,0,0,0,100
c7a36429a25420d7a54ba6fb30caa3c4a99dc270,0,0,0,0,0,0,0,0,0,0,0,0,0,0,52,2,0,0,0,0,0,0,0,0,0,100
32b7f593fd17c3ea4bae5387da96091284f5b91e,0,0,0,0,0,0,0,0,0,0,0,0,0,0,53,3,0,0,0,0,0,0,0,0,0,100
75b3112661c0900d7447d8ad56647b3e73ec0a24,9,68,91,23,0,0,0,3,9,14,1,2,2.966133426,1128,57,8,147,156,9,6525,6702,177,95,93,2,99.93670886
c1b88405c96db8203641c2baae8ff30527bb2b46,2,124,54,70,0,0,0,4,10,15,1,2,0.737382222,880,31,5,123,113,10,6491,6056,435,48,47,1,100
52b7e5d6e9afd6b9f129be8dcbf9ebe53e5383db,16,51,39,12,0,0,0,3,11,46,1,5,3.658955188,1199,54,3,140,140,0,6882,6944,62,81,81,0,100
14171ad3cb5a8bf52ceb62dfd5632338bbe2d11b,0,0,0,0,0,0,0,0,0,0,0,0,0,0,7,0,0,0,0,0,0,0,0,0,0,100
903302d12fb2af7788a8745af1bd05003ee985dd,24,868,226,642,4,0,4,4,28,25,3,13,3.527422891,5226,58,6,823,799,24,34670,31834,2836,353,330,23,96.20838471
6c05902ba16de1e70dbf80da702492aeb32b5317,1,2,2,0,0,0,0,6,29,29,1,1,0,445,59,1,116,116,0,2476,2476,0,109,109,0,100
ff970f2db73018f6f48b5361ffd9e21c5154aba9,2,10,9,1,0,0,0,2,2,59,1,2,0.485460761,280,60,2,28,28,0,1696,1696,0,12,12,0,100
c5a87d16119c7e9a9f2af80a5534c4fe37605dd3,23,1274,192,1082,8,0,8,5,30,22,2,7,3.437270923,4742,61,3,851,760,91,32850,28737,4113,363,307,56,95.82253886
4b0f52cc8e8841b64ac970733c1ef5dcd0ad4c18,28,1312,106,1206,19,0,19,1,14,8,2,13,4.170685239,1206,55,1,224,152,72,12936,8047,4889,139,78,61,95.73070608
4f88fc8fcefd0f8e3cf3b951e7642a4a1cbe28e1,0,0,0,0,0,0,0,0,0,0,0,0,0,0,62,4,0,0,0,0,0,0,0,0,0,100
d36dd50810929b5dad2d3bab2007e28802087ad6,5,276,17,259,2,0,2,7,31,14,1,3,1.946797925,1951,56,1,309,290,19,12487,11785,702,160,150,10,99.84610649
61ef4d2bc9ecb64a1e433bc1059bfb9e730416dd,1,4,2,2,0,0,0,1,2,0,1,1,0,39,57,2,3,3,0,147,147,0,2,2,0,100
b88292dbffea2fdc03abc68685394b64d4f34cba,2,0,18,18,0,0,0,6,32,0,1,1,1,794,48,0,122,123,1,4626,4654,28,111,112,1,100
d8baf4b80b4c98073bfd82d29ccf46b11847ee4e,6,252,100,152,2,0,2,1,3,4,1,2,2.455069258,346,63,5,39,25,14,2299,1874,425,35,20,15,96.29404617
56d8e89887f9037cb1849b66d99e1e01eddec106,1,1,1,0,0,0,0,2,6,47,1,1,0,48,64,6,3,3,0,246,247,1,3,3,0,100
e495238bb16f248c9a100f62f17449f8c381e3b9,0,0,0,0,0,0,0,0,0,0,0,0,0,0,249,0,0,0,0,0,0,0,0,0,0,100
afb3ecce139ab7c4037602ad143b5e6424dc48a2,19,641,33,608,9,0,9,1,33,24,1,7,3.976431912,2823,58,3,479,450,29,20067,17750,2317,304,285,19,99.01345291
a419a7bc4b3d93ce18b84ef79a77afc8fbfbbc05,0,0,0,0,0,0,0,0,0,0,0,0,0,0,250,1,0,0,0,0,0,0,0,0,0,100
fd9690a05de75707de59f5c44d56373bed500819,3,101,27,74,1,0,1,1,7,16,3,3,1.173464455,509,59,4,39,34,5,3855,3692,163,26,21,5,99.9405116
a9636e246b7593fd446ec89bc31259a5e373c49d,0,0,0,0,0,0,0,0,0,0,0,0,0,0,251,2,0,0,0,0,0,0,0,0,0,100
190974b5175252ff4c8ae53935f764a3d7b2f686,0,0,0,0,0,0,0,0,0,0,0,0,0,0,60,5,0,0,0,0,0,0,0,0,0,100
b053658abefd676b703e7567595e4b8d89b765c4,0,0,0,0,0,0,0,0,0,0,0,0,0,0,32,0,0,0,0,0,0,0,0,0,0,100
7f8ac565e0629337e08f189399a3e0d18163db1b,1,4,4,0,0,0,0,1,3,12,1,1,0,131,65,6,5,5,0,742,742,0,4,4,0,100
04bf3d64448b79be9967337888cc8eec1c9ab097,1,1,1,0,0,0,0,1,2,11,1,1,0,100,61,6,17,17,0,584,584,0,17,17,0,100
ff02c5d6cf98c86f2aff5cf21206b1bdfabab4f9,0,0,0,0,0,0,0,0,0,0,0,0,0,0,33,1,0,0,0,0,0,0,0,0,0,100
5922de1476454fa9e7462aabacb2f3f2dd3e162d,0,0,0,0,0,0,0,0,0,0,0,0,0,0,34,2,0,0,0,0,0,0,0,0,0,100
5e758b849e817d846c5a39b57bb07b72eaf40f7d,0,0,0,0,0,0,0,0,0,0,0,0,0,0,35,3,0,0,0,0,0,0,0,0,0,100
bc066fa431e520370e3cdd5ba5766c75d7060869,0,0,0,0,0,0,0,0,0,0,0,0,0,0,66,7,0,0,0,0,0,0,0,0,0,100
57821392a9dedafe3f6cc02d89ebd5624ba1a7e1,2,36,29,7,0,0,0,5,14,42,1,2,0.333522004,852,252,3,144,144,0,5420,5355,65,53,53,0,100
7b724131fd7fd7f67119258a532a651789beec68,5,32,2,30,0,0,0,2,15,98,1,3,2.279116418,1758,253,4,270,266,4,11149,11059,90,87,85,2,100
9f7a347896248ef1136d59e9a5b1b872ea11941b,1,1,1,0,0,0,0,2,2,392,1,1,0,26,254,5,0,0,0,68,68,0,0,0,0,100
8811165e85ae2db442e34f1021db29f4dfcc8430,263,3526,3039,487,6,0,6,2,34,43,6,52,7.048696664,30427,67,4,3626,3321,305,185069,168390,16679,1847,1701,146,87.01550388
bcfef4588727f253fb5d80b501314ffc1d2b6438,0,0,0,0,0,0,0,0,0,0,0,0,0,0,62,4,0,0,0,0,0,0,0,0,0,100
f74d4c9cd5df808b5d66ec348b0a8d3c6c1934ed,0,0,0,0,0,0,0,0,0,0,0,0,0,0,49,0,0,0,0,0,0,0,0,0,0,100
458ddd8f92d7dab8428c7bf481cd2797b05b278e,11,25,22,3,0,0,0,2,10,66,4,8,3.324929543,888,63,1,94,94,0,4612,4612,0,50,50,0,100
c5fe858e9cf7ccd5746aa1168414b42b79c4adc2,4,37,3,34,0,0,0,3,12,32,1,3,1.523077528,759,50,1,105,103,2,5147,5014,133,60,59,1,100
3d4f31343c3686435696e75ce88a75c9bffb024e,2,114,0,114,2,0,2,1,1,0,1,2,0.977682542,0,64,1,8,0,8,508,0,508,3,0,3,95.34806994
487ec36fb2e124646a238c9aa294ad63510e6ab3,1,19,1,18,0,0,0,2,7,149,1,1,0,96,68,0,15,12,3,567,507,60,12,10,2,100
ea957c226f07fc4c73bb556bfb51576ce3462ae5,2,2,19,17,0,0,0,7,23,32,1,2,0.276195428,1288,36,0,185,188,3,7649,7700,51,51,53,2,100
2f2d807176cdf5a4da7037f08b04161cec5a987d,1,19,1,18,0,0,0,2,7,149,1,1,0,96,37,1,15,12,3,567,507,60,12,10,2,100
85dae7f8593d7562546a3d81ac9e77470220dc37,0,0,0,0,0,0,0,0,0,0,0,0,0,0,38,2,0,0,0,0,0,0,0,0,0,100
90f3116e38f7ba54b654345ef2774aa2a99412e8,40,410,295,115,1,0,1,4,25,37,5,20,3.089855651,5970,65,1,645,645,0,40496,40151,345,388,388,0,94.70160116
7fb9b5f3a2d4fe377c014d16f54d06a626228526,1,244,0,244,1,0,1,1,1,0,1,1,0,0,66,2,26,0,26,1054,0,1054,23,0,23,99.94505495
0d358c9d5e59351a55462e860befd6b6a3dbe535,1,1,0,1,0,0,0,4,13,5,1,1,0,720,39,3,113,113,0,4499,4492,7,40,40,0,100
1eaddd183259047476893a014fb24e44fc549531,11,397,40,357,1,0,1,4,24,67,2,6,2.680503939,3467,255,0,514,488,26,22058,20613,1445,138,116,22,98.8630061
8f89bd85a03a1fec25e21e334631931f69078040,44,1827,511,1316,14,0,14,5,35,97,3,13,4.621307372,5552,67,2,966,896,70,39047,34662,4385,581,505,76,96.40224123
d333c4099abc0280335a56a73104deeb734e6057,1,10,9,1,0,0,0,6,36,0,1,1,0,487,256,1,125,125,0,2764,2755,9,114,114,0,100
52c88d8d9850c49deed9c15f658b05b72855d488,18,459,166,293,0,0,0,1,34,30,3,5,2.187680761,1523,68,3,172,167,5,9325,8519,806,127,125,2,100
7ea62d9c123c8a1865187e76b65da2aac936281c,1,18,0,18,0,0,0,4,4,104,1,1,0,94,257,2,17,15,2,473,441,32,17,15,2,100
f8a3c777e1fc1902a6a965c1d2a33e7ce3cc1643,2,45,1,44,0,0,0,7,35,15,1,2,0.495969072,2036,40,1,263,257,6,11745,11529,216,48,47,1,100
89445670eee21e38c0dadde4753310adae14b964,22,388,763,375,1,0,1,3,18,146,1,6,3.673904217,3631,69,0,413,334,79,21300,18030,3270,171,133,38,99.00466563
8fbade6a7801afd6065007473585d9d2a761818a,45,653,136,517,4,0,4,2,19,87,5,20,4.546515314,4065,69,2,466,420,46,27256,24093,3163,306,270,36,91.71471927
94acaaa54d2f981a365e88e414d76449014bfe19,1,5,6,1,0,0,0,2,3,161,1,1,0,153,32,0,22,23,1,942,954,12,8,8,0,100
110d77c5536f7d5e00c08f4df575cd8de6c75792,2,16,2,14,0,0,0,3,20,10,2,2,0.764204507,980,70,1,138,137,1,6614,6542,72,49,48,1,99.82185273
df64dd7b8094864b3857d95309b1278c48be7322,7,63,20,43,0,0,0,2,24,115,1,4,2.766880019,2202,258,3,347,340,7,12845,12694,151,102,101,1,99.34543291
8db290147e5d16e84ff103d3ebfa8835cf843d1e,0,0,0,0,0,0,0,0,0,0,0,0,0,0,41,1,0,0,0,0,0,0,0,0,0,100
d6200bdd8327c94a1b171123ae14157bafacbd6f,2,44,4,40,0,0,0,2,25,16,2,2,0.994984828,1285,71,2,183,179,4,8054,7823,231,47,46,1,99.9702381
40a557367a49df5c73ce4e17ad047e91d1f56688,0,0,0,0,0,0,0,0,0,0,0,0,0,0,42,2,0,0,0,0,0,0,0,0,0,100
01a46f9ba7d38264a785bdafddc2b39188602c28,0,0,0,0,0,0,0,0,0,0,0,0,0,0,43,3,0,0,0,0,0,0,0,0,0,100
49dbdf72ee486c9f35992f7c95e2eae9a1c2efa1,17,1316,42,1274,7,0,7,1,26,37,1,9,3.119001243,2611,72,3,456,336,120,23390,16079,7311,190,128,62,94.04861693
c2af20485a2acf3bff5175ba79981382236942f4,52,2300,92,2208,41,0,41,1,17,11,2,11,5.310930139,1375,70,1,286,192,94,15487,8987,6500,159,77,82,96.01085482
0c8700dafb01b28b5e8727d93261da0bcc080a9f,0,0,0,0,0,0,0,0,0,0,0,0,0,0,71,2,0,0,0,0,0,0,0,0,0,100
4b01c88e4c6d72d72234a069bed856dd49737112,52,805,352,453,9,0,9,2,37,19,2,18,5.056938602,7959,72,3,1118,1099,19,51733,49849,1884,615,590,25,90.32906305
efe6bf3d6ece4bedfd0ab0ba649bcc558d1b0c80,11,588,137,451,3,0,3,1,22,0,1,7,2.527951866,1396,73,3,240,199,41,9838,8456,1382,89,61,28,94.60458241
039903ef208658ced9a05af6944e1199f613adab,5,5,5,0,0,0,0,1,2,5,1,1,2.321928095,130,74,4,5,5,0,270,254,16,5,5,0,100
f1af43d72ab628b7fcf94831ddc5c8945506e37b,1,1,1,0,0,0,0,1,2,1,1,1,0,92,75,5,15,15,0,448,445,3,9,9,0,100
d97b396654d476fb7e9c7d15d71d3553f1c48083,2,29,27,2,0,0,0,1,28,6,1,2,0.905928216,482,76,6,99,98,1,3330,3267,63,80,79,1,96.04815493
6c0917ab17cd65d51e0d5315489d5d43bb9a8133,7,105,121,16,0,0,0,2,38,93,1,3,2.251833129,947,73,1,156,163,7,4835,5140,305,147,152,5,97.11238293
4caffaf2b0c9c5be90eab06a9d6df38b62e68429,3,15,1,14,0,0,0,2,23,165,1,2,1.014097656,751,74,2,132,131,1,4501,4376,125,52,52,0,100
482b7ccb5a9bb55fd9852fe639775cb965c32445,1,9,1,8,0,0,0,3,5,332,1,1,0,133,75,3,20,18,2,726,702,24,12,10,2,100
345b3d965d42efeafa0b2e7dba2a505c1fa1d771,2,0,2,2,0,0,0,6,14,88,1,1,1,282,76,4,25,25,0,1639,1651,12,6,6,0,100
d31949a11d184f337fa1287f0c2b8f769bae82fd,22,582,98,484,0,0,0,3,39,156,2,16,3.530885915,6432,259,0,946,909,37,39832,38198,1634,407,375,32,94.81500782
294b73583fc0dcd548ae95a841829f9ad2ab3ed0,3,631,0,631,3,0,3,1,1,0,1,3,1.510879928,0,260,1,59,0,59,2592,0,2592,28,0,28,97.6744186
13c3aa116546ad99748de2bc7c8607958b314464,13,1440,0,1440,13,0,13,1,1,0,1,5,3.233306159,0,44,0,87,0,87,5349,0,5349,44,0,44,99.19751488
218f60236ff174852ce91384256d722d2ad48cf8,2,104,5,99,1,0,1,1,3,157,1,2,0.940840309,210,77,4,43,38,5,1477,1158,319,28,24,4,99.58656331
8df1027b4403f3b64ef02bd066d864371f6613f3,2,7,3,4,0,0,0,3,5,416,1,2,0.721928095,324,51,0,50,50,0,1892,1862,30,26,26,0,93.19969551
d419f8f4f84723e1eadce96168414de9f3ce5677,113,5426,921,4505,32,0,32,2,40,7,4,31,5.440388559,7416,77,0,1290,883,407,58209,41301,16908,851,561,290,90.48305696
fa6e3d5a8b25616e31cf355f2cb5a7001f4c8f64,22,1823,0,1823,22,0,22,1,1,0,1,2,4.335126155,0,52,1,134,0,134,5118,0,5118,102,0,102,98.92177105
05d4f17c8f29e3ca9ba28dd62173b8256a985af5,7,1296,0,1296,7,0,7,1,1,0,1,4,2.321844646,0,45,0,117,0,117,4700,0,4700,57,0,57,99.57216843
8a147a30ea5ed92e49a5fea81757fba310b64d90,0,0,0,0,0,0,0,0,0,0,0,0,0,0,46,1,0,0,0,0,0,0,0,0,0,100
44ae3c38c5560f869623a6f286f5c657b6d9a37f,1,2,0,2,0,0,0,2,2,715,1,1,0,79,47,2,12,12,0,384,380,4,8,8,0,100
328cc82923a445b62090a6ba7863c35d51815b91,1,1,1,0,0,0,0,3,3,395,1,1,0,86,48,3,13,13,0,494,495,1,5,5,0,100
8af453cdab42b5276cec2e89d83ce5c87d70a137,1,6,2,4,0,0,0,4,14,191,1,1,0,721,49,4,115,113,2,4519,4499,20,40,40,0,100
738fcd2a1ea9f97f22bc1cc1c13c43fd357702a4,1,1,1,0,0,0,0,4,15,0,1,1,0,725,50,5,115,115,0,4520,4519,1,40,40,0,100
7d0e006992574973bbd732373af32462393f00b5,25,216,49,167,0,0,0,2,28,259,3,13,4.413426187,7496,78,0,1183,1149,34,44625,43886,739,347,334,13,100
fa6b75495404b0bcccfa3bb5a822c1d82387b151,3,3,3,0,0,0,0,1,2,66,1,1,1.584962501,217,79,1,13,13,0,1265,1265,0,13,13,0,100
ae01f0399cae6baab045b2ece0d71096aebe8ca3,16,1122,26,1096,7,0,7,1,41,85,1,8,3.62362059,3555,51,6,621,552,69,25713,21436,4277,341,305,36,99.48649252
b22d56cb946bf43d47ed399c3262f2dd2e088670,2,9,5,4,0,0,0,1,2,2,1,1,0.940285959,157,52,5,13,13,0,893,840,53,12,12,0,100
2ff690f110627782c4142eed744d1b7239d4bec4,3,160,2,158,2,0,2,1,2,144,1,2,1.203876143,84,80,2,25,10,15,1016,503,513,15,3,12,92.76090432
a2e2f02132bfebabc5d33e27c23c893817a5c1cd,0,0,0,0,0,0,0,0,0,0,0,0,0,0,81,3,0,0,0,0,0,0,0,0,0,100
0959a87e638e1965ac4920181cbb249f38fb8abb,1,214,0,214,1,0,1,1,1,0,1,1,0,0,53,6,21,0,21,980,0,980,11,0,11,99.85912186
96968fdcadb1f87017c6e7853c4a63ba065c6611,20,888,217,671,7,0,7,1,40,195,1,6,3.656167467,2353,78,0,347,276,71,15661,13689,1972,233,177,56,95.42174109
af21be3b77c10a27e7598d358a6162550b5cb6de,44,1670,419,1251,9,0,9,1,2,4,1,6,4.821073187,1637,53,0,323,65,258,12517,6811,5706,226,44,182,97.25181082
7d4b725615916d26610afb2bc2ec71a774ed8cfb,9,268,0,268,2,0,2,1,41,212,1,6,2.066576149,3702,79,1,574,552,22,22317,21326,991,154,144,10,99.95819398
ed91e4e3f1e1741e18401836891fd3a6257a5247,0,0,0,0,0,0,0,0,0,0,0,0,0,0,80,1,0,0,0,0,0,0,0,0,0,100
c6c86aa6520cbad5ce1c19782a92dc97bd910c1e,1,2,1,1,0,0,0,4,4,512,1,1,0,211,261,0,37,37,0,1569,1567,2,16,16,0,100
e26b51e0dc416fe026734b7079441baeefc33247,5,324,257,67,2,0,2,1,8,178,1,1,1.586751071,353,262,1,48,65,17,2383,3261,878,35,43,8,97.48132337
a95066cd06bdf4ed238e0bef304f28856817d9c9,69,1424,485,939,6,0,6,3,42,202,3,29,5.263998137,12019,263,2,1664,1664,0,80916,85362,4446,875,892,17,96.1214539
e421d27a1361f140d41f33de2b747526b5efecd5,0,0,0,0,0,0,0,0,0,0,0,0,0,0,264,3,0,0,0,0,0,0,0,0,0,100
2c89b9702a5a4ba9747153d5d39bd7cd6ed79b1f,1,16,12,4,0,0,0,2,6,213,1,1,0,240,81,1,43,42,1,1691,1681,10,19,19,0,100
d644af86642b5efbf889731139a880d68eedd153,1,2,1,1,0,0,0,2,2,4,1,1,0,98,82,2,11,11,0,581,575,6,7,7,0,100
4b8fae2593e3d9b7d46542d886046444aa97a092,6,147,8,139,1,0,1,3,18,253,2,5,1.36957903,726,83,3,90,83,7,5699,5224,475,53,46,7,99.9549955
768b7917f260bc3528f30c541e8974a841fe3fbc,10,97,58,39,0,0,0,2,8,259,1,6,2.970244364,603,84,4,57,54,3,3543,3478,65,51,46,5,100
b3eada3c06deb0ca7137cad6ba8285be9d9df52c,3,36,7,29,0,0,0,6,43,187,1,3,1.221192235,871,54,0,61,53,8,5049,4858,191,22,21,1,100
fad298ebb5a35c7466aac69af57f60775ff6a87f,4,43,11,32,0,0,0,2,2,108,1,1,1.974937501,276,85,4,48,48,0,1684,1440,244,36,36,0,100
e28bfd3236b83b584d333c115cb964f48898b27e,0,0,0,0,0,0,0,0,0,0,0,0,0,0,265,2,0,0,0,0,0,0,0,0,0,100
909d4c3cc09bcc83c199000f632c798b39b24bf7,5,115,66,49,0,0,0,3,18,308,1,5,1.436572464,913,86,1,140,140,0,6374,6307,67,69,69,0,100
f2b28e14b6a8b70c25e86e9823e7ed3f64aaf459,6,139,21,118,2,0,2,1,44,53,1,2,2.339475975,1672,87,1,258,250,8,9982,9720,262,215,211,4,99.88771615
b8de740e20a2dc24db4a9acf5b3ae5affd28d8e9,1,3,3,0,0,0,0,5,19,14,1,1,0,454,88,2,81,81,0,3224,3224,0,34,34,0,100
3a20c5597c4f7ca67421eb39fd426cc8b0cbef2d,5,562,461,101,0,0,0,1,4,488,1,3,0.966007727,1292,33,0,193,182,11,8578,8316,262,75,67,8,100
e5a21c4bb27055cad85f1d9dd494867c0fae8c22,7,56,31,25,0,0,0,2,45,77,1,6,2.445825045,5684,55,0,899,897,2,33818,33766,52,307,305,2,100
4a8b5c3f1bb93dccab309225164c249d1f9770f2,0,0,0,0,0,0,0,0,0,0,0,0,0,0,56,1,0,0,0,0,0,0,0,0,0,100
0be911bc430d736befce5b3a272be485e835460c,0,0,0,0,0,0,0,0,0,0,0,0,0,0,57,2,0,0,0,0,0,0,0,0,0,100
4dd605a3afec0f3c97c730a1721ba933a0b44eca,0,0,0,0,0,0,0,0,0,0,0,0,0,0,58,3,0,0,0,0,0,0,0,0,0,100
f13c148df439a4e3db681c0e46b803834d80b86f,0,0,0,0,0,0,0,0,0,0,0,0,0,0,0,0,0,0,0,0,0,0,0,0,0,100
5251864a2c26d8797b5833d247deda82dae672c7,0,0,0,0,0,0,0,0,0,0,0,0,0,0,1,1,0,0,0,0,0,0,0,0,0,100
371f554f94fc5398ef7d63fc710bd99a4ce62596,0,0,0,0,0,0,0,0,0,0,0,0,0,0,2,2,0,0,0,0,0,0,0,0,0,100
3e88476ce725aaca544b09be151fa1008a960a5b,0,0,0,0,0,0,0,0,0,0,0,0,0,0,59,4,0,0,0,0,0,0,0,0,0,100
52a6d3e6aa04c977310f0dc46bb18901812e272a,1,8,0,8,0,0,0,3,6,283,1,1,0,701,60,5,115,114,1,4040,4005,35,21,21,0,100
357c186584ddce07853db125c5de09ccc144e5d3,0,0,0,0,0,0,0,0,0,0,0,0,0,0,61,6,0,0,0,0,0,0,0,0,0,100
adc87aee5f5399b75005101f746a236be2750bb0,0,0,0,0,0,0,0,0,0,0,0,0,0,0,62,7,0,0,0,0,0,0,0,0,0,100
9ded6c372b3bcbceb28f6186efea7140c1f62dcd,19,2518,0,2518,19,0,19,1,1,0,1,5,3.782390199,0,63,8,177,0,177,8344,0,8344,127,0,127,89.33671119
e987492ee3c84e5b7d69af2ecbec2b07f6c4b6ae,5,1070,0,1070,5,0,5,1,1,0,1,3,2.085330511,0,64,9,79,0,79,3590,0,3590,59,0,59,99.67027791
b151d7a97f8f06451a915668e01f393ad0445b36,5,883,0,883,5,0,5,1,1,0,1,3,2.09232593,0,65,10,66,0,66,2967,0,2967,52,0,52,99.11778732
f7c302587c1191d3c68508ea6395d55e22ea1175,0,0,0,0,0,0,0,0,0,0,0,0,0,0,66,11,0,0,0,0,0,0,0,0,0,100
82dad0a175b986ae9236c07ac14aa12824c6a7c1,0,0,0,0,0,0,0,0,0,0,0,0,0,0,67,12,0,0,0,0,0,0,0,0,0,100
ba8ea976bec6fcfee1630acd2cb238a688e33b71,1,12,0,12,0,0,0,6,19,132,1,1,0,413,68,11,76,74,2,2824,2736,88,12,12,0,100
ac93c3b6c5bce5f22b293b29df91663ca7d7ce63,1,3,4,1,0,0,0,7,32,48,1,1,0,1299,266,0,187,188,1,7965,7975,10,42,42,0,100
37bc2c80564b45d7e4ce95db76f5411a6b8bdb3a,0,0,0,0,0,0,0,0,0,0,0,0,0,0,267,1,0,0,0,0,0,0,0,0,0,100
4ce0f6a0dcacde371625e1ea4e5b431a773f339a,0,0,0,0,0,0,0,0,0,0,0,0,0,0,268,0,0,0,0,0,0,0,0,0,0,100
cdb49fd5f76027a4a66930e6b266ba79266c9852,13,329,534,205,2,0,2,1,5,513,1,2,3.554488495,701,89,0,52,62,10,3032,3068,36,31,46,15,92.77913974
20f8df00e71a0061de820f0973f7fa7b62086afb,2,37,2,35,0,0,0,7,29,352,1,2,0.391243564,1699,90,1,282,280,2,10015,9907,108,64,62,2,100
ca442deeb5c63a8d7bcab796067b712de30e910c,1,1,1,0,0,0,0,7,33,141,1,1,0,1298,91,2,187,187,0,7965,7965,0,42,42,0,100
28f4d1b09b712c02c2003a413a1118fd218030cf,4,190,4,186,1,0,1,1,46,162,1,3,1.016625278,1226,92,3,155,147,8,7588,6680,908,128,122,6,95.92592593
6b54593af9156e346c40e6fafeb7668a7ac4ae6e,5,77,4,73,1,0,1,1,9,245,1,3,1.327219432,622,93,4,88,84,4,3809,3621,188,52,50,2,99.88476608
21548aa8d8a5ed1c3414dd1743432fe207d80df4,2,96,6,90,1,0,1,1,3,472,1,2,0.522559375,234,94,5,51,43,8,1868,1522,346,29,26,3,99.95404412
0deccf5a21953670c478b866ee1d74784fcae277,0,0,0,0,0,0,0,0,0,0,0,0,0,0,95,6,0,0,0,0,0,0,0,0,0,100
26d31606bda1000638b7fec59e1914aa83e1c71a,5,21,14,7,0,0,0,3,47,299,1,4,2.101454349,2040,69,0,279,279,0,11828,11791,37,170,170,0,99.97703261
55e22de8114dbbae83ffc2ec713de798d2a05349,13,0,1441,1441,0,0,0,1,3,528,1,5,3.232449249,1016,70,1,0,87,87,0,5376,5376,0,44,44,99.28389928
5d1bc2de1bc10eac795994772d17154b8c6b4e0a,23,3548,0,3548,23,0,23,1,1,0,1,6,3.957462851,0,71,2,288,0,288,14494,0,14494,142,0,142,98.59931114
88a86ea70338b93f52811c8ccdf732bd55d9a8e4,0,0,0,0,0,0,0,0,0,0,0,0,0,0,72,3,0,0,0,0,0,0,0,0,0,100
e6c4c4170aa675819dc17761470806eaec08bb33,1,1,1,0,0,0,0,2,5,495,1,1,0,129,269,0,14,14,0,748,748,0,6,6,0,100
d1a061e1a5382a12d03407d6bb1c19801fcc7fb1,5,189,15,174,2,0,2,1,48,50,1,3,2.015104917,1787,270,1,255,244,11,10263,9768,495,149,141,8,94.33564961
7cc54575d867e37a43020df309a78cd65c3fbdc0,16,886,64,822,5,0,5,1,49,155,1,7,2.884353182,6061,96,2,1004,925,79,38702,35782,2920,364,317,47,99.70588235
13d84663bc4eedb2e9e4035af75622b0a3cb480e,2,22,5,17,0,0,0,1,28,4,1,2,0.503258335,677,97,1,119,118,1,4075,4051,24,38,37,1,100
585511f7c0d1cdb0d515a979dcc00641df2a026f,1,3,9,6,0,0,0,2,4,255,1,1,0,364,34,0,52,53,1,2396,2430,34,19,19,0,100
419445017610d1c65db1bfafa0cd09e094b7156f,4,21,5,16,0,0,0,7,35,425,1,4,1.950063756,2116,73,4,315,314,1,13053,12988,65,85,85,0,100
763621a45cd7812ee968f78961775f85f5e95cb2,1,51,48,3,0,0,0,1,2,17,1,1,0,117,98,2,14,12,2,652,640,12,3,3,0,100
9325fa9869c2604172576f89311308915ebb416d,1,3,3,0,0,0,0,2,5,777,1,1,0,110,99,3,14,14,0,625,625,0,7,7,0,100
4d520645ff53b9a354fef57074c7661f3bc46e39,4,44,14,30,0,0,0,3,31,502,1,3,1.932993142,1883,100,4,300,299,1,11152,11049,103,62,61,1,98.43266653
af1c05d8cfb1205fde974845d05805871ec31aa7,0,0,0,0,0,0,0,0,0,0,0,0,0,0,271,2,0,0,0,0,0,0,0,0,0,100
8046f5f5787ce41ca4ade0d297b47afeb6a7e51d,1,8,6,2,0,0,0,5,20,282,1,1,0,454,272,3,81,81,0,3224,3224,0,34,34,0,100
5542c8a4f819cc6cb79ffd14fbcaa4722e25fa55,3,98,146,48,0,0,0,5,20,547,2,3,1.034195716,497,273,4,34,38,4,3295,3482,187,13,13,0,99.5215311
a615507c55325f79985706d23be9571302952982,0,0,0,0,0,0,0,0,0,0,0,0,0,0,3,0,0,0,0,0,0,0,0,0,0,100
c9a368144b2e6eaf2e7af0b5247baae047faedb0,0,0,0,0,0,0,0,0,0,0,0,0,0,0,4,1,0,0,0,0,0,0,0,0,0,100
a3a6e9a8fff39ea32e2ceeda8bd2b85d9df660ad,3,170,8,162,1,0,1,3,4,490,1,2,1.001702284,209,1,0,21,12,9,2290,1497,793,16,9,7,99.91319444
1cd1f347f0e3d126f6568f0a246c0dce1de20122,2,68,14,54,0,0,0,5,12,376,1,2,0.978869851,450,101,4,43,39,4,3860,3411,449,27,23,4,100
c5f2d61e8c14cbf8a96521eceeec41f953e64e14,6,90,0,90,1,0,1,2,3,624,1,4,2.321928095,386,0,0,22,22,0,2937,2937,0,16,16,0,99.95659722
62f9fd3fd3c13c8387e7448c4f3ea6b8f65b8a8c,23,969,786,183,4,0,4,2,50,686,1,4,3.850266382,3826,102,4,530,521,9,21964,21818,146,277,266,11,96.11780455
dbb021be4e82dd4433ac17c8f6eecdf8b8b82919,1,2,2,0,0,0,0,3,7,641,1,1,0,75,103,5,12,12,0,336,334,2,11,11,0,100
94033dbbd6f20e03b64b63095a52939a654e52ac,1,2,2,0,0,0,0,6,51,0,1,1,0,604,104,6,0,0,0,3081,3081,0,0,0,0,100
9a232d185eb97a523359e2e2e73a869a4af15a85,4,129,43,86,0,0,0,3,34,365,1,3,1.618494004,979,105,7,197,183,14,6802,6468,334,139,133,6,100
e004359a1702cd01d7e40edba789d9fbfe65ac53,1,2,4,2,0,0,0,2,2,981,1,1,0,43,274,3,4,5,1,148,158,10,2,2,0,100
c1d50bca96043c8a3e1ed1acfec98f92d03f6864,5,33,64,31,0,0,0,4,52,39,1,4,1.516386801,2836,74,0,413,419,6,16247,16399,152,198,200,2,100
4d9ed36cff191b223926cda95d60a308aa727d92,1,3,1,2,0,0,0,2,3,316,1,1,0,173,75,1,30,30,0,1283,1267,16,9,9,0,100
3032f4061be0d8b97f0ddaafd67fb694b2266b41,0,0,0,0,0,0,0,0,0,0,0,0,0,0,76,2,0,0,0,0,0,0,0,0,0,100
096accfd0666f1b669ad960b161bb131030bbbfe,0,0,0,0,0,0,0,0,0,0,0,0,0,0,275,1,0,0,0,0,0,0,0,0,0,100
beca35e450c6103bf1020bdc1a13ee7b87624b5d,3,61,9,52,0,0,0,4,53,18,1,2,1.287054028,1846,276,2,257,253,4,10309,10137,172,147,144,3,100
dc2cd63d0e570064f41326bcc09b3d074fe3a01f,4,63,0,63,0,0,0,1,36,80,1,2,1.193856127,1688,106,4,256,250,6,10256,9972,284,88,84,4,99.12627761
6140c873a6b4938550a99f58b12bde4de8a6678e,1,2,3,1,0,0,0,1,3,69,1,1,0,120,107,5,14,14,0,639,652,13,3,3,0,100
4968416aa0b1d1b32053c36e8a0bd649f7180b49,1,4,0,4,0,0,0,1,4,0,1,1,0,119,108,6,14,14,0,639,639,0,3,3,0,100
17fac729227197a3577d2a1c179c6cc5368165d3,5,17,13,4,0,0,0,2,5,784,1,2,2.149255397,401,2,0,36,36,0,2195,2175,20,24,24,0,99.87273306
6d603ec7ddbb78cfa1b0bf14e3efa22a0676f5c8,2,12,5,7,0,0,0,1,37,28,1,1,0.322756959,1381,109,3,197,197,0,8426,8392,34,44,44,0,100
4d227c289ad98c3ff58e49812b47bdea92976c39,1,8,0,8,0,0,0,3,6,204,1,1,0,171,110,1,18,17,1,1103,1034,69,6,6,0,100
dcbb4805887fa5dc2e3fb21c8a6769aa4172c986,1,11,3,8,0,0,0,5,10,105,1,1,0,664,77,0,102,99,3,4337,4295,42,14,14,0,100
01d11687dd2e89f97e0b5c557bbfd0cefb6ed625,2,4,5,1,0,0,0,3,7,104,1,1,0.764204507,236,78,1,28,29,1,1233,1245,12,11,11,0,100
120091511f4729441541cd764414fb52a34889b2,1,6,1,5,0,0,0,2,7,1075,1,1,0,152,79,0,24,23,1,852,823,29,11,11,0,100
614df7f9f064e8523b0732ae6ee951f0c9a4be1d,0,0,0,0,0,0,0,0,0,0,0,0,0,0,80,0,0,0,0,0,0,0,0,0,0,100
bd4127b76ac058b34318d848cf00f5b8bef34a6c,14,1249,695,554,0,0,0,5,54,461,1,10,1.20576138,4842,81,1,604,583,21,33073,31025,2048,219,206,13,100
f732f300fa63959b5dcbc803ec157f8d6a1c22d1,0,0,0,0,0,0,0,0,0,0,0,0,0,0,82,2,0,0,0,0,0,0,0,0,0,100
dd47ce6abdf01adc3584d6e7e0d41c6749d02d30,13,306,129,177,1,0,1,2,55,529,1,7,3.40452846,2528,111,0,261,247,14,16227,15714,513,131,115,16,96.64500263
2ce3efbb7e872f11c49f92a8830ff2ad2df5a22b,2,116,37,79,0,0,0,2,4,1034,1,1,0.99626817,108,0,0,23,13,10,734,498,236,9,7,2,100
61cd43b19f55bf15dfb07f8cb5c785a357660a0e,13,124,13,111,1,0,1,1,16,844,1,3,3.452334222,1631,1,1,240,224,16,10233,9819,414,137,128,9,99.96075353
400b7706ab28f138923e6db5b31fda28f1458917,3,44,3,41,0,0,0,2,56,692,1,2,1.158759672,750,2,2,24,20,4,3880,3775,105,15,13,2,100
2a7ea8b8389c103b03df961f8d6a9b5571caa991,1,33,17,16,0,0,0,5,15,650,1,1,0,372,3,3,38,37,1,2536,2509,27,18,17,1,100
f0b6cddd3e255e9e31e3afe22d0f69b3c046d554,0,0,0,0,0,0,0,0,0,0,0,0,0,0,112,1,0,0,0,0,0,0,0,0,0,100
9cedc7d76f2bbe52b3d1cc4caf8024e730266f83,11,849,202,647,7,0,7,1,57,47,1,4,2.867667072,1400,4,0,177,145,32,11169,8429,2740,124,100,24,98.38804797
e92f2942f00a442283fa0bfabd443dc78e93adc8,0,0,0,0,0,0,0,0,0,0,0,0,0,0,5,1,0,0,0,0,0,0,0,0,0,100
535a333b7776f7a229b76c7656e928d8a21d21bc,66,1803,1045,758,18,0,18,5,58,380,1,13,5.142620465,6773,6,2,884,869,15,41250,39606,1644,599,584,15,96.80187207
4a133f5766c09362917e0416af503c0a00b24e87,51,3237,124,3113,30,0,30,1,59,201,2,15,5.270410061,6816,7,3,1227,1009,218,51996,41340,10656,490,365,125,88.34737264
28dac9e5a790199dffe944bad2d518435474b396,10,75,67,8,0,0,0,3,8,668,1,3,3.086015862,1003,8,4,162,162,0,5486,5469,17,104,104,0,100
0c345c6a7754c4db9928ad6c5775495d68261536,1,5,2,3,0,0,0,3,3,1152,1,1,0,58,9,5,8,8,0,251,238,13,8,8,0,100
e4b8db5d8b34b33d7551d912e53fe198bb95d7e0,5,1,124,123,0,0,0,3,17,909,1,2,1.796027355,579,10,6,64,70,6,3288,3650,362,43,49,6,99.95824635
a00c4ecbb2e3e6d0bb200e8109962c5424be570a,2,2,2,0,0,0,0,2,53,803,1,2,1,607,11,7,154,154,0,3289,3281,8,138,138,0,100
2e8c2c694c98c4ac7c371a7b9dc0b28abba79ffd,0,0,0,0,0,0,0,0,0,0,0,0,0,0,5,0,0,0,0,0,0,0,0,0,0,100
372c35ebccedf64266a38a35e365d3810642fef2,5,153,0,153,1,0,1,8,60,4,1,4,1.130876755,4207,12,8,628,613,15,25012,24506,506,229,220,9,99.95824635
ffdddff32e7ac6e2cbb5ae8471c1192c69ac6a94,1,6,5,1,0,0,0,8,41,0,1,1,0,1426,13,9,206,206,0,8755,8757,2,45,45,0,100
58576c81fed9f4eccb03366151c1cf280765d237,9,42,16,26,0,0,0,2,9,496,1,4,2.298483564,874,14,8,133,127,6,4308,4265,43,94,91,3,100
64428a9d0f8bca0edb1ccf34d281e89747b295f7,4,14,19,5,0,0,0,1,3,28,1,2,1.954272805,474,15,9,50,50,0,3037,3106,69,25,25,0,100
b218d72cedc52467e691c6002e596e482d8583e4,1,1,1,0,0,0,0,1,4,0,1,1,0,168,16,10,17,17,0,1123,1123,0,4,4,0,100
9e1a5a05368a1543aaf6bea0176b9d79058e03b9,6,200,4,196,1,0,1,3,34,180,1,5,1.872473902,2458,113,0,420,405,15,15157,14495,662,118,105,13,99.81222616
441ec8bef03644c9d629f871993c14ff5442409a,1,1,1,0,0,0,0,8,42,41,1,1,0,1426,114,1,206,206,0,8755,8755,0,45,45,0,100
666d5fdd966c5111316519a862336144223652ba,1,4,1,3,0,0,0,7,55,81,1,1,0,519,17,0,137,137,0,2927,2887,40,126,126,0,100
4223ccc08bcd3689bddb310dddedab0485f7a6bd,4,99,1,98,0,0,0,7,61,229,1,2,1.633348256,2205,18,1,272,255,17,14078,13635,443,123,120,3,100
7f9218aeb6410929ddada81b4fabb17bf8636a4c,1,52,11,41,0,0,0,7,21,449,1,1,0,208,19,2,26,20,6,1605,1443,162,9,8,1,100
61cb37ecd50b0d9400873624e46692c3282e4cfc,20,252,93,159,2,0,2,4,43,578,1,8,3.928906039,6177,20,3,862,856,6,38262,37890,372,225,221,4,99.87497395
f31e9a328d3b4f10906a10a8e69d2ae515e3aba0,41,1768,565,1203,13,0,13,5,62,92,1,11,4.491392152,4653,21,4,639,537,102,31658,27659,3999,399,340,59,94.80576168
25d912cd910712a7c1e7da98db657f6dce877e7e,1,12,0,12,0,0,0,2,3,1163,1,1,0,51,22,5,9,7,2,305,273,32,8,7,1,100
0a90177161d65ff2802d3926599561adc985dc65,9,253,12,241,2,0,2,4,63,250,1,4,2.18974106,3157,115,0,533,517,16,20937,20010,927,348,337,11,99.54275263
02d9e6c2533a3cd108f5e6feaf40f26e95deb64c,20,904,404,500,1,0,1,1,64,607,2,11,2.659386059,6020,116,1,850,821,29,36718,34751,1967,271,246,25,93.97098821
969a488183a42dedbde8dcec7ac00595a836974c,10,506,6,500,4,0,4,2,65,5,2,8,2.239237746,3244,23,6,425,375,50,21262,19470,1792,152,118,34,99.55116697
930352220d5b201007e886ad8f92f9796d828a6a,0,0,0,0,0,0,0,0,0,0,0,0,0,0,277,0,0,0,0,0,0,0,0,0,0,100
ce97134d253c4e9fca48b7cede2048e60f36ff79,23,687,208,479,5,0,5,1,18,864,1,9,4.025887483,1968,117,0,291,258,33,12614,10772,1842,180,153,27,88.21541711
6d4af60e729a6b2153c220046cf6a3804427f1c1,1,1,1,0,0,0,0,2,2,41,1,1,0,169,118,1,26,26,0,978,973,5,15,15,0,100
24309fea666a7c82b79e17395523ad1b8ee87528,1,3,3,0,0,0,0,4,6,1224,1,1,0,167,119,2,8,8,0,1155,1139,16,5,5,0,99.93995196
d455270e2a8d5ec34d63d20ccb0f99d3629efa5e,1,2,1,1,0,0,0,3,7,9,1,1,0,273,120,3,40,40,0,1737,1735,2,16,16,0,100
fc267734887dddd7c379144d6d5499fe3d541db8,6,90,26,64,0,0,0,2,35,792,1,3,2.274062282,904,24,0,159,147,12,5011,4857,154,77,67,10,100
d8b443979d49517b40856009647231c1dfd17b4c,0,0,0,0,0,0,0,0,0,0,0,0,0,0,278,0,0,0,0,0,0,0,0,0,0,100
b914fec7e2bc669c20531ae7c2fbf340f8de9a8e,6,60,23,37,1,0,1,3,40,649,1,4,1.988076077,929,121,4,178,178,0,6115,6076,39,136,136,0,99.94
181ce39561c10aca2f4064047309d4a2ed66638f,0,0,0,0,0,0,0,0,0,0,0,0,0,0,6,0,0,0,0,0,0,0,0,0,0,100
bc9f823e23d110d3c54d6eb0f5ccf7eff155a6b7,1,1,4,3,0,0,0,7,58,81,1,1,0,524,25,1,137,137,0,2906,2946,40,126,126,0,100
5adca63deca25d84f4fdea053c35a85efc8bbb3d,22,786,175,611,3,0,3,2,66,495,2,10,3.698385023,6748,122,2,1006,944,62,41856,39540,2316,309,285,24,90.01140251
de0efb07518082439b9a5cccd503270b09f40e84,6,745,0,745,6,0,6,1,1,0,1,2,2.387876484,0,123,1,68,0,68,2776,0,2776,34,0,34,99.44311854
4485e563a6582afb1c848ea80888fdad50ada516,22,734,285,449,4,0,4,3,67,358,3,11,3.187370845,8408,124,2,1295,1243,52,52081,50985,1096,434,395,39,99.19396776
f6845a374e39b91cb8d9292125a52048d71530a3,2,8,3,5,0,0,0,6,21,84,1,2,0.945660305,608,125,2,104,105,1,3803,3839,36,23,24,1,100
185205703ee4cd886598f5393395f19fc367f65f,24,2947,7,2940,23,0,23,1,11,7,1,5,3.929276592,143,26,0,315,22,293,12028,921,11107,231,6,225,92.52224092
414ef89ebd00594ab93e410d09ce007eaad3b202,5,15,14,1,0,0,0,2,2,1070,1,1,2.318369254,166,126,0,12,12,0,489,478,11,10,10,0,100
da3c7b2d648fa270b997e514933dfc081ae7810b,8,48,48,0,0,0,0,3,6,196,2,3,2.289116053,536,127,1,53,53,0,2808,2789,19,37,37,0,100
61db689128679b886753fed0b8f310b0ece9e0cf,3,55,0,55,0,0,0,1,68,103,1,2,0.973150619,1005,128,2,60,53,7,5496,5287,209,22,20,2,100
f43f450093876ba8ae164681789cad0e6ea4b68e,58,1950,1511,439,9,0,9,5,48,388,2,17,5.106261824,8546,0,0,1183,1127,56,52045,49911,2134,449,416,33,89.46442533
46d7d901e35e83e4b95f95edda3217d08fb5b690,0,0,0,0,0,0,0,0,0,0,0,0,0,0,0,0,0,0,0,0,0,0,0,0,0,100
0bcc76de532636985a020ed4f41129041bffa850,2,39,6,33,0,0,0,3,4,1524,1,1,0.99964375,326,0,0,52,52,0,1899,1836,63,17,17,0,100
7c61dcf4abaa422637a68839bf0d547a164375a3,20,2593,649,1944,0,0,0,2,2,1000,1,4,2.445738769,2316,7,0,503,313,190,20699,13395,7304,389,231,158,100
d32c429a1d475b322b3fe44738f0cc8f30a97b48,21,303,336,33,0,0,0,2,40,48,1,9,3.600013129,3763,1,1,562,557,5,21309,21453,144,210,211,1,91.87080385
54a1a8dedbd4af64ca8079da69878f89a69d9e5b,9,283,142,141,0,0,0,2,49,110,1,6,2.599146722,4835,0,0,800,782,18,29433,28910,523,208,201,7,100
d49edb82f13f1e9c295f21d966bcb246d0bae3bd,0,0,0,0,0,0,0,0,0,0,0,0,0,0,8,1,0,0,0,0,0,0,0,0,0,100
d3cdd11384f51253713de47330bef3267b57cabb,0,0,0,0,0,0,0,0,0,0,0,0,0,0,9,2,0,0,0,0,0,0,0,0,0,100
4bb1d3e17220b903b102d64a62fdb04f2bffa88a,1,3,3,0,0,0,0,5,14,21,1,1,0,175,279,0,29,29,0,936,936,0,12,12,0,100
62b714547ea082099f673ed2e53a7aa7d47c8b5c,5,23,11,12,0,0,0,7,17,1092,1,2,2.192038936,670,2,1,99,99,0,3647,3594,53,48,48,0,100
39237cf7fbf0742a8d7200db4039e5b43a58eca8,3,17,5,12,0,0,0,10,42,542,1,2,1.288649765,2026,3,2,334,333,1,12390,12315,75,84,83,1,100
acd716fd2ff9e04c47a531fc194003fc2d5a9dc1,1,3,1,2,0,0,0,2,4,21,1,1,0,196,1,0,29,29,0,1229,1214,15,19,19,0,100
a45450cc5bdac12432651611effb975fa4c5481c,1,5,1,4,0,0,0,6,22,456,1,1,0,500,129,0,88,88,0,3571,3564,7,37,37,0,100
2aa3af8d940a793cd2339e158e5bbac4fe9637d1,0,0,0,0,0,0,0,0,0,0,0,0,0,0,10,0,0,0,0,0,0,0,0,0,0,100
0afeb63605cfcf3afacbf3fd43f63e69bf996b70,1,57,1,56,0,0,0,9,39,158,1,1,0,671,130,0,123,120,3,4179,4057,122,43,41,2,100
bad44d4723e42dd74e0052378d32faa463842d2e,2,4,6,2,0,0,0,9,40,219,1,1,0.970950594,764,131,1,129,129,0,4500,4500,0,47,47,0,100
fda1bb3820ac574ed5d59cb779171e313798336d,28,854,42,812,6,0,6,1,18,364,1,9,4.00533009,2793,4,0,526,446,80,18265,15677,2588,343,280,63,91.32082623
8675c84a8eb3693efa4aa319860a2714556de02e,94,11972,4,11968,92,0,92,1,14,0,2,18,5.883241891,194,2,0,1070,32,1038,41524,973,40551,532,30,502,82.90203327
7f2d58445e2353a1a42fbb4282ed5cad724186b5,3,35,16,19,0,0,0,10,50,169,1,3,1.46955943,4007,3,1,671,669,2,24368,24369,1,152,150,2,100
480475a51776bfb20d9515978b7803ca14b0dd05,1,4,0,4,0,0,0,2,5,548,1,1,0,168,4,2,18,17,1,1153,1123,30,4,4,0,100
5def2380c35c4b42faf4fe30b7b81910a963d919,5,71,8,63,0,0,0,1,44,694,1,4,2.079781454,2277,132,0,398,392,6,13119,12895,224,132,128,4,100
78931c03f36e2371bb1870d485be73e6bc2146a6,2,58,10,48,0,0,0,4,11,675,1,2,0.969204095,259,133,1,29,22,7,2072,1844,228,21,18,3,99.92676675
dc4d9a2a7f5d2e40fc1e28c3b8da011306d7dccc,6,484,164,320,3,0,3,1,69,130,1,3,1.939183123,2133,5,0,266,244,22,12922,12052,870,77,65,12,99.83567647
705f93d15cbe6294229ad483667527eeef830a73,1,2,1,1,0,0,0,10,45,26,1,1,0,1682,134,2,284,284,0,9993,9989,4,52,52,0,100
c8db59b6a19e23f0665dae2d06c3d44da2895602,0,0,0,0,0,0,0,0,0,0,0,0,0,0,6,1,0,0,0,0,0,0,0,0,0,100
5a58a775403afb89fd24918ee4abd95046cfd7d5,1,18,16,2,0,0,0,2,3,255,1,1,0,85,7,2,12,11,1,449,433,16,6,6,0,100
8af7670c3afb4924b2603712c1532925ce8b89fa,12,172,30,142,2,0,2,10,70,125,1,5,2.899259142,5316,8,3,782,776,6,31019,30627,392,295,291,4,99.76342129
9d20d69fdb0be53a5410711489173f808fbe6f4e,1,3,3,0,0,0,0,1,2,428,1,1,0,83,135,1,13,13,0,365,365,0,5,5,0,100
43de1d8cddacf02e48cf6a7ac5a5888369e978cd,1,2,1,1,0,0,0,4,4,1557,1,1,0,86,136,2,14,13,1,498,494,4,5,5,0,100
bc2babcc63ba482f7f15ff4820abf51339081e5f,14,403,36,367,2,0,2,2,3,156,1,3,3.045242839,1099,5,0,227,176,51,6884,5498,1386,198,155,43,95.51676934
31026d4d2a4ecc6f0af13a545d0ee633900ff2e5,6,77,25,52,0,0,0,2,19,1102,1,4,1.507066491,1201,137,3,148,147,1,7741,7419,322,35,34,1,100
a6f2a4fc929d01073058578175981b0c1c616ba0,1,4,4,0,0,0,0,3,7,5,1,1,0,78,6,1,7,7,0,433,433,0,6,6,0,100
d11da67793bd4729bd7db63194b57684e82e89fe,4,26,0,26,0,0,0,2,4,202,1,2,1.933195991,339,7,2,56,52,4,1808,1738,70,52,48,4,100
931569d5816a520a9f67844eca296e24140bd259,15,43,43,0,0,0,0,1,11,146,1,6,3.704425219,1354,8,3,176,176,0,7547,7547,0,106,106,0,99.93531695
63b8c412fbe731c7fc0a9d7dceb92ae955b553ae,3,98,54,44,1,0,1,1,5,72,1,2,1.236987877,396,9,0,80,75,5,2008,1918,90,65,61,4,99.52944994
226fa4bb47a97ac825e05274cba77914f9c96252,2,16,2,14,0,0,0,2,47,1198,1,2,0.964078765,2015,10,1,341,338,3,11943,11853,90,68,68,0,100
0dab32741a8882c6450e2a3ae9f3b778659f4bcf,0,0,0,0,0,0,0,0,0,0,0,0,0,0,11,0,0,0,0,0,0,0,0,0,0,100
b9f41429619590e8e1c06d47c2a8268fa3bc07db,2,17,0,17,0,0,0,8,71,137,1,2,0.977417818,1423,138,0,111,110,1,8386,8314,72,16,16,0,100
8a952155df33e56802a6e601eef22c75c034430c,6,20,15,5,0,0,0,3,12,1186,2,4,2.525871146,1062,139,1,154,154,0,5944,5937,7,56,56,0,100
43909035cc6cf860958d2ea6527433025eda0f17,5,335,0,335,2,0,2,1,60,328,1,2,1.549460122,1517,0,0,392,370,22,10936,9703,1233,303,288,15,99.91864627
6ee97e77eb1f45699d2f34fc2e28c89b6fd6c1b3,1,29,3,26,0,0,0,2,5,2019,1,1,0,92,140,1,11,10,1,696,551,145,4,4,0,99.67186218
5d0b81ac42ab0de80bb68b87c7d1c1dd710f1108,60,1037,970,67,3,0,3,4,72,1050,3,24,5.016459833,12746,9,0,1811,1837,26,78518,78322,196,919,926,7,96.82642487
92a8f1ca1b472e539e4b9831679848cd108ab29a,6,109,50,59,0,0,0,2,5,332,1,3,1.881943661,768,10,1,111,107,4,4828,4586,242,90,86,4,98.62553451
f930318772845ea1f121ad3b3e593513239a3e4b,3,11,5,6,0,0,0,4,73,224,1,3,1.5,1132,141,0,55,55,0,6357,6312,45,22,22,0,100
7b4a5b7fabac83a32ff62fda2108f860f2caaac4,1,4,4,0,0,0,0,2,2,887,1,1,0,30,11,0,2,2,0,59,59,0,2,2,0,100
4b743f163616281d98af6684280e9caad7470358,2,9,9,0,0,0,0,1,21,1157,2,2,0.503258335,278,142,0,25,25,0,1825,1825,0,9,9,0,100
c8078a2f3348f53d2abd276977323aff74c34f1c,2,31,8,23,0,0,0,2,53,1329,1,1,0.988110837,1643,0,0,232,228,4,10168,10084,84,55,54,1,100
905acc96008fb912b4d03b0428dde9716171fb78,4,18,15,3,0,0,0,2,74,1081,1,4,1.755626695,928,12,0,21,21,0,4819,4815,4,14,14,0,100
27661ba3b79d76d962126ba10b402db861e3813d,16,79,67,12,0,0,0,11,54,980,1,10,3.691296787,5284,13,1,747,747,0,31613,31613,0,219,219,0,100
06a1084af99ee46a03ebbbee53e3224ca8862132,19,2172,36,2136,18,0,18,1,20,0,1,5,3.518816171,545,14,2,262,92,170,11126,3268,7858,159,37,122,99.38452521
819d6d38d6cb7073786f4b7ed11763fff5200ded,102,7950,0,7950,101,0,101,1,21,0,2,21,6.181570779,573,15,3,645,100,545,30437,3477,26960,401,39,362,92.45419131
ad27a2914d57a3ee174b34bc3a2a4de9f3aca215,85,0,8044,8044,0,0,0,2,23,1857,1,20,5.688918739,5487,143,0,0,530,530,0,31106,31106,0,355,355,90.79389313
79e7f1c98575a473d12022e198679614b1fe9029,8,1321,3,1318,6,0,6,1,11,24,2,3,2.202988065,213,16,3,177,30,147,7871,1221,6650,112,24,88,93.68140483
17355f55811be1b1392c3ca066fb9adf803846d3,4,290,47,243,1,0,1,1,2,2,1,4,1.719610405,480,17,4,58,48,10,4659,3247,1412,22,13,9,99.45758626
6dd7d1425e2f67e6262a096120521e166fa0bb29,1,11,1,10,0,0,0,1,2,878,1,1,0,131,144,1,18,18,0,693,591,102,8,8,0,100
b9d20edece212b3898fd61f0e6799c2ebbf99986,4,33,38,5,0,0,0,4,7,240,2,4,1.435437294,635,18,5,62,61,1,4697,4720,23,31,30,1,100
27f234f1f2f7e5f30dd6dfaffaa0109a98be49ac,15,1691,0,1691,15,0,15,1,1,0,2,5,3.408325369,0,19,6,166,0,166,6103,0,6103,122,0,122,94.20408163
a1a236fa6f8bd2c9e3ba479e8cc1aa94a7f1f402,17,1717,0,1717,17,0,17,1,1,0,1,6,3.397372561,0,20,7,70,0,70,7171,0,7171,58,0,58,93.80062305
572ca06300c04a3b8abee4da1fdaaef7056bb9b9,2,131,3,128,1,0,1,1,8,1,1,2,0.88846679,110,145,2,25,17,8,1577,821,756,19,14,5,99.97226844
ffed230ba8958ba3bc27310b71b0c6df589c3e63,2,17,6,11,0,0,0,1,2,34,1,2,0.558629373,165,21,7,20,17,3,991,974,17,11,10,1,100
add1d4f07c925b8a9044cb3aa5bb4abdeaf49fc7,3,78,9,69,1,0,1,2,2,30,1,3,1.49515948,416,146,3,50,47,3,3011,2684,327,31,28,3,99.97228381
77f8a075ccc029cb608a382f5deb7cc0b27b02e5,31,2842,0,2842,31,0,31,1,1,0,2,9,4.368663835,0,22,6,202,0,202,11611,0,11611,142,0,142,97.27805695
acd532373072b69d0d802c4456943aa35388bdca,14,1280,0,1280,13,0,13,1,2,0,1,4,3.209113818,45,23,7,110,6,104,5990,342,5648,70,2,68,98.1065729
f9dc6b59eeb9b80f1cea47f504b6c969e5c560a3,12,96,70,26,0,0,0,6,55,884,1,6,3.417464932,4545,1,0,649,644,5,29096,29227,131,248,243,5,97.67010855
d7e4bde11fdbfdef13e9316702c914e749a7757f,32,2308,56,2252,18,0,18,4,7,206,4,13,3.940627157,1555,24,3,367,198,169,21070,9802,11268,209,109,100,97.29767968
3b7c68e54a76d02ae721161b1b81c15c2e22e44a,33,3433,17,3416,30,0,30,1,4,3,3,14,4.600711121,689,25,4,272,52,220,23565,5038,18527,161,29,132,97.61595145
1a4756b66bbd219943dce80a95dd46f44f46cbeb,10,261,141,120,0,0,0,4,45,1208,2,7,2.717537562,2266,2,1,305,296,9,15209,14727,482,120,118,2,98.41696113
6cb6acb44a1cff4136125faf763e67525ea696b1,1,1,1,0,0,0,0,3,3,1205,1,1,0,91,3,1,18,18,0,419,417,2,13,13,0,100
1ca3222078064fe4bc1f92fc94a58cafa39f2643,1,6,0,6,0,0,0,8,22,30,1,1,0,228,4,2,35,35,0,1559,1525,34,17,17,0,100
03ade425dd5a65d3a713d5e7d85aa7605956fbd2,31,3489,1609,1880,9,0,9,1,75,420,2,15,3.074568903,6692,5,2,1033,842,191,50147,42564,7583,434,378,56,94.73614949
4f3551dfd2465c51f834d74d70dd2f7a527f60f6,0,0,0,0,0,0,0,0,0,0,0,0,0,0,11,0,0,0,0,0,0,0,0,0,0,100
6f5a457fa93ac8b53cc77afd0eb8729f1e5665af,34,1172,448,724,2,0,2,1,57,264,2,17,3.102286095,8108,6,1,1176,1115,61,55008,51892,3116,475,447,28,95.8611482
daa8f92f733c3e6f5bb80126a941a478fe3bdb6c,0,0,0,0,0,0,0,0,0,0,0,0,0,0,26,0,0,0,0,0,0,0,0,0,0,100
f183402ea3aa777fd7fe822eb794837a8e0b3478,5,127,25,102,1,0,1,1,6,401,1,3,1.24992154,370,0,0,68,58,10,2496,1955,541,57,54,3,99.95181303
4a188d8d13e44b397bb40ce1280279d0c9b1feb1,4,29,5,24,0,0,0,2,16,1432,1,1,1.841816815,417,12,0,65,64,1,2077,2031,46,28,27,1,99.89189189
47da751824e9a58cd51fe6b77acdfba566a8df79,7,627,111,516,5,0,5,1,2,84,2,3,2.562600176,321,0,0,72,21,51,6090,2767,3323,50,14,36,99.84438592
5b0cd0e0a2ddbf722b6140d28474295c8376e561,41,1163,1647,484,12,0,12,5,58,985,2,12,4.56000469,6657,147,0,828,921,93,36330,39247,2917,273,265,8,96.09559867
843d1863d3624eeda4f094beefdd1eaf6eb23daf,6,39,24,15,0,0,0,1,76,1443,1,3,1.442462615,1158,148,1,42,41,1,6151,6097,54,23,23,0,100
b735f02bde1ed684eb0d0db2ec125d26d103aced,16,92,20,72,0,0,0,3,77,816,1,8,3.620809814,6237,13,0,819,812,7,37648,37391,257,297,292,5,100
81d5badf7b76e9f1efde1cebe2150bee70e4cf58,7,64,22,42,0,0,0,1,6,1092,1,4,1.760342553,826,149,2,128,124,4,4473,4319,154,84,83,1,99.94141769
c32f465d442c52edb8aba4e7fb78c153639d8cd7,25,315,81,234,2,0,2,7,25,493,2,12,3.646732764,2561,27,0,360,340,20,15943,15182,761,262,245,17,93.85872738
3d51e770c28b404ac119acd7c108ba174251a929,1,3,1,2,0,0,0,2,2,482,1,1,0,21,14,0,0,0,0,30,21,9,0,0,0,100
937d5038c90f382f659a292ce6249718039ab682,0,0,0,0,0,0,0,0,0,0,0,0,0,0,15,1,0,0,0,0,0,0,0,0,0,100
0adfdfd4205d24be29ab65408643b50ffa1f81d1,1,3,3,0,0,0,0,3,3,1094,1,1,0,24,16,2,0,0,0,49,49,0,0,0,0,100
1e802da3a611eb2953c4ec3c650436278d76b9dc,2,61,0,61,1,0,1,1,2,330,1,2,0.46377735,56,17,0,8,5,3,638,276,362,6,3,3,99.95349378
ca36f1d499a70b1aee85ac637de53f153a9f4c92,27,546,713,167,3,0,3,4,78,1172,4,11,4.104357309,2939,28,0,229,237,8,17132,17145,13,138,149,11,92.26939203
24150590597c89aa7e322ed56f4c916b666b3b09,7,396,1,395,6,0,6,1,2,101,2,6,2.603919348,308,0,0,50,28,22,3798,2202,1596,30,11,19,94.72595657
3c07b123c22a2fecd875e76371afdaa5a1d5b9fe,1,5,2,3,0,0,0,2,5,450,1,1,0,181,18,0,30,30,0,975,956,19,10,10,0,100
0f8d3377e8319cce7b8feeaa3c70528e030fab37,0,0,0,0,0,0,0,0,0,0,0,0,0,0,12,0,0,0,0,0,0,0,0,0,0,100
c6af3ed8a52ddfc3c54c69dab18e36345ba5b92e,2,102,6,96,0,0,0,1,4,468,1,1,0.581321499,194,29,0,33,25,8,1734,1064,670,14,9,5,99.94192799
fafecee712bc9b2ce8ef081d8170cdf99c48288b,52,4098,3712,386,18,0,18,2,79,411,2,18,4.141367922,8699,19,0,1127,1114,13,55090,54824,266,506,436,70,93.15644483
4170eeb054ba1414eceb08ec6c0fbdbdb17eb5c2,1,29,17,12,0,0,0,2,2,830,1,1,0,333,1,0,45,44,1,1997,1955,42,29,28,1,95.60669456
5a04dc554ef53ddc39895a9211286b9fb2e65586,1,3,2,1,0,0,0,3,7,442,1,1,0,87,150,0,14,14,0,373,366,7,11,11,0,100
e4aa99d3f603e70c7db3a55ae5d59470c1a37f58,1,65,41,24,0,0,0,11,51,449,1,1,0,1560,0,0,265,260,5,9348,9248,100,51,51,0,100
a927450aa63fe8e21f7da22cc79de182cfcfd780,35,384,34,350,1,0,1,1,1,0,1,5,3.577541706,850,30,1,34,0,34,2576,275,2301,31,0,31,93.70118418
cc2fa8a4b8f4508dcc05044f97acac50dd49259b,2,437,84,353,1,0,1,1,2,716,1,2,0.962033266,95,2,1,57,17,40,2383,454,1929,29,7,22,99.62441315
16dba64c31c3eb18ac916d49f1529fe4810fe754,3,53,26,27,0,0,0,2,43,660,1,3,1.374321318,1087,3,1,230,225,5,6893,6816,77,153,151,2,99.23479662
97e26e65f0ca669926c9c8ddc05f19da76180ab5,8,668,89,579,1,0,1,8,23,1052,1,3,1.309029954,1496,7,0,249,183,66,11364,9314,2050,69,50,19,99.28410447
24bed1a9bdbe3a1edd46bc3b2af83ee385e041a9,3,171,4,167,1,0,1,1,61,188,1,2,0.565663601,2051,151,0,344,326,18,13141,12446,695,101,98,3,96.68550874
093e81995e94ee6dbfe6278f04d59a29cd54ac8b,5,83,0,83,1,0,1,1,80,131,1,2,2.134509365,2551,152,1,412,406,6,15241,15020,221,284,280,4,99.97483644
bac93fadea1a696e9017e273be594b4b0981f010,1,0,1,1,0,0,0,3,3,129,1,1,0,358,153,2,34,34,0,2570,2577,7,14,14,0,100
77ae12e00e6e0b4955949bc71e9b275bd6d70538,51,3682,1053,2629,29,0,29,1,7,404,2,12,4.691631708,3187,31,0,647,445,202,26671,19205,7466,483,341,142,91.93348908
c9ab310db6c63e9151e0cbd01b83f3b2378b4676,5,33,0,33,0,0,0,2,10,1238,1,2,2.227185425,466,154,2,62,59,3,2319,2199,120,30,27,3,99.71177184
b5b76c28408e7401dc61fc2047182d971bbc2537,6,115,52,63,1,0,1,3,81,113,1,3,1.857238462,1263,280,0,83,79,4,6608,6472,136,34,32,2,97.46474647
e5f851aacf84385da626810719e34d9767fd0c44,0,0,0,0,0,0,0,0,0,0,0,0,0,0,281,1,0,0,0,0,0,0,0,0,0,100
b5284cd9b0d66523f6aa0a57576beace90c86e55,2,35,0,35,0,0,0,10,82,37,1,2,0.822404226,849,8,0,19,15,4,4606,4473,133,7,6,1,100
b90b59d2b5064782c501dfca5a1497f1ef513a6a,29,922,676,246,6,0,6,5,62,453,1,9,2.982339886,5974,20,0,775,779,4,36418,35907,511,225,207,18,97.87794527
fd61fdad30c073f5b2576d1dc65452c5e4dac657,3,527,352,175,1,0,1,2,45,48,1,2,1.060268616,920,4,0,210,196,14,6315,5875,440,151,139,12,99.59816303
1c7552b1a3c2bbde15f98671c7b7c1424494c128,2,24,1,23,0,0,0,10,83,8,1,2,0.721928095,1484,155,1,123,120,3,8758,8665,93,20,20,0,100
0b1962253c8cd3e2194b1b0015c4352277c1ce0a,9,126,29,97,1,0,1,2,8,316,2,4,2.27441251,994,156,1,143,133,10,6082,5696,386,129,118,11,92.03924317
1c554424859377458fe3d808692122403001304f,10,387,6,381,3,0,3,1,5,433,1,5,1.791085178,704,1,0,107,75,32,6016,4310,1706,65,35,30,99.86218302
7cacb1830c3385098d308979ae45e3ea42b9b16c,3,224,0,224,3,0,3,1,1,0,1,2,1.352431713,0,157,2,8,0,8,1250,0,1250,8,0,8,92.11868958
608d50697c5e19a8249dd9290cd15b652f5f01a1,1,5,3,2,0,0,0,2,5,76,1,1,0,151,158,2,19,19,0,766,747,19,9,9,0,100
9b6d6f9f6f91c5d6a8a153635f7e5f3c52a1f4f2,4,235,182,53,1,0,1,3,84,52,1,2,1.164215898,1063,159,3,61,61,0,5622,5495,127,23,23,0,92.93222683
4321e4483867cfc55f7fafe0a291b71a6da66824,110,7993,0,7993,109,0,109,1,3,1,1,5,6.041656431,152,160,4,573,21,552,21523,824,20699,289,13,276,96.76870748
6256a761d61a5b27a05878da2449ce8537d60c99,53,3551,974,2577,8,0,8,2,85,428,2,18,4.547336265,11092,21,0,1800,1542,258,75790,66057,9733,735,642,93,95.0508661
c94dd9c74895d419f72974fcbe5456fbae84b7a9,38,246,1618,1372,0,0,0,3,86,908,1,16,3.747345015,6697,9,0,585,713,128,36478,42027,5549,332,395,63,93.90578103
fe87b23fbd86d8f978142dc326231ea6bd4a61f0,9,26,41,15,0,0,0,2,6,2739,1,2,1.044078283,972,22,0,158,157,1,5427,5431,4,94,95,1,99.77678571
5068b6f0082a020a6124cd7e652558efe3ec5f37,1,2,2,0,0,0,0,4,9,705,1,1,0,185,23,1,19,19,0,1138,1138,0,6,6,0,100
916763e747b0f2d3bf2dcda76100dbc0d5714a9c,12,321,659,338,1,0,1,1,87,1218,1,6,2.751182968,4298,24,2,587,630,43,22850,24818,1968,289,290,1,99.90080595
b5a63d8162d8756e4ae73b80ff125439a1b47613,2,37,9,28,0,0,0,1,5,2444,1,2,0.495969072,310,161,0,59,54,5,2102,1948,154,33,31,2,100
24664b9397a6dc153251ffd7a4d3c01515988748,1,2,1,1,0,0,0,4,6,0,1,1,0,245,162,1,47,47,0,1562,1560,2,28,28,0,100
d827c97fc244dd89ccee46e686eaf008889550ed,9,122,13,109,0,0,0,2,54,561,1,8,2.918776038,3277,10,0,590,579,11,19132,18694,438,252,244,8,100
2185f5946edfddcca8a5bcb76160212bfe2ef797,1,9,3,6,0,0,0,1,3,17,1,1,0,131,25,3,16,16,0,687,682,5,8,8,0,100
51f09376456ed8dadc2e801afaa495863fd7ee3b,1,40,6,34,0,0,0,9,21,95,1,1,0,793,163,2,126,124,2,5202,5091,111,23,21,2,100
cf6abc09a3b4077646c0ec03ec3d1046acecc57a,12,1221,0,1221,12,0,12,1,1,0,2,3,3.121845266,0,164,3,81,0,81,6052,0,6052,52,0,52,97.25921138
8eb1f763d0cb0f98de1f12e3d48d9c516f5ac7a8,1,8,11,3,0,0,0,6,14,26,1,1,0,538,26,3,87,87,0,2886,2917,31,20,20,0,100
3793c9ef69993bf4b180b6f6b15bb2a5edde5530,35,1015,495,520,3,0,3,2,88,115,2,12,3.884891836,8379,11,1,1316,1146,170,51425,43805,7620,673,594,79,92.26616594
77a24a9fcd3b01961f881143e485b4be0826c139,3,260,0,260,3,0,3,1,1,0,1,2,1.257700937,0,165,4,16,0,16,1364,0,1364,11,0,11,95.87235896
23184e15023157312d7a8afe0adfe30b5d7864a8,2,11,6,5,0,0,0,2,5,2,1,1,0.936667382,817,12,2,157,156,1,5390,5362,28,62,62,0,100
faf339206c5611651d4dfb38af0bf638caba6c74,7,211,4,207,1,0,1,1,3,642,2,4,0.429248821,631,166,5,67,62,5,4701,3942,759,39,36,3,98.01274436
819f293f4c780fc6833785da27e10f965570f44e,6,67,52,15,0,0,0,2,53,720,1,3,2.381886464,1355,167,6,218,223,5,7752,7730,22,86,85,1,100
28cbe037cf9299ed6a089cc78039d0a16d0116ce,12,384,159,225,3,0,3,11,64,494,1,7,3.362086298,4378,168,3,698,683,15,26720,26083,637,217,198,19,97.45255252
b51ecd27cccc520764c9ae53cabcb61d67d46d15,4,177,2,175,1,0,1,1,3,800,1,3,0.65638286,415,169,4,74,55,19,3049,2543,506,45,31,14,94.19831224
b0262f8c81c352c0cf3ac11e1e98646aa9587944,8,230,68,162,0,0,0,2,18,52,2,6,1.569029222,2113,13,1,350,327,23,14381,13783,598,139,133,6,100
72562004cfa5106472f61efc5d456788bbc256f9,2,133,19,114,0,0,0,1,3,4,1,2,0.926819064,275,170,3,63,51,12,1729,1400,329,47,38,9,99.81792717
8a2ec5ebd9afa8a299cfdd5d3cd359898346588a,1,8,6,2,0,0,0,3,5,803,1,1,0,99,171,4,10,10,0,705,669,36,3,3,0,95.20737327
07dfe0f23c3aabdb4dd47d2a7a26bbd75934da5f,1,1,0,1,0,0,0,3,3,278,1,1,0,55,27,0,4,4,0,325,320,5,3,3,0,100
b7c533baf4ce8f0fd3d3e7d521cc355e71bca797,2,19,1,18,0,0,0,7,89,54,1,2,0.970950594,1245,28,1,89,87,2,6708,6621,87,20,20,0,100
daf6bd54af7149e06961607f36e3034aec1e70ef,1,1,3,2,0,0,0,2,6,18,1,1,0,94,29,2,6,6,0,567,591,24,5,5,0,100
160a0d35f64a52b9e31a725adc2672498d1f3f29,1,14,4,10,0,0,0,9,22,83,1,1,0,813,172,4,126,126,0,5272,5202,70,23,23,0,100
d3c8c564ceef470411821b5a6c82db17782ea3b2,3,6,9,3,0,0,0,1,17,67,1,1,1.338268928,697,30,3,104,105,1,3662,3673,11,28,28,0,100
a85c41e3068bb517e4a8ddd68a7fced6452e8f84,0,0,0,0,0,0,0,0,0,0,0,0,0,0,14,0,0,0,0,0,0,0,0,0,0,100
0a8225712e4b4a4471c5efb1ca11e97e2ddbd71e,3,77,6,71,1,0,1,1,4,811,1,2,1.300673543,339,173,0,72,68,4,2091,1716,375,50,49,1,99.95037221
9d7bb4b52a78301ea6256ae20279a8db63523e99,1,1,1,0,0,0,0,1,2,134,1,1,0,108,174,1,5,5,0,730,730,0,3,3,0,100
693a71c85a9e899b8f4054778e886fdcdd4470de,9,76,9,67,1,0,1,3,65,947,1,5,2.126196976,4533,175,2,765,763,2,27814,27635,179,271,270,1,99.95040298
a15675cae4c91d0fe0496a879de4242ffbc5f9ce,8,115,106,9,0,0,0,2,23,425,1,5,2.628774498,1525,176,2,226,226,0,8581,8647,66,76,73,3,93.76417234
8205f0d26abda68a740de8c962a32172d2bc7e8b,3,10,8,2,0,0,0,2,6,161,1,2,1.530493057,464,1,0,66,65,1,2691,2681,10,17,17,0,100
2ae95bd6e65f698120eb3a7b774b4a7b252ce168,3,113,0,113,1,0,1,1,55,935,1,3,0.636153258,829,177,2,155,145,10,5172,4878,294,63,58,5,99.94879017
2117d1dbba8f18b08da70e890c30111edb3aebe3,38,1317,1051,266,3,0,3,2,66,472,3,18,4.447481393,6964,5,0,947,927,20,45054,44212,842,501,488,13,88.63405429
984f45efed6f79e41d7e5e684ea8705172c90436,5,52,8,44,1,0,1,3,24,1458,2,5,1.369974075,757,31,0,99,97,2,4854,4788,66,50,48,2,99.09571745
833ccb78e61f01d1525f6c6af6757ad573d8a78c,2,2,4,2,0,0,0,11,56,259,1,1,0.918295834,825,178,0,139,139,0,4923,4925,2,51,51,0,100
c4cb42f7d77138beb79d66c70c8b42448078d992,7,84,23,61,0,0,0,2,5,679,1,4,2.483704128,973,179,1,161,150,11,6144,5794,350,123,112,11,91.68183
9e97a9075da943fdaf08f3ad681c24962e272212,0,0,0,0,0,0,0,0,0,0,0,0,0,0,32,1,0,0,0,0,0,0,0,0,0,100
06de6c48a0126db2d0ce56693eec92d6afd9252d,0,0,0,0,0,0,0,0,0,0,0,0,0,0,33,2,0,0,0,0,0,0,0,0,0,100
8bf08f545d15b39e43874a2b1ac5b0586a917a4f,6,199,18,181,2,0,2,2,90,615,1,4,2.379073167,1207,34,2,63,58,5,7740,7163,577,31,27,4,92.55969547
b2c982294b90f03d507e3078b0b3bf0a359a29c6,2,28,15,13,0,0,0,2,2,3061,2,2,0.952265625,559,35,1,62,62,0,3892,3843,49,31,31,0,100
3eec67e4e0bfa38be5ab3d939bcf3550c6113a3e,0,0,0,0,0,0,0,0,0,0,0,0,0,0,36,2,0,0,0,0,0,0,0,0,0,100
bf4c371de97762d1cb3abd42d872c538a28b2cd8,4,69,0,69,0,0,0,3,3,787,2,4,1.999549748,536,37,3,47,47,0,5714,5714,0,38,38,0,100
70c6545a6821977b22cce62e993fc14eafe994d9,187,231,223,8,0,0,0,3,91,807,4,38,7.408150904,12279,38,3,1462,1462,0,60209,60122,87,919,919,0,99.85758674
0b67d74ec884e2e202dd8af5f79468552920ed30,0,0,0,0,0,0,0,0,0,0,0,0,0,0,39,2,0,0,0,0,0,0,0,0,0,100
f892342140c4dd4e852eebf3279723fe6ef6519c,8,35,32,3,0,0,0,2,7,88,2,7,2.665164527,874,40,0,131,131,0,4853,4940,87,81,81,0,99.85758674
8a40ce0aad03838cbc3be7bf158f81e508ecde6f,0,0,0,0,0,0,0,0,0,0,0,0,0,0,41,1,0,0,0,0,0,0,0,0,0,100
eb4b5337751f72e1f32cc3c4851c98b4b66ece53,1,1,1,0,0,0,0,8,22,1610,1,1,0,665,0,0,120,120,0,4057,4057,0,49,49,0,100
cdf37f23a24b5665123f540905bdd6570619fc89,0,0,0,0,0,0,0,0,0,0,0,0,0,0,42,1,0,0,0,0,0,0,0,0,0,100
f5b685efa09b539b1f95925405723f7ac7b1dcea,23,255,251,4,0,0,0,8,92,683,1,12,3.123534376,7151,15,0,916,913,3,44143,44240,97,339,333,6,92.56360078
2ddabf3b84d42184d9781e02a936fa1160177866,4,1039,0,1039,4,0,4,1,1,0,1,3,0.831319627,0,43,0,115,0,115,4111,0,4111,24,0,24,90.5974026
3b53360ab4ada66b857d3fe847df07bc9be0ce8f,0,0,0,0,0,0,0,0,0,0,0,0,0,0,13,0,0,0,0,0,0,0,0,0,0,100
ad84a99e2ba630fa81aa6823515bfdeac1f3fe8a,10,888,0,888,10,0,10,1,1,0,1,2,3.132197372,0,32,0,73,0,73,3907,0,3907,49,0,49,99.53149401
24b8c0e031669c34f6912415fbd501599a857364,28,915,5,910,25,0,25,1,5,27,2,5,4.705349038,245,33,1,37,25,12,2429,1114,1315,25,14,11,98.45969536
e61cbfddbb54afce67a086811c9788eac8a66a6e,12,572,125,447,2,0,2,1,30,730,3,8,2.97126271,1929,34,2,310,255,55,14819,12570,2249,173,139,34,88.72645064
8cb309da868afdc03f0dbddbdd18bbc0a6a1eb90,5,96,16,80,0,0,0,1,4,1762,1,4,2.242731133,703,35,1,53,48,5,5157,4691,466,39,35,4,97.08618331
f37f373a04af7de05b089a55bfb4d2d86d055fce,1,1,1,0,0,0,0,3,3,731,1,1,0,141,2,0,22,21,1,852,848,4,10,10,0,100
18c67ca3c221cf2961d59ac19a245762f4dd8f7d,7,53,14,39,0,0,0,2,93,1605,1,6,2.492566758,4587,44,0,616,615,1,26972,26839,133,166,166,0,100
9c2d135bb030213819e40f73c47e7e33d35ab3c6,1,1,1,0,0,0,0,11,57,507,1,1,0,756,180,0,133,133,0,4570,4570,0,47,47,0,100
3dbd158c7b0b1df5785d3a395a3ae058b7867381,2,3,1,2,0,0,0,12,58,31,1,2,1,2347,45,1,399,399,0,14068,14059,9,98,98,0,100
a1d546f7a39df6ffb7d3ed9d3bcc47126ab2e579,7,170,19,151,1,0,1,1,59,614,1,3,2.21906199,2107,181,1,354,337,17,12563,12041,522,91,80,11,99.95859785
2173d87cf4aa84937abe438d0f836c8fdd3ba1c1,4,79,29,50,0,0,0,3,8,367,1,3,1.522353994,1205,16,0,207,203,4,7771,7567,204,49,48,1,97.40863787
ebb424989c23060feb869e0cf817a4d5285c853e,1,7,2,5,0,0,0,2,2,1972,1,1,0,93,3,0,11,11,0,539,539,0,7,7,0,100
dbce6582a04e9b6281d64786c9be63d8f8d09b31,0,0,0,0,0,0,0,0,0,0,0,0,0,0,17,1,0,0,0,0,0,0,0,0,0,100
824b34cac1d05917eb2bc3dc8c62c9772d0c6e4d,3,50,21,29,0,0,0,3,3,277,2,3,0.95264382,871,4,1,150,147,3,5703,5622,81,44,44,0,100
ba8c6e130e524fc1454b279ab329b03a9877b13e,2,15,0,15,0,0,0,7,59,401,1,2,0.721928095,1299,182,1,225,222,3,7571,7520,51,68,67,1,100
e354e067ea6b5d099db609aff76a199a81e92d12,1,1,1,0,0,0,0,11,60,0,1,1,0,761,183,2,135,134,1,4601,4597,4,47,47,0,100
c9621e30ba79b20322f449e24a2f438918ce33fa,2,65,3,62,0,0,0,1,7,52,1,1,0.997502546,317,184,2,61,53,8,2027,1807,220,18,15,3,99.97436555
4f9c6c24a8b4b03e2836c77fe2e53e38b6519420,1,35,29,6,0,0,0,12,60,93,1,1,0,1597,282,0,267,266,1,9580,9547,33,51,51,0,100
d4596a029984865ace68fab981047bed1f1d1494,19,212,2,210,1,0,1,3,94,1354,3,10,3.294644897,2411,185,0,205,175,30,14794,13889,905,135,117,18,96.56723485
67540b32bea000574561485e11f7f033be1dc2cd,1,10,2,8,0,0,0,2,7,920,1,1,0,273,186,1,53,51,2,1601,1558,43,31,31,0,100
02e73b917972ef69c7b901c3b5c493a4a504731c,5,119,10,109,0,0,0,1,61,1273,1,4,1.283588971,1993,187,2,319,311,8,12287,11803,484,76,73,3,100
e2f82b25d19faa263bbdbdf074948c6537d85e3a,2,98,3,95,0,0,0,2,4,771,2,2,0.496622112,686,188,0,50,48,2,5280,4723,557,37,36,1,96.51233443
ea7753f06b2fe66df61b63a49558ff80ac3a09bb,4,500,0,500,2,0,2,1,3,624,1,2,1.182576726,301,5,0,87,40,47,4814,1786,3028,51,31,20,95.15106304
6903248d4ed5a383bf0fa080992c038185221a59,3,13,5,8,0,0,0,9,23,2111,1,2,1.392147224,751,0,0,86,86,0,5074,5050,24,42,42,0,100
5ed0d65dd3b79a990f8f8c4974c3b20c82964e50,3,3,3,0,0,0,0,3,4,3931,1,1,1.584962501,285,6,0,27,27,0,1695,1683,12,15,15,0,100
cc489350eba8db8bc62a4fca77b7ad9aa14bcf3d,3,30,24,6,0,0,0,13,69,459,1,3,1.475478024,3640,0,0,591,591,0,22032,22003,29,152,152,0,100
0f39df025ff43caff8a6fc0b841ad429379db242,1,2,2,0,0,0,0,6,8,1400,1,1,0,119,0,0,11,11,0,732,732,0,8,8,0,100
fc996e7530dadf0cb498ba1970a6de5ea6edd817,1,7,7,0,0,0,0,3,3,1092,1,1,0,56,7,1,5,5,0,187,187,0,4,4,0,100
448ae1c06150d4fd62939b5a31f38c03d9a33c7c,1,12,15,3,0,0,0,1,5,468,1,1,0,193,189,0,33,34,1,959,988,29,13,13,0,100
d4db3a650fa40ee89513ff581653dbe2d44cb671,2,52,1,51,0,0,0,1,9,203,1,1,0.956155024,358,190,1,67,61,6,2144,2052,92,23,18,5,100
b8f966acb480b84e8076a539b346a1ba6b29af69,1,12,3,9,0,0,0,1,7,11,1,1,0,198,191,2,36,35,1,1048,1011,37,14,14,0,100
22e8511f2f68b536a0b1c31b2ec271fab255d5bb,1,2,3,1,0,0,0,4,4,524,1,1,0,596,192,3,112,112,0,3941,3944,3,19,19,0,100
3bbac90fc37d225ff4eefaab018fe6147a5a0937,1,1,0,1,0,0,0,14,63,96,1,1,0,1606,0,0,267,267,0,9601,9594,7,51,51,0,100
83d06d95dd70db6e3340afead3bd32fa58d9a396,2,15,2,13,0,0,0,11,95,599,1,2,0.997502546,1014,1,0,24,24,0,5899,5865,34,3,3,0,100
2e7ce47dfc59e772a9fcc8577bbc6b14f9311bf3,7,45,10,35,0,0,0,2,61,890,1,3,2.305178101,1339,193,0,217,215,2,7471,7313,158,93,91,2,99.96560028
dc500a7adffbb3cf94604097efe1eb93bc43822d,1,6,0,6,0,0,0,9,25,1244,1,1,0,206,8,0,22,22,0,1466,1398,68,10,10,0,100
8e2df4f8cff43e2fd7f7eda1b9f73cd093008c3e,7,34,1,33,0,0,0,2,64,2242,1,3,2.660347864,1926,194,0,319,314,5,10899,10759,140,97,93,4,97.00610998
f944f5cc3dd7874dac049e0c8c4d7212df781452,2,381,0,381,2,0,2,1,1,0,1,2,0.985995885,0,9,0,36,0,36,1996,0,1996,22,0,22,96.9839209
1f959d076ed7f29c3f8a5c6e99cbfcc62c1058d9,5,163,2,161,3,0,3,1,96,358,1,2,2.092354243,1387,195,0,152,148,4,8838,8337,501,117,113,4,93.37915235
14845725ea57e4ff110bc5fd838aabe6e6d20c25,1,1,1,0,0,0,0,1,9,368,1,1,0,206,196,1,36,36,0,1053,1053,0,14,14,0,100
94a3ac5fbd184bde121f94895a5bdf22cf034d70,1,4,0,4,0,0,0,3,4,1788,1,1,0,311,197,2,49,49,0,2110,2060,50,28,28,0,100
39eb2533b8f7c6c8cb17ee30d5c2005e74873ff4,10,72,16,56,0,0,0,13,70,672,1,6,2.859653833,4027,198,2,612,609,3,24372,24136,236,199,196,3,91.69690502
d86d0d56e363a20ffa1ef48deea045851fc49d91,1,5,3,2,0,0,0,4,6,60,1,1,0,316,10,0,50,49,1,2118,2110,8,28,28,0,100
8e6ec266190d59558f369f808c53cf9186887ce5,5,80,0,80,1,0,1,1,97,448,1,3,2.001806631,2694,199,0,425,420,5,16299,16052,247,288,285,3,99.98076923
251b167e9a17d29b3da6074933acaf92cf5dec81,1,4,3,1,0,0,0,4,7,0,1,1,0,318,11,1,50,50,0,2118,2118,0,28,28,0,100
d16b6b8ce843e6e931cb8dbc92823f82ab10ce0d,2,11,3,8,0,0,0,9,25,2926,1,1,0.749595257,894,200,1,140,140,0,5590,5559,31,32,32,0,100
98b724f979a9305a5c92d361aa9a89a111c76701,1,0,8,8,0,0,0,4,12,1592,1,1,0,162,201,1,13,14,1,966,1035,69,5,5,0,100
5c418ff33ad704d0596c631dad9e082c4b2076ca,12,198,166,32,0,0,0,2,7,3824,1,4,2.079881267,1116,202,2,179,177,2,5601,5546,55,108,106,2,92.8528827
3273f2572f79bfcfc9abe1d821a9743108c65ebb,2,13,10,3,0,0,0,12,70,70,1,1,0.987692509,1196,203,2,289,289,0,7604,7595,9,241,241,0,100
60752aab7f8c3ce2b1fd57e232c7305adfb6200a,6,717,22,695,3,0,3,1,5,895,2,3,1.697067405,424,204,2,153,48,105,5376,2560,2816,129,34,95,99.90735022
94d60e2f800a47f06ca1e6a6fcae8c455670f10e,0,0,0,0,0,0,0,0,0,0,0,0,0,0,0,0,0,0,0,0,0,0,0,0,0,100
345f3db49a7f4e662d117fb778bc66b49de14dae,1,3,3,0,0,0,0,3,6,61,1,1,0,327,0,0,37,37,0,2082,2082,0,22,22,0,100
b2d77411ae4a43ddd2386c4a1db5e0191790acf6,10,951,9,942,4,0,4,1,98,608,3,7,1.977115586,2211,2,0,316,228,88,16223,12897,3326,142,96,46,99.00010416
243a02487237bc5029a10e86665e51ecb20d3cb7,16,46,3,43,0,0,0,2,19,3778,1,8,3.627279681,1679,12,0,254,254,0,8981,8981,0,112,112,0,100
81d3805cae760e12ca120b2725a6c31b83da035f,1,10,7,3,0,0,0,15,66,279,1,1,0,1611,13,1,268,268,0,9644,9621,23,51,51,0,100
505c98d9a807d92640e6a2ac8fba410a700d4d58,1,0,2,2,0,0,0,15,67,17,1,1,0,1613,14,2,268,268,0,9637,9644,7,51,51,0,100
0c1e2ebce6e4f6e1a47d4dec5c0b8475433ef8df,4,104,48,56,1,0,1,2,8,1399,1,3,1.853093474,616,15,3,73,67,6,4553,4178,375,52,46,6,99.95780591
f118fcf2cd1047571447d92cb7fb33da8a6e3a85,0,0,0,0,0,0,0,0,0,0,0,0,0,0,0,0,0,0,0,0,0,0,0,0,0,100
239ea8fb3cab9e2c052d933e8f0ae25648782e95,1,1,1,0,0,0,0,4,7,2331,1,1,0,349,1,0,49,49,0,2343,2343,0,18,18,0,100
6128d66eba5b1dfc0a5e047a057c33d00abac6e7,1,32,5,27,0,0,0,9,26,539,1,1,0,824,205,0,127,127,0,5350,5262,88,24,24,0,100
7f6a33d94efdfa9f1db4bd71da6ddff10aace45e,1,7,1,6,0,0,0,15,68,338,1,1,0,1612,16,0,269,268,1,9643,9637,6,51,51,0,100
843cd6eea60431ae527164f8fe9b0e054c7f9157,1,5,0,5,0,0,0,6,17,2529,1,1,0,144,206,1,11,11,0,1020,962,58,7,7,0,100
5e44c4e4be97e93f5d13cdc7bd52b7374635398c,1,20,6,14,0,0,0,9,27,90,1,1,0,842,207,0,126,127,1,5401,5350,51,24,24,0,100
36ea4c00124e0a44cc32c9c2d11ff3f77a2da541,1,2,1,1,0,0,0,9,28,0,1,1,0,854,208,1,126,126,0,5401,5401,0,24,24,0,100
583c8311df06e92afcea0f3c89d085a980e2dd9f,1,1,1,0,0,0,0,2,3,5603,1,1,0,32,0,0,3,3,0,102,103,1,2,2,0,100
1ba982d80ba74544730f36f3cd46cdbe894a9e6a,2,11,14,3,0,0,0,5,9,1013,2,2,0.40217919,449,17,0,45,46,1,2728,2748,20,28,28,0,100
f69f77d20cc37882ff76bbe8e9e6382705755417,2,0,6,6,0,0,0,3,7,3756,1,1,0.918295834,262,18,0,8,8,0,1408,1408,0,8,8,0,100
d41221966cece5ed8c029a7e941b5d621486ddb1,2,28,4,24,0,0,0,11,99,299,1,2,0.857148437,1616,209,0,127,126,1,9506,9424,82,24,24,0,100
f5dacbbebb0fd48f136abab2658711719df575eb,3,21,4,17,0,0,0,4,71,2086,1,3,1.553520951,886,210,0,196,193,3,5093,5037,56,143,142,1,100
bb8dab546215a602108d29d8026111cf099b7609,11,22,11,11,0,0,0,2,3,2343,1,2,3.459431619,2279,211,1,515,504,11,13525,13459,66,264,264,0,100
aa740b54bd914a0246e2a9280459e33c233de9b3,2,23,7,16,0,0,0,5,30,1450,1,2,0.650022422,947,212,1,141,137,4,6015,5887,128,29,29,0,100
6d861f542d0cb5b55f214819787c9ac855dd7066,0,0,0,0,0,0,0,0,0,0,0,0,0,0,19,0,0,0,0,0,0,0,0,0,0,100
d3bf4a2cf5347f7cfd9d217b216c906cb7801217,8,25,25,0,0,0,0,7,11,5091,2,7,2.724889452,949,0,0,143,143,0,5364,5353,11,111,111,0,100
fff0d3404e53d9349184f5016d8a0848e1210957,1,3,0,3,0,0,0,5,11,98,1,1,0,167,0,0,28,27,1,917,901,16,12,12,0,100
e827a5668a94d13800201191ebf7d34642728771,1,62,24,38,0,0,0,3,8,1719,1,1,0,164,20,0,22,20,2,967,823,144,11,10,1,100
12b2d7430f51b3e0195e5a7320d27429c1b39edf,1,11,3,8,0,0,0,3,9,15,1,1,0,186,21,1,23,22,1,997,967,30,11,11,0,100
0f41dbb1b40ecdc2e546d1366b8973e576f59486,1,1,1,0,0,0,0,3,10,11,1,1,0,191,22,2,23,23,0,997,997,0,11,11,0,100
5edbdb28dcd8895d31b19313f9441791f6b71bc9,10,138,67,71,1,0,1,13,71,3743,2,5,2.589234936,2076,213,0,254,245,9,12577,12332,245,87,79,8,99.94728519
1c5a4e7790d526edfe31a03e41749c9d71f3f3fa,4,29,12,17,0,0,0,2,100,2532,1,2,1.581321256,1017,214,0,40,40,0,5302,5245,57,29,29,0,100
009603ae2c8faeee7894941d718fd303cc823f9b,2,8,1,7,0,0,0,15,101,541,1,2,0.764204507,2381,215,1,270,269,1,13716,13694,22,51,51,0,100
3ad842906611d9bcfeabb63b5a419df7207e4bc2,0,0,0,0,0,0,0,0,0,0,0,0,0,0,0,0,0,0,0,0,0,0,0,0,0,100
19f76a33cb081b8b91afc24b78e4f265fc3e94c8,6,50,10,40,0,0,0,2,102,1909,1,3,2.345183152,2002,23,0,205,202,3,11054,10931,123,82,79,3,98.0681692
13da0ebb032035880adb65ef0a9bd0efc0511499,24,905,48,857,3,0,3,4,103,1788,2,11,3.559483261,8234,1,0,1284,1199,85,52100,48613,3487,491,449,42,95.53084347
acc1f71af03dec6f1a1c83fb0fcce08451e140ea,6,31,49,18,0,0,0,12,104,2034,1,3,2.031052061,2932,24,1,332,336,4,18026,18057,31,158,159,1,100
8c6c58799a7e24f9e3c3472b2ce89dde4ae43d2c,1,0,1,1,0,0,0,11,33,0,1,1,0,901,25,2,133,133,0,5764,5764,0,26,26,0,100
526f5619e6b115ad8db1af245fd4736125dd5c37,6,30,16,14,0,0,0,14,73,78,1,4,2.299305658,3616,2,0,552,552,0,22077,22045,32,132,132,0,100
f8d017e61d66ec56b17ecf796743d6851c2f0988,4,65,21,44,0,0,0,15,74,525,1,3,1.78783932,3231,26,0,501,498,3,20123,20000,123,142,140,2,100
55b9d3508ea913fe57f8b544384210fc471f2b24,1,0,32,32,0,0,0,13,66,432,1,1,0,786,27,0,136,141,5,4596,4757,161,49,50,1,100
f600ccf00f70049dc3ffa7e71ec25cb81d2c25a3,11,0,2279,2279,0,0,0,2,12,7841,1,3,2.987934683,1390,28,1,0,175,175,0,8144,8144,0,86,86,99.75264009
e213461033331bd2fdcb5cb6b6c51558fab6e2c0,29,0,6416,6416,0,0,0,2,4,6028,1,5,4.120865345,3583,29,2,0,512,512,0,22201,22201,0,396,396,99.31730769
271fb855b1a7d8bad926179c734223dbd1f48f69,6,0,744,744,0,0,0,4,11,7587,1,3,2.354080426,493,30,3,0,35,35,0,2933,2933,0,25,25,99.86413043
ce0e4f3553cf328f552ee2951112ce99e0c0f9ec,23,0,3561,3561,0,0,0,3,3,6655,1,6,3.953083727,2626,31,4,0,288,288,0,14544,14544,0,142,142,97.92075324
2cae34a3cfd95329b21e0537ddb30afb5b750209,6,0,723,723,0,0,0,5,11,7706,1,3,2.366001748,504,32,5,0,41,41,0,2875,2875,0,26,26,99.86122125
baa887fccbe989aaad6872eb1d1468088ec483d0,0,0,0,0,0,0,0,0,0,0,0,0,0,0,33,6,0,0,0,0,0,0,0,0,0,100
2f2085c8770d3f15c2bc8aaaf71f3590d098af47,0,0,0,0,0,0,0,0,0,0,0,0,0,0,34,7,0,0,0,0,0,0,0,0,0,100
548d3d522f14f74b821c8af8a9d7b7d2a225566f,0,0,0,0,0,0,0,0,0,0,0,0,0,0,35,8,0,0,0,0,0,0,0,0,0,100
58a997c6e7846ddd7214e9bf7089f635cbe8bf2f,0,0,0,0,0,0,0,0,0,0,0,0,0,0,36,9,0,0,0,0,0,0,0,0,0,100
a3fb5a27a47432cf11b17f31f6750f1a8abf768a,1,0,2,2,0,0,0,13,67,12,1,1,0,764,37,10,136,136,0,4582,4596,14,49,49,0,100
8dfb29047aec68859b439974594e38161359893a,6,6,6,0,0,0,0,2,7,4573,2,6,2.584962501,861,38,11,96,96,0,5575,5587,12,61,61,0,100
5e4d7fbc87851bed43cb9d28c5bc7e894e1fcdc9,1,4,4,0,0,0,0,3,4,811,1,1,0,120,39,12,16,16,0,719,705,14,7,7,0,100
4d046496439dff1da2e517a0081f939df1aaefae,6,16,5,11,0,0,0,3,35,3438,1,4,2.315667876,1650,40,13,255,255,0,10019,9930,89,86,86,0,100
f635a2e2bc63c041bf950241cc29e6d49043fa72,1,1,1,0,0,0,0,2,3,7367,1,1,0,462,0,0,60,60,0,2890,2890,0,31,31,0,100
a2094a717a739bd189805539471b1bd1e2c32d37,0,0,0,0,0,0,0,0,0,0,0,0,0,0,41,0,0,0,0,0,0,0,0,0,0,100
34843189b834a4460eabeea268e4c1e960524882,0,0,0,0,0,0,0,0,0,0,0,0,0,0,42,1,0,0,0,0,0,0,0,0,0,100
0b2d51bff038e4149e3733995330f85a9a6c929e,0,0,0,0,0,0,0,0,0,0,0,0,0,0,43,2,0,0,0,0,0,0,0,0,0,100
b0d18a23a4445b51df767d53fda697b215d10776,1,3,1,2,0,0,0,14,68,337,1,1,0,762,0,0,137,136,1,4590,4582,8,49,49,0,100
993731c3d9a2f6650f83a668e5c73bb3a127c469,1,1,1,0,0,0,0,14,69,57,1,1,0,764,44,0,137,137,0,4590,4590,0,49,49,0,100
643c7aa0d03ee2a520a137db8c8438bedd7275e3,1,25,3,22,0,0,0,9,13,925,1,1,0,339,45,1,32,29,3,2146,2080,66,8,8,0,100
1acb587f807a8e7b0e50bfd19b85a246db9e2abd,2,9,5,4,0,0,0,16,75,424,1,2,0.863120569,2249,1,0,352,351,1,13862,13841,21,107,107,0,100
58871e6e253bf852b5b96c3c1a2578db37b397a4,2,627,0,627,2,0,2,1,1,0,1,2,0.999587111,0,0,0,75,0,75,3700,0,3700,43,0,43,99.77306364
8ba2fea912ead1b8e3a81629250bdd684d36d23c,2,346,230,116,0,0,0,2,2,2,1,2,0.191948146,513,46,0,75,75,0,3701,3700,1,43,43,0,100
2c63aa2321a570f7dfcc659f565d18afb63a2e3c,9,605,5,600,3,0,3,13,105,1076,1,3,2.111007817,3313,0,0,511,467,44,21941,20105,1836,296,282,14,99.93139273
7ee6c39c8c7a6782246513b609763a1ebce4543e,0,0,0,0,0,0,0,0,0,0,0,0,0,0,0,0,0,0,0,0,0,0,0,0,0,100
14a74297378dc1584efbb698054f0e8bff4f90bc,3,4,21,17,0,0,0,3,3,6144,1,2,0.794309555,370,0,0,35,35,0,3241,3328,87,24,24,0,100
