CommitID,FileNum,TotalAddLines,TotalDeleteLines,LC,FileAdd,FileDelete,NAD,NDEV,NUC,AGE,NS,ND,Entropy,LT,EXP,REXP,CommitComplexity,LastCommitComplexity,CFC,CommitTokenCount,LastCommitTokenCount,NCC,CommitMethodNum,LastCommitMethodNum,NMC,A2A
22c72f70298ae5b2edd636ddeb363d6d8f750685,1,136,0,136,1,0,1,1,1,0,1,1,0,0,2,2,35,0,35,984,0,984,12,0,12,99.28057554
e8a0c370ddd6fb6bb70c0742ad7e864b819c2d08,1,0,136,136,0,0,0,1,4,0,1,1,0,115,10,10,0,35,35,0,984,984,0,12,12,99.28057554
8edb62db76579f58d3713e6dde9345363153d2df,0,0,0,0,0,0,0,0,0,0,0,0,0,0,11,11,0,0,0,0,0,0,0,0,0,100
e2b3d669da0efd84d73805d0fe11383b049ca3de,3,154,42,112,1,0,1,1,4,2,1,3,1.554682498,111,12,12,38,24,14,1234,889,345,17,14,3,90.68322981
fc29ce8b138b408b3ae054c2bfca61cc08c0c232,0,0,0,0,0,0,0,0,0,0,0,0,0,0,0,0,0,0,0,0,0,0,0,0,0,100
7947e7367bfcbd96851ef986d99ef170ee09c992,19,509,232,277,0,0,0,1,4,0,1,5,3.657421711,2121,13,13,701,668,33,19132,17569,1563,273,239,34,90.19607843
9b14a2a7da50853d869d0fa0f153c6dbcbd4a2de,3,48,19,29,0,0,0,1,5,10,1,1,1.331072575,231,14,14,73,67,6,2187,1997,190,22,20,2,100
e6d1fca400c0f5627f81f0f673ba06393b8745d0,2,9,0,9,0,0,0,1,5,12,1,2,0.764204507,130,15,15,25,22,3,977,912,65,17,16,1,100
952db93552b995be8af8a9c54f7c4ab8c152a364,4,47,152,105,0,0,0,1,5,0,1,2,1.586470743,260,16,16,33,57,24,1226,2023,797,22,28,6,98.35390947
288a8cfdcf6bbba131fb5414663ad84b4dc35d0a,0,0,0,0,0,0,0,0,0,0,0,0,0,0,1,1,0,0,0,0,0,0,0,0,0,100
9bd461944d016a23876a28680c3ec405b8c8ff55,2,60,18,42,0,0,0,2,5,0,1,1,0.999525689,188,2,2,33,30,3,1729,1450,279,22,20,2,100
c201bb7b930d8c5be3e5b5c52a3f51192f9ebb14,0,0,0,0,0,0,0,0,0,0,0,0,0,0,17,17,0,0,0,0,0,0,0,0,0,100
55574fe9a59e76e111260d28de09ed1dec04d478,0,0,0,0,0,0,0,0,0,0,0,0,0,0,3,3,0,0,0,0,0,0,0,0,0,100
5183bd9feb3a288632337de3533d36558248de61,5,61,51,10,0,0,0,1,6,38,1,3,1.917058475,880,18,5,250,242,8,6921,6825,96,135,135,0,100
0abe6d6ae36cc5f9cffd9047ed76baf13f2d0ca1,0,0,0,0,0,0,0,0,0,0,0,0,0,0,19,6,0,0,0,0,0,0,0,0,0,100
87f3bff4097e2782e8ebd6b3446ed5192f7e3934,9,42,60,18,0,0,0,1,6,24,1,5,2.625823335,1756,20,7,584,588,4,14344,14554,210,209,211,2,100
75b5c9a86bf1d342b848ecd629d244f2942c904c,0,0,0,0,0,0,0,0,0,0,0,0,0,0,21,8,0,0,0,0,0,0,0,0,0,100
d1a9521495c8ca1ed7f6e6f3437ae7e5a58f1b72,6,174,43,131,0,0,0,1,7,36,1,4,2.108248129,1309,22,1,477,446,31,11833,10664,1169,170,164,6,96.26556017
20633ecbe5bb3787857494b8476f612c7f7fddcb,0,0,0,0,0,0,0,0,0,0,0,0,0,0,23,1,0,0,0,0,0,0,0,0,0,100
32a1fcb5682049aacfbd06c32b630f166c23f643,4,13,5,8,0,0,0,1,7,82,1,2,1.904875005,357,24,2,76,75,1,3040,2970,70,33,33,0,100
94335e391efff84c65e2d9f7bfd57c2e9f34c9e4,2,56,31,25,0,0,0,1,8,4,1,1,0.090543853,633,25,3,220,205,15,5281,5060,221,111,105,6,100
13ba975ab15341d7ecda31b2e8870d68084828e8,0,0,0,0,0,0,0,0,0,0,0,0,0,0,26,4,0,0,0,0,0,0,0,0,0,100
ff6e70c84c24f4c0e86dbaa3b4fc969d5660f6da,12,279,129,150,3,0,3,1,8,41,1,3,3.473771211,776,27,5,130,122,8,6723,6074,649,75,68,7,97.1659919
f42255b1f8bbf661680383677e70135fd6ac8f2a,14,229,29,200,0,0,0,1,9,31,1,5,2.828898841,2344,28,6,763,708,55,20657,19274,1383,283,264,19,100
b061e6203def8a518b23fc8863126b0b3d43002b,1,0,20,20,0,0,0,1,6,107,1,1,0,45,29,7,5,10,5,224,351,127,5,7,2,100
70ffe34fe20ea9b6a85995b29b6d1a8c25a43a83,15,255,19,236,3,0,3,1,10,0,1,5,3.351408129,2243,30,8,745,689,56,19858,18510,1348,270,248,22,97.265625
998a811d2a0506a34aeb3f9bdb263cf2d89979fb,4,34,34,0,0,0,0,1,11,2,1,3,1.511210352,1290,31,9,454,454,0,10716,10722,6,172,172,0,100
513251ce736834d9507cd41ceb4cb73af9de0cd1,0,0,0,0,0,0,0,0,0,0,0,0,0,0,32,10,0,0,0,0,0,0,0,0,0,100
2b7ea9cc6054a9408457fdd01a5a82181144c992,2,53,2,51,0,0,0,1,12,0,1,2,0.684038436,692,33,11,231,221,10,5743,5387,356,127,121,6,100
ac3528e555e4d896d275f9213c755ace0f549a15,3,13,9,4,0,0,0,1,13,4,1,2,0.865856617,851,34,12,249,248,1,6600,6585,15,135,135,0,100
dc20712f258623f6d9d8977f2a8f9100c279e5f1,0,0,0,0,0,0,0,0,0,0,0,0,0,0,35,11,0,0,0,0,0,0,0,0,0,100
60dabd6f9cae2a62554e9de8aff904bc07acb9dc,0,0,0,0,0,0,0,0,0,0,0,0,0,0,36,12,0,0,0,0,0,0,0,0,0,100
c4c9689155ae22f1cab7f9f9bb9f23abbd807fac,2,2,1,1,0,0,0,1,14,14,1,2,0.918295834,744,37,11,232,232,0,5776,5758,18,127,127,0,100
c5aa64581b100d2e7d6ab7ab4e29734551f3c1ce,0,0,0,0,0,0,0,0,0,0,0,0,0,0,38,10,0,0,0,0,0,0,0,0,0,100
f806cb0b94a073c667debbcf54fc91d21ee85ccc,4,111,2,109,2,0,2,2,11,16,1,2,1.358747225,341,39,11,95,81,14,3257,2831,426,35,29,6,92.33226837
5e4733ecf7b1102772af70a2255924c3903653c0,14,244,106,138,0,0,0,1,12,68,1,5,2.849562728,1409,40,12,350,326,24,12230,11229,1001,134,129,5,98.13333333
11c84aeb7b115b0108b193f1bbc7f8beec41e91b,0,0,0,0,0,0,0,0,0,0,0,0,0,0,41,12,0,0,0,0,0,0,0,0,0,100
111ac06544ec45b8f2b17f224e0b6b4b15a0219e,0,0,0,0,0,0,0,0,0,0,0,0,0,0,42,13,0,0,0,0,0,0,0,0,0,100
c787721da830d7fc22cc49da4843f60685231b2d,0,0,0,0,0,0,0,0,0,0,0,0,0,0,43,14,0,0,0,0,0,0,0,0,0,100
0282ee3550dd4d7c3ea05ad816a16c1bb125005c,0,0,0,0,0,0,0,0,0,0,0,0,0,0,44,15,0,0,0,0,0,0,0,0,0,100
8204eee49c1be262c2078dcb1404e8dc7be71bf3,18,2034,347,1687,2,0,2,1,12,79,1,6,2.754179101,1702,45,11,607,400,207,21379,13507,7872,267,171,96,91.44542773
bd8c9502c42ccfbeba3b82958d1571a861b6e7b0,2,0,0,0,2,0,2,1,5,8,1,1,0,0,46,11,0,0,0,0,0,0,0,0,0,98.63013699
7fd4f2c44cf7de14271c1ed5a20e534f66e6ab79,25,69,107,38,0,0,0,1,15,71,1,9,4.096311977,2568,47,12,667,667,0,20193,20419,226,304,304,0,84.64419476
8a714f4aeb5c723c6aafb98714bed027cddf8749,0,0,0,0,0,0,0,0,0,0,0,0,0,0,4,0,0,0,0,0,0,0,0,0,0,100
dfadedf21488a9f068367ca9ee36a12ba7e6f3ad,0,0,0,0,0,0,0,0,0,0,0,0,0,0,48,3,0,0,0,0,0,0,0,0,0,100
774c3a041f810fe54a6ed47a02fc409cb713c0c5,0,0,0,0,0,0,0,0,0,0,0,0,0,0,49,4,0,0,0,0,0,0,0,0,0,100
40f9f941d3f9821d6f47c07a905dc5bdf0496955,2,160,112,48,0,0,0,1,16,32,1,1,0.864505251,803,50,4,271,275,4,6546,6455,91,137,133,4,100
7a6f8469d096f6ff6c496df2e48365c772af9ce1,0,0,0,0,0,0,0,0,0,0,0,0,0,0,51,3,0,0,0,0,0,0,0,0,0,100
33037ded0106608d9485934ba2ad21a1fe31df59,2,5,3,2,0,0,0,1,15,49,1,2,0.954434003,514,52,4,153,153,0,4042,4024,18,53,53,0,100
842690ea2a8203b7d3a313a53feb761ec9d68383,23,1223,989,234,4,0,4,1,16,36,1,7,3.105264563,2707,53,5,617,556,61,21590,19271,2319,278,272,6,77.13178295
98eb9203b65eb452bd2a1ff3559ccbca6f97f670,0,0,0,0,0,0,0,0,0,0,0,0,0,0,54,6,0,0,0,0,0,0,0,0,0,100
345ff7eddf9c23302803157ae89b1301e47c80df,14,3355,195,3160,9,0,9,1,13,0,1,3,3.313062534,804,55,7,685,218,467,22701,6100,16601,284,94,190,87.61061947
b2869cccb9627e3ff5c8f65a837129783707dd2e,0,0,0,0,0,0,0,0,0,0,0,0,0,0,56,8,0,0,0,0,0,0,0,0,0,100
df176b7a1fc65be86c7be47c8a3cd56c2d31d1cf,1,169,91,78,0,0,0,1,14,0,1,1,0,270,57,9,128,88,40,2860,2283,577,30,30,0,99.26650367
1b21659a1955b679532776854ecb1db9a0fb668f,0,0,0,0,0,0,0,0,0,0,0,0,0,0,58,10,0,0,0,0,0,0,0,0,0,100
fe6629997fd57d96748e83001e12a371c737f62b,1,7,6,1,0,0,0,1,15,17,1,1,0,342,59,11,129,128,1,2863,2860,3,30,30,0,100
8120af19115d00d57d1ce1d29ef7d51443f2589f,2,24,0,24,0,0,0,1,8,24,1,1,1,235,60,11,39,39,0,2065,1777,288,12,12,0,100
c1f86d23010746ef0821781a7236adedd2d6279e,0,0,0,0,0,0,0,0,0,0,0,0,0,0,61,12,0,0,0,0,0,0,0,0,0,100
253247088f347695486d5c45c541ad22a23ed39a,0,0,0,0,0,0,0,0,0,0,0,0,0,0,62,12,0,0,0,0,0,0,0,0,0,100
3727a55f345e638f7980a19841c108f67498e79d,0,0,0,0,0,0,0,0,0,0,0,0,0,0,63,13,0,0,0,0,0,0,0,0,0,100
81fee7a09d854e760ecff4e0fb3bddf1b4ab910b,5,85,0,85,0,0,0,1,3,21,1,1,2.321928095,1804,64,14,257,257,0,13172,13172,0,78,78,0,100
63eb29883e0dfc6f80994775b94eda1e61332c83,0,0,0,0,0,0,0,0,0,0,0,0,0,0,65,15,0,0,0,0,0,0,0,0,0,100
5a34ebef52a77c087ffbc235424478b265ab2403,1,2,2,0,0,0,0,1,9,3,1,1,0,122,66,16,19,19,0,1022,1013,9,4,4,0,100
8e9674a1b88b8c84d558534189dc10acea84bb15,0,0,0,0,0,0,0,0,0,0,0,0,0,0,67,17,0,0,0,0,0,0,0,0,0,100
f7cc40a6c6f5d4e9eeb28e8c95bcb57ff66e12cf,0,0,0,0,0,0,0,0,0,0,0,0,0,0,68,17,0,0,0,0,0,0,0,0,0,100
db7edf99495b95397c87afeb422931a40940ff9a,0,0,0,0,0,0,0,0,0,0,0,0,0,0,69,18,0,0,0,0,0,0,0,0,0,100
ffe3481808405433362a0377354aec6d553e3f5c,0,0,0,0,0,0,0,0,0,0,0,0,0,0,70,19,0,0,0,0,0,0,0,0,0,100
55bd090ba3447e96c69416ab314718f67f0fe2db,0,0,0,0,0,0,0,0,0,0,0,0,0,0,5,0,0,0,0,0,0,0,0,0,0,100
a63515ce5863262afedc1f77d83d43185e86809d,0,0,0,0,0,0,0,0,0,0,0,0,0,0,6,1,0,0,0,0,0,0,0,0,0,100
fff545fef5e06cc1eb970c97970757c8060e3a68,0,0,0,0,0,0,0,0,0,0,0,0,0,0,71,17,0,0,0,0,0,0,0,0,0,100
41d08b5cfd94954f5d663d3a091d0aba5f5e2c87,0,0,0,0,0,0,0,0,0,0,0,0,0,0,72,14,0,0,0,0,0,0,0,0,0,100
eb3b1bbd9c5c1648af42eca6ab33d3db80ea88d7,0,0,0,0,0,0,0,0,0,0,0,0,0,0,73,14,0,0,0,0,0,0,0,0,0,100
86d3ba82a52c921bcf820f580405e06fd3d797cd,0,0,0,0,0,0,0,0,0,0,0,0,0,0,74,15,0,0,0,0,0,0,0,0,0,100
86c74fb4b57813378fe2fd71d44dc1f8f7a28056,0,0,0,0,0,0,0,0,0,0,0,0,0,0,75,16,0,0,0,0,0,0,0,0,0,100
751a179769ed29c686558cd618a7934754b6691f,4,70,19,51,0,0,0,1,10,106,1,2,1.53554765,347,76,10,106,95,11,3294,2991,303,30,26,4,93.77682403
e6715a6d0792cca5fb0fd6961d565fa869795433,0,0,0,0,0,0,0,0,0,0,0,0,0,0,77,9,0,0,0,0,0,0,0,0,0,100
e2e7fd906abe882be5d9ffa6f8ce0ef9025f7107,1,1,1,0,0,0,0,1,16,57,1,1,0,343,78,7,129,129,0,2864,2863,1,30,30,0,100
0039f146bd31549fee2b80119a3c977a5072a5d5,24,2740,2362,378,10,0,10,1,17,32,1,6,4.080698285,3386,79,7,793,733,60,23546,23257,289,310,278,32,93.46642468
f352f56536e1855bdb97208b23f65c659eed3b69,61,127,61,66,0,0,0,1,18,101,1,9,5.29439242,6036,80,7,1517,1517,0,44391,44397,6,660,660,0,92.90187891
f03f432cc7d71b7969d56f9dc17ca264a3771650,0,0,0,0,0,0,0,0,0,0,0,0,0,0,81,5,0,0,0,0,0,0,0,0,0,100
2034a4ee5bc4fd9623797590e1dbb411e4848787,15,302,326,24,1,0,1,1,18,110,1,3,3.201329052,2223,82,6,334,336,2,15831,15966,135,132,135,3,97.59358289
eeb1023f9630a576bf8ea2d5b0e485f565e90e42,0,0,0,0,0,0,0,0,0,0,0,0,0,0,83,6,0,0,0,0,0,0,0,0,0,100
62806bad9162f22afe69f01e97ea96321d83710a,12,657,16,641,6,0,6,1,14,0,1,4,3.017296424,635,84,7,138,82,56,7688,5144,2544,85,47,38,96.40102828
127800a158ce6d6af08e5b32e01e153ade03d474,0,0,0,0,0,0,0,0,0,0,0,0,0,0,85,8,0,0,0,0,0,0,0,0,0,100
79d571847ca673a23733377fdfd9a489017c499c,8,19,10,9,0,0,0,1,12,39,1,3,2.846301808,224,86,3,45,45,0,1651,1651,0,35,35,0,100
a02c72575832bd9a451bd6d8fed62c7818eac611,1,12,1,11,0,0,0,1,14,45,1,1,0,212,87,4,72,66,6,1882,1820,62,16,15,1,100
e1d53e342f55f7ee51b8f4b04fc03aaa287712dd,6,70,47,23,0,0,0,1,19,60,1,4,2.022012759,1661,88,2,435,438,3,11982,11818,164,194,199,5,100
f736dfd4dd6089d9323cf7290ca7852c9dd045cd,6,234,5,229,3,0,3,1,13,26,1,4,1.802370874,335,89,3,111,90,21,3720,2604,1116,66,49,17,93.99538106
73b69bc59c61294a6689b695342e7f9d6b48db90,2,168,0,168,1,0,1,1,3,31,1,2,0.193196413,439,90,4,92,88,4,3682,2734,948,37,33,4,98.72881356
b9821a460520ea9c7f5bcc6cb35a33c725295f44,3,87,2,85,1,0,1,1,5,42,1,2,0.309461189,238,91,5,57,51,6,1808,1427,381,32,30,2,99.59016393
c529c6d5821d89bfb3f37e2c6bb0ec9b83635899,0,0,0,0,0,0,0,0,0,0,0,0,0,0,92,6,0,0,0,0,0,0,0,0,0,100
a84db2bc15c8876d40993d29adfe22f8aa9601cd,0,0,0,0,0,0,0,0,0,0,0,0,0,0,93,7,0,0,0,0,0,0,0,0,0,100
a1ea81add49b8684f979988f342193a547795fb0,1,8,1,7,0,0,0,1,15,17,1,1,0,222,94,8,75,72,3,1964,1882,82,16,16,0,100
710e2379a2ef1c5c4d2cf6ada9e0dc49795f5c86,2,30,2,28,0,0,0,1,2,8,1,1,1,49,95,9,12,12,0,238,238,0,10,10,0,100
97a5793f050400d38b07d4fbab0539809ce579ff,8,206,43,163,0,0,0,1,14,48,1,3,2.517193933,620,96,10,167,146,21,6056,5124,932,71,54,17,100
acba0fcdc047d14f0a28a88aec0a9b8b0cf524f8,2,4,1,3,0,0,0,1,19,58,1,1,0.721928095,824,97,9,267,265,2,6445,6416,29,131,131,0,100
f49a465349ae11ffccfffb1ed0693363a8b28a87,0,0,0,0,0,0,0,0,0,0,0,0,0,0,98,10,0,0,0,0,0,0,0,0,0,100
b062afaea6c4534bea3e2ec1387afb549da72570,2,350,0,350,2,0,2,1,1,0,1,2,0.994693795,0,99,11,74,0,74,2409,0,2409,23,0,23,96.7462039
490d0c72dc345c4683e9099e8f2b5244cffb868a,23,427,184,243,2,0,2,1,20,55,1,6,3.433059815,2432,100,5,725,685,40,21578,20064,1514,254,232,22,98.39449541
c454652c1cd491976b894dc293856c8f73495725,0,0,0,0,0,0,0,0,0,0,0,0,0,0,101,6,0,0,0,0,0,0,0,0,0,100
b43975aa1e773cd471f5771d7c7faac7a0f73a7c,5,150,107,43,0,0,0,1,20,4,1,5,1.494220774,1283,102,7,434,430,4,10975,10655,320,178,171,7,100
7d83e93e0d50487125d747265d2aa325cdce029d,0,0,0,0,0,0,0,0,0,0,0,0,0,0,103,8,0,0,0,0,0,0,0,0,0,100
604f27bc286f17bb8b43c25c1aa3302882c80395,2,34,0,34,0,0,0,1,3,112,1,2,1,127,104,9,12,12,0,708,708,0,9,9,0,100
d8d90987da6300e3c0a8741dfedc8109fee49da2,0,0,0,0,0,0,0,0,0,0,0,0,0,0,105,10,0,0,0,0,0,0,0,0,0,100
14c0ae1564cd6a067abb735c3b4f09ddf200910a,0,0,0,0,0,0,0,0,0,0,0,0,0,0,106,9,0,0,0,0,0,0,0,0,0,100
1dbb683d17f571213a8367d8e1306019063325d3,0,0,0,0,0,0,0,0,0,0,0,0,0,0,107,8,0,0,0,0,0,0,0,0,0,100
cea9e51cfb33fb2baef302e0e7c1f4bf8f87a9f6,0,0,0,0,0,0,0,0,0,0,0,0,0,0,108,1,0,0,0,0,0,0,0,0,0,100
fc44dd5d2201fae7208660c0bfb5d4847f452c87,0,0,0,0,0,0,0,0,0,0,0,0,0,0,109,2,0,0,0,0,0,0,0,0,0,100
c7a4f7c2caad4117a71f23ae97cfc10237674be0,0,0,0,0,0,0,0,0,0,0,0,0,0,0,110,3,0,0,0,0,0,0,0,0,0,100
cad632eb6c894f77cdf40f8c458491aba9677852,12,302,81,221,4,0,4,2,15,106,1,2,3.135587193,774,111,4,142,128,14,6692,5884,808,81,70,11,94.9339207
0c2a837bb14eab720fef8a25409a8e489897b507,1,12,0,12,0,0,0,1,14,60,1,1,0,353,112,5,150,146,4,3067,2984,83,40,39,1,100
86614561e4d1dd43a1e508f169c091e7cc935a4c,0,0,0,0,0,0,0,0,0,0,0,0,0,0,113,6,0,0,0,0,0,0,0,0,0,100
5661078ce4669dc428f8f59f39aa182666020f38,1,5,2,3,0,0,0,1,20,66,1,1,0,344,114,7,130,129,1,2892,2873,19,31,30,1,100
7c346f7ae726fd3213a9974752a3c4739469f79b,5,29,9,20,0,0,0,1,21,137,1,3,1.734167556,813,115,8,147,144,3,5573,5488,85,95,94,1,100
78983ffcfbf719ee6d190c486074c87779c6663f,0,0,0,0,0,0,0,0,0,0,0,0,0,0,116,9,0,0,0,0,0,0,0,0,0,100
777d0477c689d2fd9ebfe72dbd4e4dbab705a99f,25,589,367,222,2,0,2,1,21,72,1,5,3.329088124,2932,117,9,731,683,48,24858,23713,1145,338,318,20,94.9044586
e0c27e12a33b282eb0036e8c5c95a338a7977c0c,2,9,2,7,0,0,0,2,18,0,1,2,0.945660305,385,118,10,106,104,2,3075,3028,47,32,30,2,100
b397dd7b6f952bd1d2f34a09127661cee1b3e679,0,0,0,0,0,0,0,0,0,0,0,0,0,0,119,11,0,0,0,0,0,0,0,0,0,100
aa7305fcb283a28841eb1f03959c0c1550c187f5,1,58,0,58,0,0,0,1,5,0,1,1,0,127,120,12,17,9,8,1309,1019,290,12,6,6,100
8289fbdb37bb10b52d772327cb124555e1dfb020,0,0,0,0,0,0,0,0,0,0,0,0,0,0,121,13,0,0,0,0,0,0,0,0,0,100
6b2a2265e242307fa50030990bc018bff7a7964a,3,233,0,233,3,0,3,1,1,0,1,2,1.469216537,0,122,14,23,0,23,1143,0,1143,14,0,14,98.54469854
4ae97e26c4037a97aca08f05c93a2887285d356e,3,111,140,29,1,0,1,1,8,63,1,2,1.049303006,187,123,15,25,28,3,1254,1443,189,17,15,2,96.57794677
fdd0b8cb52af8256e5691d3065b256a387d17718,0,0,0,0,0,0,0,0,0,0,0,0,0,0,124,13,0,0,0,0,0,0,0,0,0,100
2b348c1f4dfe97f755034d57d5336cfd7ab130df,0,0,0,0,0,0,0,0,0,0,0,0,0,0,125,14,0,0,0,0,0,0,0,0,0,100
dc0107bc2ed79e4c17b8ddbb178fd14357d47147,3,66,27,39,1,0,1,1,9,119,1,1,1.563627971,302,126,15,62,59,3,2451,2305,146,34,34,0,77.59433962
35776f85ca9b658fb187a988966c259781759ed7,0,0,0,0,0,0,0,0,0,0,0,0,0,0,127,16,0,0,0,0,0,0,0,0,0,100
c1e75de882bf7e9eb669f2d6b8c23330b7c3313e,0,0,0,0,0,0,0,0,0,0,0,0,0,0,0,0,0,0,0,0,0,0,0,0,0,100
2af1f70cdad4fb612bc22634ae183bd11e6e96e6,1,1,0,1,0,0,0,2,19,40,1,1,0,254,7,0,89,89,0,1993,1986,7,17,17,0,100
844b081141f6e1e42231e9598c167cbf547af488,3,68,27,41,1,0,1,1,3,17,1,1,1.172626332,131,128,6,24,22,2,1051,976,75,15,13,2,76.04938272
db971a2ecfa4990f3512afac14acc1fb37248a42,3,3,0,3,0,0,0,1,15,161,1,2,1.584962501,375,129,7,154,154,0,3147,3147,0,44,44,0,100
2427f18b729c51eb485f580572086bc782974d4a,0,0,0,0,0,0,0,0,0,0,0,0,0,0,130,8,0,0,0,0,0,0,0,0,0,100
a7bfbd4b56d99655062c069e26ab6d476f5f06a0,2,15,5,10,0,0,0,1,15,56,1,2,0.286396957,383,131,7,118,112,6,3275,3184,91,27,27,0,100
bc9491c9dcea4035f3fd4733a2c0b649d08398ed,24,88,110,22,0,0,0,1,22,94,1,7,4.074760941,4325,132,8,805,807,2,31496,31637,141,371,373,2,99.23954373
7ddc6d64b2f81cc4022ae36aa233f7ce7e191314,0,0,0,0,0,0,0,0,0,0,0,0,0,0,1,1,0,0,0,0,0,0,0,0,0,100
1999497b9115b71d325e87f66f05dc006a9d0e9b,0,0,0,0,0,0,0,0,0,0,0,0,0,0,133,9,0,0,0,0,0,0,0,0,0,100
b57431769b7b42f8561ef4625ecf80e0d4bd019b,0,0,0,0,0,0,0,0,0,0,0,0,0,0,0,0,0,0,0,0,0,0,0,0,0,100
5690cd025ce5c1bcb21b69e4f17bbb65e3db80fb,0,0,0,0,0,0,0,0,0,0,0,0,0,0,1,1,0,0,0,0,0,0,0,0,0,100
1ecc7b63fbb0b13181ea16b38055729536c0225e,0,0,0,0,0,0,0,0,0,0,0,0,0,0,8,1,0,0,0,0,0,0,0,0,0,100
fac2b0477cba4cd01a56c635459a949f81680a84,0,0,0,0,0,0,0,0,0,0,0,0,0,0,134,9,0,0,0,0,0,0,0,0,0,100
21ba02b631c068abd4f295b8b903bdc392fa4573,0,0,0,0,0,0,0,0,0,0,0,0,0,0,2,2,0,0,0,0,0,0,0,0,0,100
62e4e5bc62c1716224f60e61813103ec54704459,1,9,6,3,0,0,0,1,14,20,1,1,0,114,135,8,27,23,4,839,810,29,11,11,0,100
d086fd7aaa4906cf4c50600744ed30fac9544269,2,35,13,22,0,0,0,1,23,20,1,2,0.249882293,1381,136,8,369,365,4,9400,9329,71,137,135,2,100
edbb3feac1bb12c0b00934b1fa58ba7c4b094b40,3,263,136,127,1,0,1,1,23,18,1,3,0.86705026,485,137,9,127,115,12,4325,3665,660,50,41,9,99.62121212
4d2c4381dc5019ec721b525dafec3e6197b7e972,0,0,0,0,0,0,0,0,0,0,0,0,0,0,2,2,0,0,0,0,0,0,0,0,0,100
e83268ede627871932e5de46d3bc69be500715b2,0,0,0,0,0,0,0,0,0,0,0,0,0,0,138,10,0,0,0,0,0,0,0,0,0,100
5f7cb7d6d00a284364c629ba85d4b3114c677cc2,0,0,0,0,0,0,0,0,0,0,0,0,0,0,3,3,0,0,0,0,0,0,0,0,0,100
3623bbcaf7c0f889fa0973b4b9d4e38fdfddb863,0,0,0,0,0,0,0,0,0,0,0,0,0,0,4,4,0,0,0,0,0,0,0,0,0,100
4fadaaba38d555cd869a10ac6c8e305f4b59ec61,3,118,0,118,2,0,2,1,21,6,1,2,1.501727227,289,139,8,105,95,10,2682,2290,392,24,20,4,98.88682746
f1b834377fc2f4f7ba5436e2cc0945c4fd7a9652,0,0,0,0,0,0,0,0,0,0,0,0,0,0,3,2,0,0,0,0,0,0,0,0,0,100
de86bbe9b92fda06368889a9554cb71fbb03bace,0,0,0,0,0,0,0,0,0,0,0,0,0,0,4,2,0,0,0,0,0,0,0,0,0,100
8be88359e7685ffba7d71b6710c2b0d9e1a02212,0,0,0,0,0,0,0,0,0,0,0,0,0,0,5,3,0,0,0,0,0,0,0,0,0,100
a4b6df067b9e320919b8997612c922863fc6a911,0,0,0,0,0,0,0,0,0,0,0,0,0,0,5,3,0,0,0,0,0,0,0,0,0,100
e4a937b229b3c8d77ac10a38bd05ce8ca1f86cee,0,0,0,0,0,0,0,0,0,0,0,0,0,0,6,4,0,0,0,0,0,0,0,0,0,100
e0871c82beaced35e4b1ea2e1d7a9023ec7e4e4a,0,0,0,0,0,0,0,0,0,0,0,0,0,0,140,1,0,0,0,0,0,0,0,0,0,100
6c6a0cb898b7b4182ebe6ee9ee41ae5c83206075,0,0,0,0,0,0,0,0,0,0,0,0,0,0,141,2,0,0,0,0,0,0,0,0,0,100
ea05a9146f0edb64e76a25ab30230e9b35c98092,4,110,32,78,0,0,0,2,13,131,1,2,1.518193186,430,142,3,97,84,13,3844,3301,543,54,47,7,100
e0940cb77cd3029fd90efc6952783754a619dd8e,0,0,0,0,0,0,0,0,0,0,0,0,0,0,7,3,0,0,0,0,0,0,0,0,0,100
8d1df9769947050afa23ae3b6371ac4a74dd4928,0,0,0,0,0,0,0,0,0,0,0,0,0,0,8,4,0,0,0,0,0,0,0,0,0,100
a45e938a1c59fb4f1fdc66252bdafac6aa9f2069,0,0,0,0,0,0,0,0,0,0,0,0,0,0,9,4,0,0,0,0,0,0,0,0,0,100
8d27b88ec0c3ff374952f56519896f0c932f2967,0,0,0,0,0,0,0,0,0,0,0,0,0,0,10,5,0,0,0,0,0,0,0,0,0,100
39e6d507642777ab6ac2db0903775fbf094257a9,0,0,0,0,0,0,0,0,0,0,0,0,0,0,11,6,0,0,0,0,0,0,0,0,0,100
76c6762906b4802dd9e41b647a7a5146a08e180b,7,135,76,59,0,0,0,1,24,127,1,5,2.513346984,1589,143,3,530,522,8,13709,13273,436,204,199,5,78.73303167
8ab3b6db708dfd187159fb2785bad2cacfc3a2b6,2,29,2,27,0,0,0,1,25,31,1,2,0.907165768,889,144,4,254,250,4,7039,6901,138,138,137,1,100
6b33f0278abc9a1d81f925d39673d9fccefc5370,16,419,402,17,0,0,0,1,22,114,1,4,3.036039894,1246,145,5,304,315,11,10050,9970,80,129,126,3,90.60402685
2185314c78c943fa3e5369e747c6807bc3b9d960,0,0,0,0,0,0,0,0,0,0,0,0,0,0,6,2,0,0,0,0,0,0,0,0,0,100
f353002184959c18354700b5b5f14e9c4a5269be,0,0,0,0,0,0,0,0,0,0,0,0,0,0,7,3,0,0,0,0,0,0,0,0,0,100
7ae507b40fd3493e02438165f1d0c982e6e79914,0,0,0,0,0,0,0,0,0,0,0,0,0,0,8,4,0,0,0,0,0,0,0,0,0,100
21bb13cd6122a926b670945bb11cde8bc0d973a3,0,0,0,0,0,0,0,0,0,0,0,0,0,0,146,6,0,0,0,0,0,0,0,0,0,100
8fa1312a50ec65a250de8df72794c061654cd9c9,3,25,11,14,0,0,0,1,26,71,1,2,1.369471138,1036,147,7,325,325,0,8183,8032,151,158,157,1,100
43884c872df6d638d67a4584391bd79802dbbaa2,0,0,0,0,0,0,0,0,0,0,0,0,0,0,148,8,0,0,0,0,0,0,0,0,0,100
ff753de85e2216415f8fda01c814af11da13c90f,0,0,0,0,0,0,0,0,0,0,0,0,0,0,12,7,0,0,0,0,0,0,0,0,0,100
57d8f4535d9321d47dccd2148c4d0df40d011612,0,0,0,0,0,0,0,0,0,0,0,0,0,0,9,4,0,0,0,0,0,0,0,0,0,100
2bf0a95abdec4a7b49f2ec75200c7354b6df9564,0,0,0,0,0,0,0,0,0,0,0,0,0,0,10,5,0,0,0,0,0,0,0,0,0,100
9c9b79b536b55d252da46863e067705f52572ac5,0,0,0,0,0,0,0,0,0,0,0,0,0,0,11,5,0,0,0,0,0,0,0,0,0,100
60ad460b6fd8d8cdd2ba3cf6b533bc0a94d7a521,0,0,0,0,0,0,0,0,0,0,0,0,0,0,149,9,0,0,0,0,0,0,0,0,0,100
c4e01e1353f25e5acc40cacba02b753430b84a31,0,0,0,0,0,0,0,0,0,0,0,0,0,0,150,10,0,0,0,0,0,0,0,0,0,100
dd75906e473d7df696bb73ebfea4207992444629,0,0,0,0,0,0,0,0,0,0,0,0,0,0,12,6,0,0,0,0,0,0,0,0,0,100
d9600ed0b2e237cc7fd0cb89319c724d3251ff00,0,0,0,0,0,0,0,0,0,0,0,0,0,0,151,10,0,0,0,0,0,0,0,0,0,100
1aa6a71c292d95f4f591713e4f8e51cf49822d8e,0,0,0,0,0,0,0,0,0,0,0,0,0,0,152,10,0,0,0,0,0,0,0,0,0,100
19684abe028c3362ca80884fd737a1ff6a44aad3,0,0,0,0,0,0,0,0,0,0,0,0,0,0,153,11,0,0,0,0,0,0,0,0,0,100
e2d1051e95de6628da5758bb91f2511e588d3eb1,0,0,0,0,0,0,0,0,0,0,0,0,0,0,154,12,0,0,0,0,0,0,0,0,0,100
148436898364857155f03278e3eff328403f7226,0,0,0,0,0,0,0,0,0,0,0,0,0,0,155,13,0,0,0,0,0,0,0,0,0,100
43bcac65cdd6cd43f73714eb3d72a51c406d8feb,2,61,0,61,1,0,1,1,2,34,1,2,0.208180946,28,156,14,12,6,6,521,212,309,4,3,1,99.23664122
d0d4e91341d00075cc46eb3ced62761644ce2c6e,0,0,0,0,0,0,0,0,0,0,0,0,0,0,13,6,0,0,0,0,0,0,0,0,0,100
fd1d9077277695e8f5668c062289f9d17bb9981a,2,107,10,97,0,0,0,1,23,58,1,2,0.971941752,353,157,15,111,105,6,3334,2778,556,32,27,5,98.87218045
e0c709a3b29bdd335a9b604fb94580003f54c6af,2,12,13,1,0,0,0,1,24,13,1,1,0.634309555,535,158,16,175,175,0,4365,4365,0,36,36,0,100
c854cd83e69bc220cd472e4006086c043efb4cc8,3,7,8,1,0,0,0,1,11,243,1,3,1.456564762,223,159,17,31,31,0,1785,1758,27,24,24,0,100
234893c3d0ff9c18fd2b90e5c7ea0b0a9a0b2762,14,681,89,592,1,0,1,1,21,67,1,5,2.778364912,1621,160,17,630,516,114,16708,13276,3432,240,175,65,74.56359102
56d154f53715a3234a7cafd5fca4bbeb15999f6c,0,0,0,0,0,0,0,0,0,0,0,0,0,0,161,18,0,0,0,0,0,0,0,0,0,100
6d882a3832cd9ecf2d15568dd74ff30c9c2cfe83,0,0,0,0,0,0,0,0,0,0,0,0,0,0,13,7,0,0,0,0,0,0,0,0,0,100
6b3399f6ea202f570ad92deb26652a5480da2717,0,0,0,0,0,0,0,0,0,0,0,0,0,0,14,8,0,0,0,0,0,0,0,0,0,100
6bf016960332ba751f3e1124e11b5993fc75e070,0,0,0,0,0,0,0,0,0,0,0,0,0,0,15,9,0,0,0,0,0,0,0,0,0,100
91856e0e927a07b4e6940cdb48d99261b1dbaa18,0,0,0,0,0,0,0,0,0,0,0,0,0,0,16,10,0,0,0,0,0,0,0,0,0,100
6dcb9a03a1d161425cf722d9b5dea06ffe56e675,0,0,0,0,0,0,0,0,0,0,0,0,0,0,162,19,0,0,0,0,0,0,0,0,0,100
f1b61e8f9d5ae1c5e0f155ff1ebeb40e4e2295eb,4,65,11,54,0,0,0,1,25,28,1,3,1.967788463,399,163,20,119,113,6,3412,3192,220,30,26,4,100
ba55ccc8e773ecbb0e71b13997c628b82f40eeac,4,26,8,18,0,0,0,1,27,16,1,3,1.866196857,968,164,21,310,305,5,7649,7563,86,151,149,2,94.83101392
913074da585f2737160b962aca0b905bb283012a,0,0,0,0,0,0,0,0,0,0,0,0,0,0,17,11,0,0,0,0,0,0,0,0,0,100
c7fe3355d2c8d966179aa8ff3189f354bc252ceb,8,147,68,79,0,0,0,1,19,89,1,5,1.744240214,993,165,20,270,251,19,8516,7967,549,101,94,7,100
21b3430f67fd55dbdd508e9593e522705247680f,0,0,0,0,0,0,0,0,0,0,0,0,0,0,166,17,0,0,0,0,0,0,0,0,0,100
e0839ab5642e57853443d7388565c5acd6311ee3,0,0,0,0,0,0,0,0,0,0,0,0,0,0,167,18,0,0,0,0,0,0,0,0,0,100
a976791d656760a9d724276d31bed869f6396fde,2,133,57,76,0,0,0,1,28,45,1,2,0.547246947,911,168,16,274,254,20,7652,7012,640,145,139,6,100
7c655949f7bd1bc0896181545204665ff0a8ed87,0,0,0,0,0,0,0,0,0,0,0,0,0,0,0,0,0,0,0,0,0,0,0,0,0,100
8fca9cd353d16aa7396fb91c4b9a7cb4660d23fd,5,130,201,71,1,0,1,1,20,23,1,3,1.850495335,746,169,7,170,179,9,5595,5771,176,72,86,14,92.91666667
3abbd30b6ea58ef7916699d5715ebc343e49cf8e,6,40,16,24,0,0,0,1,22,15,1,4,2.406669265,1312,170,8,396,389,7,10836,10629,207,130,127,3,100
47646602d304105ec8edac22be3ac8dd9b0bbe38,8,111,7,104,1,0,1,1,23,22,1,3,2.733285855,1394,171,6,397,382,15,11731,11230,501,153,146,7,99.59183673
2bf92732789f7cb1ec25be368fe76f6ad8007848,2,33,0,33,0,0,0,2,29,16,1,2,0.745517843,983,1,1,277,274,3,7758,7652,106,147,145,2,100
4e4ef4f8834a17e879113bf9f6fc465859d2f548,5,70,14,56,0,0,0,1,23,9,1,3,2.112063347,926,172,6,262,252,10,8111,7566,545,92,90,2,100
cfd4b63a8bb9244e3c1cdd48fffe2dd429f8e48d,2,34,53,19,0,0,0,1,26,68,1,2,0.442958679,445,173,5,110,113,3,3188,3381,193,34,34,0,100
a87b0c1be09e0449a2c941ea542ce0f22639fdb1,2,40,19,21,0,0,0,2,30,18,1,2,0.81792525,998,174,6,278,277,1,7889,7758,131,148,147,1,100
3fde11fc9af39832b871b098f18a90b15c079e82,0,0,0,0,0,0,0,0,0,0,0,0,0,0,175,7,0,0,0,0,0,0,0,0,0,100
39c4b9c04f2232e71cca1e2f29dbc4e3319c9edf,2,10,8,2,0,0,0,1,24,58,1,2,0.764204507,355,176,8,102,102,0,3103,3117,14,26,26,0,100
c5df78537022403f7725b273c1d9371e345cf905,4,15,10,5,0,0,0,1,27,88,1,3,1.874444455,421,177,0,117,117,0,3272,3251,21,30,30,0,100
e2b5b07fea44c4400386da565e880900fadfa7ea,0,0,0,0,0,0,0,0,0,0,0,0,0,0,178,1,0,0,0,0,0,0,0,0,0,100
1acc9913afd9bee7ad319ffd789a6e47a2e7baa8,0,0,0,0,0,0,0,0,0,0,0,0,0,0,179,2,0,0,0,0,0,0,0,0,0,100
4471c7079a4e7cc62ff6d67cfe22b078a6bbe4af,11,730,24,706,9,0,9,1,5,36,1,4,3.198549137,385,180,3,131,81,50,5516,2489,3027,65,35,30,92.63565891
1d125b4a4fdabf0bf55f27d092226a53d70427ac,10,382,331,51,1,0,1,1,15,96,1,4,2.431137363,1036,181,4,175,162,13,7549,7820,271,89,82,7,97.61029412
2310971c1ca6e632a938266f68921b0221a80d61,4,14,0,14,0,0,0,1,15,246,1,2,1.610577243,486,182,5,79,77,2,3886,3810,76,38,36,2,100
d0b76375fb71ea127d0d0f2ef38b9712efce36da,3,85,34,51,0,0,0,1,28,31,1,3,0.929398973,719,183,6,147,143,4,5570,5342,228,63,63,0,99.81751825
162726205705d4130e4090e4c4aa24d9e7ef34a6,4,235,1,234,2,0,2,1,31,11,1,3,1.017979253,773,184,7,283,253,30,7117,6099,1018,134,122,12,96.92585895
09077d848518150782f9a44c08d25699fbd680a1,1,1,1,0,0,0,0,2,32,0,1,1,0,726,185,8,245,245,0,5740,5741,1,119,119,0,100
939eb8a8a6f5fb7239432eb0bc42730153d46c92,1,4,2,2,0,0,0,1,2,0,1,1,0,97,186,9,19,19,0,675,669,6,9,9,0,100
e5631c1b774681f92de43f9f7d6ec64ae15d5c9b,6,335,1,334,3,0,3,1,7,0,1,3,2.010706158,412,187,10,110,86,24,4271,2607,1664,54,37,17,96.58703072
3b522378847be1e45c11024f153dbac7f83c9c67,0,0,0,0,0,0,0,0,0,0,0,0,0,0,188,11,0,0,0,0,0,0,0,0,0,100
2faea630242fa636cbb123597f47d2216e159136,0,0,0,0,0,0,0,0,0,0,0,0,0,0,189,12,0,0,0,0,0,0,0,0,0,100
b0e42bf54f6575ffadd2766582cf01633d6061d7,2,116,0,116,2,0,2,1,1,0,1,2,0.992266639,0,190,13,8,0,8,421,0,421,8,0,8,98.14814815
8911c848b1625d911a99ab846c4000985c74758c,2,3,2,1,0,0,0,1,8,314,1,1,0.970950594,139,191,14,26,26,0,902,885,17,14,14,0,100
fee963d618d493bf630fc0afdfbc1eb8d74b5362,0,0,0,0,0,0,0,0,0,0,0,0,0,0,192,15,0,0,0,0,0,0,0,0,0,100
0def48146dd7e2590a41f9da2c025d4024865ccc,0,0,0,0,0,0,0,0,0,0,0,0,0,0,193,16,0,0,0,0,0,0,0,0,0,100
e5d6f00462a43a94edd3ad1e4266443c63ecf51c,10,1053,0,1053,10,0,10,1,1,0,1,2,3.16305332,0,194,17,94,0,94,4550,0,4550,68,0,68,95.93908629
d933c26e39b707dcfeeff28a089a085506cba5e2,0,0,0,0,0,0,0,0,0,0,0,0,0,0,195,18,0,0,0,0,0,0,0,0,0,100
7b13b5dda2f7014ed15d86887a963299232ca1d2,9,222,40,182,1,0,1,1,33,73,1,6,2.827344862,2638,196,19,759,738,21,21917,20871,1046,307,293,14,99.67213115
853d0a7c72fbecb76748ea0ff7f4bf31f6529e6a,4,46,27,19,0,0,0,2,30,82,1,4,1.515272249,853,197,20,206,207,1,6725,6585,140,86,87,1,100
6a9539134694a73e1dd5bdded697461ac88b4744,7,52,42,10,0,0,0,1,25,67,1,4,1.769104212,1210,198,21,385,381,4,9971,9876,95,134,129,5,100
8fc362ad49300d2aa145c0e0e118851fbcc563b6,2,39,2,37,1,0,1,1,20,0,1,2,0.534943699,407,199,22,168,164,4,3519,3417,102,51,49,2,96.32587859
8697acfffac7f9d677793ea65ad3d66143b6963d,0,0,0,0,0,0,0,0,0,0,0,0,0,0,2,0,0,0,0,0,0,0,0,0,0,100
5d6bcad33de3aec97c4de7a2ff143a728837b5c1,0,0,0,0,0,0,0,0,0,0,0,0,0,0,200,23,0,0,0,0,0,0,0,0,0,100
7c85a78d59b838852273934706bd394df56c23ee,0,0,0,0,0,0,0,0,0,0,0,0,0,0,201,24,0,0,0,0,0,0,0,0,0,100
3765440645e1dd8a585a11fb14476334ed54f1e8,0,0,0,0,0,0,0,0,0,0,0,0,0,0,202,25,0,0,0,0,0,0,0,0,0,100
5979ad309e117fed1d59c3610255fe16852d8d60,14,68,67,1,0,0,0,1,23,94,1,4,3.308866249,1631,203,26,279,279,0,12943,12764,179,169,169,0,100
666ef349f0d5700803cc24ac38b1216e926d1519,0,0,0,0,0,0,0,0,0,0,0,0,0,0,204,27,0,0,0,0,0,0,0,0,0,100
2b43cbdc5d51752325dd9f29a669dcc532a1c6b0,137,2,2,0,0,0,0,1,1,0,1,19,1,13395,205,28,2782,137,2645,98473,34387,64086,1297,137,1160,22.72727273
198bdac00482ea898b6035e9cd6c96f00ea3f026,0,0,0,0,0,0,0,0,0,0,0,0,0,0,206,29,0,0,0,0,0,0,0,0,0,100
107cb5e18a20a09f19fb97e4e0f4a2652574ac09,0,0,0,0,0,0,0,0,0,0,0,0,0,0,207,30,0,0,0,0,0,0,0,0,0,100
820d85de389914cd414a0dac60ca4e9cca359b02,0,0,0,0,0,0,0,0,0,0,0,0,0,0,208,28,0,0,0,0,0,0,0,0,0,100
6b57b501c1c93efc5c6b42c511c4d3c19974a71a,1,1,1,0,0,0,0,1,2,2,1,1,0,737,209,29,247,247,0,5850,5850,0,122,122,0,100
56794b99650ef9343e7e7fd5b518391cfeaff032,0,0,0,0,0,0,0,0,0,0,0,0,0,0,210,30,0,0,0,0,0,0,0,0,0,100
f3820c4131858ee2c0781dfed445b239569e61cc,0,0,0,0,0,0,0,0,0,0,0,0,0,0,211,31,0,0,0,0,0,0,0,0,0,100
63a4e8c60a5aa8d269968e984b668c476ea18c36,1,4,4,0,0,0,0,1,2,5,1,1,0,161,212,32,24,24,0,1150,1149,1,9,9,0,99.85294118
e634f34b9abc17de550d37b249b5bc750e1e9f59,3,14,5,9,0,0,0,1,3,2,1,2,0.774243303,338,213,32,53,52,1,2456,2418,38,30,29,1,100
801eb60caf59f2af13fcc7edceb00787840716f6,1,22,0,22,0,0,0,1,2,5,1,1,0,356,214,33,38,38,0,2919,2604,315,32,32,0,100
1b0d92f9f1a06faafc698b8d170999cfd582dcfd,5,21,6,15,0,0,0,1,2,5,1,3,1.763965743,570,215,34,137,135,2,4448,4320,128,42,41,1,100
7e5266955d8c92e7c6f1b2f4de3f04d57759cc29,0,0,0,0,0,0,0,0,0,0,0,0,0,0,216,35,0,0,0,0,0,0,0,0,0,100
e72ac6c69b0e3e06c22a6a84394b4f64dafd7b3e,2,211,20,191,1,0,1,1,2,3,1,2,0.684038436,206,3,1,79,50,29,2425,1149,1276,45,29,16,98.80597015
e10a0be31a2495dcc9205a681e8401003e2a5bea,7,66,24,42,0,0,0,2,2,7,1,3,2.130710378,958,4,2,182,179,3,6393,6202,191,112,111,1,100
115547c97f36bd8cb8d95a85878eaed5d1074507,12,109,68,41,0,0,0,1,3,0,1,3,2.160812675,1938,5,3,437,432,5,12982,12909,73,204,200,4,100
e2619a8330a83f8a4f88a5dc055fa9cc2c606873,0,0,0,0,0,0,0,0,0,0,0,0,0,0,217,31,0,0,0,0,0,0,0,0,0,100
b6bd22843bec5f28b5c44af91c4e5fb2b1187f2b,0,0,0,0,0,0,0,0,0,0,0,0,0,0,218,30,0,0,0,0,0,0,0,0,0,100
aaa7f4764b7396fd2d1cb63058fbdf6209e829cb,0,0,0,0,0,0,0,0,0,0,0,0,0,0,219,31,0,0,0,0,0,0,0,0,0,100
eeb127e7edec95b9663f416cee4bebab9581e0e3,13,92,175,83,0,0,0,2,4,0,1,3,2.753568677,2071,220,32,433,441,8,13311,13575,264,203,208,5,100
55e42a83f141d22d2c69b27167def8380e89683c,0,0,0,0,0,0,0,0,0,0,0,0,0,0,18,0,0,0,0,0,0,0,0,0,0,100
516ad11ed8f9c3d2f7830a9b8624fc82cc2346ab,5,43,6,37,0,0,0,2,5,0,1,2,1.85201274,678,6,4,144,137,7,4572,4404,168,86,84,2,100
91afe7721577c98ceef926842a2a1faf4b806f39,12,136,79,57,0,0,0,2,6,0,1,3,1.956941249,1951,7,5,443,436,7,13148,12978,170,206,201,5,100
bbf437e11f1b6ccd16f3bc79cd09af077dc0f638,0,0,0,0,0,0,0,0,0,0,0,0,0,0,14,0,0,0,0,0,0,0,0,0,0,100
76315b92e96ff9ed61183d81124fc3acf6998249,4,9,6,3,0,0,0,2,2,12,1,2,1.832262897,310,8,6,35,35,0,2171,2129,42,21,21,0,100
4a0d5ae8a855c9f1b1260cd5eba802fcfc18dcf1,2,192,5,187,0,0,0,2,7,0,1,2,0.602809302,459,9,7,105,81,24,3922,2996,926,72,57,15,100
7ddcfd485ee59e909a107cf85b7af927f422c8c9,0,0,0,0,0,0,0,0,0,0,0,0,0,0,15,1,0,0,0,0,0,0,0,0,0,100
b844f7e03bbe8dd1b787d0c077c18a4a07330a01,0,0,0,0,0,0,0,0,0,0,0,0,0,0,16,2,0,0,0,0,0,0,0,0,0,100
771a96e26cab64a37d8dbbbcc898a2f0132db1c3,0,0,0,0,0,0,0,0,0,0,0,0,0,0,17,3,0,0,0,0,0,0,0,0,0,100
c11181848af28d91162a4f87647400eacaafcff5,0,0,0,0,0,0,0,0,0,0,0,0,0,0,221,32,0,0,0,0,0,0,0,0,0,100
93e81f7ce6480d3a18b7921e0263686a237bf0f6,0,0,0,0,0,0,0,0,0,0,0,0,0,0,222,33,0,0,0,0,0,0,0,0,0,100
ca085246f097b19ba44b84768568fc56e8dfbb87,2,19,4,15,0,0,0,1,2,20,1,2,0.828055725,421,223,34,172,168,4,3646,3519,127,53,51,2,99.84848485
b25e6a3de8adbc0a88c920e7d18ca96292835b1b,4,108,72,36,0,0,0,2,8,8,1,3,1.486663164,954,10,8,216,211,5,6819,6604,215,94,90,4,99.54614221
abd816c13c3e1af987e8a7b88face7f06288bde9,3,38,4,34,1,0,1,1,3,12,1,3,0.814227111,111,0,0,22,19,3,969,877,92,8,7,1,99.69879518
e3ddec6f5a87984a5d5358734f8ee5e26a6682df,0,0,0,0,0,0,0,0,0,0,0,0,0,0,18,4,0,0,0,0,0,0,0,0,0,100
904a5a7b36db75afa7f6471c005e67ef50fee665,0,0,0,0,0,0,0,0,0,0,0,0,0,0,19,5,0,0,0,0,0,0,0,0,0,100
558af6be61eaa44c36a7c45caaf184d9eae0ab33,0,0,0,0,0,0,0,0,0,0,0,0,0,0,224,33,0,0,0,0,0,0,0,0,0,100
015b9bc7c86d8eba331ebc2dc1aea05325444151,0,0,0,0,0,0,0,0,0,0,0,0,0,0,20,6,0,0,0,0,0,0,0,0,0,100
25009db0b89af97cc8d863a7bd355a55cb6c89c8,0,0,0,0,0,0,0,0,0,0,0,0,0,0,21,7,0,0,0,0,0,0,0,0,0,100
89593506cd9e34fc28bfe2d0be546ab7c9915ebe,0,0,0,0,0,0,0,0,0,0,0,0,0,0,22,8,0,0,0,0,0,0,0,0,0,100
06896f8e3a96f125d099c1b5311eb3e6238a31f9,0,0,0,0,0,0,0,0,0,0,0,0,0,0,0,0,0,0,0,0,0,0,0,0,0,100
77bb1e976a00ce949f5ca61421d43b08108e28e1,3,36,17,19,0,0,0,2,3,26,1,3,1.251880118,1468,1,1,419,414,5,11800,11692,108,190,186,4,100
9de8a8d9f7c13dca27df22fcd1ee4ffe696cd144,0,0,0,0,0,0,0,0,0,0,0,0,0,0,23,9,0,0,0,0,0,0,0,0,0,100
56f6af364fa4d8d20e1bf7ed138e8445586b1ac6,12,659,52,607,7,0,7,3,4,9,1,5,3.47026236,644,2,2,149,101,48,7002,4465,2537,88,54,34,97.65395894
7679cb3ca82f36c56238845e7c71b6139c34e8a0,0,0,0,0,0,0,0,0,0,0,0,0,0,0,24,10,0,0,0,0,0,0,0,0,0,100
01193b5705a8a36d0df95dd1e35ebfce3fc6c318,0,0,0,0,0,0,0,0,0,0,0,0,0,0,25,11,0,0,0,0,0,0,0,0,0,100
005f0a6a6d474f7e80b308a1cddbe73c5d061895,0,0,0,0,0,0,0,0,0,0,0,0,0,0,26,12,0,0,0,0,0,0,0,0,0,100
8590c10521e043f068999d182d616c80cd8b34e2,0,0,0,0,0,0,0,0,0,0,0,0,0,0,19,1,0,0,0,0,0,0,0,0,0,100
f24e3146f5515d4be9841bffd8840de492274d69,0,0,0,0,0,0,0,0,0,0,0,0,0,0,20,2,0,0,0,0,0,0,0,0,0,100
d5f3181c9bd0dae7597349302c4d9d0a822bdb6d,0,0,0,0,0,0,0,0,0,0,0,0,0,0,225,25,0,0,0,0,0,0,0,0,0,100
520b9b4f09dd9bec743be83722530133a7f1e3de,0,0,0,0,0,0,0,0,0,0,0,0,0,0,27,13,0,0,0,0,0,0,0,0,0,100
61aad5477d396fcb9dfa27ae660e05fcac0b2dc8,1,15,6,9,0,0,0,2,7,17,1,1,0,244,11,8,48,47,1,1667,1649,18,29,28,1,100
fbc0ac7c6c17e991e1dd6c3079df84efcbf3c0e7,0,0,0,0,0,0,0,0,0,0,0,0,0,0,12,9,0,0,0,0,0,0,0,0,0,100
ceba79182df36c355ad56298bdf33dc23d913264,0,0,0,0,0,0,0,0,0,0,0,0,0,0,28,14,0,0,0,0,0,0,0,0,0,100
27c7ad120beb6a432e3afa67acc9a532140cf6fd,1,12,5,7,0,0,0,2,3,36,1,1,0,207,13,10,49,48,1,1329,1288,41,29,29,0,100
26f53a11450952dc17b2248d6d08d18cb106acf7,3,16,8,8,0,0,0,2,6,36,1,1,1.040852083,514,14,11,104,101,3,3631,3609,22,79,78,1,100
8cbe31ef59354a9eff47aa82b13fd72650874b89,1,49,0,49,1,0,1,1,1,0,1,1,0,0,15,12,3,0,3,174,0,174,3,0,3,99.71428571
8a4ddb52579070a3744a2bb9a0baf42d5da6b0a5,1,1,0,1,0,0,0,2,5,33,1,1,0,361,16,13,79,79,0,2254,2246,8,36,36,0,100
c85ab4b4f9a40f760fe781542d50a414cf1393e4,6,77,17,60,1,0,1,3,4,14,1,3,1.591578524,471,3,3,68,64,4,3494,3175,319,49,45,4,99.29078014
c635452b1d8ce1f26364bfd18b118595bfed3945,0,0,0,0,0,0,0,0,0,0,0,0,0,0,4,4,0,0,0,0,0,0,0,0,0,100
2be9e693c4d68e1afac5a0c75d9e2de4d910c5df,0,0,0,0,0,0,0,0,0,0,0,0,0,0,29,15,0,0,0,0,0,0,0,0,0,100
e790f4837a3ee242a6e8b523ee4b10cb45d59bbc,0,0,0,0,0,0,0,0,0,0,0,0,0,0,30,16,0,0,0,0,0,0,0,0,0,100
0319db2a8fe241b364968693afbb9bd741ee148d,0,0,0,0,0,0,0,0,0,0,0,0,0,0,31,17,0,0,0,0,0,0,0,0,0,100
8f3ad160ce8c452bfbafc4ca09ab263a2e6aa06a,2,7,1,6,0,0,0,2,3,36,1,2,0.811278124,547,5,5,187,185,2,4586,4553,33,65,64,1,100
6915f0c35380fc41ba0af682ba0dc2c21f6cd5f3,0,0,0,0,0,0,0,0,0,0,0,0,0,0,32,18,0,0,0,0,0,0,0,0,0,100
b73d4499cb85dda67ba432ce156a22a74e78f142,0,0,0,0,0,0,0,0,0,0,0,0,0,0,21,2,0,0,0,0,0,0,0,0,0,100
3dfd487bf2a7b4f83b33f5ef9a9ed3e101bfe369,2,16,8,8,0,0,0,1,2,29,1,2,0.811278124,463,17,10,93,91,2,2921,2883,38,37,36,1,99.85875706
7a0078b786f0e3575fef5d98a8242c13530ceccd,5,255,19,236,1,0,1,1,9,20,1,4,1.786943458,993,18,10,249,217,32,7992,6837,1155,103,95,8,94.73684211
2e4f32687d9c6b669bcda7b8a0b42d71daf97a2c,8,89,39,50,0,0,0,3,5,11,1,3,2.735845517,817,6,6,133,124,9,5949,5732,217,75,74,1,96.72131148
6e4ae0b6566b795e14dadf6d1902cfbd69bbe2b7,4,18,7,11,0,0,0,2,10,19,1,3,1.681541933,914,19,9,195,195,0,6227,6208,19,72,72,0,100
1167caf735140964f5dcba441b76d99e7c9ceed1,2,26,2,24,0,0,0,2,8,0,1,2,0.591672779,449,20,10,102,102,0,3081,2929,152,15,15,0,100
bf7db0c2ecb2104fb087f0eea560a7d36935929c,3,20,5,15,0,0,0,2,9,21,1,2,0.916118214,1209,21,11,247,246,1,7365,7301,64,41,41,0,100
6c7b0e1396e9e6326f80a82515f4de44d4f0ebf9,2,86,2,84,0,0,0,2,4,32,1,2,0.658743531,1124,7,7,296,289,7,9611,8845,766,161,158,3,100
f86e0305115fdf9aaa90b19e3bb8ee58324a1406,13,116,79,37,2,0,2,1,4,45,1,4,3.088504419,1575,226,2,533,543,10,12743,12941,198,161,158,3,93.37121212
1b9263f5e8587f147c7d2920552c639f1bbf9759,2,14,1,13,0,0,0,1,5,0,1,2,0.836640742,442,227,2,175,173,2,3824,3730,94,55,54,1,100
7e4037de2a891fa738aaf8a4fc56f424d6c6833a,8,337,272,65,0,0,0,2,10,33,1,6,1.63685474,2397,22,11,654,684,30,18499,18860,361,293,280,13,99.88636364
a861b870bd09f49ecea1a56146a9edf8fc173cb1,0,0,0,0,0,0,0,0,0,0,0,0,0,0,8,7,0,0,0,0,0,0,0,0,0,100
1c5dc778b032b9b4bf5605e883b79fe36ce62363,0,0,0,0,0,0,0,0,0,0,0,0,0,0,33,10,0,0,0,0,0,0,0,0,0,100
e1e7220560d799b380d79c257dfc0aaac949a623,2,37,0,37,1,0,1,1,2,34,1,2,0.571354974,56,228,3,21,18,3,539,404,135,11,9,2,97.5308642
a27490c186343bce568e64075f4e4dbfe13945ea,0,0,0,0,0,0,0,0,0,0,0,0,0,0,229,4,0,0,0,0,0,0,0,0,0,100
00df8fbcb882af2c5f02e44483c07d2fe0c91a20,0,0,0,0,0,0,0,0,0,0,0,0,0,0,34,11,0,0,0,0,0,0,0,0,0,100
710f365be8bc4b94b690f3a669976c7675d54704,0,0,0,0,0,0,0,0,0,0,0,0,0,0,1,0,0,0,0,0,0,0,0,0,0,100
05b3442fbf6f20ede5212cbc8ce3c9b709341af2,0,0,0,0,0,0,0,0,0,0,0,0,0,0,2,1,0,0,0,0,0,0,0,0,0,100
441e55023dbb9774ac2fd6b6543968d63a0c1d42,0,0,0,0,0,0,0,0,0,0,0,0,0,0,3,2,0,0,0,0,0,0,0,0,0,92.25181598
cd1e3ed623a6edc0dba743dfc327ce5a4092d159,5,12,7,5,0,0,0,1,2,70,1,1,2.21260991,318,230,5,57,57,0,2201,2191,10,33,33,0,92.25181598
8c3259ba2089f1af607e60296a8de56292ea91b9,2,3,1,2,0,0,0,2,6,5,1,2,0.811278124,1198,231,6,298,297,1,9661,9643,18,162,162,0,100
62cba7ee3c6f0b73f1d195934b940b5061757a84,4,110,36,74,0,0,0,2,3,65,1,2,1.820612629,230,232,7,29,23,6,2097,1662,435,16,15,1,91.88235294
79c0980088a4e97c114e75c4f251db3f95b72618,0,0,0,0,0,0,0,0,0,0,0,0,0,0,233,8,0,0,0,0,0,0,0,0,0,100
b57e524fc1c9477515bb5ca9523b86f66461494c,0,0,0,0,0,0,0,0,0,0,0,0,0,0,35,12,0,0,0,0,0,0,0,0,0,100
340c58f3c11c90d1b678bd0ceea8dd4fdc90ff94,0,0,0,0,0,0,0,0,0,0,0,0,0,0,36,8,0,0,0,0,0,0,0,0,0,100
fc1935c78e8b885708edaa05adb790da9b63a4c8,0,0,0,0,0,0,0,0,0,0,0,0,0,0,37,9,0,0,0,0,0,0,0,0,0,100
e1c17e745462a8ac3d93ddef0bdaba3cdfac0a71,0,0,0,0,0,0,0,0,0,0,0,0,0,0,38,10,0,0,0,0,0,0,0,0,0,100
258d4191bf1c8030686d65e38db74534eb7f0a71,0,0,0,0,0,0,0,0,0,0,0,0,0,0,39,11,0,0,0,0,0,0,0,0,0,100
c06063a88b9956fab43db106157d5ea1c640fa37,0,0,0,0,0,0,0,0,0,0,0,0,0,0,40,12,0,0,0,0,0,0,0,0,0,100
f4e4771f13fc9bc7921f71c1b9e094d5a4309134,1,2,6,4,0,0,0,2,4,30,1,1,0,138,234,8,31,32,1,931,942,11,13,13,0,100
c8ee72a75cf26b5c364a8ec032e7d9235af8f469,0,0,0,0,0,0,0,0,0,0,0,0,0,0,41,12,0,0,0,0,0,0,0,0,0,100
835e48610941ae55f70c71c7542482f30500e961,18,367,157,210,0,0,0,2,10,37,1,8,2.616700083,4360,23,10,1234,1203,31,35331,34978,353,491,464,27,100
3e3f0fbe27d319893393f34a887b2ab427a038c0,0,0,0,0,0,0,0,0,0,0,0,0,0,0,235,9,0,0,0,0,0,0,0,0,0,100
5fa06695d45c1ae7afc6e7f7ad4716e0ff32886d,0,0,0,0,0,0,0,0,0,0,0,0,0,0,42,12,0,0,0,0,0,0,0,0,0,100
02b9415b1d31f0c4a5d8c52ca9821e18dd060d31,0,0,0,0,0,0,0,0,0,0,0,0,0,0,236,10,0,0,0,0,0,0,0,0,0,100
1d6b6c5549fd0086e0682d519527d879b1efda33,1,52,0,52,1,0,1,1,1,0,1,1,0,0,24,7,1,0,1,233,0,233,1,0,1,97.0959596
a2a731f3f58e82d58e6359c32d8c423eee63a3c8,0,0,0,0,0,0,0,0,0,0,0,0,0,0,4,3,0,0,0,0,0,0,0,0,0,100
c39ca5896e0d6c665c601666d2a9abf6aa0cd61a,0,0,0,0,0,0,0,0,0,0,0,0,0,0,5,4,0,0,0,0,0,0,0,0,0,100
f24c33c97cacbab60f6f3f0f5a26cb350c5cce28,0,0,0,0,0,0,0,0,0,0,0,0,0,0,6,5,0,0,0,0,0,0,0,0,0,100
ac2a19f791bfe80ce526139fcc3043f1972b0c34,0,0,0,0,0,0,0,0,0,0,0,0,0,0,7,6,0,0,0,0,0,0,0,0,0,100
89d56e9e23bee4db4c19a8f22d755a191e6cf0e5,0,0,0,0,0,0,0,0,0,0,0,0,0,0,237,9,0,0,0,0,0,0,0,0,0,100
dff585bd6876f20b5148ee2848e42e95d6ae94c2,0,0,0,0,0,0,0,0,0,0,0,0,0,0,238,10,0,0,0,0,0,0,0,0,0,100
c221b63f52afd4d2b2c75b45360eb41bb9e55b7b,0,0,0,0,0,0,0,0,0,0,0,0,0,0,239,11,0,0,0,0,0,0,0,0,0,100
6595bb6610b4a43060471b4d54d53c1b874fa851,0,0,0,0,0,0,0,0,0,0,0,0,0,0,240,12,0,0,0,0,0,0,0,0,0,100
281f46ff26ed61d76d65cdfbd6e79382a804d236,0,0,0,0,0,0,0,0,0,0,0,0,0,0,241,7,0,0,0,0,0,0,0,0,0,100
fcb06cfeebb753332463b4f0ed2b404e2ed3b5f4,0,0,0,0,0,0,0,0,0,0,0,0,0,0,242,8,0,0,0,0,0,0,0,0,0,100
674deee1e61c6ef21041951ad8db0771b4547a75,0,0,0,0,0,0,0,0,0,0,0,0,0,0,243,9,0,0,0,0,0,0,0,0,0,100
5d523b4d7f0f99cb0d231c05f847cda331d0fb4f,0,0,0,0,0,0,0,0,0,0,0,0,0,0,244,10,0,0,0,0,0,0,0,0,0,100
be98c2990d9d557e77424c0ea5d7b4b5a279a463,0,0,0,0,0,0,0,0,0,0,0,0,0,0,22,0,0,0,0,0,0,0,0,0,0,100
03e67154953150c38fbf92e079ada74aec75398d,24,1907,361,1546,2,0,2,2,11,60,1,6,2.784853928,4523,245,11,986,796,190,38787,32118,6669,445,354,91,90.73405535
2789bebdba3125304cf69747c95e80ba1e98fc67,0,0,0,0,0,0,0,0,0,0,0,0,0,0,246,12,0,0,0,0,0,0,0,0,0,100
1e9fe807f93282fe8c98cab35642ca160ec1e368,8,410,66,344,1,0,1,1,6,17,1,2,2.5427071,599,247,13,166,116,50,5866,4040,1826,88,69,19,99.31584949
728362023bc6fbef9130e979818aa358c9152635,0,0,0,0,0,0,0,0,0,0,0,0,0,0,248,14,0,0,0,0,0,0,0,0,0,100
af00ca67a7726c88f9e875f242cb09ea5a72f56f,1,1,1,0,0,0,0,3,7,3,1,1,0,195,25,2,28,28,0,1436,1436,0,12,12,0,100
c3a37aae3698172059b0f863d3d9fbdef21f140d,0,0,0,0,0,0,0,0,0,0,0,0,0,0,249,14,0,0,0,0,0,0,0,0,0,100
d5526daad1db62eec60e793b7278a47413a9e634,0,0,0,0,0,0,0,0,0,0,0,0,0,0,43,0,0,0,0,0,0,0,0,0,0,100
e5479e7b975bfc7c0251c49ba0bd40a0e1c46edd,0,0,0,0,0,0,0,0,0,0,0,0,0,0,44,1,0,0,0,0,0,0,0,0,0,100
e2c272282eb8911e286eb16c98dc2cd844eeae56,0,0,0,0,0,0,0,0,0,0,0,0,0,0,250,13,0,0,0,0,0,0,0,0,0,100
2b1580376f7ad813683a981657e9a88615397568,0,0,0,0,0,0,0,0,0,0,0,0,0,0,251,14,0,0,0,0,0,0,0,0,0,100
15bc535766bc375840b7f70915f68c1aad71b803,0,0,0,0,0,0,0,0,0,0,0,0,0,0,252,15,0,0,0,0,0,0,0,0,0,100
306ab962e91355e5d5843f787550ce748d732a38,0,0,0,0,0,0,0,0,0,0,0,0,0,0,253,16,0,0,0,0,0,0,0,0,0,100
65a762048fdf4ece99ebe105466f37861e89d0b2,0,0,0,0,0,0,0,0,0,0,0,0,0,0,254,14,0,0,0,0,0,0,0,0,0,100
5dac18f3862ee12ab03f2a94be0f675d7101b40d,0,0,0,0,0,0,0,0,0,0,0,0,0,0,255,14,0,0,0,0,0,0,0,0,0,100
40ded25b536fb66d0311a81708fd8ae333122c9c,0,0,0,0,0,0,0,0,0,0,0,0,0,0,45,2,0,0,0,0,0,0,0,0,0,100
cddf986ed92adb768d6a1f8a82a56facb808fefa,0,0,0,0,0,0,0,0,0,0,0,0,0,0,256,15,0,0,0,0,0,0,0,0,0,100
5fd2d18c75104effed0bd90f6726d03dba46a723,4,103,9,94,1,0,1,2,4,47,1,3,1.649481183,842,257,16,237,230,7,7743,7104,639,82,78,4,99.77272727
4313c25bb307d1c79f64cdb54104ba86a80edc60,11,79,35,44,1,0,1,1,4,83,1,5,3.201615584,880,258,17,153,146,7,6870,6750,120,92,89,3,99.77426637
97aa7f54862cb6386af67670ac1ecbccfa792419,0,0,0,0,0,0,0,0,0,0,0,0,0,0,46,3,0,0,0,0,0,0,0,0,0,100
9f1d7cdc003a26d0901bd975496bc403061b7003,0,0,0,0,0,0,0,0,0,0,0,0,0,0,47,4,0,0,0,0,0,0,0,0,0,100
a1368aa02fd7a5882cc0bb916742fcc9d5f0bdb1,0,0,0,0,0,0,0,0,0,0,0,0,0,0,48,5,0,0,0,0,0,0,0,0,0,100
4ed47ec7f88dca738f6c18c94d294b6fe7dd97b1,0,0,0,0,0,0,0,0,0,0,0,0,0,0,49,6,0,0,0,0,0,0,0,0,0,100
fc1f019c48bb677b460be103542cce4af12f3f06,0,0,0,0,0,0,0,0,0,0,0,0,0,0,50,7,0,0,0,0,0,0,0,0,0,100
3d190e5a2a735219cfc2118bbc5d4b297a0bb99a,0,0,0,0,0,0,0,0,0,0,0,0,0,0,51,8,0,0,0,0,0,0,0,0,0,100
114601653caf6a866e6b48f5c0622ed5683827fc,0,0,0,0,0,0,0,0,0,0,0,0,0,0,52,9,0,0,0,0,0,0,0,0,0,100
3c8d3aa06e74b586b8c83d37c110445b4a7e88ee,0,0,0,0,0,0,0,0,0,0,0,0,0,0,53,10,0,0,0,0,0,0,0,0,0,100
cd965b576f92f0ef2261b92ea13a20dcdc813d67,0,0,0,0,0,0,0,0,0,0,0,0,0,0,259,9,0,0,0,0,0,0,0,0,0,100
6513df9bf5b0d7d56cfa48f087dbaee28d622fde,0,0,0,0,0,0,0,0,0,0,0,0,0,0,54,9,0,0,0,0,0,0,0,0,0,100
44fe73d4f54cde76fd8064e930cacd96b78977b1,0,0,0,0,0,0,0,0,0,0,0,0,0,0,260,6,0,0,0,0,0,0,0,0,0,100
fe8f2de2ffb39e0fe6d3e633fed4564396d1b5cc,0,0,0,0,0,0,0,0,0,0,0,0,0,0,261,7,0,0,0,0,0,0,0,0,0,100
977cd22c129e69177d6fbf095f7f6ac7462cf1ab,1,2,1,1,0,0,0,2,7,62,1,1,0,188,262,8,46,46,0,1254,1245,9,19,19,0,100
36b5eae90d2f30950ba784cb66b15239c7ed7177,0,0,0,0,0,0,0,0,0,0,0,0,0,0,55,10,0,0,0,0,0,0,0,0,0,100
69d6017b4de1b0d449b7cf0f7a958546ba1ba897,0,0,0,0,0,0,0,0,0,0,0,0,0,0,56,11,0,0,0,0,0,0,0,0,0,100
02471d05b8043553a3f0436d45a96754ef62bb3d,0,0,0,0,0,0,0,0,0,0,0,0,0,0,263,4,0,0,0,0,0,0,0,0,0,100
6e01d187db9e6afa423f40779cf8f2ca7597a3a6,0,0,0,0,0,0,0,0,0,0,0,0,0,0,264,5,0,0,0,0,0,0,0,0,0,100
3432fe2379f3d9a808a4f7bf02945f5303633b24,0,0,0,0,0,0,0,0,0,0,0,0,0,0,57,11,0,0,0,0,0,0,0,0,0,100
37300016b27378e870dd6f48108792bc41e8ba3d,0,0,0,0,0,0,0,0,0,0,0,0,0,0,58,7,0,0,0,0,0,0,0,0,0,100
cd64e00c18831e2256751042899640e3764605a4,0,0,0,0,0,0,0,0,0,0,0,0,0,0,8,0,0,0,0,0,0,0,0,0,0,100
3131ef1f0ea5ab4bb72541a6a198a45ce0a0d559,0,0,0,0,0,0,0,0,0,0,0,0,0,0,9,1,0,0,0,0,0,0,0,0,0,100
e3123126b5b07d7a71e2e15f838d98f047597554,4,46,7,39,0,0,0,2,5,45,1,2,1.741795327,817,265,5,194,190,4,7270,6926,344,87,84,3,99.5505618
4e0cc6ed2ae8d93603f9c768aec6a91883a6b7b8,0,0,0,0,0,0,0,0,0,0,0,0,0,0,266,6,0,0,0,0,0,0,0,0,0,100
f33fb897c762b55b798dc5c43b6995b3c1ff202e,0,0,0,0,0,0,0,0,0,0,0,0,0,0,267,7,0,0,0,0,0,0,0,0,0,100
466dc8fc715889dbccd793e7fb7802dfcfe1063d,0,0,0,0,0,0,0,0,0,0,0,0,0,0,268,8,0,0,0,0,0,0,0,0,0,100
cdeb6ea2198cc94f450ca2ff949c0c198a4f8b00,13,1089,0,1089,13,0,13,1,1,0,1,2,3.637703795,0,269,4,104,0,104,5198,0,5198,64,0,64,95.67147614
492dc3b8f8a1b5dbf98b6c30b79b18ec87e7e89e,0,0,0,0,0,0,0,0,0,0,0,0,0,0,0,0,0,0,0,0,0,0,0,0,0,100
e7456bf58156eaf072e18416e90a6ec2494eae94,0,0,0,0,0,0,0,0,0,0,0,0,0,0,1,1,0,0,0,0,0,0,0,0,0,100
be73ec7ae269c3f503e55211add6b8cf9cb1fe50,0,0,0,0,0,0,0,0,0,0,0,0,0,0,2,2,0,0,0,0,0,0,0,0,0,100
9b8e375aea658b40495f91bfad343464d3824dfa,0,0,0,0,0,0,0,0,0,0,0,0,0,0,3,3,0,0,0,0,0,0,0,0,0,100
11dc42ad6478ab67d753a9f1b657cdaba0669b29,0,0,0,0,0,0,0,0,0,0,0,0,0,0,4,4,0,0,0,0,0,0,0,0,0,100
e18f9ca99b848f301b6349869d2512f706dc73f3,0,0,0,0,0,0,0,0,0,0,0,0,0,0,59,0,0,0,0,0,0,0,0,0,0,100
ed9239ee042925d1d37949e7954ae971fe391fc6,0,0,0,0,0,0,0,0,0,0,0,0,0,0,60,1,0,0,0,0,0,0,0,0,0,100
a23505906e4fe76706365ff7aa92f386fb6fcf97,0,0,0,0,0,0,0,0,0,0,0,0,0,0,10,0,0,0,0,0,0,0,0,0,0,100
f85120ba79690dc094ea33606facda1db19631ae,0,0,0,0,0,0,0,0,0,0,0,0,0,0,23,0,0,0,0,0,0,0,0,0,0,100
5c7b7486d1cbedbc006d5e9a7dfbcea7678a8311,0,0,0,0,0,0,0,0,0,0,0,0,0,0,5,5,0,0,0,0,0,0,0,0,0,100
ff664ef8a34de6dac9044875d4059c1493ce6528,0,0,0,0,0,0,0,0,0,0,0,0,0,0,6,6,0,0,0,0,0,0,0,0,0,100
e1311b64517df7b121eb4878b8bde174db88f0cf,0,0,0,0,0,0,0,0,0,0,0,0,0,0,7,7,0,0,0,0,0,0,0,0,0,100
0ac105e163d7fe4feaabc3d00521cf7e1d7d78d2,0,0,0,0,0,0,0,0,0,0,0,0,0,0,24,1,0,0,0,0,0,0,0,0,0,100
87b64a3b0530a433520bd32ca81858207bd64588,0,0,0,0,0,0,0,0,0,0,0,0,0,0,25,2,0,0,0,0,0,0,0,0,0,100
8c1db2821e3a0e87e7ab96498d4be14cb75f49d7,0,0,0,0,0,0,0,0,0,0,0,0,0,0,8,8,0,0,0,0,0,0,0,0,0,100
48da0df6c57ad2fd51ed91a971b44b415e17de4d,0,0,0,0,0,0,0,0,0,0,0,0,0,0,9,9,0,0,0,0,0,0,0,0,0,100
bc40723fc8aeeb0b57d83e8b2cbe1377d4a1ebe3,0,0,0,0,0,0,0,0,0,0,0,0,0,0,10,10,0,0,0,0,0,0,0,0,0,100
754bbd5a43f0156acaeb84bc2573274be1da8a69,0,0,0,0,0,0,0,0,0,0,0,0,0,0,11,11,0,0,0,0,0,0,0,0,0,100
9e422555234952d9d7090d14d86eb25e8114c586,0,0,0,0,0,0,0,0,0,0,0,0,0,0,26,3,0,0,0,0,0,0,0,0,0,100
66243cb6fd778eeb5c2dc960b0430584088fc943,0,0,0,0,0,0,0,0,0,0,0,0,0,0,27,4,0,0,0,0,0,0,0,0,0,100
1857557df701c5c27093dd2762cd60110f06a5f3,3,33,1,32,0,0,0,2,12,203,1,3,1.395123307,494,26,0,116,115,1,3686,3602,84,46,45,1,100
3b1b3f0d79608c32df9acebcac1dd757ea3fef24,2,60,44,16,0,0,0,2,2,64,1,1,0.998932655,121,27,1,18,18,0,1047,985,62,10,10,0,100
00c23392cc9a6a902217d58a5f20360163b61450,1,3,6,3,0,0,0,3,7,199,1,1,0,254,28,2,48,48,0,1818,1839,21,29,29,0,100
93a483eb1efafadd9cac2e104ecbe31ae2b9451d,0,0,0,0,0,0,0,0,0,0,0,0,0,0,12,0,0,0,0,0,0,0,0,0,0,100
bbcfd0b3e23062b1f33e9f81eb94ff0c2093ad41,0,0,0,0,0,0,0,0,0,0,0,0,0,0,13,1,0,0,0,0,0,0,0,0,0,100
0c4cb52cbdc1b12732ec154dcfc70594ea9e9088,0,0,0,0,0,0,0,0,0,0,0,0,0,0,11,0,0,0,0,0,0,0,0,0,0,100
7a42efd0d6c07d85f89c46ced85bf3949f60fc02,0,0,0,0,0,0,0,0,0,0,0,0,0,0,12,1,0,0,0,0,0,0,0,0,0,100
3f7443f350516b697e9e409c757c432be4540662,0,0,0,0,0,0,0,0,0,0,0,0,0,0,13,2,0,0,0,0,0,0,0,0,0,100
0fa29793bb738f3b1848063806c6fb53d44fca01,0,0,0,0,0,0,0,0,0,0,0,0,0,0,14,3,0,0,0,0,0,0,0,0,0,100
c22739175bc664887b4195f58cdec1e63e15959e,0,0,0,0,0,0,0,0,0,0,0,0,0,0,270,0,0,0,0,0,0,0,0,0,0,100
d77c7ecb8e3438e4ca4b25dd28373b3ae05a5c49,0,0,0,0,0,0,0,0,0,0,0,0,0,0,0,0,0,0,0,0,0,0,0,0,0,100
627d42de01bbd935ac469ff0ca0af135b75cef1e,3,31,0,31,0,0,0,2,7,307,1,2,1.358584608,457,271,1,180,175,5,3983,3790,193,57,55,2,99.67105263
0d274c9617ee25f51abfcef572e881b93e8216b7,2,18,3,15,0,0,0,2,6,150,1,2,0.998363673,752,272,2,179,177,2,6665,6583,82,72,71,1,100
dd7d8f60f47002c6c785c59783b66ea5abf4bc60,20,301,97,204,0,0,0,1,5,302,1,4,3.363037747,1843,273,3,404,343,61,15295,14254,1041,186,164,22,100
c2d9f070a66e2dd4203a8474ff8d53e4a6e0f406,0,0,0,0,0,0,0,0,0,0,0,0,0,0,274,4,0,0,0,0,0,0,0,0,0,100
4c8ef34d89fd8ff2277c901a092c961bebe3269a,0,0,0,0,0,0,0,0,0,0,0,0,0,0,14,0,0,0,0,0,0,0,0,0,0,100
e70a61217cd55cf6449b814b49a02939363b120d,0,0,0,0,0,0,0,0,0,0,0,0,0,0,0,0,0,0,0,0,0,0,0,0,0,100
37f6d5bc4ffdb794c4a7e03c5e2dd073c6d50cf4,0,0,0,0,0,0,0,0,0,0,0,0,0,0,1,1,0,0,0,0,0,0,0,0,0,100
9c81a5237f5c72819ec66e8e7a1e87f3c71afc35,0,0,0,0,0,0,0,0,0,0,0,0,0,0,2,2,0,0,0,0,0,0,0,0,0,100
a2365d95f8b7a8d20730a44654b2a20215bf9156,0,0,0,0,0,0,0,0,0,0,0,0,0,0,15,0,0,0,0,0,0,0,0,0,0,100
e9c1d6396e4178b837181a624b65a958af03fd34,0,0,0,0,0,0,0,0,0,0,0,0,0,0,16,1,0,0,0,0,0,0,0,0,0,100
9c3095aeab368e4984fde046e10d0c274cf240c0,0,0,0,0,0,0,0,0,0,0,0,0,0,0,3,3,0,0,0,0,0,0,0,0,0,100
b79cc95f1c33e84ec79c32abddf7bb2551440f0d,0,0,0,0,0,0,0,0,0,0,0,0,0,0,4,4,0,0,0,0,0,0,0,0,0,100
7eaba5aa09a2bff529590a1c309b9575a25a497e,0,0,0,0,0,0,0,0,0,0,0,0,0,0,15,1,0,0,0,0,0,0,0,0,0,100
5949f5e5a36e47dc613b250a9b7f279f306240d0,0,0,0,0,0,0,0,0,0,0,0,0,0,0,16,2,0,0,0,0,0,0,0,0,0,100
3604f4fd70c81c782d26b7f7b0c2d6fa54240ae2,0,0,0,0,0,0,0,0,0,0,0,0,0,0,275,0,0,0,0,0,0,0,0,0,0,100
1b5c4e428e3ac83bee7d0a73e518880819f34541,0,0,0,0,0,0,0,0,0,0,0,0,0,0,276,1,0,0,0,0,0,0,0,0,0,100
cb3dab05528ea8597fa41d4c09618b2907d544d8,0,0,0,0,0,0,0,0,0,0,0,0,0,0,277,2,0,0,0,0,0,0,0,0,0,100
8dfd1a6027d2c293fac298c3197567b80c2f0402,0,0,0,0,0,0,0,0,0,0,0,0,0,0,17,2,0,0,0,0,0,0,0,0,0,100
9b31fdd70fcd6aa0bac31f6d91256d1df81a86c8,0,0,0,0,0,0,0,0,0,0,0,0,0,0,18,3,0,0,0,0,0,0,0,0,0,100
05cc368353d72c798b261d9dbfcee05d8c7cdaa5,0,0,0,0,0,0,0,0,0,0,0,0,0,0,17,2,0,0,0,0,0,0,0,0,0,100
a4c97afaf377cb1461faee2654a1a7c00e0a92c1,0,0,0,0,0,0,0,0,0,0,0,0,0,0,19,4,0,0,0,0,0,0,0,0,0,100
2660351b81bb6ea57f5c8c33a935600132db1d57,0,0,0,0,0,0,0,0,0,0,0,0,0,0,28,0,0,0,0,0,0,0,0,0,0,100
af73cd3f2d5249dd386dc299a9d4d1e4f9b3bec2,0,0,0,0,0,0,0,0,0,0,0,0,0,0,278,3,0,0,0,0,0,0,0,0,0,100
bed2354c5d0f773aedffc5299b4e18554e0b28ed,0,0,0,0,0,0,0,0,0,0,0,0,0,0,279,4,0,0,0,0,0,0,0,0,0,100
3c71a148c09d3951aaabdb7dcf6639d70905016f,0,0,0,0,0,0,0,0,0,0,0,0,0,0,20,3,0,0,0,0,0,0,0,0,0,100
50755b27a23a8ae8968f1126dbcff5ad91dd0a9f,0,0,0,0,0,0,0,0,0,0,0,0,0,0,21,4,0,0,0,0,0,0,0,0,0,100
7da52d806e8ad31fe039140e461ab7986fa7d948,0,0,0,0,0,0,0,0,0,0,0,0,0,0,22,5,0,0,0,0,0,0,0,0,0,100
e6407b570ecbb06e93efe178194bd3fe33bfb0e5,0,0,0,0,0,0,0,0,0,0,0,0,0,0,23,6,0,0,0,0,0,0,0,0,0,100
2bce9ea43fada2e40501477af25c94c0f5fa771e,0,0,0,0,0,0,0,0,0,0,0,0,0,0,280,5,0,0,0,0,0,0,0,0,0,100
cac9e93d3984bf05f67c86fba0d7024b82469ae1,29,1624,58,1566,15,0,15,1,8,128,1,12,4.298145929,1762,281,6,624,437,187,21704,14058,7646,285,184,101,88.83034773
2ca528fa31870b767f7d89550d8781c40c6b8bcf,3,140,0,140,1,0,1,1,3,128,1,2,1.14022707,138,282,7,30,16,14,1902,1120,782,20,8,12,97.97979798
76bf17aaebe0ac8a6bd3d0c787a9e4616a00f5b1,0,0,0,0,0,0,0,0,0,0,0,0,0,0,283,8,0,0,0,0,0,0,0,0,0,100
3e8840cd1454bb16d170c9dec2b1f2b40171bdc8,1,0,0,0,0,0,0,1,1,0,1,1,0,30,284,9,5,5,0,241,241,0,3,3,0,99.59758551
bbb830dff638cb1e80395941db1d0e0b58103eff,2,47,9,38,0,0,0,1,6,281,1,2,0.924133542,526,285,10,131,127,4,4150,3859,291,39,38,1,100
5874b2ab91721eaae00afb492b5b52bf58e0335f,0,0,0,0,0,0,0,0,0,0,0,0,0,0,24,7,0,0,0,0,0,0,0,0,0,100
9c56ed4e8af0f977fe76f82d231757c2563d2094,4,244,7,237,2,0,2,1,5,102,1,1,1.648237882,99,286,8,32,14,18,1909,760,1149,14,7,7,88.58921162
26fb764f5bbf47abd0531c1e8633386171c1e1bf,3,19,19,0,0,0,0,1,6,0,1,2,1.210810026,209,287,9,40,48,8,1553,1891,338,16,22,6,99.14346895
5cbc5e25099098ff17761b21fedc3581b27d05fc,3,170,5,165,1,0,1,2,2,326,1,2,1.563853487,187,9,0,52,32,20,2132,1345,787,33,23,10,99.24973205
0fcfe2863c26eb73d5cec07a6d552b0d130f362b,7,120,31,89,0,0,0,1,5,246,1,2,2.494648942,657,288,7,139,130,9,5488,5096,392,69,63,6,100
14b6af1c75a552e6d0718a1e9fde95f18a394bc3,0,0,0,0,0,0,0,0,0,0,0,0,0,0,289,3,0,0,0,0,0,0,0,0,0,100
f739842c9055909dbd9bf8fc6e49dcd34661b84f,4,635,0,635,4,0,4,1,1,0,1,2,1.836714815,0,290,4,59,0,59,3086,0,3086,43,0,43,96.8238691
7f5901e8bdc281305ab29a32fd5630c5024b4feb,3,15,3,12,0,0,0,2,11,356,1,2,1.122113677,651,29,0,114,114,0,4147,4087,60,23,23,0,100
d4a3c058e80030e85eb5dbe4b9d2a44819b22202,22,50,16,34,0,0,0,1,6,264,1,7,3.195262175,1451,291,0,181,180,1,11135,10996,139,123,121,2,100
76088c6238f58ba05a5c891e3439b288ef0d0bc5,2,27,24,3,0,0,0,1,3,2,1,2,0.139232999,151,292,1,13,12,1,1133,1122,11,11,10,1,100
905586f88119ff02fb5eb9c3c713c6f6bad2301d,3,383,74,309,0,0,0,2,4,381,1,2,1.411381262,269,10,0,54,31,23,3933,2005,1928,33,23,10,99.2139738
a90142c5321e6d48b46da96bc11fb56389cb6bb0,3,71,380,309,0,0,0,2,5,0,1,2,1.418782847,527,293,2,31,54,23,2005,3933,1928,23,33,10,99.2139738
ce35df9fb9c907883e9cede03109765e900248e7,29,1185,424,761,9,0,9,1,8,181,1,9,3.92073633,1644,294,3,393,278,115,17862,12919,4943,260,162,98,89.93288591
1c37d4cee7042d64acc446007b30c99357c158b9,1,3,1,2,0,0,0,2,7,113,1,1,0,345,295,4,107,107,0,2654,2636,18,25,25,0,100
0457a5785252d997d93cebb4c275e2a355577d75,5,459,74,385,2,0,2,2,6,12,1,2,1.959087684,269,11,1,59,31,28,4187,2005,2182,36,23,13,97.23991507
2dc24e02526e29a3bd385276d7db162f8624fc65,6,77,5,72,0,0,0,2,7,256,1,4,2.450371212,546,296,5,91,79,12,4554,4194,360,66,62,4,100
53aca6d7e502e83f1c38e8926ae671b026bd3872,2,77,40,37,0,0,0,3,9,282,1,2,0.421166015,1354,297,4,338,329,9,10703,10376,327,193,189,4,100
cc369c8d7ac793349eecf0fcdfe1ee82f79c6f88,1,6,0,6,0,0,0,3,9,0,1,1,0,871,298,5,283,281,2,6587,6549,38,142,142,0,100
5aa8b0cccef971441fcda29b86eee652ee6884a3,0,0,0,0,0,0,0,0,0,0,0,0,0,0,299,6,0,0,0,0,0,0,0,0,0,100
2182b994ccaaeff046c37965d99a75a6709aa692,3,20,12,8,0,0,0,1,7,322,1,3,1.014097656,301,300,7,97,96,1,2440,2424,16,39,38,1,100
4c6d01f9bc333e20cf44f603804ce28bc7612501,0,0,0,0,0,0,0,0,0,0,0,0,0,0,301,6,0,0,0,0,0,0,0,0,0,100
819709d877b8f21d4c680d8d1a91f70cfd6bbadb,14,2358,4,2354,13,0,13,1,6,8,1,3,3.442132587,184,12,1,217,33,184,13504,1432,12072,82,9,73,94.59459459
a71d0cf565522bac947fd25f8da16e90d59b4b81,1,3,2,1,0,0,0,2,2,2,1,1,0,138,302,7,8,8,0,1585,1574,11,5,5,0,100
de5d14395bed3d9eeae07c7a1d60975b6778e3d2,27,180,140,40,1,0,1,1,10,130,1,12,4.100905002,4672,303,7,1098,1089,9,37059,36977,82,486,482,4,93.90774587
d7041830569503ca674fe0600c0d18f3707779cd,2,4,2,2,0,0,0,2,3,626,1,2,0.650022422,90,304,8,8,8,0,609,588,21,5,5,0,100
de72584e5d5262f3c28f4b7be7ffd719482484d1,4,325,46,279,1,0,1,2,11,284,1,4,1.468546093,889,305,9,243,201,42,7291,5951,1340,141,107,34,99.1290578
230b96c418e4638d8529e1adbe61a195f142f0cd,4,66,1,65,0,0,0,1,4,60,1,2,1.669311823,254,306,9,41,32,9,2604,2132,472,25,20,5,100
5b06c3290bd7f43e9a1061aed66e1f751b885e05,8,641,12,629,2,0,2,1,3,16,1,2,1.835681021,586,13,1,151,79,72,7268,4127,3141,52,30,22,98.96988906
e213cfe5d3614e2826c87ea604796838e428ce9e,3,228,7,221,0,0,0,3,11,26,1,3,0.681162934,1652,307,10,485,425,60,14442,12855,1587,238,226,12,100
8349f69f13cafcb3b8de4e004725a85d6bdbc65c,1,8,1,7,0,0,0,2,9,21,1,1,0,347,308,11,107,107,0,2677,2654,23,25,25,0,100
a3a4644d45779fddb50789f7ea48ddaa2d1f1afc,2,7,6,1,0,0,0,1,2,182,1,2,0.619382195,144,309,7,30,30,0,1024,1026,2,12,12,0,100
094c95b0a7ce084a1dd97776bc67d0f84786af08,0,0,0,0,0,0,0,0,0,0,0,0,0,0,310,8,0,0,0,0,0,0,0,0,0,100
7afee340172a95bf1d7df4038ce615448f719a0d,2,16,0,16,0,0,0,3,12,2,1,2,0.543564443,1588,311,9,402,400,2,12445,12351,94,206,205,1,100
77a7965f776d2e6932d0abaac69c0747ac33d2d6,2,52,22,30,0,0,0,3,13,12,1,2,0.727300679,681,312,10,104,98,6,5700,5511,189,76,74,2,100
8a0ee2eea940e235ec42f0203b293fc7c155f7ca,0,0,0,0,0,0,0,0,0,0,0,0,0,0,14,1,0,0,0,0,0,0,0,0,0,100
ec468882133c8ed33b3eeee9243b38f152727781,0,0,0,0,0,0,0,0,0,0,0,0,0,0,15,2,0,0,0,0,0,0,0,0,0,100
c62f97dd29b803040d573845f335ac1ecaa765d7,13,872,78,794,4,0,4,1,4,29,1,3,2.96061103,1039,16,3,263,168,95,11388,7462,3926,111,56,55,91.08989658
b2c40ab4701dbc1fd7a2968afd69ee431a96beef,0,0,0,0,0,0,0,0,0,0,0,0,0,0,313,10,0,0,0,0,0,0,0,0,0,100
0f0875da373007f87acd3ad6a8bd88b9b747494d,2,54,1,53,0,0,0,1,5,34,1,1,0.225363639,158,314,11,19,16,3,1728,1372,356,10,9,1,100
18249237dc0ff1623c14239519d798963ef93269,2,37,0,37,0,0,0,3,14,81,1,2,0.99947302,908,315,12,171,159,12,7076,6814,262,65,65,0,100
19dccec28aeb48d40b403de97502df1490e17f67,0,0,0,0,0,0,0,0,0,0,0,0,0,0,316,13,0,0,0,0,0,0,0,0,0,100
bb4d21dec8fd0ab0ae233332197b90a783218082,0,0,0,0,0,0,0,0,0,0,0,0,0,0,317,14,0,0,0,0,0,0,0,0,0,100
4d31386d2a9c184b349a6f50b45bcdf73e7bb3f7,0,0,0,0,0,0,0,0,0,0,0,0,0,0,17,4,0,0,0,0,0,0,0,0,0,100
94c4c520a055d7e32dde19bdafac8c6ccfd72d08,0,0,0,0,0,0,0,0,0,0,0,0,0,0,18,5,0,0,0,0,0,0,0,0,0,100
35bb270f96850e789372c9e68855a9727e64aa9c,4,200,150,50,0,0,0,1,9,382,1,2,1.83958346,686,318,12,142,133,9,4977,4746,231,74,64,10,100
ce397913a36beaf1077aa2f98cab98f9b2a0a45a,3,36,3,33,1,0,1,2,8,118,1,3,1.453147172,760,319,13,183,178,5,6739,6652,87,73,71,2,99.84301413
e0bbd4f474776009648b4f8389deefccbefb39a9,5,45,1,44,0,0,0,2,10,38,1,3,1.590506546,1393,320,14,412,404,8,11995,11637,358,155,152,3,94.6031746
6593926aed7eb2a142e32d2d58894738c3de0f51,0,0,0,0,0,0,0,0,0,0,0,0,0,0,321,15,0,0,0,0,0,0,0,0,0,100
8c2d1e975ddb3516e2c42de73d78f3d40556c13b,0,0,0,0,0,0,0,0,0,0,0,0,0,0,322,16,0,0,0,0,0,0,0,0,0,100
5355146c7a871aa70d4f8ed1ad6d82de516f1b96,6,17,11,6,0,0,0,2,8,39,1,4,2.113571995,795,323,16,128,128,0,6828,6799,29,53,53,0,100
4537345e599d764591ff4ccb2fd8e11efe5cbc67,1,1,0,1,0,0,0,1,8,0,1,1,0,162,324,17,29,29,0,1355,1346,9,6,6,0,100
61a54e4487501db5ce5ce3447363560fb0d880d6,0,0,0,0,0,0,0,0,0,0,0,0,0,0,18,0,0,0,0,0,0,0,0,0,0,100
c6cbf0b58c33dfc1db464aa439679e828dec7b3f,0,0,0,0,0,0,0,0,0,0,0,0,0,0,325,18,0,0,0,0,0,0,0,0,0,100
5a7bae1a5937682448a0b67ad0aaf19b7da49279,4,73,0,73,0,0,0,2,5,110,1,4,1.999597534,311,326,19,35,35,0,2294,2294,0,25,25,0,100
5d2ea9dc0e8ebbdeb3a99f47869ce245a4d4d441,4,102,26,76,1,0,1,1,4,6,1,2,1.46757542,638,19,6,114,104,10,5213,4717,496,59,53,6,99.78689398
bdedfc82349d9c3c4fa6fe8e55acefddd7a4d0b7,0,0,0,0,0,0,0,0,0,0,0,0,0,0,327,20,0,0,0,0,0,0,0,0,0,100
72d74a4d1548083846adc8f18fa53881b713df8c,0,0,0,0,0,0,0,0,0,0,0,0,0,0,328,21,0,0,0,0,0,0,0,0,0,100
90e38800b75f2ddc58a8ccb4fe160a060a419b6a,1,17,0,17,0,0,0,2,2,2,1,1,0,23,329,22,2,2,0,227,227,0,1,1,0,100
db2aff843fca366f96f98e3830811a4c0cfabbd1,0,0,0,0,0,0,0,0,0,0,0,0,0,0,330,23,0,0,0,0,0,0,0,0,0,100
91b8e3c3df7ac9afe8b45e9d6c713686fab49b55,7,274,3,271,3,0,3,1,5,10,1,2,2.195529186,828,20,6,107,83,24,6925,5845,1080,46,36,10,93.84800965
5bc80f6428c46f41e88ce70f8f23866da762f70f,0,0,0,0,0,0,0,0,0,0,0,0,0,0,331,24,0,0,0,0,0,0,0,0,0,100
2b664be8e81f68125e14b3b920ce5980fbd00120,8,49,61,12,0,0,0,3,15,63,1,4,2.682356251,2222,332,25,592,592,0,17488,17536,48,214,213,1,99.93036212
3418c6ed05c8bafaad7c3f4e94584aa6ac6e50e3,0,0,0,0,0,0,0,0,0,0,0,0,0,0,333,26,0,0,0,0,0,0,0,0,0,100
7d9919f7d80450bb7a7c0116820484d16444b6ae,0,0,0,0,0,0,0,0,0,0,0,0,0,0,334,27,0,0,0,0,0,0,0,0,0,100
fdfd71874ee5a66580dfabd27551ac3c2150c286,0,0,0,0,0,0,0,0,0,0,0,0,0,0,335,28,0,0,0,0,0,0,0,0,0,100
679c5317c3b60f7cb4ca7b799fdf97edf80c3e98,0,0,0,0,0,0,0,0,0,0,0,0,0,0,336,29,0,0,0,0,0,0,0,0,0,100
3af2f76c6d3f62785d4017c127b0a0657870eb03,0,0,0,0,0,0,0,0,0,0,0,0,0,0,337,30,0,0,0,0,0,0,0,0,0,100
cac87ab452a3b1ab60f02730db30e7b4977dae30,1,1,1,0,0,0,0,1,7,4,1,1,0,153,338,29,63,63,0,1327,1327,0,10,10,0,100
825c34115bfbd2e97fbd519ce9cb8e303c8a4e08,0,0,0,0,0,0,0,0,0,0,0,0,0,0,339,26,0,0,0,0,0,0,0,0,0,100
73feedb2d246bc9e89259e96a35e869e166fe248,2,36,0,36,0,0,0,3,8,582,1,2,0.710676854,311,340,27,58,53,5,2381,2193,188,29,27,2,100
8fed51d2d0faf08c744611b6feef61f853d43244,1,13,6,7,0,0,0,3,12,10,1,1,0,264,341,28,86,86,0,2146,2106,40,33,33,0,100
a3d6e2d839e1c1eeb81a08fdd1d3ad199326aee0,0,0,0,0,0,0,0,0,0,0,0,0,0,0,25,0,0,0,0,0,0,0,0,0,0,100
9b6148ddf8b1b7a231f06cdb41bb70fe263d48fc,0,0,0,0,0,0,0,0,0,0,0,0,0,0,342,5,0,0,0,0,0,0,0,0,0,100
9e3d6fd35ac79736f6339cedc5d94fe13d2f3fab,0,0,0,0,0,0,0,0,0,0,0,0,0,0,343,6,0,0,0,0,0,0,0,0,0,100
1086f2ae3dc617dfcb8fec7333d62e3e72217ac7,1,16,3,13,0,0,0,3,12,77,1,1,0,1045,344,7,347,343,4,8095,8009,86,154,153,1,100
25dabab47a6dcdaee4c291b47467b0e63a850357,0,0,0,0,0,0,0,0,0,0,0,0,0,0,30,0,0,0,0,0,0,0,0,0,0,100
3efcc1ed043bc4f9866a34d9d9206f75a8e0b905,2,69,13,56,0,0,0,3,12,215,1,2,0.999570839,493,0,0,195,188,7,4555,4094,461,64,62,2,88.62713241
f9c3ccc83b9b5f89c786a593c9bc23af10209f00,5,739,12,727,4,0,4,1,5,35,1,2,1.861840305,73,345,3,128,13,115,4457,474,3983,67,7,60,89.02439024
13bf69f3eda8d6046a61ffb3bf281e3dde3298f4,9,511,12,499,5,0,5,1,5,117,1,4,2.238594445,303,346,4,99,59,40,4935,2186,2749,68,40,28,99.17012448
3397abb9d37d1a84a9d26c2e90558fc4e4be26d9,2,64,12,52,0,0,0,3,6,712,1,2,0.850382117,234,21,0,31,23,8,1937,1584,353,16,14,2,100
13c020ed4a76f0da417cd72416cf96aabcee75cc,0,0,0,0,0,0,0,0,0,0,0,0,0,0,347,5,0,0,0,0,0,0,0,0,0,100
1ff170419245138b875bc315cdf51d51f34955cd,7,73,20,53,0,0,0,1,7,541,1,3,2.727557532,1212,348,6,271,264,7,8626,8427,199,160,152,8,100
b56ff0fecbf61869aa29d319f575187c0ef4f8b8,0,0,0,0,0,0,0,0,0,0,0,0,0,0,22,1,0,0,0,0,0,0,0,0,0,100
4bcde0be98a25e6246b8e56bd0786c75791401ec,0,0,0,0,0,0,0,0,0,0,0,0,0,0,61,0,0,0,0,0,0,0,0,0,0,100
b5097567812c1e09e91cc610bd0860c7cd16df4b,2,36,5,31,0,0,0,3,16,93,1,2,0.989245297,1646,349,0,418,411,7,12923,12739,184,209,208,1,100
f7245d4546960c783d48d6bba27465a8bb99b04b,0,0,0,0,0,0,0,0,0,0,0,0,0,0,350,1,0,0,0,0,0,0,0,0,0,100
4dda8ddb4f6ca16d11b908f5597e299bb7fd8d76,0,0,0,0,0,0,0,0,0,0,0,0,0,0,351,2,0,0,0,0,0,0,0,0,0,100
ff8221710612c83b365d105091c816caf90c22e2,0,0,0,0,0,0,0,0,0,0,0,0,0,0,352,3,0,0,0,0,0,0,0,0,0,100
48cbce8f86cc008c4d8f2e0685dae992ccab4922,0,0,0,0,0,0,0,0,0,0,0,0,0,0,353,4,0,0,0,0,0,0,0,0,0,100
4794325c1b416be59dfdc8c40d2d12d1cacc8b10,0,0,0,0,0,0,0,0,0,0,0,0,0,0,354,5,0,0,0,0,0,0,0,0,0,100
63ad1ce82e49b683a073745223a017057db8acab,0,0,0,0,0,0,0,0,0,0,0,0,0,0,355,6,0,0,0,0,0,0,0,0,0,100
954df1fc6c138b8213b7a8a3c6cb5a7888e51c7b,0,0,0,0,0,0,0,0,0,0,0,0,0,0,356,7,0,0,0,0,0,0,0,0,0,100
77f169d8e43f9cd919cb9ef2154878e821ce85ac,9,119,87,32,0,0,0,2,13,156,1,4,2.850944207,2068,357,4,629,626,3,17542,17278,264,229,229,0,99.93131868
dd8e3d56354a611ed79f765d2a6775bd7df3db7f,2,18,0,18,0,0,0,2,10,499,1,2,0.764204507,283,358,5,64,63,1,2048,1960,88,33,32,1,100
78d9518f26978baafb69670fefd1417a36bb10e7,14,28,25,3,0,0,0,1,7,312,1,6,3.211678467,937,359,6,135,135,0,7234,7208,26,90,90,0,100
ddf2947a0493dad44c4151689d20adc01a1870e0,2,32,2,30,0,0,0,3,17,62,1,2,0.672294817,1672,360,3,425,418,7,13147,12923,224,210,209,1,100
ba0a281322583b6d92bbea81ab37bdf849b1f5e3,1,4,2,2,0,0,0,2,13,201,1,1,0,358,361,4,107,107,0,2475,2455,20,11,11,0,100
efd4e04a712622b7a3df63b60e9b58f9a3f47d9c,5,492,182,310,2,0,2,1,18,88,1,3,1.777739445,1186,362,5,253,200,53,10609,9086,1523,111,94,17,99.51956074
c9e3bcf524da7c3618201aa2b7189ba54900e1e1,1,2,0,2,0,0,0,3,12,12,1,1,0,291,0,0,86,86,0,1923,1914,9,25,25,0,100
9ecce5d7f857f099bc3038e87c09974bae4b8b77,1,1,1,0,0,0,0,4,10,254,1,1,0,248,1,1,49,49,0,1762,1762,0,29,29,0,100
4d73af83a5ec618781a1476e55d60b5e3a6e72f5,4,227,2,225,2,0,2,1,11,120,1,3,1.145040263,313,2,1,76,59,17,3552,2289,1263,38,33,5,97.29916898
7adf61bb2083f9f027901fd63441b3bf06607fd5,3,127,16,111,0,0,0,2,6,256,1,2,0.829065741,256,3,2,40,31,9,2885,2208,677,29,23,6,97.78085992
0c52cf1c8f6ae6878787541fbc8973e8e71d9a8c,2,15,0,15,0,0,0,4,19,89,1,2,0.721928095,1695,4,3,426,425,1,13242,13155,87,211,210,1,100
5440e53a1a9792b3f67eaf3eedc0c7c5f38629e8,3,24,6,18,0,0,0,2,14,413,1,3,1.517915957,651,31,0,154,151,3,4582,4451,131,31,30,1,100
615d3d16d6cb969c8521c4c6b681dcf11aa29183,2,27,0,27,0,0,0,2,5,379,1,2,0.764204507,95,5,1,19,16,3,918,753,165,11,9,2,100
2145bb9893c44e3506c9e6f6bb1d981e0999c5e8,5,260,5,255,1,0,1,4,9,205,1,4,0.852732035,444,6,2,120,75,45,4644,3158,1486,60,41,19,99.86282579
6647059e85e3c70c01a1596fe11f4a12f69125a7,5,68,15,53,1,0,1,2,6,418,1,2,1.601366836,393,7,3,64,58,6,2843,2660,183,32,30,2,93.96551724
bc55a1460c19c127d143736baef3e1881f22418c,2,20,6,14,0,0,0,2,7,2,1,1,0.840358672,166,8,4,36,34,2,1160,1051,109,18,18,0,100
759ef5d44b57bc23ac86a4eaf94f7d76d6e79f11,2,32,4,28,0,0,0,2,3,880,1,2,0.764204507,487,9,5,85,84,1,3606,3399,207,46,45,1,99.83212087
e0d56061638d04a592b7fcff2e1435182f4a4ec8,2,23,2,21,0,0,0,4,14,208,1,2,0.795040279,550,10,6,200,196,4,4738,4590,148,67,66,1,100
352bc86e525eda5f83f13485cac01e57ab9447bb,4,45,2,43,0,0,0,3,9,238,1,3,1.686468915,593,11,6,104,100,4,4863,4640,223,48,45,3,100
d5ec60896fef71973d49436df077664b830aaa46,1,2,2,0,0,0,0,3,10,2,1,1,0,200,12,7,35,34,1,1554,1545,9,9,9,0,100
4631aef659d3795b5d3d7dc8e458b131387c2640,252,456,19,437,4,0,4,1,1,0,1,38,2.669132016,25532,1,0,4868,245,4623,189963,61495,128468,2392,245,2147,37.28598605
50b4f76b01b201bcd3d272cdbe805c3c367c111b,0,0,0,0,0,0,0,0,0,0,0,0,0,0,2,1,0,0,0,0,0,0,0,0,0,100
69c78580f2a0862e90f69a79fc73b66b5e2dc75a,2,72,2,70,0,0,0,2,2,2,1,2,0.922734621,571,13,8,219,200,19,5221,4738,483,69,67,2,100
cb2aca3e71e9098c8ef2cfe7415039ad5954e27e,0,0,0,0,0,0,0,0,0,0,0,0,0,0,14,9,0,0,0,0,0,0,0,0,0,100
d2d8ce9cbdf9c8a05afb51ddcd3a1f8f65a21d49,0,0,0,0,0,0,0,0,0,0,0,0,0,0,15,10,0,0,0,0,0,0,0,0,0,100
e623053db00a27e9c6ce80bb352f788b7759e806,0,0,0,0,0,0,0,0,0,0,0,0,0,0,16,3,0,0,0,0,0,0,0,0,0,100
c5890b7be7522db5484a0bc1e95913ec438aab9d,0,0,0,0,0,0,0,0,0,0,0,0,0,0,17,4,0,0,0,0,0,0,0,0,0,100
a612645c98b33802c70259bc9599e39afc32b385,10,271,12,259,1,0,1,2,2,36,1,3,1.903047895,1261,18,5,338,298,40,12665,10708,1957,198,166,32,91.40794224
1116da410809a4572e6134c01b1e8e4be6627647,3,59,2,57,1,0,1,1,2,38,1,2,0.55410153,244,19,3,32,31,1,1969,1729,240,21,20,1,90.27993779
9ea51393c75b1ec5a47ce6ce4cd66a4169c9da3d,1,12,11,1,0,0,0,2,2,68,1,1,0,81,20,4,3,3,0,713,713,0,1,1,0,100
5a8078804ce08c49c2c5e5314fec94cb72415f2a,2,85,4,81,1,0,1,1,2,34,1,2,0.472547222,200,21,5,45,35,10,2020,1554,466,19,9,10,91.41414141
701473043802d2e54638df2c8c112af8d8d4504a,8,139,55,84,0,0,0,2,2,64,1,3,2.403916776,643,22,6,97,78,19,5000,4692,308,74,59,15,95.71890145
6cac5fe1283d797f62e40b1dd755e40f5b213d7b,7,54,2,52,1,0,1,2,3,45,1,5,1.583478878,1257,23,7,328,324,4,9942,9758,184,131,128,3,93.09803922
ee5428d3eb38c34ef2a9ded2f0cd447fe3f2f959,3,51,1,50,1,0,1,1,3,30,1,3,1.140115679,75,24,8,10,7,3,823,667,156,5,2,3,99.68823071
a0d444d9eb8ffac43ecabb7476f80cbae998170a,0,0,0,0,0,0,0,0,0,0,0,0,0,0,25,9,0,0,0,0,0,0,0,0,0,100
161206d6d49f352e1a9158f884c8020709f5b1ff,0,0,0,0,0,0,0,0,0,0,0,0,0,0,5,0,0,0,0,0,0,0,0,0,0,100
02fc973f779bc18482554841abc43844562da75a,0,0,0,0,0,0,0,0,0,0,0,0,0,0,6,1,0,0,0,0,0,0,0,0,0,100
8028574ba42ff2aa8d1faf4085f84ca3d13d55b3,0,0,0,0,0,0,0,0,0,0,0,0,0,0,7,2,0,0,0,0,0,0,0,0,0,100
7febb30db2f2038ab9b750457a6df016cd583a04,0,0,0,0,0,0,0,0,0,0,0,0,0,0,8,3,0,0,0,0,0,0,0,0,0,100
44eb7b879277cd5be5fa3f23376d299d8f4a6067,0,0,0,0,0,0,0,0,0,0,0,0,0,0,9,4,0,0,0,0,0,0,0,0,0,100
2a3841f9419723b3007832d368a8c365d89ffd17,0,0,0,0,0,0,0,0,0,0,0,0,0,0,10,5,0,0,0,0,0,0,0,0,0,100
8bb68f7949fa14c10fd2549bcae2e4ddfdb817da,0,0,0,0,0,0,0,0,0,0,0,0,0,0,11,6,0,0,0,0,0,0,0,0,0,100
c69a5bb3780fcae1ca02439ef03c2f2d6188774b,0,0,0,0,0,0,0,0,0,0,0,0,0,0,12,7,0,0,0,0,0,0,0,0,0,100
2f5d854451fc832fda13e170323c065c9b048c3c,0,0,0,0,0,0,0,0,0,0,0,0,0,0,13,8,0,0,0,0,0,0,0,0,0,100
d88f0e4b854b5317555ad2a08c2c0b8ce4fe5b90,0,0,0,0,0,0,0,0,0,0,0,0,0,0,14,9,0,0,0,0,0,0,0,0,0,100
a2d92d73cdc29f92091ac958511ffef36d2f9e1f,0,0,0,0,0,0,0,0,0,0,0,0,0,0,15,10,0,0,0,0,0,0,0,0,0,100
fe2631a02ad01d755199076f43398a770b9750f4,0,0,0,0,0,0,0,0,0,0,0,0,0,0,16,11,0,0,0,0,0,0,0,0,0,100
4f8f908cf16850f7f6225c9359de2cbf9f770de6,0,0,0,0,0,0,0,0,0,0,0,0,0,0,26,10,0,0,0,0,0,0,0,0,0,100
5a5a90960f2a25e98198c8845e193b47ffeb208a,0,0,0,0,0,0,0,0,0,0,0,0,0,0,3,0,0,0,0,0,0,0,0,0,0,100
f036caa094c30ad39abd76e75858aee4cca0cb62,0,0,0,0,0,0,0,0,0,0,0,0,0,0,4,1,0,0,0,0,0,0,0,0,0,100
d0985f9e601ba97754bf072ac77e754a6c0a8c92,1,0,1,1,0,0,0,2,3,20,1,1,0,72,5,2,14,14,0,576,585,9,9,9,0,100
6076010d1b73aa9061b3a2a44f4242b6ab1d2230,4,89,76,13,1,0,1,1,2,66,1,3,1.39706645,348,6,3,41,41,0,2682,2646,36,24,24,0,99.68968192
309b4a3eddea7cf386d56c7371fc11159f0bb402,0,0,0,0,0,0,0,0,0,0,0,0,0,0,7,4,0,0,0,0,0,0,0,0,0,100
f46af6b5788544d8789bec5e8fdeb58d9d9d2d47,0,0,0,0,0,0,0,0,0,0,0,0,0,0,8,5,0,0,0,0,0,0,0,0,0,100
914bdb53b61b9b65e3260459217bdf6063b9b83b,0,0,0,0,0,0,0,0,0,0,0,0,0,0,9,6,0,0,0,0,0,0,0,0,0,100
a1eb97af3d931594b450321eb277817d186e1f50,3,24,2,22,0,0,0,2,3,30,1,2,0.892995357,415,27,8,74,71,3,3446,3272,174,21,20,1,100
baab72449d90842142032a6cc668c52d855de716,0,0,0,0,0,0,0,0,0,0,0,0,0,0,10,7,0,0,0,0,0,0,0,0,0,100
c849a8f76708f8995c311396f3933421b80bdaa7,0,0,0,0,0,0,0,0,0,0,0,0,0,0,17,12,0,0,0,0,0,0,0,0,0,100
b4f29d127108be85af3ea0f856c4ef3b52a2a798,0,0,0,0,0,0,0,0,0,0,0,0,0,0,18,13,0,0,0,0,0,0,0,0,0,100
a1e801aadba4ba65ce54b078d6c02b8617a88774,0,0,0,0,0,0,0,0,0,0,0,0,0,0,19,14,0,0,0,0,0,0,0,0,0,100
26ea6ca388642f96d4d0dfab28150d6b0f51aa33,0,0,0,0,0,0,0,0,0,0,0,0,0,0,20,15,0,0,0,0,0,0,0,0,0,100
335d72590281875b500f776afd3b43fc24c1e4dc,0,0,0,0,0,0,0,0,0,0,0,0,0,0,21,16,0,0,0,0,0,0,0,0,0,100
bd1c8fedb2c9566a9b161749fb6b49904b8caad8,0,0,0,0,0,0,0,0,0,0,0,0,0,0,22,5,0,0,0,0,0,0,0,0,0,100
9403bef4294b16c9eb59e6876f7a6fb6cecfaa0a,63,183,150,33,1,0,1,1,4,63,1,23,5.280812257,7369,11,8,1227,893,334,55176,45178,9998,589,450,139,84.10774411
330e7fb6c2708b4dba775d9bad05a62b0ce2146e,0,0,0,0,0,0,0,0,0,0,0,0,0,0,32,0,0,0,0,0,0,0,0,0,0,100
7fedde60b8704c2715526f6da81d6c43c4ca03e3,0,0,0,0,0,0,0,0,0,0,0,0,0,0,23,6,0,0,0,0,0,0,0,0,0,100
5ca4688a84af2406da81c0915ef781a790a016cb,1,934,474,460,0,0,0,1,2,143,1,1,0,533,12,1,192,96,96,6245,3301,2944,105,62,43,96.37681159
bb9b1c9796fab5960839e5b3eb8ff53b036eb6ad,0,0,0,0,0,0,0,0,0,0,0,0,0,0,28,0,0,0,0,0,0,0,0,0,0,100
214803f7333fa6681caf0c36abf5899b7e861992,5,159,39,120,1,0,1,1,3,42,1,4,1.891622654,389,13,2,57,55,2,3093,2868,225,31,30,1,95.88414634
9a34604d54723f44660d71d3e0ecd609fbf7d8a1,1,16,9,7,0,0,0,1,2,161,1,1,0,266,14,3,86,84,2,2125,2112,13,31,31,0,100
0011118ad62f56a42559fb432c2d46155649ade9,4,95,24,71,0,0,0,2,3,124,1,2,1.666824618,839,29,1,176,169,7,6278,5859,419,94,88,6,100
e020bbab1ba977e7b2f0cd0693d0d20c2c73441f,1,19,8,11,0,0,0,1,3,21,1,1,0,967,15,4,193,192,1,6292,6245,47,106,105,1,100
555df469c341e8aedc6a4a2822735edeed8ec095,1,53,43,10,0,0,0,1,2,182,1,1,0,648,16,4,135,133,2,3845,3821,24,70,69,1,100
4becf049d94e442f0b7aed95d61cc7574454f96c,0,0,0,0,0,0,0,0,0,0,0,0,0,0,0,0,0,0,0,0,0,0,0,0,0,100
c6469bfc32c0ebd53439b42feebc28439ac04506,0,0,0,0,0,0,0,0,0,0,0,0,0,0,1,1,0,0,0,0,0,0,0,0,0,100
9075618bf7890a8761107fa96da92dedf73d8a3e,2,9,4,5,0,0,0,2,3,120,1,2,0.961236605,1709,30,1,427,426,1,13262,13244,18,211,211,0,100
1ab4eec4d462d7384045a6efec7da0973ca71492,4,59,4,55,0,0,0,1,3,173,1,4,1.181445038,435,17,3,110,107,3,4090,3683,407,33,31,2,98.67394696
b366fd1f242f160f86d473cf3c883e8a5d4ac8e5,0,0,0,0,0,0,0,0,0,0,0,0,0,0,18,4,0,0,0,0,0,0,0,0,0,100
f7e0c4a5c396077c936beedf145c6178167bc0ee,0,0,0,0,0,0,0,0,0,0,0,0,0,0,19,5,0,0,0,0,0,0,0,0,0,100
bccc9984b80b6f94e92281767500632c77286eed,2,74,0,74,0,0,0,2,4,67,1,2,0.753197991,674,31,2,232,221,11,6159,5571,588,74,70,4,100
dcbfacdced7d0a7b50edf39afc1c50c87b1dcd7a,0,0,0,0,0,0,0,0,0,0,0,0,0,0,33,0,0,0,0,0,0,0,0,0,0,100
1c5bbe95f612b841bfeec3880e660d1b6ec44fab,6,81,40,41,0,0,0,2,5,93,1,6,2.054663018,695,32,3,159,158,1,5852,5517,335,64,63,1,98.67394696
a21cdcde9e3b9f9d203a441abce5b2e3aa2a583f,0,0,0,0,0,0,0,0,0,0,0,0,0,0,20,5,0,0,0,0,0,0,0,0,0,100
6fccf353fcbf236c93f8afefdd20be5f7cd3fd5b,2,110,2,108,1,0,1,1,2,106,1,2,0.954434003,37,24,0,17,8,9,838,240,598,14,6,8,99.29133858
8b173f0e65b83415ac4d6b6b772ed146ae499559,0,0,0,0,0,0,0,0,0,0,0,0,0,0,33,3,0,0,0,0,0,0,0,0,0,100
507684968666f97c5af23116884cf0ba88c60be4,20,119,413,294,0,0,0,1,5,121,1,10,2.412555959,4457,34,4,1110,1171,61,33749,35683,1934,426,437,11,87.95275591
9852becf651de1d845b1bf6e80ab2deeacbd6d9c,3,9,0,9,0,0,0,2,2,210,1,1,1.584962501,33,35,5,17,14,3,275,242,33,10,7,3,100
690bcb19471a3e5bf201665b5a75c1247f021e1d,0,0,0,0,0,0,0,0,0,0,0,0,0,0,36,6,0,0,0,0,0,0,0,0,0,100
82ba2e6a9320d3d81c0b9e9cdaa40f5be528ee3a,1,6,2,4,0,0,0,2,3,144,1,1,0,192,37,7,30,29,1,1276,1256,20,23,22,1,100
3962eec7f14fc83542437a50c49dcd2d4b481410,44,1857,494,1363,5,0,5,1,6,92,1,17,4.078405814,8968,21,5,1887,1765,122,71752,65983,5769,889,811,78,92.5900277
5f561248fa164725ec1e7600124fa4aa65a81c9c,0,0,0,0,0,0,0,0,0,0,0,0,0,0,2,2,0,0,0,0,0,0,0,0,0,100
9534b3cd1c35add821f13f736fdfec28cbd8ccef,0,0,0,0,0,0,0,0,0,0,0,0,0,0,3,3,0,0,0,0,0,0,0,0,0,100
aa3e9607963bb35f9067d3539b8881fe154c14cb,0,0,0,0,0,0,0,0,0,0,0,0,0,0,4,4,0,0,0,0,0,0,0,0,0,100
7f0c2f36e04d80eeca72df974c9c3eb6fb4c4914,0,0,0,0,0,0,0,0,0,0,0,0,0,0,5,5,0,0,0,0,0,0,0,0,0,100
474cd6bb4632dc0bec91e9f4ec2707673cf96890,0,0,0,0,0,0,0,0,0,0,0,0,0,0,6,6,0,0,0,0,0,0,0,0,0,100
3e897246bf0cb958aa80ca1749fdf3514a8fd2b6,0,0,0,0,0,0,0,0,0,0,0,0,0,0,7,7,0,0,0,0,0,0,0,0,0,100
16987f2bbedcc310a29e000b2ee72685170727be,0,0,0,0,0,0,0,0,0,0,0,0,0,0,8,8,0,0,0,0,0,0,0,0,0,100
196a252b6657068013d76e903b1f90ad33ad5c8e,0,0,0,0,0,0,0,0,0,0,0,0,0,0,9,9,0,0,0,0,0,0,0,0,0,100
3b5d0336153495e29ee42605e6b11fa27a3fec5b,36,395,278,117,0,0,0,2,7,51,1,12,3.48266342,8893,38,8,1697,1685,12,62729,62447,282,788,784,4,93.26788219
4d58a729c799e8d1fe3de8605bb53f14bd3374a2,0,0,0,0,0,0,0,0,0,0,0,0,0,0,39,9,0,0,0,0,0,0,0,0,0,100
e8dc149b002aa76473084894171f8df7e81ab767,0,0,0,0,0,0,0,0,0,0,0,0,0,0,40,10,0,0,0,0,0,0,0,0,0,100
b328ff0683899b44bb931d6a10a9e6b3624d9a44,7,34,15,19,0,0,0,2,4,8,1,1,2.776922602,958,41,11,205,204,1,6170,6137,33,123,122,1,100
e73a781d5a2ef9259749f882820d4b5932014d96,0,0,0,0,0,0,0,0,0,0,0,0,0,0,42,11,0,0,0,0,0,0,0,0,0,100
1b144474a26da6ea77d8d959a8b4dc8b07896cb4,2,15,3,12,0,0,0,2,5,30,1,1,0.918295834,408,43,10,129,127,2,3293,3271,22,54,52,2,100
ad935798984a24a6e9e9d2c136ff06a93b761ead,2,8,1,7,0,0,0,2,4,138,1,1,0.918295834,172,44,11,37,36,1,1233,1201,32,22,21,1,100
16f9fbc19a28d6c22e6a8fe8550ff5801b853d0b,5,53,21,32,0,0,0,2,8,92,1,2,1.841799478,793,45,12,141,137,4,6144,6017,127,73,69,4,100
b63f694a7efa6b0a4bc22c70bc2ac6747880267e,0,0,0,0,0,0,0,0,0,0,0,0,0,0,46,13,0,0,0,0,0,0,0,0,0,100
c567683f528d5af38e6835773e55092e3e2749bc,1,1,0,1,0,0,0,2,3,120,1,1,0,100,0,0,16,16,0,635,629,6,8,8,0,100
49681761a71ee17e1f554e3a411860a28a91fa18,1,1,1,0,0,0,0,2,4,0,1,1,0,101,1,1,16,16,0,635,635,0,8,8,0,100
addcbe199d2fe5fbc690554c2309b947f5dd3d54,0,0,0,0,0,0,0,0,0,0,0,0,0,0,34,0,0,0,0,0,0,0,0,0,0,100
3d64951d77db4a070e4f4be187dc03a92fc03c7e,0,0,0,0,0,0,0,0,0,0,0,0,0,0,35,1,0,0,0,0,0,0,0,0,0,100
b7d0d2bdc56d4bc7b5514feb534a5194335445fc,4,33,10,23,0,0,0,2,7,116,1,4,1.762930646,1786,47,0,474,470,4,14724,14553,171,161,159,2,100
60e5ddfd8fd3a41e513e22ef1b228117943886ca,0,0,0,0,0,0,0,0,0,0,0,0,0,0,48,1,0,0,0,0,0,0,0,0,0,100
554434befcb9df043e6ac918966e4271482eb1f4,0,0,0,0,0,0,0,0,0,0,0,0,0,0,36,2,0,0,0,0,0,0,0,0,0,100
0963e563fde59a0848c9200da08885783bd0c637,0,0,0,0,0,0,0,0,0,0,0,0,0,0,49,2,0,0,0,0,0,0,0,0,0,100
7784b56a4aeda94de1de3bbe12a468108b7b8e0e,0,0,0,0,0,0,0,0,0,0,0,0,0,0,50,3,0,0,0,0,0,0,0,0,0,100
a02c5c2ce3edae38b70648b177a78cc7a64a7b25,3,10,1,9,0,0,0,2,5,67,1,2,1.095795255,926,51,4,219,216,3,8060,8004,56,89,88,1,100
e9dbb30d296595f0ebd28350eb7904f4e596370d,0,0,0,0,0,0,0,0,0,0,0,0,0,0,52,5,0,0,0,0,0,0,0,0,0,100
fb8d5a0b64bed038374fff83de4abfeeb89c9461,0,0,0,0,0,0,0,0,0,0,0,0,0,0,53,6,0,0,0,0,0,0,0,0,0,100
e3315556f1a58ed027e52047516b02992d26278d,1,6,0,6,0,0,0,2,5,104,1,1,0,1084,54,7,361,358,3,8362,8305,57,156,156,0,100
361b0fb520d83636b0301203295a25682939d582,0,0,0,0,0,0,0,0,0,0,0,0,0,0,55,8,0,0,0,0,0,0,0,0,0,100
fb9e558d5f831a8ec27cb578014a122dc36dfd33,0,0,0,0,0,0,0,0,0,0,0,0,0,0,56,9,0,0,0,0,0,0,0,0,0,100
26b4efe10915380de91b0ab5672df6a08d79dd7f,0,0,0,0,0,0,0,0,0,0,0,0,0,0,37,2,0,0,0,0,0,0,0,0,0,100
9d567ae97e945f0c5997b0f65d0e4697fd1d732b,0,0,0,0,0,0,0,0,0,0,0,0,0,0,38,3,0,0,0,0,0,0,0,0,0,100
77047acd0d8b5b269047f471d5c2df7aad3cbf25,7,104,1,103,1,0,1,2,4,235,1,4,1.282430335,543,57,10,91,77,14,4796,4297,499,54,45,9,99.83766234
3f9db28ce5abc7163e7b8a718136d1d0b7e54caf,2,29,5,24,0,0,0,2,8,93,1,2,0.322756959,967,22,0,163,160,3,7709,7599,110,93,91,2,100
9f34df4ffa72adf599f8b2202de0af000159ef70,1,41,1,40,0,0,0,2,2,374,1,1,0,141,58,1,13,11,2,1569,1294,275,10,8,2,100
4ed7ff8e89a89af2df7a56f3dc83996a080adece,3,192,17,175,1,0,1,1,2,248,1,2,1.032455232,118,59,2,29,12,17,1948,849,1099,11,6,5,99.5951417
df001ad422e33182514811b50d0b63d81f868acd,1,18,7,11,0,0,0,1,2,39,1,1,0,51,60,3,12,11,1,463,348,115,7,7,0,100
a364235bde361cb9d4336fdc5564e8a1b392291f,5,98,13,85,0,0,0,2,3,308,1,2,1.928299614,209,61,3,34,23,11,2260,1873,387,27,16,11,100
03933b393626604faabfb2d4a5adf3463bede4bb,0,0,0,0,0,0,0,0,0,0,0,0,0,0,62,4,0,0,0,0,0,0,0,0,0,100
7833e4baa36951829a4ed4cbb81ae37df617464f,2,42,3,39,0,0,0,2,3,248,1,2,0.982474087,369,63,5,87,82,5,2621,2388,233,43,41,2,94.73684211
4601ccfd84bafa293d74ab4d2c9cd953652277c2,0,0,0,0,0,0,0,0,0,0,0,0,0,0,64,6,0,0,0,0,0,0,0,0,0,100
d1e46b246eeecee53c5c84a08578a066698e0c8e,4,252,0,252,3,0,3,2,3,88,1,2,1.898742146,101,65,7,34,11,23,2137,866,1271,19,6,13,99.29015084
7472d98289bcb9776339ad253285a6f6dfa939cf,2,13,0,13,0,0,0,2,2,404,1,2,0.391243564,519,66,8,68,68,0,3296,3237,59,53,53,0,100
b34848d4b561098b6515ef8fc5217cf18a55a9f5,0,0,0,0,0,0,0,0,0,0,0,0,0,0,67,9,0,0,0,0,0,0,0,0,0,100
afa1fd51ad1defb83e622260625cedf597057458,3,3,3,0,0,0,0,2,3,273,1,1,1.584962501,74,68,10,10,10,0,498,498,0,9,9,0,100
064d76042fc429844fb51fed01c9399240a83020,0,0,0,0,0,0,0,0,0,0,0,0,0,0,69,11,0,0,0,0,0,0,0,0,0,100
3ea269b831f04da1159b8156536fe8e823767714,4,91,25,66,0,0,0,3,4,276,1,2,0.576539066,415,2,0,69,55,14,3230,2916,314,55,44,11,100
3eb8a8c93c9388d1bd79b2297118a1d381bde51d,0,0,0,0,0,0,0,0,0,0,0,0,0,0,3,1,0,0,0,0,0,0,0,0,0,100
fbab55fdd499dae4736f099111aecf2bc8e488e3,0,0,0,0,0,0,0,0,0,0,0,0,0,0,10,0,0,0,0,0,0,0,0,0,0,100
947bd7daab9ac512bba06f09d27f9dd29b55bef7,0,0,0,0,0,0,0,0,0,0,0,0,0,0,11,1,0,0,0,0,0,0,0,0,0,100
85bc4f8916fa5db77b6ac3d78747e98844780d04,1,1,1,0,0,0,0,3,4,38,1,1,0,114,70,0,13,13,0,822,822,0,9,9,0,100
ac835f5458ee587f937312bb1eeb3b70699d3aee,0,0,0,0,0,0,0,0,0,0,0,0,0,0,71,1,0,0,0,0,0,0,0,0,0,100
e05d7e823c8b05c18d4245b894eb43db66df21b6,2,7,1,6,0,0,0,2,5,146,1,2,0.811278124,619,72,2,151,149,2,5424,5362,62,65,64,1,100
1dbd63f4d14887ad4f7ac4c74db576f336b8c95f,0,0,0,0,0,0,0,0,0,0,0,0,0,0,73,3,0,0,0,0,0,0,0,0,0,100
ea05ebd20d8ae1fc7e6cdfa64c6a40c204d728fe,2,52,3,49,0,0,0,2,5,189,1,2,0.892121281,478,74,4,86,79,7,3713,3488,225,45,42,3,100
b65bfcf9cf6004ae8c2cff0cd58e251032e4c719,5,268,35,233,2,0,2,2,5,52,1,2,1.885326005,232,75,5,46,26,20,3458,2031,1427,21,12,9,99.20983319
215c50fe20bd74b0d7cdf0e41aaa93bf39f6be91,0,0,0,0,0,0,0,0,0,0,0,0,0,0,76,6,0,0,0,0,0,0,0,0,0,100
94d4da5ee1ee30e5f65f051885732e02fddef2f0,0,0,0,0,0,0,0,0,0,0,0,0,0,0,12,0,0,0,0,0,0,0,0,0,0,100
89d8396263807fd5bf94e3ee39e8b34baef28476,0,0,0,0,0,0,0,0,0,0,0,0,0,0,13,1,0,0,0,0,0,0,0,0,0,100
535f4ba55859d64d4a566ec68eea64aec774f3f6,0,0,0,0,0,0,0,0,0,0,0,0,0,0,14,2,0,0,0,0,0,0,0,0,0,100
452ed338b64e52116e0c0c3e24705ad09cb27584,0,0,0,0,0,0,0,0,0,0,0,0,0,0,23,0,0,0,0,0,0,0,0,0,0,100
d4867eb2aba282ebc38d4a25631ea8cd802b2b18,7,80,15,65,0,0,0,2,8,308,1,6,2.046994292,773,77,3,112,105,7,6419,5855,564,59,53,6,100
6c6b08cf33fb1911dd50c6abc2a5e7bfeb1c1a16,0,0,0,0,0,0,0,0,0,0,0,0,0,0,78,4,0,0,0,0,0,0,0,0,0,100
153ce108ab9334a4a74e266c078f4d0c08e2f485,11,1250,227,1023,4,0,4,1,9,104,1,5,2.564774377,866,79,0,242,142,100,10989,6513,4476,123,73,50,95.36480687
77c3c699fa348c191cee812392dc025f6ed1331e,0,0,0,0,0,0,0,0,0,0,0,0,0,0,80,1,0,0,0,0,0,0,0,0,0,100
52ae42f054fc9ac62262b28b6a5c5d3ba4a288fd,0,0,0,0,0,0,0,0,0,0,0,0,0,0,24,0,0,0,0,0,0,0,0,0,0,100
3a282bd65030c4361ea901a8e09a495227df15b0,2,42,0,42,0,0,0,2,7,309,1,2,0.892623013,770,81,2,249,242,7,6855,6430,425,82,80,2,100
2f5cdaf1a0d0003a01184ee201ca8e81bd8a9db0,1,1,1,0,0,0,0,2,4,371,1,1,0,62,82,3,6,6,0,424,424,0,3,3,0,100
5b88de9f8724e046c745869b335b82a4af439af3,0,0,0,0,0,0,0,0,0,0,0,0,0,0,25,1,0,0,0,0,0,0,0,0,0,100
460b26da6b3d929887c9e0fa814851562e2a797f,3,28,1,27,0,0,0,2,9,286,1,3,1.073551999,2066,83,3,501,497,4,15756,15628,128,252,249,3,100
6a584228314e7ea255c6aa68edee4b770dc6e899,0,0,0,0,0,0,0,0,0,0,0,0,0,0,84,4,0,0,0,0,0,0,0,0,0,100
0a3c5b470e8882e478052af07283b2a6b46ba79f,6,214,21,193,1,0,1,2,5,336,1,3,1.638207406,360,85,4,58,49,9,4059,2981,1078,31,29,2,99.83164983
cd50b81836131e56355a8617be5ea9b1be5d63d9,0,0,0,0,0,0,0,0,0,0,0,0,0,0,86,5,0,0,0,0,0,0,0,0,0,100
c4f243262392626c8a9e95ba1e4c355e21ab388a,6,323,80,243,0,0,0,1,10,92,1,4,1.548209047,1120,87,6,187,168,19,9090,8138,952,102,90,12,100
df5f9be0214ea3884fc15181d88a0b3e0da4bf3c,3,37,1,36,0,0,0,2,8,15,1,3,1.086987702,1918,88,7,620,613,7,15579,15307,272,244,240,4,100
07c66f99ada606e5e832d0b9cad0eab776c98c83,0,0,0,0,0,0,0,0,0,0,0,0,0,0,89,8,0,0,0,0,0,0,0,0,0,100
0cc2905bb678d3b729a14913ae7bd7a6ee10aa28,0,0,0,0,0,0,0,0,0,0,0,0,0,0,90,9,0,0,0,0,0,0,0,0,0,100
b623e6f1019798c69c9178c3eb3e2101fb0fe383,1,21,30,9,0,0,0,1,3,249,1,1,0,59,91,9,10,12,2,420,463,43,7,7,0,100
34d6f3ac20492b8b39d05c8e71333bf4d46a59b9,0,0,0,0,0,0,0,0,0,0,0,0,0,0,15,0,0,0,0,0,0,0,0,0,0,100
1fa65b7921fd9a718a70b53c9c2f61efbcbfc279,0,0,0,0,0,0,0,0,0,0,0,0,0,0,16,1,0,0,0,0,0,0,0,0,0,100
23b9833e7f7fc164e9ed715062ed84aec8d2a27e,0,0,0,0,0,0,0,0,0,0,0,0,0,0,17,2,0,0,0,0,0,0,0,0,0,100
aae39c90a3e5ac80d940471b5694aef1ab193803,0,0,0,0,0,0,0,0,0,0,0,0,0,0,18,3,0,0,0,0,0,0,0,0,0,100
3dff33cb9b8bc5d4c8a1f94a964bc4e5c4d7e5ff,0,0,0,0,0,0,0,0,0,0,0,0,0,0,19,4,0,0,0,0,0,0,0,0,0,100
c9f6f4eb4756d387746ea458bc27a4bd08e121ca,0,0,0,0,0,0,0,0,0,0,0,0,0,0,20,5,0,0,0,0,0,0,0,0,0,100
6d3e2f0facaf2f21e049bd71e5f555c365f8c71e,0,0,0,0,0,0,0,0,0,0,0,0,0,0,21,6,0,0,0,0,0,0,0,0,0,100
78ab4204ce33450f466e7cacb1949b53c5b053f5,0,0,0,0,0,0,0,0,0,0,0,0,0,0,92,0,0,0,0,0,0,0,0,0,0,100
b61743eb5b604f50aeed13abcdd5164e2d71f706,2,160,0,160,1,0,1,1,6,178,1,2,0.168660931,398,93,1,128,118,10,4529,3520,1009,32,25,7,99.83221477
827cac5eccfc507d829d7f734f9365f816eaf6d0,0,0,0,0,0,0,0,0,0,0,0,0,0,0,94,2,0,0,0,0,0,0,0,0,0,100
a03c19564906b179de1845c9614a985523162f6a,2,20,7,13,0,0,0,2,6,486,1,1,0.99107606,225,95,0,87,85,2,1968,1929,39,22,20,2,100
646bfb81eece405f0e898b8caa9165579295859d,1,77,21,56,0,0,0,2,8,126,1,1,0,1110,96,1,376,366,10,8685,8478,207,166,158,8,100
b1bb350b513bfc925960faeb65a28351e7e9ceaa,1,51,20,31,0,0,0,2,9,0,1,1,0,1138,97,2,389,376,13,8794,8685,109,168,166,2,100
2679a8b0563aea563d1d8ca4e124662e6d381db0,0,0,0,0,0,0,0,0,0,0,0,0,0,0,98,3,0,0,0,0,0,0,0,0,0,100
4f693b17f1065f1a688628af3578ee34c55bfbe8,1,2,1,1,0,0,0,1,2,156,1,1,0,80,99,4,2,2,0,786,779,7,1,1,0,100
174f5a8898511b7275a81a9b7e8f89ad6c7a40f4,0,0,0,0,0,0,0,0,0,0,0,0,0,0,100,5,0,0,0,0,0,0,0,0,0,100
d3d6134e08a361a1ad774b527adc5ef7330c09ac,0,0,0,0,0,0,0,0,0,0,0,0,0,0,101,5,0,0,0,0,0,0,0,0,0,100
79b61b53124d555583791061429f12db0f7c4810,0,0,0,0,0,0,0,0,0,0,0,0,0,0,102,6,0,0,0,0,0,0,0,0,0,100
1462c10fb5ae684dfa9fb03b4eb5d54903c8a384,5,281,12,269,3,0,3,1,3,248,1,4,1.925878878,373,103,7,140,107,33,3652,2344,1308,44,29,15,99.25124792
341d12014ead1a0bf5bafb1c666c0cc668a62308,0,0,0,0,0,0,0,0,0,0,0,0,0,0,104,8,0,0,0,0,0,0,0,0,0,100
d15cce120f81f5118ea590fa48d3e7e6150d920f,0,0,0,0,0,0,0,0,0,0,0,0,0,0,105,9,0,0,0,0,0,0,0,0,0,100
3be4df96cf956e38c56561e4e7954cb0ebc96cae,0,0,0,0,0,0,0,0,0,0,0,0,0,0,106,10,0,0,0,0,0,0,0,0,0,100
31d1e9b84baf9c6ee4ea234ddad9a7b584e11d0c,0,0,0,0,0,0,0,0,0,0,0,0,0,0,107,11,0,0,0,0,0,0,0,0,0,100
203cbd49010dfcd677af4a6d8ce8b4065d4e629d,0,0,0,0,0,0,0,0,0,0,0,0,0,0,108,12,0,0,0,0,0,0,0,0,0,100
666be14b735fa4b6e03c20b5c15d229f90efd437,37,2431,315,2116,11,0,11,1,9,316,1,18,4.378607791,4713,109,11,1231,1022,209,50478,37322,13156,559,448,111,93.94409938
72c9d6bb7aa23546a0bf82c2ce546fd1278bd72b,2,21,0,21,0,0,0,2,11,119,1,2,0.998363673,641,110,9,110,106,4,4707,4562,145,56,55,1,100
7c2bfeb2c6ebb2f69eaa4aafbf586ddd2c000629,0,0,0,0,0,0,0,0,0,0,0,0,0,0,111,10,0,0,0,0,0,0,0,0,0,100
b4d6a171e5e2d96d4e6fad49e06aca19c916420a,0,0,0,0,0,0,0,0,0,0,0,0,0,0,112,11,0,0,0,0,0,0,0,0,0,100
5f2cc474348dfdc8cfca669f3f4f0d75bc9e7ae9,7,561,40,521,4,0,4,1,10,34,1,5,2.075360915,1290,113,3,552,459,93,13589,10723,2866,148,113,35,99.34545455
7185321c45049659c172d64651c2ebe83143a031,0,0,0,0,0,0,0,0,0,0,0,0,0,0,114,4,0,0,0,0,0,0,0,0,0,100
fed95bb179d5459bd58538028f7deafe703f2f90,2,10,8,2,0,0,0,1,2,0,1,2,0.503258335,299,115,5,82,82,0,2339,2330,9,19,19,0,100
ce10b0708139dd131a6342d5e189f5d857000c19,1,1,1,0,0,0,0,1,2,0,1,1,0,52,116,6,11,11,0,408,402,6,9,9,0,100
bfdee03fe22f9743dbfddb593de3821fcfa737a8,0,0,0,0,0,0,0,0,0,0,0,0,0,0,117,7,0,0,0,0,0,0,0,0,0,100
dba584208bc0006ce773c2919469b6027da753ed,0,0,0,0,0,0,0,0,0,0,0,0,0,0,118,8,0,0,0,0,0,0,0,0,0,100
8feed041e4d0f296e954d1b4d38ce952d64bc07d,3,19,4,15,0,0,0,2,4,537,1,3,1.353448505,845,119,9,253,249,4,6059,5962,97,96,94,2,100
6ea146d357b041e1c16167124afd7fc4d0f36c21,2,128,0,128,2,0,2,1,1,0,1,2,0.912999214,0,120,10,9,0,9,582,0,582,7,0,7,91.36331192
afc36212528a46d6e00a1031764a3defe66bed45,2,13,2,11,0,0,0,2,8,202,1,2,0.918295834,847,121,8,198,196,2,7550,7482,68,80,79,1,100
895ce26802026187f1a6ac227bf0ec1482178247,0,0,0,0,0,0,0,0,0,0,0,0,0,0,122,9,0,0,0,0,0,0,0,0,0,100
e93f2ff7ca53586dbfd3941035fdaf67cb8ae306,3,125,14,111,1,0,1,2,4,486,1,2,0.958176013,242,123,10,39,28,11,2284,1719,565,23,16,7,95.85714286
3fe4738eff4bfe13116094a48ce5e22e4934bfbc,3,98,1,97,1,0,1,1,8,52,1,3,0.974351241,284,124,11,100,89,11,2693,2236,457,40,36,4,99.85549133
fe169ad3db467159b48da150c639c4ad7c06c0bf,0,0,0,0,0,0,0,0,0,0,0,0,0,0,125,12,0,0,0,0,0,0,0,0,0,100
471b3f5f896035f264f29cf4f6a136a23a0b40b3,0,0,0,0,0,0,0,0,0,0,0,0,0,0,22,0,0,0,0,0,0,0,0,0,0,100
d6d9116c6bfb31535491912f55a658d4f0291fb5,0,0,0,0,0,0,0,0,0,0,0,0,0,0,23,1,0,0,0,0,0,0,0,0,0,100
e1fa71998aa7ecbf230b7b5dc8af8b446a2870f1,0,0,0,0,0,0,0,0,0,0,0,0,0,0,24,2,0,0,0,0,0,0,0,0,0,100
47161bac6a9c3e0ff5fbf3885cd922fa29848adb,0,0,0,0,0,0,0,0,0,0,0,0,0,0,25,3,0,0,0,0,0,0,0,0,0,100
27493bbf6257f48278df922517bc9e38be2df8d2,0,0,0,0,0,0,0,0,0,0,0,0,0,0,26,4,0,0,0,0,0,0,0,0,0,100
7a1cdae26c92bb14e63ac71eab4ee7ce3859752b,0,0,0,0,0,0,0,0,0,0,0,0,0,0,27,5,0,0,0,0,0,0,0,0,0,100
fd02845b1307edba65587a6e2cefda72e54ed8b9,4,211,0,211,4,0,4,1,1,0,1,3,1.946767684,0,126,11,8,0,8,555,0,555,7,0,7,99.42611191
d6d8e36128e1b733b520abfc2f6687914e0cd9e0,0,0,0,0,0,0,0,0,0,0,0,0,0,0,127,10,0,0,0,0,0,0,0,0,0,100
21223692e8066b2bdf2100641fb7befdae453e8e,5,326,11,315,0,0,0,2,4,654,1,3,0.943403568,1072,39,0,255,218,37,8635,7009,1626,132,123,9,91.23674912
2b4a20cddc3856755e1104775398c5d95d7570d5,1,7,2,5,0,0,0,3,6,328,1,1,0,110,128,9,13,12,1,828,803,25,10,9,1,100
ce9db305e58824d3f892a9fe89c38537f7e75a39,0,0,0,0,0,0,0,0,0,0,0,0,0,0,129,10,0,0,0,0,0,0,0,0,0,100
3f01ca6b4de96fc5b9167651d4f700b2fcb2c5f4,12,4186,6,4180,9,0,9,1,11,60,1,4,2.277466706,1081,130,9,1237,385,852,32605,8589,24016,506,126,380,98.75518672
126e9769f45f978f42321c4fc465198982df482b,2,7,1,6,0,0,0,2,10,225,1,2,0.811278124,1886,131,8,466,465,1,14413,14376,37,231,230,1,100
29f33991babbc6ba48cb03b067d063d38751a7e9,3,25,6,19,0,0,0,2,5,228,1,3,1.540251345,401,132,8,66,65,1,2929,2775,154,45,44,1,100
5c4ebdc2113e15afcbde83756a0dc1c0d09935ba,5,34,27,7,0,0,0,1,12,13,1,3,1.521099626,1500,133,9,508,508,0,12028,11944,84,161,160,1,100
86fa1ce37647ccc27cf85365ace50aa593073394,3,19,24,5,0,0,0,2,3,557,1,2,1.21132135,275,40,1,34,33,1,2091,2091,0,12,12,0,100
748e8c1be6a8c44e2a5cda05d05c5668526a7b25,0,0,0,0,0,0,0,0,0,0,0,0,0,0,41,2,0,0,0,0,0,0,0,0,0,100
d7dbac1ad7177bc8065298cc452466b2a39d7a9c,1,1,1,0,0,0,0,3,4,119,1,1,0,135,42,3,18,18,0,1126,1126,0,4,4,0,100
240c6945700aa1f2fd7e9c508ae24543a34211f7,2,1650,2,1648,1,0,1,1,3,34,1,1,0.024530133,49,134,10,315,1,314,9400,424,8976,178,1,177,99.65916837
c4fa8c58b9952951ba2307cc2ec796ad05e822e2,5,25,15,10,0,0,0,2,4,349,1,3,1.930240673,352,43,4,39,38,1,3091,3008,83,17,17,0,100
a614a28bc9e2f90bf516577252863b8af1cd2e00,0,0,0,0,0,0,0,0,0,0,0,0,0,0,44,5,0,0,0,0,0,0,0,0,0,100
fdc2c4899f2ba71a661a3b3f239cc17fa7221fb2,0,0,0,0,0,0,0,0,0,0,0,0,0,0,45,6,0,0,0,0,0,0,0,0,0,100
85949e751323c72ed55af0a1ba1f47f3a55a318f,0,0,0,0,0,0,0,0,0,0,0,0,0,0,46,7,0,0,0,0,0,0,0,0,0,100
efc3db5634563602e2e504b8b1fe16475f431112,0,0,0,0,0,0,0,0,0,0,0,0,0,0,135,9,0,0,0,0,0,0,0,0,0,100
ff1e35fb0774691aa77ff47b196c5a1e7335240b,1,5,1,4,0,0,0,2,3,684,1,1,0,68,136,10,12,11,1,575,549,26,7,7,0,100
844ea7709ce2ef022cca280b4376cefb6d579c4b,0,0,0,0,0,0,0,0,0,0,0,0,0,0,137,11,0,0,0,0,0,0,0,0,0,100
c7acde0a81b8413c40b40c5cef2fed13faa1b85d,0,0,0,0,0,0,0,0,0,0,0,0,0,0,47,8,0,0,0,0,0,0,0,0,0,100
874faae7323ea0888769ef96bc0d12d23db052ca,0,0,0,0,0,0,0,0,0,0,0,0,0,0,48,9,0,0,0,0,0,0,0,0,0,100
da44c2318c5dc9bfc4116cd713bcd0eb872e6e5a,36,317,140,177,0,0,0,1,13,364,1,16,4.506325286,7549,138,11,1853,1820,33,56161,55146,1015,768,757,11,96.1352657
eb895229861088c0b25dc0b23693920ccee5d593,0,0,0,0,0,0,0,0,0,0,0,0,0,0,49,10,0,0,0,0,0,0,0,0,0,100
c4c44266b38bce822072c200343520c58b4b6902,0,0,0,0,0,0,0,0,0,0,0,0,0,0,50,11,0,0,0,0,0,0,0,0,0,100
6e774f574bc75ade354423dadacfa9dd6aa5ff2b,0,0,0,0,0,0,0,0,0,0,0,0,0,0,51,12,0,0,0,0,0,0,0,0,0,100
122353642cc8ca30c04908f20e7636b342c30a0d,0,0,0,0,0,0,0,0,0,0,0,0,0,0,52,13,0,0,0,0,0,0,0,0,0,100
883f32a9d1060d6578176efcc974ae453fc38e72,0,0,0,0,0,0,0,0,0,0,0,0,0,0,53,14,0,0,0,0,0,0,0,0,0,100
287f348e2e331ebfca808275413585dd99e6865f,0,0,0,0,0,0,0,0,0,0,0,0,0,0,54,15,0,0,0,0,0,0,0,0,0,100
8fad411325a514d8dbf782c2a15ec169f3e428e6,0,0,0,0,0,0,0,0,0,0,0,0,0,0,55,16,0,0,0,0,0,0,0,0,0,100
5c7076df6a213fb62838a246fa061a34d24858fa,0,0,0,0,0,0,0,0,0,0,0,0,0,0,28,0,0,0,0,0,0,0,0,0,0,100
acbb703c989806356d7edb1d7ff563c913a5cb0e,0,0,0,0,0,0,0,0,0,0,0,0,0,0,29,1,0,0,0,0,0,0,0,0,0,100
d5e1e385ce6464c2c95e1d3aaab7b5d015bf3e81,0,0,0,0,0,0,0,0,0,0,0,0,0,0,30,2,0,0,0,0,0,0,0,0,0,100
c909aa17c9f592da6db3dffc3505e91af7545b86,0,0,0,0,0,0,0,0,0,0,0,0,0,0,31,3,0,0,0,0,0,0,0,0,0,100
0c0a454e4e06cb35fb9db9d5054684f8ea6c16fd,0,0,0,0,0,0,0,0,0,0,0,0,0,0,32,4,0,0,0,0,0,0,0,0,0,100
29fa142825a7b094abb61475e2f787ca3495a316,0,0,0,0,0,0,0,0,0,0,0,0,0,0,33,5,0,0,0,0,0,0,0,0,0,100
35f6ce9cbc8cbba05efe70a3578bc78ef29da594,0,0,0,0,0,0,0,0,0,0,0,0,0,0,34,6,0,0,0,0,0,0,0,0,0,100
67142f000666b7bb8f344dcd45b0b2608457226d,0,0,0,0,0,0,0,0,0,0,0,0,0,0,35,7,0,0,0,0,0,0,0,0,0,100
9eed34dac2bc0203e2e42242d08e90b96fc56fbb,0,0,0,0,0,0,0,0,0,0,0,0,0,0,56,16,0,0,0,0,0,0,0,0,0,100
b4bd442ba87dddefa58143a9793b31df3cb7e708,0,0,0,0,0,0,0,0,0,0,0,0,0,0,57,17,0,0,0,0,0,0,0,0,0,100
fc986ce223a13e88c11d611c6d3870d023e99d08,0,0,0,0,0,0,0,0,0,0,0,0,0,0,58,18,0,0,0,0,0,0,0,0,0,100
6310f6945fd409d27bc1347e993d8dab5c5da8f1,0,0,0,0,0,0,0,0,0,0,0,0,0,0,59,19,0,0,0,0,0,0,0,0,0,100
ee35b2176aa020353549c1877052094f0cbd35ac,0,0,0,0,0,0,0,0,0,0,0,0,0,0,60,20,0,0,0,0,0,0,0,0,0,100
60c0c5450755ee4dc21d3e6cb575f9291bc7656e,2,208,1,207,1,0,1,2,11,18,1,2,0.528259588,725,139,9,112,77,35,6888,5619,1269,72,63,9,99.86013986
db12764c2637364addfb835b783533460d49a159,1,1,1,0,0,0,0,2,4,155,1,1,0,441,140,10,110,110,0,3993,3989,4,100,100,0,100
2c39d103b922c3796e3771df1d979daa49cf494f,0,0,0,0,0,0,0,0,0,0,0,0,0,0,141,11,0,0,0,0,0,0,0,0,0,100
1628df0503496cef5d3c55b255c44a90a0daa624,0,0,0,0,0,0,0,0,0,0,0,0,0,0,61,18,0,0,0,0,0,0,0,0,0,100
6debff5cf9e7054aeffca17f9e91e87a2fc122f2,0,0,0,0,0,0,0,0,0,0,0,0,0,0,62,19,0,0,0,0,0,0,0,0,0,100
f6ddbe438d7f488314c50d536e2a1b2dd79adf8c,3,7,5,2,0,0,0,3,5,24,1,1,1.584962501,122,63,20,19,19,0,882,861,21,9,9,0,100
2eef70c41920acb336d7910acb0f577a1e83c968,0,0,0,0,0,0,0,0,0,0,0,0,0,0,64,17,0,0,0,0,0,0,0,0,0,100
b151f1f3a0fbb14a840aa33048a42427134f5fb5,0,0,0,0,0,0,0,0,0,0,0,0,0,0,142,4,0,0,0,0,0,0,0,0,0,100
c542500c8316da5bfc83f9dba58ec8bb07c2a0a8,2,3,7,4,0,0,0,3,6,43,1,2,0.970950594,631,23,0,170,171,1,4572,4585,13,45,45,0,100
23c645641c0dcceff6515a2f00b3d7bc940aba9a,0,0,0,0,0,0,0,0,0,0,0,0,0,0,36,8,0,0,0,0,0,0,0,0,0,100
37f4c480cdfb3367f5482cf07ccd099d1d7a59ab,0,0,0,0,0,0,0,0,0,0,0,0,0,0,37,9,0,0,0,0,0,0,0,0,0,100
ba6b305d9bf41d7e695132340147809f42e93b23,0,0,0,0,0,0,0,0,0,0,0,0,0,0,38,10,0,0,0,0,0,0,0,0,0,100
cd30b485062b1920887276cc44552590d703f443,2,18,5,13,0,0,0,2,9,98,1,2,0.998635964,857,143,5,200,198,2,7660,7550,110,80,80,0,100
af78321f7d6fb7d35f7eba2116cb8811e38d5ab6,5,89,0,89,0,0,0,1,2,99,1,4,2.321559629,207,144,6,14,14,0,1073,1073,0,11,11,0,100
1ef1b15816702ad7a9bad27a40d8abff34a4b4b8,0,0,0,0,0,0,0,0,0,0,0,0,0,0,145,7,0,0,0,0,0,0,0,0,0,100
12fce370b665d14852bb757f92bd5de99ab5859c,0,0,0,0,0,0,0,0,0,0,0,0,0,0,146,8,0,0,0,0,0,0,0,0,0,100
04d3e592f34d38d17c04a6e7b0217f7ae7ea1feb,0,0,0,0,0,0,0,0,0,0,0,0,0,0,147,9,0,0,0,0,0,0,0,0,0,100
cc434590d3e8970208bd60c822146b2e2a91382c,0,0,0,0,0,0,0,0,0,0,0,0,0,0,65,9,0,0,0,0,0,0,0,0,0,100
08d0b88a9975956c107f1bbd378ae91550843be6,1,13,2,11,0,0,0,2,10,50,1,1,0,202,148,9,82,80,2,1854,1750,104,15,15,0,100
b0da28f5ba067365251aa0964caf5f3baee6d1bd,3,109,47,62,0,0,0,1,4,64,1,3,1.401163781,1480,149,10,437,417,20,11294,10921,373,120,114,6,100
14bad855be78ba3416a0ff477ca8c6ca688ec9a8,1,3,7,4,0,0,0,2,5,734,1,1,0,91,150,11,18,18,0,756,759,3,11,11,0,100
28fbfce69cb4ad3f9622c18c965c9ca8233c77f3,0,0,0,0,0,0,0,0,0,0,0,0,0,0,151,12,0,0,0,0,0,0,0,0,0,100
1db27e251129f32236e2c879c273189d596b63ac,0,0,0,0,0,0,0,0,0,0,0,0,0,0,152,10,0,0,0,0,0,0,0,0,0,100
c1038fad9da75fd0eae6a145690424d180ba73a3,0,0,0,0,0,0,0,0,0,0,0,0,0,0,153,11,0,0,0,0,0,0,0,0,0,100
2ce7e30f51cbaec49016bc592df88202e39745ea,4,162,41,121,0,0,0,1,7,225,1,3,0.41017,805,154,12,113,101,12,5939,5588,351,71,65,6,100
5a0df85d1fd828969cb8dce1919cd40203c67d9a,0,0,0,0,0,0,0,0,0,0,0,0,0,0,155,13,0,0,0,0,0,0,0,0,0,100
8b58efb07e6613d3a11a9e7b8e04797ffbc82413,4,60,51,9,0,0,0,1,3,208,1,4,1.52226004,970,156,13,144,140,4,9437,9267,170,84,80,4,100
4e10536f31e6a1de4df0fceb77bfc7d34bbb1b21,3,60,32,28,0,0,0,2,14,76,1,2,1.338898732,2012,157,14,711,698,13,15793,15568,225,274,269,5,100
729385bed515560f2d2319e9c3519958a4114846,0,0,0,0,0,0,0,0,0,0,0,0,0,0,158,15,0,0,0,0,0,0,0,0,0,100
478925203c46758ba4cf3123bf7c7fa1f3f7baec,0,0,0,0,0,0,0,0,0,0,0,0,0,0,159,16,0,0,0,0,0,0,0,0,0,100
4cfa82af2adf6753bef4ce04748a9a7f4237d2d5,0,0,0,0,0,0,0,0,0,0,0,0,0,0,160,17,0,0,0,0,0,0,0,0,0,100
ed24ecc793981a4eeb15293f11f3ab89ef9a5f11,0,0,0,0,0,0,0,0,0,0,0,0,0,0,161,5,0,0,0,0,0,0,0,0,0,100
0e6318c7415cfc5c814cc01e6bc037fa584adba3,5,62,60,2,0,0,0,2,5,348,1,3,1.633117455,625,162,0,49,49,0,6244,6219,25,22,22,0,100
dac0b38b159434ca492a1bde53ed9d3208266a65,3,10,0,10,0,0,0,3,6,138,1,1,0.921928095,123,163,1,19,19,0,902,882,20,9,9,0,100
7ded439f4f7b6783b6e5334f9ca9310dff8d009a,1,1,0,1,0,0,0,2,5,3,1,1,0,34,164,2,4,4,0,264,257,7,3,3,0,100
480e5934ffba54a02361bd40a865cfc1ee80383c,0,0,0,0,0,0,0,0,0,0,0,0,0,0,165,3,0,0,0,0,0,0,0,0,0,100
f8e718ab54836079fe75ea1d0e60d0154d50448f,2,20,0,20,0,0,0,2,10,132,1,2,0.881290899,869,166,4,205,200,5,7825,7660,165,82,80,2,100
cf4b82354f818e583c8d3ab9c5c171c8ab3acf10,0,0,0,0,0,0,0,0,0,0,0,0,0,0,167,5,0,0,0,0,0,0,0,0,0,100
0ba056f58b54d299fbe991102b5aa416ac3ab845,2,24,5,19,0,0,0,2,13,131,1,2,0.735508582,1905,168,6,473,468,5,14804,14639,165,238,237,1,100
af1ab38314e5b7c6d0d1cee6dfd9478662da8d6f,3,122,19,103,0,0,0,2,14,126,1,2,0.420555514,2011,169,7,672,650,22,15781,15079,702,274,265,9,100
c7919f9b5b52f38b9304799f157e9c3ff292842f,1,33,15,18,0,0,0,3,7,210,1,1,0,114,170,8,15,13,2,898,828,70,11,10,1,100
77480fda068aa8878e6f1002f92cfb436a1b964d,0,0,0,0,0,0,0,0,0,0,0,0,0,0,171,9,0,0,0,0,0,0,0,0,0,100
cc0e5cf5eb7bc7b6dd2bf75064dd84c7d201e6b0,0,0,0,0,0,0,0,0,0,0,0,0,0,0,172,10,0,0,0,0,0,0,0,0,0,100
8f0693356c5c35d41e8ba8c40bfd8aa085f67ca9,2,2,2,0,0,0,0,1,4,220,1,1,1,180,173,11,51,51,0,1663,1653,10,34,34,0,100
940493f37adab4c3e0da3f7e98b04037836a18b5,5,30,7,23,0,0,0,2,11,252,1,3,2.108309462,1274,174,12,337,329,8,11176,10968,208,123,121,2,100
f95e27221ec2bb39fc29e46c4b4789e87142cc5a,0,0,0,0,0,0,0,0,0,0,0,0,0,0,39,0,0,0,0,0,0,0,0,0,0,100
09e1155948e295b9fed27bf76d57125d75063726,0,0,0,0,0,0,0,0,0,0,0,0,0,0,40,1,0,0,0,0,0,0,0,0,0,100
2d4458383bd8a4a99da25171525ae9716061a339,2,125,20,105,0,0,0,1,8,134,1,2,0.105001496,749,175,13,102,95,7,5520,5163,357,59,56,3,100
9aed3b71c2e80014f8d3239273304a761891dd16,0,0,0,0,0,0,0,0,0,0,0,0,0,0,41,2,0,0,0,0,0,0,0,0,0,100
fdcb6c279bbc966d0d919333de43aa2f849d62e0,0,0,0,0,0,0,0,0,0,0,0,0,0,0,42,3,0,0,0,0,0,0,0,0,0,100
62d3cac249d5858d0650e1e5a1925ff98f4f05c1,0,0,0,0,0,0,0,0,0,0,0,0,0,0,176,12,0,0,0,0,0,0,0,0,0,100
2874dfde27e4390f9b2510629dacff9d2db409d6,0,0,0,0,0,0,0,0,0,0,0,0,0,0,43,4,0,0,0,0,0,0,0,0,0,100
ebbcdcacd48ecb210a165de2d149582c87baca85,1,5,1,4,0,0,0,4,6,128,1,1,0,135,0,0,20,18,2,1158,1126,32,4,4,0,100
d72dafc3e20c310271e45acb371529e18e0c2fc4,0,0,0,0,0,0,0,0,0,0,0,0,0,0,1,1,0,0,0,0,0,0,0,0,0,100
40b2a8672349cad661cf53f07d52d2219585e2fb,1,37,0,37,0,0,0,3,12,293,1,1,0,261,2,2,87,84,3,2151,2072,79,34,31,3,100
b180bd8ab188342dc989740e082e2bf3487882fa,3,14,9,5,0,0,0,2,10,757,1,3,1.121177461,608,177,0,83,81,2,4697,4665,32,48,46,2,100
b4ad6eb2375b93bfafde60fef3df4d1df021141b,2,5,13,8,0,0,0,2,15,429,1,2,0.852405179,999,178,1,304,309,5,8318,8356,38,95,97,2,100
c31563877d3ce82dda14d553d1132fecacc87c86,0,0,0,0,0,0,0,0,0,0,0,0,0,0,179,2,0,0,0,0,0,0,0,0,0,100
2af5295264a8d9fb13f5aa18ed860b67e51703b9,0,0,0,0,0,0,0,0,0,0,0,0,0,0,180,3,0,0,0,0,0,0,0,0,0,100
cef41283f2b5efd606d4a810e021218ee15a9fd9,0,0,0,0,0,0,0,0,0,0,0,0,0,0,44,0,0,0,0,0,0,0,0,0,0,100
2681d58693dcf0c7987307e939e3c551880e93d3,0,0,0,0,0,0,0,0,0,0,0,0,0,0,45,1,0,0,0,0,0,0,0,0,0,100
dbab66b91b879c902e700a0ca9bbdd48696cbf5b,2,14,0,14,0,0,0,3,7,490,1,2,0.940285959,410,46,2,74,70,4,3054,2971,83,36,35,1,100
f36a3b4bb5e9bc58f9bbe4579f8db2dd60ae45a3,0,0,0,0,0,0,0,0,0,0,0,0,0,0,47,3,0,0,0,0,0,0,0,0,0,100
c0d9d5c0be6ac5627f3a2009acb46840fc7305b4,0,0,0,0,0,0,0,0,0,0,0,0,0,0,66,0,0,0,0,0,0,0,0,0,0,100
634fead210e40e93f848389eff6118a1a2541d61,0,0,0,0,0,0,0,0,0,0,0,0,0,0,67,1,0,0,0,0,0,0,0,0,0,100
29f8701a42d172cf4b9a2a474000d509f34a2d46,2,72,8,64,0,0,0,2,16,115,1,2,0.543564443,828,3,0,281,281,0,7603,6883,720,83,81,2,100
70e19ce67e3ade7237663097c1952ed32f6b16b2,1,0,26,26,0,0,0,3,4,370,1,1,0,83,24,0,2,2,0,587,802,215,1,1,0,100
044c065e73bd04f639e7f26a9a8a3166fd3ab821,6,31,2,29,0,0,0,1,17,212,1,6,2.55034071,1918,181,0,640,635,5,16017,15864,153,168,163,5,100
e99366aa5977c973a7be3ca96adf51b3bf52801f,2,15,2,13,0,0,0,2,15,180,1,2,0.977417818,1923,182,1,477,473,4,14931,14803,128,239,238,1,100
0b1df07d7172c6b847fb3e5e6c9d7bdb1752aab3,1,12,1,11,0,0,0,2,2,1256,1,1,0,79,183,2,17,15,2,674,622,52,10,9,1,100
d517dcd5a1df13c49048ec19ad694e61edf2b5fd,3,42,16,26,0,0,0,2,6,867,1,2,0.861074727,233,184,3,44,44,0,1828,1831,3,31,31,0,100
c003680ca9f06f87e54385a84f30715358951537,0,0,0,0,0,0,0,0,0,0,0,0,0,0,25,1,0,0,0,0,0,0,0,0,0,100
d21d80226046af0947a860f249f1131c3671cedb,0,0,0,0,0,0,0,0,0,0,0,0,0,0,26,2,0,0,0,0,0,0,0,0,0,100
142bcd964e4b2b519b010ed377eb9101d0cfdb7d,1,199,0,199,1,0,1,1,1,0,1,1,0,0,4,1,16,0,16,661,0,661,9,0,9,99.86072423
69e23098c6ef347ebdcd4cb0a83c22b2a70f4e72,2,51,7,44,0,0,0,2,9,160,1,2,0.872696504,810,5,2,104,102,2,5737,5520,217,60,59,1,100
17207770e6e311d2faae7e47149b6b3cf6a2b2a3,0,0,0,0,0,0,0,0,0,0,0,0,0,0,27,3,0,0,0,0,0,0,0,0,0,100
e5c993189cdfddc4e42c65304ecdecf9c423b411,3,62,67,5,0,0,0,2,3,318,1,2,1.514691291,100,28,4,2,2,0,164,164,0,2,2,0,100
212c6ee756eba7a622148eaf7382ce6b7500e799,0,0,0,0,0,0,0,0,0,0,0,0,0,0,185,4,0,0,0,0,0,0,0,0,0,100
234487d0a347a100210258aea1466a2d3cde8509,4,40,3,37,0,0,0,2,6,245,1,3,1.645992759,606,186,5,162,159,3,4931,4639,292,75,74,1,100
abe9f8d8be7e75417a19c73e65bdab2c781a213b,5,67,10,57,0,0,0,2,4,256,1,4,1.861914587,529,187,6,91,80,11,5215,4772,443,48,43,5,100
fc616d5176ed4750c2382bb229aef9f1c62ea78e,0,0,0,0,0,0,0,0,0,0,0,0,0,0,68,2,0,0,0,0,0,0,0,0,0,100
6f117bde64f18e2b1920c732dbbf1e8ff16b1a0f,0,0,0,0,0,0,0,0,0,0,0,0,0,0,188,7,0,0,0,0,0,0,0,0,0,100
2850cfb21f3b2463205a4defda9bdcf0999ba93a,0,0,0,0,0,0,0,0,0,0,0,0,0,0,189,8,0,0,0,0,0,0,0,0,0,100
7fc68def2d27219fafd282c9525a3ad167e00b24,0,0,0,0,0,0,0,0,0,0,0,0,0,0,190,9,0,0,0,0,0,0,0,0,0,100
753c54f0c060e098cce00a125f6ce022dfa86815,0,0,0,0,0,0,0,0,0,0,0,0,0,0,48,1,0,0,0,0,0,0,0,0,0,100
a985f082ef6af57eb453228b0c74cf8222a28cf9,0,0,0,0,0,0,0,0,0,0,0,0,0,0,191,10,0,0,0,0,0,0,0,0,0,100
9869e9b5db2e54a072f46cebf7044fcfbd8ca166,0,0,0,0,0,0,0,0,0,0,0,0,0,0,192,4,0,0,0,0,0,0,0,0,0,100
61b059be57010a44023474ff40242a5c6e32ec75,1,2,2,0,0,0,0,2,16,51,1,1,0,1180,29,0,399,399,0,8974,8974,0,175,175,0,100
17aec14ebba7764fb20cf4745157788dfcfe78ab,0,0,0,0,0,0,0,0,0,0,0,0,0,0,193,2,0,0,0,0,0,0,0,0,0,100
6de7a277f7c58af8f5d831176951291cd2d87d81,0,0,0,0,0,0,0,0,0,0,0,0,0,0,49,0,0,0,0,0,0,0,0,0,0,100
a77a88d8b2afbfd3bf57546aa03a0c4f56699426,0,0,0,0,0,0,0,0,0,0,0,0,0,0,50,1,0,0,0,0,0,0,0,0,0,100
8f779e177336039e695e4e4c97a8e152ed6ea815,0,0,0,0,0,0,0,0,0,0,0,0,0,0,51,2,0,0,0,0,0,0,0,0,0,100
0ad579a6276a75f018d60be364534ad2d142db69,0,0,0,0,0,0,0,0,0,0,0,0,0,0,52,3,0,0,0,0,0,0,0,0,0,100
523d2de7141ff2e6a3416a0e04a647a4283e3d8f,0,0,0,0,0,0,0,0,0,0,0,0,0,0,53,4,0,0,0,0,0,0,0,0,0,100
98b14a071b3e5b6aa7c694731099f72ae22a3473,2,20,1,19,0,0,0,2,4,947,1,2,0.453716339,94,194,2,28,27,1,872,734,138,19,18,1,100
c9dfafb695b7d7b3e4f637e0f9af862c6dad8a28,1,8,2,6,0,0,0,4,10,71,1,1,0,335,195,3,56,54,2,2200,2168,32,29,29,0,100
6979b94bbf1cdbd6845553424d9e6b1228931375,0,0,0,0,0,0,0,0,0,0,0,0,0,0,196,4,0,0,0,0,0,0,0,0,0,100
66a34cf75e174d15451746f1b509993538603df3,0,0,0,0,0,0,0,0,0,0,0,0,0,0,197,5,0,0,0,0,0,0,0,0,0,100
87c3c2f57e0e2b67088ec3148a8a410ef8e4c0e6,0,0,0,0,0,0,0,0,0,0,0,0,0,0,198,5,0,0,0,0,0,0,0,0,0,100
0ea74a36cebb2e5fbc37e599814a05c33cb7d424,4,647,0,647,4,0,4,1,1,0,1,3,1.968890359,0,199,6,86,0,86,3389,0,3389,31,0,31,99.31034483
989b7b643a038f32a84f14f428ca901b5bbfdef0,0,0,0,0,0,0,0,0,0,0,0,0,0,0,200,7,0,0,0,0,0,0,0,0,0,100
17e0ec1ab5762644682900251ae5ad4eb8bdd249,0,0,0,0,0,0,0,0,0,0,0,0,0,0,0,0,0,0,0,0,0,0,0,0,0,100
23fc278df3a8ae5a2b9093f9b91934d58a184fee,0,0,0,0,0,0,0,0,0,0,0,0,0,0,1,1,0,0,0,0,0,0,0,0,0,100
36f9b467e714eff199edac938c00e017accefa5a,3,28,6,22,0,0,0,2,18,126,1,3,1.082720388,1188,201,3,319,318,1,10598,10436,162,107,106,1,100
5cac72e7c1173faae8da920eb9461b9ea958f96f,1,12,11,1,0,0,0,2,2,106,1,1,0,114,69,0,31,33,2,979,989,10,8,8,0,100
446bd1be05c2e1c385d24b31e79504a9fcb1b4b2,44,6208,0,6208,44,0,44,1,1,0,1,9,5.021740929,0,202,0,402,0,402,26712,0,26712,268,0,268,88.84172226
2cb83f478424c00d36d2b58cae1508d1ab4df235,0,0,0,0,0,0,0,0,0,0,0,0,0,0,203,1,0,0,0,0,0,0,0,0,0,100
6fd751939e1759654c174b863637fad12ced9269,0,0,0,0,0,0,0,0,0,0,0,0,0,0,70,1,0,0,0,0,0,0,0,0,0,100
64664a630cb0674f145a1b8f4ef132b83bde9523,0,0,0,0,0,0,0,0,0,0,0,0,0,0,71,2,0,0,0,0,0,0,0,0,0,100
52ea2d88416fbf964cfd6bf1c6c959596ed1063e,0,0,0,0,0,0,0,0,0,0,0,0,0,0,54,0,0,0,0,0,0,0,0,0,0,100
03dfcb3c4ce15896c12b39f96dbe3de1894dc172,0,0,0,0,0,0,0,0,0,0,0,0,0,0,55,1,0,0,0,0,0,0,0,0,0,100
acfa07feb6b47e554d14429c3c98a8810ac3be42,0,0,0,0,0,0,0,0,0,0,0,0,0,0,204,0,0,0,0,0,0,0,0,0,0,100
6cf7a47b16039ee50cd616eedf23e8e166d457e4,0,0,0,0,0,0,0,0,0,0,0,0,0,0,205,1,0,0,0,0,0,0,0,0,0,100
34ece34c097347fd06b0e4f717d5d102266e25ff,1,2,2,0,0,0,0,2,2,76,1,1,0,70,72,0,6,6,0,574,574,0,3,3,0,100
6eb2c5801e9029b22e5800a86986bde03d5541b9,0,0,0,0,0,0,0,0,0,0,0,0,0,0,73,1,0,0,0,0,0,0,0,0,0,100
b50ab97269c4c52bf45db27d5b54e0d6e0e4154c,2,9,2,7,0,0,0,3,4,1430,1,2,0.945660305,780,74,2,153,153,0,4477,4467,10,31,31,0,100
563afdbf1e35b7d12723d0c88562a8f277ddd353,0,0,0,0,0,0,0,0,0,0,0,0,0,0,75,3,0,0,0,0,0,0,0,0,0,100
0b0a574620b6ab87f36e4cad8480e9872c40f90a,0,0,0,0,0,0,0,0,0,0,0,0,0,0,76,4,0,0,0,0,0,0,0,0,0,100
5e8664c16e75d4d9a4523d368ef75290fd0ea4c2,0,0,0,0,0,0,0,0,0,0,0,0,0,0,77,5,0,0,0,0,0,0,0,0,0,100
c6cf5d5fc36c69525dbf3712af42014a3da417e0,0,0,0,0,0,0,0,0,0,0,0,0,0,0,78,6,0,0,0,0,0,0,0,0,0,100
7d46ba4ab4c4589e544f3df51b9d4552771b14fb,0,0,0,0,0,0,0,0,0,0,0,0,0,0,79,7,0,0,0,0,0,0,0,0,0,100
e16dd633702a190f91767a14c33393e2d0bbbf91,1,2,2,0,0,0,0,2,5,1089,1,1,0,275,206,2,54,54,0,1927,1928,1,33,33,0,100
7fb563982d6f44d05a6f3c578a6948e7c7d6f1e5,2,74,1,73,1,0,1,1,13,148,1,2,0.665273523,215,207,3,97,83,14,2285,1891,394,25,16,9,99.61811238
02802d57b0698cacf72668fa50ca93e77c12b302,4,30,4,26,0,0,0,2,19,225,1,4,1.214210357,2939,208,4,783,781,2,23645,23436,209,337,336,1,100
4a6cd2780b741db3a01296f758abdd6fcaa71a40,0,0,0,0,0,0,0,0,0,0,0,0,0,0,209,5,0,0,0,0,0,0,0,0,0,100
5be068e83656f026c68ebe78bb039b84165564e5,9,208,14,194,1,0,1,1,13,621,1,6,1.973779552,1794,210,6,446,429,17,15418,14321,1097,210,200,10,99.89071038
1f3580f5d53746eaf8eb1d5d0fad00a18971666c,1,13,11,2,0,0,0,2,7,0,1,1,0,274,211,7,54,54,0,1870,1904,34,34,33,1,99.94541485
2020c8a8cc19c58eaef2d9de75260e7341099038,6,408,5,403,3,0,3,1,14,0,1,4,1.639100432,1022,212,8,304,239,65,11210,8850,2360,138,98,40,99.67302452
f84b9a4b6af31a7758f48f947e6a8fde1f126661,2,8,0,8,0,0,0,2,15,0,1,2,0.543564443,913,213,9,214,212,2,8112,8053,59,86,85,1,100
d4151ed11a8a0f2a5a2032d524951efb3d50560e,2,34,1,33,1,0,1,1,5,148,1,2,0.315997133,402,214,10,124,123,1,3294,3202,92,60,59,1,99.89130435
d3b4045aa537e048c2df007afd6e54b7ace5f272,1,1,0,1,0,0,0,2,5,228,1,1,0,81,215,11,26,25,1,636,625,11,17,17,0,100
91af47b9ef66965d1df524c555d29af24d9b75c4,2,60,4,56,1,0,1,1,8,241,1,2,0.757878463,512,216,12,156,155,1,3930,3686,244,43,42,1,99.78319783
dc4d37dd6d5d69ea27ffff797d926b9042719643,0,0,0,0,0,0,0,0,0,0,0,0,0,0,217,13,0,0,0,0,0,0,0,0,0,100
2567f66612bc97f984f52be54b0b213882a52287,0,0,0,0,0,0,0,0,0,0,0,0,0,0,218,14,0,0,0,0,0,0,0,0,0,100
aa24373e12a75bff689a543711391597d0e63e6b,0,0,0,0,0,0,0,0,0,0,0,0,0,0,56,0,0,0,0,0,0,0,0,0,0,100
e7619cc5dec31c6db342d341504635048d60afb1,0,0,0,0,0,0,0,0,0,0,0,0,0,0,57,1,0,0,0,0,0,0,0,0,0,100
24673177ca18128f1c5dd137e5968ae4e8359e7f,0,0,0,0,0,0,0,0,0,0,0,0,0,0,58,2,0,0,0,0,0,0,0,0,0,100
78b172c040f934ad59635b69ff797a09ff039136,0,0,0,0,0,0,0,0,0,0,0,0,0,0,59,3,0,0,0,0,0,0,0,0,0,100
b49babe09e3c2a83fee4d52b11822d500ebc67f1,0,0,0,0,0,0,0,0,0,0,0,0,0,0,60,4,0,0,0,0,0,0,0,0,0,100
46726e0e5b5a722096a2594c83946ac5c996bd10,0,0,0,0,0,0,0,0,0,0,0,0,0,0,61,5,0,0,0,0,0,0,0,0,0,100
60d75c554ccbc72b8a60c5759f0175ae07e8254a,0,0,0,0,0,0,0,0,0,0,0,0,0,0,62,6,0,0,0,0,0,0,0,0,0,100
fbb36181e2b30571b71d177986f0e75285736866,0,0,0,0,0,0,0,0,0,0,0,0,0,0,63,7,0,0,0,0,0,0,0,0,0,100
bc4e7d8066a1ee564c096fc940e34f1b45c07eec,0,0,0,0,0,0,0,0,0,0,0,0,0,0,64,8,0,0,0,0,0,0,0,0,0,100
034665d0cd02b90558bb39115f7f1f2b42e4e156,0,0,0,0,0,0,0,0,0,0,0,0,0,0,80,8,0,0,0,0,0,0,0,0,0,100
b6632258952f5e60a1a40c10ea2625ba6c1f841f,0,0,0,0,0,0,0,0,0,0,0,0,0,0,81,9,0,0,0,0,0,0,0,0,0,100
099e20794a818ccb5cbab71d1934c784ed45ac14,0,0,0,0,0,0,0,0,0,0,0,0,0,0,65,9,0,0,0,0,0,0,0,0,0,100
3c2cec4957178552c5e325e622da270d863815f6,0,0,0,0,0,0,0,0,0,0,0,0,0,0,66,10,0,0,0,0,0,0,0,0,0,100
b52d006922d50150e4de9b447f44be574bef9633,0,0,0,0,0,0,0,0,0,0,0,0,0,0,2,0,0,0,0,0,0,0,0,0,0,100
ab4fe4f2647bca4123a6c1f5f5012958d75affcf,3,54,0,54,0,0,0,1,2,10,1,2,1.584962501,230,219,15,39,39,0,1623,1623,0,26,26,0,100
c7e3f4a687564b125686f4a075d8fcfa90d63aaf,2,747,0,747,2,0,2,1,1,0,1,2,0.845867078,0,220,16,62,0,62,2918,0,2918,29,0,29,99.46495452
a581cf389f5d4ce82ff95f3d9d98efbe326cacae,2,15,0,15,0,0,0,2,5,1016,1,2,0.566509507,1013,221,15,190,188,2,6584,6482,102,101,100,1,100
ea125d9f3a7aaa3876bab84b08a0d7f1fa2e8904,0,0,0,0,0,0,0,0,0,0,0,0,0,0,222,16,0,0,0,0,0,0,0,0,0,100
172408e77233aa562d5b3a5c3fae9c8a7160ca86,0,0,0,0,0,0,0,0,0,0,0,0,0,0,223,17,0,0,0,0,0,0,0,0,0,100
f9a423d2a85d820cec8404a254b605f56eb070c7,0,0,0,0,0,0,0,0,0,0,0,0,0,0,224,18,0,0,0,0,0,0,0,0,0,100
3a7cc7ea565e8ff1a5dc6b106f7828e0922916c7,0,0,0,0,0,0,0,0,0,0,0,0,0,0,67,0,0,0,0,0,0,0,0,0,0,100
a39e6deea243dcd9a09df8f67af724003dec1d02,2,67,4,63,1,0,1,1,6,359,1,2,0.507935356,582,225,0,120,114,6,3646,3388,258,46,41,5,96.83985003
a760e09477b74b640ff8796c02da1c2be8585d1f,0,0,0,0,0,0,0,0,0,0,0,0,0,0,226,1,0,0,0,0,0,0,0,0,0,100
cbe3f07f01fa77c0f4cf6d18393856bcc01d5db5,0,0,0,0,0,0,0,0,0,0,0,0,0,0,227,2,0,0,0,0,0,0,0,0,0,100
f563913d15ec74a44ca86c8bd528b3573a4b031a,43,258,215,43,0,0,0,1,3,170,1,9,5.426264755,3197,228,3,397,397,0,26076,26076,0,263,263,0,100
dedacbf2e159dbf695aad3e9669940da0cc55a2c,3,896,1,895,2,0,2,1,3,0,1,2,1.030016883,22,229,4,76,3,73,4732,209,4523,38,2,36,88.37485172
98cffd10bbdb249a962e77ec6fbc993e56279b8e,1,13,2,11,0,0,0,2,3,377,1,1,0,88,230,5,17,17,0,708,674,34,10,10,0,100
03f675f14810ae9341632a9b9d077afd74887473,3,25,5,20,0,0,0,1,4,8,1,2,1.373017485,161,231,6,25,23,2,1565,1439,126,19,18,1,89.65863454
eaa8213371b88ceb301520235782db7bc95358d4,6,147,10,137,0,0,0,1,3,6,1,3,0.846019505,475,232,7,63,54,9,5002,4002,1000,45,39,6,99.71819646
04f9469cc9e9e0cbb8158cd503612bccef2ade1b,0,0,0,0,0,0,0,0,0,0,0,0,0,0,68,1,0,0,0,0,0,0,0,0,0,100
69135f593004a942c43fec1194148689df5b1d0a,0,0,0,0,0,0,0,0,0,0,0,0,0,0,69,2,0,0,0,0,0,0,0,0,0,100
6e9b037d4f4bcdfc955ffec71dea0f195d81c2a8,0,0,0,0,0,0,0,0,0,0,0,0,0,0,70,2,0,0,0,0,0,0,0,0,0,100
f60833f8d4251691ea9134beacaf0abc09afdea8,0,0,0,0,0,0,0,0,0,0,0,0,0,0,71,3,0,0,0,0,0,0,0,0,0,100
061fc31088fe6f2d2a96253607c47c2d56c016ea,2,74,11,63,0,0,0,1,2,124,1,2,0.64544959,375,233,0,68,62,6,3465,2918,547,33,29,4,100
fdba5e0eb725230fc1cb55b653bb88f597015728,0,0,0,0,0,0,0,0,0,0,0,0,0,0,82,0,0,0,0,0,0,0,0,0,0,100
f64893200b21f504c0bc291789de093728fae4ab,2,297,27,270,1,0,1,1,8,308,1,2,0.775203027,124,234,1,42,15,27,2207,898,1309,32,11,21,96.26655961
dd4db64fdcd29966924effefa747d50a1a256700,0,0,0,0,0,0,0,0,0,0,0,0,0,0,83,1,0,0,0,0,0,0,0,0,0,100
10c9b56e8af246d884c7f549bfe2d011881f8df8,0,0,0,0,0,0,0,0,0,0,0,0,0,0,235,2,0,0,0,0,0,0,0,0,0,100
b49190ec19694313d287331e48f03c6f4aae90fb,0,0,0,0,0,0,0,0,0,0,0,0,0,0,236,3,0,0,0,0,0,0,0,0,0,100
85a0b7c2e7caff6a3836fdf97cc68c521036b7a7,0,0,0,0,0,0,0,0,0,0,0,0,0,0,237,3,0,0,0,0,0,0,0,0,0,100
fa3db4e5b698ce3787ec3b0d7e60ee8410aec240,2,2,1,1,0,0,0,2,6,1059,1,2,0.918295834,225,238,3,22,22,0,2313,2293,20,14,14,0,100
eaa43dbcf545d2b28d5ed49b86e85d25742fc5ed,0,0,0,0,0,0,0,0,0,0,0,0,0,0,84,1,0,0,0,0,0,0,0,0,0,100
be2f37890c7368277aabad722bad608f9d0fcb12,0,0,0,0,0,0,0,0,0,0,0,0,0,0,239,1,0,0,0,0,0,0,0,0,0,100
196011b43149f38797fb7c462a0a46e0263d9f4e,10,53,14,39,0,0,0,1,16,189,1,4,3.12203715,1058,240,2,287,284,3,9314,9094,220,88,85,3,100
a76428f0e1e3d0fef6a596eb953a1a79facd5006,0,0,0,0,0,0,0,0,0,0,0,0,0,0,85,0,0,0,0,0,0,0,0,0,0,100
ab5eb85475902d62de9b16ad2f008b4f7f385f4a,0,0,0,0,0,0,0,0,0,0,0,0,0,0,86,1,0,0,0,0,0,0,0,0,0,100
1096f34fa9dd01d418616a00184029f2a85c1bca,0,0,0,0,0,0,0,0,0,0,0,0,0,0,241,0,0,0,0,0,0,0,0,0,0,100
31d32f47d50ffcf48f5e785212cc2140e7554681,0,0,0,0,0,0,0,0,0,0,0,0,0,0,87,2,0,0,0,0,0,0,0,0,0,100
9babffef5210c3d1621fb99c9b516cdd920d8821,0,0,0,0,0,0,0,0,0,0,0,0,0,0,88,1,0,0,0,0,0,0,0,0,0,100
6816e60f93ad02388b4fbcf4b9a0c70a7f640ef6,2,57,5,52,0,0,0,2,17,232,1,2,0.889034904,923,242,0,226,215,11,8475,8125,350,90,87,3,100
df362fa186cd0ed08737391f430e7068aff04f34,1,6,3,3,0,0,0,2,2,1905,1,1,0,42,243,1,6,5,1,265,259,6,5,4,1,100
911cc53aea0ed2f26fe772b7d4751f2691233a01,5,75,20,55,0,0,0,1,18,279,1,3,1.686640404,1493,244,2,394,387,7,13052,12669,383,166,161,5,99.83805668
69c305b834818ba84b14a1b7f9636a6f80a41588,0,0,0,0,0,0,0,0,0,0,0,0,0,0,245,3,0,0,0,0,0,0,0,0,0,100
2ff7ecbc409b2e0f72a253a09091fcc0f34f0544,2,33,1,32,0,0,0,4,9,573,1,2,0.936667382,232,0,0,34,31,3,1784,1590,194,27,24,3,100
6d91cdfad4aeb24a82579ffb1e136e7c565a47b7,2,41,1,40,0,0,0,4,9,953,1,2,1,218,1,1,38,35,3,1694,1453,241,27,25,2,100
8775193276e3c5511b6a97a9546c8c9804706b28,44,4867,1,4866,43,0,43,1,5,24,1,5,5.114027773,64,246,4,721,10,711,26492,500,25992,310,4,306,95.96868885
156280d809b673fc56d57b7d1a351458c5181061,1,16,0,16,0,0,0,1,5,821,1,1,0,174,247,5,53,51,2,1667,1595,72,36,34,2,100
bd0f7ef963c6a9537e23713129febe2d0f2a6fd9,2,0,2,2,0,0,0,2,19,4,1,2,1,989,2,2,230,230,0,8738,8764,26,92,92,0,100
a4994fdf861d381ea9c6496935a09646dfbf0116,2,29,4,25,0,0,0,2,20,0,1,2,0.945660305,987,248,6,234,230,4,8866,8738,128,95,92,3,100
c0781539c1b155ed7b7a53303ec46f1200015e5c,2,4,3,1,0,0,0,2,20,358,1,2,0.985228136,1024,249,7,305,305,0,8706,8706,0,98,98,0,100
92a56a456c65dc728773c6434f8877987cf7c07f,0,0,0,0,0,0,0,0,0,0,0,0,0,0,250,8,0,0,0,0,0,0,0,0,0,100
6f5327bf7fc0a62f7e1d737571780e20fcbfe4a2,2,163,2,161,1,0,1,1,11,292,1,2,0.628478325,341,251,9,71,56,15,2839,2200,639,31,29,2,96.37764933
111b2f49cd1685217319ed90ec00ed547848cc41,0,0,0,0,0,0,0,0,0,0,0,0,0,0,252,10,0,0,0,0,0,0,0,0,0,100
850ca3cff4da4fc5f05072c27257b830fec5004c,0,0,0,0,0,0,0,0,0,0,0,0,0,0,72,0,0,0,0,0,0,0,0,0,0,100
9fff186165946961776cde4e47793395a4a65e78,0,0,0,0,0,0,0,0,0,0,0,0,0,0,73,1,0,0,0,0,0,0,0,0,0,100
b85435944b6845dded6e512db2b25457e21aa830,0,0,0,0,0,0,0,0,0,0,0,0,0,0,74,2,0,0,0,0,0,0,0,0,0,100
124ed638b1472e67fd0efc21a5b2b77bedb78d35,0,0,0,0,0,0,0,0,0,0,0,0,0,0,75,3,0,0,0,0,0,0,0,0,0,100
13bb8b26f0d9b08baf3570ade1aa2a043b60d8b4,0,0,0,0,0,0,0,0,0,0,0,0,0,0,76,4,0,0,0,0,0,0,0,0,0,100
a6cc5ca284ab09563228129dd700fb33dcd12d51,2,56,2,54,0,0,0,1,3,282,1,2,0.362051252,115,253,11,9,7,2,1468,1078,390,6,5,1,96.07381233
7470a57f98d9d9d0ef083b998cbc63f1baf75eea,0,0,0,0,0,0,0,0,0,0,0,0,0,0,254,12,0,0,0,0,0,0,0,0,0,100
c41fc158d0f29ceea675ce7c9f8f277ddc51d87e,0,0,0,0,0,0,0,0,0,0,0,0,0,0,255,13,0,0,0,0,0,0,0,0,0,100
17fe15ec630c8c1512bdfc7f20fd81948c7a5897,0,0,0,0,0,0,0,0,0,0,0,0,0,0,256,14,0,0,0,0,0,0,0,0,0,100
d2d05c3e5952bf56741c2cb8434292867c4a1096,2,12,2,10,0,0,0,2,15,582,1,2,0.863120569,270,257,15,94,93,1,2411,2356,55,22,21,1,100
cc6dce5eac8cf960f68175ffc13c99ea8217e00a,10,52,95,43,0,0,0,2,4,1339,1,7,2.859315973,1120,258,16,82,85,3,10491,10471,20,55,58,3,96.22557726
5f19b060591af1de2b09487ff464bea8bf0b498e,0,0,0,0,0,0,0,0,0,0,0,0,0,0,77,5,0,0,0,0,0,0,0,0,0,100
a2589652eea0a321df6a4b9d60c43dc7a828112c,0,0,0,0,0,0,0,0,0,0,0,0,0,0,78,6,0,0,0,0,0,0,0,0,0,100
828c61c5f40d39697cd4a72b5ce0ea279a65870f,0,0,0,0,0,0,0,0,0,0,0,0,0,0,79,7,0,0,0,0,0,0,0,0,0,100
caad471d0ec01197074a68ae5f77e311281b877f,0,0,0,0,0,0,0,0,0,0,0,0,0,0,259,17,0,0,0,0,0,0,0,0,0,100
69aef1e46bb98eaab52b00a64b5380a16481c1b7,0,0,0,0,0,0,0,0,0,0,0,0,0,0,260,18,0,0,0,0,0,0,0,0,0,100
7b78665d822003b268e8f7d34ac3cb6e967309af,0,0,0,0,0,0,0,0,0,0,0,0,0,0,261,19,0,0,0,0,0,0,0,0,0,100
ba55d815ea63d923fea504d1da8baa1e5920701f,0,0,0,0,0,0,0,0,0,0,0,0,0,0,262,16,0,0,0,0,0,0,0,0,0,100
79323b0bd6a3e77469f9b4c23f33783460324e09,1,4,4,0,0,0,0,2,5,1185,1,1,0,369,263,17,111,111,0,2558,2562,4,11,11,0,100
1b896e1a8456c2320f3dba8eef43beffd15d2d91,3,2,5,3,0,0,0,2,4,1569,1,2,1.148834854,224,264,18,26,26,0,1901,1919,18,21,21,0,100
c3577650285efd083a22a86670e33137d0fc6cdf,4,41,117,76,0,0,0,2,4,317,1,4,1.616323079,710,3,0,136,139,3,4254,4543,289,69,72,3,92.4037981
f920d4e1067e5951b5ea7b38b6cb5d925d60b99b,0,0,0,0,0,0,0,0,0,0,0,0,0,0,265,16,0,0,0,0,0,0,0,0,0,100
01f774f28153d220f59bff026ade4982d20ace2d,0,0,0,0,0,0,0,0,0,0,0,0,0,0,3,0,0,0,0,0,0,0,0,0,0,100
1dbb07ac2f068dbc6b0bea963bf2abacab7cc434,0,0,0,0,0,0,0,0,0,0,0,0,0,0,266,1,0,0,0,0,0,0,0,0,0,100
3c15fc6183d1df06abc2eb1904f9c4514ef4f665,5,181,151,30,1,0,1,2,18,402,1,3,1.788221648,2851,267,0,753,756,3,21941,21845,96,336,340,4,97.20998532
9b9068a00a3a1fac2525fe245365238b58370120,3,72,0,72,1,0,1,2,10,52,1,3,1.560535828,1061,268,1,190,184,6,10050,9686,364,63,61,2,99.90224829
9e5e0462b1957c372bd7351b7f5e6c68d4a41b5d,0,0,0,0,0,0,0,0,0,0,0,0,0,0,269,2,0,0,0,0,0,0,0,0,0,100
f261733c575fbb57ced1f11e8af69ec88b573b8a,2,6,2,4,0,0,0,4,7,920,1,1,0.954434003,99,4,0,16,16,0,726,704,22,6,6,0,100
121b98ddc5a9db44040260bf5a6ec7bb106ad3de,2,174,0,174,0,0,0,3,8,1022,1,2,0.383269164,171,5,1,72,44,28,2560,1434,1126,46,24,22,99.60841899
b81a91a57a111650245aa803a3c2233995b3bf56,2,2,6,4,0,0,0,4,8,0,1,1,0.954434003,102,6,2,16,16,0,704,726,22,6,6,0,100
957ccf706a1d124c7fb74caf31862b9c03a99a1b,2,65,2,63,0,0,0,4,9,10,1,1,0.879458774,99,7,3,27,16,11,984,704,280,6,6,0,100
1638ebb5ea88f277fe065babd90551fbf74439df,2,69,18,51,1,0,1,1,5,591,1,2,0.995325107,441,270,3,114,110,4,3975,3993,18,102,100,2,99.70631424
c8fe3e085e7afb5ee7de69561f0578a8ca2f046c,7,35,25,10,0,0,0,1,21,365,1,7,2.290018766,1799,271,4,459,458,1,15297,15241,56,203,202,1,97.41463415
22d55ddf3e6ff8021da1743c8bb989111391b32a,2,108,0,108,2,0,2,1,1,0,1,1,0.99975261,0,272,4,4,0,4,681,0,681,2,0,2,97.22492697
88736f8d389c17584508a105d608bca2b3281084,5,200,1,199,4,0,4,1,7,170,1,2,2.16056545,50,273,4,15,6,9,935,412,523,9,3,6,98.67582148
a2a7aeae62aa0eb9f3225ce0befde7a7bedfbad2,4,177,35,142,1,0,1,1,22,148,1,3,1.592668878,875,274,5,329,311,18,7782,7088,694,121,107,14,99.34967484
a8a905895a6a8a71617158bf4059f15905b3dd71,3,34,0,34,1,0,1,1,7,350,1,2,0.381580488,187,275,6,53,53,0,1783,1698,85,36,36,0,99.74709155
fab6363adf4cf07db4004017c8e1dc5968850475,0,0,0,0,0,0,0,0,0,0,0,0,0,0,276,4,0,0,0,0,0,0,0,0,0,100
0c5813b70f38952cbac69f5217bbf13e0e0b1a4c,2,4,4,0,0,0,0,2,3,316,1,2,1,491,277,5,104,104,0,3407,3407,0,43,43,0,100
2efa6cee3abd81f2816cff9631606647ed5998fb,0,0,0,0,0,0,0,0,0,0,0,0,0,0,278,6,0,0,0,0,0,0,0,0,0,100
fb165e6ec812d4d03ea89de09ca1b758a7cdab6c,0,0,0,0,0,0,0,0,0,0,0,0,0,0,279,7,0,0,0,0,0,0,0,0,0,100
23c2acf93231095ae5f7eb58c08748b62c83d9b5,2,29,22,7,0,0,0,2,6,1245,1,1,0.818955502,1000,280,8,242,237,5,6855,6822,33,94,89,5,100
47308d10309622d3e04912485b1c951f67d4ca73,6,215,11,204,0,0,0,4,11,248,1,3,1.429010054,776,281,9,223,199,24,6752,5701,1051,71,56,15,100
2eb0672964db2f8a0b047c62f0f50a4c8222cdc5,0,0,0,0,0,0,0,0,0,0,0,0,0,0,282,10,0,0,0,0,0,0,0,0,0,100
8e33d6c26000e31ee22e1f32e73324582f669ebc,0,0,0,0,0,0,0,0,0,0,0,0,0,0,25,0,0,0,0,0,0,0,0,0,0,100
dc1eadb8806821000412fa77963e86a60f78267b,0,0,0,0,0,0,0,0,0,0,0,0,0,0,26,1,0,0,0,0,0,0,0,0,0,100
d160f17357c241a2c925a182e064f4068db22fe6,0,0,0,0,0,0,0,0,0,0,0,0,0,0,283,11,0,0,0,0,0,0,0,0,0,100
f0e4e90568d40992c78e0b2e5e2367d33b1d05e1,0,0,0,0,0,0,0,0,0,0,0,0,0,0,80,0,0,0,0,0,0,0,0,0,0,100
785523bf05b62b0681e5c81ed210843262b59546,0,0,0,0,0,0,0,0,0,0,0,0,0,0,284,11,0,0,0,0,0,0,0,0,0,100
bfc1bdc733da592fd665a56692a4f5c08e731f53,0,0,0,0,0,0,0,0,0,0,0,0,0,0,285,9,0,0,0,0,0,0,0,0,0,100
a77d713671e7a53a3c7ebed1d3f5b843b224a6da,0,0,0,0,0,0,0,0,0,0,0,0,0,0,4,0,0,0,0,0,0,0,0,0,0,100
111c5c91507b943acfdb1370dd9401de4a63b5a8,3,237,0,237,3,0,3,1,1,0,1,1,1.478328754,0,8,0,17,0,17,1326,0,1326,9,0,9,98.02431611
588288be89c3d8aeca79f6aa41d09f3efe5a0918,1,5,1,4,0,0,0,2,4,1699,1,1,0,150,286,1,19,18,1,1107,1079,28,8,7,1,100
6774ee3b5f08666c6ba1e9ee6040283932d0f875,2,5,3,2,0,0,0,2,11,1128,1,2,0.811278124,301,287,2,50,49,1,2161,2158,3,16,16,0,100
a4769d950af7074c060d7f962fada88352620dbe,2,14,0,14,0,0,0,1,2,374,1,2,0.371232327,320,288,0,67,66,1,2714,2631,83,28,27,1,100
53fa2dcc0773985912ce5ced3c1dea1e5b2d0a45,0,0,0,0,0,0,0,0,0,0,0,0,0,0,9,0,0,0,0,0,0,0,0,0,0,100
77c48330740108e658cb3fcc94c4d8e04324e547,2,12,0,12,0,0,0,1,2,382,1,2,0.41381685,467,289,1,111,110,1,3947,3829,118,43,42,1,100
7e141b815cd05d75a210b00010a6cad8edbb84b7,9,76,5,71,0,0,0,1,3,212,1,5,2.374449339,1336,290,2,346,326,20,11122,10663,459,124,118,6,100
350f09f3cefec53e20762e7862cb37f38c6251e6,6,165,15,150,2,0,2,1,4,1424,1,3,1.738281676,198,291,3,52,37,15,1851,1219,632,34,27,7,98.22154472
30e1a5222aba7f80e9609b020816931e857d35ef,2,9,1,8,0,0,0,2,12,258,1,2,0.970950594,608,292,4,172,171,1,4490,4422,68,54,53,1,85.30693069
fd4edf6088965a6edda1bfc17ce992b0e0e1c37c,3,100,0,100,1,0,1,1,4,910,1,3,1.162073433,386,293,5,47,42,5,4100,3527,573,30,26,4,85.48065417
7666029b4a61c67530f24ee3bc109a520c296f95,2,2,0,2,0,0,0,1,8,172,1,1,1,189,294,6,55,53,2,1754,1718,36,38,36,2,100
dc0d13f9456637e26b4e977bc187453d584d87e8,2,2,1,1,0,0,0,1,4,378,1,2,0.918295834,252,295,7,41,41,0,1642,1638,4,26,26,0,99.79274611
acf33453c71da6b92f9feface1a9e7c8d36456a0,1,5,4,1,0,0,0,1,4,51,1,1,0,303,296,1,82,82,0,2137,2110,27,25,25,0,100
ed8c6144f8fd716203a933fab8b43a9cb79e71e2,6,276,67,209,1,0,1,1,23,371,1,4,2.254551006,1345,297,2,423,392,31,11924,10778,1146,137,130,7,99.74133471
d84d4df196746d00c85657672b64e20be3c0d2e8,3,20,2,18,0,0,0,2,15,795,1,3,1.502220254,444,298,3,138,135,3,3481,3420,61,62,59,3,100
e73d18ddd3554dcaf36063ce7bc26f418155cff2,2,60,5,55,1,0,1,1,2,223,1,2,0.779349837,69,299,4,9,7,2,888,599,289,4,2,2,99.84520124
57c9811a1695761d3e0f224b7e89e8174d927e43,4,56,19,37,0,0,0,2,6,1382,1,1,1.25704865,874,300,4,226,216,10,6169,5982,187,77,67,10,100
448249366ff5ab9f5cfe4117b26ef0ab3bc7d047,3,208,0,208,2,0,2,1,6,151,1,2,1.035360097,67,26,0,21,10,11,1462,515,947,12,4,8,94.37119675
68bdc4317ef2c5e33ad23bbc78f0b0690350e459,2,18,0,18,0,0,0,2,7,510,1,2,0.764204507,1031,301,5,197,194,3,6758,6648,110,106,105,1,100
cf495ef5736b6fc960196dda969fb1072ead324e,3,378,0,378,2,0,2,1,7,2,1,2,0.996671657,68,302,6,42,10,32,2696,520,2176,17,4,13,99.75099602
4d8a4dd7a2582ad4fa59b8ed3e0db27b91559334,10,527,18,509,4,0,4,2,7,768,1,8,2.986944419,259,303,7,70,27,43,4417,2136,2281,47,18,29,95.49727857
c6d00c7462eaef15703f1b4ac635ac278263a6fe,2,16,3,13,0,0,0,3,8,980,1,2,0.981940787,520,304,8,91,89,2,3775,3735,40,48,48,0,100
e044aadc7c2d7da7f5f50a651b219d3270494263,3,148,0,148,2,0,2,1,2,155,1,2,1.087623966,18,305,9,14,5,9,710,126,584,5,1,4,99.75429975
e32e2198384ed0c887c8d96f30c791dc0cfd91dc,12,145,48,97,0,0,0,2,16,1549,1,7,3.093478905,1297,306,10,305,288,17,10560,9905,655,183,166,17,100
21c239025f435bea117e11e61792b89d20a9110e,4,345,5,340,2,0,2,1,4,808,1,3,0.964750357,164,307,11,83,24,59,3096,1081,2015,52,13,39,97.48134328
85b9c2c8c79c34b2ebbd6187da58f6b46652f440,0,0,0,0,0,0,0,0,0,0,0,0,0,0,308,12,0,0,0,0,0,0,0,0,0,100
267bda8996a1c8ae0d016b25486731ce122cf222,3,133,116,17,1,0,1,1,10,380,1,1,1.252482532,313,309,13,38,43,5,2156,2146,10,31,34,3,98.95738894
f5c61dab3264c77e5ec12d7b1ddb95bd2239b51f,2,106,37,69,0,0,0,1,4,498,1,2,0.927338928,553,310,14,86,78,8,5346,4613,733,40,38,2,100
9eae49165b55cc25f441b5d52eafe95367fe9441,14,1153,19,1134,12,0,12,1,2,68,1,3,3.626321454,175,311,12,71,15,56,6027,1480,4547,51,9,42,98.03742583
a78127b2356b9f6c2efab7e36cee442be5be90f4,0,0,0,0,0,0,0,0,0,0,0,0,0,0,312,13,0,0,0,0,0,0,0,0,0,100
8e8de3360c93cca2b6e2877f96423cdf0b48e747,0,0,0,0,0,0,0,0,0,0,0,0,0,0,313,14,0,0,0,0,0,0,0,0,0,100
1dc08581ba6ad5c17d20555818faef9da300478c,0,0,0,0,0,0,0,0,0,0,0,0,0,0,314,15,0,0,0,0,0,0,0,0,0,100
b99318cc3b18e60a051cb03699e592611a50919e,0,0,0,0,0,0,0,0,0,0,0,0,0,0,315,16,0,0,0,0,0,0,0,0,0,100
f7ce4ab5922dfe16c2b35bd21815c3180d7643ca,2,14,8,6,0,0,0,1,2,6,1,1,1,221,316,16,21,19,2,1966,1936,30,15,13,2,100
882b0b32e1b0e01aee5d5ed6aeff8207f43919ed,0,0,0,0,0,0,0,0,0,0,0,0,0,0,317,12,0,0,0,0,0,0,0,0,0,100
84ad7a72bbf42ae7f1e22fceddc9edf48b81655d,0,0,0,0,0,0,0,0,0,0,0,0,0,0,318,8,0,0,0,0,0,0,0,0,0,100
1788948bc9b1bbc36449e5039c8a5b8bf4626963,0,0,0,0,0,0,0,0,0,0,0,0,0,0,319,8,0,0,0,0,0,0,0,0,0,100
48c7b54ccf006935df64853f5c6443b8430b3c75,0,0,0,0,0,0,0,0,0,0,0,0,0,0,320,0,0,0,0,0,0,0,0,0,0,100
a3b38ebfdaf93eb77860fe80540bbc788e9589df,14,402,192,210,1,0,1,1,21,311,1,8,3.362319914,3239,321,1,851,607,244,25129,17124,8005,346,212,134,98.04923363
253e96e9d84da192c9095210529a84def74f6ec6,5,60,7,53,0,0,0,1,5,424,1,1,1.34285416,612,322,2,170,159,11,4694,4434,260,72,70,2,100
0820a9e0e2442730395da77ece1c6a550a86383d,2,179,15,164,0,0,0,2,4,628,1,2,0.98700443,430,0,0,83,68,15,4361,3465,896,41,33,8,100
3726dc2888b2b7d1c5e93f257563043fa9305b89,1,6,4,2,0,0,0,3,3,2334,1,1,0,114,1,1,31,29,2,1052,1010,42,7,7,0,100
1e7a16eb1d624fd10b5b7676ade9a37b77234bb5,0,0,0,0,0,0,0,0,0,0,0,0,0,0,2,2,0,0,0,0,0,0,0,0,0,100
0d22770de46e3aad404dff8901264067cdfdc714,2,13,0,13,0,0,0,2,19,498,1,2,0.89049164,1901,323,0,467,464,3,14760,14650,110,233,232,1,100
c56c4366f80f95a095090e30c511ed0ad4acf2a5,0,0,0,0,0,0,0,0,0,0,0,0,0,0,27,0,0,0,0,0,0,0,0,0,0,100
ebe57473f9a64f540cd4f0dd977313f21de42f6f,2,32,0,32,0,0,0,1,9,240,1,2,1,366,324,1,116,108,8,3740,3316,424,74,74,0,100
2985e27b367370c8c7176f52a26077044b0e77a1,9,104,106,2,0,0,0,3,5,2128,1,1,2.221007122,577,325,2,68,71,3,3823,3999,176,34,30,4,99.76076555
eb7a72136b48a827aae62296b1ba65d63ad0ead5,0,0,0,0,0,0,0,0,0,0,0,0,0,0,28,1,0,0,0,0,0,0,0,0,0,100
3eb36b556128ddcc237489366996b8c237ecdcb8,3,408,31,377,0,0,0,1,6,1570,1,2,0.55870446,1799,326,3,469,399,70,13692,11474,2218,253,199,54,100
9a501d91b962ade5554e8ddeb8bbacde544fb9b8,2,60,1,59,0,0,0,1,5,456,1,2,0.747394446,77,327,4,25,15,10,914,540,374,18,12,6,91.95979899
c880210c65d0289d96ca6472ad333fc8068f4e03,5,446,38,408,0,0,0,1,7,688,1,2,0.578869404,2208,328,5,570,487,83,17185,14334,2851,305,268,37,100
6983e7cf8fc86ae26d192cbeca779a57b3d75df5,0,0,0,0,0,0,0,0,0,0,0,0,0,0,3,3,0,0,0,0,0,0,0,0,0,100
3e35fd44125397c1a9d2313220e225c1059b04e0,4,628,0,628,2,0,2,1,8,57,1,2,1.353034008,146,329,6,82,25,57,4634,1048,3586,36,13,23,98.37362637
866a68df261cc259074d864a2e584b077fa6b2bb,6,1494,4,1490,3,0,3,1,24,269,1,3,1.001165149,2051,10,0,842,707,135,22104,15798,6306,390,271,119,99.69176574
2d90087552098f008bc8d4b6d9ae60f84b345b90,0,0,0,0,0,0,0,0,0,0,0,0,0,0,30,0,0,0,0,0,0,0,0,0,0,100
40650540dcb8ca8a6b6235de5cdd36c0f6e2eb31,15,1726,179,1547,7,0,7,2,22,247,1,5,3.338131157,2965,31,1,947,677,270,30730,22398,8332,487,327,160,93.91377853
2e102f67b8ac4a29afba03b121b4f928ee27f09b,2,10,7,3,0,0,0,1,2,4,1,1,0.322756959,109,32,2,18,17,1,707,682,25,15,15,0,100
258f800dce8433d0de3ced0916167df0446e9390,5,17,12,5,0,0,0,1,25,114,1,3,2.214152221,1648,330,1,566,565,1,13084,13073,11,173,172,1,100
52fe3505338ceb51a2299d1303d0f0c7c8afac2d,5,343,0,343,4,0,4,1,9,7,1,2,2.031136782,70,331,2,32,10,22,2289,530,1759,16,4,12,99.43181818
23201deb6d468b4cd8be4db7f812f37285358f5b,3,19,2,17,0,0,0,2,26,980,1,2,1.441166544,1094,332,3,321,319,2,9398,9265,133,107,105,2,96.10058309
82441729dd69fc5d431cabc8b1ffa25e924b8bbe,2,5,2,3,0,0,0,1,2,256,1,2,0.985228136,92,333,4,14,14,0,692,671,21,8,8,0,100
e10bd69255549a854d1ef178ab9df4dbd99dd2ac,0,0,0,0,0,0,0,0,0,0,0,0,0,0,334,5,0,0,0,0,0,0,0,0,0,100
711a4ed4230c0ba1627670e7b89db88472575e1f,7,149,10,139,1,0,1,1,21,371,1,5,2.54921066,2770,335,6,723,712,11,23386,22654,732,306,299,7,99.933687
d32617f83f4b4b78c1a852127595e02d2ffb77f2,3,3,0,3,0,0,0,4,11,498,1,1,1.584962501,121,33,1,15,15,0,929,929,0,9,9,0,100
9199bac9f99f1d5ec8d8f4c396b030c2ae08cd79,1,2,4,2,0,0,0,3,22,20,1,1,0,1158,336,6,389,390,1,8761,8771,10,169,169,0,100
16c626006f3d29f65f4fb1b648e09531106405f5,0,0,0,0,0,0,0,0,0,0,0,0,0,0,34,1,0,0,0,0,0,0,0,0,0,100
2fd8d25b142048ed159731b7e110aa9c3edba843,0,0,0,0,0,0,0,0,0,0,0,0,0,0,81,0,0,0,0,0,0,0,0,0,0,100
0b9ac6561d279342f2eaf85985e2ebf5675691c5,0,0,0,0,0,0,0,0,0,0,0,0,0,0,82,1,0,0,0,0,0,0,0,0,0,100
b790897340eefc626c107c1578f26ee49a3de412,0,0,0,0,0,0,0,0,0,0,0,0,0,0,89,0,0,0,0,0,0,0,0,0,0,100
923b619a011733c9f0669556ab96322335568951,0,0,0,0,0,0,0,0,0,0,0,0,0,0,90,1,0,0,0,0,0,0,0,0,0,100
710684f733c19928f4e5132b25f0c858ea9dfa3f,0,0,0,0,0,0,0,0,0,0,0,0,0,0,91,2,0,0,0,0,0,0,0,0,0,100
d2a8de16fcafeb94b381c38dbe4110b83a16872f,0,0,0,0,0,0,0,0,0,0,0,0,0,0,92,3,0,0,0,0,0,0,0,0,0,100
a1796711e1470ba794f37ae74eb9a34101ff7daa,0,0,0,0,0,0,0,0,0,0,0,0,0,0,337,0,0,0,0,0,0,0,0,0,0,100
1074bbd253c7275648ff8845c54e8f15e70e5428,0,0,0,0,0,0,0,0,0,0,0,0,0,0,338,1,0,0,0,0,0,0,0,0,0,100
ecee999e3be6ea7ffec8f3c7bce267efe9395d4d,1,7,1,6,0,0,0,4,12,875,1,1,0,360,339,2,61,60,1,2299,2278,21,29,29,0,100
c979ba8577fa3d29bd7ebbcf5d8f083c4033f4e2,1,73,10,63,0,0,0,4,13,0,1,1,0,365,340,3,71,61,10,2570,2299,271,32,29,3,100
ae6eede41c9fca1bc235f65fece131816bda3d9d,7,159,18,141,0,0,0,1,27,538,1,7,2.096629821,2460,341,4,736,720,16,20935,20150,785,230,214,16,100
9d9ab81eead6ad75ef182de58f0c0c421fc52237,0,0,0,0,0,0,0,0,0,0,0,0,0,0,342,5,0,0,0,0,0,0,0,0,0,100
b6c2905a5e28233f824147242e40a3c7df52f7da,0,0,0,0,0,0,0,0,0,0,0,0,0,0,343,6,0,0,0,0,0,0,0,0,0,100
6e79ea1e08f7ba0414934c7c65a3dad381a20562,2,6,2,4,0,0,0,1,10,236,1,2,1,398,344,7,116,116,0,3740,3740,0,74,74,0,100
1579ab1ac95731630af58fc303a07c9bf28541d6,1,16,1,15,0,0,0,4,14,36,1,1,0,408,6,0,72,71,1,2586,2570,16,33,32,1,100
4cd58297e1c30930d4cca53c10ff3cd99a33269c,0,0,0,0,0,0,0,0,0,0,0,0,0,0,83,0,0,0,0,0,0,0,0,0,0,100
9b0a633bca2f657e250ddd602468d1fccdc5c027,0,0,0,0,0,0,0,0,0,0,0,0,0,0,84,1,0,0,0,0,0,0,0,0,0,100
05e9ff1711b968388c7cb54e5488e91c8be630af,0,0,0,0,0,0,0,0,0,0,0,0,0,0,85,2,0,0,0,0,0,0,0,0,0,100
e6549b48822e7491406344397c5fce8b1e1f091e,4,3011,1139,1872,0,0,0,2,4,594,1,3,0.775191447,959,35,0,356,154,202,17060,7315,9745,322,128,194,99.90056347
b7897db6425377d3f0a6e6a9df169f65737b580b,1,1,1,0,0,0,0,1,2,2874,1,1,0,30,36,1,6,6,0,225,225,0,6,6,0,100
00f36ae402b34d5b47ca5a6349ad5488e2ec5bcd,3,132,0,132,2,0,2,1,10,89,1,2,0.954042522,72,345,0,24,10,14,1094,540,554,11,4,7,99.83449189
fe114b90dff01f10d91055577e58c4325dd45a6e,3,35,3,32,0,0,0,2,6,1017,1,3,1.08622182,360,346,1,64,58,6,2618,2433,185,44,44,0,100
d6b1d2cd0d1bb625f5fb73ef3931a63bbb622953,0,0,0,0,0,0,0,0,0,0,0,0,0,0,347,2,0,0,0,0,0,0,0,0,0,100
8af840b2cd1ad273e6417f58d359e9b113a1c927,17,653,27,626,7,0,7,3,24,307,1,4,3.562157613,3252,348,3,964,906,58,28140,25490,2650,439,409,30,93.25337331
854daafa0d91b3e0da986841ba6ad023eddddeca,23,351,80,271,0,0,0,1,28,1011,1,8,3.998639397,2888,349,4,775,743,32,25325,23846,1479,295,274,21,93.15181518
74811387064c8668aaf6c538a54284d394bb1d09,0,0,0,0,0,0,0,0,0,0,0,0,0,0,350,5,0,0,0,0,0,0,0,0,0,100
7523d4c863886a1c60bfc89950836fe4c1f69ebf,0,0,0,0,0,0,0,0,0,0,0,0,0,0,351,6,0,0,0,0,0,0,0,0,0,100
d1a22055fa9bc51d44816b342a1035a6d91191d3,0,0,0,0,0,0,0,0,0,0,0,0,0,0,352,7,0,0,0,0,0,0,0,0,0,100
79d6b2b0ff5777faef685639ef2ef9f1fc83f532,2,27,1,26,0,0,0,2,24,53,1,2,0.811278124,1188,353,8,396,393,3,9249,9032,217,173,172,1,100
2b6eafc504cfb04732ba9b4523778fbd2a6f6908,0,0,0,0,0,0,0,0,0,0,0,0,0,0,354,3,0,0,0,0,0,0,0,0,0,100
50baf4cfb47fbdd29c311de756bbc503f0508dd5,2,29,2,27,0,0,0,1,6,442,1,2,0.938315352,130,355,1,29,25,4,1058,885,173,21,19,2,100
4128159f67cdfe1e28fa375f36e120243aeb3919,1,1,1,0,0,0,0,3,6,2066,1,1,0,117,356,1,16,16,0,941,937,4,3,3,0,100
2c336d872d9fa863840ea753cfb92a978d6339e2,0,0,0,0,0,0,0,0,0,0,0,0,0,0,357,2,0,0,0,0,0,0,0,0,0,100
9e3de75e27aef8feab9abcda090f27a36e2add55,2,22,2,20,0,0,0,2,25,301,1,2,0.41381685,1930,358,0,473,472,1,15082,14884,198,238,236,2,100
a56e7f13c4fa976b7926649b058665f42850a349,0,0,0,0,0,0,0,0,0,0,0,0,0,0,359,1,0,0,0,0,0,0,0,0,0,100
35750393891c40f0ceb925a852162ec764bcae6c,3,100,5,95,0,0,0,3,9,1356,1,2,1.447593904,790,360,0,162,152,10,5774,5497,277,86,80,6,100
0520c1cec0fcaf23104eaf40724485da1c67088e,3,20,10,10,0,0,0,1,10,866,1,2,0.985171747,183,361,1,34,34,0,1391,1391,0,8,8,0,100
15d5cdc81c23c4d47099b510e4efa50fd18ac9bf,2,59,1,58,0,0,0,2,7,1884,1,2,0.286396957,438,362,2,118,114,4,3440,2972,468,17,14,3,99.60861057
62557712722e94614140ed945a2e1c276f604ba8,4,204,4,200,2,0,2,3,10,18,1,2,1.747395571,572,363,3,111,98,13,4462,4017,445,61,52,9,99.80597594
217a633a4ddcceb6b3e30a4f2ee1fd98130d96ac,0,0,0,0,0,0,0,0,0,0,0,0,0,0,364,3,0,0,0,0,0,0,0,0,0,100
2e8db1e2c3e914d1938096f98c1d0f71e6af0a99,13,227,61,166,1,0,1,3,11,1051,1,6,2.834062757,1170,365,4,182,162,20,9679,8712,967,79,63,16,99.49884348
7d8746bdfdf86f2816d8b37a2192f06931d3c377,1,1,0,1,0,0,0,2,8,317,1,1,0,111,366,2,8,8,0,912,899,13,8,8,0,100
335fb784a38d69700fbe4beeca4b2a08121e61db,4,56,3,53,1,0,1,3,26,244,1,3,1.623708518,2537,367,0,693,690,3,20515,20373,142,295,294,1,99.92331288
3289a4dec81912dada7bf38275ea47f4ae9b437f,1,1,1,0,0,0,0,2,6,95,1,1,0,18,368,1,1,1,0,142,142,0,1,1,0,100
fe0c6c82566cdade205b62b0c223886bf799f716,4,140,17,123,1,0,1,1,2,2359,1,3,1.73119348,90,369,2,18,12,6,1343,792,551,9,6,3,97.47383616
deb4354cc35e824951f7f5e2084693b59f67c9a1,3,51,22,29,0,0,0,2,6,1564,1,2,1.500016806,135,370,3,17,10,7,1126,981,145,12,8,4,99.96589359
692f2b7c529d6203916e17e45f5491062fad48b3,6,87,20,67,0,0,0,2,9,283,1,2,2.29978228,305,371,4,35,32,3,2819,2553,266,25,22,3,100
ffaf716f2d4c65d90c5a6e7def47751a263b28d9,0,0,0,0,0,0,0,0,0,0,0,0,0,0,93,0,0,0,0,0,0,0,0,0,0,100
08c097bec5a8e078afa47810edbe0dccd9de8479,0,0,0,0,0,0,0,0,0,0,0,0,0,0,11,0,0,0,0,0,0,0,0,0,0,100
be7fc3504828c42d534c1522d3f050fd52d66b2d,0,0,0,0,0,0,0,0,0,0,0,0,0,0,12,1,0,0,0,0,0,0,0,0,0,100
e2905e6225ef6b5ad1b177264d3d25bbebb50736,7,201,43,158,0,0,0,2,7,741,1,3,2.587207032,697,372,5,125,112,13,5678,4783,895,77,69,8,99.79529171
b69af81348c6ff15e5be9f1ac8f884b3680bdb74,2,1135,0,1135,2,0,2,1,1,0,1,2,0.996139027,0,373,6,114,0,114,5183,0,5183,41,0,41,99.82964225
aab73f1762db333005ce15fc3f76a21fc754625a,0,0,0,0,0,0,0,0,0,0,0,0,0,0,86,0,0,0,0,0,0,0,0,0,0,100
b0e6e0593931035b86e07bb4d88ce967cd18937e,0,0,0,0,0,0,0,0,0,0,0,0,0,0,87,1,0,0,0,0,0,0,0,0,0,100
4498b9928857ac010b77274da8d060b54f95d912,0,0,0,0,0,0,0,0,0,0,0,0,0,0,88,2,0,0,0,0,0,0,0,0,0,100
f91e32bb70d22f1a344b769403e5148d795d0205,0,0,0,0,0,0,0,0,0,0,0,0,0,0,89,3,0,0,0,0,0,0,0,0,0,100
f36368729fa537559ef13060c304d14aa87f7671,0,0,0,0,0,0,0,0,0,0,0,0,0,0,374,7,0,0,0,0,0,0,0,0,0,100
f5ebcf11bd09946ea0f717d0f236f19a0f9ab8e8,0,0,0,0,0,0,0,0,0,0,0,0,0,0,375,8,0,0,0,0,0,0,0,0,0,100
7699e3d28d1596f29bb00483451cab3e392e992b,1,35,2,33,0,0,0,2,7,1199,1,1,0,88,376,9,31,27,4,865,671,194,20,18,2,100
a2fe7c3ff68f4cec606c644555172a40ba1e9cda,2,112,5,107,1,0,1,1,1,0,1,1,0.421166015,58,377,10,15,7,8,1144,479,665,8,4,4,94.1091954
f03f61883f32e110818e6592b345329fd90a9426,0,0,0,0,0,0,0,0,0,0,0,0,0,0,90,4,0,0,0,0,0,0,0,0,0,100
7c3ac7dd5688fc7d85721b8bef2f3bf84a7d0eec,0,0,0,0,0,0,0,0,0,0,0,0,0,0,378,11,0,0,0,0,0,0,0,0,0,100
1547d4980cab06feeb09bc5b81ed4da03483de02,0,0,0,0,0,0,0,0,0,0,0,0,0,0,379,12,0,0,0,0,0,0,0,0,0,100
f80baa2fe481adaee91569631e7dfb09e10e238a,0,0,0,0,0,0,0,0,0,0,0,0,0,0,380,13,0,0,0,0,0,0,0,0,0,100
6fd5335dbc3ad9cf38b3a582f204aeb495c28322,0,0,0,0,0,0,0,0,0,0,0,0,0,0,381,14,0,0,0,0,0,0,0,0,0,100
9414a3262ec98f4c8c4c8200ede87f918e785e90,0,0,0,0,0,0,0,0,0,0,0,0,0,0,382,15,0,0,0,0,0,0,0,0,0,100
020089aaa9fcc670b391074408e8d605a2b86794,0,0,0,0,0,0,0,0,0,0,0,0,0,0,383,16,0,0,0,0,0,0,0,0,0,100
da51810a0e603212742e30d7b13242a16a1b0a92,0,0,0,0,0,0,0,0,0,0,0,0,0,0,384,17,0,0,0,0,0,0,0,0,0,100
25c06cf3edb56fee923796d24c28c7af529c1b72,0,0,0,0,0,0,0,0,0,0,0,0,0,0,385,18,0,0,0,0,0,0,0,0,0,100
cca7abe6e1308fa4565a78f80f5a974564e9b5c4,0,0,0,0,0,0,0,0,0,0,0,0,0,0,386,19,0,0,0,0,0,0,0,0,0,100
30f8e22712801890af94f19adfb1dc6b1fb602d0,1,124,0,124,1,0,1,1,1,0,1,1,0,0,387,0,7,0,7,711,0,711,4,0,4,99.92401216
5b2098924b36e784bfb6a6efd798efc225030458,0,0,0,0,0,0,0,0,0,0,0,0,0,0,94,0,0,0,0,0,0,0,0,0,0,100
48dedd57aac54e35a4c54cf7a840bb55a1f53e76,0,0,0,0,0,0,0,0,0,0,0,0,0,0,388,1,0,0,0,0,0,0,0,0,0,100
d70a506f2d6432d12975979f19a9e39e2e36b348,7,635,21,614,2,0,2,1,6,288,1,2,1.766642393,515,389,2,110,75,35,8802,4191,4611,57,36,21,92.51618123
ed15da83f6981160078a5c6e30ff785cd3cc8ca0,3,103,4,99,1,0,1,3,27,54,1,2,1.54160925,1386,390,3,308,301,7,12082,11610,472,127,124,3,99.91341991
62d19fe37f1649c4fcef5d226ee11e2fdfd11f2a,0,0,0,0,0,0,0,0,0,0,0,0,0,0,391,4,0,0,0,0,0,0,0,0,0,100
e4124c17adeb58f84b35d09cf3c865262006a629,0,0,0,0,0,0,0,0,0,0,0,0,0,0,392,5,0,0,0,0,0,0,0,0,0,100
05354bf64a32425533b73bf5310a12586f284e9b,8,123,7,116,1,0,1,1,28,690,1,5,1.091473168,1525,393,6,476,460,16,12903,12512,391,137,132,5,99.82721382
0855eb7eb478632ad8f1192f64e81ded7694a343,3,51,47,4,0,0,0,3,5,2642,1,1,0.932623662,1083,394,7,156,161,5,6243,6198,45,37,38,1,100
4c51fe33c252ff7a5ab726539bddd3b2d313bee3,22,43,49,6,0,0,0,1,29,835,1,15,3.381990874,5653,395,8,1585,1585,0,43199,43216,17,845,845,0,100
07b6a7cd3b6bef66d4fdff2b0199b823324db59a,2,20,0,20,0,0,0,2,15,734,1,2,0.721928095,1149,396,9,206,203,3,10518,10354,164,73,72,1,100
0a576b82eb1fb2649e3c57e461a052131ad57d97,0,0,0,0,0,0,0,0,0,0,0,0,0,0,95,1,0,0,0,0,0,0,0,0,0,100
6bb32463a05dac03e3bb4d15018e6bd55554edc5,0,0,0,0,0,0,0,0,0,0,0,0,0,0,397,10,0,0,0,0,0,0,0,0,0,100
ffe0bd8a8e6683e9129f7b9e1707bf0a3b869888,0,0,0,0,0,0,0,0,0,0,0,0,0,0,398,11,0,0,0,0,0,0,0,0,0,100
e4b9acafd627dc6771e4a49b028cef68b6ff2ab1,0,0,0,0,0,0,0,0,0,0,0,0,0,0,399,12,0,0,0,0,0,0,0,0,0,100
2bd29335725d96280b5269064af6cbcc3586d2b1,0,0,0,0,0,0,0,0,0,0,0,0,0,0,400,13,0,0,0,0,0,0,0,0,0,100
c069e284fa1afb7620b8a4b0d35503624c659432,0,0,0,0,0,0,0,0,0,0,0,0,0,0,401,14,0,0,0,0,0,0,0,0,0,100
bd263c4141780f56d0494fd58071a9c64d85a0a1,0,0,0,0,0,0,0,0,0,0,0,0,0,0,402,15,0,0,0,0,0,0,0,0,0,100
ac7c3a784d7344eb9fd59488da94259ab5507bd6,0,0,0,0,0,0,0,0,0,0,0,0,0,0,403,16,0,0,0,0,0,0,0,0,0,100
9ef7389146407441220a6d79af05ee754fcf73df,0,0,0,0,0,0,0,0,0,0,0,0,0,0,404,7,0,0,0,0,0,0,0,0,0,100
b19df789480e063ee36eb5f2b1fef47f9c2e90c4,0,0,0,0,0,0,0,0,0,0,0,0,0,0,405,1,0,0,0,0,0,0,0,0,0,100
86a642787c9bac4d608d053b9c7b3be1128368d9,0,0,0,0,0,0,0,0,0,0,0,0,0,0,406,2,0,0,0,0,0,0,0,0,0,100
9bae616d4f9948c6bb2c8d7b75a2c53d456a1646,2,22,16,6,0,0,0,1,10,445,1,2,0.74248757,2459,407,3,552,551,1,16034,16001,33,289,289,0,100
1c43a60e65da433cf1d0f2e5088ed30f9f8d8bca,0,0,0,0,0,0,0,0,0,0,0,0,0,0,408,4,0,0,0,0,0,0,0,0,0,100
7be037b56f722005ea568b5b19766538434bc1c0,0,0,0,0,0,0,0,0,0,0,0,0,0,0,409,5,0,0,0,0,0,0,0,0,0,100
06711d38a9a5913a3816c6eb8a5dc47b4b612e24,0,0,0,0,0,0,0,0,0,0,0,0,0,0,410,6,0,0,0,0,0,0,0,0,0,100
a0f75f971f81c1b01efd083888e65e968c057846,1,1,1,0,0,0,0,2,3,235,1,1,0,152,411,7,17,17,0,1229,1229,0,4,4,0,100
49593cc38c388b89b85433b4533501a2d11e722f,7,928,26,902,6,0,6,1,4,213,1,2,2.483065282,56,412,8,80,7,73,4392,470,3922,54,5,49,98.53889128
5e2e176168f7d8f528704a05608ee0ab68e32b63,0,0,0,0,0,0,0,0,0,0,0,0,0,0,413,9,0,0,0,0,0,0,0,0,0,100
364444783b65832b07a1436ee3a93faece63d484,2,102,3,99,0,0,0,2,28,234,1,2,0.721928095,1948,414,10,508,473,35,15630,15083,547,244,238,6,100
41b8efb05a6de0a1112c0ea08dfb0c63a86b3614,1,1,1,0,0,0,0,1,2,2,1,1,0,84,415,11,14,14,0,652,648,4,6,6,0,100
706131388a81646d12a53ce31cf4c4557f93c017,2,20,2,18,0,0,0,3,8,382,1,2,0.439496987,1097,13,0,198,194,4,8599,8449,150,142,141,1,100
e0966a1ec55a6ca45baf5d3f53ad6b0e7a049452,2,12,6,6,0,0,0,2,30,1389,1,2,0.99107606,875,14,1,303,298,5,7227,7173,54,90,90,0,100
8dd83708d454f9dc7caebf2769b3f5c513ba242c,3,19,1,18,0,0,0,1,31,1339,1,3,1.44064545,1190,416,0,346,339,7,10177,9967,210,120,119,1,91.22725152
63b868907ada80f8621610ceefc47a0ec4fd26f4,0,0,0,0,0,0,0,0,0,0,0,0,0,0,417,1,0,0,0,0,0,0,0,0,0,100
6e1e0bcf4fb4a0466e0cedb4ac00a0d4bbfed8e1,2,62,11,51,0,0,0,2,29,110,1,2,0.30642473,2039,418,2,514,508,6,16076,15630,446,249,244,5,100
4405ed978425b779a2e2fdd238af2e1a95bfd8b8,1,3,1,2,0,0,0,4,32,30,1,1,0,814,419,3,298,298,0,6475,6460,15,89,89,0,100
c81303a746f4706b3c039635af37a81d6cfcc962,0,0,0,0,0,0,0,0,0,0,0,0,0,0,420,4,0,0,0,0,0,0,0,0,0,100
14cae5dd0114a28f9a750c718291abba2763fcbd,3,47,1,46,0,0,0,4,16,834,1,3,1.109534908,750,421,5,197,193,4,5773,5444,329,64,62,2,100
f88cabc1e1271c8d4d2135807fc861664062c276,0,0,0,0,0,0,0,0,0,0,0,0,0,0,422,6,0,0,0,0,0,0,0,0,0,100
4fec1d9c1fde62c384d59ed520dfc80b4a4205a5,6,216,4,212,2,0,2,3,33,231,1,2,2.15259304,2150,15,0,555,535,20,18036,17113,923,240,227,13,86.97674419
7122ddad939d59f03da8c60bd41eb9247352c449,6,4,216,212,0,0,0,3,34,18,1,2,2.15259304,2274,16,1,535,555,20,17113,18036,923,227,240,13,86.97674419
c754127aae3f252e59d4533f93c8cfaec5608529,0,0,0,0,0,0,0,0,0,0,0,0,0,0,0,0,0,0,0,0,0,0,0,0,0,100
c533aeff68af47a99f3f61d091451a4cff700e19,3,15,9,6,0,0,0,2,7,1489,1,2,1.040852083,440,423,0,61,61,0,3295,3242,53,38,38,0,100
4deed74fe934dbc1edf207cefde92aed587c96a2,1,1,1,0,0,0,0,3,30,228,1,1,0,1244,424,1,426,426,0,9298,9299,1,176,176,0,100
c3a67e5ad90ff19d7557eb627678a3d0a09446e5,4,402,3,399,1,0,1,1,8,1518,1,3,0.880642852,1541,425,2,525,439,86,13713,11369,2344,159,122,37,99.89754098
71c2fc608a443404d0872b12ea08269a84f02d41,2,35,0,35,1,0,1,1,8,304,1,2,0.187176257,370,426,3,113,111,2,2682,2555,127,12,11,1,99.79560552
30e914cf37160bfd0aa4daf97feadd8e57435a33,2,103,0,103,0,0,0,1,5,994,1,2,0.748293286,480,427,4,62,54,8,4514,3849,665,46,40,6,89.06037222
5c5e2ea98e792d8a09e5ba173818e02ba570aabc,3,98,4,94,0,0,0,1,9,24,1,3,0.508729019,1624,428,5,494,467,27,12542,11961,581,133,127,6,100
98ec5f2a172391cb5dfa7b4d85f39065bae22754,11,637,0,637,10,0,10,1,6,41,1,3,3.272866961,392,17,0,124,74,50,4562,2587,1975,89,59,30,99.11147011
3e9479b3c8ec6c18f4f7dbe5b1a5a68671296206,0,0,0,0,0,0,0,0,0,0,0,0,0,0,429,4,0,0,0,0,0,0,0,0,0,100
a076f6f6f9848090776080b876fa0c1f2ca660a5,0,0,0,0,0,0,0,0,0,0,0,0,0,0,430,4,0,0,0,0,0,0,0,0,0,100
070c430b72098481e544052d1dc116a624dbcce8,0,0,0,0,0,0,0,0,0,0,0,0,0,0,431,4,0,0,0,0,0,0,0,0,0,100
cc7ec43e22f65fdea2bec9be04832f194c9bc6b8,2,17,0,17,0,0,0,3,29,385,1,2,0.322756959,1445,18,1,315,312,3,12276,12148,128,130,128,2,100
b723741bfd071077c50d998131af1417c4371c26,0,0,0,0,0,0,0,0,0,0,0,0,0,0,96,0,0,0,0,0,0,0,0,0,0,100
010091fc66a92292525c18713117a673bee14831,0,0,0,0,0,0,0,0,0,0,0,0,0,0,97,1,0,0,0,0,0,0,0,0,0,100
289ea57aa60c151f4fd2eb59c73b8d81c141d2b8,2,15,4,11,0,0,0,3,31,173,1,2,0.981940787,2083,432,0,515,514,1,16129,16075,54,250,249,1,100
ce9888491b24b295865940ec68a21a43b0bca467,0,0,0,0,0,0,0,0,0,0,0,0,0,0,433,1,0,0,0,0,0,0,0,0,0,100
11a18d9b686d98f7731904584ed8a809cd86dea8,3,91,4,87,0,0,0,2,9,1427,1,3,1.181532551,684,434,2,177,161,16,5182,4706,476,36,31,5,100
b67cea15443e22db2e57c30dfdc5da2697e5ecb5,0,0,0,0,0,0,0,0,0,0,0,0,0,0,4,0,0,0,0,0,0,0,0,0,0,100
3e997c3b63fd10ec27b1bc0061e14881da5e4dab,0,0,0,0,0,0,0,0,0,0,0,0,0,0,5,1,0,0,0,0,0,0,0,0,0,100
175a67d10cabb1672d4c966182432dec62e8d288,4,74,6,68,0,0,0,3,30,599,1,2,1.385907251,1588,435,3,348,336,12,13387,13049,338,152,148,4,99.40452561
f406cb4693a95842ae99bea8d9971513ea975b27,1,18,0,18,0,0,0,2,2,73,1,1,0,5,436,4,0,0,0,24,24,0,0,0,0,100
f3e482fd2339cd697d3eb2136f0d76b7b602525a,0,0,0,0,0,0,0,0,0,0,0,0,0,0,437,5,0,0,0,0,0,0,0,0,0,100
d5f32e1624696c6a67923595da82d53c1103e6c8,0,0,0,0,0,0,0,0,0,0,0,0,0,0,438,6,0,0,0,0,0,0,0,0,0,100
082fb97eb5d1c29b12e41115e45be357553afc8e,0,0,0,0,0,0,0,0,0,0,0,0,0,0,0,0,0,0,0,0,0,0,0,0,0,100
0478e9cea93142e1ec0eefb9e0d7d19962a8bf0f,0,0,0,0,0,0,0,0,0,0,0,0,0,0,98,0,0,0,0,0,0,0,0,0,0,100
1de668f8390edef0ee135b1c02c490a40e1a165e,0,0,0,0,0,0,0,0,0,0,0,0,0,0,439,4,0,0,0,0,0,0,0,0,0,100
2cf39f749f0e58e0a48754d71bdb106540b4ca86,0,0,0,0,0,0,0,0,0,0,0,0,0,0,440,1,0,0,0,0,0,0,0,0,0,100
06d463b1a119c5d8bc4347fa9e280f4096551080,2,5,3,2,0,0,0,2,35,354,1,2,0.954434003,1142,441,2,333,333,0,9683,9663,20,113,112,1,100
d9f748e1469e5a37f1369270722f8b0d12376264,0,0,0,0,0,0,0,0,0,0,0,0,0,0,442,3,0,0,0,0,0,0,0,0,0,100
0d577247ca54ca9f180d2902c5ce6cf182b67904,2,67,4,63,0,0,0,2,4,1699,1,2,0.417864262,360,19,0,56,55,1,3202,2704,498,37,36,1,100
b8dec14716b112a07ffba2df39cee9da1ee08725,2,37,0,37,0,0,0,2,36,50,1,2,0.179256067,1143,443,1,335,333,2,10025,9683,342,114,113,1,100
0781e9f27d2f92af283e2033e4284ea18b3794a2,0,0,0,0,0,0,0,0,0,0,0,0,0,0,444,2,0,0,0,0,0,0,0,0,0,100
2a618069759cb7c68e3204edf3de28821721ffee,0,0,0,0,0,0,0,0,0,0,0,0,0,0,445,3,0,0,0,0,0,0,0,0,0,100
919ace25804400a6b14d42dc60f5685578b5fcb9,0,0,0,0,0,0,0,0,0,0,0,0,0,0,446,4,0,0,0,0,0,0,0,0,0,100
d3e984ec25fb0c0a99cd080fa4320cbe3432ee6c,0,0,0,0,0,0,0,0,0,0,0,0,0,0,447,0,0,0,0,0,0,0,0,0,0,100
aad41f750d1332d6a90ad52a70ba2791bd74969a,2,32,15,17,0,0,0,2,6,800,1,2,0.983939395,253,448,1,30,27,3,1918,1807,111,22,19,3,100
7aa6d34cf9f0bee928a2fcb69003fb579de67b25,0,0,0,0,0,0,0,0,0,0,0,0,0,0,20,0,0,0,0,0,0,0,0,0,0,100
884c3fcbc57cc5d8afff87dccd4caf87ce478aed,22,2851,1080,1771,0,0,0,1,11,1718,1,6,2.039779618,6871,449,1,1700,1533,167,54888,47823,7065,791,713,78,100
7c0f04e97f6b324ce2447afc4f05665bf83762a8,2,104,0,104,1,0,1,1,31,121,1,2,0.278171008,616,450,2,186,181,5,5869,5287,582,46,42,4,99.92119779
fdb45a7968cc0ba7f57bc5fa97777995dc946820,4,28,12,16,0,0,0,1,12,1199,1,4,1.712887622,606,451,3,147,144,3,5219,5124,95,88,88,0,100
fb28910e926f1c442b90e650c3bd9e6ecfb80a79,3,198,6,192,0,0,0,1,10,326,1,3,1.448394189,515,452,3,147,132,15,4948,3871,1077,30,22,8,99.49592865
4eec345521b9b7ec5a27e4f495a2e9a5b7d09efc,6,81,6,75,0,0,0,2,37,1182,1,4,1.98988298,2160,453,4,457,452,5,18548,18074,474,204,200,4,100
f71e0cd28d1ebc039ec57cd303ba30e190e72dce,13,418,34,384,2,0,2,1,22,1286,1,7,2.865565594,1677,454,5,536,475,61,16144,13678,2466,256,210,46,88.9827856
f426a75e9c8dc48fdc4901224313edbb9c4739a1,2,129,26,103,1,0,1,1,6,894,1,2,0.996363935,127,455,6,42,25,17,1464,981,483,20,16,4,95.59112609
5af5e3992a6a58dcb3e52969e4e2b5d903a076c3,11,489,69,420,1,0,1,1,7,2553,1,4,2.893098107,709,456,4,147,110,37,7730,5501,2229,67,62,5,88.8580354
4a78a2da6a4d648d62249a9de048c419084320c0,0,0,0,0,0,0,0,0,0,0,0,0,0,0,457,5,0,0,0,0,0,0,0,0,0,100
2cfab13bb3cb9474745f1b34afeaed103def2999,1,5,2,3,0,0,0,2,10,428,1,1,0,210,21,0,54,54,0,1730,1712,18,19,19,0,100
c915fb13a26bd885200591148af91fe483d8723b,0,0,0,0,0,0,0,0,0,0,0,0,0,0,458,0,0,0,0,0,0,0,0,0,0,100
4f6eb207b1df2ff438d952e383041021f0275705,0,0,0,0,0,0,0,0,0,0,0,0,0,0,459,1,0,0,0,0,0,0,0,0,0,100
3b8740860e33fa1b28609901b5e1bd554b11b090,1,13,4,9,0,0,0,3,5,95,1,1,0,45,22,1,11,9,2,380,340,40,8,6,2,100
535f6efca296d80f01e1bad2050b1bdc453f4800,1,25,8,17,0,0,0,1,8,95,1,1,0,116,460,2,19,20,1,927,815,112,14,15,1,90.53414469
97165abbb62a558fe498c33999c34a73a35b6bd8,0,0,0,0,0,0,0,0,0,0,0,0,0,0,461,3,0,0,0,0,0,0,0,0,0,100
d84eef25161d31bcc69829810e7c00e730f45935,1,34,38,4,0,0,0,4,7,3073,1,1,0,137,462,4,16,20,4,1107,1158,51,5,4,1,100
4210b05960b6657b4f0ca98f97c49649e1de7139,3,26,14,12,0,0,0,2,23,105,1,3,1.493469276,974,463,5,284,282,2,7567,7485,82,84,83,1,100
77e7fa0274b85742937026b95a839590368d2879,2,35,4,31,0,0,0,1,2,2000,1,2,0.619382195,120,464,6,24,21,3,1074,888,186,12,10,2,99.09356725
5b9b847fa099d2476ba497ad971ac36495add960,23,0,4138,4138,0,0,0,2,8,3827,1,2,4.207378222,2720,465,5,0,382,382,0,20842,20842,0,168,168,95.34487653
3bb62d24aa90230d17da5ab612042799f5c2d7c9,2,98,1,97,1,0,1,1,7,581,1,2,0.14257333,270,23,1,67,64,3,2358,1757,601,36,34,2,99.94617869
5cc99503deea276eabfb9deb8c88fd1f01f5ebad,4,502,0,502,2,0,2,1,11,350,1,3,1.024934575,343,24,2,137,74,63,5355,2302,3053,63,38,25,96.49565461
f66a7875b8b904e21e0f0e40a418627ea98d9ce7,15,496,42,454,2,0,2,3,32,1348,1,11,2.812294511,4639,25,3,945,872,73,40130,37580,2550,425,402,23,99.85350132
ad27ed0d9430ea9b944ad6e70138a355aebe10e0,3,135,35,100,0,0,0,1,11,266,1,3,0.381580488,1953,466,1,578,549,29,15095,14441,654,144,139,5,100
fbaf3c399e2f34e57008d8625c76f0543a3cadf4,2,94,0,94,1,0,1,1,15,749,1,2,0.550984443,412,467,2,80,72,8,2908,2586,322,35,33,2,96.64516129
5009caa85de9f61c3d8144713c5fecd0331eee61,2,72,2,70,0,0,0,1,32,194,1,2,0.821812731,691,468,3,190,186,4,6240,5869,371,47,46,1,99.85627021
d2cd7b84dccb647c9637074986edc0baec70e50d,0,0,0,0,0,0,0,0,0,0,0,0,0,0,26,0,0,0,0,0,0,0,0,0,0,100
6501dd51fc3a910a4cdc3e5abc73f49ed47240bc,4,68,0,68,0,0,0,2,2,99,1,3,2,432,27,1,68,68,0,4103,4103,0,22,22,0,100
71c29bdef8fb3c43ecbf1c5ddae8a10f6f38d830,2,144,58,86,0,0,0,1,14,218,1,2,1,424,469,0,120,120,0,4052,4052,0,78,78,0,100
7d61edb1057f9b3361f142228ec6da2797bc2dec,0,0,0,0,0,0,0,0,0,0,0,0,0,0,470,1,0,0,0,0,0,0,0,0,0,100
34174efd237c8aabdcf8b546d9b1b2bd1e16b01e,5,292,17,275,1,0,1,1,24,48,1,5,1.392842022,1302,471,2,413,396,17,12244,10702,1542,164,154,10,99.92821249
7c0a16b8385c95c3e319de1aca9b7f20c7e61c46,0,0,0,0,0,0,0,0,0,0,0,0,0,0,472,3,0,0,0,0,0,0,0,0,0,100
510a61709411918fc7d4126b46176954189bb85f,2,29,4,25,0,0,0,2,38,224,1,2,0.884963636,1188,473,4,337,337,0,10323,10177,146,117,116,1,100
3fdea9c2021b1491825f45547c62b52d75dc505c,2,150,2,148,1,0,1,1,3,757,1,2,0.464810709,30,474,5,17,6,11,1054,225,829,16,6,10,86.85208597
3414ca077b774e98db41d32b69128cd8a7ed12b2,0,0,0,0,0,0,0,0,0,0,0,0,0,0,28,2,0,0,0,0,0,0,0,0,0,100
005c7e0fd6377162a1bd7cc425cb35a23cdf9d52,0,0,0,0,0,0,0,0,0,0,0,0,0,0,29,0,0,0,0,0,0,0,0,0,0,100
56838397367fbe3570e3f361034aec24ba9e0f64,0,0,0,0,0,0,0,0,0,0,0,0,0,0,30,1,0,0,0,0,0,0,0,0,0,100
a34ae84b27d7060fcbd41dd744d047d316ce449e,0,0,0,0,0,0,0,0,0,0,0,0,0,0,31,2,0,0,0,0,0,0,0,0,0,100
a471a726a499081c912d50fe9a6ad722e5fe3b4d,2,21,0,21,0,0,0,2,33,854,1,2,0.998363673,1304,475,0,436,433,3,9972,9829,143,185,182,3,100
6a80468a68de9bd035d5cc21d2ee664e1956c884,1,52,0,52,0,0,0,2,2,142,1,1,0,149,32,0,8,7,1,1788,1293,495,7,6,1,100
2e5acf3e5fd1e6c0f193bea0c2234c09a848f17a,5,662,7,655,1,0,1,1,39,816,1,3,1.065416408,1769,0,0,659,569,90,18291,14290,4001,215,163,52,99.03258656
42abe4f510cafa843d46805662a5b564e13f6aea,0,0,0,0,0,0,0,0,0,0,0,0,0,0,1,0,0,0,0,0,0,0,0,0,0,100
5a52b4b8c9201102183ea643307ceae932e5b8f5,0,0,0,0,0,0,0,0,0,0,0,0,0,0,2,1,0,0,0,0,0,0,0,0,0,100
630562a0b16ae73c8cb8d85da723bca6b28de6db,1,2,4,2,0,0,0,4,34,228,1,1,0,1268,3,2,432,432,0,9465,9478,13,182,182,0,100
60d9ef0ad24d91735210830b2481e884ec45c9e7,2,45,2,43,0,0,0,3,35,164,1,2,0.997059057,1318,4,0,442,436,6,10241,9959,282,190,185,5,100
eb31746cd5efd5e2c9c57780a651afaccd5cfe06,13,2180,22,2158,7,0,7,1,40,206,1,6,2.992199706,3520,5,0,1425,1144,281,40725,27497,13228,545,407,138,89.13443831
ab938b84b2cd305eef3fbd238edf78945bd043e9,2,108,5,103,1,0,1,1,11,892,1,2,0.711180663,288,33,0,68,59,9,2565,1951,614,43,37,6,99.91582492
83cb47e04c057627ac839a16e03972ed7481ca02,0,0,0,0,0,0,0,0,0,0,0,0,0,0,34,1,0,0,0,0,0,0,0,0,0,100
1e1b379463d0dbe1d2e0d162586dcebceb6af1e6,0,0,0,0,0,0,0,0,0,0,0,0,0,0,6,0,0,0,0,0,0,0,0,0,0,100
b81761e72307bfc62843c0b207a4712aa2d9c9c0,4,96,22,74,0,0,0,2,16,1266,1,4,1.344852003,1408,35,2,271,270,1,13551,13522,29,155,155,0,100
4f7013b1465959d6c17e21c969dcb90b5a0d6a25,1,6,6,0,0,0,0,2,4,693,1,1,0,452,36,3,23,23,0,3407,3407,0,20,20,0,100
f2d7c194ddd2734e567e77b9810ffb44ed65d6bd,0,0,0,0,0,0,0,0,0,0,0,0,0,0,37,4,0,0,0,0,0,0,0,0,0,100
c5fe80507610fcf24e53516365cd7c2efb2291dd,0,0,0,0,0,0,0,0,0,0,0,0,0,0,38,5,0,0,0,0,0,0,0,0,0,100
ba10e8bf61efbceaad0a8f95ba73c659f678bc1e,0,0,0,0,0,0,0,0,0,0,0,0,0,0,39,6,0,0,0,0,0,0,0,0,0,100
9e9f0e86e00ba71f501ac2c8b09f98f8e3f9365e,0,0,0,0,0,0,0,0,0,0,0,0,0,0,40,7,0,0,0,0,0,0,0,0,0,100
d3f854449e540cd2f34a0a96df15d379d8c1d525,0,0,0,0,0,0,0,0,0,0,0,0,0,0,41,8,0,0,0,0,0,0,0,0,0,100
a6743849b29b67f5013bf9b917daf70b19810929,0,0,0,0,0,0,0,0,0,0,0,0,0,0,42,9,0,0,0,0,0,0,0,0,0,100
dfdbb60a8d9f97b43db981b6ee08f434a288111a,3,493,5,488,2,0,2,1,2,43,1,3,1.5302269,167,7,1,100,44,56,3835,1045,2790,62,18,44,99.79018044
c4c3739dedd51a6fe02731adc617b30d3f4bbd80,0,0,0,0,0,0,0,0,0,0,0,0,0,0,43,7,0,0,0,0,0,0,0,0,0,100
74b444929bfdbdd0bcdf45a80dec7b507f805428,0,0,0,0,0,0,0,0,0,0,0,0,0,0,44,8,0,0,0,0,0,0,0,0,0,100
e12bdb0bee1e298c5a2ab352e1b2ac3dac6448fa,5,447,29,418,1,0,1,1,41,116,1,3,0.826249921,2083,45,9,702,660,42,19083,16804,2279,222,190,32,99.79079498
96c95a93cc5cc4c4fc19ea16edb926ffb4625156,0,0,0,0,0,0,0,0,0,0,0,0,0,0,46,10,0,0,0,0,0,0,0,0,0,100
7fcfcf12648d322728da549a56994607baf989ae,0,0,0,0,0,0,0,0,0,0,0,0,0,0,47,11,0,0,0,0,0,0,0,0,0,100
fe306bf207ab4fd290893651a9c92caae611aff3,0,0,0,0,0,0,0,0,0,0,0,0,0,0,48,12,0,0,0,0,0,0,0,0,0,100
4de802425783c8abbb97a0574741670cab776dff,0,0,0,0,0,0,0,0,0,0,0,0,0,0,49,13,0,0,0,0,0,0,0,0,0,100
90d02b4bfa2154ba71a8a05b6c2661cf792d062d,0,0,0,0,0,0,0,0,0,0,0,0,0,0,50,14,0,0,0,0,0,0,0,0,0,100
65841fc8967c4599e29b99dafe8c8f7272b7a4c2,0,0,0,0,0,0,0,0,0,0,0,0,0,0,51,15,0,0,0,0,0,0,0,0,0,100
2c76eb516ccff61f29ea4efd15cff44c7832fd33,10,180,0,180,0,0,0,2,3,87,1,6,3.321928095,2169,52,16,299,299,0,16134,16134,0,201,201,0,100
946e96680764095588e5a3e40e97a821b5fb9038,0,0,0,0,0,0,0,0,0,0,0,0,0,0,53,17,0,0,0,0,0,0,0,0,0,100
bc657e4d93166b6d5c2cdc587aaeca17760099a6,0,0,0,0,0,0,0,0,0,0,0,0,0,0,54,18,0,0,0,0,0,0,0,0,0,100
8570a93e1f6ebc14bc3c78692256122b9ba2c1ea,0,0,0,0,0,0,0,0,0,0,0,0,0,0,55,19,0,0,0,0,0,0,0,0,0,100
82ee5b448983f5074e513c053258c6ed23c8701b,0,0,0,0,0,0,0,0,0,0,0,0,0,0,8,0,0,0,0,0,0,0,0,0,0,100
e90092bce9d3e9436475dc61521e0cd019831a67,0,0,0,0,0,0,0,0,0,0,0,0,0,0,56,0,0,0,0,0,0,0,0,0,0,100
72846f1daeadda01b3af29f922dc6f840b224b0e,0,0,0,0,0,0,0,0,0,0,0,0,0,0,57,1,0,0,0,0,0,0,0,0,0,100
248c4bfefdc5fcc6966910ff2bf0b91d9c4da4ac,0,0,0,0,0,0,0,0,0,0,0,0,0,0,58,2,0,0,0,0,0,0,0,0,0,100
710a001a1b41d465db7a300bfcc03040fcef03b3,2,13,2,11,0,0,0,3,42,498,1,2,0.721928095,985,59,0,321,320,1,8090,7937,153,104,103,1,100
069f00e0e849775a93c08a74e48fc10b34566d02,0,0,0,0,0,0,0,0,0,0,0,0,0,0,9,0,0,0,0,0,0,0,0,0,0,100
4fdc75209ba54f60b2c5798cff731a11053fbcfd,0,0,0,0,0,0,0,0,0,0,0,0,0,0,10,1,0,0,0,0,0,0,0,0,0,100
4686716c4ef7bb139a371d1de881ad1aaf93a144,0,0,0,0,0,0,0,0,0,0,0,0,0,0,0,0,0,0,0,0,0,0,0,0,0,100
e0096f2f9d0036e02f16eb0b111fd68470758351,0,0,0,0,0,0,0,0,0,0,0,0,0,0,1,1,0,0,0,0,0,0,0,0,0,100
0f5758b2d0f75c8234443e72c43d2fd38fe1894d,0,0,0,0,0,0,0,0,0,0,0,0,0,0,11,0,0,0,0,0,0,0,0,0,0,100
4707d9abe1202c7266aa8d58711fd22907863cbd,6,24,6,18,0,0,0,4,37,1169,1,2,2.031729149,1734,12,1,500,499,1,12895,12877,18,215,214,1,100
bc19e3a12e033e60c4f5c6c1d7a20fc9f8182da6,0,0,0,0,0,0,0,0,0,0,0,0,0,0,13,2,0,0,0,0,0,0,0,0,0,100
5cb83db6a66a6d60aa01b41160a9c90ad4987736,0,0,0,0,0,0,0,0,0,0,0,0,0,0,14,3,0,0,0,0,0,0,0,0,0,100
3585c45902b99ae5cf5e3086d1dfc61389017d7f,0,0,0,0,0,0,0,0,0,0,0,0,0,0,15,4,0,0,0,0,0,0,0,0,0,100
1c5205ef3f1516fa5f3a323057139bffd5758182,9,393,68,325,2,0,2,3,36,650,1,5,1.849447591,2169,0,0,650,588,62,17955,15652,2303,285,276,9,94.83585393
bdc98484730275bebcc4f22d6e3ffd9f97616920,9,68,393,325,0,0,0,4,37,829,1,5,1.849447591,2459,60,0,588,650,62,15652,17955,2303,276,285,9,94.83585393
5662cbbffa89fb8d363ccbee03fe85980e17ba15,0,0,0,0,0,0,0,0,0,0,0,0,0,0,99,0,0,0,0,0,0,0,0,0,0,100
df5c513f1e7a606b7333975b6d28784702f77077,0,0,0,0,0,0,0,0,0,0,0,0,0,0,16,0,0,0,0,0,0,0,0,0,0,100
96d2d35fa20a7ec14f699e0c899cc7e21ae3393b,0,0,0,0,0,0,0,0,0,0,0,0,0,0,17,1,0,0,0,0,0,0,0,0,0,100
ada69ac5e0be21c96cdc683ae5152b0a8216e14f,0,0,0,0,0,0,0,0,0,0,0,0,0,0,18,2,0,0,0,0,0,0,0,0,0,100
e11c588ebe034d5f2a043598e600791e38e124bb,0,0,0,0,0,0,0,0,0,0,0,0,0,0,19,3,0,0,0,0,0,0,0,0,0,100
2c6c570d3b66975cfac367334d8a6971801397e5,0,0,0,0,0,0,0,0,0,0,0,0,0,0,20,4,0,0,0,0,0,0,0,0,0,100
f49b2d31fd9a0249a64c049da800db6648792ee0,10,156,5,151,0,0,0,2,17,2213,2,6,3.310856643,930,21,5,210,210,0,8814,8814,0,137,137,0,100
bf751dfaada53680f66bc200f3acb04a4d538fd1,4,0,64,64,0,0,0,2,18,0,1,2,2,440,22,6,122,122,0,4244,4244,0,80,80,0,100
2863a185ee8c6a036ce811e1ecd80eefd7f54401,0,0,0,0,0,0,0,0,0,0,0,0,0,0,23,7,0,0,0,0,0,0,0,0,0,100
02418de9dee7b330552d43183109efa0b50ddf1f,0,0,0,0,0,0,0,0,0,0,0,0,0,0,24,8,0,0,0,0,0,0,0,0,0,100
80ba788ecdccaff5fbc011f6ad619bb62815dc04,0,0,0,0,0,0,0,0,0,0,0,0,0,0,25,9,0,0,0,0,0,0,0,0,0,100
273106bd1186680c54c8101e75e0e7a8a0d83fd1,0,0,0,0,0,0,0,0,0,0,0,0,0,0,26,10,0,0,0,0,0,0,0,0,0,100
1f6fa7b79efde2eb999de34334b686a77b23e46a,3,387,44,343,2,0,2,1,7,548,1,3,1.465314378,425,0,0,151,88,63,5078,2757,2321,71,61,10,94.83585393
57bea12e3a0860958b2060cab4f1193391584839,0,0,0,0,0,0,0,0,0,0,0,0,0,0,2,1,0,0,0,0,0,0,0,0,0,100
4590538073b1b9cb8d4d471e082cfcfc3e1940ff,5,59,390,331,0,0,0,0,43,373,1,5,1.686085404,1996,27,11,440,502,62,13696,15923,2227,185,193,8,94.83585393
ee28a20bef542d693312a3fc39239eee33800879,0,0,0,0,0,0,0,0,0,0,0,0,0,0,28,12,0,0,0,0,0,0,0,0,0,100
1ccb4c22c1723d8137c3fa21dc16252af593d76c,0,0,0,0,0,0,0,0,0,0,0,0,0,0,29,13,0,0,0,0,0,0,0,0,0,100
1910fade19f52b4beccc167507bdc8d417672b81,0,0,0,0,0,0,0,0,0,0,0,0,0,0,30,14,0,0,0,0,0,0,0,0,0,100
a3957200a86a4582c6622738caacd153f0ad7882,0,0,0,0,0,0,0,0,0,0,0,0,0,0,6,0,0,0,0,0,0,0,0,0,0,100
146c5285030aab67ac172b659e8b748335cd2275,0,0,0,0,0,0,0,0,0,0,0,0,0,0,7,1,0,0,0,0,0,0,0,0,0,100
00b1c43740a78540c64c36731b4de64b3402d181,0,0,0,0,0,0,0,0,0,0,0,0,0,0,8,2,0,0,0,0,0,0,0,0,0,100
7ff749b8f26a3f3c90d3b480a35434fb0352b278,0,0,0,0,0,0,0,0,0,0,0,0,0,0,61,0,0,0,0,0,0,0,0,0,0,100
1abf6c2dc31528cc6cd0675a215932c81e7075c9,0,0,0,0,0,0,0,0,0,0,0,0,0,0,62,1,0,0,0,0,0,0,0,0,0,100
e747a43c3fbb5189175ddce143c1a587f1e8a26c,0,0,0,0,0,0,0,0,0,0,0,0,0,0,63,2,0,0,0,0,0,0,0,0,0,100
cfa305bc381a8bc4d428ce88eb1a3ff6668d7953,0,0,0,0,0,0,0,0,0,0,0,0,0,0,9,3,0,0,0,0,0,0,0,0,0,100
080cd772f235a8f490928ce512aa62089af0f203,0,0,0,0,0,0,0,0,0,0,0,0,0,0,64,3,0,0,0,0,0,0,0,0,0,100
2564afeb1fdc4792603f7ddc1a7b3b347d05b54e,1,14,1,13,0,0,0,5,12,1263,1,1,0,74,31,0,13,10,3,638,550,88,5,4,1,100
f7ec67996b66444f9de2284d1ddfaa66297ba51e,2,38,5,33,1,0,1,1,4,273,1,2,0.854180205,271,32,1,69,69,0,1650,1591,59,33,33,0,90.995671
60365c1b05181960e141b71ca035164137f2cf64,0,0,0,0,0,0,0,0,0,0,0,0,0,0,10,1,0,0,0,0,0,0,0,0,0,100
363360229e7ea5f816d87f9d5747dd4494d3b862,1,3,3,0,0,0,0,5,44,103,1,1,0,881,65,4,311,311,0,7013,7018,5,95,95,0,100
5a2febcb97cd5c71cc620c4f294f2d4d12be3aa9,0,0,0,0,0,0,0,0,0,0,0,0,0,0,11,2,0,0,0,0,0,0,0,0,0,100
693ba378fc15ef8774cddd6ac11b8177a1d3e4f5,0,0,0,0,0,0,0,0,0,0,0,0,0,0,12,3,0,0,0,0,0,0,0,0,0,100
7f2afa8df4167435f4e92c715d65519d01bda2f8,0,0,0,0,0,0,0,0,0,0,0,0,0,0,13,4,0,0,0,0,0,0,0,0,0,100
05f3fced7811cb5c6b3cb07361a4c4563bec5632,0,0,0,0,0,0,0,0,0,0,0,0,0,0,14,5,0,0,0,0,0,0,0,0,0,100
4c9b159c3e03dc0965f5d0eac1884a04856c258a,1,1,16,15,0,0,0,2,5,19,1,1,0,273,33,2,68,69,1,1526,1617,91,33,33,0,100
257aba0638a18380a5f99b6226d01db0a0390e26,0,0,0,0,0,0,0,0,0,0,0,0,0,0,66,2,0,0,0,0,0,0,0,0,0,100
315d842148d57590a58fafecf6e5ea378e9e0d74,0,0,0,0,0,0,0,0,0,0,0,0,0,0,15,6,0,0,0,0,0,0,0,0,0,100
274c510db79c651cc2141c4e1eaa07df292295dc,0,0,0,0,0,0,0,0,0,0,0,0,0,0,67,3,0,0,0,0,0,0,0,0,0,100
499b756e7dbc5e0cde8f385ec7bd76023dc2534f,0,0,0,0,0,0,0,0,0,0,0,0,0,0,68,4,0,0,0,0,0,0,0,0,0,100
a50068f11e121bf87fa8bc24639af0fc62064633,0,0,0,0,0,0,0,0,0,0,0,0,0,0,0,0,0,0,0,0,0,0,0,0,0,100
9101a42badd32f0540caa28e27ca053a36e936e3,0,0,0,0,0,0,0,0,0,0,0,0,0,0,1,1,0,0,0,0,0,0,0,0,0,100
5e6ffb8d444c0ed3fb6d0180718a9a7c131f2ce6,2,26,4,22,0,0,0,2,38,2374,1,2,0.881290899,1366,0,0,456,453,3,10507,10322,185,200,197,3,100
62ad11dcf765d6735ef652f4252d19e4ded7afae,2,4,2,2,0,0,0,3,45,178,1,2,0.918295834,1280,34,0,352,352,0,10957,10934,23,124,124,0,100
482adcfa1857033f2a76b07b429a266b0231f433,2,90,1,89,1,0,1,1,7,967,1,2,0.670856159,425,35,0,99,88,11,3143,2757,386,64,61,3,100
fd6c4228fbecc6eff3e3ecd5ee27d2ceb46339ff,3,378,44,334,2,0,2,1,8,1,1,3,1.449527081,437,0,0,152,92,60,5146,2872,2274,72,62,10,91.04606113
c299da64ee53de57ea34e589b858d7fe8ada72fd,0,0,0,0,0,0,0,0,0,0,0,0,0,0,4,1,0,0,0,0,0,0,0,0,0,100
3ff1fa8cac828bfaabd082cb82d7ea3a3827f02f,1,2,3,1,0,0,0,6,9,0,1,1,0,437,5,2,92,92,0,2872,2870,2,62,62,0,100
ce16a3fc9e493d50425ecc697e397c486e9c62dd,1,43,42,1,0,0,0,6,10,0,1,1,0,437,6,3,92,92,0,2872,2872,0,62,62,0,100
1158152de6debcf8e5a532585a68a39ab64d78ed,1,174,179,5,0,0,0,1,2,54,1,1,0,206,7,0,57,57,0,1576,1576,0,8,8,0,100
b5e13ff04d1e9b6e5bb02b482b6ef0111268a9ed,0,0,0,0,0,0,0,0,0,0,0,0,0,0,8,1,0,0,0,0,0,0,0,0,0,100
df57d3ad29918b6c45b6fce15d4f0815024d49f2,1,56,54,2,0,0,0,1,2,54,1,1,0,86,9,2,3,3,0,727,700,27,2,2,0,100
a084fcdb5e79b1b8b86710f836ac6afce08c4a54,1,1,1,0,0,0,0,1,3,0,1,1,0,207,10,3,57,57,0,1576,1576,0,8,8,0,100
32067dec274ba93aa0775fcfe990eef3b87b534c,2,0,331,331,0,0,0,0,0,0,1,2,0.907894446,296,36,0,0,60,60,0,2303,2303,0,10,10,91.04606113
e98caa9937c47a4b44c80e0497995fd404102755,0,0,0,0,0,0,0,0,0,0,0,0,0,0,100,0,0,0,0,0,0,0,0,0,0,100
683bc7135b6a69a8d524393f91ada8310a8f9f88,0,0,0,0,0,0,0,0,0,0,0,0,0,0,101,1,0,0,0,0,0,0,0,0,0,100
1de82871ccf2886171efd917aac822b7f2486ad3,0,0,0,0,0,0,0,0,0,0,0,0,0,0,102,2,0,0,0,0,0,0,0,0,0,100
58daaf08a2637e0976cc124571200ce198b3143d,2,41,4,37,1,0,1,1,36,415,1,2,0.764204507,758,37,1,220,218,2,6482,6245,237,51,50,1,91.01123596
f4f226378918cce8a722d9795f3df4a6c7219746,1,1,1,0,0,0,0,4,9,1548,1,1,0,271,38,2,65,65,0,1769,1767,2,35,35,0,100
54eefb8d780237a7108c2a0c91b12282686426ad,1,0,2,2,0,0,0,4,37,0,1,1,0,760,39,3,218,218,0,6255,6277,22,50,50,0,91.10535406
e62b98c7c6ff0c38f142b72d3b3fed7f3d717710,2,155,2,153,0,0,0,1,20,728,1,2,0.945191769,774,0,0,222,204,18,6525,5658,867,76,66,10,99.82078853
4996990874d127f4908c9f55f7bc3a4334e2aed4,0,0,0,0,0,0,0,0,0,0,0,0,0,0,0,0,0,0,0,0,0,0,0,0,0,100
2875665a5bace62f4e7dfb01060cd50a08637b86,0,0,0,0,0,0,0,0,0,0,0,0,0,0,1,1,0,0,0,0,0,0,0,0,0,100
b30b9e7a3365f50aa6f4481705937c462914764d,1,18,0,18,0,0,0,1,2,3,1,1,0,26,40,4,2,2,0,205,205,0,1,1,0,100
a593cb03f93a9d449723c0e5d765bf2dcf55e132,7,338,213,125,2,0,2,1,35,245,1,7,2.21548273,1950,11,4,547,507,40,15973,14754,1219,161,162,1,90.79569892
cc224aba71ae32f7f371139701bf8f1a9587ad38,1,42,23,19,0,0,0,1,4,40,1,1,0,207,12,5,57,57,0,1576,1576,0,8,8,0,100
21efba087b9fec37500b59e21a8bf5be546ea5a8,1,13,3,10,0,0,0,1,5,0,1,1,0,207,13,6,60,57,3,1643,1576,67,8,8,0,100
4c1463cba1bc268c2ccf2a506d27e6ee84030316,10,262,378,116,1,0,1,2,39,990,1,9,2.521166669,3846,0,0,1074,1111,37,28121,29125,1004,410,407,3,90.79569892
ea242ffa266502e9c5ba01a964fc346d217b5846,2,12,0,12,0,0,0,4,19,432,1,2,1,424,2,2,120,120,0,4052,4052,0,78,78,0,100
4cac7c8980791856c3fb7d3377d249cf8dd44b86,2,14,8,6,0,0,0,4,20,8,1,2,1,424,3,3,120,120,0,4010,4052,42,78,78,0,100
96ef881811ac4f8f4017319d5344bcd3164a7bc4,0,0,0,0,0,0,0,0,0,0,0,0,0,0,4,4,0,0,0,0,0,0,0,0,0,100
da22ffcba82efa50aa384b3acdf26561085e14f6,318,3037,3037,0,0,0,0,2,46,3180,2,60,7.256039695,50387,5,3,9832,9832,0,381164,381164,0,4997,4997,0,100
4fe9b453333c2cf1a0c212fa469b26ba5cf589ed,0,0,0,0,0,0,0,0,0,0,0,0,0,0,6,4,0,0,0,0,0,0,0,0,0,100
7e10babe3eaad11c90cfed41553fc0c1ff90c16a,2,22,4,18,0,0,0,3,8,18,1,2,0.930586129,617,41,0,123,120,3,3768,3646,122,47,46,1,87.11683696
02f623bfe62fd35914b41a8727e041de70635655,0,0,0,0,0,0,0,0,0,0,0,0,0,0,42,1,0,0,0,0,0,0,0,0,0,100
f614e15e6255877d31bb4836ae880eceda90484e,0,0,0,0,0,0,0,0,0,0,0,0,0,0,7,5,0,0,0,0,0,0,0,0,0,100
bedf2f21a05715c3c1aa3b151329f2368c43c965,0,0,0,0,0,0,0,0,0,0,0,0,0,0,8,6,0,0,0,0,0,0,0,0,0,100
51a260a27f3b2d6a046d2ed005eeff0dc7fa6e76,0,0,0,0,0,0,0,0,0,0,0,0,0,0,9,6,0,0,0,0,0,0,0,0,0,100
fc34234028264bc15e779350204b78056d65810a,0,0,0,0,0,0,0,0,0,0,0,0,0,0,10,7,0,0,0,0,0,0,0,0,0,100
f793202c4b87ec258326513568dd62353850f1d0,1,2,0,2,0,0,0,2,3,1561,1,1,0,129,43,2,48,48,0,1134,1118,16,5,5,0,100
c22a1a102d78558e04249dad2cc086ca647fc2dd,9,1545,2,1543,3,0,3,2,22,29,1,5,1.950148742,1247,44,3,578,328,250,17930,9332,8598,271,128,143,87.87268332
48239bb2207b1d1adecb35035898efd064a146ab,0,0,0,0,0,0,0,0,0,0,0,0,0,0,45,4,0,0,0,0,0,0,0,0,0,100
ae3b78f7df9acf255c1534599c697106cf0c5e6d,0,0,0,0,0,0,0,0,0,0,0,0,0,0,46,5,0,0,0,0,0,0,0,0,0,100
191badb80281498611ffcbc0e79b9b020a3d5096,0,0,0,0,0,0,0,0,0,0,0,0,0,0,47,0,0,0,0,0,0,0,0,0,0,100
89a31b9236c92b2036b8f4ddd190183a18c630fc,15,497,74,423,0,0,0,3,26,327,1,8,3.227672571,3281,0,0,876,828,48,27124,24982,2142,379,360,19,90.66455696
0376544cf47600eb1a23f0dc098051fbc75ec00c,1,2,1,1,0,0,0,3,4,17,1,1,0,164,48,0,55,55,0,1383,1385,2,14,14,0,100
c3964345189581db8347bf0e038a0559d7a7626c,331,3679,5568,1889,3,0,3,1,45,671,2,65,6.831651852,52651,14,0,10064,10328,264,388925,398755,9830,5076,5242,166,86.44351464
f2c7b08c3395cd9065730c21bd1a6dc25a57dbf4,331,5568,3679,1889,5,0,5,2,46,2993,2,65,6.831651852,51438,0,0,10328,10064,264,398755,388925,9830,5242,5076,166,86.44351464
5259f26ecee6c268f0ddc86ef45104fe967f267a,2,121,12,109,0,0,0,3,24,86,1,2,0.907942863,1052,1,0,249,242,7,8703,7848,855,88,84,4,100
e3c5da696d4762b287bfec0d133efec20ddb8b14,13,1250,0,1250,12,0,12,1,2,44,1,4,3.328008232,11,49,0,74,0,74,4425,33,4392,55,0,55,98.91122278
f6c044e56f9de7d3e34eeb1702c11fa4add04d84,6,202,7,195,1,0,1,4,22,115,1,4,2.100465504,1691,50,1,412,399,13,16045,14939,1106,254,241,13,89.30369128
f01f61b96dce5b402939fd81f9247313b4b8da0c,0,0,0,0,0,0,0,0,0,0,0,0,0,0,0,0,0,0,0,0,0,0,0,0,0,100
be1639c44b16ddec8c54ecfca050364048daf896,2,87,9,78,0,0,0,3,47,801,1,2,0.946422051,1052,476,0,336,325,11,9174,8629,545,113,106,7,100
9456db01859dd3619fb09a6d4205ab433b357b02,1,1,1,0,0,0,0,6,48,0,1,1,0,893,477,1,315,315,0,7122,7120,2,96,96,0,100
5d45505b85fb55d4d3753b695bd3afc3f15b0c30,1,1,1,0,0,0,0,7,49,1,1,1,0,893,2,0,315,315,0,7120,7122,2,96,96,0,100
07c8f328603a4cacca087133ec3fb45337867aaf,2,9,87,78,0,0,0,4,50,0,1,2,0.946422051,1111,3,1,325,336,11,8629,9174,545,106,113,7,100
973aa71a97e99293a99da965c973c20ce6e0a84a,2,87,9,78,0,0,0,4,51,0,1,2,0.946422051,1052,478,2,336,325,11,9174,8629,545,113,106,7,100
9cfd33870092d5c16a35b523305950215d1feabe,1,1,1,0,0,0,0,7,52,0,1,1,0,893,479,3,315,315,0,7122,7120,2,96,96,0,100
749934f3cd13c413e293815e7f64848a688a6e60,0,0,0,0,0,0,0,0,0,0,0,0,0,0,0,0,0,0,0,0,0,0,0,0,0,100
fa0059c55a31813634188eb85e53b68e33644489,2,23,8,15,0,0,0,2,26,247,1,2,0.708835673,308,0,0,101,100,1,2683,2559,124,24,24,0,100
17cfe99d72121fad1ead76e8bf80729c5c7f7e6b,2,40,2,38,0,0,0,1,2,122,1,2,0.453716339,299,51,0,32,29,3,2598,2322,276,20,17,3,100
d7e12314832f1ef58f87d2f5106ac6b49c5a0be9,0,0,0,0,0,0,0,0,0,0,0,0,0,0,0,0,0,0,0,0,0,0,0,0,0,100
30408a9c192c5f4eaaf42f01f0ffbfffd705aa57,0,0,0,0,0,0,0,0,0,0,0,0,0,0,52,1,0,0,0,0,0,0,0,0,0,100
c37d05e87957d7b46c32c5fadcb569dc9be44117,0,0,0,0,0,0,0,0,0,0,0,0,0,0,0,0,0,0,0,0,0,0,0,0,0,100
e6d2c4d864222290e6e24039365476c8eeb2ea1e,1,9,3,6,0,0,0,7,25,135,1,1,0,721,0,0,212,211,1,5002,4981,21,65,64,1,100
64f898c4322ec641379c9916007303acfe817f84,0,0,0,0,0,0,0,0,0,0,0,0,0,0,0,0,0,0,0,0,0,0,0,0,0,100
5acae5e10ee5d9d7d98b208e29a930f1e66f40ae,2,26,1,25,0,0,0,3,9,1245,1,2,0.950956048,582,53,2,111,107,4,4351,4198,153,76,74,2,100
4c992a58743b564fba831bb7349e3bc07fca4b8e,2,4,3,1,0,0,0,5,26,198,1,2,0.863120569,1315,54,3,245,245,0,11372,11365,7,88,88,0,100
832512edcd7591c238c35b5a479e15ac0709e4cb,0,0,0,0,0,0,0,0,0,0,0,0,0,0,55,4,0,0,0,0,0,0,0,0,0,100
33d495840c896b693b7f37b5ec786ac1acacd3b4,0,0,0,0,0,0,0,0,0,0,0,0,0,0,56,5,0,0,0,0,0,0,0,0,0,100
4810d48cf9643850587e98a1cde17215feb24655,3,16,10,6,0,0,0,4,23,239,1,3,1.465536041,703,11,0,195,195,0,6775,6671,104,127,127,0,100
27cb9e271715b00ff5784164a9fb02de00e57203,2,34,0,34,0,0,0,2,3,204,1,1,1,267,12,1,14,14,0,1868,1868,0,11,11,0,100
bafac8d9d80bfcf8207f42629862617442a01481,2,360,0,360,2,0,2,1,5,27,1,2,0.877868813,0,15,0,63,0,63,2370,0,2370,10,0,10,98.98175647
be33922c03bd229b885fb9d664b55ce308f6ffaf,6,21,365,344,0,0,0,5,27,35,1,6,1.24200883,1913,0,0,378,438,60,13181,15444,2263,172,182,10,98.98175647
fcd0a65f64984fc4b469760f44e07e1bdf8d1644,0,0,0,0,0,0,0,0,0,0,0,0,0,0,480,0,0,0,0,0,0,0,0,0,0,100
ab25bf2037f98a2fc99179b8ee175d3d876f87b3,0,0,0,0,0,0,0,0,0,0,0,0,0,0,481,1,0,0,0,0,0,0,0,0,0,100
1296ce9238a315b4323db351483dc66ec1a1afe3,0,0,0,0,0,0,0,0,0,0,0,0,0,0,0,0,0,0,0,0,0,0,0,0,0,100
a92c8f5413e537c116e6b09021b7ed9944467e32,0,0,0,0,0,0,0,0,0,0,0,0,0,0,482,2,0,0,0,0,0,0,0,0,0,100
bc3fffb067c93ebece18a80f455ea4662a240e0b,0,0,0,0,0,0,0,0,0,0,0,0,0,0,0,0,0,0,0,0,0,0,0,0,0,100
2b1639ce5adc100760118ed6ea0cbb66786bec4d,0,0,0,0,0,0,0,0,0,0,0,0,0,0,483,3,0,0,0,0,0,0,0,0,0,100
e276aa5e40cf51e36b581750c135c9c3875cac84,2,74,7,67,0,0,0,4,53,281,1,2,0.825626526,1295,13,0,360,356,4,11663,11060,603,126,125,1,99.95751912
ef0e1a1a011298ee77f1112ec9709ef03c5035ab,2,21,1,20,0,0,0,4,41,470,1,2,0.439496987,1901,484,3,471,470,1,16782,16581,201,218,217,1,100
0a74e1e0fb45dae8785f204f17d05bd86d0a2d2b,2,16,5,11,0,0,0,2,5,2223,1,2,0.958711883,766,485,4,116,114,2,5205,5169,36,41,41,0,100
8ecb2f130fdb1f730e1e8df667ab99bd31af15b2,4,112,1,111,1,0,1,5,25,71,1,4,1.262668528,569,14,1,149,141,8,5495,4980,515,98,90,8,99.83029275
420824c13381c4014d102c8e51e231c694ddacf2,3,108,13,95,1,0,1,3,12,362,1,2,1.451083153,539,1,0,109,100,9,4663,4233,430,65,57,8,98.93162393
e2d1073bf5095af38fc6ed194d92fc82de225fc9,1,11,3,8,0,0,0,6,12,545,1,1,0,132,0,0,21,19,2,976,929,47,16,16,0,100
67bec06dbdc910856fdc33d149aece97c26a59b1,2,129,7,122,0,0,0,4,54,84,1,2,0.822725596,1347,15,0,364,360,4,12871,11663,1208,127,126,1,100
b2cd78d549ad72cc1a1441562ea1bc5181116040,0,0,0,0,0,0,0,0,0,0,0,0,0,0,1,1,0,0,0,0,0,0,0,0,0,100
bf7f3934c3f33bbd1d8923bf3c33e0fe45831ec5,1,7,0,7,0,0,0,4,7,408,1,1,0,263,2,2,68,68,0,1573,1526,47,33,33,0,100
ecc2adb31a1bcd61d073d87de8be18b2a91f5e6d,0,0,0,0,0,0,0,0,0,0,0,0,0,0,0,0,0,0,0,0,0,0,0,0,0,100
23de4d0133f04fd9d33b54a7c304f92b6802049e,0,0,0,0,0,0,0,0,0,0,0,0,0,0,57,0,0,0,0,0,0,0,0,0,0,100
454db15472ee849e58220fb714638610eb869bac,1,3,1,2,0,0,0,4,8,0,1,1,0,268,58,1,69,68,1,1586,1573,13,33,33,0,100
7a398e0f373fcbe4e9fe5e068c3e720530f0a849,0,0,0,0,0,0,0,0,0,0,0,0,0,0,59,2,0,0,0,0,0,0,0,0,0,100
cae491a6204b8167481fcc46e7f7eed061a44a82,0,0,0,0,0,0,0,0,0,0,0,0,0,0,60,3,0,0,0,0,0,0,0,0,0,100
a53a4fd10072471aa7c8170499a10792e61e0d95,3,37,8,29,0,0,0,5,26,756,1,3,1.294487566,666,16,0,137,136,1,6520,6248,272,94,93,1,100
152fa0954bb74e8e1e627751ccab55ada4f5b375,3,99,6,93,0,0,0,5,27,48,1,3,1.103307409,690,17,0,145,137,8,7004,6520,484,98,94,4,100
d559a7e877777096b3a2ad656606a5a2a88a2df9,1,2,2,0,0,0,0,3,3,758,1,1,0,26,3,0,2,2,0,227,224,3,1,1,0,100
4f53fa933447865d7afb22c5d7d472d87fc2a4ae,1,4,0,4,0,0,0,6,9,740,1,1,0,583,0,0,116,116,0,3434,3414,20,41,41,0,100
d9338a4cf008b445ea3efbe2523288d07162ec71,2,42,4,38,0,0,0,5,55,513,1,2,0.347816914,1130,1,1,356,349,7,9109,8886,223,127,121,6,99.9137931
68a5418bf4b71c15876347260fd1df2b17069c99,2,360,0,360,2,0,2,1,5,27,1,2,0.877868813,0,16,0,63,0,63,2370,0,2370,10,0,10,98.03921569
f8c70a3a9fe5a410363544493a03dc2d10340cbd,6,143,377,234,0,0,0,2,9,1714,1,4,2.035689709,1026,0,0,93,145,52,6241,7802,1561,46,52,6,98.03921569
6bdc8f43e1ac2019e5a405c3edb4cf8fb795ccf8,7,14,5,9,0,0,0,3,42,1125,1,3,2.655050539,1743,1,0,531,522,9,12550,12481,69,249,249,0,100
630e6bc0e789d5baa5bf84cecd124ec1bb6486d2,0,0,0,0,0,0,0,0,0,0,0,0,0,0,0,0,0,0,0,0,0,0,0,0,0,100
f5cbd7378142dc4d730a234059543b2b1e083c0b,0,0,0,0,0,0,0,0,0,0,0,0,0,0,0,0,0,0,0,0,0,0,0,0,0,100
3ab93ca43aa2dbcac3c7b50c201bd3e297dc493b,0,0,0,0,0,0,0,0,0,0,0,0,0,0,1,1,0,0,0,0,0,0,0,0,0,100
ad42bb36c96e7dda17cc04900e3dedfd7b8ea9e7,0,0,0,0,0,0,0,0,0,0,0,0,0,0,2,2,0,0,0,0,0,0,0,0,0,100
57983af07b751809141cfc3b6a0ed07f4ea5ae9d,0,0,0,0,0,0,0,0,0,0,0,0,0,0,3,3,0,0,0,0,0,0,0,0,0,100
cc31afef46b76eef0feb60c1e506db206d0df593,0,0,0,0,0,0,0,0,0,0,0,0,0,0,4,4,0,0,0,0,0,0,0,0,0,100
92b83f5a6ca234b2ac7e3323e3bd2e0b58c758f0,0,0,0,0,0,0,0,0,0,0,0,0,0,0,0,0,0,0,0,0,0,0,0,0,0,100
2ac78613d444332194669c2e9807d2ea55c674b6,0,0,0,0,0,0,0,0,0,0,0,0,0,0,103,0,0,0,0,0,0,0,0,0,0,100
a974984e6e7150b2c6e757bce9cc994b740094c1,0,0,0,0,0,0,0,0,0,0,0,0,0,0,5,5,0,0,0,0,0,0,0,0,0,100
94d15f4be1f4e25e5d6170ad32b5251ac14a4736,1,1,1,0,0,0,0,6,8,804,1,1,0,60,0,0,13,13,0,429,429,0,10,10,0,100
c3384e4d016bac264f6577fff9543199a1fb1970,18,771,158,613,6,0,6,1,41,1402,1,10,2.959006979,2638,17,1,733,637,96,22248,19220,3028,321,305,16,97.37171464
b735b4259d0512482477a2648b92d095a29cfa54,18,158,771,613,0,0,0,2,42,1052,1,10,2.959006979,3121,4,0,637,733,96,19220,22248,3028,305,321,16,97.37171464
656b2bb525b087d3d65f93a58f566164616e1766,0,0,0,0,0,0,0,0,0,0,0,0,0,0,0,0,0,0,0,0,0,0,0,0,0,100
30b5d4dfa98bf49e7165ca47e86fc55ad51fa2bd,0,0,0,0,0,0,0,0,0,0,0,0,0,0,4,0,0,0,0,0,0,0,0,0,0,100
29129abeecd58d387fd8f8986fba052a4868fc7c,0,0,0,0,0,0,0,0,0,0,0,0,0,0,0,0,0,0,0,0,0,0,0,0,0,100
e9fd99ffa53e95ddbb1d136ddd6fabbfd2961f7f,0,0,0,0,0,0,0,0,0,0,0,0,0,0,0,0,0,0,0,0,0,0,0,0,0,100
ce36fffca8dd0bf8f5282041ba473e84193483c1,0,0,0,0,0,0,0,0,0,0,0,0,0,0,6,0,0,0,0,0,0,0,0,0,0,100
ec8514f711b739307d460b23bcb6eccc784f419a,0,0,0,0,0,0,0,0,0,0,0,0,0,0,104,0,0,0,0,0,0,0,0,0,0,100
230c7e75392d3c3dc2598f027603b4fc9d78d041,0,0,0,0,0,0,0,0,0,0,0,0,0,0,105,1,0,0,0,0,0,0,0,0,0,100
52d12bbc11a2990d5c4b49fd7a971341f4474922,1,22,13,9,0,0,0,4,9,881,1,1,0,506,5,1,52,50,2,3630,3569,61,31,31,0,100
0e24e2ab452ff85641cad8e8b74da81890fb6d03,0,0,0,0,0,0,0,0,0,0,0,0,0,0,106,2,0,0,0,0,0,0,0,0,0,100
5ec94b9aff523cd0b847af823243f6fb11cf23c4,0,0,0,0,0,0,0,0,0,0,0,0,0,0,0,0,0,0,0,0,0,0,0,0,0,100
27355642317a0c87b4dc7350203a4197232d83b1,0,0,0,0,0,0,0,0,0,0,0,0,0,0,107,3,0,0,0,0,0,0,0,0,0,100
db6bb9d7a9f404e907d12a1380b65caac776b8a3,3,25,1,24,1,0,1,1,5,590,1,3,1.105612401,1356,0,0,353,350,3,10305,10096,209,286,285,1,99.91386736
43297652d0d08b680b5ab75060d3f7de54e5aa3e,0,0,0,0,0,0,0,0,0,0,0,0,0,0,7,1,0,0,0,0,0,0,0,0,0,100
e06b40163584f46cb77ddf4a85002a5f1b45b9d5,3,1,25,24,0,0,0,2,6,0,1,3,1.105612401,1375,5,0,350,353,3,10096,10305,209,285,286,1,99.91386736
37ce7f72478fcd3dd15637efe25b422f9631bacc,3,25,1,24,1,0,1,2,7,0,1,3,1.105612401,1356,1,1,353,350,3,10305,10096,209,286,285,1,99.91386736
884fbabd3a07e6442dac9a43f34eb9ca0e5a0cbc,6,715,1,714,5,0,5,1,6,182,1,4,2.060193345,14,18,0,116,1,115,3916,140,3776,20,1,19,97.37390579
0550d2cce2793d1b810960a652f03fadf88b02ff,6,1,715,714,0,0,0,0,3,0,1,4,2.060193345,579,0,0,1,116,115,140,3916,3776,1,20,19,97.37390579
4b3677c32b879e0e7f717eb95f9135ac654da760,0,0,0,0,0,0,0,0,0,0,0,0,0,0,1,0,0,0,0,0,0,0,0,0,0,100
874fff780dfe6d6ee8a3fa13f461110794b56f35,10,1062,1,1061,9,0,9,1,7,38,1,5,2.982451264,14,19,1,150,1,149,5505,140,5365,42,1,41,96.973466
64c482fdeeaeac9d19511f9e4ea58447dbfcb91e,1,1,1,0,0,0,0,2,3,0,1,1,0,14,22,2,1,1,0,140,140,0,1,1,0,100
fc3d582617c027f6215f92f8bcdf1bd55f9310aa,9,0,1061,1061,0,0,0,0,0,0,1,4,2.968289507,833,0,0,0,149,149,0,5365,5365,0,41,41,96.973466
17f2d75132021fafeca29edbdcade40df960fdc9,0,0,0,0,0,0,0,0,0,0,0,0,0,0,1,1,0,0,0,0,0,0,0,0,0,100
ce1654df5e6b3c9e4b142678b61d36f19c9da359,9,1049,0,1049,9,0,9,1,7,77,1,4,2.959224685,0,23,0,149,0,149,5321,0,5321,41,0,41,96.973466
60b78961ae0117492062370f5a9774b10ea48255,0,0,0,0,0,0,0,0,0,0,0,0,0,0,24,1,0,0,0,0,0,0,0,0,0,100
ce0bad58393fb1d1d5a446062aca16f1a68d1260,0,0,0,0,0,0,0,0,0,0,0,0,0,0,25,2,0,0,0,0,0,0,0,0,0,100
9132015450a2ad6f56cd582b393e8f1b8df573c9,11,552,278,274,2,0,2,1,8,158,1,4,2.715001715,821,8,0,181,149,32,6911,5321,1590,67,41,26,99.59935897
008cd8a209564a958e9065a5f6ff05526a41f4a5,0,0,0,0,0,0,0,0,0,0,0,0,0,0,26,3,0,0,0,0,0,0,0,0,0,100
53156fd1e475d976df2d55231cbe40b6e0f5dec8,0,0,0,0,0,0,0,0,0,0,0,0,0,0,108,0,0,0,0,0,0,0,0,0,0,100
1f4ec52df822f5b5689cb15c8d005c224a271b6d,0,0,0,0,0,0,0,0,0,0,0,0,0,0,27,4,0,0,0,0,0,0,0,0,0,100
5795c5e505b817d6481eb1863068c0aa0ad329b9,3,5,7,2,0,0,0,2,9,42,1,2,1.384431504,441,28,1,107,107,0,3033,3053,20,26,26,0,100
9d76342ae8d7d017b0fb71c673bf5774b7bf6f61,0,0,0,0,0,0,0,0,0,0,0,0,0,0,29,2,0,0,0,0,0,0,0,0,0,100
e0a3907a58956bf35e64193d0e26f644905c7a1a,3,7,5,2,0,0,0,2,8,50,1,2,1.384431504,441,108,0,107,107,0,3053,3033,20,26,26,0,100
e1d331dcec98e820f9d5bce6d1f18415fd45b3d5,3,5,7,2,0,0,0,2,9,51,1,2,1.384431504,441,26,0,107,107,0,3033,3053,20,26,26,0,100
2cb0638bcaa0147134feb644a293a0512c499741,0,0,0,0,0,0,0,0,0,0,0,0,0,0,27,1,0,0,0,0,0,0,0,0,0,100
81ca4dba8176c1a577205d12e1088880b7714947,0,0,0,0,0,0,0,0,0,0,0,0,0,0,109,1,0,0,0,0,0,0,0,0,0,100
7fcd5eb3382f13e4100a424dce43079ed9c7e07e,0,0,0,0,0,0,0,0,0,0,0,0,0,0,9,0,0,0,0,0,0,0,0,0,0,100
0b74bd5e7a37ccdb42918a0ab7768e9292df5dab,0,0,0,0,0,0,0,0,0,0,0,0,0,0,111,2,0,0,0,0,0,0,0,0,0,100
c9f2c49241397fb3967bd281225f7cce353c32fc,2,63,2,61,0,0,0,5,6,1162,1,2,0.391243564,303,2,0,56,50,6,2500,2011,489,41,36,5,100
ddfcabcee064d137fb0b9082e8c522ab900433c2,0,0,0,0,0,0,0,0,0,0,0,0,0,0,0,0,0,0,0,0,0,0,0,0,0,100
8336f7ece1dc65b1dc17edff5dab9d9ad7aa9666,2,64,18,46,0,0,0,3,5,1534,1,2,0.499179836,142,3,0,20,15,5,1334,1093,241,12,8,4,100
c04a17c86078431d0ae33a3045520e3ec9d9787d,2,34,3,31,0,0,0,5,39,1222,1,2,0.84185219,1619,4,1,361,354,7,13465,13338,127,144,139,5,100
edd8edda0659f802e203e36bcb9d8ec51d821f26,3,43,2,41,0,0,0,6,40,411,1,2,1.153868724,1654,0,0,366,361,5,13797,13547,250,147,144,3,99.14250715
528a1c8a997a0831e83b525173c6a70b08ee681a,8,86,36,50,0,0,0,6,28,1868,1,6,2.869258018,1764,6,0,408,402,6,12686,12488,198,150,150,0,100
e5ae42e5703b8b193e5c2a61458e28a931c5774e,1,1,1,0,0,0,0,8,43,243,1,1,0,1292,486,0,439,439,0,9653,9653,0,186,186,0,100
49ddc8938e3268166a41f100269b93e7e3da652e,1,1,1,0,0,0,0,8,42,533,1,1,0,1292,0,0,439,439,0,9653,9653,0,186,186,0,100
d145b8b6463a7b0d1821d7ebdd561524f9d80914,2,1,2,1,0,0,0,4,43,754,1,2,0.918295834,2141,487,1,528,528,0,16481,16488,7,260,260,0,100
9bff02fbfa5b5d8356aa8af57e250bac7a92ca7f,0,0,0,0,0,0,0,0,0,0,0,0,0,0,5,0,0,0,0,0,0,0,0,0,0,100
21b369895cc6826b862605796bc35704bd142841,0,0,0,0,0,0,0,0,0,0,0,0,0,0,6,0,0,0,0,0,0,0,0,0,0,100
f72b620b9d700cf5f2febb0022079b69b9c9577e,0,0,0,0,0,0,0,0,0,0,0,0,0,0,7,0,0,0,0,0,0,0,0,0,0,100
b1233fd6468d4de546891cc12d19f905c55604cc,0,0,0,0,0,0,0,0,0,0,0,0,0,0,2,0,0,0,0,0,0,0,0,0,0,100
3801888fa8c9dc96a1613e41cbc33800bc84f1b4,1,0,1,1,0,0,0,3,3,1352,1,1,0,81,0,0,17,17,0,501,512,11,11,11,0,100
224f75f64982fa65c56039e4c413b5d9c138800b,1,8,8,0,0,0,0,3,3,1352,1,1,0,92,1,1,26,26,0,694,689,5,17,17,0,100
d0cce25208ad83a9fb6fcce825ae64881bdda420,1,5,23,18,0,0,0,9,56,563,1,1,0,922,2,2,315,321,6,7194,7336,142,94,96,2,100
91d4cc03bbe84ca2aa0ed7f9094a20061b04a8a3,2,2,12,10,0,0,0,4,8,2617,1,2,0.749595257,141,3,3,25,25,0,1052,1070,18,17,17,0,100
14488e35bc31f299de8cd88bd6d1ac07576eaa3e,2,28,5,23,0,0,0,4,9,1352,1,2,0.884963636,1048,4,4,200,197,3,6891,6758,133,107,106,1,100
5e852265ea7197efe809a8c37ec6a0c34811d3ba,0,0,0,0,0,0,0,0,0,0,0,0,0,0,0,0,0,0,0,0,0,0,0,0,0,100
040a3be09216f188dff2b1bf1c23d21ecd4a265c,1,2,2,0,0,0,0,6,11,1406,1,1,0,271,5,0,65,65,0,1769,1769,0,35,35,0,100
15651fc95e058d1b3cc165a70c367d1dc2bad8b7,3,329,6,323,1,0,1,3,6,630,1,2,0.755214937,774,0,0,136,116,20,7671,5205,2466,59,41,18,99.95843724
09c997e206615c4b23ab9ae2ab5f6a3d793e9afb,1,1,1,0,0,0,0,9,44,170,1,1,0,1292,0,0,439,439,0,9658,9653,5,186,186,0,100
189368ed485f5577528824dd88856991a51b6918,2,2,3,1,0,0,0,4,8,1250,1,2,0.970950594,640,7,0,57,57,0,5930,5930,0,35,35,0,100
db8ed216eaf13c8f3862eb31152185f0504c4467,10,1270,345,925,7,0,7,1,7,120,1,2,2.964500138,971,1,0,194,134,60,12533,6932,5601,88,55,33,99.25373134
50eebb8a0b96565641bb56a0f11e326b3f5cc50b,4,125,9,116,0,0,0,5,13,395,1,2,0.936673281,1364,8,1,196,184,12,11722,10788,934,71,62,9,100
6f8c72773753079527e6c5bc37f6ed7842915a24,0,0,0,0,0,0,0,0,0,0,0,0,0,0,8,0,0,0,0,0,0,0,0,0,0,100
ce3f821a79d2a653a08da2ac26a14df9deccb7ec,1,6,9,3,0,0,0,3,4,5755,1,1,0,70,6,0,7,6,1,570,574,4,3,3,0,100
9f3ceefda1ee31c388f535a8d3007f0749119447,1,5,4,1,0,0,0,4,5,1493,1,1,0,340,7,1,77,77,0,1833,1813,20,43,43,0,100
3af404efb31a1dc2fd720384ef9a3f7326c2d303,5,86,61,25,0,0,0,3,4,2826,1,4,1.696602831,320,0,0,43,39,4,2431,2294,137,30,28,2,99.58609272
2df0775d2f368b326e3ac6442ce4850e3fe62edc,10,664,268,396,1,0,1,2,9,197,1,2,2.160934993,1320,0,0,193,173,20,12385,9727,2658,82,72,10,99.83450559
8466975290773f5e0d19a16d2c36c05d64ea5134,10,254,650,396,0,0,0,1,8,6,1,2,2.200533077,1618,0,0,173,193,20,9727,12385,2658,72,82,10,99.83450559
7bbbf92cd699dd82240caa395ee5f6136f22f2b0,10,664,268,396,1,0,1,2,9,197,1,2,2.160934993,1320,18,0,193,173,20,12385,9727,2658,82,72,10,99.83450559
b8c37b32256113bd64f35f0b97e673d74ef61db2,6,52,6,46,1,0,1,4,28,999,1,4,1.211483034,947,0,0,183,176,7,8935,8636,299,115,113,2,99.91742362
b84f64023c4a8e61d1274fc8a3e9c26acfb15c5b,2,26,4,22,0,0,0,7,29,0,1,2,1,488,0,0,132,132,0,4606,4606,0,86,86,0,100
c412267d1d32ab10a929f189cb53cfb3cc619300,9,40,79,39,0,0,0,3,41,1196,1,6,2.494874179,2670,0,0,546,549,3,22662,22737,75,262,262,0,99.91742362
03a3d6f9affa0e70858725bccb11756f975784fb,9,79,40,39,1,0,1,4,40,426,1,6,2.494874179,2657,19,1,549,546,3,22737,22662,75,262,262,0,99.91742362
164ee588cf822588df2c877f07ba03cb1a4a9482,9,43,79,36,0,0,0,3,41,1136,1,6,2.487271603,2670,1,1,547,549,2,22710,22737,27,262,262,0,99.91742362
ba11ddab1558f408905d0f730096e9963cb58f4c,11,114,43,71,1,0,1,4,40,484,1,8,2.921064456,2816,20,2,584,582,2,23924,23897,27,271,271,0,99.91742362
53a9af762acbfdc734a3cadf7d3c6d8736e1ec61,11,45,115,70,0,0,0,3,41,236,1,8,2.97031573,2860,2,2,582,584,2,23897,23924,27,271,271,0,99.91742362
ff5099c85ddb668af8a80560d706a8914f717356,15,382,93,289,2,0,2,4,57,544,1,11,2.576564748,4235,21,3,997,981,16,36435,35910,525,429,422,7,99.71134021
5040c6413b112665cd051c415f368f9a51426b97,3,35,2,33,0,0,0,7,41,183,1,2,1.041464763,1685,488,0,371,366,5,14074,13802,272,149,147,2,100
1f9553a759d05b46e91e7380699b0c646fa21e86,35,519,2334,1815,0,0,0,3,56,1025,1,18,3.995551522,7856,0,0,1377,1500,123,52250,62665,10415,579,644,65,98.55252275
c7a3c960902abffcbd3e9caf084f0dc5fae9f7f0,37,2373,556,1817,10,0,10,4,57,939,1,19,4.120295253,6616,22,4,1500,1377,123,62743,52328,10415,644,579,65,98.55252275
48b2abca0f3b7873519f3566eb46a49cb4d15db7,6,75,41,34,0,0,0,2,10,340,1,2,2.493440314,636,32,0,140,140,0,4032,4032,0,33,33,0,100
41653853c66143796e0bac503064e24cc0353a87,4,4,10,6,0,0,0,3,6,0,1,1,1.863120569,346,23,5,90,90,0,2270,2270,0,17,17,0,100
a79b4366305d8796aeac60bb7b68bfc86fbde804,0,0,0,0,0,0,0,0,0,0,0,0,0,0,24,6,0,0,0,0,0,0,0,0,0,100
2e25d2edd2d06c665502afe788c197a63ce663fa,0,0,0,0,0,0,0,0,0,0,0,0,0,0,25,7,0,0,0,0,0,0,0,0,0,100
ea23e37f8fe3bc87248d917dd539575103aacfef,0,0,0,0,0,0,0,0,0,0,0,0,0,0,0,0,0,0,0,0,0,0,0,0,0,100
4b69cb20ad51d80b9404b505c4550dec1ba32df5,40,63,63,0,0,0,0,3,45,1930,1,24,5.123717423,9324,26,5,2091,2091,0,67061,67061,0,1084,1084,0,100
706d8ce0da8aa595061e880288682385cc77a0d0,6,70,70,0,0,0,0,3,10,1104,1,5,1.412253883,1715,27,6,294,294,0,13971,13971,0,185,185,0,100
42afa621c8a3ce6fc2d1de73b15db5f253e5990d,0,0,0,0,0,0,0,0,0,0,0,0,0,0,28,7,0,0,0,0,0,0,0,0,0,100
8bc495109e8be07dc4fb502131414059cbf7e3ca,262,1282,1286,4,0,0,0,2,58,2047,1,62,6.995285848,47898,29,8,8408,8413,5,372830,375162,2332,4162,4162,0,99.91786448
2bbb99602e9e925058ead86fc8ac4e27055b05d6,517,518,518,0,0,0,0,2,59,1544,2,71,9.012947284,59201,30,9,10147,10147,0,453604,453604,0,5341,5341,0,100
61ab73837a56b5ce89b6a05d205b38b78d58cea9,45,8,181,173,0,0,0,2,28,40,1,15,4.833284539,9973,31,10,1600,1600,0,71633,73162,1529,805,805,0,90.36850921
6a4dd09b8d24c2c62420f2eaf90365789606b2e3,14,51,54,3,0,0,0,2,16,0,1,9,3.113669592,2752,32,11,300,300,0,20666,20748,82,216,216,0,100
a3e05bee1c81b54eed8cb37b278652cf80666121,9,11,11,0,0,0,0,2,16,0,1,5,3.095795255,2764,33,12,465,465,0,19709,19740,31,364,364,0,100
a7a43da6de9bd44e57e057319127c64b2fca56a0,2,8,0,8,0,0,0,4,48,10,1,2,0.954434003,1398,34,12,448,446,2,10337,10291,46,193,192,1,100
673261c8656124cc58bee65fe5e8c779350779ee,3,106,10,96,1,0,1,1,16,10,1,3,1.126456155,484,9,0,106,97,9,3216,2880,336,62,58,4,98.85198852
37bd84dc608c39f611c19557d4b2d1052d08db32,0,0,0,0,0,0,0,0,0,0,0,0,0,0,10,1,0,0,0,0,0,0,0,0,0,100
7f9cbca12af13d4b8b5709edba2bae4d4a808102,2,30,6,24,0,0,0,7,13,74,1,2,0.918295834,795,0,0,118,115,3,5896,5744,152,80,78,2,100
027d196fd3f6f990977a4e86c1c07464506cabc3,2,75,2,73,0,0,0,4,4,82,1,2,0.964547659,341,0,0,42,31,11,2657,2244,413,40,29,11,99.92125984
51a92fea4ad197c6f8ddd91cefc1e35840c15c4a,0,0,0,0,0,0,0,0,0,0,0,0,0,0,1,0,0,0,0,0,0,0,0,0,0,100
e74ab07e9a37650baac391da3d0d7a9cb626ad85,0,0,0,0,0,0,0,0,0,0,0,0,0,0,2,1,0,0,0,0,0,0,0,0,0,100
517e617d450074ba00781e7b9ff90a6ff0b10ee7,0,0,0,0,0,0,0,0,0,0,0,0,0,0,3,2,0,0,0,0,0,0,0,0,0,100
340ef224eb856c7c5472051b4e5f9b30ce628f03,4,42,20,22,0,0,0,4,44,136,1,3,1.423050818,2718,489,0,549,544,5,21662,21528,134,211,209,2,100
338f250b69af0e577304aed7ec24be7b16c38f7c,4,20,42,22,0,0,0,3,43,0,1,3,1.423050818,2737,35,0,544,549,5,21528,21662,134,209,211,2,100
407c48afdb9cb31f477d64b966184a5766545e3c,4,42,20,22,0,0,0,4,44,136,1,3,1.423050818,2718,490,1,549,544,5,21662,21528,134,211,209,2,100
9c200c993147dd3ac0b5f6ed94b558ad863d7c18,0,0,0,0,0,0,0,0,0,0,0,0,0,0,491,2,0,0,0,0,0,0,0,0,0,100
26894395cb480790488e0db283f8a503bd093909,2,12,6,6,0,0,0,4,49,159,1,2,0.99107606,1450,492,3,447,445,2,11137,11095,42,192,191,1,100
61befce7e70aeb13ab5a8d6ff3c336d4f982b9a9,0,0,0,0,0,0,0,0,0,0,0,0,0,0,493,4,0,0,0,0,0,0,0,0,0,100
94f12b85c3d269cdb510f8c0b843008469e4f826,1,9,2,7,0,0,0,2,14,189,1,1,0,300,494,4,89,88,1,2174,2138,36,24,24,0,100
86bc2604c6832a56f806121dcde5fd3e91c9d3a4,0,0,0,0,0,0,0,0,0,0,0,0,0,0,0,0,0,0,0,0,0,0,0,0,0,100
5c270dad2a281f4e70fb8c8a657d93a0cc72b7a8,0,0,0,0,0,0,0,0,0,0,0,0,0,0,495,1,0,0,0,0,0,0,0,0,0,100
82a57ada210dcda48a206b3ab47cb320a3e96bec,2,290,0,290,0,0,0,5,10,266,1,2,0.182138465,1893,0,0,346,337,9,18627,16076,2551,321,312,9,100
463fbc07df0072570789a2b36592def8f3611fd0,0,0,0,0,0,0,0,0,0,0,0,0,0,0,496,0,0,0,0,0,0,0,0,0,0,100
33c165b32eb73547905362766991b46765fba686,2,0,290,290,0,0,0,4,9,0,1,2,0.182138465,2124,112,0,337,346,9,16076,18627,2551,312,321,9,100
bdeb76be063268756ebe84983475a93ee3fdc59b,2,290,0,290,0,0,0,5,10,266,1,2,0.182138465,1893,10,0,346,337,9,18627,16076,2551,321,312,9,100
79e4e9d41002ee8677cbd64148a62a0035d5512e,0,0,0,0,0,0,0,0,0,0,0,0,0,0,11,1,0,0,0,0,0,0,0,0,0,100
3b6658dfcfea85e140420de207fb29d583a6df0e,0,0,0,0,0,0,0,0,0,0,0,0,0,0,12,2,0,0,0,0,0,0,0,0,0,100
0f25ed1f6a78ad0356f4d0202f570cf09ed3f601,9,1149,0,1149,9,0,9,1,1,0,1,2,3.052985933,0,0,0,121,0,121,5766,0,5766,72,0,72,98.95913647
238714d324d1623f144ca09c0dfb10330a2ba2c4,18,266,1167,901,1,0,1,0,50,112,1,6,3.621903171,6136,0,0,1148,1246,98,42546,46360,3814,608,669,61,90.46372476
d5eeeed469fc7de4e141042da9b347d18c084b9e,9,1149,0,1149,9,0,9,1,1,0,1,2,3.052985933,0,497,0,121,0,121,5766,0,5766,72,0,72,98.9427634
b71dcf24f252da5858bd95bfd4bd56402e3a458c,0,0,0,0,0,0,0,0,0,0,0,0,0,0,2,0,0,0,0,0,0,0,0,0,0,100
18164dc87649265c85f1dca76efd4ac5d16424dc,0,0,0,0,0,0,0,0,0,0,0,0,0,0,9,0,0,0,0,0,0,0,0,0,0,100
5e8168a25494b04ef0aeaf6421a033d7192f5625,1,1,1,0,0,0,0,8,12,131,1,1,0,1255,0,0,305,305,0,9012,9012,0,282,282,0,100
5f885281acb5a4c3e6bae402761036828c6736d4,0,0,0,0,0,0,0,0,0,0,0,0,0,0,36,0,0,0,0,0,0,0,0,0,0,100
d8ad935132bc5a375f339c5aa18af36423628b59,0,0,0,0,0,0,0,0,0,0,0,0,0,0,13,0,0,0,0,0,0,0,0,0,0,100
cf2f30336efe0ecc3debc7bede86fde6d23f7c79,6,185,1,184,2,0,2,4,17,424,1,4,1.481711093,589,10,0,81,64,17,4634,3810,824,46,35,11,95.40186916
ff1e23f2bdb5bd49ecbd20817647b65badc1e681,0,0,0,0,0,0,0,0,0,0,0,0,0,0,0,0,0,0,0,0,0,0,0,0,0,100
390a85409006f829d4d3564c2308c06ade211920,0,0,0,0,0,0,0,0,0,0,0,0,0,0,0,0,0,0,0,0,0,0,0,0,0,100
67204b83ddbce6d62f48fdf9dbe073f0b9f3abf1,0,0,0,0,0,0,0,0,0,0,0,0,0,0,0,0,0,0,0,0,0,0,0,0,0,100
b41da12492f084c0da0af84e37711348f92f0898,0,0,0,0,0,0,0,0,0,0,0,0,0,0,1,1,0,0,0,0,0,0,0,0,0,100
e1c30a236a6b8244fc6e78e759c886617e9a05fb,0,0,0,0,0,0,0,0,0,0,0,0,0,0,37,0,0,0,0,0,0,0,0,0,0,100
dc15bfcdbb210396f4cf0580e485e7776d77d383,0,0,0,0,0,0,0,0,0,0,0,0,0,0,1,0,0,0,0,0,0,0,0,0,0,100
e83caaf341af5368cf39a461bb5a15fe6108a21b,0,0,0,0,0,0,0,0,0,0,0,0,0,0,2,1,0,0,0,0,0,0,0,0,0,100
b814cd0b76b63b08cd7772f43c3cb904a1dcbff5,18,1703,66,1637,3,0,3,5,31,675,1,8,2.534364845,2602,0,0,675,486,189,27002,18095,8907,342,211,131,99.37718957
3efbd4c1a5d81966ab5dd01b394c4b0a188bf871,0,0,0,0,0,0,0,0,0,0,0,0,0,0,14,0,0,0,0,0,0,0,0,0,0,100
fec162dda29ecbf36579ebb61a666bd17ed9bb01,0,0,0,0,0,0,0,0,0,0,0,0,0,0,15,1,0,0,0,0,0,0,0,0,0,100
a943df760f6df520702a54e9b061e98250172c8e,0,0,0,0,0,0,0,0,0,0,0,0,0,0,16,2,0,0,0,0,0,0,0,0,0,100
355d51ba1e09ae73737160880ee2f07f953ceb6e,0,0,0,0,0,0,0,0,0,0,0,0,0,0,15,1,0,0,0,0,0,0,0,0,0,100
4505b498da9800f2d3143d7487ee07e99177808b,0,0,0,0,0,0,0,0,0,0,0,0,0,0,18,4,0,0,0,0,0,0,0,0,0,100
993cedea14eb511e6341e1ed2692112bd253e3d3,0,0,0,0,0,0,0,0,0,0,0,0,0,0,17,3,0,0,0,0,0,0,0,0,0,100
389231ef31b02d444a73105ea4d6b5e0cbaac1d4,0,0,0,0,0,0,0,0,0,0,0,0,0,0,19,5,0,0,0,0,0,0,0,0,0,100
f7f2f82cc511e334db25015d32a911addce0c064,18,66,1703,1637,0,0,0,4,30,952,1,8,2.534364845,3678,3,2,486,675,189,18095,27002,8907,211,342,131,99.37718957
c83acd5ac1443c9afd5ae06eb5e3a802c2b1eeee,0,0,0,0,0,0,0,0,0,0,0,0,0,0,4,3,0,0,0,0,0,0,0,0,0,100
2cf3c9909a970039b7f85af4c59bf5fd8068bc88,18,1703,66,1637,3,0,3,5,31,675,1,8,2.534364845,2602,1,0,675,486,189,27002,18095,8907,342,211,131,99.37718957
377bc5848d066a851560fb921b6b77996f7d150f,0,0,0,0,0,0,0,0,0,0,0,0,0,0,2,1,0,0,0,0,0,0,0,0,0,100
54a79769987d78384899062b59d413412c577de3,0,0,0,0,0,0,0,0,0,0,0,0,0,0,20,6,0,0,0,0,0,0,0,0,0,100
6b6ddfeb920f901d851ca12c6be3476ca00a58a9,0,0,0,0,0,0,0,0,0,0,0,0,0,0,22,8,0,0,0,0,0,0,0,0,0,100
bbd41db436a8185e9c66cf3c59272d7a65f80ecc,0,0,0,0,0,0,0,0,0,0,0,0,0,0,1,0,0,0,0,0,0,0,0,0,0,100
a11bd49e86d50f5a840ab2cdfe4f6927bedb4f93,0,0,0,0,0,0,0,0,0,0,0,0,0,0,0,0,0,0,0,0,0,0,0,0,0,100
f20b566febaac5d68a16802350272d8517c3775f,0,0,0,0,0,0,0,0,0,0,0,0,0,0,3,2,0,0,0,0,0,0,0,0,0,100
a9f286b6d27d432ba2028495ec9ecd251382108f,0,0,0,0,0,0,0,0,0,0,0,0,0,0,4,3,0,0,0,0,0,0,0,0,0,100
8be63e391e698f743c4c84ce5708fd472f62e469,0,0,0,0,0,0,0,0,0,0,0,0,0,0,8,4,0,0,0,0,0,0,0,0,0,100
787be93d3cb1ef8f90e9e136cff6b0d2b66f4bcb,0,0,0,0,0,0,0,0,0,0,0,0,0,0,9,5,0,0,0,0,0,0,0,0,0,100
089ee708b2b2deb0a3cb1f1c937288954c6a5700,0,0,0,0,0,0,0,0,0,0,0,0,0,0,23,9,0,0,0,0,0,0,0,0,0,100
47923b7bec3ed1326941ad4db5cef9babfd2d106,0,0,0,0,0,0,0,0,0,0,0,0,0,0,0,0,0,0,0,0,0,0,0,0,0,100
421a37058d305a9f723aba0912bca25f4dad30b8,0,0,0,0,0,0,0,0,0,0,0,0,0,0,24,10,0,0,0,0,0,0,0,0,0,100
563e79d0f2d64b64d5407f1c3b8b579b91f6446d,0,0,0,0,0,0,0,0,0,0,0,0,0,0,25,11,0,0,0,0,0,0,0,0,0,100
d695a50ae56398b7daeac40f9a0bbbd605b68731,1,6,4,2,0,0,0,5,7,66,1,1,0,272,1,0,12,12,0,2225,2179,46,10,10,0,100
b4ede4b116b24b5308e8419504a73e02b7f7e406,12,410,14,396,1,0,1,8,45,589,1,8,2.884599258,3431,0,0,909,834,75,28787,26307,2480,334,312,22,99.92242048
764c9322c136f0e3b8bd1e3f646d683321927e1a,0,0,0,0,0,0,0,0,0,0,0,0,0,0,1,1,0,0,0,0,0,0,0,0,0,100
c9a62f3c2530f5c957edca4b5096f74c78b408a3,0,0,0,0,0,0,0,0,0,0,0,0,0,0,26,3,0,0,0,0,0,0,0,0,0,100
8d2a2ce10db3fdef107f834a0fe0c9297b043a94,1,68,10,58,0,0,0,4,6,914,1,1,0,1534,1,0,312,290,22,10519,9998,521,181,181,0,100
9373b13259181895faab95b02d7576ad51260249,0,0,0,0,0,0,0,0,0,0,0,0,0,0,2,0,0,0,0,0,0,0,0,0,0,100
63d0524a75b753dc4cf679ef9e2f423a639196c6,0,0,0,0,0,0,0,0,0,0,0,0,0,0,3,1,0,0,0,0,0,0,0,0,0,100
0ebd2c8448979daf97b5d1605d85de6b36c434a9,0,0,0,0,0,0,0,0,0,0,0,0,0,0,4,2,0,0,0,0,0,0,0,0,0,100
46d2c8b5da67b87f8f427140cb6964c3125c84cb,0,0,0,0,0,0,0,0,0,0,0,0,0,0,0,0,0,0,0,0,0,0,0,0,0,100
8e069398b7da9d74f3b46a430ea869470eb299da,0,0,0,0,0,0,0,0,0,0,0,0,0,0,5,3,0,0,0,0,0,0,0,0,0,100
26700949812e39f6ddedc63c53f8cb5562fd7f15,2,2,0,2,0,0,0,7,16,94,1,1,1,122,0,0,11,11,0,726,694,32,6,6,0,100
943411d20d27c9f11f9bd0311ae5c4438b7cc81c,1,9,2,7,0,0,0,4,7,8,1,1,0,1591,2,1,313,312,1,10571,10519,52,181,181,0,100
95234db14b7afca9593829f43c41a9851e08dcd7,26,210,145,65,0,0,0,3,60,769,1,18,4.054734857,11648,6,4,2604,2603,1,89768,89384,384,1153,1153,0,100
9855529f1af979ade479d5658bbe90917ae2734b,0,0,0,0,0,0,0,0,0,0,0,0,0,0,0,0,0,0,0,0,0,0,0,0,0,100
d799e1829a39ca0379f3e12d2e8cfdf5fcd26151,16,277,147,130,1,0,1,3,61,114,1,12,3.127280101,7049,7,5,1947,1932,15,52383,51624,759,706,692,14,95.06454062
c78a3d5ea4e7e511ba9f6182157956db3e65e1a0,13,95,107,12,0,0,0,4,62,684,1,9,3.072479363,3945,8,6,970,962,8,29384,29449,65,338,335,3,99.92553984
fd26721a5b333d59ebf37d39ed69fedcf33dc8dd,1,4,2,2,0,0,0,8,22,0,1,1,0,954,9,7,149,149,0,7653,7625,28,99,99,0,100
25032e10a86851bdabfa29b99885ccfc03c6667e,97,1536,1876,340,0,0,0,3,32,730,1,21,5.533997794,21414,2,0,2399,2409,10,166047,168505,2458,1507,1509,2,95.49005682
9e60e59c53e006629a341822a39a22fa35f8270c,0,0,0,0,0,0,0,0,0,0,0,0,0,0,0,0,0,0,0,0,0,0,0,0,0,100
a318a34d1f5f8146fb441c092c73b6170719e88a,3,101,29,72,0,0,0,11,53,12,1,1,1.114729977,1919,10,8,614,605,9,14625,14303,322,268,263,5,99.8982706
33f7177e66e04c4843676e3d7a9cf739ba812304,0,0,0,0,0,0,0,0,0,0,0,0,0,0,3,0,0,0,0,0,0,0,0,0,0,100
6527d6d1d5081d38168b9ea14bd7d715c5e2af8d,0,0,0,0,0,0,0,0,0,0,0,0,0,0,1,1,0,0,0,0,0,0,0,0,0,100
aa5860fc355d7d44c3d567fdb1fb2d20ad474cc0,1,14,3,11,0,0,0,6,10,114,1,1,0,166,0,0,24,23,1,1114,1038,76,7,7,0,100
c4386ad21f16b4fdd761eeb5ac4332f6221aac3f,1,12,92,80,0,0,0,13,35,17,1,1,0,831,3,1,222,243,21,5107,5477,370,74,78,4,100
409dac80e9e042f308d097f64b496df122c58dd2,3,96,128,32,1,0,1,2,6,102,1,1,1.556254104,92,0,0,5,6,1,398,525,127,3,2,1,90.27088897
9623e50cb0da0140fd0427c04f6fa29b518e4034,0,0,0,0,0,0,0,0,0,0,0,0,0,0,11,9,0,0,0,0,0,0,0,0,0,100
33bbf35c3dcc6a89b8ac6a8433ccf4bca21c7435,0,0,0,0,0,0,0,0,0,0,0,0,0,0,12,10,0,0,0,0,0,0,0,0,0,100
561a811f671a16139403741f707da6bfdf23997c,2,49,2,47,0,0,0,7,63,3,1,2,0.462749059,1459,0,0,360,359,1,13154,12659,495,126,125,1,100
43dbc590a0ef1d954b505b14c1f48b66f10f650a,1,1,1,0,0,0,0,5,8,47,1,1,0,216,0,0,47,47,0,1470,1470,0,17,17,0,100
c8ea9dac88b112d8bb282b9502cd463bf9249396,1,0,1,1,0,0,0,7,30,0,1,1,0,574,13,11,45,45,0,5952,5961,9,32,32,0,100
c6f772b408046c61b3269d8aecc5f1684bcad6fb,8,93,9,84,3,0,3,4,15,585,1,3,2.537838264,1522,0,0,319,316,3,9377,9221,156,164,161,3,90.29618083
207d4ff95d4dd48a4267e3d2577f86b304d0b11b,1,2,35,33,0,0,0,4,10,942,1,1,0,136,14,12,27,31,4,671,865,194,18,20,2,100
4fad66df0132c815a2a74c01704168d87f47009f,1,21,0,21,0,0,0,4,11,0,1,1,0,105,15,13,30,27,3,793,671,122,19,18,1,100
ca1ef06d87424630f80ade31afcd8a1108dd5fed,0,0,0,0,0,0,0,0,0,0,0,0,0,0,2,2,0,0,0,0,0,0,0,0,0,100
bb6a79ea79315037956c1665b83b8c80a3016c73,0,0,0,0,0,0,0,0,0,0,0,0,0,0,27,0,0,0,0,0,0,0,0,0,0,100
07bd95a82f93458196d44f8e285435a865d3d70d,7,56,93,37,0,0,0,2,10,770,1,1,2.699387797,563,1,1,79,81,2,2679,2836,157,54,56,2,100
6d4f6bef8d03f6bb5d452b65e68074f11892ccbf,0,0,0,0,0,0,0,0,0,0,0,0,0,0,4,2,0,0,0,0,0,0,0,0,0,100
4a8e814327be1f18b203784778f8b17d7f9da8b0,0,0,0,0,0,0,0,0,0,0,0,0,0,0,0,0,0,0,0,0,0,0,0,0,0,100
9bf8b01243b059911dc042ed2b0ecf4729005cf0,0,0,0,0,0,0,0,0,0,0,0,0,0,0,5,3,0,0,0,0,0,0,0,0,0,100
a8875da2cff6bd08c4169f3126b1871f09c557e3,0,0,0,0,0,0,0,0,0,0,0,0,0,0,6,4,0,0,0,0,0,0,0,0,0,100
88de5c89207d92f402cf250f2225bf7898af3c0c,0,0,0,0,0,0,0,0,0,0,0,0,0,0,28,1,0,0,0,0,0,0,0,0,0,100
40a5e6ae4cc4cd2d8065880c2641d640d1ca2f8f,1,33,0,33,0,0,0,1,2,12,1,1,0,68,2,2,6,5,1,561,398,163,4,3,1,100
80632f46e75f447739c2fe91b13d26910bc527ac,0,0,0,0,0,0,0,0,0,0,0,0,0,0,29,2,0,0,0,0,0,0,0,0,0,100
71be8a456ffb250abb22f2a956ae0c6acd5104fa,1,47,80,33,0,0,0,3,5,17,1,1,0,220,7,5,15,15,0,1893,1945,52,12,12,0,100
113ea7f4397fd9a24746d1ab7c8124d3c3bf6bac,0,0,0,0,0,0,0,0,0,0,0,0,0,0,1,1,0,0,0,0,0,0,0,0,0,100
5bd23ddf297952d816166083f2f02b83abae344a,0,0,0,0,0,0,0,0,0,0,0,0,0,0,30,3,0,0,0,0,0,0,0,0,0,100
89f3503af2acc7a6ef52bde01d4961a7f49899a8,1,2,1,1,0,0,0,5,8,41,1,1,0,1597,2,0,313,313,0,10587,10571,16,181,181,0,100
a7fb39172ddec93e289127e1a58d7ea1e0b3a498,6,97,122,25,0,0,0,7,54,27,1,4,2.211810353,3027,16,8,681,681,0,25307,25527,220,321,320,1,100
21098529e659743e551f2c35652d1a93c1528082,4,45,10,35,0,0,0,10,49,16,1,2,1.397786827,1023,17,9,264,258,6,7727,7558,169,81,79,2,100
fe6a2fc4c4178633d85d84657520967893f18aec,0,0,0,0,0,0,0,0,0,0,0,0,0,0,4,1,0,0,0,0,0,0,0,0,0,100
e6a3126e6f23ddabf829e47efa27d4ec2f76f7e0,0,0,0,0,0,0,0,0,0,0,0,0,0,0,5,2,0,0,0,0,0,0,0,0,0,100
eb06f71861025c9261b5ad7a09cab0c46f2ac311,14,85,310,225,0,0,0,3,30,361,1,8,2.377382028,2852,31,4,311,361,50,19471,20964,1493,180,189,9,93.59831164
39500088491512aeccf3e9dc7b76d99b91a82436,0,0,0,0,0,0,0,0,0,0,0,0,0,0,6,3,0,0,0,0,0,0,0,0,0,100
e04c2c291395339b8eb488a5e045500d366553b6,1,11,7,4,0,0,0,6,9,38,1,1,0,282,32,5,12,12,0,2264,2274,10,10,10,0,100
04d4423d4ee4f86e308fa761c6918223b55a6c5c,6,108,0,108,0,0,0,8,36,229,1,3,1.802988042,1370,18,8,286,280,6,9850,9465,385,106,100,6,100
021c01c4c2756f793a4eee3a0f914c2c131823ac,3,185,15,170,0,0,0,11,55,30,1,3,1.336666482,1978,19,9,537,508,29,16115,15198,917,244,226,18,100
01a347e996a20406b0bf13026dd375725c4efb7f,3,55,4,51,1,0,1,10,50,16,1,2,1.480725487,1754,0,0,379,376,3,14190,13985,205,155,154,1,99.92977528
619c6c0bf5b3440cfe80fff8b1c399b91d1d69db,1,17,0,17,0,0,0,2,2,0,1,1,0,10,3,0,0,0,0,76,76,0,0,0,0,100
f86da24a94fb0cd9d31f266c2639f4b82a3392b7,0,0,0,0,0,0,0,0,0,0,0,0,0,0,0,0,0,0,0,0,0,0,0,0,0,100
fe58b5a5d434c60bf3971a5dce4079bde33363d7,1,153,34,119,0,0,0,5,9,31,1,1,0,1598,4,1,332,313,19,11311,10587,724,191,181,10,100
008b19051b0de6b81a57b93442b341916a6acf8a,0,0,0,0,0,0,0,0,0,0,0,0,0,0,5,2,0,0,0,0,0,0,0,0,0,100
2950a10eb9bbaf4f6a52f4692f6a151e00997cd1,0,0,0,0,0,0,0,0,0,0,0,0,0,0,6,3,0,0,0,0,0,0,0,0,0,100
563cfb76e846e307426afd020d3e8c59d29cc1df,0,0,0,0,0,0,0,0,0,0,0,0,0,0,0,0,0,0,0,0,0,0,0,0,0,100
d3c726fce8d5dd9632960939858af134895ff3ea,1,1,1,0,0,0,0,5,10,73,1,1,0,137,0,0,20,20,0,897,897,0,10,10,0,100
39ec1a3f0addfce06869f705f7a17c03d538fe16,1,1,1,0,0,0,0,10,14,73,1,1,0,1255,0,0,305,305,0,9018,9018,0,282,282,0,100
6eb25603b96169bf8d77269176218c63c181e9f4,6,237,69,168,0,0,0,9,33,205,1,5,2.280589437,1812,3,1,505,447,58,14773,13363,1410,188,186,2,100
226013fdc311fca600af1207e756518e1b153de8,0,0,0,0,0,0,0,0,0,0,0,0,0,0,1,1,0,0,0,0,0,0,0,0,0,100
bbea1cec3ed6ffae631b4c0d975639a098687ab4,2,14,7,7,0,0,0,8,64,62,1,2,0.453716339,1496,2,2,361,360,1,13199,13145,54,127,126,1,100
30a5725789d4cf77beec0e504371a766529ad7a0,0,0,0,0,0,0,0,0,0,0,0,0,0,0,7,3,0,0,0,0,0,0,0,0,0,100
e2e11cba3303b189f090383c931f0ae60c4fa952,2,16,0,16,0,0,0,10,34,4,1,2,1,648,20,4,182,180,2,6258,6230,28,94,92,2,100
0beb39d78f6bdccb803b8c6eb58af02b2cc80429,2,120,1,119,1,0,1,1,56,13,1,2,0.318855419,1385,0,0,461,458,3,10812,10137,675,195,193,2,99.54513646
734eddefb2b271cdbe5386f6f78a17d7a7a1809e,1,17,0,17,0,0,0,2,2,0,1,1,0,103,21,5,2,2,0,641,641,0,2,2,0,100
3e5cf4a94dd1f71e42a45c812f26a53c7b89e945,0,0,0,0,0,0,0,0,0,0,0,0,0,0,0,0,0,0,0,0,0,0,0,0,0,100
6583fcce6d32627c55faf9e1df35cc353b8c8841,3,110,0,110,1,0,1,4,7,357,1,2,1.368297198,567,0,0,106,89,17,4070,3470,600,48,39,9,99.75652174
ee5008d9ed66f3237cf1304484b1d1e6836c8a33,2,71,4,67,0,0,0,5,13,535,1,2,0.996791632,295,0,0,40,28,12,2373,1913,460,29,22,7,100
b07dfbcc6c37da1b730a4bd897d4cfdeabe63cdc,0,0,0,0,0,0,0,0,0,0,0,0,0,0,1,1,0,0,0,0,0,0,0,0,0,100
b991c93ad1238a1b128213a5d7ef754ddeaa827e,0,0,0,0,0,0,0,0,0,0,0,0,0,0,0,0,0,0,0,0,0,0,0,0,0,100
54fc3f53807f7cfa535100d826e19e66aa5cad8e,0,0,0,0,0,0,0,0,0,0,0,0,0,0,2,2,0,0,0,0,0,0,0,0,0,100
d9d95871441b015353429585baa3ae821fdb39c1,2,49,1,48,1,0,1,1,16,508,1,1,0.327444919,113,0,0,17,13,4,949,669,280,8,5,3,99.54861111
b5bec5ca18901507f6fc01d635f10465fd3edcdf,0,0,0,0,0,0,0,0,0,0,0,0,0,0,0,0,0,0,0,0,0,0,0,0,0,100
3299a9f0fa36367c7b5a68dc6bde633fe6e1ae1c,0,0,0,0,0,0,0,0,0,0,0,0,0,0,0,0,0,0,0,0,0,0,0,0,0,100
c5aa1d6962ee16812d8d8c19b167b1b256e8002f,3,41,3,38,0,0,0,3,6,678,1,2,1.219748493,253,3,3,40,37,3,1621,1540,81,13,12,1,100
0e6df4837b1032a51e7fd85c95451781991d4856,0,0,0,0,0,0,0,0,0,0,0,0,0,0,0,0,0,0,0,0,0,0,0,0,0,100
b64081ee174e5b5aefcd93c3bc6c5aefe6acbf49,1,12,29,17,0,0,0,12,51,43,1,1,0,816,4,4,227,229,2,6420,6508,88,54,55,1,100
915cb4541fa0e7d3d96646947f449cbb4b75589a,0,0,0,0,0,0,0,0,0,0,0,0,0,0,0,0,0,0,0,0,0,0,0,0,0,100
eaa7cca922b916ab7ad0fac6e109330197f8c75f,0,0,0,0,0,0,0,0,0,0,0,0,0,0,0,0,0,0,0,0,0,0,0,0,0,100
602a2c5b5258d5e1f0f60f71506b16801cbdf156,0,0,0,0,0,0,0,0,0,0,0,0,0,0,1,1,0,0,0,0,0,0,0,0,0,100
0530d6cebf1979ca65b6abb7b2df080460910127,0,0,0,0,0,0,0,0,0,0,0,0,0,0,0,0,0,0,0,0,0,0,0,0,0,100
de5d8ebc897407eda369cbbab1facff61076e780,0,0,0,0,0,0,0,0,0,0,0,0,0,0,0,0,0,0,0,0,0,0,0,0,0,100
8c99b3409005feae42d24529687860220b7d25d6,0,0,0,0,0,0,0,0,0,0,0,0,0,0,0,0,0,0,0,0,0,0,0,0,0,100
6eda0b41796d5d039ace7720bbd8066f0b7835e5,0,0,0,0,0,0,0,0,0,0,0,0,0,0,1,0,0,0,0,0,0,0,0,0,0,100
eaaf263372229f9aad9970f54767e043b1e104dc,0,0,0,0,0,0,0,0,0,0,0,0,0,0,22,2,0,0,0,0,0,0,0,0,0,100
b9409b3bee5a45e8ffc67430e6a878be564569ce,0,0,0,0,0,0,0,0,0,0,0,0,0,0,23,3,0,0,0,0,0,0,0,0,0,100
b597c3ab93ef1c6a37a9c1fa3584d86d20723784,0,0,0,0,0,0,0,0,0,0,0,0,0,0,0,0,0,0,0,0,0,0,0,0,0,100
7fbedbb8923bb203409f5d5576a38ac70aba9f4b,0,0,0,0,0,0,0,0,0,0,0,0,0,0,1,1,0,0,0,0,0,0,0,0,0,100
4b1ab225fef8e8f66cb95d6605bdd4fd568929ed,0,0,0,0,0,0,0,0,0,0,0,0,0,0,24,4,0,0,0,0,0,0,0,0,0,100
e37a52d909b913059ba4493f509ede7d46dcf0e1,0,0,0,0,0,0,0,0,0,0,0,0,0,0,0,0,0,0,0,0,0,0,0,0,0,100
269d0ff7d3025cf3370023e353a373916dd67433,3,18,2,16,0,0,0,10,52,57,1,3,1.336666482,2115,25,5,490,488,2,16866,16756,110,185,183,2,100
4d07366aae24b6701c304dd5124b7c5bae5ea6ab,0,0,0,0,0,0,0,0,0,0,0,0,0,0,0,0,0,0,0,0,0,0,0,0,0,100
c8436998ae107996c1c48c9b7efcbb98b8b92930,0,0,0,0,0,0,0,0,0,0,0,0,0,0,0,0,0,0,0,0,0,0,0,0,0,100
6971ac739aee41bfd62dcd4031f6c848bb0b2d4e,0,0,0,0,0,0,0,0,0,0,0,0,0,0,1,0,0,0,0,0,0,0,0,0,0,100
67dbda933bb2e1286a28fd832ea4316d34906005,0,0,0,0,0,0,0,0,0,0,0,0,0,0,0,0,0,0,0,0,0,0,0,0,0,100
5432cd09da963bb72796729dafa2bf5954d57772,0,0,0,0,0,0,0,0,0,0,0,0,0,0,1,1,0,0,0,0,0,0,0,0,0,100
e65411f5cce2d58588fbb96a366560f6e6803dab,4,14,14,0,0,0,0,10,35,864,1,4,1.724407818,930,26,6,201,201,0,8682,8723,41,108,108,0,100
595643cba16a2b4d7be68d46ee8f79c4e380cbf7,4,58,13,45,0,0,0,5,15,324,1,3,0.866987402,1559,0,0,270,264,6,10472,10166,306,136,133,3,100
d55f5e152c288a2037d65d15a7169d76aa9be2be,2,120,1,119,1,0,1,1,15,0,1,2,0.439496987,649,0,0,120,117,3,4251,3637,614,43,41,2,99.54923717
254ee8ff595c6c52580128aec9355394f96382d5,1,8,13,5,0,0,0,9,16,0,1,1,0,652,27,7,116,118,2,3626,3657,31,41,41,0,100
475904893244b23e612073f9f8cf476380cec812,1,17,0,17,0,0,0,2,2,0,1,1,0,68,28,8,2,2,0,594,594,0,2,2,0,100
beef86697a0dbd09d4d99a735f8a5afe37e5d976,0,0,0,0,0,0,0,0,0,0,0,0,0,0,0,0,0,0,0,0,0,0,0,0,0,100
7ed38d7c7e150987ef8bf035196576fc158e03eb,23,747,73,674,7,0,7,11,65,85,1,11,3.918194014,4548,0,0,1248,1165,83,38499,35155,3344,516,472,44,92.57142857
726c7bf18300ece22199b37b2c4b2b1c4cc9ffc8,0,0,0,0,0,0,0,0,0,0,0,0,0,0,29,9,0,0,0,0,0,0,0,0,0,100
4b498e5c76569dfa7acb7e62f175075db3d314e2,4,268,0,268,4,0,4,1,1,0,1,4,1.628356075,0,0,0,23,0,23,975,0,975,13,0,13,99.76108309
67014e575a96a1172b1601254ab7bfab19bceb88,1,2,2,0,0,0,0,2,2,0,1,1,0,76,30,10,13,13,0,580,580,0,5,5,0,100
c011d76436a1c11c614a133ae06abbc19baf2436,0,0,0,0,0,0,0,0,0,0,0,0,0,0,0,0,0,0,0,0,0,0,0,0,0,100
34aa0fa4c674c281c1060515dec0a72b1c973778,0,0,0,0,0,0,0,0,0,0,0,0,0,0,0,0,0,0,0,0,0,0,0,0,0,100
a262a107ddd403e3ac5a773c735110a6565104de,3,95,6,89,1,0,1,1,17,392,1,2,1.263199462,523,0,0,112,103,9,3665,3270,395,64,61,3,99.84147952
52a53e9520d7657bd237cae3e92e3ed015c71811,0,0,0,0,0,0,0,0,0,0,0,0,0,0,33,0,0,0,0,0,0,0,0,0,0,100
29e1d662bafc66499e198a6af9b0920aa79695e5,0,0,0,0,0,0,0,0,0,0,0,0,0,0,34,1,0,0,0,0,0,0,0,0,0,100
d2f92b445cf07683b7aa9afd2f69e2b23a033e6b,0,0,0,0,0,0,0,0,0,0,0,0,0,0,35,2,0,0,0,0,0,0,0,0,0,100
6599fb29fb0ba8a2c3dba0b0e39feb31cfe2111c,0,0,0,0,0,0,0,0,0,0,0,0,0,0,5,0,0,0,0,0,0,0,0,0,0,100
7182fda6eb3f4b8aa43016ac8c32692103b0cb9e,1,1,1,0,0,0,0,5,14,448,1,1,0,141,6,1,9,9,0,1037,1038,1,9,9,0,100
4eb2bed0bbbf7c25d9a25ab06eb368348771e918,0,0,0,0,0,0,0,0,0,0,0,0,0,0,7,2,0,0,0,0,0,0,0,0,0,100
b1249403bc0e9e62af8e87f61bb4a33e44007b4d,1,12,10,2,0,0,0,3,6,1086,1,1,0,1548,0,0,347,347,0,11677,11693,16,233,233,0,100
a9ec22cce3c5d0bbde162dca99a96adf4584b429,2,10,8,2,0,0,0,2,10,76,1,2,0.650022422,333,8,3,21,21,0,2491,2477,14,15,15,0,100
fab3d4051c6bf5cacf6bd80895a72332ae5f362f,1,4,4,0,0,0,0,3,5,1086,1,1,0,287,9,4,84,84,0,2096,2104,8,24,24,0,100
35dd8813b6366b68ad302c38217ff5a7e26553d2,0,0,0,0,0,0,0,0,0,0,0,0,0,0,36,3,0,0,0,0,0,0,0,0,0,100
904a9146cbb95ef39ff85610e953b1ab428192e9,0,0,0,0,0,0,0,0,0,0,0,0,0,0,37,4,0,0,0,0,0,0,0,0,0,100
6c1e81c8ce9140e7a9f9e1d389654e9aa6f4231f,0,0,0,0,0,0,0,0,0,0,0,0,0,0,38,5,0,0,0,0,0,0,0,0,0,100
b3d027654b943899c609d5bcf529a45a458dfa56,0,0,0,0,0,0,0,0,0,0,0,0,0,0,39,6,0,0,0,0,0,0,0,0,0,100
8f94f5647b6351c219fa105f37cd01f156427f71,0,0,0,0,0,0,0,0,0,0,0,0,0,0,40,7,0,0,0,0,0,0,0,0,0,100
202748df75a29e8b27ce4e374ff289cfe8a91040,0,0,0,0,0,0,0,0,0,0,0,0,0,0,41,8,0,0,0,0,0,0,0,0,0,100
d3dbf7122d3b8386ae72f46f0e966c8b69b8621a,0,0,0,0,0,0,0,0,0,0,0,0,0,0,42,9,0,0,0,0,0,0,0,0,0,100
0917c496a26877a3bb260a5a09ff60b3d1ab85d8,0,0,0,0,0,0,0,0,0,0,0,0,0,0,43,10,0,0,0,0,0,0,0,0,0,100
7da2a4f05f80a044a1d5033048d0040a9f7f2445,0,0,0,0,0,0,0,0,0,0,0,0,0,0,43,10,0,0,0,0,0,0,0,0,0,100
a296ebc8894ad52ae7c0946e635b93cadc709e70,0,0,0,0,0,0,0,0,0,0,0,0,0,0,44,11,0,0,0,0,0,0,0,0,0,100
e61751efd9f72cc299fce55c16e1d15e2ee1addc,0,0,0,0,0,0,0,0,0,0,0,0,0,0,46,13,0,0,0,0,0,0,0,0,0,100
1e5f62c8bd3b58d5d622d8abeb665d601c978f75,0,0,0,0,0,0,0,0,0,0,0,0,0,0,47,14,0,0,0,0,0,0,0,0,0,100
1d7f2d7b46794348394a2f0a70658d94c38530a1,0,0,0,0,0,0,0,0,0,0,0,0,0,0,48,15,0,0,0,0,0,0,0,0,0,100
0c223c9da6d0286c9e16257cef8b9988099cf8a2,1,5,4,1,0,0,0,8,11,24,1,1,0,284,31,0,12,12,0,2308,2271,37,10,10,0,100
7622817b35b5511607d33facb6c0877e08b6c21f,0,0,0,0,0,0,0,0,0,0,0,0,0,0,49,16,0,0,0,0,0,0,0,0,0,100
2b8513f94ba04b3b14867d639ae37750db56f765,0,0,0,0,0,0,0,0,0,0,0,0,0,0,50,17,0,0,0,0,0,0,0,0,0,100
1a934e37e1d3bf63fdec844d676d6a5c129e1b67,0,0,0,0,0,0,0,0,0,0,0,0,0,0,51,18,0,0,0,0,0,0,0,0,0,100
efd6274a4c7a9ed7c1c0d41477649b68baeefa0b,0,0,0,0,0,0,0,0,0,0,0,0,0,0,52,19,0,0,0,0,0,0,0,0,0,100
7740efa3ee8e3ddd01405c8f3af1937859f6bd1a,0,0,0,0,0,0,0,0,0,0,0,0,0,0,8,0,0,0,0,0,0,0,0,0,0,100
9133577129111a75103d9bcfa5444f9847abb515,0,0,0,0,0,0,0,0,0,0,0,0,0,0,9,1,0,0,0,0,0,0,0,0,0,100
dd31b7eb4d537d83197ba04059953283c58696fc,0,0,0,0,0,0,0,0,0,0,0,0,0,0,53,18,0,0,0,0,0,0,0,0,0,100
a7e72b5b581605d70919b8d244414b879533bd8f,0,0,0,0,0,0,0,0,0,0,0,0,0,0,54,19,0,0,0,0,0,0,0,0,0,100
298047ba76ad69007a5d9ba7e931322c933a03b3,0,0,0,0,0,0,0,0,0,0,0,0,0,0,55,20,0,0,0,0,0,0,0,0,0,100
e5fdce55138d59839ff16797aac02e4b1d916ab9,0,0,0,0,0,0,0,0,0,0,0,0,0,0,56,21,0,0,0,0,0,0,0,0,0,100
63a34a693763f0f103b15e4fd77dcfc8547829dc,0,0,0,0,0,0,0,0,0,0,0,0,0,0,57,22,0,0,0,0,0,0,0,0,0,100
6660870e3e13ceb91bcf9d4b8ff5cad8fa142856,0,0,0,0,0,0,0,0,0,0,0,0,0,0,55,20,0,0,0,0,0,0,0,0,0,100
c3a488cb1808f0de86f4f0ab27acbc26095c6f09,0,0,0,0,0,0,0,0,0,0,0,0,0,0,58,23,0,0,0,0,0,0,0,0,0,100
695d83d02d5c5cd074c3fed0655f0940e0f3c4de,0,0,0,0,0,0,0,0,0,0,0,0,0,0,59,24,0,0,0,0,0,0,0,0,0,100
29ebfc3af238de33dc4bbbf508c4b6daf3306b38,0,0,0,0,0,0,0,0,0,0,0,0,0,0,60,25,0,0,0,0,0,0,0,0,0,100
8a42cd0642fcadca7765f59d83a059b1eddb26bd,0,0,0,0,0,0,0,0,0,0,0,0,0,0,61,26,0,0,0,0,0,0,0,0,0,100
7f116b8d58655ac369e3ae2c31cd68bc93f0b903,0,0,0,0,0,0,0,0,0,0,0,0,0,0,0,0,0,0,0,0,0,0,0,0,0,100
55acae0fdb725aec974dd125086d161c097b0dac,0,0,0,0,0,0,0,0,0,0,0,0,0,0,32,1,0,0,0,0,0,0,0,0,0,100
7a098485a585fa3e387e2ad2b2e4af682a88a997,0,0,0,0,0,0,0,0,0,0,0,0,0,0,63,27,0,0,0,0,0,0,0,0,0,100
114cf9c826c38c925292f81109e3dce0837d71ed,0,0,0,0,0,0,0,0,0,0,0,0,0,0,33,2,0,0,0,0,0,0,0,0,0,100
9a05375436385b7fce75d32cfdcd359e279e0628,0,0,0,0,0,0,0,0,0,0,0,0,0,0,2,0,0,0,0,0,0,0,0,0,0,100
806adf7bba3dbff20002b6dd2d64d6e3be062321,4,58,3,55,0,0,0,9,66,629,1,2,1.909887141,1929,0,0,485,476,9,16411,16162,249,178,172,6,100
2084ca42ffd22b7827cc7e240cf249534b9f9d45,0,0,0,0,0,0,0,0,0,0,0,0,0,0,34,3,0,0,0,0,0,0,0,0,0,100
5a64ea53d2e37449295c8d29f3d33ce849691155,0,0,0,0,0,0,0,0,0,0,0,0,0,0,64,15,0,0,0,0,0,0,0,0,0,100
6d0323cc950f0b05a7e30a81fa5970df312be736,0,0,0,0,0,0,0,0,0,0,0,0,0,0,65,16,0,0,0,0,0,0,0,0,0,100
0d997e5e5952546e0bdeab3080ef7c00d8caffc1,0,0,0,0,0,0,0,0,0,0,0,0,0,0,1,0,0,0,0,0,0,0,0,0,0,100
05171ee872bb8d6e9173a34b7832f522b2a56763,7,22,11,11,0,0,0,5,38,812,1,4,2.248495256,2201,0,0,417,414,3,14817,14789,28,190,189,1,100
411cfb96db6126a06df9e8093106e690b7e35dfc,1,22,39,17,0,0,0,12,17,111,1,1,0,663,35,3,63,66,3,5610,5668,58,39,39,0,100
2eea14c10f87029dfe89e7575fbd587cb23b812d,0,0,0,0,0,0,0,0,0,0,0,0,0,0,3,1,0,0,0,0,0,0,0,0,0,100
5896f1a1bdcbc2f7450b09b1dbbdeb4ad0cb13b6,2,5,2,3,0,0,0,5,10,126,1,2,0.985228136,199,8,0,19,19,0,1311,1307,4,12,12,0,100
c3e0c4974db92bf6001a6da654870455cac70eac,0,0,0,0,0,0,0,0,0,0,0,0,0,0,10,0,0,0,0,0,0,0,0,0,0,100
8643e3bd73cab8dbbbcac1203a19c2d2cdc62cfe,0,0,0,0,0,0,0,0,0,0,0,0,0,0,9,1,0,0,0,0,0,0,0,0,0,100
384061c05720287aa93a756a742aab2572b75e79,0,0,0,0,0,0,0,0,0,0,0,0,0,0,0,0,0,0,0,0,0,0,0,0,0,100
10445fe1c366cbafcd5de4ddf4520ac5f91183cb,0,0,0,0,0,0,0,0,0,0,0,0,0,0,11,1,0,0,0,0,0,0,0,0,0,100
3c16299956d64dc4a1b76161228ebb545d3d400b,14,45,85,40,0,0,0,4,53,558,1,11,3.750085681,3017,0,0,683,694,11,21219,21378,159,283,283,0,100
bcc79e90540f55dc9e1dd34da7a1f5901ee22b2a,1,3,7,4,0,0,0,5,6,1187,1,1,0,182,1,1,53,55,2,1366,1383,17,14,14,0,100
0de805575f41c2d7deff9fcbe408e51606f88269,1,3,3,0,0,0,0,15,67,43,1,1,0,936,2,2,319,319,0,7246,7258,12,97,97,0,100
4fad0f252d06f5cf4c51fbfdfa2ac966daf55a1f,0,0,0,0,0,0,0,0,0,0,0,0,0,0,36,2,0,0,0,0,0,0,0,0,0,100
e03f9d44faaaa5fd0908f9402340164972415c0d,0,0,0,0,0,0,0,0,0,0,0,0,0,0,4,0,0,0,0,0,0,0,0,0,0,100
cef06d90fd2e4156f83498f6a77b325115491a49,0,0,0,0,0,0,0,0,0,0,0,0,0,0,0,0,0,0,0,0,0,0,0,0,0,100
a780991e7316762cda2a7cc8bc7092c4c61ccf63,0,0,0,0,0,0,0,0,0,0,0,0,0,0,66,0,0,0,0,0,0,0,0,0,0,100
99393272e65c24778254e97be11ec87e02d5689e,0,0,0,0,0,0,0,0,0,0,0,0,0,0,12,1,0,0,0,0,0,0,0,0,0,100
6b5963d64e8c339c5266b6b14c707ea9cb10f8fa,0,0,0,0,0,0,0,0,0,0,0,0,0,0,10,0,0,0,0,0,0,0,0,0,0,100
f4425913940a11870bc8fda602d29217cff53af0,0,0,0,0,0,0,0,0,0,0,0,0,0,0,11,1,0,0,0,0,0,0,0,0,0,100
7e64b40104f0918b04ddc83038ef0bb779ff1c95,0,0,0,0,0,0,0,0,0,0,0,0,0,0,13,1,0,0,0,0,0,0,0,0,0,100
c1faf3b56504de9e366000ceeb4a65ef9567f8d2,3,2,13,11,0,0,0,2,2,840,1,1,1.584962501,290,14,2,34,34,0,1597,1639,42,21,21,0,100
ba30662a00fe5f883d643c956d7b982a5d4b8751,0,0,0,0,0,0,0,0,0,0,0,0,0,0,15,3,0,0,0,0,0,0,0,0,0,100
1f88d9ede26daad76f1343ca300f16cc824ef712,0,0,0,0,0,0,0,0,0,0,0,0,0,0,16,4,0,0,0,0,0,0,0,0,0,100
c4f880eb00b07a4cc6fbab24ae9f5c9d970d269b,0,0,0,0,0,0,0,0,0,0,0,0,0,0,17,5,0,0,0,0,0,0,0,0,0,100
95cd62055fd24910d8873b4d8ab209eec198239e,0,0,0,0,0,0,0,0,0,0,0,0,0,0,12,2,0,0,0,0,0,0,0,0,0,100
ac95febf82b15ffa564cac1d92475cdf6efed9f6,27,105,52,53,0,0,0,4,12,360,1,10,4.389798373,3503,37,1,396,142,254,21133,7503,13630,227,97,130,97.37817797
e0ab6bd54ab632569782a577b7e9a1d419e08845,3,9,7,2,0,0,0,3,17,907,1,2,1.505240815,451,0,0,102,101,1,3183,3149,34,35,34,1,99.92025518
114fee5317ca2bb2b09864c66da99e86190faffb,0,0,0,0,0,0,0,0,0,0,0,0,0,0,0,0,0,0,0,0,0,0,0,0,0,100
e44acccf69a0b40f12f904144df67b345a5138ad,0,0,0,0,0,0,0,0,0,0,0,0,0,0,13,3,0,0,0,0,0,0,0,0,0,100
2aa4946f42541369b31094538801c2caec251c67,0,0,0,0,0,0,0,0,0,0,0,0,0,0,3,0,0,0,0,0,0,0,0,0,0,100
c62a8f9d11c85c18a9df1f28d23fe0396f7766b9,0,0,0,0,0,0,0,0,0,0,0,0,0,0,14,4,0,0,0,0,0,0,0,0,0,100
ff11298e397977b820bdeed612e61dab17f118b9,0,0,0,0,0,0,0,0,0,0,0,0,0,0,15,5,0,0,0,0,0,0,0,0,0,100
e2ca27ef053becb47d3b18a00215e9df3da3ad2a,0,0,0,0,0,0,0,0,0,0,0,0,0,0,16,1,0,0,0,0,0,0,0,0,0,100
b82a370b1607d6f45c3ec9db6125dd527d5eaab5,0,0,0,0,0,0,0,0,0,0,0,0,0,0,17,2,0,0,0,0,0,0,0,0,0,100
846a9a1bb85e9832b696970c96e6089d43c3ee6b,0,0,0,0,0,0,0,0,0,0,0,0,0,0,5,0,0,0,0,0,0,0,0,0,0,100
a56108835a0aa35530c8f367ce8a50d0c5861192,0,0,0,0,0,0,0,0,0,0,0,0,0,0,6,1,0,0,0,0,0,0,0,0,0,100
5714c9e837428279329b9758e415ce89118be646,0,0,0,0,0,0,0,0,0,0,0,0,0,0,0,0,0,0,0,0,0,0,0,0,0,100
4468b34b5da5fba1a7ed5bf79a829e1efcffbd63,0,0,0,0,0,0,0,0,0,0,0,0,0,0,1,1,0,0,0,0,0,0,0,0,0,100
3ec3db79af89d5674c2cfe5cedb7c784787e9bcd,0,0,0,0,0,0,0,0,0,0,0,0,0,0,18,3,0,0,0,0,0,0,0,0,0,100
d93a33a3860787da855822c0d6e0cfd425f4583b,0,0,0,0,0,0,0,0,0,0,0,0,0,0,18,0,0,0,0,0,0,0,0,0,0,100
4a3609cd854e9ef5bdda5b43e188a3309a93aef9,7,101,8,93,1,0,1,5,68,1215,1,6,1.159378587,986,0,0,331,323,8,8202,7627,575,109,101,8,99.73418394
e561b5a95caecf9d394186031868251b7a229f2e,0,0,0,0,0,0,0,0,0,0,0,0,0,0,19,1,0,0,0,0,0,0,0,0,0,100
02e08dafd35b31e9e596564b0996dc63bd2fb1ed,0,0,0,0,0,0,0,0,0,0,0,0,0,0,0,0,0,0,0,0,0,0,0,0,0,100
2f2025201bf937cb163d263396a097bbc5fad1b0,2,0,143,143,0,0,0,3,3,1298,1,2,0.974129188,121,1,1,0,16,16,0,543,543,0,10,10,99.86677325
f173ae8d690b5f90e8cc5899b654762a9d11e17d,1,3,3,0,0,0,0,11,15,299,1,1,0,1255,2,2,305,305,0,9018,9018,0,282,282,0,100
f715c974b9f7eb4d4809c1e0f04b7b4ff12837b3,0,0,0,0,0,0,0,0,0,0,0,0,0,0,3,0,0,0,0,0,0,0,0,0,0,100
e16f30abf6d1b7befcc36f49a5bc39166a75f814,1,8,5,3,0,0,0,3,5,1299,1,1,0,101,4,1,14,14,0,670,645,25,6,6,0,100
ef8349ffd6da5c6f4693ac46548c96e22eeb7cd7,3,35,50,15,0,0,0,13,69,485,1,3,0.320827992,2093,5,2,635,648,13,16435,16569,134,172,172,0,100
8c3c590d7bfa6d486f5741c5e2f5214a1f2436c1,1,4,3,1,0,0,0,6,12,369,1,1,0,689,6,3,141,142,1,4006,4007,1,73,73,0,100
6d0698705299e67e2f463216b95bf962ab6f11a2,1,5,9,4,0,0,0,8,34,270,1,1,0,382,7,4,119,120,1,2926,2942,16,32,32,0,100
a7a5aeba3927404f6d83306caeb546a7f3a5e705,1,2,2,0,0,0,0,5,18,95,1,1,0,306,0,0,89,89,0,2180,2180,0,24,24,0,100
d195e1fc626f960eef7ef9a5aaeb3851cb4fda31,1,29,14,15,0,0,0,6,13,2,1,1,0,690,8,5,141,141,0,4007,4006,1,73,73,0,100
6fddbae08fcf0aba1d51289d1b90681c3bfa9477,1,18,19,1,0,0,0,6,14,0,1,1,0,690,9,6,140,141,1,3996,4007,11,73,73,0,100
3d51ba5e96556136c2084838591aa325e81bfca9,190,1024,739,285,0,0,0,3,70,617,1,54,6.347343862,44087,20,2,8218,8227,9,314775,312891,1884,4095,4095,0,100
63e02101cf94d8ab0e1ae01baafe04c5767aa371,1,32,17,15,0,0,0,6,11,1314,1,1,0,287,10,7,69,69,0,1551,1583,32,33,33,0,100
0e6977d1b89c9a103cec0be5bd4bbeceb740d50f,6,15,19,4,0,0,0,4,58,281,1,6,2.254447579,3379,11,8,1031,1031,0,23989,24024,35,362,362,0,100
fb3c25f92baa17249219e263e0fe17568c67eadc,2,3,10,7,0,0,0,7,59,0,1,2,0.995727452,1593,12,9,496,498,2,11546,11600,54,205,205,0,100
46485b555dc16b38be59aa8e777aaecf74185fab,1,0,1,1,0,0,0,7,10,0,1,1,0,187,21,3,39,39,0,1296,1307,11,12,12,0,100
1119b6eb5b92730b27e9798793bc67f192591c15,157,775,1373,598,0,0,0,3,60,339,1,60,6.355159396,41560,22,4,7076,7161,85,295316,298914,3598,3514,3530,16,100
8026c8ffe4ef67ab419dba73910636bf2c1a691c,548,18961,19651,690,0,0,0,3,71,417,1,78,7.829641153,80077,23,3,12780,12780,0,543693,543883,190,6738,6738,0,99.9733191
8f0eca6990a584707c0cc7690fc1d325803a5287,1,2,0,2,0,0,0,8,21,5,1,1,0,232,13,0,55,55,0,1539,1523,16,26,26,0,100
d81bffd41c348d8ffe11506fe26c66c58a37a580,6,135,14,121,2,0,2,6,23,69,1,4,2.206616272,595,37,0,84,77,7,4496,4089,407,50,43,7,99.8401279
b2f4790ab20537907d9bc29050e9eb31f711f671,1,15,14,1,0,0,0,17,43,6,1,1,0,862,38,0,253,253,0,5655,5643,12,84,84,0,100
ff6a4e8317689928056ed18805a944057ae666ad,10,31,30,1,0,0,0,8,44,0,1,6,2.484509313,2104,39,1,412,407,5,15109,15097,12,166,165,1,100
c1abf35eec063f582da2551bc9121ae0beee65f5,6,51,14,37,0,0,0,11,45,107,1,6,1.869557962,2782,40,2,566,566,0,25235,25240,5,249,249,0,100
05ad1a7b49568b400268e7e2d504eac3ed97f0d1,2,7,0,7,0,0,0,13,46,0,1,2,0.591672779,1455,41,3,316,316,0,11374,11284,90,123,123,0,100
48ed810a0d1352adcb3f608ff33b186ed433e784,41,5112,0,5112,40,0,40,1,12,0,1,7,5.280279968,1661,14,1,762,332,430,38876,11124,27752,449,191,258,89.33823529
8197803dceb89d53d6f5a3e9143f46c035d6558b,5,720,0,720,1,0,1,4,47,108,1,5,0.546514543,1217,42,4,415,315,100,11494,7977,3517,207,142,65,99.90952955
c552c1746ff9bac97512fc7db2523f3cff1bd15d,25,85,86,1,0,0,0,4,23,0,1,16,4.278604499,6401,15,2,1296,1298,2,45360,45216,144,698,698,0,100
c369dd1b4d2f807bfdec5b25317a5adee855d7fc,13,699,679,20,2,0,2,2,48,0,1,6,3.191020235,3757,11,0,769,798,29,30824,31734,910,430,458,28,92.23268325
db992cf8686ffa681b0c592696b37ad519c33ee6,0,0,0,0,0,0,0,0,0,0,0,0,0,0,24,2,0,0,0,0,0,0,0,0,0,100
392c761952ec7f679b29ae28129403ea8cf307ea,0,0,0,0,0,0,0,0,0,0,0,0,0,0,10,0,0,0,0,0,0,0,0,0,0,100
de48a0a8a0343b61fdb255011fde38c619761046,3,97,22,75,0,0,0,5,58,15,1,2,1.580649601,909,1,0,244,239,5,7655,7134,521,65,63,2,99.96194825
451deec474935db54824069dcf5cfe7ae49a1b11,2,91,34,57,0,0,0,3,5,18,1,2,0.505919244,126,0,0,32,23,9,1325,927,398,14,13,1,99.92383854
22c4685e1711235e7435a2acbdb4df48f39e3f92,1,27,1,26,0,0,0,4,6,0,1,1,0,122,1,1,25,22,3,881,784,97,7,6,1,100
dbf977989105217b37a798d30793d90e747eceb1,1,11,256,245,0,0,0,12,20,11,1,1,0,641,0,0,93,116,23,2652,3630,978,37,41,4,100
e0871378317e2e10e60f7a6ec992802e341e240f,1,13,11,2,0,0,0,12,21,0,1,1,0,435,1,1,93,93,0,2660,2652,8,37,37,0,100
7cd66387b7a249eabcfbd57fb651613d9eb1b8c4,2,184,0,184,2,0,2,1,1,0,1,2,0.932111568,0,0,0,3,0,3,1056,0,1056,3,0,3,98.80463205
f7f1a5ec111a781201c5b720e058342b4ed69613,1,4,4,0,0,0,0,2,2,0,1,1,0,90,0,0,1,1,0,799,799,0,1,1,0,100
763591d28c1c82245aa4360b9dad1949ef16a62d,0,0,0,0,0,0,0,0,0,0,0,0,0,0,43,5,0,0,0,0,0,0,0,0,0,100
689ca49e41764d12df6963f5fd418052f0159900,2,20,27,7,0,0,0,3,3,0,1,2,0.997059057,116,44,6,3,3,0,1056,1056,0,3,3,0,100
6337479d5dff9bef5d249ace16fddaf8346923c4,1,12,10,2,0,0,0,3,4,0,1,1,0,83,45,7,4,1,3,802,799,3,1,1,0,100
a5e0f4ad01703eb4a724e71dfcf99306819c6bf3,1,12,9,3,0,0,0,4,4,18,1,1,0,71,46,8,15,12,3,363,328,35,5,5,0,100
3a7786ed1a3bedf05e6bce7924aea2f75b576912,0,0,0,0,0,0,0,0,0,0,0,0,0,0,0,0,0,0,0,0,0,0,0,0,0,100
bd89d59def7c3b273e122635b9a2ccfa9ada2f7f,9,4650,665,3985,6,0,6,1,23,4,1,4,1.805818985,2556,1,0,1308,573,735,39103,17264,21839,615,296,319,99.3797884
4c0e41cebc0804c563dffe98a58c06b1c39098e1,22,104,121,17,0,0,0,6,59,83,1,13,3.588312035,4271,47,9,642,648,6,32584,32754,170,309,311,2,95.83492549
1c679b12bab24c315a3547efa0aee1fd7838bbba,2,32,23,9,0,0,0,7,62,28,1,1,0.980597441,2066,48,10,597,596,1,13935,13926,9,236,235,1,100
df9ce91231d26655ea1fc11ece5132b389fdf860,2,8,8,0,0,0,0,9,72,30,1,2,0.811278124,1596,49,11,366,366,0,13308,13308,0,131,131,0,100
73506f295a7835334d31c68da35e4beabdeb4443,0,0,0,0,0,0,0,0,0,0,0,0,0,0,50,12,0,0,0,0,0,0,0,0,0,100
b09726d066111d3e884872960f511f97a0215d34,4,122,1,121,1,0,1,4,19,21,1,2,1.015676375,283,51,13,60,52,8,2523,1985,538,29,24,5,99.91941982
22d5483a1fe8a242f3a512cc0bb7131268e23e92,0,0,0,0,0,0,0,0,0,0,0,0,0,0,52,14,0,0,0,0,0,0,0,0,0,100
9839e2a67373a5cfd700182a15f949822ce3df99,0,0,0,0,0,0,0,0,0,0,0,0,0,0,53,15,0,0,0,0,0,0,0,0,0,100
fa1a8ef805111c4bb0d6e5fc59e635cf72d33d14,6,166,136,30,0,0,0,4,63,21,1,3,1.338489189,4224,54,16,974,971,3,34861,34619,242,609,609,0,100
bf8f9edcaa8545c134ad2eab1b2715cb32f44e16,1,1,1,0,0,0,0,9,22,27,1,1,0,234,0,0,55,55,0,1537,1539,2,26,26,0,100
5ca17a271a8f31449cb51fb1f58fb8f9748d9447,1,1,1,0,0,0,0,9,23,0,1,1,0,234,1,1,55,55,0,1543,1537,6,26,26,0,100
996c6382aa0dd9d3bb7955094f9247c77054c6fd,1,1,1,0,0,0,0,10,24,0,1,1,0,234,55,17,55,55,0,1543,1543,0,26,26,0,100
3a0f663db8294ea855d3520e43686c9ead28e5b9,0,0,0,0,0,0,0,0,0,0,0,0,0,0,25,2,0,0,0,0,0,0,0,0,0,100
3c3171eaa13e2aa6265577bff9cabf751bf29c4f,0,0,0,0,0,0,0,0,0,0,0,0,0,0,26,3,0,0,0,0,0,0,0,0,0,100
adcd8a5fcce05fbfcf919d103cf4077a96084ba6,0,0,0,0,0,0,0,0,0,0,0,0,0,0,27,4,0,0,0,0,0,0,0,0,0,100
95534f4ca63293fc51df3a533f07b5a9cae7f473,0,0,0,0,0,0,0,0,0,0,0,0,0,0,28,5,0,0,0,0,0,0,0,0,0,100
c847de572528d64dfa28ad5a3a67deac692c3fe1,0,0,0,0,0,0,0,0,0,0,0,0,0,0,29,6,0,0,0,0,0,0,0,0,0,100
d0354df648e8b0067f87ee162edf322dff60523c,0,0,0,0,0,0,0,0,0,0,0,0,0,0,30,7,0,0,0,0,0,0,0,0,0,100
a02495613d514e984ff486f334890099b1c922e7,0,0,0,0,0,0,0,0,0,0,0,0,0,0,31,8,0,0,0,0,0,0,0,0,0,100
71fb2b29fc3e5f200b3d1ccbd177a95691910986,0,0,0,0,0,0,0,0,0,0,0,0,0,0,32,9,0,0,0,0,0,0,0,0,0,100
350a3f0beb779c783daecf6f1b1de58e53e5f3fa,0,0,0,0,0,0,0,0,0,0,0,0,0,0,56,18,0,0,0,0,0,0,0,0,0,100
ee6386f44a288f20cf2df5933fd29b4ab54f9e55,0,0,0,0,0,0,0,0,0,0,0,0,0,0,19,0,0,0,0,0,0,0,0,0,0,100
c41939351d00f2e1bb87ac8e8b8e1c721150c1ef,0,0,0,0,0,0,0,0,0,0,0,0,0,0,12,1,0,0,0,0,0,0,0,0,0,100
94b3faeccfd7507d63a69027d7d1703a4bd18c9d,3,63,6,57,0,0,0,12,60,51,1,2,1.251518814,1834,2,0,373,368,5,14394,14060,334,157,154,3,100
39d959e1c6a1f339f03dab18289e47f27c10be7f,6,960,570,390,1,0,1,6,24,54,1,4,1.576827249,1798,7,0,442,383,59,14936,13022,1914,115,98,17,99.91954948
ea61af812478af7e6922b83e0818bf06b91c0052,3,102,88,14,0,0,0,11,64,13,1,2,0.66324221,2175,8,1,675,676,1,15811,15644,167,218,220,2,100
d39077d2f02ae0f11ad6c3af851c37567e70270f,1,91,57,34,0,0,0,1,3,0,1,1,0,411,9,2,154,153,1,3469,3258,211,24,23,1,100
b5ef7f8683d23df96b7621ba1db4558424f35767,1,9,2,7,0,0,0,1,4,0,1,1,0,432,10,3,154,154,0,3469,3469,0,24,24,0,100
918d04e517625de96b6931eb47f61abbc26487bf,7,380,335,45,0,0,0,7,65,0,1,4,1.179602616,3511,67,0,896,896,0,25565,25562,3,304,304,0,100
da50f7f205a7c3f8f69096fd27652d69066224e8,18,1487,1145,342,2,0,2,2,63,66,1,8,2.947284413,8879,0,0,2260,2204,56,66228,64668,1560,951,919,32,99.59871589
b8b8ef5a44a7a3f25e943a9438772fc3bbc870bb,7,1059,569,490,1,0,1,7,65,0,1,4,1.591890018,3313,68,1,896,837,59,25565,23270,2295,304,288,16,99.91993595
47c27e907772947d5eae0e2b7b2aa668a931e17b,0,0,0,0,0,0,0,0,0,0,0,0,0,0,20,0,0,0,0,0,0,0,0,0,0,100
307b2619f31ba18292fece706d8e282771f6ff46,0,0,0,0,0,0,0,0,0,0,0,0,0,0,21,1,0,0,0,0,0,0,0,0,0,100
0f89cc8e7347fed1f348a33b00b434a6acb4791d,2,9,16,7,0,0,0,17,66,36,1,1,0.795040279,2003,3,0,580,580,0,13748,13745,3,251,251,0,100
3cd2c2d6f41017d376c9751ed19e95c7e8db5d4d,0,0,0,0,0,0,0,0,0,0,0,0,0,0,22,2,0,0,0,0,0,0,0,0,0,100
5c8894b84578b18796fa9b71aa5beee7e94bae1d,4,23,20,3,0,0,0,10,38,78,1,3,1.466609395,1177,23,3,341,341,0,8468,8453,15,88,88,0,99.59935897
9dea42829f5d9e4ce27264f4ddd513b168862025,0,0,0,0,0,0,0,0,0,0,0,0,0,0,24,4,0,0,0,0,0,0,0,0,0,100
605e1b9ed5f111b702a1061c5abee36ef1a2b774,0,0,0,0,0,0,0,0,0,0,0,0,0,0,25,5,0,0,0,0,0,0,0,0,0,100
3f44b7c22e355e5fde239fd16b5105cf5804b70b,0,0,0,0,0,0,0,0,0,0,0,0,0,0,11,0,0,0,0,0,0,0,0,0,0,100
196777ccc2e698e9dba153d48a08ef4b68b144a1,2,16,1,15,0,0,0,8,67,56,1,2,0.522559375,2275,0,0,544,543,1,17900,17797,103,265,264,1,100
7ba925e86775ddb34a736fafced646837b73d08c,0,0,0,0,0,0,0,0,0,0,0,0,0,0,57,0,0,0,0,0,0,0,0,0,0,100
2a814405a2370480a8644dbb554def7226c9b0d7,0,0,0,0,0,0,0,0,0,0,0,0,0,0,58,1,0,0,0,0,0,0,0,0,0,100
0c6367802773005f563bc2ca0429abf2c420c082,0,0,0,0,0,0,0,0,0,0,0,0,0,0,59,2,0,0,0,0,0,0,0,0,0,100
544e372c63daa720a01b4d558d53fb12aa6016b8,0,0,0,0,0,0,0,0,0,0,0,0,0,0,26,6,0,0,0,0,0,0,0,0,0,100
e250dcc0ae0e3b32ce9d1cad0e9f580dbd241b15,4,40,6,34,1,0,1,11,38,66,1,4,1.241524204,750,1,0,202,201,1,6875,6785,90,111,110,1,99.91980754
4066e612d05dd2e439781863b5256b9454c0a5ab,0,0,0,0,0,0,0,0,0,0,0,0,0,0,0,0,0,0,0,0,0,0,0,0,0,100
580519b20853cce4c7bc68137a25e76a6e9d742b,0,0,0,0,0,0,0,0,0,0,0,0,0,0,27,0,0,0,0,0,0,0,0,0,0,100
d2d26f9ef9f498063484a001d64617e993bce751,0,0,0,0,0,0,0,0,0,0,0,0,0,0,7,0,0,0,0,0,0,0,0,0,0,100
4fe259547614b68b65989fd7c6cd69eb9fa25544,0,0,0,0,0,0,0,0,0,0,0,0,0,0,28,1,0,0,0,0,0,0,0,0,0,100
e607b3164e59be9ab3f0dec641d8824a024429b9,0,0,0,0,0,0,0,0,0,0,0,0,0,0,29,2,0,0,0,0,0,0,0,0,0,100
48e518f5e7ad0e1bd456537e6ae0e640d5a46ef2,0,0,0,0,0,0,0,0,0,0,0,0,0,0,30,3,0,0,0,0,0,0,0,0,0,100
41759e6c92d1d2578db0e878ead822a7f1abef99,0,0,0,0,0,0,0,0,0,0,0,0,0,0,38,0,0,0,0,0,0,0,0,0,0,100
f33e36f70f5f149b38b9056273f584184591c23f,0,0,0,0,0,0,0,0,0,0,0,0,0,0,4,0,0,0,0,0,0,0,0,0,0,100
b990042604b8bf83db3a137de0f54d726c1af9f0,0,0,0,0,0,0,0,0,0,0,0,0,0,0,5,1,0,0,0,0,0,0,0,0,0,100
9cfc27ae51bece7e84dcf01263ce67175d67ad86,0,0,0,0,0,0,0,0,0,0,0,0,0,0,6,2,0,0,0,0,0,0,0,0,0,100
d3011c98d746e211c06a0308f759ef4d8312566c,0,0,0,0,0,0,0,0,0,0,0,0,0,0,7,3,0,0,0,0,0,0,0,0,0,100
d88900ce2eebd2200a9f1a6912719854fba7a102,0,0,0,0,0,0,0,0,0,0,0,0,0,0,31,2,0,0,0,0,0,0,0,0,0,100
e72aae63be4d5ceb2ad05822e85894e868c7b2d6,0,0,0,0,0,0,0,0,0,0,0,0,0,0,8,0,0,0,0,0,0,0,0,0,0,100
a897c50bf28720373b89b10661902a8b9754f7a5,9,118,0,118,0,0,0,5,49,222,1,4,2.721982027,1984,0,0,390,378,12,15318,14600,718,153,147,6,100
57b22212351f6a9d0fc2fe7ca737c7f688e37829,0,0,0,0,0,0,0,0,0,0,0,0,0,0,1,0,0,0,0,0,0,0,0,0,0,100
aa972ced3c001e0d9d8de6cd5013a1cb3b989551,8,33,19,14,0,0,0,8,27,209,1,3,2.881031837,2105,3,0,418,418,0,17641,17514,127,118,118,0,100
f6417e88b9973e932b8bad66fa6894d42c43c663,3,11,6,5,0,0,0,9,28,9,1,2,1.289608558,658,1,0,95,95,0,6751,6701,50,27,27,0,100
d8d73c8ea74268cd6d98d5ea9f83774d371ffed6,4,63,4,59,1,0,1,12,61,157,1,2,1.566277449,1878,1,0,375,373,2,14607,14351,256,159,157,2,99.83993597
4db27025c8d9665370f8e951adc5ba7e5cfe3f17,0,0,0,0,0,0,0,0,0,0,0,0,0,0,2,0,0,0,0,0,0,0,0,0,0,100
81605f7d6467e687c518be5c3097521edcbb9494,0,0,0,0,0,0,0,0,0,0,0,0,0,0,8,0,0,0,0,0,0,0,0,0,0,100
347d209d2b07c46a2f9e2f2545abb2e6f89b8ff5,0,0,0,0,0,0,0,0,0,0,0,0,0,0,1,0,0,0,0,0,0,0,0,0,0,100
89cf20fd44af8ce7b734e7455cd57f4dda7168f9,0,0,0,0,0,0,0,0,0,0,0,0,0,0,32,0,0,0,0,0,0,0,0,0,0,100
fb2d025a3d6d4a786283c770ec955f644d133b9a,0,0,0,0,0,0,0,0,0,0,0,0,0,0,39,0,0,0,0,0,0,0,0,0,0,100
70260919426f89825ca148f5ee815f3b2cf4764d,629,631,631,0,0,0,0,3,73,71,2,92,9.295157051,76406,40,1,11573,11573,0,532877,532877,0,6220,6220,0,100
2d3b1fe7efd865639663ba785877182e7e038c45,10,18,18,0,0,0,0,3,74,0,1,8,3.05881389,4918,41,2,1387,1387,0,33729,33729,0,531,531,0,100
312df981a5511488ba5f6d88a310d7078de6403c,0,0,0,0,0,0,0,0,0,0,0,0,0,0,3,1,0,0,0,0,0,0,0,0,0,100
42ef522cd6ad38487b09ebc9933e4e312c1beece,0,0,0,0,0,0,0,0,0,0,0,0,0,0,2,1,0,0,0,0,0,0,0,0,0,84.06374502
d7621a0ece3f6d326f018a9ccc0e27213af1e222,0,0,0,0,0,0,0,0,0,0,0,0,0,0,3,2,0,0,0,0,0,0,0,0,0,100
8bffed2c95cefb062d1593f7c59eae62da012c52,0,0,0,0,0,0,0,0,0,0,0,0,0,0,4,3,0,0,0,0,0,0,0,0,0,100
d5f46ac8789f86aa29d4da756ac1b6a5d6a66f35,0,0,0,0,0,0,0,0,0,0,0,0,0,0,9,1,0,0,0,0,0,0,0,0,0,84.06374502
371e22468baa045b5eb5f1e05ee716d3996f520e,2,33,9,24,0,0,0,5,9,14,1,2,0.940285959,255,0,0,33,30,3,2631,2495,136,19,18,1,100
7a6d8b60b37f92700d4b80833dcca44653d83339,1,2,0,2,0,0,0,5,10,0,1,1,0,175,1,1,16,16,0,2007,2007,0,13,13,0,100
0b7ac89771461dfd610a56a1463532eeac96c892,3,3,0,3,0,0,0,12,39,186,1,2,1.584962501,996,0,0,276,276,0,9544,9514,30,154,154,0,100
fcffe2f11fd65f3a2e6ec369dadaaf3a6da9bf40,0,0,0,0,0,0,0,0,0,0,0,0,0,0,5,4,0,0,0,0,0,0,0,0,0,100
e644e23998578d4b5e1995482c811b1174758be8,0,0,0,0,0,0,0,0,0,0,0,0,0,0,6,5,0,0,0,0,0,0,0,0,0,100
72dfbf02b62df5d313ebfd9343c22b034214ee49,1,6,3,3,0,0,0,3,4,16,1,1,0,53,42,3,4,4,0,273,260,13,2,2,0,100
413ab671864e399366e2b5e32bf464d1c0994ac0,0,0,0,0,0,0,0,0,0,0,0,0,0,0,9,0,0,0,0,0,0,0,0,0,0,100
1b98ad2d46fb2af0e0416b100ec6a0940192b017,0,0,0,0,0,0,0,0,0,0,0,0,0,0,10,2,0,0,0,0,0,0,0,0,0,100
a604880b5245812d002932031b404b897d2c963a,0,0,0,0,0,0,0,0,0,0,0,0,0,0,11,3,0,0,0,0,0,0,0,0,0,100
96a7fb08e74cb7be1c63ab9c73ce0b25b1abfed1,0,0,0,0,0,0,0,0,0,0,0,0,0,0,7,6,0,0,0,0,0,0,0,0,0,100
4988b9b701a99561f49a0e5147f08d2dbec0ab3d,0,0,0,0,0,0,0,0,0,0,0,0,0,0,10,1,0,0,0,0,0,0,0,0,0,100
c7a9b93246c6cccd4bfd210213141befc170990b,1,5,1,4,0,0,0,8,15,31,1,1,0,80,6,0,13,13,0,450,412,38,10,10,0,100
b6407285171e6c08172b2239b0c989a17f6be628,0,0,0,0,0,0,0,0,0,0,0,0,0,0,8,6,0,0,0,0,0,0,0,0,0,100
4317e4a2610555fe205e892ba0494f8bc6dcb2b4,0,0,0,0,0,0,0,0,0,0,0,0,0,0,9,7,0,0,0,0,0,0,0,0,0,100
223f953d5218cd3aab9b82a526d8177f27a50861,1,4,1,3,0,0,0,5,10,40,1,1,0,61,10,8,6,6,0,347,330,17,4,4,0,100
a49c3427694636280b5c09560863b031cd672d40,0,0,0,0,0,0,0,0,0,0,0,0,0,0,11,9,0,0,0,0,0,0,0,0,0,100
9beb79def587e4ee7056a91cc3e21d6392b0ff94,0,0,0,0,0,0,0,0,0,0,0,0,0,0,12,10,0,0,0,0,0,0,0,0,0,100
95f6c12d3ec57ccc79d6a3ff4977947138b679a7,0,0,0,0,0,0,0,0,0,0,0,0,0,0,13,9,0,0,0,0,0,0,0,0,0,100
a15090758a09ef55196c1dd77cda0124e8278a1b,0,0,0,0,0,0,0,0,0,0,0,0,0,0,14,9,0,0,0,0,0,0,0,0,0,100
a2098bd88361b5ff9298c462a2dccafbb0c2c508,4,236,1,235,0,0,0,7,15,52,1,4,1.920237867,1210,0,0,217,188,29,10900,9354,1546,138,115,23,99.96003197
5f3e59bf4bd2a89a1c676526f22036515c397b94,0,0,0,0,0,0,0,0,0,0,0,0,0,0,15,8,0,0,0,0,0,0,0,0,0,100
fbfb135dd50fc39835c5323057561144eff2bc41,0,0,0,0,0,0,0,0,0,0,0,0,0,0,16,8,0,0,0,0,0,0,0,0,0,100
fcb4764468cd1d70b3341c1488a394bb8f20929b,0,0,0,0,0,0,0,0,0,0,0,0,0,0,17,9,0,0,0,0,0,0,0,0,0,100
85fe67126ac9c732d8cdc58ec3c2ef23288c27d6,0,0,0,0,0,0,0,0,0,0,0,0,0,0,12,0,0,0,0,0,0,0,0,0,0,100
e19fe14a3a945539a66b672c74740ede19af6b6e,2,45,1,44,0,0,0,8,70,84,1,2,1,1665,0,0,478,475,3,11609,11370,239,213,210,3,100
e8e2fccd931df600ebed566a6c6b39b2b7f3907b,1,1,1,0,0,0,0,5,10,94,1,1,0,105,0,0,27,27,0,608,608,0,17,17,0,100
ee4c2aaf4a5a0e1108dc01b157150d4629dd7881,0,0,0,0,0,0,0,0,0,0,0,0,0,0,18,3,0,0,0,0,0,0,0,0,0,100
efe1181bc76adc89a69f0763ad469386db84ed67,0,0,0,0,0,0,0,0,0,0,0,0,0,0,13,1,0,0,0,0,0,0,0,0,0,100
e0ae0cd8a36520907304d52f4a19668a3218d5ea,0,0,0,0,0,0,0,0,0,0,0,0,0,0,19,4,0,0,0,0,0,0,0,0,0,100
ad9614acebcf686a67f052ba80ca8eb872402066,2,58,2,56,1,0,1,1,17,49,1,2,0.468995594,170,20,5,38,35,3,1570,1292,278,20,18,2,100
efc8f7d83c598fd61600d194ebb0aab7e5274ad4,0,0,0,0,0,0,0,0,0,0,0,0,0,0,21,6,0,0,0,0,0,0,0,0,0,100
10d61843003a16b738f65dd9d4580ede284f09d8,0,0,0,0,0,0,0,0,0,0,0,0,0,0,11,0,0,0,0,0,0,0,0,0,0,100
49ee803d6d5fd702a5370728b6e3e010b3ee8a29,1,1,1,0,0,0,0,20,71,21,1,1,0,1526,2,0,456,456,0,10326,10326,0,192,192,0,100
f18d76af62d981bee21778af8872c736418f626e,0,0,0,0,0,0,0,0,0,0,0,0,0,0,60,0,0,0,0,0,0,0,0,0,0,100
1c5d3ff4ff78551edd4bab9824642d6918d3565d,1,10,1,9,0,0,0,20,72,14,1,1,0,1526,33,0,456,456,0,10328,10326,2,192,192,0,100
7293dd0be192d8e5230f5a1c597c2c7577f91efd,0,0,0,0,0,0,0,0,0,0,0,0,0,0,0,0,0,0,0,0,0,0,0,0,0,100
41bc0ef4f2ccd65005d6ffd9ccdc141f3ac16d7d,0,0,0,0,0,0,0,0,0,0,0,0,0,0,61,1,0,0,0,0,0,0,0,0,0,100
9125e9acff342accbb404270c09fef4ccff151d6,0,0,0,0,0,0,0,0,0,0,0,0,0,0,22,4,0,0,0,0,0,0,0,0,0,100
1d60c81c82f161f381c35bd5045e9a69b6d3c2ac,3,4,4,0,0,0,0,5,10,135,1,3,1.5,263,0,0,52,52,0,1861,1861,0,32,32,0,100
3cfebb821f6a34f8600bdef102355e5b8ac2160e,0,0,0,0,0,0,0,0,0,0,0,0,0,0,12,1,0,0,0,0,0,0,0,0,0,100
c0094b5bb1abb79304ce42a56cc115186370d407,0,0,0,0,0,0,0,0,0,0,0,0,0,0,13,2,0,0,0,0,0,0,0,0,0,100
61f36e7df8daa9a49a89c0b35bcd9395360adae6,0,0,0,0,0,0,0,0,0,0,0,0,0,0,62,2,0,0,0,0,0,0,0,0,0,100
4593c3651516a6ff5c30e43198285d6435e2ff49,0,0,0,0,0,0,0,0,0,0,0,0,0,0,0,0,0,0,0,0,0,0,0,0,0,100
1b96b5bdf7d361bd25e1c2ef1697f0bc1d4a6e9d,0,0,0,0,0,0,0,0,0,0,0,0,0,0,1,1,0,0,0,0,0,0,0,0,0,100
122e3bb06e8a022ac9e755cb3ccc1b1924ac567f,0,0,0,0,0,0,0,0,0,0,0,0,0,0,1,1,0,0,0,0,0,0,0,0,0,100
4d324431edf34fc24373829a0d0af95235e6acc3,0,0,0,0,0,0,0,0,0,0,0,0,0,0,0,0,0,0,0,0,0,0,0,0,0,100
26f59018800bd88dd58fb84cdaf04860e1b47a54,0,0,0,0,0,0,0,0,0,0,0,0,0,0,23,1,0,0,0,0,0,0,0,0,0,100
574d5ea5dea62afc58f195ddf7c0b8b4390270d3,0,0,0,0,0,0,0,0,0,0,0,0,0,0,0,0,0,0,0,0,0,0,0,0,0,100
080152eeb732a888dc6edd8e03073addeae7c2b0,1,11,1,10,0,0,0,9,17,171,1,1,0,236,0,0,49,46,3,1554,1520,34,29,27,2,100
1267c4c8ce898143d58b18469aa9ea11726fcdd4,1,108,46,62,0,0,0,9,14,171,1,1,0,227,1,1,26,22,4,2173,1715,458,25,21,4,100
a2eae61d7fda7156176cae6ef9acd2e6f8a8e335,1,2,3,1,0,0,0,9,15,0,1,1,0,276,2,2,26,26,0,2167,2173,6,25,25,0,100
67545b9b569a7d02e181ba7ab441d184b3aeacf8,1,31,31,0,0,0,0,9,16,0,1,1,0,275,3,3,26,26,0,2167,2167,0,25,25,0,100
9b0c88cc6e9a4405d5731ddeda3ed831206e486c,0,0,0,0,0,0,0,0,0,0,0,0,0,0,24,2,0,0,0,0,0,0,0,0,0,100
93a3ca4f6a3ace56a2e32d4249d05dad6f220f1f,0,0,0,0,0,0,0,0,0,0,0,0,0,0,14,2,0,0,0,0,0,0,0,0,0,100
d4c16599b3fbcb7671bf4255bf9419b1d6c4c281,0,0,0,0,0,0,0,0,0,0,0,0,0,0,2,1,0,0,0,0,0,0,0,0,0,100
4de6d838be56662b658e220deb2f1475685f768c,0,0,0,0,0,0,0,0,0,0,0,0,0,0,25,2,0,0,0,0,0,0,0,0,0,100
e305f0625be79753dd34d20a5bfbecf9f01e5b41,6,43,9,34,0,0,0,7,18,163,1,2,2.119287613,802,26,3,111,107,4,6107,5862,245,66,62,4,100
02dbe25e35d5ffc644f049cf602f88c1b137ea29,0,0,0,0,0,0,0,0,0,0,0,0,0,0,27,4,0,0,0,0,0,0,0,0,0,100
f17c77f20b74862b41bbc308619294d35871c518,0,0,0,0,0,0,0,0,0,0,0,0,0,0,28,5,0,0,0,0,0,0,0,0,0,100
058cfefadeaa642d1ce17727ded149b3a01b6de5,1,1,1,0,0,0,0,9,16,182,1,1,0,559,33,0,145,145,0,3759,3763,4,46,46,0,100
d1eac15926e73d1bdc91867881b13b93d7fdf3e0,0,0,0,0,0,0,0,0,0,0,0,0,0,0,34,1,0,0,0,0,0,0,0,0,0,100
eda435931b8dbd913b98567814494ddfe4bea016,1,1,2,1,0,0,0,9,17,0,1,1,0,559,35,2,145,145,0,3759,3759,0,46,46,0,100
bce00d9c4a44f66c6906e66cde21938935c00fc5,1,2,2,0,0,0,0,9,26,188,1,1,0,340,0,0,98,98,0,2397,2397,0,24,24,0,100
98c7c6cd898a156b5fe0cef93761f0e756ab94db,0,0,0,0,0,0,0,0,0,0,0,0,0,0,0,0,0,0,0,0,0,0,0,0,0,100
1be286e774761ab67dd97f2ad96fc9d7b3d7b738,0,0,0,0,0,0,0,0,0,0,0,0,0,0,34,0,0,0,0,0,0,0,0,0,0,100
7a9f4aee4ffd97f9faffc9b417377a050f240a8f,40,92,92,0,0,0,0,1,1,0,1,6,5.248308559,3988,35,1,430,440,10,27934,28880,946,258,280,22,90.76976663
94923cf2fb64ed56705ae6310d948a28a506a2f4,0,0,0,0,0,0,0,0,0,0,0,0,0,0,36,3,0,0,0,0,0,0,0,0,0,100
a8a7b74035835cda72e4764813ad999b53232efd,0,0,0,0,0,0,0,0,0,0,0,0,0,0,37,4,0,0,0,0,0,0,0,0,0,100
3018fc1448c1c16627932768c77b7a00e724f4a5,0,0,0,0,0,0,0,0,0,0,0,0,0,0,29,6,0,0,0,0,0,0,0,0,0,100
bd559d63d5d86eeff7b317d8188cdd7038c9f3fe,0,0,0,0,0,0,0,0,0,0,0,0,0,0,36,2,0,0,0,0,0,0,0,0,0,100
5772eaf972b43a3a682bbc7bb1100836cd83bf01,0,0,0,0,0,0,0,0,0,0,0,0,0,0,38,5,0,0,0,0,0,0,0,0,0,100
1adddb25be168f39798d0ff5ea173eeabff86260,0,0,0,0,0,0,0,0,0,0,0,0,0,0,39,6,0,0,0,0,0,0,0,0,0,100
68240987e78004365c379ff05ba2d6fb8b31d8e5,0,0,0,0,0,0,0,0,0,0,0,0,0,0,40,7,0,0,0,0,0,0,0,0,0,100
ce36fc1c318810356fcceb7a27653cdc5629b147,0,0,0,0,0,0,0,0,0,0,0,0,0,0,41,8,0,0,0,0,0,0,0,0,0,100
13bc181e23871af9676c3553f0da90e7fcb7b0b1,0,0,0,0,0,0,0,0,0,0,0,0,0,0,42,9,0,0,0,0,0,0,0,0,0,100
92e3f49ba15c7437fb99b1f21f55d2457a759cb2,0,0,0,0,0,0,0,0,0,0,0,0,0,0,30,7,0,0,0,0,0,0,0,0,0,100
516af0958885b9da721b0ed6f626c20649df98f1,0,0,0,0,0,0,0,0,0,0,0,0,0,0,31,8,0,0,0,0,0,0,0,0,0,100
fd80ae5939270a4af993465ca625f50f46a791b6,0,0,0,0,0,0,0,0,0,0,0,0,0,0,32,9,0,0,0,0,0,0,0,0,0,100
811ce84d28e1a7e855452d368a08781dc0105d4f,0,0,0,0,0,0,0,0,0,0,0,0,0,0,33,10,0,0,0,0,0,0,0,0,0,100
c493a4ed56e02df0bcce800eec10b3aab7a359ff,0,0,0,0,0,0,0,0,0,0,0,0,0,0,43,10,0,0,0,0,0,0,0,0,0,100
ad1569240af6ba7c380fb7ac8eee65c72b9c02b5,0,0,0,0,0,0,0,0,0,0,0,0,0,0,44,11,0,0,0,0,0,0,0,0,0,100
9cd2f49fc4c3bf2018723bab012241782deaf9e5,2,4,4,0,0,0,0,4,6,218,1,1,1,208,45,12,23,23,0,1292,1288,4,11,11,0,100
d7f03892f6508ea476306bf09d4fd2169f4531f2,0,0,0,0,0,0,0,0,0,0,0,0,0,0,46,13,0,0,0,0,0,0,0,0,0,100
a1d9b1a64c5c5ca273e5f6dfcf6015a7d1e0cc8f,0,0,0,0,0,0,0,0,0,0,0,0,0,0,15,0,0,0,0,0,0,0,0,0,0,100
21698b9baa331e0f2506acb4c1b5408c1b84f071,0,0,0,0,0,0,0,0,0,0,0,0,0,0,16,1,0,0,0,0,0,0,0,0,0,100
770acd5a5f2de734eb7a6e51ae18ed254b2828f8,0,0,0,0,0,0,0,0,0,0,0,0,0,0,17,2,0,0,0,0,0,0,0,0,0,100
61e56249baa8aeb63ac4ce990ac595189e7282b4,0,0,0,0,0,0,0,0,0,0,0,0,0,0,18,3,0,0,0,0,0,0,0,0,0,100
5d3ad3e179c31a444b51bc2f6556448eb5ad3408,0,0,0,0,0,0,0,0,0,0,0,0,0,0,19,4,0,0,0,0,0,0,0,0,0,100
539d746274a01011cffe6a863d7373d3a38d4c78,0,0,0,0,0,0,0,0,0,0,0,0,0,0,20,5,0,0,0,0,0,0,0,0,0,100
33418a3955cac1c00b6c2ee31b3fc4929a54d996,0,0,0,0,0,0,0,0,0,0,0,0,0,0,21,6,0,0,0,0,0,0,0,0,0,100
ded1087822b590ac5106cf58bef51c8476653743,0,0,0,0,0,0,0,0,0,0,0,0,0,0,22,7,0,0,0,0,0,0,0,0,0,100
e6479eae59aa9d83d6effc7284e5a3821c5e8c14,0,0,0,0,0,0,0,0,0,0,0,0,0,0,23,8,0,0,0,0,0,0,0,0,0,100
0e1073e98b4323fd85af1826a72ca12d5eabc1d2,0,0,0,0,0,0,0,0,0,0,0,0,0,0,24,9,0,0,0,0,0,0,0,0,0,100
5b7fcf6d9a628e768410a369fd7773b46378052c,0,0,0,0,0,0,0,0,0,0,0,0,0,0,25,10,0,0,0,0,0,0,0,0,0,100
2e93877491ef385455183cf9a430b54227945858,0,0,0,0,0,0,0,0,0,0,0,0,0,0,26,11,0,0,0,0,0,0,0,0,0,100
eef00d72cc172896980e515bee1a84fa3a29aa3a,0,0,0,0,0,0,0,0,0,0,0,0,0,0,27,12,0,0,0,0,0,0,0,0,0,100
2641b45e2d61d718fd3301cf380ea829f2c0ae6a,0,0,0,0,0,0,0,0,0,0,0,0,0,0,28,13,0,0,0,0,0,0,0,0,0,100
2014d7d6f86ad0a48f801ef152dbc88ef208f620,0,0,0,0,0,0,0,0,0,0,0,0,0,0,29,14,0,0,0,0,0,0,0,0,0,100
85016374897e776c54d7e8cfe022f60b1d4e9550,0,0,0,0,0,0,0,0,0,0,0,0,0,0,30,15,0,0,0,0,0,0,0,0,0,100
2dd342921cc7264a54cd66c00528381a167230f9,0,0,0,0,0,0,0,0,0,0,0,0,0,0,31,16,0,0,0,0,0,0,0,0,0,100
658b697a24685f7710c8596a68a86fe6a3f92725,0,0,0,0,0,0,0,0,0,0,0,0,0,0,34,5,0,0,0,0,0,0,0,0,0,100
f310ac8db5ab962a49d448f41b7b953488cdb033,21,476,2120,1644,0,0,0,9,52,276,1,8,3.065651769,4269,47,0,579,774,195,23578,33003,9425,267,401,134,95.00335345
e0171ea39c24624297159fb3bbe4a2ade0d18f73,0,0,0,0,0,0,0,0,0,0,0,0,0,0,0,0,0,0,0,0,0,0,0,0,0,100
1bd62dde0e065a1527553e3abf36b305b7e4004c,1,1,1,0,0,0,0,6,18,280,1,1,0,95,1,1,16,16,0,704,702,2,8,8,0,100
89b5acfbfcf9a9f0d2e9e91accf8ab880486e795,0,0,0,0,0,0,0,0,0,0,0,0,0,0,63,0,0,0,0,0,0,0,0,0,0,100
0fe596a123d03e3a2ada9d34a79685bc9d4be9de,0,0,0,0,0,0,0,0,0,0,0,0,0,0,0,0,0,0,0,0,0,0,0,0,0,100
ea1ee734ab12f8b931683cd9511b127257d41954,0,0,0,0,0,0,0,0,0,0,0,0,0,0,35,0,0,0,0,0,0,0,0,0,0,100
410b00ab4af7131f7409d7cd1c2bcc845e103732,1,1,1,0,0,0,0,4,6,302,1,1,0,56,2,2,2,2,0,361,361,0,1,1,0,100
062ecbedd7ee9f29a5dae374eeba419f8ab23c0d,0,0,0,0,0,0,0,0,0,0,0,0,0,0,3,3,0,0,0,0,0,0,0,0,0,100
c7c2c932e7a177f8d3fe163777351fe2de4a9842,0,0,0,0,0,0,0,0,0,0,0,0,0,0,36,1,0,0,0,0,0,0,0,0,0,100
563c246628612287364a2e6596826831fab006e3,0,0,0,0,0,0,0,0,0,0,0,0,0,0,48,0,0,0,0,0,0,0,0,0,0,100
85ce0227e427e5f7b5c84cfe59293e1b649b925a,0,0,0,0,0,0,0,0,0,0,0,0,0,0,32,0,0,0,0,0,0,0,0,0,0,100
bfbd2d115aec576545b0673e876a652806b41986,0,0,0,0,0,0,0,0,0,0,0,0,0,0,33,1,0,0,0,0,0,0,0,0,0,100
4cd5b8d804279eb670cbfdf0a0b08311e92d29a7,0,0,0,0,0,0,0,0,0,0,0,0,0,0,49,1,0,0,0,0,0,0,0,0,0,100
d99e2c2460ff305e92a9b103a9db441a0150ae81,0,0,0,0,0,0,0,0,0,0,0,0,0,0,50,2,0,0,0,0,0,0,0,0,0,100
6a5ef2beabe52fb8612c807f424fc6cc64dacd2b,0,0,0,0,0,0,0,0,0,0,0,0,0,0,51,3,0,0,0,0,0,0,0,0,0,100
21a30042cf6b8704d440497088ede85afa17aee0,0,0,0,0,0,0,0,0,0,0,0,0,0,0,52,4,0,0,0,0,0,0,0,0,0,100
2b75804d73fa3a8d4d25be2f79aa772f5965bbcd,1,3,3,0,0,0,0,13,21,333,1,1,0,1218,0,0,306,306,0,9059,9059,0,282,282,0,100
097ff2d69b52cddb249ea27c89bea7059f6a79df,0,0,0,0,0,0,0,0,0,0,0,0,0,0,14,0,0,0,0,0,0,0,0,0,0,100
2cd197acd8295f949f429613b82b66d042c43342,4,9,9,0,0,0,0,13,25,270,1,4,1.446616668,1169,4,2,123,123,0,11784,11776,8,72,72,0,100
2b579ee0df983c3fa28014f3a16e7a1ea18aa8cf,0,0,0,0,0,0,0,0,0,0,0,0,0,0,53,4,0,0,0,0,0,0,0,0,0,100
8d31e91f42390eb1cdc115c4a8e6cd7e70347805,0,0,0,0,0,0,0,0,0,0,0,0,0,0,15,1,0,0,0,0,0,0,0,0,0,100
f13f026d92789ad442bff7e0a2f2fcb85a707364,6,13,13,0,0,0,0,12,24,469,2,6,2.141619525,2443,3,0,431,431,0,21196,21204,8,355,355,0,100
6dde7e02c00568d723d13a8abb3ccacc4e509800,6,13,13,0,0,0,0,13,25,285,2,6,2.141619525,2443,16,2,431,431,0,21204,21196,8,355,355,0,100
0f9b051ce95c88f53cb3dd91d86479100ba6f698,0,0,0,0,0,0,0,0,0,0,0,0,0,0,17,3,0,0,0,0,0,0,0,0,0,100
edbf413e56c7f04b4a6291f94c2193ff2620a735,0,0,0,0,0,0,0,0,0,0,0,0,0,0,18,4,0,0,0,0,0,0,0,0,0,100
d5cc3ddf3068c32e3b6048d2312f5833478842cb,0,0,0,0,0,0,0,0,0,0,0,0,0,0,37,0,0,0,0,0,0,0,0,0,0,100
a36cdb36b06541bcbb02345039390291d09e2080,0,0,0,0,0,0,0,0,0,0,0,0,0,0,0,0,0,0,0,0,0,0,0,0,0,100
360f31b298ed5f6ad3c88aa25b7fb444cb0f144a,0,0,0,0,0,0,0,0,0,0,0,0,0,0,19,4,0,0,0,0,0,0,0,0,0,100
e3219382f3fbc9c20bc851f56d4e56a0f73c7c52,0,0,0,0,0,0,0,0,0,0,0,0,0,0,20,5,0,0,0,0,0,0,0,0,0,100
1f638fbad382881c5a7f0be7a29e29330e87e71f,0,0,0,0,0,0,0,0,0,0,0,0,0,0,21,6,0,0,0,0,0,0,0,0,0,100
5cf2361bbe0369e7efcfee4b8874e71c50641a0f,0,0,0,0,0,0,0,0,0,0,0,0,0,0,22,7,0,0,0,0,0,0,0,0,0,100
3e79dfec8461fb0157f068cff7ba24be8cdfa9d8,0,0,0,0,0,0,0,0,0,0,0,0,0,0,23,8,0,0,0,0,0,0,0,0,0,100
a684f3e0b1859ba05c17b18407c2e9905701079a,0,0,0,0,0,0,0,0,0,0,0,0,0,0,38,1,0,0,0,0,0,0,0,0,0,100
5bb2cb8c5818faeda134ccdce4f0b5560f316edd,0,0,0,0,0,0,0,0,0,0,0,0,0,0,5,0,0,0,0,0,0,0,0,0,0,100
eff234d910949d8052300eac7456ad50a0c294c5,0,0,0,0,0,0,0,0,0,0,0,0,0,0,69,0,0,0,0,0,0,0,0,0,0,100
ce91b2e67031bd0c0c6fd899ab76fc28d8d5dda4,0,0,0,0,0,0,0,0,0,0,0,0,0,0,24,9,0,0,0,0,0,0,0,0,0,100
7d87cde06253913e9ef23c671e9ce092bc35dfe3,0,0,0,0,0,0,0,0,0,0,0,0,0,0,25,10,0,0,0,0,0,0,0,0,0,100
cfc80417bb61e31c5e4ae66669b3cef27a873a13,0,0,0,0,0,0,0,0,0,0,0,0,0,0,26,11,0,0,0,0,0,0,0,0,0,100
f0aad4230f5d2e6d6565c86701f3d21e59990f28,0,0,0,0,0,0,0,0,0,0,0,0,0,0,27,12,0,0,0,0,0,0,0,0,0,100
eb3f51e7b5c9f87ed5fa9a6a10dd88cd5ec62faf,0,0,0,0,0,0,0,0,0,0,0,0,0,0,28,13,0,0,0,0,0,0,0,0,0,100
77fa25b5a65805f3067c065b9ff46eaf2c2f0897,0,0,0,0,0,0,0,0,0,0,0,0,0,0,29,13,0,0,0,0,0,0,0,0,0,100
62f3c26e2c303df0a208590041bcf20590fce62d,0,0,0,0,0,0,0,0,0,0,0,0,0,0,30,14,0,0,0,0,0,0,0,0,0,100
044572a8550a87cd04c5ce31bd9f737a0e8cd3c3,1,6,6,0,0,0,0,20,53,145,1,1,0,854,0,0,253,253,0,5664,5664,0,81,81,0,100
abe9ce706646b6bf43fa98cedccd3dd5ca6c6ab7,0,0,0,0,0,0,0,0,0,0,0,0,0,0,1,0,0,0,0,0,0,0,0,0,0,100
62bdc83e46fbd65d34a1715c1bcc53fa5d1919fa,0,0,0,0,0,0,0,0,0,0,0,0,0,0,34,0,0,0,0,0,0,0,0,0,0,100
bf47ec97e0b7f5701042fac067b73b421a9177b7,0,0,0,0,0,0,0,0,0,0,0,0,0,0,2,1,0,0,0,0,0,0,0,0,0,100
96cfef55661fe2f29b89aa8b6813f94d06a62500,1,1,4,3,0,0,0,9,16,365,1,1,0,328,0,0,78,78,0,1737,1742,5,39,39,0,100
f0c6fe85ce3121c12b616d610f59aa6c6fdda169,1,11,1,10,0,0,0,6,8,419,1,1,0,207,1,1,21,21,0,1804,1741,63,19,19,0,100
df663c511b640f912b673f55c0c8b679996b6c79,2,5,12,7,0,0,0,5,15,155,1,2,0.873981048,540,31,9,99,99,0,3483,3541,58,58,58,0,100
bb304e9047c905d2da207ace2719c743ec26e10f,1,1,1,0,0,0,0,6,11,425,1,1,0,128,32,9,10,10,0,988,988,0,3,3,0,100
6b02824fa4e7f3d019873ac04c1669765ad0aa08,0,0,0,0,0,0,0,0,0,0,0,0,0,0,70,1,0,0,0,0,0,0,0,0,0,100
eab8e019d6452c5cf54c1278db51861ca9bf6aac,2,12,5,7,0,0,0,6,16,391,1,2,0.873981048,535,71,2,99,99,0,3541,3483,58,58,58,0,100
eaf11a8f0ce04b61b4f58cc071a29f82e4f23e5a,0,0,0,0,0,0,0,0,0,0,0,0,0,0,33,2,0,0,0,0,0,0,0,0,0,100
af8f9c7dea4dd28f9c51dc43b1efaaa41dca9c4f,0,0,0,0,0,0,0,0,0,0,0,0,0,0,34,3,0,0,0,0,0,0,0,0,0,100
3953878891efdc2a222e57382c3cfeab0a70079c,0,0,0,0,0,0,0,0,0,0,0,0,0,0,35,4,0,0,0,0,0,0,0,0,0,100
bda7d995ff7cb3079285c169b23064309ecda8b1,0,0,0,0,0,0,0,0,0,0,0,0,0,0,35,1,0,0,0,0,0,0,0,0,0,100
3c10c361a788add7d7f27fb6102148d6106f2544,0,0,0,0,0,0,0,0,0,0,0,0,0,0,0,0,0,0,0,0,0,0,0,0,0,100
76d918ab980590acb2cacc7504b86861bc26102a,1,1,1,0,0,0,0,5,6,453,1,1,0,53,36,5,9,9,0,289,289,0,3,3,0,100
1d55d10ed9200084d2603f2a6b136aede1f530b2,0,0,0,0,0,0,0,0,0,0,0,0,0,0,3,1,0,0,0,0,0,0,0,0,0,100
4254e280271e6b53495d866cf4262af4f1f2a288,0,0,0,0,0,0,0,0,0,0,0,0,0,0,37,6,0,0,0,0,0,0,0,0,0,100
f8afef1f98b1f27deb9e73ef804ed74ba2d20bbb,0,0,0,0,0,0,0,0,0,0,0,0,0,0,38,7,0,0,0,0,0,0,0,0,0,100
68796d30d8898cf1cd9e806623602da519cd4058,10,43,48,5,0,0,0,4,23,368,1,4,3.154903396,3442,0,0,752,767,15,22320,22362,42,507,508,1,100
bd8da9731f407d61f070748437789b2645c89912,5,12,13,1,0,0,0,6,54,286,1,4,2.262824692,3149,1,1,813,813,0,22803,22821,18,532,532,0,100
29db1adf5b9052d6d57a5c9f9e855a44e7c8d84b,0,0,0,0,0,0,0,0,0,0,0,0,0,0,39,6,0,0,0,0,0,0,0,0,0,100
ea084ff5e9dd0cc7d3d4c9c7c0e01fa4275a02db,0,0,0,0,0,0,0,0,0,0,0,0,0,0,2,0,0,0,0,0,0,0,0,0,0,100
790faee01824abe9623dcdcb38af0788df595727,0,0,0,0,0,0,0,0,0,0,0,0,0,0,40,7,0,0,0,0,0,0,0,0,0,100
d28bf07d2da8dbddb561630ca69c0cee2d3f5b52,0,0,0,0,0,0,0,0,0,0,0,0,0,0,41,8,0,0,0,0,0,0,0,0,0,100
1238bdfad85e63becc53e21bb6dca506456264d2,2,52,1,51,1,0,1,1,55,13,1,2,0.563102824,855,3,0,256,253,3,5861,5670,191,82,81,1,89.35946797
e3e41dcd27822ac3fd4692291d1bbea4f8a294dc,0,0,0,0,0,0,0,0,0,0,0,0,0,0,42,6,0,0,0,0,0,0,0,0,0,100
c4f3bb67dd8c6e28fce2f84cbaf0cb353ec2b2aa,0,0,0,0,0,0,0,0,0,0,0,0,0,0,37,0,0,0,0,0,0,0,0,0,0,100
2b8d7308489b4e9b4669fdedead59eb1b6544ec8,0,0,0,0,0,0,0,0,0,0,0,0,0,0,4,0,0,0,0,0,0,0,0,0,0,100
9ab19ee49678e930beeb05d2f1c7fedbd663223d,0,0,0,0,0,0,0,0,0,0,0,0,0,0,43,3,0,0,0,0,0,0,0,0,0,100
0ff34ca6771ab7d9ff34844bc4e312df103450fb,0,0,0,0,0,0,0,0,0,0,0,0,0,0,5,1,0,0,0,0,0,0,0,0,0,100
b9679a8986638304ffde1c99d203bb34754bc1ad,3,19,11,8,0,0,0,7,16,537,1,2,1.255536725,349,4,0,47,47,0,2647,2593,54,11,11,0,100
9b39a985bcd6cd34f0820f3680f145d46c0e56bd,0,0,0,0,0,0,0,0,0,0,0,0,0,0,0,0,0,0,0,0,0,0,0,0,0,100
a4a0bccfaebcecce429acc78e7aab0b68cccaa45,1,21,1,20,0,0,0,10,15,276,1,1,0,146,0,0,23,22,1,1039,973,66,8,7,1,100
f15b7de647cddc5836575818d81a73a46a8b85fd,0,0,0,0,0,0,0,0,0,0,0,0,0,0,39,0,0,0,0,0,0,0,0,0,0,100
bd9e6c4514db274ca97dbf78975a3f9156a523b6,0,0,0,0,0,0,0,0,0,0,0,0,0,0,44,1,0,0,0,0,0,0,0,0,0,100
3d54a9e4385358082ba5111f4a546a660f9d6c21,0,0,0,0,0,0,0,0,0,0,0,0,0,0,40,1,0,0,0,0,0,0,0,0,0,100
5cca39d955e831be4ca4bfcc016a7da37e158aeb,0,0,0,0,0,0,0,0,0,0,0,0,0,0,45,2,0,0,0,0,0,0,0,0,0,100
cd91695168f9edaac8c1f0140f4a023258f265d4,0,0,0,0,0,0,0,0,0,0,0,0,0,0,46,3,0,0,0,0,0,0,0,0,0,100
ff5c4d6db9af3edd915a2176a627d51eb3478da3,2,4,7,3,0,0,0,7,17,334,1,2,0.845350937,253,0,0,54,54,0,1390,1432,42,30,30,0,100
e8f6b003aff981e6b96d069153b8cd79cc1b9ec2,0,0,0,0,0,0,0,0,0,0,0,0,0,0,54,0,0,0,0,0,0,0,0,0,0,100
d6cf7c46c20973f4e2e4ef41c064a40fb616994d,0,0,0,0,0,0,0,0,0,0,0,0,0,0,1,0,0,0,0,0,0,0,0,0,0,100
4cd778a7e0de048eacf2a06abe3d0e310bbcc343,0,0,0,0,0,0,0,0,0,0,0,0,0,0,47,1,0,0,0,0,0,0,0,0,0,100
9c54c3db7374b833b2fde97e3ee4ee57e9d90447,0,0,0,0,0,0,0,0,0,0,0,0,0,0,41,0,0,0,0,0,0,0,0,0,0,100
912c15b36caacdea5cf3a6753316022156681470,0,0,0,0,0,0,0,0,0,0,0,0,0,0,0,0,0,0,0,0,0,0,0,0,0,100
5df740679737fdfb591213dff5bf1217a299c4c3,0,0,0,0,0,0,0,0,0,0,0,0,0,0,55,0,0,0,0,0,0,0,0,0,0,100
b0f0131647b8f8277b3648cb95c10ef4810e5c26,0,0,0,0,0,0,0,0,0,0,0,0,0,0,56,1,0,0,0,0,0,0,0,0,0,100
760112a748a608f555c20fcaec0edaa404beaf91,0,0,0,0,0,0,0,0,0,0,0,0,0,0,57,2,0,0,0,0,0,0,0,0,0,100
8efc875f16b079e8c26d1b1bbedf433099aaa4eb,0,0,0,0,0,0,0,0,0,0,0,0,0,0,58,3,0,0,0,0,0,0,0,0,0,100
2fba6f606b08140d0ef75b610c028f1b7872e06a,14,329,209,120,0,0,0,6,75,569,1,10,2.735844749,5321,59,4,1407,1404,3,39504,38995,509,423,422,1,100
e8f54211db381ad3b54b59bdb2fe71adb4d53cd5,0,0,0,0,0,0,0,0,0,0,0,0,0,0,48,1,0,0,0,0,0,0,0,0,0,100
bcaa54576074a1f786f7ce88710502dd03ddc656,0,0,0,0,0,0,0,0,0,0,0,0,0,0,6,0,0,0,0,0,0,0,0,0,0,100
fe383d8eba8078a706620c8848efe7949efb8017,0,0,0,0,0,0,0,0,0,0,0,0,0,0,38,0,0,0,0,0,0,0,0,0,0,100
ac82a6ef35b7ca76c557d46471becc818846c35a,0,0,0,0,0,0,0,0,0,0,0,0,0,0,42,1,0,0,0,0,0,0,0,0,0,100
f621d9370005c0dee32295d4c1ad45a2b7c54f1c,0,0,0,0,0,0,0,0,0,0,0,0,0,0,60,5,0,0,0,0,0,0,0,0,0,100
ced4d7f9f3802216db81fb015b450bc7ad507d66,0,0,0,0,0,0,0,0,0,0,0,0,0,0,61,6,0,0,0,0,0,0,0,0,0,100
84b056c2adc069cf31f3b4d3c9337cb7cdaa58d6,0,0,0,0,0,0,0,0,0,0,0,0,0,0,62,7,0,0,0,0,0,0,0,0,0,100
dd9ea675124713c7abff343d34e2812f01d6a718,0,0,0,0,0,0,0,0,0,0,0,0,0,0,63,8,0,0,0,0,0,0,0,0,0,100
ca38fb98f83e0345ca6c49b0660e9fbd03ea3cd5,19,6,51,45,0,0,0,7,56,520,1,15,3.85841041,5168,1,0,871,874,3,40242,40531,289,403,406,3,100
afbda0798a4fe662bd5379cf535da79800c4e840,2,41,2,39,0,0,0,8,18,574,1,2,0.999609836,332,0,0,48,41,7,2726,2439,287,33,30,3,100
ce9032a4123e262341a3e746e6eb2b8476eae1ae,2,44,3,41,0,0,0,9,14,647,1,2,0.550984443,457,2,0,79,77,2,4430,4115,315,37,35,2,100
3ad0106f5fa15fbe718727016c600d14cd23294c,8,821,26,795,2,0,2,8,76,127,1,6,1.506717478,2733,2,0,963,804,159,24527,19725,4802,285,221,64,92.75517488
4a1e3acdc09de0545cbb6bfd4554604e64ca1a35,2,3,3,0,0,0,0,13,33,670,1,1,0.918295834,670,0,0,185,182,3,6390,6378,12,106,106,0,100
9bc2c62c6a82dbce260d4cc0277f1d0276063468,3,50,76,26,0,0,0,6,10,230,1,2,1.113749052,702,7,0,158,159,1,5040,5048,8,65,66,1,96.99331849
0d7eda62854b89badd7e217062212364354e5a0d,0,0,0,0,0,0,0,0,0,0,0,0,0,0,0,0,0,0,0,0,0,0,0,0,0,100
75e8f58c95e2b8c69af1a6f60c35a848a6781f0c,0,0,0,0,0,0,0,0,0,0,0,0,0,0,0,0,0,0,0,0,0,0,0,0,0,100
5c40cb12c9e2694ad1e47f22e275b6692893c96d,1,1,2,1,0,0,0,5,7,689,1,1,0,66,2,1,16,16,0,353,352,1,3,3,0,100
5c49fdae92df878c587b3ea74e5d3d2418d3a32d,0,0,0,0,0,0,0,0,0,0,0,0,0,0,3,2,0,0,0,0,0,0,0,0,0,100
8e5a4ea769d925df95b4d4cde596a71248f2d3c5,1,1,1,0,0,0,0,19,77,9,1,1,0,1043,0,0,332,332,0,7499,7498,1,103,103,0,100
335acc5770f7ad6bd6fdf4caa305373a79912d70,2,11,3,8,0,0,0,9,73,631,1,2,0.863120569,2302,0,0,546,546,0,18063,17986,77,268,267,1,100
b31bf3133c641679741aca01f1ea61b4959d96bc,0,0,0,0,0,0,0,0,0,0,0,0,0,0,39,0,0,0,0,0,0,0,0,0,0,100
1430ccde8d7a7035138d45eb433941c5fdc50baf,2,5,4,1,0,0,0,15,32,350,1,2,0.764204507,311,40,1,70,70,0,2490,2476,14,7,7,0,100
6d76044e2d3aaaf34fdb634dc2b1608e207ebcb8,0,0,0,0,0,0,0,0,0,0,0,0,0,0,41,2,0,0,0,0,0,0,0,0,0,100
f7892a319e4f8bf35098cc74ca0cbfcf7a3f6fc0,0,0,0,0,0,0,0,0,0,0,0,0,0,0,42,3,0,0,0,0,0,0,0,0,0,100
343c92e736d8fa7fce5974314b79bc2f01b00800,0,0,0,0,0,0,0,0,0,0,0,0,0,0,1,1,0,0,0,0,0,0,0,0,0,100
ad2a8933d45488e4b0b306d14e1be50a87c33cf3,0,0,0,0,0,0,0,0,0,0,0,0,0,0,8,1,0,0,0,0,0,0,0,0,0,100
c50a87e1d4a92232b5ec13997549822b51a3c02e,1,0,1,1,0,0,0,7,11,24,1,1,0,517,0,0,157,157,0,3677,3690,13,24,24,0,100
a439bf96f922fb065aed4fa8eb9f0fc43223482b,0,0,0,0,0,0,0,0,0,0,0,0,0,0,49,0,0,0,0,0,0,0,0,0,0,100
eff3deecaa35562f6f78c37ed9d01bf44b6d8893,0,0,0,0,0,0,0,0,0,0,0,0,0,0,50,1,0,0,0,0,0,0,0,0,0,100
59d8c6d3105f364127658dca270c6babdda59ba3,0,0,0,0,0,0,0,0,0,0,0,0,0,0,43,4,0,0,0,0,0,0,0,0,0,100
ca048907828d557eda64a4c1afdfbf279f28e286,0,0,0,0,0,0,0,0,0,0,0,0,0,0,44,5,0,0,0,0,0,0,0,0,0,100
53a7d9feef4b857be7dbe6aa5b2744b086384302,3,20,20,0,0,0,0,6,13,508,1,3,1.336666482,1030,4,2,195,195,0,6292,6312,20,108,108,0,100
a65dca9bc4981b7788b51d3297323136e4f664ae,1,2,3,1,0,0,0,8,17,158,1,1,0,110,5,3,24,24,0,625,631,6,11,11,0,100
3812985c2d4219815c0521dc193fdf811afba0dc,0,0,0,0,0,0,0,0,0,0,0,0,0,0,51,2,0,0,0,0,0,0,0,0,0,100
37be95b0bd64b9ecc118d0ff8b30e734f94e4d3c,1,1,5,4,0,0,0,11,18,266,1,1,0,322,6,2,76,76,0,1720,1732,12,39,39,0,100
1dbf61ee8cf2866e6e590388198e64c190af1e3f,0,0,0,0,0,0,0,0,0,0,0,0,0,0,45,6,0,0,0,0,0,0,0,0,0,100
2e8ba13d8a6c126224db503537c9870ce225c19d,0,0,0,0,0,0,0,0,0,0,0,0,0,0,7,3,0,0,0,0,0,0,0,0,0,100
ebe9080060e5dd46328fcdd9a05f073944af54ce,0,0,0,0,0,0,0,0,0,0,0,0,0,0,43,0,0,0,0,0,0,0,0,0,0,100
9cba8570aa5d9fab9371915b048caff6e05779a1,0,0,0,0,0,0,0,0,0,0,0,0,0,0,44,1,0,0,0,0,0,0,0,0,0,100
8288df87e69d9332caa7202901f321c88f06de86,0,0,0,0,0,0,0,0,0,0,0,0,0,0,52,3,0,0,0,0,0,0,0,0,0,100
8199b9626e4badd34a85946cd223a91863f44cee,0,0,0,0,0,0,0,0,0,0,0,0,0,0,0,0,0,0,0,0,0,0,0,0,0,100
9d26540d9259f8e05d32e9f300f171f2530a17cd,1,1,1,0,0,0,0,12,42,69,1,1,0,407,0,0,125,124,1,3049,3045,4,33,33,0,100
17be402804cd0264d89e94d7b6f8b2d595008656,0,0,0,0,0,0,0,0,0,0,0,0,0,0,45,2,0,0,0,0,0,0,0,0,0,100
9741c08ae2ffe06adbf3559b5c5702d9bf8cae3c,0,0,0,0,0,0,0,0,0,0,0,0,0,0,46,3,0,0,0,0,0,0,0,0,0,100
791ec6017b03e3cc79fbf546dd9d79d20d476b4e,0,0,0,0,0,0,0,0,0,0,0,0,0,0,47,4,0,0,0,0,0,0,0,0,0,100
40622368863c19f9b103927b85af9dd65d18aedb,1,6,17,11,0,0,0,8,12,140,1,1,0,516,8,0,154,157,3,3597,3677,80,24,24,0,100
1fe960ef7b3da9222a38db443f56461466114f8f,1,14,16,2,0,0,0,6,12,848,1,1,0,343,9,1,88,88,0,2708,2762,54,19,19,0,100
7c44eef21561056aa0637c72f0f6be0bfd95a292,2,44,4,40,1,0,1,1,13,0,1,2,0.599314237,342,10,2,89,88,1,2772,2708,64,20,19,1,99.89193084
da132659c4676ede53aabb66ebd943b8232a18f3,4,20,34,14,0,0,0,23,64,225,1,4,1.589738503,2521,11,3,725,727,2,18536,18602,66,228,228,0,100
87aefa28ad6cb11ab95010cdeac2223cfb701c0d,1,15,7,8,0,0,0,2,2,656,1,1,0,80,12,4,6,6,0,554,501,53,4,4,0,100
c81ea58c601a2f600d9d45cf50b9f6434b911d5a,2,27,2,25,0,0,0,7,29,537,1,2,0.66319684,442,0,0,105,103,2,3522,3284,238,31,29,2,100
d5d1cd70e920f45468bf696d3668b496a9adbab3,2,21,3,18,0,0,0,7,19,524,1,2,1,195,13,5,37,35,2,1163,1074,89,23,22,1,100
01e039ca12ade8bc08b6b4b33ef87a32f3f06b88,0,0,0,0,0,0,0,0,0,0,0,0,0,0,0,0,0,0,0,0,0,0,0,0,0,100
9af218d3c060da103868cdc69d7b39fc8d50dcbc,0,0,0,0,0,0,0,0,0,0,0,0,0,0,48,0,0,0,0,0,0,0,0,0,0,100
6b0d470a79b4c4e10d9890183d6c913608a2a225,0,0,0,0,0,0,0,0,0,0,0,0,0,0,49,1,0,0,0,0,0,0,0,0,0,100
97c2aeb6ca5186524e8576febfe44b1a03a1b97e,0,0,0,0,0,0,0,0,0,0,0,0,0,0,53,0,0,0,0,0,0,0,0,0,0,100
8e345c48e8f9708c27af63754965777314dac85c,1,3,0,3,0,0,0,8,20,55,1,1,0,155,14,0,33,33,0,876,854,22,20,20,0,100
d336babe3e0a11d90613083de72652f358207b29,0,0,0,0,0,0,0,0,0,0,0,0,0,0,50,1,0,0,0,0,0,0,0,0,0,100
b6f49705ad3cc81020117d04938e1ae03d3a99d9,0,0,0,0,0,0,0,0,0,0,0,0,0,0,6,0,0,0,0,0,0,0,0,0,0,100
f56cafb83854a7529625bd1d82521f5848399ccc,0,0,0,0,0,0,0,0,0,0,0,0,0,0,51,2,0,0,0,0,0,0,0,0,0,100
d83e43b3cf087aa1911befd39e9df0c9f5e82628,1,2,2,0,0,0,0,24,58,83,1,1,0,860,7,1,255,255,0,5701,5705,4,81,81,0,100
771c16b521e34e721e31bb2caf9f86699ea10dff,0,0,0,0,0,0,0,0,0,0,0,0,0,0,54,1,0,0,0,0,0,0,0,0,0,100
067af1875257a11438a3f35cc576b152b0e6ac9c,0,0,0,0,0,0,0,0,0,0,0,0,0,0,3,0,0,0,0,0,0,0,0,0,0,100
7d372932c08e10ef04e060c138949dfd7c714616,0,0,0,0,0,0,0,0,0,0,0,0,0,0,55,2,0,0,0,0,0,0,0,0,0,100
1dca808f1294056cd804af4f7bd417bc1917fe8a,0,0,0,0,0,0,0,0,0,0,0,0,0,0,0,0,0,0,0,0,0,0,0,0,0,100
cfb6a12a5eba4ebcef1e04f53b19728d6da9aa5c,3,211,43,168,0,0,0,6,65,454,1,3,1.090374256,980,0,0,287,273,14,8639,8040,599,68,60,8,99.96400288
02f12b87b7a8254b5169c479d44d0e1a5952f1c7,0,0,0,0,0,0,0,0,0,0,0,0,0,0,56,3,0,0,0,0,0,0,0,0,0,100
07fd336c6e5cc052931405b7257d9d06b5337d7c,2,10,0,10,0,0,0,6,12,479,1,2,0.970950594,228,8,2,55,53,2,2139,2035,104,8,8,0,100
40196080593557380d8e9ad5bc588a61dc5de93e,0,0,0,0,0,0,0,0,0,0,0,0,0,0,12,0,0,0,0,0,0,0,0,0,0,100
d5c1ad2d7facc3f328b51dd0f9b736d925217e39,0,0,0,0,0,0,0,0,0,0,0,0,0,0,0,0,0,0,0,0,0,0,0,0,0,100
5f7b068663671bb1d4a810c35e3a4a55815bc1ef,1,5,5,0,0,0,0,5,8,957,1,1,0,51,15,1,5,5,0,309,306,3,2,2,0,100
285bda86d3f49aa5054d4fd1487680bb1accd8ac,0,0,0,0,0,0,0,0,0,0,0,0,0,0,64,0,0,0,0,0,0,0,0,0,0,100
7ab212b8e454c271797fc343204762ca1b925057,0,0,0,0,0,0,0,0,0,0,0,0,0,0,1,1,0,0,0,0,0,0,0,0,0,100
9c80782e3df8f025726ef6d7ccbba4817482082d,0,0,0,0,0,0,0,0,0,0,0,0,0,0,0,0,0,0,0,0,0,0,0,0,0,100
b5a3c44d223d781fed2572cb4ed6f11ca431f25f,2,37,1,36,0,0,0,10,74,300,1,2,0.967788463,1698,0,0,482,477,5,11767,11598,169,216,213,3,100
bcad995f4a70fe756decb9023575e0027c1243c0,6,45,0,45,0,0,0,13,59,515,1,3,1.876799922,1845,0,0,378,373,5,14067,13879,188,140,137,3,100
d916ca2c1ceaabb5fc002630171255dfcdf8d882,0,0,0,0,0,0,0,0,0,0,0,0,0,0,0,0,0,0,0,0,0,0,0,0,0,100
46d87d9aa8964684e602f114292825b9fd5c2554,0,0,0,0,0,0,0,0,0,0,0,0,0,0,1,1,0,0,0,0,0,0,0,0,0,100
384c355b976e107cff11a85b9fe2658e1f335792,0,0,0,0,0,0,0,0,0,0,0,0,0,0,46,0,0,0,0,0,0,0,0,0,0,100
f50faa9c6bdc0ad9bc8db308b74668fa93644102,0,0,0,0,0,0,0,0,0,0,0,0,0,0,47,1,0,0,0,0,0,0,0,0,0,100
f93cd266d3031e35463a6bfc4aeee92a7550b260,0,0,0,0,0,0,0,0,0,0,0,0,0,0,48,2,0,0,0,0,0,0,0,0,0,100
8f4134a09f8cb707cd7f0de784ecda20234c818f,0,0,0,0,0,0,0,0,0,0,0,0,0,0,49,3,0,0,0,0,0,0,0,0,0,100
e813aff84591724b237c1943e5d20b27d8d50bf4,0,0,0,0,0,0,0,0,0,0,0,0,0,0,9,0,0,0,0,0,0,0,0,0,0,100
4898556ee5455231645fc9c4c2e9cc7014dec1c0,0,0,0,0,0,0,0,0,0,0,0,0,0,0,2,2,0,0,0,0,0,0,0,0,0,100
bfd5906795df1ddf830f96a1b3b5013968e6b829,0,0,0,0,0,0,0,0,0,0,0,0,0,0,64,0,0,0,0,0,0,0,0,0,0,100
b2c58098704b9ffc70e40f657915fe820126e3d7,0,0,0,0,0,0,0,0,0,0,0,0,0,0,0,0,0,0,0,0,0,0,0,0,0,100
2b398cf179330ef545f2cae0daecd86a4aa3ac89,0,0,0,0,0,0,0,0,0,0,0,0,0,0,0,0,0,0,0,0,0,0,0,0,0,100
414a51fdc1856083bb16851f09a4c61a48796132,0,0,0,0,0,0,0,0,0,0,0,0,0,0,0,0,0,0,0,0,0,0,0,0,0,100
32436402057df32011ebccf17ff9ba81e86b0130,0,0,0,0,0,0,0,0,0,0,0,0,0,0,65,1,0,0,0,0,0,0,0,0,0,100
29fe2f612fc1420ad66d30859d424372098e9ff1,0,0,0,0,0,0,0,0,0,0,0,0,0,0,66,2,0,0,0,0,0,0,0,0,0,100
69cc41c17eefd8a8e6c28cc5ed67a2246cbb1ca0,0,0,0,0,0,0,0,0,0,0,0,0,0,0,67,3,0,0,0,0,0,0,0,0,0,100
1eb2eb7212d2c63cb96299de2f319c9f2a5a8162,0,0,0,0,0,0,0,0,0,0,0,0,0,0,3,3,0,0,0,0,0,0,0,0,0,100
efd6cda8bf9a025ca2847fe8900ac590305facf6,2,22,2,20,0,0,0,6,66,56,1,2,0.811278124,915,2,1,239,236,3,7493,7399,94,64,62,2,100
f106abdb13fb1fd9e6dfaf6a417dece75b9c74ac,0,0,0,0,0,0,0,0,0,0,0,0,0,0,68,4,0,0,0,0,0,0,0,0,0,100
7e7681a6882b1815fc2762beef42e053f440f0f8,0,0,0,0,0,0,0,0,0,0,0,0,0,0,69,5,0,0,0,0,0,0,0,0,0,100
94b6a1fc495f4681a1dfd750effb739d6446dd60,0,0,0,0,0,0,0,0,0,0,0,0,0,0,70,6,0,0,0,0,0,0,0,0,0,100
af429f7ea599d64becbef80a5cf8ac0fba3e85dc,0,0,0,0,0,0,0,0,0,0,0,0,0,0,71,7,0,0,0,0,0,0,0,0,0,100
c536a358e19644e3dc6b646b3ee541f531d6cc6c,0,0,0,0,0,0,0,0,0,0,0,0,0,0,4,4,0,0,0,0,0,0,0,0,0,100
207035aaf405ce468902e86d8d64f096a5a812b2,0,0,0,0,0,0,0,0,0,0,0,0,0,0,52,0,0,0,0,0,0,0,0,0,0,100
88538e9f1d6be236ce69ea2e0bdd6eed352c503e,0,0,0,0,0,0,0,0,0,0,0,0,0,0,5,0,0,0,0,0,0,0,0,0,0,100
833127d6ed09618babd1cce10053d5f183740dab,0,0,0,0,0,0,0,0,0,0,0,0,0,0,72,8,0,0,0,0,0,0,0,0,0,100
5e8537c3363a8fe3076295e5c8f3ae229991314f,0,0,0,0,0,0,0,0,0,0,0,0,0,0,73,9,0,0,0,0,0,0,0,0,0,100
1b1e4ba8172c083f65f3e400ab070570a3bb278a,0,0,0,0,0,0,0,0,0,0,0,0,0,0,0,0,0,0,0,0,0,0,0,0,0,100
258b917d5b3e00152d25de8f1a750bbe857afcfc,0,0,0,0,0,0,0,0,0,0,0,0,0,0,1,1,0,0,0,0,0,0,0,0,0,100
b7948f40ca3de4edcb1ac1d10bd932b33a2c71d9,0,0,0,0,0,0,0,0,0,0,0,0,0,0,2,2,0,0,0,0,0,0,0,0,0,100
f5d2f11972d53eca4e6ce6f8b0e16218a7c4d6c7,0,0,0,0,0,0,0,0,0,0,0,0,0,0,0,0,0,0,0,0,0,0,0,0,0,100
bb31f109c34212e4077518d95671429587bec2db,0,0,0,0,0,0,0,0,0,0,0,0,0,0,3,3,0,0,0,0,0,0,0,0,0,100
dcb8c5b25776f1d2434ac28587c68106998b4b37,0,0,0,0,0,0,0,0,0,0,0,0,0,0,53,1,0,0,0,0,0,0,0,0,0,100
b9bfc07c43140ef0aa58340430ab3c4909337f21,1,1,0,1,0,0,0,8,14,1007,1,1,0,1662,54,2,332,332,0,11135,11126,9,191,191,0,100
eb21a2148b552d3df2db251558c7986ffb2bc833,0,0,0,0,0,0,0,0,0,0,0,0,0,0,55,3,0,0,0,0,0,0,0,0,0,100
ef85cd4099dc645bcd853ceb60e44ff93b4840f0,0,0,0,0,0,0,0,0,0,0,0,0,0,0,56,4,0,0,0,0,0,0,0,0,0,100
b9efa050bac3aa5e67ad659f8d4bb972a0b5d2dc,0,0,0,0,0,0,0,0,0,0,0,0,0,0,57,5,0,0,0,0,0,0,0,0,0,100
efc7cbb8f6b586569903bda469a21b442e461108,6,141,83,58,1,0,1,4,7,835,1,2,1.76904899,240,0,0,29,24,5,1535,1212,323,17,13,4,99.7839395
f301980140db3c8506baa43a40ded48a7c2e2c40,2,44,26,18,0,0,0,17,60,36,1,2,0.255242113,1504,6,1,328,327,1,11796,11694,102,125,124,1,100
641193688c0ec49a46af041d2d7b7fe1e8f108ec,1,4,8,4,0,0,0,17,30,0,1,1,0,652,7,2,70,71,1,6044,6062,18,41,42,1,100
acce806f68282a2b02f07e06ab304d2ae3fc308e,3,540,6,534,1,0,1,5,16,490,1,3,0.459906872,264,8,3,113,34,79,4494,1822,2672,60,17,43,99.89196975
331587a27f93880a910985ea6a42125d3878bb16,6,28,26,2,0,0,0,7,14,804,1,5,2.535046874,651,9,4,115,115,0,3520,3520,0,69,69,0,100
a57f7537594dd10c85d3ecdeab1d193436e6a978,2,1,4,3,0,0,0,7,15,0,1,2,0.970950594,133,10,5,19,19,0,823,823,0,8,8,0,100
7baac0fbb5b8ff9d42e97e2dd65936318ae7f5c7,0,0,0,0,0,0,0,0,0,0,0,0,0,0,11,6,0,0,0,0,0,0,0,0,0,100
192cd3b8d607ce77a268f99ab4e3450597d882db,0,0,0,0,0,0,0,0,0,0,0,0,0,0,12,7,0,0,0,0,0,0,0,0,0,100
b0c09361fe985fe57858f19485b43e1deeec8d89,1,16,0,16,0,0,0,10,21,669,1,1,0,510,13,8,34,33,1,6636,6522,114,24,23,1,100
ccb95a6763d53eaa5ba24ced3531096bac390d3a,0,0,0,0,0,0,0,0,0,0,0,0,0,0,5,5,0,0,0,0,0,0,0,0,0,100
7347e25381f170a28d6ab081e08ddf4b3354b8fe,3,159,1,158,0,0,0,11,75,42,1,3,0.602188892,1878,1,0,560,535,25,14731,13059,1672,237,222,15,100
cb0d6e88a4f0c985a2ecceab3be77dadd874e3cb,1,5,5,0,0,0,0,8,14,1007,1,1,0,200,14,9,43,43,0,1289,1289,0,23,23,0,100
8c15c1241fb52f3ce6eb480bbe16ff70d3bc426a,1,26,2,24,0,0,0,8,15,0,1,1,0,200,15,10,43,43,0,1289,1289,0,23,23,0,100
2c238747755a19fe6acce107b6fb1ce7d1984563,1,4,4,0,0,0,0,11,26,1007,1,1,0,234,1,0,55,55,0,1561,1543,18,26,26,0,100
74ad244741a391450610f4d273172707ae2b9a80,1,28,11,17,0,0,0,8,15,1007,1,1,0,263,2,1,36,35,1,1829,1683,146,32,31,1,100
97e05457f55e3f51dd8279df1247be65125d767a,1,13,9,4,0,0,0,8,16,0,1,1,0,276,3,2,36,36,0,1857,1829,28,32,32,0,100
58569bd5dc678a753c8a456e29d78462228b9a29,0,0,0,0,0,0,0,0,0,0,0,0,0,0,1,0,0,0,0,0,0,0,0,0,0,100
dab5fbe35e7bafcf86eb587cf4c6a898ea57f673,4,28,26,2,0,0,0,10,61,251,1,4,1.834362703,1544,16,11,424,424,0,10709,10627,82,133,133,0,100
ecc489ce5dc069a8fe8d047d9297ff11827010e6,0,0,0,0,0,0,0,0,0,0,0,0,0,0,17,12,0,0,0,0,0,0,0,0,0,100
b534b8ba924cd7515ec71bd0c0898153952c6eba,26,257,197,60,0,0,0,5,25,912,2,13,3.663142664,3882,18,13,370,370,0,34402,34118,284,246,246,0,100
3c8a4d4514e80788611710d92b2ac7880714507b,3,27,0,27,0,0,0,9,27,335,1,3,1.380094336,547,0,0,98,94,4,3708,3494,214,63,61,2,99.49622166
734ea36dfe00fb70b506b4e987f0ad8341bcad94,1,18,0,18,0,0,0,17,31,2,1,1,0,648,74,10,72,70,2,6151,6044,107,42,41,1,100
086a15f04cc16dc1ee6a6259e31f5339f2ade840,0,0,0,0,0,0,0,0,0,0,0,0,0,0,0,0,0,0,0,0,0,0,0,0,0,100
87656846db4684591ec13484f2e2347f6e1b68d0,0,0,0,0,0,0,0,0,0,0,0,0,0,0,1,1,0,0,0,0,0,0,0,0,0,100
dfd3dd64bed7f783b0d33c7688a440235ecfc0f3,0,0,0,0,0,0,0,0,0,0,0,0,0,0,2,2,0,0,0,0,0,0,0,0,0,100
3a098e8be4944216f811211c9e3240fd6f67a4ae,9,39,19,20,0,0,0,13,78,591,1,6,3.048041655,3799,33,0,755,751,4,36620,36522,98,377,376,1,99.11158493
61f162de6f441f65297cf8b57c0e8c36474be7d6,0,0,0,0,0,0,0,0,0,0,0,0,0,0,0,0,0,0,0,0,0,0,0,0,0,100
13405739ccf0ac3b10d3ac66c6d2cc87ddfac3a2,0,0,0,0,0,0,0,0,0,0,0,0,0,0,2,0,0,0,0,0,0,0,0,0,0,100
2d8c857a291ab61ee32e3e2b8ced02f6af6a5c76,0,0,0,0,0,0,0,0,0,0,0,0,0,0,0,0,0,0,0,0,0,0,0,0,0,100
3226f4ef7eab4e27b10b5a5266de15f78849c3db,0,0,0,0,0,0,0,0,0,0,0,0,0,0,58,6,0,0,0,0,0,0,0,0,0,100
005a39123a67b8fa81d985a63239c4f6a5096c34,0,0,0,0,0,0,0,0,0,0,0,0,0,0,0,0,0,0,0,0,0,0,0,0,0,100
da680e43943ef18f12443e2a7b21bb9258dfa827,1,2,2,0,0,0,0,2,2,2,1,1,0,283,75,11,76,76,0,2436,2442,6,42,42,0,100
4318701a20e8b0131374e63ccd263338ea57891c,3,196,7,189,2,0,2,1,21,337,1,2,1.304498776,85,0,0,28,13,15,1694,663,1031,14,5,9,99.82474588
e208f4b2d442bc14aaba3dad86e8122b83a0873c,21,95,71,24,0,0,0,2,79,778,1,13,4.182841858,5315,76,12,1208,1208,0,35361,34927,434,675,675,0,100
5f064c0d162ea3bb2a28b576c590638052177054,0,0,0,0,0,0,0,0,0,0,0,0,0,0,0,0,0,0,0,0,0,0,0,0,0,100
9d6a4cf2d814d1efda5caf855b3a89d8a997c6e0,0,0,0,0,0,0,0,0,0,0,0,0,0,0,59,7,0,0,0,0,0,0,0,0,0,100
ad63705b30504ba385cde76c530a524843adf0fc,0,0,0,0,0,0,0,0,0,0,0,0,0,0,19,14,0,0,0,0,0,0,0,0,0,100
6f431fa1717b4557768cb274524874d064485dfc,1,52,24,28,0,0,0,9,16,14,1,1,0,200,16,0,48,43,5,1425,1289,136,24,23,1,100
f30a7caee322f8679d90595f3f3d00549cdb6d29,0,0,0,0,0,0,0,0,0,0,0,0,0,0,6,4,0,0,0,0,0,0,0,0,0,100
664c2fc7fba19709c1f974055f9cf4c8a799e108,0,0,0,0,0,0,0,0,0,0,0,0,0,0,1,0,0,0,0,0,0,0,0,0,0,100
ab83dcd6fee848cb0a82a9da328e114cc9e3568b,4,51,6,45,0,0,0,3,62,768,1,3,1.664630365,1025,0,0,280,275,5,6906,6513,393,101,97,4,99.9650105
d3a2b149aa92608956fb0b163eb1bea06ef2c05a,1,1,0,1,0,0,0,12,36,339,1,1,0,417,0,0,112,112,0,2896,2890,6,44,44,0,100
a565690bdaeb9ad1cc296f3832eb45384dded2a8,0,0,0,0,0,0,0,0,0,0,0,0,0,0,0,0,0,0,0,0,0,0,0,0,0,100
1e77a401b951a481b8175e9e5f99afeebd9acf75,1,19,11,8,0,0,0,24,76,14,1,1,0,1539,2,0,461,461,0,10486,10422,64,194,194,0,100
d2d5663076d9c4a5b92b7102a21217a5c8cf6115,12,333,486,153,1,0,1,3,9,651,1,2,2.860520733,1850,77,13,227,240,13,10931,12021,1090,126,139,13,93.0740038
4c0dccbaf557ae6a769f8d397b1be4e14ef979af,0,0,0,0,0,0,0,0,0,0,0,0,0,0,78,14,0,0,0,0,0,0,0,0,0,100
3bf7356376ff176d17960814fad62f13f66c3a4d,3,63,16,47,0,0,0,5,80,401,1,3,1.416497931,1524,9,0,473,467,6,11611,11366,245,140,137,3,100
7fd098a56064ece218c66ba1d2ad78bd358f6009,2,39,10,29,0,0,0,6,17,14,1,2,0.985228136,292,4,3,38,37,1,2283,2058,225,19,18,1,100
a6a0346b4aae937f8e19e928d7c45f85cde09ba2,2,8,5,3,0,0,0,13,67,521,1,2,0.961236605,1916,0,0,385,385,0,14750,14716,34,164,164,0,100
ccbbb8353fcc168563c567580cb773d5fe442704,9,319,7,312,4,0,4,16,28,366,1,6,2.842820392,1381,0,0,264,226,38,11393,10224,1169,146,119,27,99.6835443
e3b06fb914abc05c0fc232e54be94883b784dff6,2,20,4,16,0,0,0,7,28,526,1,2,0.650022422,401,10,1,103,98,5,2845,2734,111,40,38,2,100
1c5e32d2b98e193ea048f8ece8ee3984c6165bfe,1,19,16,3,0,0,0,12,18,8,1,1,0,172,79,15,25,25,0,1254,1206,48,8,8,0,100
49263e7ae117252bdf225499b6fdfb81bac71605,1,2,2,0,0,0,0,22,81,8,1,1,0,1054,3,0,333,333,0,7536,7536,0,104,104,0,100
34c5e7b3b542c0e0b33747086c3cba7bc73b4904,0,0,0,0,0,0,0,0,0,0,0,0,0,0,4,1,0,0,0,0,0,0,0,0,0,100
0281256d42c19bb45e4dc84f8ab7c35e45edd138,0,0,0,0,0,0,0,0,0,0,0,0,0,0,80,12,0,0,0,0,0,0,0,0,0,100
09f8afe0faa0a846b2537b0b5aff9ef05d0ce072,0,0,0,0,0,0,0,0,0,0,0,0,0,0,50,0,0,0,0,0,0,0,0,0,0,100
5287c794d17ec0aefbb4b964a0c01166333c8649,0,0,0,0,0,0,0,0,0,0,0,0,0,0,13,0,0,0,0,0,0,0,0,0,0,100
2a766be2c417c71b42b49ed2898ad3e8ed0d0113,2,251,12,239,1,0,1,1,10,182,1,2,0.717341825,184,1,1,73,53,20,2818,1370,1448,32,14,18,99.94266055
59f220109ea67f18cbcf02f28f2f3f85aeabfb8f,0,0,0,0,0,0,0,0,0,0,0,0,0,0,51,1,0,0,0,0,0,0,0,0,0,100
6e9286ec80af368b2750a57d7a7869cb97ff3d74,1,1,0,1,0,0,0,25,77,17,1,1,0,1547,5,2,461,461,0,10491,10486,5,194,194,0,100
42d81d70e7b9409d3b17fbcc9ea102876b45b945,1,2,1,1,0,0,0,25,78,0,1,1,0,1548,10,0,461,461,0,10488,10491,3,194,194,0,100
bf707863e9c26696fe1046e1a45037d7d8b37463,0,0,0,0,0,0,0,0,0,0,0,0,0,0,52,2,0,0,0,0,0,0,0,0,0,100
144120b540122d11c509a11e74d2559957222e30,0,0,0,0,0,0,0,0,0,0,0,0,0,0,53,3,0,0,0,0,0,0,0,0,0,100
fe2228e59376f03709a558c65a9edf9031eef4e6,0,0,0,0,0,0,0,0,0,0,0,0,0,0,54,4,0,0,0,0,0,0,0,0,0,100
0de45f5592f6a891e0493676de254a5f41db230b,0,0,0,0,0,0,0,0,0,0,0,0,0,0,55,5,0,0,0,0,0,0,0,0,0,100
8f3b419b2d8085d068c85e034d2ad8983733f56c,0,0,0,0,0,0,0,0,0,0,0,0,0,0,56,6,0,0,0,0,0,0,0,0,0,100
72c4a8f84a52c540f824db0dc9b80ec050bfe96d,0,0,0,0,0,0,0,0,0,0,0,0,0,0,57,7,0,0,0,0,0,0,0,0,0,100
e982f2e6ee57c362a7fae21ba7373c1cfc964fce,0,0,0,0,0,0,0,0,0,0,0,0,0,0,58,8,0,0,0,0,0,0,0,0,0,100
93ec41bacf678a875d3696dec72a84901482602a,0,0,0,0,0,0,0,0,0,0,0,0,0,0,59,9,0,0,0,0,0,0,0,0,0,100
249db48c63a9ddf5bd736a8c020fa5ebb267c50d,2,2,2,0,0,0,0,7,31,246,1,2,1,573,17,1,153,153,0,4156,4152,4,43,43,0,100
51d0fe8451bc15e3274ba2f0c5ae0260fcfcb78b,1,52,0,52,1,0,1,1,1,0,1,1,0,0,18,2,1,0,1,186,0,186,1,0,1,99.94272623
b8ccc2f6451343c1da00b288ed4161d055e5daef,0,0,0,0,0,0,0,0,0,0,0,0,0,0,7,1,0,0,0,0,0,0,0,0,0,100
f84ca85ab59cfef44b999262cde5fcd87f9aea19,0,0,0,0,0,0,0,0,0,0,0,0,0,0,11,1,0,0,0,0,0,0,0,0,0,100
5ac4553c796712c8f5941c6b35d031a4bbce64ac,0,0,0,0,0,0,0,0,0,0,0,0,0,0,6,3,0,0,0,0,0,0,0,0,0,100
91410e3a189dcc7cfcabe2ae1243efe0a1259c0b,0,0,0,0,0,0,0,0,0,0,0,0,0,0,60,10,0,0,0,0,0,0,0,0,0,100
9a33ed5498a68b58fc0d3d667d64899bed1fceeb,0,0,0,0,0,0,0,0,0,0,0,0,0,0,0,0,0,0,0,0,0,0,0,0,0,100
95f48dd6dd51f98485d04c7359371e767579bc76,0,0,0,0,0,0,0,0,0,0,0,0,0,0,7,1,0,0,0,0,0,0,0,0,0,100
d9fae92aed6d40bb881badbbbe5eb74060efd01b,0,0,0,0,0,0,0,0,0,0,0,0,0,0,8,2,0,0,0,0,0,0,0,0,0,100
98c29fbf866302c6215cca7762c47e65ff062fb7,0,0,0,0,0,0,0,0,0,0,0,0,0,0,60,0,0,0,0,0,0,0,0,0,0,100
2c7b9af7d5ba35afe9cf84eae3b273a6df0612b1,3,52,37,15,0,0,0,14,68,108,1,3,0.874083571,2328,12,0,511,512,1,17926,17810,116,198,198,0,100
dc2afc5d3bedefa0fa1dfe611adfaedd67418a51,0,0,0,0,0,0,0,0,0,0,0,0,0,0,14,0,0,0,0,0,0,0,0,0,0,100
c903aa6d6fc42d3c347f95d469a8364ea44165e8,0,0,0,0,0,0,0,0,0,0,0,0,0,0,57,0,0,0,0,0,0,0,0,0,0,100
0394e1772e78d9b726bd015c9d02b146a1abaee0,2,23,7,16,0,0,0,18,63,180,1,2,0.836640742,1532,0,0,332,329,3,12043,11928,115,126,125,1,100
307c8f85f3733dce4e22f83232094172084d8e62,0,0,0,0,0,0,0,0,0,0,0,0,0,0,13,0,0,0,0,0,0,0,0,0,0,100
20cbf14f8473154f0a27f064ec04823a8349c6a1,0,0,0,0,0,0,0,0,0,0,0,0,0,0,0,0,0,0,0,0,0,0,0,0,0,100
7791b348c979453bb071bcb5189dcd400b5521b8,2,54,1,53,1,0,1,1,37,118,1,2,0.225363639,418,0,0,113,112,1,3153,2896,257,45,44,1,98.27039493
d5e35e8afaee0566cd85c748ffbff3841be2bd20,0,0,0,0,0,0,0,0,0,0,0,0,0,0,58,0,0,0,0,0,0,0,0,0,0,100
0552c674637dd15b8751ed5181387cdbd81480d5,0,0,0,0,0,0,0,0,0,0,0,0,0,0,59,1,0,0,0,0,0,0,0,0,0,100
ad820ed7edba566a8a2be480d5e2e42238862a5a,0,0,0,0,0,0,0,0,0,0,0,0,0,0,60,2,0,0,0,0,0,0,0,0,0,100
fed505631bc9692080e35b7e8131e6f96e6e8f0d,0,0,0,0,0,0,0,0,0,0,0,0,0,0,61,3,0,0,0,0,0,0,0,0,0,100
fd2286b128cd4592a49297978e5e6e653ad269b8,0,0,0,0,0,0,0,0,0,0,0,0,0,0,62,4,0,0,0,0,0,0,0,0,0,100
c670135804df6de5eda871691e872b7b57ba562b,0,0,0,0,0,0,0,0,0,0,0,0,0,0,61,0,0,0,0,0,0,0,0,0,0,100
d62132899c66e161209754f768fe5881bf7591ff,0,0,0,0,0,0,0,0,0,0,0,0,0,0,62,1,0,0,0,0,0,0,0,0,0,100
4a298ad6dce730c4f323b9c739b810ac06d4ec3b,0,0,0,0,0,0,0,0,0,0,0,0,0,0,63,2,0,0,0,0,0,0,0,0,0,100
c01f79f064ffaf489bfea106defce22e2fc66e6b,0,0,0,0,0,0,0,0,0,0,0,0,0,0,63,5,0,0,0,0,0,0,0,0,0,100
e7e5cfe44f662c5a1af4c550e76b7756ee7f5e60,1,2,0,2,0,0,0,14,32,216,1,1,0,341,0,0,98,98,0,2443,2423,20,24,24,0,100
efb12314b5acfea075a533368441c0f5a3b844d4,0,0,0,0,0,0,0,0,0,0,0,0,0,0,0,0,0,0,0,0,0,0,0,0,0,100
859b224dd353701b38e86d1e24b4c3f0b4fddf73,0,0,0,0,0,0,0,0,0,0,0,0,0,0,8,0,0,0,0,0,0,0,0,0,0,100
cca4401c7ab4ef9e1237e01b6ea1f52fcea7dfc2,0,0,0,0,0,0,0,0,0,0,0,0,0,0,0,0,0,0,0,0,0,0,0,0,0,100
caa3a4265bf0a8e6496b63938bc4ab0b6620683c,0,0,0,0,0,0,0,0,0,0,0,0,0,0,64,6,0,0,0,0,0,0,0,0,0,100
603319f79ca7db6a3b9f40e5270aa8f137d0fb25,0,0,0,0,0,0,0,0,0,0,0,0,0,0,0,0,0,0,0,0,0,0,0,0,0,100
322ba39e68893745f0d40fb5ccc642756507898a,0,0,0,0,0,0,0,0,0,0,0,0,0,0,0,0,0,0,0,0,0,0,0,0,0,100
2a4d846e6e1cf3e5e8576e0be9a9698c97b9f606,0,0,0,0,0,0,0,0,0,0,0,0,0,0,9,0,0,0,0,0,0,0,0,0,0,100
7d1e63b219e6d0778bc57195152477adee97fcab,0,0,0,0,0,0,0,0,0,0,0,0,0,0,0,0,0,0,0,0,0,0,0,0,0,100
9a6aa43c8699ccde7bef485206928acb35378bdb,2,66,22,44,0,0,0,8,21,509,1,2,0.976020648,213,0,0,38,37,1,1528,1185,343,24,23,1,100
816893eb5cb7a71d9a06c3c5e27db2e2fb7bbb94,1,2,0,2,0,0,0,6,10,387,1,1,0,383,0,0,69,69,0,2403,2397,6,30,30,0,100
408099a9f82c542caf397b96f4279a827774a1cb,1,4,5,1,0,0,0,22,82,386,1,1,0,1054,34,0,333,333,0,7521,7536,15,104,104,0,100
328c539afc77da347ec52be1e112a6a7c371143b,2,34,4,30,0,0,0,4,20,1436,1,2,0.789749254,350,14,0,69,68,1,2232,2040,192,38,37,1,94.0248566
6caf1c304185f581fdc5ef3ef10af27a3ab0ca91,6,1967,23,1944,4,0,4,7,19,152,1,3,2.311084952,316,0,0,306,38,268,11648,2331,9317,187,19,168,99.71688574
9055b08eb00494e65adcf22498095864897b8b37,0,0,0,0,0,0,0,0,0,0,0,0,0,0,15,0,0,0,0,0,0,0,0,0,0,100
6a5acde74c45c3997b093cea79d831038ac8a182,0,0,0,0,0,0,0,0,0,0,0,0,0,0,0,0,0,0,0,0,0,0,0,0,0,100
942ec8e0cc011ec9fcfff7ba9f5c656bb54d51d1,2,68,6,62,0,0,0,5,17,267,1,2,0.571354974,290,0,0,56,53,3,2236,1885,351,29,27,2,98.0021254
c97fa4971ee951eab51a35d8e4a7c1ba7388e4e7,0,0,0,0,0,0,0,0,0,0,0,0,0,0,9,0,0,0,0,0,0,0,0,0,0,100
53b7ccc8d61427a60b6354564e1613a6577e7c04,0,0,0,0,0,0,0,0,0,0,0,0,0,0,10,1,0,0,0,0,0,0,0,0,0,100
68b2e9df5aefa187db5b627133ba009606393e2f,0,0,0,0,0,0,0,0,0,0,0,0,0,0,11,2,0,0,0,0,0,0,0,0,0,100
5ebede65e1a550295bc662e5aef9e2421a388abf,0,0,0,0,0,0,0,0,0,0,0,0,0,0,12,3,0,0,0,0,0,0,0,0,0,100
b39848b75012efe6576aad7f1a013510e3baa9f0,0,0,0,0,0,0,0,0,0,0,0,0,0,0,16,1,0,0,0,0,0,0,0,0,0,100
321d16deff543b2f07a9c1487a1dfccd8d25286e,2,5,0,5,0,0,0,19,64,336,1,2,0.970950594,1546,0,0,332,332,0,12106,12043,63,126,126,0,100
4f4ddf041c1a73aad011be62e9cd7e9bb654148c,0,0,0,0,0,0,0,0,0,0,0,0,0,0,64,0,0,0,0,0,0,0,0,0,0,100
e6ce95914cf28f6331d1c61896e65e40a121344b,0,0,0,0,0,0,0,0,0,0,0,0,0,0,65,1,0,0,0,0,0,0,0,0,0,100
398e6c9dacc094b1f3349d60331c087a8e5a545c,0,0,0,0,0,0,0,0,0,0,0,0,0,0,66,2,0,0,0,0,0,0,0,0,0,100
79f94fbc67bdc3880215e89225069e0d6b3bb460,0,0,0,0,0,0,0,0,0,0,0,0,0,0,67,3,0,0,0,0,0,0,0,0,0,100
00cdeecbf65c6cdf8ef58dbfab671475e76ec93c,0,0,0,0,0,0,0,0,0,0,0,0,0,0,68,4,0,0,0,0,0,0,0,0,0,100
73ea6c5585ed13ddd97fb47fe7515bd05b47b818,0,0,0,0,0,0,0,0,0,0,0,0,0,0,69,5,0,0,0,0,0,0,0,0,0,100
51a7b211b152a5f3d3f5b13b03c3f8a1ccc4646c,0,0,0,0,0,0,0,0,0,0,0,0,0,0,70,6,0,0,0,0,0,0,0,0,0,100
1a0bd70710bd30a4d7168e0b1c88fb33ebfdc6cd,0,0,0,0,0,0,0,0,0,0,0,0,0,0,71,7,0,0,0,0,0,0,0,0,0,100
372313b018c4b34e17469327aaf8e9381e6a4524,0,0,0,0,0,0,0,0,0,0,0,0,0,0,72,8,0,0,0,0,0,0,0,0,0,100
63afb6a2ce867379c951d42ebc8b85ff653e9bdc,0,0,0,0,0,0,0,0,0,0,0,0,0,0,73,9,0,0,0,0,0,0,0,0,0,100
c4686b715155cd31d926da962ebb2cc203e1a831,0,0,0,0,0,0,0,0,0,0,0,0,0,0,74,10,0,0,0,0,0,0,0,0,0,100
e42b44e0bfeaaf1fcfd28bb7396b7f663ec1aa50,0,0,0,0,0,0,0,0,0,0,0,0,0,0,1,0,0,0,0,0,0,0,0,0,0,100
edddf440521d253aecbd0f95a65c6b0063fe654f,0,0,0,0,0,0,0,0,0,0,0,0,0,0,61,0,0,0,0,0,0,0,0,0,0,100
d3bb916340203521065972da7e29aee05ea9f421,0,0,0,0,0,0,0,0,0,0,0,0,0,0,13,4,0,0,0,0,0,0,0,0,0,100
18b811aac4313e1ac67dab4048695bd0cf9e40ca,1,1,1,0,0,0,0,16,33,854,1,1,0,275,0,0,68,68,0,2332,2332,0,5,5,0,100
75c4dd3436cbc8b86a04e9681ad83a2f2a22334e,1,48,0,48,0,0,0,5,9,1547,1,1,0,86,14,5,7,6,1,1249,820,429,7,6,1,99.91009216
30328e20f92aee9944697de9bbb050184b8584a1,0,0,0,0,0,0,0,0,0,0,0,0,0,0,75,11,0,0,0,0,0,0,0,0,0,100
baa676566eaaa81c5249d03edcf58b6a690a4c11,0,0,0,0,0,0,0,0,0,0,0,0,0,0,17,1,0,0,0,0,0,0,0,0,0,100
9d450a50846eec18635cbde059af378575fbcaae,0,0,0,0,0,0,0,0,0,0,0,0,0,0,0,0,0,0,0,0,0,0,0,0,0,100
2a4b875081aee1e2e7030f4aedef49cb15a9fb2f,0,0,0,0,0,0,0,0,0,0,0,0,0,0,1,1,0,0,0,0,0,0,0,0,0,100
60c59212a41406e4f24b8541332a4b2496a945e6,0,0,0,0,0,0,0,0,0,0,0,0,0,0,2,2,0,0,0,0,0,0,0,0,0,100
121df31767b77c70e9417b8521c9969d62dde95d,0,0,0,0,0,0,0,0,0,0,0,0,0,0,3,3,0,0,0,0,0,0,0,0,0,100
7b778627616a97a06c19a9250bdc09d8e25935ce,0,0,0,0,0,0,0,0,0,0,0,0,0,0,4,4,0,0,0,0,0,0,0,0,0,100
b7d5027291621769653771e4fc91dba98bc08d8d,0,0,0,0,0,0,0,0,0,0,0,0,0,0,0,0,0,0,0,0,0,0,0,0,0,100
d04fc44417920714e4cad4b11a73b41e68c101a6,0,0,0,0,0,0,0,0,0,0,0,0,0,0,5,5,0,0,0,0,0,0,0,0,0,100
0bbdfc096d3d3435a6bc2c4eff7b771ba69fd8cd,0,0,0,0,0,0,0,0,0,0,0,0,0,0,6,6,0,0,0,0,0,0,0,0,0,100
64ce2af5cbdc36e0ebde12285068aa56c25ea9cf,0,0,0,0,0,0,0,0,0,0,0,0,0,0,7,7,0,0,0,0,0,0,0,0,0,100
78e524962fbc68a103094f652d605b4035326975,0,0,0,0,0,0,0,0,0,0,0,0,0,0,76,12,0,0,0,0,0,0,0,0,0,100
2cc44c5b3ab234ac1258a34d233a9d88cfe15565,0,0,0,0,0,0,0,0,0,0,0,0,0,0,18,1,0,0,0,0,0,0,0,0,0,100
89c03cfe5fe8a0ad1aacf910e9b94c57a41ea67e,0,0,0,0,0,0,0,0,0,0,0,0,0,0,8,3,0,0,0,0,0,0,0,0,0,100
0fbc98b7625577a9b51c4c52467d62cf08cbc16f,0,0,0,0,0,0,0,0,0,0,0,0,0,0,65,0,0,0,0,0,0,0,0,0,0,100
ca6d72dd618b7b52aedd32654bfaa6c35d950ccf,0,0,0,0,0,0,0,0,0,0,0,0,0,0,66,1,0,0,0,0,0,0,0,0,0,100
4467c66e05abf0f3e3ad3570fca4a7769a13533b,0,0,0,0,0,0,0,0,0,0,0,0,0,0,67,2,0,0,0,0,0,0,0,0,0,100
6c527e5f6cebd595a14b4b38f47b973a151636fa,0,0,0,0,0,0,0,0,0,0,0,0,0,0,68,1,0,0,0,0,0,0,0,0,0,100
e8db541f0c343d5f5f0773f7cec687a83cee3698,0,0,0,0,0,0,0,0,0,0,0,0,0,0,1,0,0,0,0,0,0,0,0,0,0,100
96312e4705fc6ef1c6d9fde631afe2a2cedc8e9e,0,0,0,0,0,0,0,0,0,0,0,0,0,0,2,1,0,0,0,0,0,0,0,0,0,100
bd31cc452dbe8513f9d2f00181d910622dfd4bbe,0,0,0,0,0,0,0,0,0,0,0,0,0,0,3,2,0,0,0,0,0,0,0,0,0,100
21e39347f227516aa353ee84367a0d46d18420ab,0,0,0,0,0,0,0,0,0,0,0,0,0,0,0,0,0,0,0,0,0,0,0,0,0,100
1cc5f7b607714a0750d9634d5a27e40a00e92c9c,0,0,0,0,0,0,0,0,0,0,0,0,0,0,0,0,0,0,0,0,0,0,0,0,0,100
1ee0e2778e8e6d95c9def1e94cb59c72ef0da369,0,0,0,0,0,0,0,0,0,0,0,0,0,0,15,0,0,0,0,0,0,0,0,0,0,100
3c99902f50e7998f972c491bfaecac2e3cacc981,0,0,0,0,0,0,0,0,0,0,0,0,0,0,16,1,0,0,0,0,0,0,0,0,0,100
8c2c6bf7610194bdad61b00743dae22a839b7ff5,0,0,0,0,0,0,0,0,0,0,0,0,0,0,77,0,0,0,0,0,0,0,0,0,0,100
90d0a49d02416cac41962ac40d3662967febfcdb,0,0,0,0,0,0,0,0,0,0,0,0,0,0,1,1,0,0,0,0,0,0,0,0,0,100
f4d2b0ddf51ea1bd8a8c0151ee7741ae1239eb53,0,0,0,0,0,0,0,0,0,0,0,0,0,0,1,0,0,0,0,0,0,0,0,0,0,100
dbed143b8d1f056a0516f37589bb1925d8b56768,0,0,0,0,0,0,0,0,0,0,0,0,0,0,9,0,0,0,0,0,0,0,0,0,0,100
e3f977697c605f52973aa21e61f7be3208c38029,0,0,0,0,0,0,0,0,0,0,0,0,0,0,10,1,0,0,0,0,0,0,0,0,0,100
9f3c7ee088d0a7b81a6aefe82809a75360655b49,0,0,0,0,0,0,0,0,0,0,0,0,0,0,11,2,0,0,0,0,0,0,0,0,0,100
020e30c94c71ccfbc6de58a68befb9405ee4c048,0,0,0,0,0,0,0,0,0,0,0,0,0,0,12,3,0,0,0,0,0,0,0,0,0,100
5412eca32406e3a5d8579400bc6c3843ff5fb206,0,0,0,0,0,0,0,0,0,0,0,0,0,0,65,0,0,0,0,0,0,0,0,0,0,100
7643ac45d041b4273fb1099f9638131d01381c11,0,0,0,0,0,0,0,0,0,0,0,0,0,0,13,4,0,0,0,0,0,0,0,0,0,100
72b06153729b1a7963012b1e3e0cc3837e452322,0,0,0,0,0,0,0,0,0,0,0,0,0,0,14,5,0,0,0,0,0,0,0,0,0,100
afe8fa1adfbed7971c077338cd9441b14503507a,0,0,0,0,0,0,0,0,0,0,0,0,0,0,0,0,0,0,0,0,0,0,0,0,0,100
0fc0e05ddcef06958937af561159063d4b3c634e,0,0,0,0,0,0,0,0,0,0,0,0,0,0,66,1,0,0,0,0,0,0,0,0,0,100
41587a9099eae06ceb615ec440ed70e767af02b6,0,0,0,0,0,0,0,0,0,0,0,0,0,0,67,2,0,0,0,0,0,0,0,0,0,100
351f589913b9691322966fb77fe72269a0a2ec82,0,0,0,0,0,0,0,0,0,0,0,0,0,0,2,1,0,0,0,0,0,0,0,0,0,100
30515453b14b4ca15e2f10c840dae448e0e1089e,0,0,0,0,0,0,0,0,0,0,0,0,0,0,15,6,0,0,0,0,0,0,0,0,0,100
6d77f5048dcc3b6f0924c86b740a2c90a8354fa8,0,0,0,0,0,0,0,0,0,0,0,0,0,0,16,7,0,0,0,0,0,0,0,0,0,100
8da43216f0c1c7a64154ec6ebd668d7c76893137,0,0,0,0,0,0,0,0,0,0,0,0,0,0,15,0,0,0,0,0,0,0,0,0,0,100
44737386cb17a359515f068e7fe9caa0f7bfff70,12,33,577,544,0,0,0,8,65,436,1,6,1.225457015,4217,68,3,912,993,81,33024,35728,2704,464,509,45,99.95505618
568ee67c2d0c8d62049741ae78dc91910aa1b6f2,1,24,16,8,0,0,0,5,7,276,1,1,0,121,19,0,10,8,2,869,811,58,5,5,0,100
02bdc2da3ade2fe5a0c1138bff0d4574a8d7075b,0,0,0,0,0,0,0,0,0,0,0,0,0,0,17,0,0,0,0,0,0,0,0,0,0,100
36ef0b71c6c624bef8525704229a7791b51788d5,2,80,1,79,0,0,0,6,18,141,1,2,0.573139398,343,0,0,63,58,5,2726,2294,432,33,29,4,100
da771e4d603b771c4add65e17c25c13990a1c463,0,0,0,0,0,0,0,0,0,0,0,0,0,0,17,2,0,0,0,0,0,0,0,0,0,100
5ebc186856114c508f28203b19654658e87045e7,0,0,0,0,0,0,0,0,0,0,0,0,0,0,69,3,0,0,0,0,0,0,0,0,0,100
3427f5f8f2c2f404b5112f15d143205a84fd737e,0,0,0,0,0,0,0,0,0,0,0,0,0,0,18,3,0,0,0,0,0,0,0,0,0,100
214e6ebf8dce91a0a0910281ddb8e82a19f6c310,0,0,0,0,0,0,0,0,0,0,0,0,0,0,19,4,0,0,0,0,0,0,0,0,0,100
68090374cdb00e5bdb5e6fde3d5e08a29f2293a6,0,0,0,0,0,0,0,0,0,0,0,0,0,0,20,3,0,0,0,0,0,0,0,0,0,100
7b4721d91e08ab8bf71c424365a76a5b44c74e93,0,0,0,0,0,0,0,0,0,0,0,0,0,0,21,4,0,0,0,0,0,0,0,0,0,100
1f746d4941ae80216295ce112b84353043be5395,0,0,0,0,0,0,0,0,0,0,0,0,0,0,22,5,0,0,0,0,0,0,0,0,0,100
e73952236118d144f60aa44af19eca79ba1d622a,0,0,0,0,0,0,0,0,0,0,0,0,0,0,23,6,0,0,0,0,0,0,0,0,0,100
ab583427573cd9a1476265ed176f18c6b1180a30,0,0,0,0,0,0,0,0,0,0,0,0,0,0,24,7,0,0,0,0,0,0,0,0,0,100
b90278af3446fe82b061c08076d61b7d1ecaa445,0,0,0,0,0,0,0,0,0,0,0,0,0,0,25,8,0,0,0,0,0,0,0,0,0,100
4a3a624509f5dfd40e8f5b32e9d60cc7a90ab4fa,0,0,0,0,0,0,0,0,0,0,0,0,0,0,3,0,0,0,0,0,0,0,0,0,0,100
c7eef98ba68fc23df9a0256a0a93ac405fe3b948,0,0,0,0,0,0,0,0,0,0,0,0,0,0,0,0,0,0,0,0,0,0,0,0,0,100
4918c14684a384d80b077fe27488c1912c3bc9bb,0,0,0,0,0,0,0,0,0,0,0,0,0,0,26,8,0,0,0,0,0,0,0,0,0,100
552ee9e3c1679fec9ecb959c7c12ed7bd91827b0,2,80,9,71,0,0,0,8,21,1338,1,2,0.984554353,1069,0,0,206,198,8,7335,6896,439,111,107,4,100
25459ec86ca469ee3ead855bb78556b2f09b8a24,0,0,0,0,0,0,0,0,0,0,0,0,0,0,72,0,0,0,0,0,0,0,0,0,0,100
d4a257460cfbebec3dc2d0ab82375fb7ee4bd212,0,0,0,0,0,0,0,0,0,0,0,0,0,0,27,7,0,0,0,0,0,0,0,0,0,100
adf099d5898fd92397b21ed367be299e321e8aba,0,0,0,0,0,0,0,0,0,0,0,0,0,0,28,8,0,0,0,0,0,0,0,0,0,100
23fe79f324d6c7e7e13243d6c39a5c0da7196609,0,0,0,0,0,0,0,0,0,0,0,0,0,0,29,9,0,0,0,0,0,0,0,0,0,100
c076d619ebc32c5855258e1c9b337de2a2f3a1d1,0,0,0,0,0,0,0,0,0,0,0,0,0,0,78,0,0,0,0,0,0,0,0,0,0,100
bfbb45b0605b8498b4050d05adcb2270350579ae,0,0,0,0,0,0,0,0,0,0,0,0,0,0,30,10,0,0,0,0,0,0,0,0,0,100
cff3bdad6e32faf74cae7321e0bcef83846d5351,6,66,15,51,0,0,0,4,26,1570,1,4,2.359374729,713,0,0,103,98,5,5272,4846,426,49,48,1,100
c175a63b64ee5440a906ad9dcbd298334c2c2555,0,0,0,0,0,0,0,0,0,0,0,0,0,0,3,0,0,0,0,0,0,0,0,0,0,100
7c38a2977f498708fae9ca4c0a1710d1417922ee,0,0,0,0,0,0,0,0,0,0,0,0,0,0,79,1,0,0,0,0,0,0,0,0,0,100
52e4d6ee1cd9f79970da38df11934e637e52b65a,0,0,0,0,0,0,0,0,0,0,0,0,0,0,80,2,0,0,0,0,0,0,0,0,0,100
fc22ada98fa5cca84651ba3f7c788910b324d852,0,0,0,0,0,0,0,0,0,0,0,0,0,0,81,3,0,0,0,0,0,0,0,0,0,100
f40474e07550cc33e054607a66f6cbd40fd09250,0,0,0,0,0,0,0,0,0,0,0,0,0,0,82,4,0,0,0,0,0,0,0,0,0,100
1f49e55c71184fe73c754be4fa39dcb1db46d4cb,0,0,0,0,0,0,0,0,0,0,0,0,0,0,83,5,0,0,0,0,0,0,0,0,0,100
72654bf73c9eefec06001ab2d1181fbfb127922c,2,118,0,118,1,0,1,1,79,413,1,2,0.388902232,1548,18,0,468,461,7,11174,10488,686,199,194,5,93.83167799
e90c0c5cd7740a948fa49172e921bc88573ed699,3,68,8,60,0,0,0,7,66,90,1,3,1.046143074,1869,19,1,439,421,18,15630,15178,452,184,182,2,100
bfe1d03d683d67cdb9a984c02c6b1eb75ffe7689,2,1,47,46,0,0,0,20,67,0,1,2,0.337290067,1576,20,2,327,346,19,12078,12322,244,124,126,2,91.95652174
2459d95096a59559553bc4bd8c74cebf8a75d804,2,40,0,40,1,0,1,9,15,45,1,2,0.909736123,175,0,0,17,16,1,1533,1339,194,15,14,1,99.84553599
b882d5230991b42bd017601435ea059d7cd3b492,0,0,0,0,0,0,0,0,0,0,0,0,0,0,21,3,0,0,0,0,0,0,0,0,0,90.56657224
04928ad70d7c56f821f0cce2033984874c13f53a,0,0,0,0,0,0,0,0,0,0,0,0,0,0,0,0,0,0,0,0,0,0,0,0,0,100
f4e2ebaadaf6e6d99b59882233f8024243adb55d,0,0,0,0,0,0,0,0,0,0,0,0,0,0,73,1,0,0,0,0,0,0,0,0,0,90.56657224
0209b21a348ed7d0866c3dc46bfbcc780e86f2dd,1,4,4,0,0,0,0,4,5,23,1,1,0,45,1,1,4,4,0,230,230,0,2,2,0,90.56657224
8824d6577368cf29b867efcd331151259c24e7b0,0,0,0,0,0,0,0,0,0,0,0,0,0,0,22,4,0,0,0,0,0,0,0,0,0,100
6ebaa2d8ec5a72b459c2439a255096d67eb8bb9a,0,0,0,0,0,0,0,0,0,0,0,0,0,0,31,0,0,0,0,0,0,0,0,0,0,90.56657224
e0a6a770cbc597b635009a8cb5de3d9f5437bdfe,0,0,0,0,0,0,0,0,0,0,0,0,0,0,32,1,0,0,0,0,0,0,0,0,0,90.56657224
ba7a5895179f12521eccc0b18a5941d356fc117c,0,0,0,0,0,0,0,0,0,0,0,0,0,0,33,2,0,0,0,0,0,0,0,0,0,100
f67e53ac7e8592b609ba46ea9cd4d73c350baa85,0,0,0,0,0,0,0,0,0,0,0,0,0,0,0,0,0,0,0,0,0,0,0,0,0,100
c030d4201e315f62f11ea9757017c38239fa6a17,0,0,0,0,0,0,0,0,0,0,0,0,0,0,62,0,0,0,0,0,0,0,0,0,0,100
b934afe2fa7d6a6553d505b1db2a516374c886f3,0,0,0,0,0,0,0,0,0,0,0,0,0,0,63,1,0,0,0,0,0,0,0,0,0,100
860f45803c611c985683c9fc28482338d7dd5b3b,6,843,759,84,0,0,0,3,13,2166,1,1,1.959910899,4322,84,0,1129,1066,63,34674,30284,4390,477,466,11,100
5be7d16312fb3a0e1ea18c60a04ba0c1e92e1fc0,0,0,0,0,0,0,0,0,0,0,0,0,0,0,64,2,0,0,0,0,0,0,0,0,0,100
1fb064ddb647686a707f55290bd0fee83a366df1,0,0,0,0,0,0,0,0,0,0,0,0,0,0,34,3,0,0,0,0,0,0,0,0,0,100
b4e8bd84205c0d7f210a4c5783a934d7c9a55275,0,0,0,0,0,0,0,0,0,0,0,0,0,0,74,0,0,0,0,0,0,0,0,0,0,100
338db27462cbb442a60033f99fde7d92f863b28a,0,0,0,0,0,0,0,0,0,0,0,0,0,0,75,1,0,0,0,0,0,0,0,0,0,100
f0ee46dbceb4327f50a552ff32ad8c7641b43781,0,0,0,0,0,0,0,0,0,0,0,0,0,0,0,0,0,0,0,0,0,0,0,0,0,100
42822886c28ea74a744abb7e7a80a942c540faa5,0,0,0,0,0,0,0,0,0,0,0,0,0,0,0,0,0,0,0,0,0,0,0,0,0,100
0b13a87dae9e7379c6fd4c2e0e896f2efc188015,0,0,0,0,0,0,0,0,0,0,0,0,0,0,76,2,0,0,0,0,0,0,0,0,0,100
5bd7cfe0bf742d0482bf6f54b4541b4d22cc87d9,0,0,0,0,0,0,0,0,0,0,0,0,0,0,1,1,0,0,0,0,0,0,0,0,0,100
39de1e2049008415a01004dfefe7a875afbd66bd,0,0,0,0,0,0,0,0,0,0,0,0,0,0,77,3,0,0,0,0,0,0,0,0,0,100
0ceb3dfdd3ca8ec84f43aff9678e01cf47f3fbe2,0,0,0,0,0,0,0,0,0,0,0,0,0,0,35,1,0,0,0,0,0,0,0,0,0,100
563ca6af476ce56bc1be5b5b9be82e8809c41cfa,0,0,0,0,0,0,0,0,0,0,0,0,0,0,36,2,0,0,0,0,0,0,0,0,0,100
95876f284d59acb3d7993918bda9747a68f68b99,0,0,0,0,0,0,0,0,0,0,0,0,0,0,78,4,0,0,0,0,0,0,0,0,0,100
7c5e429ac5a71596844bf1d52626ce29054dd335,0,0,0,0,0,0,0,0,0,0,0,0,0,0,2,2,0,0,0,0,0,0,0,0,0,100
5b6e75cd29d7e78fd0422bc71b1dfad0bebe47d3,0,0,0,0,0,0,0,0,0,0,0,0,0,0,20,0,0,0,0,0,0,0,0,0,0,100
c9aee06dc78ee01b39aaacba7582bc431fb36ccf,0,0,0,0,0,0,0,0,0,0,0,0,0,0,79,5,0,0,0,0,0,0,0,0,0,100
4d3da1107b8c22b0b6a3b0853fa676553d35188c,0,0,0,0,0,0,0,0,0,0,0,0,0,0,21,1,0,0,0,0,0,0,0,0,0,100
c4168a0c0eccca5f117e2cc98e283fa73fe4ea91,0,0,0,0,0,0,0,0,0,0,0,0,0,0,80,6,0,0,0,0,0,0,0,0,0,100
8a5774b8a4942c40ee9279efeb712cfea8a1ce55,0,0,0,0,0,0,0,0,0,0,0,0,0,0,81,7,0,0,0,0,0,0,0,0,0,100
20d67fdd27404b9f240a8275774b91f567ed4419,0,0,0,0,0,0,0,0,0,0,0,0,0,0,37,3,0,0,0,0,0,0,0,0,0,100
83e31445a9cb2a7cf08c88f26fb7c7772bcbecfc,0,0,0,0,0,0,0,0,0,0,0,0,0,0,38,4,0,0,0,0,0,0,0,0,0,100
2b299efb6ce3b294991e3461304e4f1715579ddc,0,0,0,0,0,0,0,0,0,0,0,0,0,0,39,5,0,0,0,0,0,0,0,0,0,100
c769c4343e24d2473417afe46b37a1b60d7ca84f,0,0,0,0,0,0,0,0,0,0,0,0,0,0,3,3,0,0,0,0,0,0,0,0,0,100
e819e3677e6e46da6cb75b1dd41d66dc976d1ea0,0,0,0,0,0,0,0,0,0,0,0,0,0,0,40,5,0,0,0,0,0,0,0,0,0,100
89efb8dd7bef28945d0e9598d913aa9ec843593c,1,17,11,6,0,0,0,16,46,834,1,1,0,408,0,0,126,125,1,3108,3062,46,34,33,1,100
589a9be3387aea2ad3c356964256eaff7645c3c2,0,0,0,0,0,0,0,0,0,0,0,0,0,0,41,6,0,0,0,0,0,0,0,0,0,100
d6e6fc068f8c0eaaf84d81b623744d363ece294d,0,0,0,0,0,0,0,0,0,0,0,0,0,0,42,7,0,0,0,0,0,0,0,0,0,100
a3befb526c0e011036b66649c2360a8c1c7d9419,0,0,0,0,0,0,0,0,0,0,0,0,0,0,43,8,0,0,0,0,0,0,0,0,0,100
357b8fad6464ab25f8e03385ca54d1ce8ec63543,0,0,0,0,0,0,0,0,0,0,0,0,0,0,44,9,0,0,0,0,0,0,0,0,0,100
0c9a60eba295adf9b92f785f204b5b2875ef5ac5,0,0,0,0,0,0,0,0,0,0,0,0,0,0,4,1,0,0,0,0,0,0,0,0,0,100
b47eda9d130f09847d5c666ce8b057196963b578,0,0,0,0,0,0,0,0,0,0,0,0,0,0,16,0,0,0,0,0,0,0,0,0,0,100
4961457f91d08a5907ebd71ca9ed088cea30f342,0,0,0,0,0,0,0,0,0,0,0,0,0,0,85,0,0,0,0,0,0,0,0,0,0,100
c5cfc6c712af06487e54e52b3983c32949650f3e,0,0,0,0,0,0,0,0,0,0,0,0,0,0,45,5,0,0,0,0,0,0,0,0,0,100
493ff8a966e17fa5bf6e293aa64afc156915d624,0,0,0,0,0,0,0,0,0,0,0,0,0,0,46,6,0,0,0,0,0,0,0,0,0,100
7df18d6fa83c2ed6e3bd69b5cc84e5b6815fb280,0,0,0,0,0,0,0,0,0,0,0,0,0,0,47,7,0,0,0,0,0,0,0,0,0,100
e25282a9bc53eb3558ec36d9daf72e84ba5145c1,0,0,0,0,0,0,0,0,0,0,0,0,0,0,48,8,0,0,0,0,0,0,0,0,0,100
101b8327a0f143bc141d75a37c8e8f601137fbda,0,0,0,0,0,0,0,0,0,0,0,0,0,0,49,9,0,0,0,0,0,0,0,0,0,100
4fd00e0f3f7d925422293f7b64eb9827e69f9c6a,0,0,0,0,0,0,0,0,0,0,0,0,0,0,86,1,0,0,0,0,0,0,0,0,0,100
2ad9d3c69b29f9ea344a93f841fe57de683a520b,0,0,0,0,0,0,0,0,0,0,0,0,0,0,87,2,0,0,0,0,0,0,0,0,0,100
50676f142fad5d685d9f0e24a7f2e9d01e6eb8e8,0,0,0,0,0,0,0,0,0,0,0,0,0,0,88,3,0,0,0,0,0,0,0,0,0,100
e177951d56d3a7cbacc8165abf7d98da743db0e9,0,0,0,0,0,0,0,0,0,0,0,0,0,0,50,8,0,0,0,0,0,0,0,0,0,100
31c4092b13cf22a2adb3a7a7925cde0a79a970f4,0,0,0,0,0,0,0,0,0,0,0,0,0,0,51,9,0,0,0,0,0,0,0,0,0,100
1f00455e496be35a941833e956376ef3d791116b,0,0,0,0,0,0,0,0,0,0,0,0,0,0,89,4,0,0,0,0,0,0,0,0,0,100
ffac9093dc183afb790ab2c01f691d8527c5fff1,0,0,0,0,0,0,0,0,0,0,0,0,0,0,52,10,0,0,0,0,0,0,0,0,0,100
18890afe3d728a0c1ef1f2aba46155c32cf0d567,0,0,0,0,0,0,0,0,0,0,0,0,0,0,90,5,0,0,0,0,0,0,0,0,0,100
c17df618cbf717b17a0e906aa4200b0ce9daebc9,1,2,5,3,0,0,0,9,37,1341,1,1,0,784,91,6,90,91,1,7734,7745,11,76,76,0,100
01b174a161892802f22c6424e800ded903084078,6,11,12,1,0,0,0,3,34,1226,1,6,2.474891718,1456,92,7,256,256,0,10767,10756,11,76,76,0,100
4be83e4a6768bcae90d43c20a914d082850ffd76,0,0,0,0,0,0,0,0,0,0,0,0,0,0,93,8,0,0,0,0,0,0,0,0,0,100
3f34bf8b65df1190c54d80f437d47f76a029de76,3,90,18,72,0,0,0,21,69,377,1,3,1.048980446,1904,22,0,441,429,12,16498,16121,377,142,135,7,100
1ac15edc8609d700aa0ed5ece207ab904f1a8623,2,24,3,21,0,0,0,12,83,824,1,2,0.999010271,1646,1,0,384,380,4,13747,13588,159,141,138,3,100
546f9f9f11152a024a035df567b5d329d2acf46f,0,0,0,0,0,0,0,0,0,0,0,0,0,0,53,6,0,0,0,0,0,0,0,0,0,100
ad4083b097257ac72e5cf32985e757aa09107b6e,0,0,0,0,0,0,0,0,0,0,0,0,0,0,17,0,0,0,0,0,0,0,0,0,0,100
d1ad56f762ab19a20f10000498e7c867532aa422,18,35,31,4,0,0,0,3,80,1738,1,13,3.703147909,3685,94,8,881,881,0,24885,24885,0,385,385,0,100
08d9f1998836355526d12a9f09b904b23e7ccb1f,0,0,0,0,0,0,0,0,0,0,0,0,0,0,95,9,0,0,0,0,0,0,0,0,0,100
69871012fffdd6de82b32c194e7a1880320fa700,32,394,175,219,0,0,0,2,41,1393,1,15,4.582990356,9743,96,9,1117,1117,0,87793,85336,2457,724,724,0,100
103477369fcb49a5372f9f5c1353fcd575119287,10,35,15,20,0,0,0,14,42,608,1,3,3.155084952,2102,3,0,555,553,2,18933,18855,78,334,332,2,100
389d35131af037bbf3bd5da739528a13191ade43,0,0,0,0,0,0,0,0,0,0,0,0,0,0,18,1,0,0,0,0,0,0,0,0,0,100
224e2bb3bae5ea22a38689b665ff730bae6a796b,0,0,0,0,0,0,0,0,0,0,0,0,0,0,19,2,0,0,0,0,0,0,0,0,0,100
759b63d90a6d8712b1e344254c5d32f350cda66a,0,0,0,0,0,0,0,0,0,0,0,0,0,0,54,1,0,0,0,0,0,0,0,0,0,100
7d4dbee18244824f3bfea90247ee4a3e27b7b822,0,0,0,0,0,0,0,0,0,0,0,0,0,0,55,2,0,0,0,0,0,0,0,0,0,100
68708e718c8f3731768644305b15fcdca2e30a77,2,7,0,7,0,0,0,12,81,538,1,2,0.863120569,1861,0,0,503,501,2,13445,13398,47,232,231,1,100
542b65d174759f32666139422d848daccc4a1c3d,0,0,0,0,0,0,0,0,0,0,0,0,0,0,69,0,0,0,0,0,0,0,0,0,0,100
93d5e2110ca867c6c6611f8715c0934e437518c7,0,0,0,0,0,0,0,0,0,0,0,0,0,0,5,0,0,0,0,0,0,0,0,0,0,100
36974d0e87f6b1af34d3575403afd22c62b728d5,0,0,0,0,0,0,0,0,0,0,0,0,0,0,97,3,0,0,0,0,0,0,0,0,0,100
df51e78752030c5ac929bd9adbb6fe1739a28485,0,0,0,0,0,0,0,0,0,0,0,0,0,0,0,0,0,0,0,0,0,0,0,0,0,100
2bbac9e8c6ebbf462e6610b699f852b8df835668,0,0,0,0,0,0,0,0,0,0,0,0,0,0,56,2,0,0,0,0,0,0,0,0,0,100
282ed6171792d30e9d15336e2ec2c289db7efd48,0,0,0,0,0,0,0,0,0,0,0,0,0,0,57,3,0,0,0,0,0,0,0,0,0,100
b51f7158b4af6b3e54918ad89aca79f76200c460,0,0,0,0,0,0,0,0,0,0,0,0,0,0,58,4,0,0,0,0,0,0,0,0,0,100
04015fed09065138679e5e90fcf8615ffb5f4e6e,0,0,0,0,0,0,0,0,0,0,0,0,0,0,70,1,0,0,0,0,0,0,0,0,0,100
be168d7d19ede539b45d42c4a310b979a7406486,0,0,0,0,0,0,0,0,0,0,0,0,0,0,71,2,0,0,0,0,0,0,0,0,0,100
817c85a2cc30c24ce2032eecccef7a7c50b6979a,0,0,0,0,0,0,0,0,0,0,0,0,0,0,72,3,0,0,0,0,0,0,0,0,0,100
72a0fef3e9247bd94621288fb2e6d88408e3c836,0,0,0,0,0,0,0,0,0,0,0,0,0,0,73,4,0,0,0,0,0,0,0,0,0,100
d979758d43f58c8c7cae38c246d8821c4e61fa31,0,0,0,0,0,0,0,0,0,0,0,0,0,0,59,3,0,0,0,0,0,0,0,0,0,100
d67e6adcb307d159517c811eee60e62f90c265d3,0,0,0,0,0,0,0,0,0,0,0,0,0,0,60,4,0,0,0,0,0,0,0,0,0,100
bdff7574f386ca317f37584531928641a66d1b96,0,0,0,0,0,0,0,0,0,0,0,0,0,0,61,5,0,0,0,0,0,0,0,0,0,100
c8f953bc5e6599b90283992b643bdc91adbef84b,0,0,0,0,0,0,0,0,0,0,0,0,0,0,74,5,0,0,0,0,0,0,0,0,0,100
88a6014b17b36eb94df9e9208c5cc44449c1da51,0,0,0,0,0,0,0,0,0,0,0,0,0,0,98,1,0,0,0,0,0,0,0,0,0,100
7f15e3d52d0066b04c11e94b7dc9a3959cb3859b,0,0,0,0,0,0,0,0,0,0,0,0,0,0,99,2,0,0,0,0,0,0,0,0,0,100
f84c53c1fb066db34fef53ab4694ff2d44462b16,0,0,0,0,0,0,0,0,0,0,0,0,0,0,100,3,0,0,0,0,0,0,0,0,0,100
e80bd2542243619673b7b3072da892a1afb9ac68,0,0,0,0,0,0,0,0,0,0,0,0,0,0,101,4,0,0,0,0,0,0,0,0,0,100
8cf8e7070958a4a287e0f1a138f1eea9d0c31fc9,0,0,0,0,0,0,0,0,0,0,0,0,0,0,102,5,0,0,0,0,0,0,0,0,0,100
25187ec39d3564b0e564baec53365c9cce565b74,0,0,0,0,0,0,0,0,0,0,0,0,0,0,75,5,0,0,0,0,0,0,0,0,0,100
0c96242bb7816cfe0d61ac8ff25c8572c3d9e2e6,0,0,0,0,0,0,0,0,0,0,0,0,0,0,76,6,0,0,0,0,0,0,0,0,0,100
9f2f2d52b5449f82f4c7fa8db8581bc16ef70d1f,0,0,0,0,0,0,0,0,0,0,0,0,0,0,77,7,0,0,0,0,0,0,0,0,0,100
8c156bd10af22f5bda22a926f86c21e93b12ab4e,0,0,0,0,0,0,0,0,0,0,0,0,0,0,78,8,0,0,0,0,0,0,0,0,0,100
b0b86bf2887ed259882a7355f4573d25629fd776,0,0,0,0,0,0,0,0,0,0,0,0,0,0,20,0,0,0,0,0,0,0,0,0,0,100
981c88a68a37012c9e7f9c26bd6982bfaaf469ea,0,0,0,0,0,0,0,0,0,0,0,0,0,0,62,3,0,0,0,0,0,0,0,0,0,100
2ab8fa85d05f04387bd5d63b10ad1c8fd2243616,0,0,0,0,0,0,0,0,0,0,0,0,0,0,63,4,0,0,0,0,0,0,0,0,0,100
67818ad2069916f25af7cc27bd192d66359aa372,0,0,0,0,0,0,0,0,0,0,0,0,0,0,98,0,0,0,0,0,0,0,0,0,0,100
14108018e886257cb629d84e85bf3148efcb4095,0,0,0,0,0,0,0,0,0,0,0,0,0,0,64,2,0,0,0,0,0,0,0,0,0,100
4db2e32cbdf5577c62e9770e8387d1d312b2bfce,0,0,0,0,0,0,0,0,0,0,0,0,0,0,79,4,0,0,0,0,0,0,0,0,0,100
c58e23b5770a6710491f7136e1279ef408fe8f40,0,0,0,0,0,0,0,0,0,0,0,0,0,0,99,1,0,0,0,0,0,0,0,0,0,100
95edb5b6506015093dad197377bd021fa94776e2,0,0,0,0,0,0,0,0,0,0,0,0,0,0,80,5,0,0,0,0,0,0,0,0,0,100
6dc6055e04188919886bd1b4ed95a7c6f4fac23e,0,0,0,0,0,0,0,0,0,0,0,0,0,0,81,6,0,0,0,0,0,0,0,0,0,100
b3944584e0dfea7c945902bde1d850b346aed4fd,0,0,0,0,0,0,0,0,0,0,0,0,0,0,103,0,0,0,0,0,0,0,0,0,0,100
5fd979fafe50cb55f0cd8129d45be0e1f15c4015,0,0,0,0,0,0,0,0,0,0,0,0,0,0,106,3,0,0,0,0,0,0,0,0,0,100
d8a08cec5cbb7962b09f019f32325a9072df52d3,0,0,0,0,0,0,0,0,0,0,0,0,0,0,65,1,0,0,0,0,0,0,0,0,0,100
9855c0eb737973e7a3976e2d85d40b41201be56d,0,0,0,0,0,0,0,0,0,0,0,0,0,0,66,2,0,0,0,0,0,0,0,0,0,100
94698e2a5f3ee5ec3a62a859c5c6a5965e835409,0,0,0,0,0,0,0,0,0,0,0,0,0,0,67,3,0,0,0,0,0,0,0,0,0,100
11621b56a5c0729d92b77974e0cd7835dab57356,0,0,0,0,0,0,0,0,0,0,0,0,0,0,82,3,0,0,0,0,0,0,0,0,0,100
a3e4572dc6de4097cdf9d1e9fe984ed59ba281ad,0,0,0,0,0,0,0,0,0,0,0,0,0,0,83,4,0,0,0,0,0,0,0,0,0,100
ea371817d2e148531bc9bae959939e2911be22b6,0,0,0,0,0,0,0,0,0,0,0,0,0,0,84,5,0,0,0,0,0,0,0,0,0,100
b2abc70bb85a5b515790d0ada7be212fadd5cce1,0,0,0,0,0,0,0,0,0,0,0,0,0,0,85,6,0,0,0,0,0,0,0,0,0,100
abee9574e0f8bbd8937dc20a6fc7ec1d6ba5eada,0,0,0,0,0,0,0,0,0,0,0,0,0,0,68,3,0,0,0,0,0,0,0,0,0,100
bd63189c2e1857e68e5266b42ab9b5247f3791a5,0,0,0,0,0,0,0,0,0,0,0,0,0,0,69,4,0,0,0,0,0,0,0,0,0,100
093f576cad4106d14eaf2129286c1bbdfbff574a,0,0,0,0,0,0,0,0,0,0,0,0,0,0,70,5,0,0,0,0,0,0,0,0,0,100
73b5fa85db895f239fc683a3225d833ec659b67c,0,0,0,0,0,0,0,0,0,0,0,0,0,0,71,6,0,0,0,0,0,0,0,0,0,100
5bb032029bb2e07e5b9175b72bbf72a6fdef4289,0,0,0,0,0,0,0,0,0,0,0,0,0,0,82,0,0,0,0,0,0,0,0,0,0,100
6c4e165584431aeb21ff8f84fe1cefc5c398fa8e,0,0,0,0,0,0,0,0,0,0,0,0,0,0,86,5,0,0,0,0,0,0,0,0,0,100
3b5cdb919ca2b40bb67d806554e98a008dfa07b1,0,0,0,0,0,0,0,0,0,0,0,0,0,0,87,5,0,0,0,0,0,0,0,0,0,100
e813d7ae065c3f58bd9f1b3a7396d3bcf3d8f4ee,0,0,0,0,0,0,0,0,0,0,0,0,0,0,107,0,0,0,0,0,0,0,0,0,0,100
72b3c51512752f471392e3e5eaa40f954a99b752,1,6,2,4,0,0,0,7,11,812,1,1,0,384,0,0,70,69,1,2417,2403,14,30,30,0,100
8dd55dbac12103c4e81be199a7d819e8e8fb5b56,2,42,1,41,0,0,0,12,25,697,1,2,0.99648599,1889,0,0,352,347,5,18895,18677,218,326,322,4,100
c4bc1da6b28f326e7c33b434627ce980c31d78fe,0,0,0,0,0,0,0,0,0,0,0,0,0,0,72,0,0,0,0,0,0,0,0,0,0,100
4a5e4a686e55882d48c527328502700c765f1772,0,0,0,0,0,0,0,0,0,0,0,0,0,0,0,0,0,0,0,0,0,0,0,0,0,100
45f425f022c64c06e6ac29df47ca2dbbbbe35fdf,0,0,0,0,0,0,0,0,0,0,0,0,0,0,73,1,0,0,0,0,0,0,0,0,0,100
f468930a1e119517491ed4e64b1bbd2906446b49,0,0,0,0,0,0,0,0,0,0,0,0,0,0,6,0,0,0,0,0,0,0,0,0,0,100
1b630a9b5099051ea6cb63a37f7ca13e949a6343,0,0,0,0,0,0,0,0,0,0,0,0,0,0,74,2,0,0,0,0,0,0,0,0,0,100
a2cfd3519c20a3022c11ff01c1f42acfad6b0108,0,0,0,0,0,0,0,0,0,0,0,0,0,0,0,0,0,0,0,0,0,0,0,0,0,100
a9e3915732fc29a47b150a902f5f5cdf666b502c,0,0,0,0,0,0,0,0,0,0,0,0,0,0,75,3,0,0,0,0,0,0,0,0,0,100
ff8b0300e796a65cff0e2df6ac912300e03cc0a4,0,0,0,0,0,0,0,0,0,0,0,0,0,0,76,4,0,0,0,0,0,0,0,0,0,100
ccb7a50077cb672407296935ffd6bacf2890ec83,0,0,0,0,0,0,0,0,0,0,0,0,0,0,77,4,0,0,0,0,0,0,0,0,0,100
d303de5c1e1e9d1348a2a3b0de847d6a80025f00,0,0,0,0,0,0,0,0,0,0,0,0,0,0,1,0,0,0,0,0,0,0,0,0,0,100
340eb3ad0d4efdcdd9646decf5f2d9fe15352d89,0,0,0,0,0,0,0,0,0,0,0,0,0,0,78,3,0,0,0,0,0,0,0,0,0,100
fca3cb41b40a0b048a43ca33c74262e89afa278b,0,0,0,0,0,0,0,0,0,0,0,0,0,0,21,0,0,0,0,0,0,0,0,0,0,100
0980ddac4c0707c22cf71a8dddeb1e8b42cc0dee,0,0,0,0,0,0,0,0,0,0,0,0,0,0,79,3,0,0,0,0,0,0,0,0,0,100
ba3ad6d7db72cb063c559babc1ef4ff8cb1c0c32,1,2,2,0,0,0,0,9,24,2333,1,1,0,327,19,0,61,61,0,2062,2062,0,39,39,0,100
d1b4810a12e369cc94b4166037b29462275f409f,0,0,0,0,0,0,0,0,0,0,0,0,0,0,2,1,0,0,0,0,0,0,0,0,0,100
914a6f2ef561c655ab64d81a35cbde1fb83b4c9d,1,2,2,0,0,0,0,8,23,251,1,1,0,327,0,0,61,61,0,2062,2062,0,39,39,0,100
3abe819c3b8a5a5666081a14a7e85be47cb19104,1,2,2,0,0,0,0,9,24,2333,1,1,0,327,80,0,61,61,0,2062,2062,0,39,39,0,100
1410e79f9df61669c2d52f6d0643e6c35156e615,0,0,0,0,0,0,0,0,0,0,0,0,0,0,81,1,0,0,0,0,0,0,0,0,0,100
0a5d4c99c21d588d83e2eca2e658b0533c65d391,0,0,0,0,0,0,0,0,0,0,0,0,0,0,0,0,0,0,0,0,0,0,0,0,0,100
411b6b9cbe4046abdc9cc4293ebd9f2548f37b64,1,1,0,1,0,0,0,12,19,326,1,1,0,309,2,0,39,39,0,2869,2867,2,38,38,0,100
6a1d0f3a1c3b39350a27802bb1df18434985fe4b,0,0,0,0,0,0,0,0,0,0,0,0,0,0,23,0,0,0,0,0,0,0,0,0,0,100
0dc26365c209c22161b16fc3a7665007aa0f9ea7,0,0,0,0,0,0,0,0,0,0,0,0,0,0,88,0,0,0,0,0,0,0,0,0,0,100
e8c61ba4f0051a76d4bf2e2d4391ec92a6e90f4f,0,0,0,0,0,0,0,0,0,0,0,0,0,0,89,1,0,0,0,0,0,0,0,0,0,100
042593d21a22918b2c3920470bbe0b5e586313e9,0,0,0,0,0,0,0,0,0,0,0,0,0,0,24,1,0,0,0,0,0,0,0,0,0,100
9fd2b0e1f7da1c53e02803f2666ed08e19883ed4,1,9,0,9,0,0,0,5,5,1384,1,1,0,52,25,2,5,4,1,336,271,65,5,4,1,100
39c0069521015537d976786cf57b6b4990b1a8c1,0,0,0,0,0,0,0,0,0,0,0,0,0,0,90,2,0,0,0,0,0,0,0,0,0,100
6a0e712e5d027ea0e8b3a9ee30ebc139bf0b842b,0,0,0,0,0,0,0,0,0,0,0,0,0,0,82,0,0,0,0,0,0,0,0,0,0,100
5a2a26bc68ae4642d3ac4839b606a6a479ac8c04,0,0,0,0,0,0,0,0,0,0,0,0,0,0,26,3,0,0,0,0,0,0,0,0,0,100
4654e621888e631fa6980e83efa8cb100a272378,0,0,0,0,0,0,0,0,0,0,0,0,0,0,83,1,0,0,0,0,0,0,0,0,0,100
5d9984ef07d821d40d70341e2848a3b312798e5c,0,0,0,0,0,0,0,0,0,0,0,0,0,0,0,0,0,0,0,0,0,0,0,0,0,100
c0874195b66005615487c56ffdf9a32fb2557d8b,0,0,0,0,0,0,0,0,0,0,0,0,0,0,84,2,0,0,0,0,0,0,0,0,0,100
6d92d7a0f0a9345df412496ede11cc33471d12d8,0,0,0,0,0,0,0,0,0,0,0,0,0,0,85,3,0,0,0,0,0,0,0,0,0,100
e15c34cc6ce7be9c172253ec528942aa8ded4ce1,0,0,0,0,0,0,0,0,0,0,0,0,0,0,0,0,0,0,0,0,0,0,0,0,0,100
46ef00a3da71cefa7ace866c203f7969b026009a,0,0,0,0,0,0,0,0,0,0,0,0,0,0,65,0,0,0,0,0,0,0,0,0,0,100
1dbb2312163aed49937f1d96d57b305d44e39ed3,0,0,0,0,0,0,0,0,0,0,0,0,0,0,27,4,0,0,0,0,0,0,0,0,0,100
cf7bfe7710febdc84e70fcc8ad21d859dbf1be1f,0,0,0,0,0,0,0,0,0,0,0,0,0,0,81,0,0,0,0,0,0,0,0,0,0,100
289a3cfdcf5ef6950dc433d10113d860bad4c382,0,0,0,0,0,0,0,0,0,0,0,0,0,0,82,1,0,0,0,0,0,0,0,0,0,100
289c193d02f9639c437692878fcad83087a4c5be,0,0,0,0,0,0,0,0,0,0,0,0,0,0,83,2,0,0,0,0,0,0,0,0,0,100
e285a8a222e6610db4eb7dd7497b4324e50ac177,0,0,0,0,0,0,0,0,0,0,0,0,0,0,84,3,0,0,0,0,0,0,0,0,0,100
ae84185254c70ada10ad93dbc7b362f934b05254,0,0,0,0,0,0,0,0,0,0,0,0,0,0,85,4,0,0,0,0,0,0,0,0,0,100
5ad692bb5f4c29433a7a737ff3b01d24315aad52,0,0,0,0,0,0,0,0,0,0,0,0,0,0,0,0,0,0,0,0,0,0,0,0,0,100
60e2da37f103868c5b776eaa22e7de6c41a7cf00,0,0,0,0,0,0,0,0,0,0,0,0,0,0,1,1,0,0,0,0,0,0,0,0,0,100
444ea493f2f210f7d9839b153f97d72671e64a7a,0,0,0,0,0,0,0,0,0,0,0,0,0,0,66,1,0,0,0,0,0,0,0,0,0,100
b6491f3f9d196867f52393985d849af54f245fbd,0,0,0,0,0,0,0,0,0,0,0,0,0,0,2,2,0,0,0,0,0,0,0,0,0,100
5978d6f558e7d1d15bcbc45ba1713116655c317d,0,0,0,0,0,0,0,0,0,0,0,0,0,0,86,4,0,0,0,0,0,0,0,0,0,100
4a9f9876f4839c668ebc6b4ce158678215a6704a,0,0,0,0,0,0,0,0,0,0,0,0,0,0,86,5,0,0,0,0,0,0,0,0,0,100
39b849e9aceecf9547d3bf4e8879ba7f227aa941,0,0,0,0,0,0,0,0,0,0,0,0,0,0,87,5,0,0,0,0,0,0,0,0,0,100
1e44880328fb1e1c8f6e98d863c9d36938316904,0,0,0,0,0,0,0,0,0,0,0,0,0,0,0,0,0,0,0,0,0,0,0,0,0,100
79a1ae9dc81873cfd767a23003846bea0f51c936,0,0,0,0,0,0,0,0,0,0,0,0,0,0,87,6,0,0,0,0,0,0,0,0,0,100
a50d65c5f446708483e1fabcd816ceb3b76bcf81,0,0,0,0,0,0,0,0,0,0,0,0,0,0,88,6,0,0,0,0,0,0,0,0,0,100
fe40576cd22e93776e7e48302f4d3358b0b4a4e3,0,0,0,0,0,0,0,0,0,0,0,0,0,0,0,0,0,0,0,0,0,0,0,0,0,100
1f1efa7a04981ac458e1889d33f7a70429e9eca7,0,0,0,0,0,0,0,0,0,0,0,0,0,0,0,0,0,0,0,0,0,0,0,0,0,100
62a2d3f0e1490ae110059823af3aeda008b8a912,0,0,0,0,0,0,0,0,0,0,0,0,0,0,1,1,0,0,0,0,0,0,0,0,0,100
d4cad4813f34252bf09f2b2ef8eca9795848a144,0,0,0,0,0,0,0,0,0,0,0,0,0,0,88,7,0,0,0,0,0,0,0,0,0,100
b815566e0f3ad3840588019b4cad6f3b6fb54971,0,0,0,0,0,0,0,0,0,0,0,0,0,0,0,0,0,0,0,0,0,0,0,0,0,100
4c9d326c9d8fc0320256034132fa6bbc90a37aa9,0,0,0,0,0,0,0,0,0,0,0,0,0,0,1,1,0,0,0,0,0,0,0,0,0,100
9418a49ef1c02a3d4192f94ac24b93e8cc58bdff,0,0,0,0,0,0,0,0,0,0,0,0,0,0,67,2,0,0,0,0,0,0,0,0,0,100
184b9b04bb51cbc294d180316fa5dc200ef6d98f,0,0,0,0,0,0,0,0,0,0,0,0,0,0,1,0,0,0,0,0,0,0,0,0,0,100
0341f4dd09024495d8a49b06212697c17b8f973e,0,0,0,0,0,0,0,0,0,0,0,0,0,0,3,3,0,0,0,0,0,0,0,0,0,100
36f5f97f6330184594edaca84a829313b7c83bcf,0,0,0,0,0,0,0,0,0,0,0,0,0,0,89,7,0,0,0,0,0,0,0,0,0,100
97d4dd72d3102233721d95a85bb5000dcf32396b,1,22,0,22,0,0,0,24,84,413,1,1,0,1059,20,0,338,336,2,7746,7564,182,107,106,1,100
6a2d7e72744bee6eb954a516bfa455e430071b99,0,0,0,0,0,0,0,0,0,0,0,0,0,0,89,8,0,0,0,0,0,0,0,0,0,100
b951829f06be7654d9543e89ff25a8b81abb3046,0,0,0,0,0,0,0,0,0,0,0,0,0,0,90,9,0,0,0,0,0,0,0,0,0,100
6322fad07a01cba1f62a2f41b891b000832370ed,2,36,3,33,0,0,0,5,13,2454,1,2,0.858230793,128,0,0,25,20,5,1055,777,278,12,11,1,99.97382199
2a353f42c18169756d04750fc3d056f1f3e7a292,0,0,0,0,0,0,0,0,0,0,0,0,0,0,1,0,0,0,0,0,0,0,0,0,0,100
b94de96866740ad3beb19d6f6784bc341aadf5a0,10,409,54,355,3,0,3,9,68,542,1,8,2.769175274,2694,2,0,600,569,31,22237,20917,1320,285,260,25,99.84317825
c5ffd6e4fa5a231e2b37cf0f165b9fe4fc4c3c6c,6,85,74,11,1,0,1,1,25,1361,1,2,2.457553603,691,21,1,110,118,8,3819,3948,129,74,78,4,99.84346465
82a7bb62a3a24d01ce33d6e4cec33387f582aad7,10,50,50,0,0,0,0,15,43,799,1,4,1.250663546,3266,23,0,864,864,0,28601,28591,10,512,512,0,100
d2468e342b26fc613741363bd41d47e365d831b8,1,0,28,28,0,0,0,4,4,2492,1,1,0,264,0,0,29,33,4,1632,1769,137,23,27,4,100
c86b34d01e80e19c58f28d4104b280a3e6b891f9,2,48,1,47,0,0,0,9,22,1088,1,2,0.948613198,252,28,0,41,38,3,1835,1528,307,27,24,3,100
00a4f5c486baf2876bb0aaa3d1978285f0cf1d0a,2,96,9,87,1,0,1,1,49,232,1,2,0.512709142,421,0,0,130,128,2,3727,3157,570,36,35,1,99.89575189
3fe5e306eaa43bdc06cef291321a8c04058a6be9,2,10,15,5,0,0,0,8,14,1684,1,2,0.40217919,210,1,0,23,23,0,1412,1461,49,12,12,0,100
14b381b576f9ceb86062f6e68708cc3343abf869,0,0,0,0,0,0,0,0,0,0,0,0,0,0,3,0,0,0,0,0,0,0,0,0,0,100
da39228b606c9260652aaa583f460cb74997b197,17,357,54,303,7,0,7,1,82,903,1,11,3.429554301,3325,29,1,907,901,6,23729,22978,751,353,343,10,99.58516982
a86dde293841a5f7856c11c799ca6561e6745419,0,0,0,0,0,0,0,0,0,0,0,0,0,0,0,0,0,0,0,0,0,0,0,0,0,100
753ff034cd853359ee1531a44d4ee8c4b85d8976,0,0,0,0,0,0,0,0,0,0,0,0,0,0,68,0,0,0,0,0,0,0,0,0,0,100
0789cb7d98608bc8ff8add3b395dddd464ba23c5,0,0,0,0,0,0,0,0,0,0,0,0,0,0,30,2,0,0,0,0,0,0,0,0,0,100
8f0b8d68c3fc10b6a5fc09bae4a5c30defe53897,0,0,0,0,0,0,0,0,0,0,0,0,0,0,31,3,0,0,0,0,0,0,0,0,0,100
dee5e32f8581107c28f73dc95fff74c0b4efc6f1,0,0,0,0,0,0,0,0,0,0,0,0,0,0,22,0,0,0,0,0,0,0,0,0,0,100
131f2c503b38ca7513fc9657205c7c67db3ab3ba,0,0,0,0,0,0,0,0,0,0,0,0,0,0,32,3,0,0,0,0,0,0,0,0,0,100
fb398e0ddbdd67ae50909533f55defe52488e5da,0,0,0,0,0,0,0,0,0,0,0,0,0,0,4,1,0,0,0,0,0,0,0,0,0,100
0f4197d94cb4672e756129d49af5c52591e2528f,0,0,0,0,0,0,0,0,0,0,0,0,0,0,23,1,0,0,0,0,0,0,0,0,0,100
e5811b404ac01fac0d0d6e223d62441554c9cbe9,0,0,0,0,0,0,0,0,0,0,0,0,0,0,90,0,0,0,0,0,0,0,0,0,0,100
0ebd940282edfcec20c0d18faca68ea26ee31733,0,0,0,0,0,0,0,0,0,0,0,0,0,0,4,0,0,0,0,0,0,0,0,0,0,100
a1fce29d9675b4dd95dfee9db32cc505d0b2227c,0,0,0,0,0,0,0,0,0,0,0,0,0,0,0,0,0,0,0,0,0,0,0,0,0,100
99547e0ee2e0a4a839253848d7b34bac7f5e4cea,2,27,6,21,0,0,0,23,69,166,1,2,0.195909271,1642,0,0,350,347,3,13110,12973,137,138,137,1,100
de50c244c00420825d4bd7d04c0c2d353e439367,0,0,0,0,0,0,0,0,0,0,0,0,0,0,24,0,0,0,0,0,0,0,0,0,0,100
64267e1f4e54a12551d02ff85e41c18090917e69,0,0,0,0,0,0,0,0,0,0,0,0,0,0,0,0,0,0,0,0,0,0,0,0,0,100
0332fdfdf07343f33e6c9e2c28c491cd80c0bb88,1,39,0,39,1,0,1,1,1,0,1,1,0,0,1,1,2,0,2,114,0,114,1,0,1,99.94840041
527221aeff36587ecf5689a11114399494c2fceb,0,0,0,0,0,0,0,0,0,0,0,0,0,0,91,0,0,0,0,0,0,0,0,0,0,100
24ab2812eae62ac921bf03e0c1c41d1993f6551c,0,0,0,0,0,0,0,0,0,0,0,0,0,0,92,1,0,0,0,0,0,0,0,0,0,100
c1dd47e9388bc30922f043877df15caedaff23af,0,0,0,0,0,0,0,0,0,0,0,0,0,0,33,0,0,0,0,0,0,0,0,0,0,100
d206242f3f8438421122accb87898a28eda1ea75,0,0,0,0,0,0,0,0,0,0,0,0,0,0,2,2,0,0,0,0,0,0,0,0,0,100
0e74de1eedc90418731d14ce51528b84dc3caf24,1,93,0,93,1,0,1,1,1,0,1,1,0,0,3,3,11,0,11,443,0,443,11,0,11,99.94845361
7d851528a5e833c5bb10a54b080b8c347cdcb2c9,0,0,0,0,0,0,0,0,0,0,0,0,0,0,93,2,0,0,0,0,0,0,0,0,0,100
7e97a1084e11851a2614677dc088734758594049,10,537,4,533,4,0,4,1,26,1252,1,6,2.719423044,432,4,4,102,56,46,5483,2591,2892,60,25,35,99.71736896
69acacd50e06e489e953f8948ee6a36759c814a0,0,0,0,0,0,0,0,0,0,0,0,0,0,0,94,3,0,0,0,0,0,0,0,0,0,100
d568e6d618e87ce176ba4f4dce29f44dc6da0507,0,0,0,0,0,0,0,0,0,0,0,0,0,0,34,1,0,0,0,0,0,0,0,0,0,100
c528cfd7582ccb67da5789bc6b114294f89805f4,0,0,0,0,0,0,0,0,0,0,0,0,0,0,0,0,0,0,0,0,0,0,0,0,0,100
8a5fc3cd17bdf6211097daf237e1e149efa78b56,0,0,0,0,0,0,0,0,0,0,0,0,0,0,1,1,0,0,0,0,0,0,0,0,0,100
895cdc8e2ebbf0341f292ff4ea684bf9cfbc68cb,0,0,0,0,0,0,0,0,0,0,0,0,0,0,0,0,0,0,0,0,0,0,0,0,0,100
a946ea706b933606540bc2afae4b81cf14cdbeb0,0,0,0,0,0,0,0,0,0,0,0,0,0,0,91,0,0,0,0,0,0,0,0,0,0,100
57e0bbf961d0bffafe6dceddadc65f0defd84d80,0,0,0,0,0,0,0,0,0,0,0,0,0,0,0,0,0,0,0,0,0,0,0,0,0,100
33d86a61a9d225d83349ffbda21d2b31eeefe7ac,4,56,6,50,1,0,1,5,70,756,1,4,1.280606313,1275,5,0,358,355,3,10274,10108,166,96,94,2,99.89756722
28f54cb35af3fab56985b710892cf9469aa7022d,0,0,0,0,0,0,0,0,0,0,0,0,0,0,92,1,0,0,0,0,0,0,0,0,0,100
e7e48170a62c6060d7e532f7198756781f1d60d8,0,0,0,0,0,0,0,0,0,0,0,0,0,0,6,1,0,0,0,0,0,0,0,0,0,100
1aa963c44d1b9da3dfcf74acb3eeed56439332a0,5,91,8,83,1,0,1,7,83,1637,1,3,1.653577775,2013,5,3,584,571,13,13753,13545,208,228,220,8,99.82097187
7c5d8df3fb282b1dffa6d11169756ed5593de838,0,0,0,0,0,0,0,0,0,0,0,0,0,0,6,4,0,0,0,0,0,0,0,0,0,100
d97e81f96e11cf0b550234d7c76045bea1734ab3,0,0,0,0,0,0,0,0,0,0,0,0,0,0,7,2,0,0,0,0,0,0,0,0,0,100
bbe3db4cc1ef68eaa129586beb5978e6315d598f,0,0,0,0,0,0,0,0,0,0,0,0,0,0,0,0,0,0,0,0,0,0,0,0,0,100
e5a0e064d795be5efa1b05d50191c0d3441c5195,0,0,0,0,0,0,0,0,0,0,0,0,0,0,24,0,0,0,0,0,0,0,0,0,0,100
ea07ac016fef769e3e80645b32ca72e0a0d13a26,0,0,0,0,0,0,0,0,0,0,0,0,0,0,8,1,0,0,0,0,0,0,0,0,0,100
6c2e3700b6c17e518755386fd81a2caa9deb1797,0,0,0,0,0,0,0,0,0,0,0,0,0,0,9,2,0,0,0,0,0,0,0,0,0,100
336f04adbe596b8f303b55ac29fbfc5c4785d960,0,0,0,0,0,0,0,0,0,0,0,0,0,0,0,0,0,0,0,0,0,0,0,0,0,100
04e41fc2c8aa21e829f690e791e8aa2b0a049700,0,0,0,0,0,0,0,0,0,0,0,0,0,0,0,0,0,0,0,0,0,0,0,0,0,100
9da79b68f4e37d2910d48e42dd43e559770fd38b,0,0,0,0,0,0,0,0,0,0,0,0,0,0,10,3,0,0,0,0,0,0,0,0,0,100
54f37e52cb373904c7529a74dee1275bffac457a,0,0,0,0,0,0,0,0,0,0,0,0,0,0,11,4,0,0,0,0,0,0,0,0,0,100
6a67d7161cf7c0f2e229c780b90afea8f2818886,0,0,0,0,0,0,0,0,0,0,0,0,0,0,95,0,0,0,0,0,0,0,0,0,0,100
c4ce231b911cb26a4b860149c542a449d717e231,0,0,0,0,0,0,0,0,0,0,0,0,0,0,96,1,0,0,0,0,0,0,0,0,0,100
87d04ef9065e3ef21f1fb4135c56d3c6500d2530,0,0,0,0,0,0,0,0,0,0,0,0,0,0,12,5,0,0,0,0,0,0,0,0,0,100
74f9a51c354f986aae3efc8766d321a0939ec45f,0,0,0,0,0,0,0,0,0,0,0,0,0,0,13,6,0,0,0,0,0,0,0,0,0,100
bce386623c79b204957f1c37c43079d1c51c2038,0,0,0,0,0,0,0,0,0,0,0,0,0,0,14,7,0,0,0,0,0,0,0,0,0,100
409ed65dcc991f49744b6f8a9f74d94e3b29ce50,0,0,0,0,0,0,0,0,0,0,0,0,0,0,25,0,0,0,0,0,0,0,0,0,0,100
b76a437b970889255703ff48f7ee5981dfbcc17a,0,0,0,0,0,0,0,0,0,0,0,0,0,0,15,8,0,0,0,0,0,0,0,0,0,100
13de1f06ea6a4a64646a8dea5edc1d2538f2eadc,0,0,0,0,0,0,0,0,0,0,0,0,0,0,4,0,0,0,0,0,0,0,0,0,0,100
edd836f9d191b4ded5f1a23b432cb6913979c0d2,7,21,21,0,0,0,0,16,44,294,1,2,2.807354922,1968,5,1,537,537,0,18260,18281,21,318,318,0,100
d5b85d820f28f0ad82864188531f853a78e33cb9,0,0,0,0,0,0,0,0,0,0,0,0,0,0,6,2,0,0,0,0,0,0,0,0,0,100
4015f96f1c71b444f626ec15fac8095861d07620,0,0,0,0,0,0,0,0,0,0,0,0,0,0,97,2,0,0,0,0,0,0,0,0,0,100
7bda57acf5f19749bb3930f8816b06e4b3dee15a,0,0,0,0,0,0,0,0,0,0,0,0,0,0,98,3,0,0,0,0,0,0,0,0,0,100
3af326e5e7befcc2d01c3f91ef525fbda788b565,0,0,0,0,0,0,0,0,0,0,0,0,0,0,99,4,0,0,0,0,0,0,0,0,0,100
5b003cba088e122c553b0c648d13edb5ba250409,0,0,0,0,0,0,0,0,0,0,0,0,0,0,16,9,0,0,0,0,0,0,0,0,0,100
2e68b3ff4f7f3633a418219cd1dcee5e5bd08921,3,4,15,11,0,0,0,10,26,1025,1,3,1.105013997,1628,7,3,363,363,0,11663,11723,60,330,330,0,94.90268767
4209b14b8750c5d631a77e2b84906a449c43f706,1,3,2,1,0,0,0,16,27,5,1,1,0,1223,8,4,306,306,0,9104,9087,17,283,283,0,100
7584320142768612bc7a58242231a476404bbceb,0,0,0,0,0,0,0,0,0,0,0,0,0,0,0,0,0,0,0,0,0,0,0,0,0,100
00969b71fb23a15a4741b4c8e906b243db5386db,0,0,0,0,0,0,0,0,0,0,0,0,0,0,9,5,0,0,0,0,0,0,0,0,0,100
36f34be4ae5a4c8b7a79867d6e082c5f608d5760,0,0,0,0,0,0,0,0,0,0,0,0,0,0,10,6,0,0,0,0,0,0,0,0,0,100
e8200cd2d40d9cf4a702905e6d2eeb9d589ec57a,0,0,0,0,0,0,0,0,0,0,0,0,0,0,1,1,0,0,0,0,0,0,0,0,0,100
c0bfb88abebff7ec754c20b7797cbbe6a548495b,0,0,0,0,0,0,0,0,0,0,0,0,0,0,11,7,0,0,0,0,0,0,0,0,0,100
a29b8691c216f2954e063230ce957a27e30e1853,0,0,0,0,0,0,0,0,0,0,0,0,0,0,12,8,0,0,0,0,0,0,0,0,0,100
a4f200efcb14ab381b0d83d71e972753c1d178c1,0,0,0,0,0,0,0,0,0,0,0,0,0,0,17,9,0,0,0,0,0,0,0,0,0,100
4781d8fe91dc8cc873d6ed21dc65c0b168e6fef4,0,0,0,0,0,0,0,0,0,0,0,0,0,0,100,5,0,0,0,0,0,0,0,0,0,100
9827fadaa339e9b81a480934542f7db57f7bed7b,0,0,0,0,0,0,0,0,0,0,0,0,0,0,101,6,0,0,0,0,0,0,0,0,0,100
180c041af1c4ddaaea88222dc0c1ba4b62ab026f,0,0,0,0,0,0,0,0,0,0,0,0,0,0,102,7,0,0,0,0,0,0,0,0,0,100
c54684853c518c004a9c72f347deb81a93f4c210,0,0,0,0,0,0,0,0,0,0,0,0,0,0,103,8,0,0,0,0,0,0,0,0,0,100
7b8f20ce52b2a74c6cc168778b655177251a53f8,0,0,0,0,0,0,0,0,0,0,0,0,0,0,5,0,0,0,0,0,0,0,0,0,0,100
8e0c4afdadbe9f1651919ab5dd66cb5fc60af83f,0,0,0,0,0,0,0,0,0,0,0,0,0,0,104,9,0,0,0,0,0,0,0,0,0,100
0811b827a233c415a5b48612817148b01db102ac,0,0,0,0,0,0,0,0,0,0,0,0,0,0,18,10,0,0,0,0,0,0,0,0,0,100
012197272fde9c6253a8c1672380d615c9e0d176,0,0,0,0,0,0,0,0,0,0,0,0,0,0,105,10,0,0,0,0,0,0,0,0,0,100
a741b2c6e368a5fd3eddf97af1b82c45c84a333d,0,0,0,0,0,0,0,0,0,0,0,0,0,0,106,11,0,0,0,0,0,0,0,0,0,100
1246cc1dd31040cb6f65c503d739d065efcfec65,0,0,0,0,0,0,0,0,0,0,0,0,0,0,19,11,0,0,0,0,0,0,0,0,0,100
613dd99f3f096a482fbce9579572dac4634c0858,0,0,0,0,0,0,0,0,0,0,0,0,0,0,6,1,0,0,0,0,0,0,0,0,0,100
6958462df53d88e96084a1288858e07291802f6a,0,0,0,0,0,0,0,0,0,0,0,0,0,0,107,12,0,0,0,0,0,0,0,0,0,100
633ce2cf931d95e5febbbee4e2dd8b5851d699bc,0,0,0,0,0,0,0,0,0,0,0,0,0,0,108,13,0,0,0,0,0,0,0,0,0,100
ac1b159e482f021fcbe8b839e2943f119005eb2c,0,0,0,0,0,0,0,0,0,0,0,0,0,0,109,14,0,0,0,0,0,0,0,0,0,100
aa890d29419511135aa13d1e95dcae2922b2912a,0,0,0,0,0,0,0,0,0,0,0,0,0,0,110,15,0,0,0,0,0,0,0,0,0,100
2a0c2638d13154e839d5cb4c438ecf67afba88b4,0,0,0,0,0,0,0,0,0,0,0,0,0,0,111,16,0,0,0,0,0,0,0,0,0,100
f4ad908608279c760b3a08390fe6f6c719a773e8,0,0,0,0,0,0,0,0,0,0,0,0,0,0,112,17,0,0,0,0,0,0,0,0,0,100
e3b11ad1aaedae21c66a7f42509b83302369fbc6,4,4,4,0,0,0,0,6,17,1737,1,4,2,762,13,9,63,63,0,6646,6646,0,58,58,0,100
9b4c7fcb6c31d8bfcc0ad76484b0c374c521b525,0,0,0,0,0,0,0,0,0,0,0,0,0,0,14,10,0,0,0,0,0,0,0,0,0,100
ee47d4cd64eddcbced7b7c77102480e767b210a6,0,0,0,0,0,0,0,0,0,0,0,0,0,0,20,12,0,0,0,0,0,0,0,0,0,100
3a8423fc48417e581d4423d2121cf16154e2dfaf,6,62,87,25,0,0,0,5,19,2640,1,1,2.473790681,640,21,13,22,22,0,5292,5286,6,17,17,0,100
6603e7777eda6f81ba7ed49c4672951b824bd6df,0,0,0,0,0,0,0,0,0,0,0,0,0,0,7,0,0,0,0,0,0,0,0,0,0,100
006f7c5ac462ab300747e367983a7223c4aa1365,2,15,4,11,0,0,0,24,70,176,1,2,0.485460761,1662,22,14,351,350,1,13149,13110,39,138,138,0,100
dcf925ec6c3f26ff7e5dfd7d48503b70259a2093,1,16,12,4,0,0,0,28,84,73,1,1,0,1566,15,11,466,466,0,10599,10621,22,196,196,0,100
9ea105c793af3459c6aa492ff9898f37defd70e1,1,6,7,1,0,0,0,5,6,1813,1,1,0,163,16,12,35,35,0,1205,1207,2,9,9,0,100
98f4f4a87bb61cacf91f50253f8154c8b36de690,0,0,0,0,0,0,0,0,0,0,0,0,0,0,23,9,0,0,0,0,0,0,0,0,0,100
bd4e91ac09d2dc6cc25e2369697dde57fb3ad2a8,0,0,0,0,0,0,0,0,0,0,0,0,0,0,25,0,0,0,0,0,0,0,0,0,0,100
daba28643dd1b267949a659e91c6849a4cf6488d,0,0,0,0,0,0,0,0,0,0,0,0,0,0,113,13,0,0,0,0,0,0,0,0,0,100
dc4b19af1ba7d93bb36aec1b5432ef5ff3af44d4,0,0,0,0,0,0,0,0,0,0,0,0,0,0,114,14,0,0,0,0,0,0,0,0,0,100
de6bfda7722d7df0bc9b14ee504af291fc9639c6,0,0,0,0,0,0,0,0,0,0,0,0,0,0,115,15,0,0,0,0,0,0,0,0,0,100
49c6e1067c937d066503be9c7f4032fb03f67474,0,0,0,0,0,0,0,0,0,0,0,0,0,0,0,0,0,0,0,0,0,0,0,0,0,100
e2eb392b5f080b7703d8bac35f6a478403d6f9af,0,0,0,0,0,0,0,0,0,0,0,0,0,0,24,7,0,0,0,0,0,0,0,0,0,100
bb6b6dae7692f7ce6f0fbe9561c7408e8f295bec,0,0,0,0,0,0,0,0,0,0,0,0,0,0,17,9,0,0,0,0,0,0,0,0,0,100
064cc6b4bd1c6dcf59da989e712a27f0a955f70d,0,0,0,0,0,0,0,0,0,0,0,0,0,0,18,10,0,0,0,0,0,0,0,0,0,100
29197da2a94c889faa9101c92b7c60fed6a6db0b,0,0,0,0,0,0,0,0,0,0,0,0,0,0,19,11,0,0,0,0,0,0,0,0,0,100
68484243164666833c03336b953c63c70a247b1a,0,0,0,0,0,0,0,0,0,0,0,0,0,0,26,1,0,0,0,0,0,0,0,0,0,100
9917a55d858dcd74d53176fad5341eb3f8846ae8,0,0,0,0,0,0,0,0,0,0,0,0,0,0,20,12,0,0,0,0,0,0,0,0,0,100
a35a2a5305560da8ccb8eb299498e73c8bafa3bd,0,0,0,0,0,0,0,0,0,0,0,0,0,0,25,8,0,0,0,0,0,0,0,0,0,100
0cbcda5ab0b51fd1c9c47d9adf23388e865dbd44,0,0,0,0,0,0,0,0,0,0,0,0,0,0,116,12,0,0,0,0,0,0,0,0,0,100
a5878d0aa4a64259885762e38485dc3e7dd54f98,0,0,0,0,0,0,0,0,0,0,0,0,0,0,117,13,0,0,0,0,0,0,0,0,0,100
bdb7fadefe7c49488bfd38765c8eafc8b2d9b008,0,0,0,0,0,0,0,0,0,0,0,0,0,0,118,14,0,0,0,0,0,0,0,0,0,100
8a06ea3107664bc0083883459e4d4839ab7dd6b4,0,0,0,0,0,0,0,0,0,0,0,0,0,0,0,0,0,0,0,0,0,0,0,0,0,100
d369f4013d36492236d64670c533b8e28c8b186e,0,0,0,0,0,0,0,0,0,0,0,0,0,0,26,8,0,0,0,0,0,0,0,0,0,100
df4638e20e94904b9ea8225061df6b04dab9198c,0,0,0,0,0,0,0,0,0,0,0,0,0,0,119,10,0,0,0,0,0,0,0,0,0,100
415f6ab02eb83becea308dfc0e16f09309a58939,0,0,0,0,0,0,0,0,0,0,0,0,0,0,69,0,0,0,0,0,0,0,0,0,0,100
44aee9e09571ab3d92a9db7f103e473ae1644dce,0,0,0,0,0,0,0,0,0,0,0,0,0,0,21,7,0,0,0,0,0,0,0,0,0,100
2e53b45fb3cafee63c1b2f9d3ce31746f0763ef7,0,0,0,0,0,0,0,0,0,0,0,0,0,0,22,8,0,0,0,0,0,0,0,0,0,100
888ab68cb5b15098972ef99558dee903fe7b1e7b,0,0,0,0,0,0,0,0,0,0,0,0,0,0,7,0,0,0,0,0,0,0,0,0,0,100
df45003d21febb2098a0cfc752a25613f0b76f4c,0,0,0,0,0,0,0,0,0,0,0,0,0,0,1,1,0,0,0,0,0,0,0,0,0,100
2af5d7e0116d53ca706b6e5a5f3b45e7d317ef7d,0,0,0,0,0,0,0,0,0,0,0,0,0,0,2,2,0,0,0,0,0,0,0,0,0,100
fadf29e734bbe2774b21cbabd711dc71bccc1008,0,0,0,0,0,0,0,0,0,0,0,0,0,0,3,3,0,0,0,0,0,0,0,0,0,100
7ee056890cc44f956ee3a46a3663132a3b688655,0,0,0,0,0,0,0,0,0,0,0,0,0,0,4,4,0,0,0,0,0,0,0,0,0,100
f7188bed2888d72a91c27e3ff0e7da63fe4ecc35,0,0,0,0,0,0,0,0,0,0,0,0,0,0,5,5,0,0,0,0,0,0,0,0,0,100
4c5379e4c15a0df2e3036094f6c90f142ee7a9fb,0,0,0,0,0,0,0,0,0,0,0,0,0,0,120,7,0,0,0,0,0,0,0,0,0,100
0766e423428b4caf36d5ef3ee1c10bcae21b6269,0,0,0,0,0,0,0,0,0,0,0,0,0,0,6,6,0,0,0,0,0,0,0,0,0,100
5eff9a7f503ab0de550c99b6b46ac628ca9d817d,0,0,0,0,0,0,0,0,0,0,0,0,0,0,7,7,0,0,0,0,0,0,0,0,0,100
c88481400a70546e7c261ca939709a551c8b1d40,0,0,0,0,0,0,0,0,0,0,0,0,0,0,8,8,0,0,0,0,0,0,0,0,0,100
b3c582237398aee44d55c831ac1ad45b107b450a,0,0,0,0,0,0,0,0,0,0,0,0,0,0,27,4,0,0,0,0,0,0,0,0,0,100
91f289e1a69ca0f337a582401381759b12d3dc22,0,0,0,0,0,0,0,0,0,0,0,0,0,0,0,0,0,0,0,0,0,0,0,0,0,100
7e5bdeec02d90ac63413fad09ce5e54adc087621,0,0,0,0,0,0,0,0,0,0,0,0,0,0,28,5,0,0,0,0,0,0,0,0,0,100
c00aaa731b67c22281ea1f93b3bfe1788bf191ff,0,0,0,0,0,0,0,0,0,0,0,0,0,0,93,0,0,0,0,0,0,0,0,0,0,100
ae3b007de6b1fab3eedca801adea8f425544baac,0,0,0,0,0,0,0,0,0,0,0,0,0,0,9,9,0,0,0,0,0,0,0,0,0,100
c304f08adaea2778a54349a95826d1cde1db8328,0,0,0,0,0,0,0,0,0,0,0,0,0,0,10,10,0,0,0,0,0,0,0,0,0,100
100574019b35465831d1b2fb0bff4fe2f512c89a,0,0,0,0,0,0,0,0,0,0,0,0,0,0,11,11,0,0,0,0,0,0,0,0,0,100
8bae4d83674dfd7b214c75bb920ecf1698f0919e,0,0,0,0,0,0,0,0,0,0,0,0,0,0,12,12,0,0,0,0,0,0,0,0,0,100
c7827d220c018ed777b26fe16bc561fe7ea5411a,0,0,0,0,0,0,0,0,0,0,0,0,0,0,13,13,0,0,0,0,0,0,0,0,0,100
9c2464ca2b76b914e3563e2b101752b59ebaf6ed,0,0,0,0,0,0,0,0,0,0,0,0,0,0,14,14,0,0,0,0,0,0,0,0,0,100
93db8e005eaaa07b5003dcbd03bee49dea3975b3,0,0,0,0,0,0,0,0,0,0,0,0,0,0,15,15,0,0,0,0,0,0,0,0,0,100
a95f0e677693ab8af75015f6bb333e55c7437f03,0,0,0,0,0,0,0,0,0,0,0,0,0,0,8,1,0,0,0,0,0,0,0,0,0,100
a80c58296037371912e9a9703bf2f7d17771b5fa,0,0,0,0,0,0,0,0,0,0,0,0,0,0,16,16,0,0,0,0,0,0,0,0,0,100
9a378ffab2b49d95edcd2dba36691096301b64ee,3,51,8,43,0,0,0,25,71,77,1,3,0.821498557,2075,0,0,476,471,5,16504,16297,207,173,170,3,100
e8cd44067de5090ec6371e97b4b7dba4ba230769,0,0,0,0,0,0,0,0,0,0,0,0,0,0,0,0,0,0,0,0,0,0,0,0,0,100
18d74959d73346f9d1e1fa9dd8881177a1f49233,0,0,0,0,0,0,0,0,0,0,0,0,0,0,17,17,0,0,0,0,0,0,0,0,0,100
b29ff557ffca53121dbc378d5c0873a06171dc60,0,0,0,0,0,0,0,0,0,0,0,0,0,0,18,18,0,0,0,0,0,0,0,0,0,100
bfe65c688c9f67c7491e394439ce4deb24b14db2,0,0,0,0,0,0,0,0,0,0,0,0,0,0,19,19,0,0,0,0,0,0,0,0,0,100
df720718aee6832b056c4c26f6f470f8ed4107e0,0,0,0,0,0,0,0,0,0,0,0,0,0,0,20,20,0,0,0,0,0,0,0,0,0,100
8cbbe84bbf5e6fc97eee99131cee2b4df8d705b5,0,0,0,0,0,0,0,0,0,0,0,0,0,0,21,21,0,0,0,0,0,0,0,0,0,100
41793f347d78127cd49d702df4d6c36abf4433fd,0,0,0,0,0,0,0,0,0,0,0,0,0,0,23,6,0,0,0,0,0,0,0,0,0,100
a5436c589d017a6670d6e65189f381f8d8c594c0,0,0,0,0,0,0,0,0,0,0,0,0,0,0,121,8,0,0,0,0,0,0,0,0,0,100
4138f45fe19987fe4026eea2cbd8e0e7857e9bbd,0,0,0,0,0,0,0,0,0,0,0,0,0,0,24,7,0,0,0,0,0,0,0,0,0,100
0cd0aa1f198e16c94cce03f7742f235d2d5bb4bd,0,0,0,0,0,0,0,0,0,0,0,0,0,0,9,2,0,0,0,0,0,0,0,0,0,100
8ce603b6317638847fa547f0d2c587cd019903db,0,0,0,0,0,0,0,0,0,0,0,0,0,0,29,4,0,0,0,0,0,0,0,0,0,100
ac85ba202a476fdd42acf4f074dfbffedd680f2b,0,0,0,0,0,0,0,0,0,0,0,0,0,0,0,0,0,0,0,0,0,0,0,0,0,100
69fda12c5f3695504e15851b9028cc57efa4c90e,0,0,0,0,0,0,0,0,0,0,0,0,0,0,25,5,0,0,0,0,0,0,0,0,0,100
fa443cf8c12b3f4cddf85c4a28f6b6aab68a148f,0,0,0,0,0,0,0,0,0,0,0,0,0,0,26,6,0,0,0,0,0,0,0,0,0,100
60cdcd0e4dcc87a702a37272767e6e5e5c961aaf,0,0,0,0,0,0,0,0,0,0,0,0,0,0,22,22,0,0,0,0,0,0,0,0,0,100
9ca68cb782a98badcbd24d0503777d6e45b0ab2f,0,0,0,0,0,0,0,0,0,0,0,0,0,0,23,23,0,0,0,0,0,0,0,0,0,100
bddc96095089b95d3e527a8e7f03550a28acc236,0,0,0,0,0,0,0,0,0,0,0,0,0,0,24,24,0,0,0,0,0,0,0,0,0,100
3c55d2610169f299b73bd453c293a4c91d193c2c,0,0,0,0,0,0,0,0,0,0,0,0,0,0,25,25,0,0,0,0,0,0,0,0,0,100
ef1efc25c47e2a437c4f2d4475da9d2551d56d8d,0,0,0,0,0,0,0,0,0,0,0,0,0,0,26,26,0,0,0,0,0,0,0,0,0,100
42edbd721fedc0ed6cde89ab3b64a9ac606aa74f,0,0,0,0,0,0,0,0,0,0,0,0,0,0,27,27,0,0,0,0,0,0,0,0,0,100
f9cceedeb46bf3c0b48ad21acb2c5f8778bfc9d8,0,0,0,0,0,0,0,0,0,0,0,0,0,0,28,28,0,0,0,0,0,0,0,0,0,100
6f704b13e4a393bb035cede13e5a2200eb3a1092,0,0,0,0,0,0,0,0,0,0,0,0,0,0,29,29,0,0,0,0,0,0,0,0,0,100
6eebdf9777117e0301603d227b6b275616624255,0,0,0,0,0,0,0,0,0,0,0,0,0,0,30,30,0,0,0,0,0,0,0,0,0,100
e57df5ea723fe403ab17d012180564ffbce1f993,0,0,0,0,0,0,0,0,0,0,0,0,0,0,31,31,0,0,0,0,0,0,0,0,0,100
0cbfb17d49186348a85cc2afc19c6b940da4aad1,0,0,0,0,0,0,0,0,0,0,0,0,0,0,32,32,0,0,0,0,0,0,0,0,0,100
c35add7b29b5fab9229d79927a74f327bd56fa70,4,34,3,31,0,0,0,7,22,2156,1,3,1.834567814,1159,0,0,189,188,1,10555,10228,327,55,54,1,95.35329341
20cb8126867c2ab6a62d42f241e696fd91b7879d,0,0,0,0,0,0,0,0,0,0,0,0,0,0,122,3,0,0,0,0,0,0,0,0,0,100
62e337e8e04a653730c6630f27d9f24181922ff6,0,0,0,0,0,0,0,0,0,0,0,0,0,0,123,4,0,0,0,0,0,0,0,0,0,100
8fbd830765adfd308984fe4a8595ecb3ae11388e,0,0,0,0,0,0,0,0,0,0,0,0,0,0,124,5,0,0,0,0,0,0,0,0,0,100
2681c1b0979fc37685d019c0db956593aa2ea5a2,2,48,37,11,0,0,0,9,16,170,1,2,0.450066658,244,8,0,32,32,0,2040,2238,198,17,17,0,100
840dec6d47b6a81e94a451c425669f025e1c88af,0,0,0,0,0,0,0,0,0,0,0,0,0,0,9,1,0,0,0,0,0,0,0,0,0,100
9ab5ae3cd60b8c38c330e9483140d1a6f8d254cc,1,1,1,0,0,0,0,34,72,18,1,1,0,914,2,0,267,267,0,6181,6181,0,88,88,0,100
5d2f01a1ea73ba45391fcfaf0f349b81ec577f51,0,0,0,0,0,0,0,0,0,0,0,0,0,0,91,0,0,0,0,0,0,0,0,0,0,100
443614c12a15bb58fcf2487eb67ca6f885a68f96,0,0,0,0,0,0,0,0,0,0,0,0,0,0,92,1,0,0,0,0,0,0,0,0,0,100
8988196545a17e76a984b07313dd4a86497c9e02,0,0,0,0,0,0,0,0,0,0,0,0,0,0,27,4,0,0,0,0,0,0,0,0,0,100
9f37f912e9bde481a14a27e5553fb61a4df1277b,0,0,0,0,0,0,0,0,0,0,0,0,0,0,10,3,0,0,0,0,0,0,0,0,0,100
11595499d6d410bf8663c365ad161e0c5d1e1358,0,0,0,0,0,0,0,0,0,0,0,0,0,0,27,0,0,0,0,0,0,0,0,0,0,100
a5f8def249e7ee510d37bcf97fc60b3b87ae8001,8,256,21,235,1,0,1,1,71,1037,1,4,1.122372574,2783,30,3,724,682,42,20804,19769,1035,268,247,21,99.94493392
5c645aefadaadacaa19c268db46df5c20e7908af,0,0,0,0,0,0,0,0,0,0,0,0,0,0,0,0,0,0,0,0,0,0,0,0,0,100
28cdc9fe57bc4d4abf8b28c9cb4b9859b4d34cdd,0,0,0,0,0,0,0,0,0,0,0,0,0,0,125,4,0,0,0,0,0,0,0,0,0,100
d7f9b9072c82b960f9eba0615e1b9989b81273eb,1,1,1,0,0,0,0,20,53,43,1,1,0,407,28,3,120,120,0,3142,3142,0,32,32,0,100
a87e3ad4360189991e28eca05f461b85b60d3cd9,0,0,0,0,0,0,0,0,0,0,0,0,0,0,29,4,0,0,0,0,0,0,0,0,0,100
f888458721ce2573a6e04113a69a30ce785f8891,2,20,6,14,0,0,0,6,11,1486,1,2,0.391243564,225,31,1,42,41,1,1654,1552,102,13,13,0,98.25136612
b8e7d7d4134318ddd7713d610a339b0cea9e12a3,2,6,1,5,0,0,0,13,85,313,1,2,0.863120569,1880,3,1,506,505,1,13501,13468,33,235,234,1,100
4c24d9ddddc8cc7d507caf495a4f93f3c7255654,18,953,32,921,13,0,13,6,54,58,1,6,3.845980073,1118,4,2,331,245,86,12109,7967,4142,145,105,40,94.63574608
7a8576475f776109d060ffdf22e876b754ac3ab4,2,4,6,2,0,0,0,6,12,4,1,2,0.881290899,235,32,2,42,42,0,1632,1654,22,13,13,0,100
96bc4983ddad9faa951035b3c94a5434c6a4940a,0,0,0,0,0,0,0,0,0,0,0,0,0,0,30,3,0,0,0,0,0,0,0,0,0,100
9b83acd4c7fbf6beb5be2cf10f76230624c98637,0,0,0,0,0,0,0,0,0,0,0,0,0,0,126,4,0,0,0,0,0,0,0,0,0,100
a5ba8b445252987dec2d5f31e34c573823a04f0b,0,0,0,0,0,0,0,0,0,0,0,0,0,0,31,4,0,0,0,0,0,0,0,0,0,100
5d3f9a687484aac766783442f45fc66d02df530e,0,0,0,0,0,0,0,0,0,0,0,0,0,0,32,5,0,0,0,0,0,0,0,0,0,100
52b6987b7281587bab6f7a307333b631ed9fd39c,0,0,0,0,0,0,0,0,0,0,0,0,0,0,33,6,0,0,0,0,0,0,0,0,0,100
70223760d8d29c1e21ca224df452f9f0cb801cbd,0,0,0,0,0,0,0,0,0,0,0,0,0,0,34,7,0,0,0,0,0,0,0,0,0,100
b91e4bcc8abb1b2ad54565514a00cec8c9b91a60,0,0,0,0,0,0,0,0,0,0,0,0,0,0,35,8,0,0,0,0,0,0,0,0,0,100
5a8c87a96d9aeb63b68b1f93bcff99347913a81b,0,0,0,0,0,0,0,0,0,0,0,0,0,0,36,9,0,0,0,0,0,0,0,0,0,100
57a8cafebabc10f22d8e2214fd7ac1eb9c5ccda5,0,0,0,0,0,0,0,0,0,0,0,0,0,0,28,0,0,0,0,0,0,0,0,0,0,100
b6c6c98536e18abc244de515f440f7f0578b3c6f,0,0,0,0,0,0,0,0,0,0,0,0,0,0,29,1,0,0,0,0,0,0,0,0,0,100
ea2d633294384cecdd50e0dd6efeb08b938a8a30,0,0,0,0,0,0,0,0,0,0,0,0,0,0,30,2,0,0,0,0,0,0,0,0,0,100
092d9a9267f2b4dd1464641739f68579145ecc0c,0,0,0,0,0,0,0,0,0,0,0,0,0,0,37,9,0,0,0,0,0,0,0,0,0,100
d2ef493dc022e60268b25740fbffe9b51d6fc342,0,0,0,0,0,0,0,0,0,0,0,0,0,0,31,3,0,0,0,0,0,0,0,0,0,100
7d4e46bb848ea9f2d0c3642787fd265bef9d7bfa,0,0,0,0,0,0,0,0,0,0,0,0,0,0,32,4,0,0,0,0,0,0,0,0,0,100
b184c357cb3e7c124a80ecd4698ba338df69d0c1,0,0,0,0,0,0,0,0,0,0,0,0,0,0,33,5,0,0,0,0,0,0,0,0,0,100
b4ab253ade3b1e88a5125e1dd533caf010141803,0,0,0,0,0,0,0,0,0,0,0,0,0,0,11,0,0,0,0,0,0,0,0,0,0,100
a4a0993a3eeb2f6a185a4314c50511037dadbac2,0,0,0,0,0,0,0,0,0,0,0,0,0,0,38,10,0,0,0,0,0,0,0,0,0,100
f10fa6b9e30e38ec5cde6e00288f0b31b24bf1de,0,0,0,0,0,0,0,0,0,0,0,0,0,0,127,2,0,0,0,0,0,0,0,0,0,100
a183a205add80fa70348d5148f79e3d12f9ef144,0,0,0,0,0,0,0,0,0,0,0,0,0,0,128,3,0,0,0,0,0,0,0,0,0,100
72e1135f7c1171b7f028f7f4f5fa0a652eb4edc2,0,0,0,0,0,0,0,0,0,0,0,0,0,0,12,1,0,0,0,0,0,0,0,0,0,100
e4f629c66f22d05c63c2ff6ed7f1956d0a7e2dbc,0,0,0,0,0,0,0,0,0,0,0,0,0,0,34,6,0,0,0,0,0,0,0,0,0,100
3753a15606407c6358f76aa45a059ad3af6a3c37,0,0,0,0,0,0,0,0,0,0,0,0,0,0,129,4,0,0,0,0,0,0,0,0,0,100
ad585c29efb46e3c056a11e4e10f9c2d408bb84b,0,0,0,0,0,0,0,0,0,0,0,0,0,0,13,2,0,0,0,0,0,0,0,0,0,100
5d3931b9ed94a6a4558432f4993948329be35357,0,0,0,0,0,0,0,0,0,0,0,0,0,0,33,2,0,0,0,0,0,0,0,0,0,100
137def8f3cf63cf9b53e5548aaba1fc6bf38a03a,0,0,0,0,0,0,0,0,0,0,0,0,0,0,35,7,0,0,0,0,0,0,0,0,0,100
81b1982da5ce28826edad26d052e6e4faad2bb9e,0,0,0,0,0,0,0,0,0,0,0,0,0,0,36,8,0,0,0,0,0,0,0,0,0,100
5194d60ce70b6b848830f1e8ebbec1f44df0fcf6,0,0,0,0,0,0,0,0,0,0,0,0,0,0,34,3,0,0,0,0,0,0,0,0,0,100
bdbb2a0379104cba9cf73a6df682c66c9e8180a4,0,0,0,0,0,0,0,0,0,0,0,0,0,0,35,4,0,0,0,0,0,0,0,0,0,100
a0d5b943ddb9452ecc8b0d9d9e804f039ec9df1f,1,15,0,15,0,0,0,13,21,731,1,1,0,696,36,5,47,46,1,9937,9791,146,44,43,1,100
9cd3c0e6df02e9706dc075d7be6eccd18c18d79d,0,0,0,0,0,0,0,0,0,0,0,0,0,0,130,4,0,0,0,0,0,0,0,0,0,100
5c1f4405ab46c68413a63a2206b49585a1d14695,0,0,0,0,0,0,0,0,0,0,0,0,0,0,14,3,0,0,0,0,0,0,0,0,0,100
e828cb0adc3c24e970f47c181d39ba21350d2ab5,0,0,0,0,0,0,0,0,0,0,0,0,0,0,33,0,0,0,0,0,0,0,0,0,0,100
44b8cd23756b752bf9d0976574453c712dcd44d9,0,0,0,0,0,0,0,0,0,0,0,0,0,0,37,4,0,0,0,0,0,0,0,0,0,100
aa22276152802a85cc628c418f304a164d82b3af,0,0,0,0,0,0,0,0,0,0,0,0,0,0,1,0,0,0,0,0,0,0,0,0,0,100
531ccde8a0fb2d782a4350cd8056de3ce08c427e,0,0,0,0,0,0,0,0,0,0,0,0,0,0,38,5,0,0,0,0,0,0,0,0,0,100
4b8dac4d0f210dce0b37d9f5c990d265f4ffc20b,0,0,0,0,0,0,0,0,0,0,0,0,0,0,37,9,0,0,0,0,0,0,0,0,0,100
f4725ca1cdac1e7b9ef9c329caf5e4bfdc5b19c2,0,0,0,0,0,0,0,0,0,0,0,0,0,0,38,10,0,0,0,0,0,0,0,0,0,100
7ec12f99c3995f50c392a5a5336cd1a5c04ae1b4,0,0,0,0,0,0,0,0,0,0,0,0,0,0,131,4,0,0,0,0,0,0,0,0,0,100
80a9bf87b12c78c3db14b8d1419e7f77eb16f0d5,0,0,0,0,0,0,0,0,0,0,0,0,0,0,39,5,0,0,0,0,0,0,0,0,0,100
8e11c613e0b0b57cf06cae3d37cb86536375770b,2,18,1,17,0,0,0,6,26,2233,1,2,0.485460761,522,10,0,129,128,1,3897,3694,203,64,63,1,99.97939843
4bc3ba0ff57bbfa4b67c6900e54181f8ed820787,0,0,0,0,0,0,0,0,0,0,0,0,0,0,132,1,0,0,0,0,0,0,0,0,0,100
ce9ef8e0e9a6ee36121a98512b1d7f510e84deed,0,0,0,0,0,0,0,0,0,0,0,0,0,0,133,2,0,0,0,0,0,0,0,0,0,100
9d5c517caa2e2aaa8ae9cb5e4f7e3ef92e2801c6,0,0,0,0,0,0,0,0,0,0,0,0,0,0,134,3,0,0,0,0,0,0,0,0,0,100
128510c4e9c3a714279aa7cea22eda19080521f7,0,0,0,0,0,0,0,0,0,0,0,0,0,0,2,1,0,0,0,0,0,0,0,0,0,100
00be26acd539f9aecc809f802dc61c861f04ee2c,0,0,0,0,0,0,0,0,0,0,0,0,0,0,15,0,0,0,0,0,0,0,0,0,0,100
269a6ae52892b8d54c494a208cd576aa30d72c1d,0,0,0,0,0,0,0,0,0,0,0,0,0,0,40,3,0,0,0,0,0,0,0,0,0,100
8d6f71209f81e27efd4644fc3c8c65121a583334,0,0,0,0,0,0,0,0,0,0,0,0,0,0,41,4,0,0,0,0,0,0,0,0,0,100
ee4725c64807549ec74e20e83d35cfc1fe8e90a8,3,67,5,62,1,0,1,8,21,356,1,2,1.559379646,599,11,1,110,106,4,4039,3914,125,69,65,4,99.85587811
c7fdf69d811b57e888f31ffa520ebeb2f055f55b,0,0,0,0,0,0,0,0,0,0,0,0,0,0,3,2,0,0,0,0,0,0,0,0,0,100
66827318f0a134e8f6d4638a0787cb1b36821d1c,0,0,0,0,0,0,0,0,0,0,0,0,0,0,4,3,0,0,0,0,0,0,0,0,0,100
842c9d26695c92a7f52d0850a09ec0f3d9f84513,0,0,0,0,0,0,0,0,0,0,0,0,0,0,135,4,0,0,0,0,0,0,0,0,0,100
a4e42112cea950e76dd4fc914765205c7b305ae7,0,0,0,0,0,0,0,0,0,0,0,0,0,0,136,5,0,0,0,0,0,0,0,0,0,100
8d0e53c3781e4fcfaac61e0bfd9c04b00115ad79,0,0,0,0,0,0,0,0,0,0,0,0,0,0,39,1,0,0,0,0,0,0,0,0,0,100
3797bbb6f844d40c58324474e9d7d8e1ea99e62b,0,0,0,0,0,0,0,0,0,0,0,0,0,0,40,2,0,0,0,0,0,0,0,0,0,100
17e5a4554f65f5c3cd3300d3f87344c3474f6f2b,0,0,0,0,0,0,0,0,0,0,0,0,0,0,5,3,0,0,0,0,0,0,0,0,0,100
fcc4e2dec64e8cbb011a388f5e612c2b09e4d3ef,0,0,0,0,0,0,0,0,0,0,0,0,0,0,41,2,0,0,0,0,0,0,0,0,0,100
c2acf468f206cba00a77dc2da462ac3029640cba,0,0,0,0,0,0,0,0,0,0,0,0,0,0,42,3,0,0,0,0,0,0,0,0,0,100
04bac0f9b63353b9e2b3eb88185ab7c7f8b84a13,0,0,0,0,0,0,0,0,0,0,0,0,0,0,12,1,0,0,0,0,0,0,0,0,0,100
7bbba423aeb25b4ffe9dde90be090a4311c32f92,0,0,0,0,0,0,0,0,0,0,0,0,0,0,16,1,0,0,0,0,0,0,0,0,0,100
565849d05f768f5fc249711dc26bde0c9f68699b,0,0,0,0,0,0,0,0,0,0,0,0,0,0,17,2,0,0,0,0,0,0,0,0,0,100
47ed66f609f079d5ffa13405d1132ce1194e9fbc,0,0,0,0,0,0,0,0,0,0,0,0,0,0,18,3,0,0,0,0,0,0,0,0,0,100
65eb24a6275632d02eed8bca54c71314bfdb42e2,0,0,0,0,0,0,0,0,0,0,0,0,0,0,1,0,0,0,0,0,0,0,0,0,0,100
4fc9e2369d620f36eabdd5d6e1f36dd45e37c458,0,0,0,0,0,0,0,0,0,0,0,0,0,0,19,4,0,0,0,0,0,0,0,0,0,100
52abb50949e8d1933c7209f97d7bff5d8a20075d,0,0,0,0,0,0,0,0,0,0,0,0,0,0,6,4,0,0,0,0,0,0,0,0,0,100
d44ed5ae2fbb6b2b8d21d4a2ada218f35d59a38a,0,0,0,0,0,0,0,0,0,0,0,0,0,0,137,0,0,0,0,0,0,0,0,0,0,100
c9a346e8eb6012fdc8594877f02ea21be98c8b26,0,0,0,0,0,0,0,0,0,0,0,0,0,0,43,0,0,0,0,0,0,0,0,0,0,100
8c778c307ca34dce2190c2a4250ff607d5c9ab41,0,0,0,0,0,0,0,0,0,0,0,0,0,0,34,0,0,0,0,0,0,0,0,0,0,100
fee1a73979b1f9e2b98e0797812f405c1ccb6615,0,0,0,0,0,0,0,0,0,0,0,0,0,0,39,0,0,0,0,0,0,0,0,0,0,100
7673e8da822a9e27d7ff3e6258f91e2369b9f620,1,13,12,1,0,0,0,12,27,102,1,1,0,479,13,0,127,126,1,3491,3483,8,61,61,0,100
387f497285d49ffc577263d154bca968e2b5ea65,0,0,0,0,0,0,0,0,0,0,0,0,0,0,44,1,0,0,0,0,0,0,0,0,0,100
dd625f4f3aec105fef49d4e88424b892d82de0cc,0,0,0,0,0,0,0,0,0,0,0,0,0,0,138,1,0,0,0,0,0,0,0,0,0,100
6077d63143dbef1c6d762c344f43384a2e0fc76b,0,0,0,0,0,0,0,0,0,0,0,0,0,0,45,2,0,0,0,0,0,0,0,0,0,100
514e1c24f5a83901c4461efe3058dd0383b96a3f,0,0,0,0,0,0,0,0,0,0,0,0,0,0,35,1,0,0,0,0,0,0,0,0,0,100
cbc4372029e7149c73db5a5aef491abdc5500b10,0,0,0,0,0,0,0,0,0,0,0,0,0,0,7,0,0,0,0,0,0,0,0,0,0,100
fbe7901093c5af959c9f0ddb3c8e447f62f86181,0,0,0,0,0,0,0,0,0,0,0,0,0,0,46,3,0,0,0,0,0,0,0,0,0,100
fc6cf1ede40735f55a8c0d95e5699524676143ae,0,0,0,0,0,0,0,0,0,0,0,0,0,0,40,1,0,0,0,0,0,0,0,0,0,100
5bdebfdc53f1c0ff62af9f84942f2519946fa3fb,0,0,0,0,0,0,0,0,0,0,0,0,0,0,47,4,0,0,0,0,0,0,0,0,0,100
e4521514c76a3b501612f376c9e6db356e28836d,0,0,0,0,0,0,0,0,0,0,0,0,0,0,48,5,0,0,0,0,0,0,0,0,0,100
c5d7cff2643792ab4b8da3cba78df5fe7778c91f,0,0,0,0,0,0,0,0,0,0,0,0,0,0,36,2,0,0,0,0,0,0,0,0,0,100
c908995f5b8ff2c37b4180a5f2d50c671b426d0b,0,0,0,0,0,0,0,0,0,0,0,0,0,0,37,3,0,0,0,0,0,0,0,0,0,100
3079cb8e88d185a3d3713163bed59d6b1c56ba5d,0,0,0,0,0,0,0,0,0,0,0,0,0,0,38,4,0,0,0,0,0,0,0,0,0,100
3c3c05edf519ce41060c0534f0099c32f5bd8989,0,0,0,0,0,0,0,0,0,0,0,0,0,0,0,0,0,0,0,0,0,0,0,0,0,100
7c6fd1aad053b2cd33d79b6a383749e9ac50d7c6,0,0,0,0,0,0,0,0,0,0,0,0,0,0,39,5,0,0,0,0,0,0,0,0,0,100
cf0cb14de5498cf420265217e8f4d3a84dd2f4a4,0,0,0,0,0,0,0,0,0,0,0,0,0,0,20,0,0,0,0,0,0,0,0,0,0,100
1c84472681c888a77fa7295b43d84e06a4294641,0,0,0,0,0,0,0,0,0,0,0,0,0,0,0,0,0,0,0,0,0,0,0,0,0,100
a852aa433111499f0479a8efd8149e7dcfb1b77a,0,0,0,0,0,0,0,0,0,0,0,0,0,0,21,1,0,0,0,0,0,0,0,0,0,100
3312b986e43252963d567e3b1137b8de33220696,0,0,0,0,0,0,0,0,0,0,0,0,0,0,49,6,0,0,0,0,0,0,0,0,0,100
a3ee2f193c199e4ff3832bdb34477e33aebd14b0,0,0,0,0,0,0,0,0,0,0,0,0,0,0,139,1,0,0,0,0,0,0,0,0,0,100
361dd8b6ffdcba93c34a1801445c15fa02447442,0,0,0,0,0,0,0,0,0,0,0,0,0,0,40,6,0,0,0,0,0,0,0,0,0,100
82b606e4289e0a3efa88d65a59e7ae3731fd4f44,0,0,0,0,0,0,0,0,0,0,0,0,0,0,50,7,0,0,0,0,0,0,0,0,0,100
ab31be4a0fdadb0d48dd149a8ce43fe1583afb95,0,0,0,0,0,0,0,0,0,0,0,0,0,0,22,2,0,0,0,0,0,0,0,0,0,100
f1f304644d3cd1ca8fa33d1fedb4aacc3aff47de,0,0,0,0,0,0,0,0,0,0,0,0,0,0,23,3,0,0,0,0,0,0,0,0,0,100
ca71f9996f78517bbff24b4c8a03f1cf0505e605,0,0,0,0,0,0,0,0,0,0,0,0,0,0,51,8,0,0,0,0,0,0,0,0,0,100
9d87a206b52de7dc9402be711a51b72cb3c11160,0,0,0,0,0,0,0,0,0,0,0,0,0,0,41,7,0,0,0,0,0,0,0,0,0,100
95b61b1983d8c3bccea000362dcfec64a42d76f6,0,0,0,0,0,0,0,0,0,0,0,0,0,0,52,9,0,0,0,0,0,0,0,0,0,100
f0b183f2773165e616ec22ed6c32f60cc5b961fe,0,0,0,0,0,0,0,0,0,0,0,0,0,0,41,2,0,0,0,0,0,0,0,0,0,100
5cab566ce2685ec4ad933a2cdd9793d26e538e8d,0,0,0,0,0,0,0,0,0,0,0,0,0,0,53,10,0,0,0,0,0,0,0,0,0,100
9d025ca5fe413a50fb8ec039a0e614d836bb2a37,0,0,0,0,0,0,0,0,0,0,0,0,0,0,54,11,0,0,0,0,0,0,0,0,0,100
d16410a651c7cf6dd7b991d6bf91709fe016f937,0,0,0,0,0,0,0,0,0,0,0,0,0,0,140,2,0,0,0,0,0,0,0,0,0,100
91baad9c4a336bd149fd00e3d98fc774e88d5f0d,0,0,0,0,0,0,0,0,0,0,0,0,0,0,141,3,0,0,0,0,0,0,0,0,0,100
8cc6650d6d52d8192b0da80cb4b1f71e33dff822,0,0,0,0,0,0,0,0,0,0,0,0,0,0,142,4,0,0,0,0,0,0,0,0,0,100
104308d6bc6302b0d462ffc68105ec3c5dea14ad,0,0,0,0,0,0,0,0,0,0,0,0,0,0,143,5,0,0,0,0,0,0,0,0,0,100
c0463d0c376b260b4095106935855c938e80105b,0,0,0,0,0,0,0,0,0,0,0,0,0,0,42,8,0,0,0,0,0,0,0,0,0,100
cf373f2926e3e8e87b6aefe731d991611e65c95c,0,0,0,0,0,0,0,0,0,0,0,0,0,0,43,9,0,0,0,0,0,0,0,0,0,100
64c8da735db1a6e2f8492de820e80f3174be3cb1,0,0,0,0,0,0,0,0,0,0,0,0,0,0,144,6,0,0,0,0,0,0,0,0,0,100
e921542dca3ab6ca8a4f513eec3976f54d8d2379,0,0,0,0,0,0,0,0,0,0,0,0,0,0,145,7,0,0,0,0,0,0,0,0,0,100
1343c80eba2f6685266d3cae67ca6281c5f7f4cf,0,0,0,0,0,0,0,0,0,0,0,0,0,0,8,1,0,0,0,0,0,0,0,0,0,100
5b055ac43085b11e467acd66c8630f424b1af50e,0,0,0,0,0,0,0,0,0,0,0,0,0,0,0,0,0,0,0,0,0,0,0,0,0,100
9dedb2b8f635a2545617a65b4fdf1f074c3fc1a0,3,31,14,17,0,0,0,11,21,1833,1,1,1.125682832,709,0,0,155,150,5,4580,4472,108,78,75,3,100
76e55d8775efb02b5248aadf0bd512b137b58443,0,0,0,0,0,0,0,0,0,0,0,0,0,0,1,0,0,0,0,0,0,0,0,0,0,100
75e74ee45c6a6f250a8f1321537e0fbb6c97517d,0,0,0,0,0,0,0,0,0,0,0,0,0,0,83,0,0,0,0,0,0,0,0,0,0,100
a21094ba79a4cad3523a47507637e2f175650380,0,0,0,0,0,0,0,0,0,0,0,0,0,0,42,1,0,0,0,0,0,0,0,0,0,100
ac71ffe2812751b8a7e64660139a79c068b7af3c,0,0,0,0,0,0,0,0,0,0,0,0,0,0,146,6,0,0,0,0,0,0,0,0,0,100
284280984e8f6a446825d30ec8c8768a644500e3,0,0,0,0,0,0,0,0,0,0,0,0,0,0,147,7,0,0,0,0,0,0,0,0,0,100
fda48f29bdebbe9b7e0af9ee8397c8729f74b569,0,0,0,0,0,0,0,0,0,0,0,0,0,0,148,8,0,0,0,0,0,0,0,0,0,100
923ea8e6042db6eddbd727ee303adc54ae58f4b9,0,0,0,0,0,0,0,0,0,0,0,0,0,0,44,3,0,0,0,0,0,0,0,0,0,100
193d528d391a27079ae5ea4b0a01f4819405f6ff,0,0,0,0,0,0,0,0,0,0,0,0,0,0,24,1,0,0,0,0,0,0,0,0,0,100
c2bd724f8af1f67ef540f6b8f80fab88663a92bf,0,0,0,0,0,0,0,0,0,0,0,0,0,0,25,2,0,0,0,0,0,0,0,0,0,100
95440c4c5b904d93cfa878d3e13879a20ff499ff,0,0,0,0,0,0,0,0,0,0,0,0,0,0,55,4,0,0,0,0,0,0,0,0,0,100
7ba9447adc1d55a990125e4203c539611d093d50,2,129,0,129,2,0,2,1,1,0,1,1,0.999956652,0,9,1,4,0,4,643,0,643,4,0,4,99.83542481
ce74e7726b33ac414299a924c63a7a7bc036f8bd,0,0,0,0,0,0,0,0,0,0,0,0,0,0,56,1,0,0,0,0,0,0,0,0,0,100
ae89799545df2ffdb7cc8b42ce7ed63c435ed340,0,0,0,0,0,0,0,0,0,0,0,0,0,0,10,2,0,0,0,0,0,0,0,0,0,100
41fbaa8e9443bebc276dc8f2d056a155f47bf0c8,0,0,0,0,0,0,0,0,0,0,0,0,0,0,11,3,0,0,0,0,0,0,0,0,0,100
3fafde2cf8dd4b3a34cf48347a346c436741ae91,0,0,0,0,0,0,0,0,0,0,0,0,0,0,12,3,0,0,0,0,0,0,0,0,0,100
f56051539d9330722c36888b730aee5b559e01ec,0,0,0,0,0,0,0,0,0,0,0,0,0,0,57,2,0,0,0,0,0,0,0,0,0,100
57c5428543d63529dcac37610551f77132c690f0,0,0,0,0,0,0,0,0,0,0,0,0,0,0,58,3,0,0,0,0,0,0,0,0,0,100
bed2ec96a8d8ecbffcf02f0ec73e4f4ecb886fb9,0,0,0,0,0,0,0,0,0,0,0,0,0,0,59,4,0,0,0,0,0,0,0,0,0,100
0c769f94515cc13ae2130a818bf566cb09f27774,0,0,0,0,0,0,0,0,0,0,0,0,0,0,60,5,0,0,0,0,0,0,0,0,0,100
1ade72037cbb1f356f10f64550e5f94ce1a7fcde,0,0,0,0,0,0,0,0,0,0,0,0,0,0,61,5,0,0,0,0,0,0,0,0,0,100
043aeb148cf86c17bc2622671127e65261e1e8d4,0,0,0,0,0,0,0,0,0,0,0,0,0,0,149,0,0,0,0,0,0,0,0,0,0,100
e429672ba6f00db5cf5fecea7f6b344b5326f47b,0,0,0,0,0,0,0,0,0,0,0,0,0,0,150,1,0,0,0,0,0,0,0,0,0,100
74f6bb15c03136aedcac687c21c8914d1bee14ee,0,0,0,0,0,0,0,0,0,0,0,0,0,0,151,2,0,0,0,0,0,0,0,0,0,100
285858f7d9b7da8a5ae74990c785bc4e4818b940,0,0,0,0,0,0,0,0,0,0,0,0,0,0,152,3,0,0,0,0,0,0,0,0,0,100
744af614ba4565b4d34ff637923961bb2e17a62d,0,0,0,0,0,0,0,0,0,0,0,0,0,0,153,4,0,0,0,0,0,0,0,0,0,100
dc54464ea7694ad2facee1d333b1fa73ba1b9431,0,0,0,0,0,0,0,0,0,0,0,0,0,0,154,5,0,0,0,0,0,0,0,0,0,100
b821b223c6e9d027a14893171c858d3ed3f03196,0,0,0,0,0,0,0,0,0,0,0,0,0,0,155,6,0,0,0,0,0,0,0,0,0,100
2c13cd7e6d6d7485e1cdf93c9777f7d2ccae7558,0,0,0,0,0,0,0,0,0,0,0,0,0,0,62,5,0,0,0,0,0,0,0,0,0,100
b6298437279cfe340aa2d51f7f9a0666f77f9cfe,0,0,0,0,0,0,0,0,0,0,0,0,0,0,156,7,0,0,0,0,0,0,0,0,0,100
5776ae39aa1495812ad66a4ce7a7ac5fb305255b,0,0,0,0,0,0,0,0,0,0,0,0,0,0,157,8,0,0,0,0,0,0,0,0,0,100
e4f5674706704299eefd9abcf86d9b3fe84bd9a5,0,0,0,0,0,0,0,0,0,0,0,0,0,0,158,9,0,0,0,0,0,0,0,0,0,100
5ad000848653d85a7a47699eb84c411ca037b0e4,0,0,0,0,0,0,0,0,0,0,0,0,0,0,159,10,0,0,0,0,0,0,0,0,0,100
9738a759f01e267772092c2299d8f0d7047942a8,0,0,0,0,0,0,0,0,0,0,0,0,0,0,63,2,0,0,0,0,0,0,0,0,0,100
aa93007678cbabe118156179c8908399d481f625,0,0,0,0,0,0,0,0,0,0,0,0,0,0,160,3,0,0,0,0,0,0,0,0,0,100
a79c96ec8b2ac51c5da6f33c4461425db0763702,0,0,0,0,0,0,0,0,0,0,0,0,0,0,161,4,0,0,0,0,0,0,0,0,0,100
8a4abf06303480114c7eec3ced8ad77f3697bd32,0,0,0,0,0,0,0,0,0,0,0,0,0,0,162,5,0,0,0,0,0,0,0,0,0,100
051249634ad726f703c13341ad70917d300f517a,0,0,0,0,0,0,0,0,0,0,0,0,0,0,64,1,0,0,0,0,0,0,0,0,0,100
e1206ade30daca0cae5399fb1d88179bf3dbe7ec,0,0,0,0,0,0,0,0,0,0,0,0,0,0,65,2,0,0,0,0,0,0,0,0,0,100
d00865afecaea95b80eb3c511b8a018fd3070d99,0,0,0,0,0,0,0,0,0,0,0,0,0,0,66,3,0,0,0,0,0,0,0,0,0,100
a8ee8778dfdccbc9bf5c8423d0d7dbdf1c2c0cbf,0,0,0,0,0,0,0,0,0,0,0,0,0,0,67,4,0,0,0,0,0,0,0,0,0,100
79976977feba9a1e77ca1d96137295bc0ab96e8a,0,0,0,0,0,0,0,0,0,0,0,0,0,0,43,0,0,0,0,0,0,0,0,0,0,100
8c723173cfcd42a098e374cdcb2416776f61393a,0,0,0,0,0,0,0,0,0,0,0,0,0,0,14,0,0,0,0,0,0,0,0,0,0,100
7f42e3ca9b44fc1745a59205445417d70ae294e7,0,0,0,0,0,0,0,0,0,0,0,0,0,0,0,0,0,0,0,0,0,0,0,0,0,100
659917b08184528999e3307e69fabc6a66fd07b3,0,0,0,0,0,0,0,0,0,0,0,0,0,0,0,0,0,0,0,0,0,0,0,0,0,100
5a80e32e6bba7d44fef0edfe333ff62c55da1392,2,4,1,3,0,0,0,21,72,369,1,2,0.970950594,1244,0,0,355,355,0,9947,9947,0,91,91,0,100
5f15869cb3c3a031a755c7b10194625d5150d68d,0,0,0,0,0,0,0,0,0,0,0,0,0,0,42,0,0,0,0,0,0,0,0,0,0,100
5af6e43fa03be6d2a6dba4842479ae06e70bcd68,0,0,0,0,0,0,0,0,0,0,0,0,0,0,163,3,0,0,0,0,0,0,0,0,0,100
41c5a3710d03b26bad5e90d04bfc51d6d9e20d65,1,1,1,0,0,0,0,2,2,2267,1,1,0,40,1,1,2,2,0,168,168,0,1,1,0,100
e53628d62c14f95ae9acb74449b5445f00ca072f,0,0,0,0,0,0,0,0,0,0,0,0,0,0,43,1,0,0,0,0,0,0,0,0,0,100
990ed3eb8a7b10ebdbde709458c7754ca4972b9c,0,0,0,0,0,0,0,0,0,0,0,0,0,0,44,2,0,0,0,0,0,0,0,0,0,100
6de4d088630e0ec6c6b5e603f2029bda4f9530a7,0,0,0,0,0,0,0,0,0,0,0,0,0,0,1,1,0,0,0,0,0,0,0,0,0,100
e4a40c4d6e93a50c17f7e42dd54928f8c42f633d,0,0,0,0,0,0,0,0,0,0,0,0,0,0,15,1,0,0,0,0,0,0,0,0,0,100
f068da73b8543c9f6d151d1af58a43d8164b5adc,0,0,0,0,0,0,0,0,0,0,0,0,0,0,2,2,0,0,0,0,0,0,0,0,0,100
a8821d3ddd7e86d9567e48f0bc6387dcc0214c66,0,0,0,0,0,0,0,0,0,0,0,0,0,0,0,0,0,0,0,0,0,0,0,0,0,100
f190f1e7d46f557881c3dc600df26d9d78a0233f,2,54,1,53,0,0,0,14,86,378,1,2,0.997852777,1884,2,2,512,506,6,13784,13501,283,238,235,3,100
e42a570fe5405f85dd5a3bab621b725d8766463f,0,0,0,0,0,0,0,0,0,0,0,0,0,0,164,1,0,0,0,0,0,0,0,0,0,100
30bb7b43d8f702e9cfe4928c1e91cb764c9437d8,0,0,0,0,0,0,0,0,0,0,0,0,0,0,68,0,0,0,0,0,0,0,0,0,0,100
d17c5cc5c066297a09208098627bbed062549dd7,0,0,0,0,0,0,0,0,0,0,0,0,0,0,69,1,0,0,0,0,0,0,0,0,0,100
eb3342bb445e42b6bd1ceedc264884d20306e98c,0,0,0,0,0,0,0,0,0,0,0,0,0,0,45,3,0,0,0,0,0,0,0,0,0,100
3f59a62b6d9ef01aa92674c9b3e776d2bee8b252,0,0,0,0,0,0,0,0,0,0,0,0,0,0,46,4,0,0,0,0,0,0,0,0,0,100
f7142660d7ca58747fd53027182a42dd2acc8a1b,0,0,0,0,0,0,0,0,0,0,0,0,0,0,47,5,0,0,0,0,0,0,0,0,0,100
bbe92d0052e2561bb4dca4739c12f9a419cb1a3f,0,0,0,0,0,0,0,0,0,0,0,0,0,0,165,2,0,0,0,0,0,0,0,0,0,100
903fa84725ca5b2aaa1c740c9b0c3b4dcf24e023,0,0,0,0,0,0,0,0,0,0,0,0,0,0,48,6,0,0,0,0,0,0,0,0,0,100
dd1d7ae0758596b6b4183a87eb3b94f1e7f298c2,0,0,0,0,0,0,0,0,0,0,0,0,0,0,49,7,0,0,0,0,0,0,0,0,0,100
f6740929b08cb3e4e04b7b303da9152dfa11b93e,0,0,0,0,0,0,0,0,0,0,0,0,0,0,50,8,0,0,0,0,0,0,0,0,0,100
a71fe72336d1ef5f387751551c5429a8a7c4c082,0,0,0,0,0,0,0,0,0,0,0,0,0,0,51,9,0,0,0,0,0,0,0,0,0,100
0654da6a33cab41c894a4b3dfdde6048a75f887a,0,0,0,0,0,0,0,0,0,0,0,0,0,0,52,10,0,0,0,0,0,0,0,0,0,100
29600bd2f569b1d31f3ffdc9f2ebd55d13db8527,0,0,0,0,0,0,0,0,0,0,0,0,0,0,70,2,0,0,0,0,0,0,0,0,0,100
bf6b86d2c784ced5ec791f8249d3f2ecf18a4ee0,0,0,0,0,0,0,0,0,0,0,0,0,0,0,71,3,0,0,0,0,0,0,0,0,0,100
8066c57fe567c7f52ce2fd6c4d47a12831782351,0,0,0,0,0,0,0,0,0,0,0,0,0,0,72,4,0,0,0,0,0,0,0,0,0,100
797cec66c4d4b2d4eaf909bfc2a7d98922e2b128,1,15,2,13,0,0,0,5,13,1460,1,1,0,73,0,0,11,9,2,644,578,66,4,3,1,100
1d72182fd6afc149d33b5de8e2c68492c116732f,0,0,0,0,0,0,0,0,0,0,0,0,0,0,73,5,0,0,0,0,0,0,0,0,0,100
85348352cebf14a465eea0725b316b471e2020ad,0,0,0,0,0,0,0,0,0,0,0,0,0,0,166,2,0,0,0,0,0,0,0,0,0,100
820ed6e5ea4417b5735078bfd26c99f1305ea363,2,198,24,174,1,0,1,1,40,215,1,2,0.995252549,419,3,2,136,112,24,3795,2909,886,58,44,14,93.27450513
80c04a32dcbc0165c4e7f15f79c83afc6937193a,0,0,0,0,0,0,0,0,0,0,0,0,0,0,53,10,0,0,0,0,0,0,0,0,0,100
2a46a61b65697706e2277921c3bf5ccb819c311f,0,0,0,0,0,0,0,0,0,0,0,0,0,0,0,0,0,0,0,0,0,0,0,0,0,100
d5621e9f8da61c02e4339c11b6852ad059dd72b3,11,210,1,209,0,0,0,6,45,1392,1,4,1.625282754,2127,4,2,581,553,28,20754,19375,1379,342,329,13,100
da2459fbc9edfd867fbd4bd7d77602b79d0ad3ce,0,0,0,0,0,0,0,0,0,0,0,0,0,0,167,3,0,0,0,0,0,0,0,0,0,90.68895935
5fc7e599958c38d5aa1d46776fbc8590fcc02424,0,0,0,0,0,0,0,0,0,0,0,0,0,0,168,4,0,0,0,0,0,0,0,0,0,100
d4f7d57b43c798fd236020fe422072682cfdc67e,0,0,0,0,0,0,0,0,0,0,0,0,0,0,74,6,0,0,0,0,0,0,0,0,0,100
eb2477555d32d25ec1e8f5469d52ff76beaf33b6,0,0,0,0,0,0,0,0,0,0,0,0,0,0,0,0,0,0,0,0,0,0,0,0,0,100
54c2110d05517793cb68e3a69d2e863bb7680f57,0,0,0,0,0,0,0,0,0,0,0,0,0,0,169,4,0,0,0,0,0,0,0,0,0,100
40418733744975977c050677cf14ca3623e60c0b,0,0,0,0,0,0,0,0,0,0,0,0,0,0,170,5,0,0,0,0,0,0,0,0,0,100
9d79af0962bc2d4400d86175340fe16542cc1988,0,0,0,0,0,0,0,0,0,0,0,0,0,0,171,6,0,0,0,0,0,0,0,0,0,100
d193d4e7c4a19f535d56e2737e9eea20e3093af0,0,0,0,0,0,0,0,0,0,0,0,0,0,0,172,7,0,0,0,0,0,0,0,0,0,100
6ef5709e6c53629b41890f9df3047554663d3727,0,0,0,0,0,0,0,0,0,0,0,0,0,0,173,8,0,0,0,0,0,0,0,0,0,100
3843ad09d37a7af89dd7e16c50824c87e450a3b3,0,0,0,0,0,0,0,0,0,0,0,0,0,0,174,8,0,0,0,0,0,0,0,0,0,100
5ca085de87274d05e6190fa571f7b9dc1d1b497d,0,0,0,0,0,0,0,0,0,0,0,0,0,0,175,9,0,0,0,0,0,0,0,0,0,100
82e9bae4be13eb6b2c9e65f6f467a5e601969fd6,0,0,0,0,0,0,0,0,0,0,0,0,0,0,176,9,0,0,0,0,0,0,0,0,0,100
2a7e85185e92f5ccb7f36b7cfab1d96e76b2bd12,3,94,97,3,0,0,0,11,28,1420,1,2,1.365873152,711,5,1,77,78,1,6141,6085,56,44,45,1,100
9c144131f1887a69221e5b30101ed890c214c277,1,3,3,0,0,0,0,6,10,2732,1,1,0,199,0,0,16,16,0,1618,1618,0,11,11,0,100
f0ac564f981556e7a92cafc7a0e10eb95ed9d9e2,0,0,0,0,0,0,0,0,0,0,0,0,0,0,177,10,0,0,0,0,0,0,0,0,0,100
18c9b4afb53f6216eca1fb464afaa1082781bf11,0,0,0,0,0,0,0,0,0,0,0,0,0,0,6,2,0,0,0,0,0,0,0,0,0,100
945820a9ce5a4ad67fb9a9cdacbddbaacfd2e5db,0,0,0,0,0,0,0,0,0,0,0,0,0,0,0,0,0,0,0,0,0,0,0,0,0,90.68895935
aa2a3f1ab23d299449e9bdd85abf6276be8cb70d,0,0,0,0,0,0,0,0,0,0,0,0,0,0,178,9,0,0,0,0,0,0,0,0,0,100
8dc17b15f3791666667fb5c1ab140c084be1f2d1,0,0,0,0,0,0,0,0,0,0,0,0,0,0,179,10,0,0,0,0,0,0,0,0,0,100
4e1a1a854482b2bb0085de67d13c60e4dd6c6550,0,0,0,0,0,0,0,0,0,0,0,0,0,0,180,11,0,0,0,0,0,0,0,0,0,100
39480d6b67345c7d7d6d2de4447cae7215991b1c,1,1,1,0,0,0,0,4,12,2380,1,1,0,347,108,0,83,84,1,2209,2213,4,25,25,0,100
f2c5d56c2f57a26d7bca29d03a7352759c081dd4,0,0,0,0,0,0,0,0,0,0,0,0,0,0,181,12,0,0,0,0,0,0,0,0,0,100
36b18515b014075ec2b3018ed9d598f18d44cfce,0,0,0,0,0,0,0,0,0,0,0,0,0,0,182,13,0,0,0,0,0,0,0,0,0,100
cdc597490720a95a6cec40cb31c89116f74cddd5,0,0,0,0,0,0,0,0,0,0,0,0,0,0,183,14,0,0,0,0,0,0,0,0,0,100
61a1cdcd500356726d4995c19c8a4d5d89989b13,0,0,0,0,0,0,0,0,0,0,0,0,0,0,0,0,0,0,0,0,0,0,0,0,0,100
4465d88d8eb8a89d4adffb7506393416dd3a964f,0,0,0,0,0,0,0,0,0,0,0,0,0,0,0,0,0,0,0,0,0,0,0,0,0,100
2c80b563a323dc24bd684385f0b2d95c3a066bd2,0,0,0,0,0,0,0,0,0,0,0,0,0,0,109,1,0,0,0,0,0,0,0,0,0,100
816f025d3c4e324621b847b0268db0c5e2922afc,0,0,0,0,0,0,0,0,0,0,0,0,0,0,184,10,0,0,0,0,0,0,0,0,0,100
e9c10d552c14917b0bc7a13c403436d8e769dacc,0,0,0,0,0,0,0,0,0,0,0,0,0,0,185,11,0,0,0,0,0,0,0,0,0,100
d3373bb12d2d0bf60964ad4a2cded4fc22bd31db,0,0,0,0,0,0,0,0,0,0,0,0,0,0,186,12,0,0,0,0,0,0,0,0,0,100
799aa75211dc54b312728605610717cb50a7ef95,0,0,0,0,0,0,0,0,0,0,0,0,0,0,187,13,0,0,0,0,0,0,0,0,0,100
74cee286d9c1c52130ac4b7f45d5b88d61f714f6,0,0,0,0,0,0,0,0,0,0,0,0,0,0,188,14,0,0,0,0,0,0,0,0,0,100
4581778df4d2ce7a0d54d691b439b020c005a56c,0,0,0,0,0,0,0,0,0,0,0,0,0,0,189,11,0,0,0,0,0,0,0,0,0,100
a0ace883567d4cd8528049befe821ff2e320bab3,0,0,0,0,0,0,0,0,0,0,0,0,0,0,190,12,0,0,0,0,0,0,0,0,0,100
f4539483a4121e81b6d6f4f4c1b53ead941d7541,0,0,0,0,0,0,0,0,0,0,0,0,0,0,191,13,0,0,0,0,0,0,0,0,0,100
15fa5ee2675d08270d90360cf4d6464ae94a1cc5,0,0,0,0,0,0,0,0,0,0,0,0,0,0,192,14,0,0,0,0,0,0,0,0,0,100
1a3b778ff47d62e10fbf1499e4f094123c320fe7,0,0,0,0,0,0,0,0,0,0,0,0,0,0,193,15,0,0,0,0,0,0,0,0,0,100
c3c64a1bf8bd7f641327cca0b7f329ed01dedf58,0,0,0,0,0,0,0,0,0,0,0,0,0,0,54,0,0,0,0,0,0,0,0,0,0,100
0a8538958fd7442d0d4255118cc0c8e45027235c,0,0,0,0,0,0,0,0,0,0,0,0,0,0,194,16,0,0,0,0,0,0,0,0,0,100
7c99739a4063c56c229f71b32bb9271d0c5fbf5e,0,0,0,0,0,0,0,0,0,0,0,0,0,0,195,17,0,0,0,0,0,0,0,0,0,100
715b25f86bdfdda5935b5202ad8eab941262743c,0,0,0,0,0,0,0,0,0,0,0,0,0,0,196,18,0,0,0,0,0,0,0,0,0,100
4787332b70b3fcf54e3ca14fc04aded363f27614,0,0,0,0,0,0,0,0,0,0,0,0,0,0,197,19,0,0,0,0,0,0,0,0,0,100
b201f5dff1034f1c0ab91146f2f42cc8f014a3c9,0,0,0,0,0,0,0,0,0,0,0,0,0,0,198,20,0,0,0,0,0,0,0,0,0,100
7825226b1d43c6dda4964f4f1090f77d4dfb7eee,0,0,0,0,0,0,0,0,0,0,0,0,0,0,75,0,0,0,0,0,0,0,0,0,0,100
68baaaefc16aac47d32c230f0240045087b4bc99,0,0,0,0,0,0,0,0,0,0,0,0,0,0,76,1,0,0,0,0,0,0,0,0,0,100
163c74767b0ce3cf4deb6993633384386dbf41b7,0,0,0,0,0,0,0,0,0,0,0,0,0,0,199,18,0,0,0,0,0,0,0,0,0,100
63db93752951d6b1cba693087093f69eb64de074,0,0,0,0,0,0,0,0,0,0,0,0,0,0,200,19,0,0,0,0,0,0,0,0,0,100
9c91c4450643b2ae03f645977105bcc2a49ad0e1,0,0,0,0,0,0,0,0,0,0,0,0,0,0,55,1,0,0,0,0,0,0,0,0,0,100
22e0b4f9030f067bf615b91a0e2e4f4f2228cded,0,0,0,0,0,0,0,0,0,0,0,0,0,0,201,17,0,0,0,0,0,0,0,0,0,100
7a4a5e0b6437c8dba73936007a4704d34e2f9558,0,0,0,0,0,0,0,0,0,0,0,0,0,0,202,18,0,0,0,0,0,0,0,0,0,100
089e40f9ca0253962009fd277995a627a65620eb,0,0,0,0,0,0,0,0,0,0,0,0,0,0,77,2,0,0,0,0,0,0,0,0,0,100
7fd454e4a0880e928d7fbc417895a4ab4e4ad3cf,0,0,0,0,0,0,0,0,0,0,0,0,0,0,0,0,0,0,0,0,0,0,0,0,0,100
73d491da866ca698291b191e1fa1a17fbb98ea6e,0,0,0,0,0,0,0,0,0,0,0,0,0,0,203,19,0,0,0,0,0,0,0,0,0,100
ce2439d7a7669a5c7f2fa555c661770fbe67493a,0,0,0,0,0,0,0,0,0,0,0,0,0,0,0,0,0,0,0,0,0,0,0,0,0,100
864774b473202d11544cb869e9323de01c5ffe5c,0,0,0,0,0,0,0,0,0,0,0,0,0,0,78,3,0,0,0,0,0,0,0,0,0,100
9101d30d05ff1672bdae5ed4a39177453de55aa4,0,0,0,0,0,0,0,0,0,0,0,0,0,0,204,15,0,0,0,0,0,0,0,0,0,100
bce7ad409a26e16255839363d7596f8a3bca3d70,0,0,0,0,0,0,0,0,0,0,0,0,0,0,79,4,0,0,0,0,0,0,0,0,0,100
f87f3a6438fa9c34aa6b9921decabc7ab9f410dd,0,0,0,0,0,0,0,0,0,0,0,0,0,0,205,16,0,0,0,0,0,0,0,0,0,100
214a888962854d975ffd1650881dd249e10192cb,0,0,0,0,0,0,0,0,0,0,0,0,0,0,206,17,0,0,0,0,0,0,0,0,0,100
d70b8470ba81c563e7fc82cc99b00d8a4de29560,0,0,0,0,0,0,0,0,0,0,0,0,0,0,80,5,0,0,0,0,0,0,0,0,0,100
63c58f3b29d20ba94a6c68d9e4c09816d448bf34,0,0,0,0,0,0,0,0,0,0,0,0,0,0,81,6,0,0,0,0,0,0,0,0,0,100
f6e45907726db2ed30b9eb6831cddce195ea193a,0,0,0,0,0,0,0,0,0,0,0,0,0,0,44,0,0,0,0,0,0,0,0,0,0,100
1008ce35bff83f7f98d5bd06b03b25c387efd4fc,0,0,0,0,0,0,0,0,0,0,0,0,0,0,207,8,0,0,0,0,0,0,0,0,0,100
d7102dfbcd49b0f7405853f76aea70e134a8b3ff,0,0,0,0,0,0,0,0,0,0,0,0,0,0,208,5,0,0,0,0,0,0,0,0,0,100
d3ecee924b5626eb003c5e60618a4db7e4292ff4,0,0,0,0,0,0,0,0,0,0,0,0,0,0,209,6,0,0,0,0,0,0,0,0,0,100
d336c6c7b91f9f39de2a5e34ae55c1d7c118507b,0,0,0,0,0,0,0,0,0,0,0,0,0,0,82,4,0,0,0,0,0,0,0,0,0,100
f1c04f7e4d664a976e0f525ac1e1726321aa11ad,2,152,2,150,0,0,0,4,23,2035,1,2,0.346731468,398,0,0,117,89,28,3531,2725,806,48,34,14,100
ddf10bd17f591638f12128c4fff2b4681b245ac0,0,0,0,0,0,0,0,0,0,0,0,0,0,0,0,0,0,0,0,0,0,0,0,0,0,100
ae31eb12a06b5387f56261283344fdbaaeca2f02,0,0,0,0,0,0,0,0,0,0,0,0,0,0,1,1,0,0,0,0,0,0,0,0,0,100
5ff1e8d2519d9f225220631b99bbe6320454f225,0,0,0,0,0,0,0,0,0,0,0,0,0,0,210,3,0,0,0,0,0,0,0,0,0,100
09041facad0a4c2c131b7ffde6497d7580b964b9,0,0,0,0,0,0,0,0,0,0,0,0,0,0,45,1,0,0,0,0,0,0,0,0,0,100
3e33348d2da6e794ca7ff80bafe39b5788e0a956,0,0,0,0,0,0,0,0,0,0,0,0,0,0,211,4,0,0,0,0,0,0,0,0,0,100
1841ff115d52727094998b80798d52210b8addb6,0,0,0,0,0,0,0,0,0,0,0,0,0,0,1,0,0,0,0,0,0,0,0,0,0,100
1542fc732647fea2a56098229061b19ffc40e56d,0,0,0,0,0,0,0,0,0,0,0,0,0,0,212,5,0,0,0,0,0,0,0,0,0,100
c9f2bf4d4b7be55bcb944b1a509eab430e24c327,0,0,0,0,0,0,0,0,0,0,0,0,0,0,213,6,0,0,0,0,0,0,0,0,0,100
1943b173b9de00fa907d89bb11a98fbf8670fbb3,0,0,0,0,0,0,0,0,0,0,0,0,0,0,214,7,0,0,0,0,0,0,0,0,0,100
de1e7862df787e7fc5a6bc44a0962d9eeca77d64,0,0,0,0,0,0,0,0,0,0,0,0,0,0,215,8,0,0,0,0,0,0,0,0,0,100
8fe8b6f480bdcd4d9c4023e45f4a40311b416951,0,0,0,0,0,0,0,0,0,0,0,0,0,0,216,9,0,0,0,0,0,0,0,0,0,100
0066daff46b66c0bd28b5525ba3d2f32f26046e3,2,82,1,81,1,0,1,2,41,5255,1,2,0.163860513,455,7,0,126,121,5,3533,3158,375,56,51,5,96.52107669
b9deb0b3bfc7bcb0c78ff3a28af51dd9792d34d6,0,0,0,0,0,0,0,0,0,0,0,0,0,0,217,7,0,0,0,0,0,0,0,0,0,100
720e3a80dfd1eb32c64ce13a968aaa9dbf875769,0,0,0,0,0,0,0,0,0,0,0,0,0,0,218,8,0,0,0,0,0,0,0,0,0,100
bf4ee7abe3bf2c4aff4eac0ed9d40dbc8e824a7a,0,0,0,0,0,0,0,0,0,0,0,0,0,0,219,9,0,0,0,0,0,0,0,0,0,100
7c17fd534b477236a9a1b635a5375c99ce811e94,0,0,0,0,0,0,0,0,0,0,0,0,0,0,220,10,0,0,0,0,0,0,0,0,0,100
34845fd49af9cd00e98f5930c6ac6190da5ea6a3,2,9,1,8,0,0,0,11,23,644,1,1,0.970950594,558,1,0,27,27,0,6014,5906,108,24,24,0,100
90b273ac6b038f319a7bcbfa4d7ba713a390c792,0,0,0,0,0,0,0,0,0,0,0,0,0,0,83,0,0,0,0,0,0,0,0,0,0,100
e233f2ff89ed62e8adf4b3b53ab5b187f391525d,0,0,0,0,0,0,0,0,0,0,0,0,0,0,56,0,0,0,0,0,0,0,0,0,0,100
c78f12f91350c01ac8cdba3d61f5650c0a2668b3,2,123,9,114,1,0,1,1,14,324,1,2,0.387051421,505,8,1,153,154,1,4652,3597,1055,28,24,4,86.1885003
a84ed7cbe76cde30d2b0dc6a6f11bbd177935efe,0,0,0,0,0,0,0,0,0,0,0,0,0,0,221,9,0,0,0,0,0,0,0,0,0,100
6c3b743fe0a8621395a92d496b48bfd93dc112ed,0,0,0,0,0,0,0,0,0,0,0,0,0,0,222,10,0,0,0,0,0,0,0,0,0,100
64f7d05156c19800bd99f753db7c4e89a7d61119,0,0,0,0,0,0,0,0,0,0,0,0,0,0,223,11,0,0,0,0,0,0,0,0,0,100
39e0aea84a67f5c41ed94518164a706d2d53309c,0,0,0,0,0,0,0,0,0,0,0,0,0,0,224,9,0,0,0,0,0,0,0,0,0,100
859645d4a55bd8d2890dafa1ce899ac990eaba9b,1,9,9,0,0,0,0,3,6,3546,1,1,0,68,84,1,6,6,0,409,391,18,5,5,0,100
b26fbee245e39fd1aed19c16711126979b311691,3,78,44,34,0,0,0,9,23,1557,1,2,0.796728646,1292,9,2,247,238,9,8568,8401,167,130,126,4,99.95822891
778aea4bf825e5aa6ead949c8d6359368d85b92d,0,0,0,0,0,0,0,0,0,0,0,0,0,0,225,8,0,0,0,0,0,0,0,0,0,100
949af9828bc5db1a701a2b333506b4f15ec09cad,0,0,0,0,0,0,0,0,0,0,0,0,0,0,226,9,0,0,0,0,0,0,0,0,0,100
8d4a22bdf1726c9782752251518b685013c43c9f,0,0,0,0,0,0,0,0,0,0,0,0,0,0,0,0,0,0,0,0,0,0,0,0,0,100
c3b03d986f558106126938690a37e4fccec07f22,0,0,0,0,0,0,0,0,0,0,0,0,0,0,227,10,0,0,0,0,0,0,0,0,0,100
40d6127d9680e376adb22610c411b2f7d8a2b010,0,0,0,0,0,0,0,0,0,0,0,0,0,0,228,11,0,0,0,0,0,0,0,0,0,100
043df25f13d7796e34ce0d5f907b4ffd3604f3ae,0,0,0,0,0,0,0,0,0,0,0,0,0,0,229,12,0,0,0,0,0,0,0,0,0,100
fd01ae5fc2d3143fec6cd122f392367110bac7d4,0,0,0,0,0,0,0,0,0,0,0,0,0,0,230,13,0,0,0,0,0,0,0,0,0,100
aa18292cb1cb56b7be19072a1892f0bc455d3ec1,0,0,0,0,0,0,0,0,0,0,0,0,0,0,231,14,0,0,0,0,0,0,0,0,0,100
a2c111dc3581f9549b173f7c6a9073cfbf173558,0,0,0,0,0,0,0,0,0,0,0,0,0,0,232,15,0,0,0,0,0,0,0,0,0,100
dd6c4567b551858e8099af8ddc6b91d3657647d9,0,0,0,0,0,0,0,0,0,0,0,0,0,0,233,16,0,0,0,0,0,0,0,0,0,100
be4a1dda31a325f1db967eebb1e1c57a5f8462ac,0,0,0,0,0,0,0,0,0,0,0,0,0,0,234,17,0,0,0,0,0,0,0,0,0,100
585c2f00bd6f9474978d4faeed267a4dd843a2f0,0,0,0,0,0,0,0,0,0,0,0,0,0,0,235,14,0,0,0,0,0,0,0,0,0,100
eb2b19d0e034dc1157dbcca5a26440c04180c704,0,0,0,0,0,0,0,0,0,0,0,0,0,0,10,2,0,0,0,0,0,0,0,0,0,100
f895a3296edb1fc29e955ebe572c6156f6a2ccd7,0,0,0,0,0,0,0,0,0,0,0,0,0,0,236,15,0,0,0,0,0,0,0,0,0,100
4c5eabcc90a409b101179c77aecb986f89a84c51,0,0,0,0,0,0,0,0,0,0,0,0,0,0,237,16,0,0,0,0,0,0,0,0,0,100
bf0b7502b499613f77c96c6293d99bff76edc8de,0,0,0,0,0,0,0,0,0,0,0,0,0,0,238,17,0,0,0,0,0,0,0,0,0,100
257dd76ada27a08b04e163007a63b497b4c02afe,0,0,0,0,0,0,0,0,0,0,0,0,0,0,239,15,0,0,0,0,0,0,0,0,0,100
14db7b75f5294333734807ce9b2ed693884250bf,0,0,0,0,0,0,0,0,0,0,0,0,0,0,240,15,0,0,0,0,0,0,0,0,0,100
e949af01d1f26301811db0dd32d2b186f73efe9c,0,0,0,0,0,0,0,0,0,0,0,0,0,0,241,16,0,0,0,0,0,0,0,0,0,100
2c188b3a603ef848b4d5e5e1f4140d68c7ecc42b,0,0,0,0,0,0,0,0,0,0,0,0,0,0,242,17,0,0,0,0,0,0,0,0,0,100
8640436de52ed25ccb0dbfb125cc3f142e968889,0,0,0,0,0,0,0,0,0,0,0,0,0,0,85,1,0,0,0,0,0,0,0,0,0,100
4f50a16498293c705f0435e1010e5672d369e810,0,0,0,0,0,0,0,0,0,0,0,0,0,0,243,18,0,0,0,0,0,0,0,0,0,100
046b4d153066c4afbdd681a71c6bdc5d706b1d35,0,0,0,0,0,0,0,0,0,0,0,0,0,0,244,11,0,0,0,0,0,0,0,0,0,100
1b80874ab96456ef7b662fb45065f051f34e90f0,0,0,0,0,0,0,0,0,0,0,0,0,0,0,245,12,0,0,0,0,0,0,0,0,0,100
0f1848ea5c0191fa74a9b686d00c02917cb75849,0,0,0,0,0,0,0,0,0,0,0,0,0,0,246,13,0,0,0,0,0,0,0,0,0,100
8e965fae1541d72653ae73ae27499eae4f72c4a4,0,0,0,0,0,0,0,0,0,0,0,0,0,0,247,14,0,0,0,0,0,0,0,0,0,100
77692d8c147e3a83812fa1a409ea31349962eb49,0,0,0,0,0,0,0,0,0,0,0,0,0,0,248,15,0,0,0,0,0,0,0,0,0,100
fa9ff6fb6cb0329382a51d8187831822a0739a12,0,0,0,0,0,0,0,0,0,0,0,0,0,0,249,10,0,0,0,0,0,0,0,0,0,100
2d8148a6731560d600a67eec705e02fee6c25bd7,0,0,0,0,0,0,0,0,0,0,0,0,0,0,250,11,0,0,0,0,0,0,0,0,0,100
d45036ff7a329dbcfd6d2e969397949cc9b9d6b7,0,0,0,0,0,0,0,0,0,0,0,0,0,0,251,12,0,0,0,0,0,0,0,0,0,100
92d57060f98f60de2a5e6eb95a91bc2bc5a61db6,0,0,0,0,0,0,0,0,0,0,0,0,0,0,0,0,0,0,0,0,0,0,0,0,0,100
fc71db2a9e65fd91cd6e49f6cdc7d41eccf914e3,0,0,0,0,0,0,0,0,0,0,0,0,0,0,0,0,0,0,0,0,0,0,0,0,0,100
3c4f5adccffd894c106e81132f39d96cab4c20b3,0,0,0,0,0,0,0,0,0,0,0,0,0,0,86,0,0,0,0,0,0,0,0,0,0,100
63844f8114e6d1068ab8443f5fb988e56f28a277,0,0,0,0,0,0,0,0,0,0,0,0,0,0,46,0,0,0,0,0,0,0,0,0,0,100
1027938c46ed3ae07ac7c23ecd0764bd357df23f,0,0,0,0,0,0,0,0,0,0,0,0,0,0,47,1,0,0,0,0,0,0,0,0,0,100
e23899e64d36722fd83f9a0c9c06a1859a1a025c,0,0,0,0,0,0,0,0,0,0,0,0,0,0,252,3,0,0,0,0,0,0,0,0,0,100
56703cdbb725868e7849cac5233c8e140d995dc4,0,0,0,0,0,0,0,0,0,0,0,0,0,0,253,4,0,0,0,0,0,0,0,0,0,100
4e5a58f77c62875a136897470fb0100d7662b940,0,0,0,0,0,0,0,0,0,0,0,0,0,0,254,5,0,0,0,0,0,0,0,0,0,100
c07ab64fa88949640427a8dac0eb474f80dca979,0,0,0,0,0,0,0,0,0,0,0,0,0,0,255,6,0,0,0,0,0,0,0,0,0,100
db5b687abd06d41bf3db264361c283cd27705a9b,0,0,0,0,0,0,0,0,0,0,0,0,0,0,256,7,0,0,0,0,0,0,0,0,0,100
6d90ec4b1c4ba47dba16650c54b4c15265016190,0,0,0,0,0,0,0,0,0,0,0,0,0,0,0,0,0,0,0,0,0,0,0,0,0,100
3e3be73bdb7f42bb05babc9c89f38c0e08734e62,0,0,0,0,0,0,0,0,0,0,0,0,0,0,0,0,0,0,0,0,0,0,0,0,0,100
84ea6cb19098d834c6946eb07658f8816f0c98e8,0,0,0,0,0,0,0,0,0,0,0,0,0,0,257,8,0,0,0,0,0,0,0,0,0,100
627b005493bb8abe6a0ffc53c709ad1b7967c769,5,112,0,112,0,0,0,5,56,612,1,3,1.271970591,2208,0,0,451,432,19,16678,16043,635,208,199,9,100
5a0fb0ffcebf3cc2c268fbe74fe117ff64cdfbe1,0,0,0,0,0,0,0,0,0,0,0,0,0,0,57,0,0,0,0,0,0,0,0,0,0,100
0d241cb038941af8428a0b886482e7d1a27bd0ec,0,0,0,0,0,0,0,0,0,0,0,0,0,0,258,9,0,0,0,0,0,0,0,0,0,100
016323828f147f185d03f50d2223a2f50bfafce1,0,0,0,0,0,0,0,0,0,0,0,0,0,0,0,0,0,0,0,0,0,0,0,0,0,100
4ed213c631caeddd686c1ddd65cc1451a8935542,0,0,0,0,0,0,0,0,0,0,0,0,0,0,259,10,0,0,0,0,0,0,0,0,0,100
c1e57e5bbcf1a8de26a594e6ce74f44ed1f37a18,0,0,0,0,0,0,0,0,0,0,0,0,0,0,260,11,0,0,0,0,0,0,0,0,0,100
d4f527a8ba8b57188cc68d34181741bd6ae7cda0,0,0,0,0,0,0,0,0,0,0,0,0,0,0,261,12,0,0,0,0,0,0,0,0,0,100
8daf14945329aee9d02a4148188fa7149ed244ef,0,0,0,0,0,0,0,0,0,0,0,0,0,0,262,13,0,0,0,0,0,0,0,0,0,100
6e1d87e5b72fa5479adea68c76cec810e6ac9c0a,0,0,0,0,0,0,0,0,0,0,0,0,0,0,263,14,0,0,0,0,0,0,0,0,0,100
a99da1cc92a2379abb2661df85c58903a7a86826,0,0,0,0,0,0,0,0,0,0,0,0,0,0,264,15,0,0,0,0,0,0,0,0,0,100
fdc73684d90a6e126971dbf94799fa9993e42363,0,0,0,0,0,0,0,0,0,0,0,0,0,0,265,16,0,0,0,0,0,0,0,0,0,100
ef1e5394e6f5c06ac3a68800d6dc9d00ceee9c9a,0,0,0,0,0,0,0,0,0,0,0,0,0,0,266,17,0,0,0,0,0,0,0,0,0,100
e2d59b29dc6e81992ad373b4fef08b5003dccca6,0,0,0,0,0,0,0,0,0,0,0,0,0,0,0,0,0,0,0,0,0,0,0,0,0,100
50a12a3bb5244bf80ef2238d920636d1253a0ca9,1,1,2,1,0,0,0,18,31,1201,1,1,0,179,1,1,36,36,0,1300,1300,0,8,8,0,100
04f024369ed7caf6237f5d048c0c9ca6d109dccf,0,0,0,0,0,0,0,0,0,0,0,0,0,0,267,15,0,0,0,0,0,0,0,0,0,100
fb4625ec4bdad9c8669f4c9257c387885d0bf01b,0,0,0,0,0,0,0,0,0,0,0,0,0,0,268,11,0,0,0,0,0,0,0,0,0,100
382ceb1e506ed1537279fd9fd88f512db87ef24a,0,0,0,0,0,0,0,0,0,0,0,0,0,0,269,12,0,0,0,0,0,0,0,0,0,100
a6b5879b5729c76224166f3e971a3b98f17a78b3,0,0,0,0,0,0,0,0,0,0,0,0,0,0,87,0,0,0,0,0,0,0,0,0,0,100
965e0a2df8c94657e333ca166515e2dba70ca400,0,0,0,0,0,0,0,0,0,0,0,0,0,0,11,0,0,0,0,0,0,0,0,0,0,100
1834742813715a8d30aa38194481437174ed7776,0,0,0,0,0,0,0,0,0,0,0,0,0,0,88,1,0,0,0,0,0,0,0,0,0,100
efb977928a2e1eb4afed538a0676ca046987f15d,0,0,0,0,0,0,0,0,0,0,0,0,0,0,270,11,0,0,0,0,0,0,0,0,0,100
48b9bacf308d6cd98cfb9cdb22e96aaaea324ecd,0,0,0,0,0,0,0,0,0,0,0,0,0,0,0,0,0,0,0,0,0,0,0,0,0,100
edd59e166c0ff06f3b5af2c27af056d559a76aeb,0,0,0,0,0,0,0,0,0,0,0,0,0,0,271,4,0,0,0,0,0,0,0,0,0,100
2a7ab42f514713e96e8026a76e2a60c1f3759b3e,0,0,0,0,0,0,0,0,0,0,0,0,0,0,272,5,0,0,0,0,0,0,0,0,0,100
f4f18d9296dd9e93835f481c4a20b9bd3f0071ec,0,0,0,0,0,0,0,0,0,0,0,0,0,0,273,6,0,0,0,0,0,0,0,0,0,100
73d208fa64ee3c145f4d2a259571e1c88b3c4144,0,0,0,0,0,0,0,0,0,0,0,0,0,0,89,2,0,0,0,0,0,0,0,0,0,100
8917a8bc9e0d48612250ab0cb24b281aa54350a9,0,0,0,0,0,0,0,0,0,0,0,0,0,0,90,3,0,0,0,0,0,0,0,0,0,100
e93a2ab345225b507c3e72bcea98a076fc9399be,0,0,0,0,0,0,0,0,0,0,0,0,0,0,274,6,0,0,0,0,0,0,0,0,0,100
00c1826aec7891a4fb638ea6ab4049f40c0fed6b,0,0,0,0,0,0,0,0,0,0,0,0,0,0,275,7,0,0,0,0,0,0,0,0,0,100
2cb323c9d8e11861fa47e9b3678acb42d217df2c,0,0,0,0,0,0,0,0,0,0,0,0,0,0,276,8,0,0,0,0,0,0,0,0,0,100
ddccc04dc62a9fddfc30fb3eab6156b93cf82cc6,0,0,0,0,0,0,0,0,0,0,0,0,0,0,0,0,0,0,0,0,0,0,0,0,0,100
35d462e65754060948a480ee2ffdbd63caaac281,1,5,1,4,0,0,0,5,10,3727,1,1,0,298,91,4,85,84,1,2126,2113,13,25,24,1,100
53cdb411ef6477f0443b6a653d42354b8f6f3692,0,0,0,0,0,0,0,0,0,0,0,0,0,0,92,5,0,0,0,0,0,0,0,0,0,100
432f073c3cfb8ac7edb2793b797ab855c5a978dd,0,0,0,0,0,0,0,0,0,0,0,0,0,0,93,6,0,0,0,0,0,0,0,0,0,100
35545f9de44658ccf5d28a9caa53a4c4fc73567a,0,0,0,0,0,0,0,0,0,0,0,0,0,0,94,7,0,0,0,0,0,0,0,0,0,100
330918c9ab7a772430e4c6b63ecb0376fafa4297,0,0,0,0,0,0,0,0,0,0,0,0,0,0,0,0,0,0,0,0,0,0,0,0,0,100
5c99751b78cb2b5de7fb325ceb2674dd9f4bb01e,0,0,0,0,0,0,0,0,0,0,0,0,0,0,277,8,0,0,0,0,0,0,0,0,0,100
000338a7ace22d39c994040db64a39fdae7d3432,3,397,4,393,2,0,2,1,57,26,1,2,0.798082894,411,0,0,160,121,39,4771,3207,1564,61,32,29,94.83793517
a9218c07fdb0a2b49ae3c66cfa185eaa83c38ca1,0,0,0,0,0,0,0,0,0,0,0,0,0,0,278,8,0,0,0,0,0,0,0,0,0,100
81920d7b87f73fecd314bbc161a0fbcec18c9b80,0,0,0,0,0,0,0,0,0,0,0,0,0,0,95,6,0,0,0,0,0,0,0,0,0,100
cb1e6f8329dd02c2eb58d9e71158442cda25bebb,0,0,0,0,0,0,0,0,0,0,0,0,0,0,96,7,0,0,0,0,0,0,0,0,0,100
4c471f75e9d8b8c61830efafff17cfe635136e77,0,0,0,0,0,0,0,0,0,0,0,0,0,0,279,8,0,0,0,0,0,0,0,0,0,100
41fb846ec3aaefba762dbc4c691688bbb722311a,0,0,0,0,0,0,0,0,0,0,0,0,0,0,280,9,0,0,0,0,0,0,0,0,0,100
ad14bb97622a814ab7b60228c9d401385f39a13d,0,0,0,0,0,0,0,0,0,0,0,0,0,0,281,10,0,0,0,0,0,0,0,0,0,100
5831ca9246f72abcc8ddea809a128097aa9f86a8,0,0,0,0,0,0,0,0,0,0,0,0,0,0,282,11,0,0,0,0,0,0,0,0,0,100
04964671e8b78e1290d6b5451ad97d7dc2a4e0a1,0,0,0,0,0,0,0,0,0,0,0,0,0,0,283,12,0,0,0,0,0,0,0,0,0,100
bd18dbd28f66d98a5cdfb0a033457cd8cb2b139a,2,11,1,10,0,0,0,13,85,1504,1,2,0.811278124,1692,1,0,388,386,2,14083,14028,55,143,142,1,100
17004daea4c9ab044dfe666386e5065b6ef8c306,0,0,0,0,0,0,0,0,0,0,0,0,0,0,284,10,0,0,0,0,0,0,0,0,0,100
1a269e5cbf7dc16e72835666650fcdfa9189371e,0,0,0,0,0,0,0,0,0,0,0,0,0,0,285,11,0,0,0,0,0,0,0,0,0,100
1f37e06b0fa2f130e4a184fa6b3748b66664b6f5,0,0,0,0,0,0,0,0,0,0,0,0,0,0,286,12,0,0,0,0,0,0,0,0,0,100
b8937526d32928b3b29040e862f7689d7230bddb,0,0,0,0,0,0,0,0,0,0,0,0,0,0,110,0,0,0,0,0,0,0,0,0,0,100
ad0ce732ff018fc7bea9e9d43eed382e76240aa8,0,0,0,0,0,0,0,0,0,0,0,0,0,0,287,10,0,0,0,0,0,0,0,0,0,100
44d32c001c3ceea07ca2a98a840c75e26568a641,0,0,0,0,0,0,0,0,0,0,0,0,0,0,288,11,0,0,0,0,0,0,0,0,0,100
0e6190966f1dc6be9979fb5218efadd3058e0e6d,0,0,0,0,0,0,0,0,0,0,0,0,0,0,289,12,0,0,0,0,0,0,0,0,0,100
27914d96855eb8f9b46ae76d8fe646f01d73b87c,0,0,0,0,0,0,0,0,0,0,0,0,0,0,290,13,0,0,0,0,0,0,0,0,0,100
7f8f237f4b70ac35cdb025c78214698e5204331c,0,0,0,0,0,0,0,0,0,0,0,0,0,0,291,14,0,0,0,0,0,0,0,0,0,100
0d6cc170580593654ae5de5d548854972bfcbc77,0,0,0,0,0,0,0,0,0,0,0,0,0,0,292,14,0,0,0,0,0,0,0,0,0,100
b8897c60ce990d15564a850e3aaf22945c4e7788,0,0,0,0,0,0,0,0,0,0,0,0,0,0,97,2,0,0,0,0,0,0,0,0,0,100
15e040fcf01614dbc36bb19d7217f35934894123,0,0,0,0,0,0,0,0,0,0,0,0,0,0,98,3,0,0,0,0,0,0,0,0,0,100
392d479e886a14e50aff72382d1ddb88b7dae759,0,0,0,0,0,0,0,0,0,0,0,0,0,0,293,14,0,0,0,0,0,0,0,0,0,100
4359e1915d615ede3203f0b7479ea041b28b6cb2,0,0,0,0,0,0,0,0,0,0,0,0,0,0,0,0,0,0,0,0,0,0,0,0,0,100
3d38016e094064a1fac7292ff591a09a599f55de,0,0,0,0,0,0,0,0,0,0,0,0,0,0,294,11,0,0,0,0,0,0,0,0,0,100
6f7eb981959466a85da021320b1c51d01d5072f4,0,0,0,0,0,0,0,0,0,0,0,0,0,0,295,12,0,0,0,0,0,0,0,0,0,100
2b127acec4773a544fcf3aa4c3820a59eacefc3a,0,0,0,0,0,0,0,0,0,0,0,0,0,0,296,12,0,0,0,0,0,0,0,0,0,100
e59fb6436885074ce6827e6dce17a571170c14ba,0,0,0,0,0,0,0,0,0,0,0,0,0,0,297,13,0,0,0,0,0,0,0,0,0,100
a08a5c7c591b792bbf1d6ac1c95608352c6a2f2f,0,0,0,0,0,0,0,0,0,0,0,0,0,0,298,14,0,0,0,0,0,0,0,0,0,100
ca3c389e140fd5021308aa9c7c8cc3554ce635d7,0,0,0,0,0,0,0,0,0,0,0,0,0,0,99,2,0,0,0,0,0,0,0,0,0,100
e3dc0ea60d664f5369094cf33ca9edf1b75a636c,0,0,0,0,0,0,0,0,0,0,0,0,0,0,26,0,0,0,0,0,0,0,0,0,0,100
012338f959c50f41bd41c7ad6ff8d26262985105,0,0,0,0,0,0,0,0,0,0,0,0,0,0,2,0,0,0,0,0,0,0,0,0,0,100
aae64be43af013bbf1159c8af880b98b6c7fb8c2,0,0,0,0,0,0,0,0,0,0,0,0,0,0,299,8,0,0,0,0,0,0,0,0,0,100
a2aa31c6d5e75a18fdb7dc8dadc063371bc3afcf,0,0,0,0,0,0,0,0,0,0,0,0,0,0,300,9,0,0,0,0,0,0,0,0,0,100
95acbd5c439bc79d74375546bfb3af88519e23bd,0,0,0,0,0,0,0,0,0,0,0,0,0,0,301,10,0,0,0,0,0,0,0,0,0,100
e6c4be4e7bbddcfac49cb624d5b8dc7ceb52d3e1,0,0,0,0,0,0,0,0,0,0,0,0,0,0,302,11,0,0,0,0,0,0,0,0,0,100
b918209e42f18174bc90b1d8bd68402d96d93353,0,0,0,0,0,0,0,0,0,0,0,0,0,0,58,0,0,0,0,0,0,0,0,0,0,100
efe9aa7fbe457805dc894a9186e1267603d82dd2,0,0,0,0,0,0,0,0,0,0,0,0,0,0,1,0,0,0,0,0,0,0,0,0,0,100
5016cd5c3f2054ebacce7983785c228798e47f59,0,0,0,0,0,0,0,0,0,0,0,0,0,0,100,1,0,0,0,0,0,0,0,0,0,100
a02e974181724a8abb9120424e9d8590b0d852a4,0,0,0,0,0,0,0,0,0,0,0,0,0,0,0,0,0,0,0,0,0,0,0,0,0,100
cd6eb11335e3b9be9ef824cde5977f38e508860f,0,0,0,0,0,0,0,0,0,0,0,0,0,0,0,0,0,0,0,0,0,0,0,0,0,100
c8ca3afbb02dcb6399f56d25139d9a67bdd973ca,0,0,0,0,0,0,0,0,0,0,0,0,0,0,0,0,0,0,0,0,0,0,0,0,0,100
558f3af601bb5d3c46389878e9f57bf62cb614d4,0,0,0,0,0,0,0,0,0,0,0,0,0,0,303,4,0,0,0,0,0,0,0,0,0,100
1fd8c627fb913426a9f97043ed3244805d3ba25a,0,0,0,0,0,0,0,0,0,0,0,0,0,0,304,5,0,0,0,0,0,0,0,0,0,100
21c10bcaf606fbb386296b85288494df09bc05b3,0,0,0,0,0,0,0,0,0,0,0,0,0,0,305,6,0,0,0,0,0,0,0,0,0,100
9b6c93250144838b33e7e6d5da401d275f6ffff7,0,0,0,0,0,0,0,0,0,0,0,0,0,0,306,7,0,0,0,0,0,0,0,0,0,100
720bccdc1f99bfaee9d0074a743b0b29e2117002,0,0,0,0,0,0,0,0,0,0,0,0,0,0,307,8,0,0,0,0,0,0,0,0,0,100
7067df861675e431331f4ade624a12c9103c42bc,0,0,0,0,0,0,0,0,0,0,0,0,0,0,308,9,0,0,0,0,0,0,0,0,0,100
17132fe3ebbda203144c87c078614f13b48e274f,0,0,0,0,0,0,0,0,0,0,0,0,0,0,309,10,0,0,0,0,0,0,0,0,0,100
bc092fda01ce9401a463eff5f5103dd188496ea0,0,0,0,0,0,0,0,0,0,0,0,0,0,0,310,11,0,0,0,0,0,0,0,0,0,100
43b5d7e3c141573379c1a16093a3191dd070e291,0,0,0,0,0,0,0,0,0,0,0,0,0,0,311,12,0,0,0,0,0,0,0,0,0,100
d4ffd0b07b75b9c31286535cd0f7bf713f445314,0,0,0,0,0,0,0,0,0,0,0,0,0,0,312,13,0,0,0,0,0,0,0,0,0,100
7d6b4028d18d820344edf94370f7390f1315765a,0,0,0,0,0,0,0,0,0,0,0,0,0,0,313,14,0,0,0,0,0,0,0,0,0,100
12fdbc55ab624d4697b6f13db84e42bec62184b1,0,0,0,0,0,0,0,0,0,0,0,0,0,0,26,0,0,0,0,0,0,0,0,0,0,100
b1de7a6a1b54642cacc6348887cb92b5c4ba3200,0,0,0,0,0,0,0,0,0,0,0,0,0,0,314,11,0,0,0,0,0,0,0,0,0,100
edc5eccffae25e1ccbdcda262860f9f151fe4cf5,0,0,0,0,0,0,0,0,0,0,0,0,0,0,315,12,0,0,0,0,0,0,0,0,0,100
3e1ba6af4aca67d7db2c0e9c9c0ecf03d6c42fba,0,0,0,0,0,0,0,0,0,0,0,0,0,0,316,13,0,0,0,0,0,0,0,0,0,100
62f45ecc90ab8bf550333abfe976884110a0b768,0,0,0,0,0,0,0,0,0,0,0,0,0,0,0,0,0,0,0,0,0,0,0,0,0,100
3545c1bb716b6a21617be52c6153c6be160d75fe,0,0,0,0,0,0,0,0,0,0,0,0,0,0,1,1,0,0,0,0,0,0,0,0,0,100
05099c3263081e264eb95ee41609095d44a0acfd,0,0,0,0,0,0,0,0,0,0,0,0,0,0,27,1,0,0,0,0,0,0,0,0,0,100
6743a41d33a55cb6b4468385142dbc86292842ae,1,23,2,21,0,0,0,7,9,957,1,1,0,162,0,0,39,35,4,1372,1221,151,11,9,2,100
08adf9140f474e2bcbce1acf2b7b8344cb42ba73,1,1,1,0,0,0,0,7,10,0,1,1,0,178,1,1,39,39,0,1372,1372,0,11,11,0,100
bf8cde0f661c2d11a770c4c3343ad19f21a5388c,1,4,2,2,0,0,0,7,11,0,1,1,0,178,2,2,39,39,0,1375,1372,3,11,11,0,100
c28dbe9f7d485f5e5d1df41df1bb2c12c838b5db,0,0,0,0,0,0,0,0,0,0,0,0,0,0,3,3,0,0,0,0,0,0,0,0,0,100
e4e1633077d0550094cd037a945b6f8e01cf2a53,188,4214,3985,229,0,0,0,4,43,2663,1,40,6.578830106,27480,4,4,2590,2592,2,226692,227712,1020,1856,1859,3,93.7593423
b2aeb2adbc85827f2cda34eae4b27ed2c0769075,1,1,2,1,0,0,0,7,10,0,1,1,0,189,5,5,14,14,0,1289,1289,0,9,9,0,100
27eaf7038b952ff03768118326113cb7f5e371b4,1,24,6,18,0,0,0,26,86,125,1,1,0,1076,6,6,343,339,4,7858,7757,101,108,107,1,100
1f7bfc44703b7b4c193efb1a2f44e1ce432a6e0c,1,49,44,5,0,0,0,26,87,0,1,1,0,1089,7,7,343,343,0,7850,7858,8,109,108,1,100
0dcb351689b75470136921cec18e4ae2872bd5c5,0,0,0,0,0,0,0,0,0,0,0,0,0,0,111,0,0,0,0,0,0,0,0,0,0,100
be4c37a9ebe31a07ab78f7186c3d22400874d96e,0,0,0,0,0,0,0,0,0,0,0,0,0,0,28,2,0,0,0,0,0,0,0,0,0,100
82fc40bbc5aca780875cb07e78056978fa0a85c6,0,0,0,0,0,0,0,0,0,0,0,0,0,0,2,0,0,0,0,0,0,0,0,0,0,100
a7ad5ac5858fef5edc45671f77c7f06ed37a51cc,0,0,0,0,0,0,0,0,0,0,0,0,0,0,112,1,0,0,0,0,0,0,0,0,0,100
8f06f2b5a0fc8e183e4dc19c9836212da2231867,0,0,0,0,0,0,0,0,0,0,0,0,0,0,317,3,0,0,0,0,0,0,0,0,0,100
adbd9fa65caf23bc63e4ce31780a16b8e2646776,0,0,0,0,0,0,0,0,0,0,0,0,0,0,318,4,0,0,0,0,0,0,0,0,0,100
111e7017f213efd922800417a43f8d56599f04c6,0,0,0,0,0,0,0,0,0,0,0,0,0,0,319,5,0,0,0,0,0,0,0,0,0,100
d87a99d532719ba6f619ba68e07dbaa77fe4f84e,3,31,3,28,0,0,0,35,73,395,1,3,1.133184254,1480,0,0,412,408,4,10451,10301,150,135,134,1,100
1ec0af204bc1c5f196e889c8af33b6e4aa784fee,0,0,0,0,0,0,0,0,0,0,0,0,0,0,0,0,0,0,0,0,0,0,0,0,0,100
0c01ff6b0193f3112ce7b715d37dc7830ff573e9,0,0,0,0,0,0,0,0,0,0,0,0,0,0,320,6,0,0,0,0,0,0,0,0,0,100
f959c459192adcdc6b885e78a425b61a3bef49f2,0,0,0,0,0,0,0,0,0,0,0,0,0,0,321,4,0,0,0,0,0,0,0,0,0,100
ee27a1fa9c56ab405435987a3598ff7d8e6e4b78,0,0,0,0,0,0,0,0,0,0,0,0,0,0,322,5,0,0,0,0,0,0,0,0,0,100
338ebb77913a328c6f0ebb7ddac6f67b90381a6b,0,0,0,0,0,0,0,0,0,0,0,0,0,0,323,6,0,0,0,0,0,0,0,0,0,100
27ac90c205adb239b25c86a9288c544c114e3c77,0,0,0,0,0,0,0,0,0,0,0,0,0,0,324,7,0,0,0,0,0,0,0,0,0,100
fc2a4e0e5d88755c776b97fa1872e70ffbe0d4bb,0,0,0,0,0,0,0,0,0,0,0,0,0,0,325,8,0,0,0,0,0,0,0,0,0,100
7e382f234ff447d2f6f72057c130821099a7b2ed,0,0,0,0,0,0,0,0,0,0,0,0,0,0,326,9,0,0,0,0,0,0,0,0,0,100
1580b17ca55669e9560f6d26671bee8d79701ff8,0,0,0,0,0,0,0,0,0,0,0,0,0,0,101,0,0,0,0,0,0,0,0,0,0,100
f93fffa482acbf7ef512a48755e5c7074c460238,0,0,0,0,0,0,0,0,0,0,0,0,0,0,327,6,0,0,0,0,0,0,0,0,0,100
41e330a14a4dbae597d491a541ef0c0c024e4347,0,0,0,0,0,0,0,0,0,0,0,0,0,0,328,7,0,0,0,0,0,0,0,0,0,100
d22e55501caa19c9f19d3e9321b55a643c226773,0,0,0,0,0,0,0,0,0,0,0,0,0,0,329,8,0,0,0,0,0,0,0,0,0,100
9b7230210c8867bd8a07e8e5cf42b8b047018f81,0,0,0,0,0,0,0,0,0,0,0,0,0,0,330,9,0,0,0,0,0,0,0,0,0,100
d2083c340d92a24ad7bc2d0b86fe8abda3b5d0db,0,0,0,0,0,0,0,0,0,0,0,0,0,0,331,10,0,0,0,0,0,0,0,0,0,100
4c6b15ef9d440ece3134dacb60ef9655d59a1e7e,0,0,0,0,0,0,0,0,0,0,0,0,0,0,332,7,0,0,0,0,0,0,0,0,0,100
c92b2bf2927cd0d1a5c32fc781beee353888c3ff,0,0,0,0,0,0,0,0,0,0,0,0,0,0,1,0,0,0,0,0,0,0,0,0,0,100
564e2a5b8fddfe92a290910edc2f25f9a5d9925e,0,0,0,0,0,0,0,0,0,0,0,0,0,0,102,1,0,0,0,0,0,0,0,0,0,100
0eba47a79e743f8b75ca046c114fe376ef7a2ebf,0,0,0,0,0,0,0,0,0,0,0,0,0,0,48,0,0,0,0,0,0,0,0,0,0,100
053ef1eb38eb18435652840d50e68667cbbb14b3,0,0,0,0,0,0,0,0,0,0,0,0,0,0,333,6,0,0,0,0,0,0,0,0,0,100
e48bb1fb03d365a1af6872deed131d4a423867fb,0,0,0,0,0,0,0,0,0,0,0,0,0,0,334,7,0,0,0,0,0,0,0,0,0,100
2c79fab271d493d2b17cef48d00aaf32d19f6496,0,0,0,0,0,0,0,0,0,0,0,0,0,0,335,8,0,0,0,0,0,0,0,0,0,100
52d670f72dbb35e06755bd288ab6eca84a3920a5,0,0,0,0,0,0,0,0,0,0,0,0,0,0,2,0,0,0,0,0,0,0,0,0,0,100
909bd05b3ef64b0ec75d5a366f1c452efb286c37,0,0,0,0,0,0,0,0,0,0,0,0,0,0,336,9,0,0,0,0,0,0,0,0,0,100
b17edc675df7ad6a53490c6d90c70155c7ad54df,0,0,0,0,0,0,0,0,0,0,0,0,0,0,337,10,0,0,0,0,0,0,0,0,0,100
c00330a4054b837fcc8560a187636dea9e084e83,0,0,0,0,0,0,0,0,0,0,0,0,0,0,338,11,0,0,0,0,0,0,0,0,0,100
cc49c4437c8851f2077db966fa0f41f123cd99d2,0,0,0,0,0,0,0,0,0,0,0,0,0,0,339,12,0,0,0,0,0,0,0,0,0,100
0255ef3c8dc9d64aa5a46782b2bd918a693a582d,0,0,0,0,0,0,0,0,0,0,0,0,0,0,340,13,0,0,0,0,0,0,0,0,0,100
e22f029c4dd74ec962dca7cfe21a87c69fa2872e,1,86,0,86,1,0,1,1,1,0,1,1,0,0,12,0,5,0,5,506,0,506,2,0,2,100
50c17468dd6d91020451761e329f72519e68eb9d,0,0,0,0,0,0,0,0,0,0,0,0,0,0,341,14,0,0,0,0,0,0,0,0,0,100
b576f46fb8696f2dbe5bfb056d6ab2ed80ab4967,1,7,0,7,0,0,0,11,18,104,1,1,0,176,13,1,21,21,0,1623,1577,46,11,11,0,100
a512fa2fdf1b370548446e83ac48b9db52e04275,0,0,0,0,0,0,0,0,0,0,0,0,0,0,103,2,0,0,0,0,0,0,0,0,0,100
0ea0dccd60b5f420f64be7688126c0149a0df044,0,0,0,0,0,0,0,0,0,0,0,0,0,0,104,3,0,0,0,0,0,0,0,0,0,100
35159d191d3b5ced2af7b5cf79d46a2a8b0356dd,0,0,0,0,0,0,0,0,0,0,0,0,0,0,342,15,0,0,0,0,0,0,0,0,0,100
2079ec51f7015509df28c1c105f61a44c8b3a9db,0,0,0,0,0,0,0,0,0,0,0,0,0,0,1,0,0,0,0,0,0,0,0,0,0,100
84d0a005d0d9586b8387c3364a285146200f8342,0,0,0,0,0,0,0,0,0,0,0,0,0,0,0,0,0,0,0,0,0,0,0,0,0,100
1998f9ee819e0002df6e7c170644b53a7ee5b762,0,0,0,0,0,0,0,0,0,0,0,0,0,0,49,0,0,0,0,0,0,0,0,0,0,100
5d9fbb286f16da8c4fa2d991861724f0f4b1841e,0,0,0,0,0,0,0,0,0,0,0,0,0,0,50,1,0,0,0,0,0,0,0,0,0,100
12adf0bc57cb1ddcb58a4f6aa41695fb7512140a,0,0,0,0,0,0,0,0,0,0,0,0,0,0,43,0,0,0,0,0,0,0,0,0,0,100
f84392d47cebb7fb885c979262088c677a60ad09,0,0,0,0,0,0,0,0,0,0,0,0,0,0,44,1,0,0,0,0,0,0,0,0,0,100
0b17623c1ca98899b4b2b98b7e63a3508f61ea21,0,0,0,0,0,0,0,0,0,0,0,0,0,0,45,2,0,0,0,0,0,0,0,0,0,100
ebeeebb4da62a792f1c369c6ab06d83362698a73,0,0,0,0,0,0,0,0,0,0,0,0,0,0,343,10,0,0,0,0,0,0,0,0,0,100
2d54b9ea5b8e226a99788356d1b918d99e61efb5,0,0,0,0,0,0,0,0,0,0,0,0,0,0,344,11,0,0,0,0,0,0,0,0,0,100
f3cd30131b84c8309f9475e2688c13173d89e1bc,0,0,0,0,0,0,0,0,0,0,0,0,0,0,345,12,0,0,0,0,0,0,0,0,0,100
35f531d16e5235f5619bfdd43838bdab47287a96,0,0,0,0,0,0,0,0,0,0,0,0,0,0,346,13,0,0,0,0,0,0,0,0,0,100
5883a4d9e60b515b9dcd6b9c743340f918535842,0,0,0,0,0,0,0,0,0,0,0,0,0,0,347,14,0,0,0,0,0,0,0,0,0,100
6459ec00bfd9efcf48dbae0ca7584d1847e85acc,0,0,0,0,0,0,0,0,0,0,0,0,0,0,0,0,0,0,0,0,0,0,0,0,0,100
74bd287cff5ac09fd47e67d1d5814f331c52cee6,0,0,0,0,0,0,0,0,0,0,0,0,0,0,46,3,0,0,0,0,0,0,0,0,0,100
72e38dc8ff4b78ad7c66e002208d404669f94ac8,0,0,0,0,0,0,0,0,0,0,0,0,0,0,47,4,0,0,0,0,0,0,0,0,0,100
ad5cf6857e28b655304a5f7f411c9d63f4ac3909,8,2840,15,2825,7,0,7,1,88,16,1,3,2.331980208,1094,48,5,707,343,364,20813,7850,12963,296,109,187,99.34994583
fa0bb7098083aba41c9aa9d9cf6383eb3e2c2696,4,256,9,247,0,0,0,7,12,3045,1,2,1.072953611,745,0,0,207,148,59,5532,4229,1303,131,106,25,99.89243456
30c4cbfde573100d60f1e27dac26bd4803ca6d31,1,8,6,2,0,0,0,17,37,135,1,1,0,1139,0,0,156,156,0,8235,8232,3,108,108,0,100
101048de5bb213aed4cff1b262205979662580bd,1,64,0,64,0,0,0,14,30,135,1,1,0,324,0,0,49,45,4,2940,2538,402,18,17,1,100
8565b87c12add2c40e5917bb384762ddfc877c91,1,0,64,64,0,0,0,14,31,0,1,1,0,371,49,6,45,49,4,2538,2940,402,17,18,1,100
2a246049ac015a0b33458b31fc945942c672a5d0,1,2,2,0,0,0,0,17,38,0,1,1,0,1142,50,7,156,156,0,8235,8235,0,108,108,0,100
536dcc35c2c832275b3ce1d1de94f559a63313a7,1,1,1,0,0,0,0,17,39,1,1,1,0,1142,51,8,156,156,0,8235,8235,0,108,108,0,100
0f4cdc0cb986452c158f8d8a651ea92512ff8282,1,43,8,35,0,0,0,6,8,138,1,1,0,155,52,9,24,21,3,1156,1044,112,17,16,1,100
dd4385ba2a8302410313cbc0ca32d0a895cc1095,0,0,0,0,0,0,0,0,0,0,0,0,0,0,348,12,0,0,0,0,0,0,0,0,0,100
95fec21c31c693e0c7949c7cc1b19e5c24f4aed6,0,0,0,0,0,0,0,0,0,0,0,0,0,0,349,13,0,0,0,0,0,0,0,0,0,100
5cfec92f5233f1c06d8ffb444e94e9b3ac349ccf,0,0,0,0,0,0,0,0,0,0,0,0,0,0,350,14,0,0,0,0,0,0,0,0,0,100
5548c9dff7a3bd851eacc791b52b21804f9f8408,0,0,0,0,0,0,0,0,0,0,0,0,0,0,351,15,0,0,0,0,0,0,0,0,0,100
1de26ebc383397c23eda902e497c5f278f56d04f,0,0,0,0,0,0,0,0,0,0,0,0,0,0,352,10,0,0,0,0,0,0,0,0,0,100
e7d9be91ef0a077514f22e3e7cf38d1781b7517f,0,0,0,0,0,0,0,0,0,0,0,0,0,0,53,10,0,0,0,0,0,0,0,0,0,100
641bea66f88aee785b0911841b26f3bf5128fbd6,0,0,0,0,0,0,0,0,0,0,0,0,0,0,353,10,0,0,0,0,0,0,0,0,0,100
5b2c27956b601c580af277614397b2e43e0ba9f9,0,0,0,0,0,0,0,0,0,0,0,0,0,0,0,0,0,0,0,0,0,0,0,0,0,100
2231b77a61de38d081fd619fadd5291149559497,0,0,0,0,0,0,0,0,0,0,0,0,0,0,354,2,0,0,0,0,0,0,0,0,0,100
b6eb0f77942dca18ef6b651f51f2938094ccf5c9,0,0,0,0,0,0,0,0,0,0,0,0,0,0,355,3,0,0,0,0,0,0,0,0,0,100
389fb2acb149df182ec1fddc2658cee400c601f2,0,0,0,0,0,0,0,0,0,0,0,0,0,0,356,4,0,0,0,0,0,0,0,0,0,100
b9fd71a730ac4c9d93280d487c12cf2750bc2e45,0,0,0,0,0,0,0,0,0,0,0,0,0,0,357,5,0,0,0,0,0,0,0,0,0,100
49b45bd27067520f4c8b48f5c0f7dd9aabc3dbeb,0,0,0,0,0,0,0,0,0,0,0,0,0,0,358,6,0,0,0,0,0,0,0,0,0,100
cdd0945b4c2978953fc72d5b4563b9239252d8d7,0,0,0,0,0,0,0,0,0,0,0,0,0,0,359,7,0,0,0,0,0,0,0,0,0,100
fd008734cb07c9814ce0d8ef2b5b9e3ecfbb51de,0,0,0,0,0,0,0,0,0,0,0,0,0,0,360,8,0,0,0,0,0,0,0,0,0,100
d797c78e570aa1efaaec72156ca80aefd88eb977,0,0,0,0,0,0,0,0,0,0,0,0,0,0,0,0,0,0,0,0,0,0,0,0,0,100
a1718e7f6f5055187bce7469bd222666bc27ff2b,0,0,0,0,0,0,0,0,0,0,0,0,0,0,361,9,0,0,0,0,0,0,0,0,0,100
8d6c2739734b3f2b8a262f01cbae68292203dc46,0,0,0,0,0,0,0,0,0,0,0,0,0,0,362,10,0,0,0,0,0,0,0,0,0,100
6886dcec0d0bfceb160ac9b3a57bf1111c591c0a,0,0,0,0,0,0,0,0,0,0,0,0,0,0,0,0,0,0,0,0,0,0,0,0,0,100
197a0ecaa00906b3a809c60df300ace796819df3,2,106,1,105,0,0,0,15,89,125,1,2,0.966408672,1730,0,0,414,391,23,14872,14151,721,148,145,3,100
0ad54c3e4928ba8070666662451df473f69fba32,0,0,0,0,0,0,0,0,0,0,0,0,0,0,363,11,0,0,0,0,0,0,0,0,0,100
2a80d55888d32aafeff4652e4eda9eefccfe0c56,0,0,0,0,0,0,0,0,0,0,0,0,0,0,364,11,0,0,0,0,0,0,0,0,0,100
b8b83b72f7184cf1b388fc20331d11eabbd93e06,0,0,0,0,0,0,0,0,0,0,0,0,0,0,105,0,0,0,0,0,0,0,0,0,0,100
c2e6e13194cb4f1879b8c98ff896c048caf6b8e5,6,25,11,14,0,0,0,36,74,862,1,5,2.176826923,3178,8,0,726,723,3,26785,26721,64,264,261,3,100
69974bc9ee1ae9a21ab35ce26701f49eef1ca3b6,0,0,0,0,0,0,0,0,0,0,0,0,0,0,365,11,0,0,0,0,0,0,0,0,0,100
5c0b17dec3dc0e9693db6e87a41b1d37ded7cfea,1,22,6,16,0,0,0,15,45,12,1,1,0,671,1,1,52,51,1,6787,6649,138,39,38,1,100
81e665f7e3821f8d340a678d40bc8a8ff1d32dd8,0,0,0,0,0,0,0,0,0,0,0,0,0,0,366,12,0,0,0,0,0,0,0,0,0,100
88db9c91897c9df8b5acd901bdab7a5ab44c7256,0,0,0,0,0,0,0,0,0,0,0,0,0,0,367,13,0,0,0,0,0,0,0,0,0,100
