CommitID,NMF,TotalAddLines,TotalDeleteLines,LC,FileAdd,FileDelete,NAD,NDEV,NUC,AGE,NS,ND,Entropy,LT,EXP,REXP,CommitComplexity,LastCommitComplexity,CFC,CommitTokenCount,LastCommitTokenCount,NCC,CommitMethodNum,LastCommitMethodNum,NMC,A2A
6b78050692cd8a0184d4ae52e8eba784a3456e27,0,0,0,0,0,0,0,0,0,0,0,0,0,0,1,1,0,0,0,0,0,0,0,0,0,100
cb19267831d82aeb551a9708ee9e65f89b8791da,7,118,9,109,1,0,1,2,2,180,1,5,1.913535143,805,0,0,134,124,10,4978,4452,526,59,52,7,99.65870307
63f0dc88396761988e8bb61efe55d290d9f3fe9f,12,1290,210,1080,8,0,8,1,2,76,1,5,2.986426071,480,2,0,193,81,112,8365,2831,5534,61,31,30,96.52892562
9883b0229fd0f0174dba8400f3999b12d4a1fc57,0,0,0,0,0,0,0,0,0,0,0,0,0,0,0,0,0,0,0,0,0,0,0,0,0,100
2edc33ac59e6018766896b84849b6d31a86fe431,148,10870,2493,8377,66,0,66,1,3,144,1,40,6.4387368,8183,0,0,1995,1123,872,93597,50085,43512,643,430,213,72.18543046
46f0ca8b38fb2f9132dd869d4fda4bc573019714,0,0,0,0,0,0,0,0,0,0,0,0,0,0,1,1,0,0,0,0,0,0,0,0,0,100
a8c8314294c80a1667e46ac84e9f87be7695b8fa,3,0,353,353,0,0,0,1,4,121,1,3,1.439347581,275,2,2,0,27,27,0,1855,1855,0,10,10,98.86492622
f9c4ff6b1e5a42564335aa667491613beff70e48,0,0,0,0,0,0,0,0,0,0,0,0,0,0,3,3,0,0,0,0,0,0,0,0,0,100
9edce2c3277c7b7cd58c44f67de63e5bb7917d1c,1,11,40,29,0,0,0,2,3,13,1,1,0,216,4,4,25,30,5,1191,1438,247,12,12,0,100
3998ce3d66fd8d0c1d2f13cf9c0ee4d55b0d014b,0,0,0,0,0,0,0,0,0,0,0,0,0,0,5,5,0,0,0,0,0,0,0,0,0,100
9d813ea08018fd1c66c7e2804f114da24cfe6ce0,0,0,0,0,0,0,0,0,0,0,0,0,0,0,6,6,0,0,0,0,0,0,0,0,0,100
7e702d92b8d67312ae1fa3a6661bb4595d2d529e,0,0,0,0,0,0,0,0,0,0,0,0,0,0,0,0,0,0,0,0,0,0,0,0,0,100
bda17f4c2ff7421bf99feff8fe2c70be9c37a6b0,0,0,0,0,0,0,0,0,0,0,0,0,0,0,1,1,0,0,0,0,0,0,0,0,0,100
4be417f70d3847c8848a0a65b047187e0ff36e94,3,201,77,124,2,0,2,1,3,10,1,1,1.568167307,152,7,7,25,15,10,1828,1271,557,12,6,6,97.75028121
7438b8dbfdcf96ad239a523fe8b01729fb075761,0,0,0,0,0,0,0,0,0,0,0,0,0,0,8,8,0,0,0,0,0,0,0,0,0,100
9bac04c90927dd02a14c77c3e671abad9a533604,2,187,88,99,0,0,0,2,3,42,1,2,0.651427745,317,9,7,78,58,20,2809,2064,745,14,12,2,98.66962306
72180ffc8d6990fc80ef9ff6d6f556da0b2d1079,0,0,0,0,0,0,0,0,0,0,0,0,0,0,10,8,0,0,0,0,0,0,0,0,0,100
28a66bca1f57585503657d52c61961738b82fd9c,1,1,0,1,0,0,0,2,2,387,1,1,0,121,11,9,14,14,0,547,541,6,7,7,0,100
3e177b2b2df598e7b01083e032b2e2c02df8c0c4,0,0,0,0,0,0,0,0,0,0,0,0,0,0,12,10,0,0,0,0,0,0,0,0,0,100
7167a5e88b4cec1ebeb0a34921dff9a27183874e,0,0,0,0,0,0,0,0,0,0,0,0,0,0,13,0,0,0,0,0,0,0,0,0,0,100
46388df9c201d4f4132342c73abed7096ba6ee1a,0,0,0,0,0,0,0,0,0,0,0,0,0,0,14,1,0,0,0,0,0,0,0,0,0,100
7cef43f160eceebb70207784b7b1c14c8e7032e7,0,0,0,0,0,0,0,0,0,0,0,0,0,0,15,2,0,0,0,0,0,0,0,0,0,100
68ca777778dd2918130d8b99d04d6be227fc6555,2,9,5,4,0,0,0,2,4,93,1,2,0.591672779,344,16,3,46,46,0,2138,2096,42,18,18,0,100
9d31753090549288ee67452a0112e08f9c5e1dc9,4,38,47,9,0,0,0,2,4,100,1,3,0.926412236,938,17,4,154,154,0,5278,5304,26,44,44,0,100
ea7c1c19577dc051ad7a6082eaef65e8d4ee78b1,0,0,0,0,0,0,0,0,0,0,0,0,0,0,18,5,0,0,0,0,0,0,0,0,0,100
78caadd9fc27a5ffe68b4ef193786e0eafb565ac,1,104,0,104,1,0,1,1,1,0,1,1,0,0,19,6,15,0,15,557,0,557,7,0,7,97.97979798
95cfd7ef1af469e194650518144764caf37f8dce,0,0,0,0,0,0,0,0,0,0,0,0,0,0,20,7,0,0,0,0,0,0,0,0,0,100
082f40687001474502193fba1dc770f2d9496e05,2,164,88,76,1,0,1,1,5,13,1,2,0.883222559,449,21,8,80,75,5,3026,2407,619,25,23,2,99.77375566
8c78b17434e83f5c18d7ae4d2f34c3d3b65e9460,1,1,1,0,0,0,0,3,3,134,1,1,0,324,0,0,34,34,0,1895,1895,0,7,7,0,100
0c0bd5fe7241fbe0ff20ce2008eef8bd7d3a3a89,2,2,2,0,0,0,0,2,4,46,1,2,1,352,22,4,61,61,0,2113,2111,2,15,15,0,100
75f1c76b148879697264f083f3f57bb86012b943,0,0,0,0,0,0,0,0,0,0,0,0,0,0,0,0,0,0,0,0,0,0,0,0,0,100
2ad8fd9082b0187bf2d3c6998e797cde00b648ef,4,72,10,62,1,0,1,1,6,75,1,4,1.074651692,738,1,1,124,119,5,4596,4133,463,44,41,3,99.77477477
5fc041b7ae7c9891bf152b44f9b6c0a345337a64,1,1,1,0,0,0,0,2,3,186,1,1,0,101,23,1,10,10,0,664,664,0,3,3,0,100
9c0b919c1480d4b72f82abe1860a55ec5c216086,0,0,0,0,0,0,0,0,0,0,0,0,0,0,24,2,0,0,0,0,0,0,0,0,0,100
215c7a008a5fb3e83212b3bfa444b5721a720f94,1,1,1,0,0,0,0,1,2,198,1,1,0,173,25,2,18,18,0,1323,1315,8,4,4,0,100
0cf1eed8174e2ba044a0f70c43f939a8e7587abb,1,2,2,0,0,0,0,2,3,198,1,1,0,143,26,3,15,15,0,1071,1071,0,4,4,0,100
efaf43f7af9e878e7aae2dc5f52052c339c4ba15,12,408,55,353,4,0,4,1,4,175,1,5,2.861933657,875,27,4,135,91,44,6449,4777,1672,52,29,23,96.92307692
cae6ed1582260fac2990181e142a8a9c359092b9,1,3,1,2,0,0,0,2,5,97,1,1,0,193,28,5,26,25,1,1236,1228,8,12,12,0,100
4aa37daa87f261eb656100e3a9fc6495cd6bf07f,2,3,3,0,0,0,0,1,3,99,1,1,0.918295834,355,29,6,39,39,0,2755,2755,0,8,8,0,100
df42c258ffdf2d1751cbd445df713e0769d162d2,0,0,0,0,0,0,0,0,0,0,0,0,0,0,30,7,0,0,0,0,0,0,0,0,0,100
a181b990461b64130158a453ecdd192902ec59be,0,0,0,0,0,0,0,0,0,0,0,0,0,0,31,8,0,0,0,0,0,0,0,0,0,100
1972440689c95f9383b019610842bf188889a086,0,0,0,0,0,0,0,0,0,0,0,0,0,0,32,9,0,0,0,0,0,0,0,0,0,100
b03e39820a9d3c21940c5955e344a4e49cfdc821,1,1,1,0,0,0,0,2,3,198,1,1,0,113,33,10,13,13,0,773,773,0,3,3,0,100
c18c4261c533809f4bb23340159e2a54aa1fc1b0,0,0,0,0,0,0,0,0,0,0,0,0,0,0,1,0,0,0,0,0,0,0,0,0,0,100
9b31456410cc51846d0e46456527abeaf22f2338,0,0,0,0,0,0,0,0,0,0,0,0,0,0,0,0,0,0,0,0,0,0,0,0,0,100
aba6e0d9dc143c341cba2fd12b35402bba2dcd3f,0,0,0,0,0,0,0,0,0,0,0,0,0,0,1,1,0,0,0,0,0,0,0,0,0,100
cc8fbad0dc62e13343a9398d3890ee5555558bf9,1,92,2,90,0,0,0,2,4,243,1,1,0,356,34,0,80,66,14,2528,2103,425,31,24,7,100
ac92276960acf879f7ecce561eebf09d120e43a0,0,0,0,0,0,0,0,0,0,0,0,0,0,0,0,0,0,0,0,0,0,0,0,0,0,100
ad3bbadc727d9a2a11519a10e7dfb81ff5c87a22,4,11,24,13,0,0,0,2,4,48,1,2,1.637315866,256,1,1,35,37,2,1235,1264,29,17,20,3,100
8e35fc23e7a065c1346e512f546ba8472441fcc9,0,0,0,0,0,0,0,0,0,0,0,0,0,0,2,2,0,0,0,0,0,0,0,0,0,100
af0fe6ed4481d53c58afee8db0e8cece61ac952e,1,5,2,3,0,0,0,3,4,48,1,1,0,113,0,0,13,13,0,789,773,16,3,3,0,100
a14c097f18f5d7269a7cc98501253c90b3744ff2,2,226,0,226,2,0,2,1,1,0,1,2,0.977283682,0,1,1,17,0,17,1103,0,1103,10,0,10,99.46524064
b7f1930d28484046066e3a62443e9cff71751cc5,0,0,0,0,0,0,0,0,0,0,0,0,0,0,2,2,0,0,0,0,0,0,0,0,0,100
694b9ecaa53edfd7079f95be72f0f438f1ecfaf5,1,36,22,14,0,0,0,2,2,249,1,1,0,32,3,3,9,5,4,338,230,108,2,2,0,97.95037756
86cc94fd704f2f48e0e1c2e70f64a1243316b552,4,266,135,131,1,0,1,1,7,59,1,3,1.402752136,851,4,4,164,148,16,5689,4929,760,46,42,4,99.78165939
e9a0b58994ee79b5e5190d202ff460d2a61b2f14,1,9,5,4,0,0,0,3,5,6,1,1,0,422,5,5,80,80,0,2534,2528,6,31,31,0,100
8ae8aa1a3801fe8d30715fa9c517d3abc1c4d756,3,163,15,148,1,0,1,1,8,0,1,3,1.058276713,663,6,6,125,111,14,4621,3788,833,37,34,3,99.7826087
40c408fd47923ed6307277b6b01cc17f5722abed,0,0,0,0,0,0,0,0,0,0,0,0,0,0,7,7,0,0,0,0,0,0,0,0,0,100
f68cea95310122abf3ff5d42b8a89b335daf3926,0,0,0,0,0,0,0,0,0,0,0,0,0,0,8,8,0,0,0,0,0,0,0,0,0,100
204e1aa702a6a89a54359db81681c934b9be0d2a,1,43,18,25,0,0,0,2,2,251,1,1,0,297,9,9,57,55,2,1705,1637,68,17,17,0,100
09a3e7c21423adae3978212cf5885cb9389ad469,1,34,24,10,0,0,0,3,3,251,1,1,0,314,10,10,54,50,4,2585,2524,61,7,7,0,100
6b578ec738e48055cc90543c9e59d90ac0e0c5b9,1,11,3,8,0,0,0,2,3,209,1,1,0,264,11,11,53,50,3,2007,1946,61,6,6,0,100
31a2b6b63e1fdaf48eace9df20d79695518b8c48,3,227,2,225,2,0,2,1,9,0,1,3,1.229434935,450,12,12,103,79,24,3556,2558,998,43,25,18,99.46062567
dd45777d352e3db8a9a47b2d9aaa74eff1a1413a,0,0,0,0,0,0,0,0,0,0,0,0,0,0,13,13,0,0,0,0,0,0,0,0,0,100
abdf5159a9013e5377a6341b73f726bab04b7747,1,15,10,5,0,0,0,3,3,252,1,1,0,70,14,14,12,12,0,371,336,35,4,4,0,100
11243807c70de997d6706b7616bad96fc2cc7779,2,77,50,27,0,0,0,3,3,126,1,1,0.880326255,498,15,15,92,87,5,2889,2743,146,21,21,0,100
ceeaaa3813f1f8ec64b5b9d7315a3ab03be27b42,1,2,2,0,0,0,0,5,7,14,1,1,0,238,3,3,37,37,0,1440,1436,4,9,9,0,100
92bb48614e364da27e2d0345e290ac44c4bec346,1,12,6,6,0,0,0,4,5,65,1,1,0,322,4,4,35,34,1,1926,1883,43,7,7,0,100
6789031cf9b453b10c6a65cfb1429706dfffba77,1,3,0,3,0,0,0,3,4,65,1,1,0,185,5,5,24,24,0,1060,1035,25,8,8,0,100
e29a913f37d558299041be6a196fb0d9931c71f9,3,66,6,60,0,0,0,2,10,56,1,3,0.944488534,600,6,6,103,96,7,3823,3441,382,42,41,1,100
b96bcabdcbe6562aa524dd579706d6202ae54466,0,0,0,0,0,0,0,0,0,0,0,0,0,0,16,16,0,0,0,0,0,0,0,0,0,100
0db81164ed84e9a09933ef298a00d37d247b432b,3,3,3,0,0,0,0,2,6,13,1,3,1.584962501,388,7,7,61,61,0,2794,2794,0,14,14,0,100
ab625c9ca429f5fb20499a530511a19f5d96fe3d,8,12,25,13,0,0,0,2,4,316,1,4,2.679304951,626,8,8,50,50,0,4489,4428,61,27,27,0,100
ccfec3f1cd6d91f4fbee37d2a994138f2ab7df4b,0,0,0,0,0,0,0,0,0,0,0,0,0,0,17,17,0,0,0,0,0,0,0,0,0,100
c95b7be3440073809e68be2005e084d9b68a444e,0,0,0,0,0,0,0,0,0,0,0,0,0,0,18,18,0,0,0,0,0,0,0,0,0,100
8f7c36d0dbf902188da7bde33840042983b6dfc5,0,0,0,0,0,0,0,0,0,0,0,0,0,0,19,19,0,0,0,0,0,0,0,0,0,100
356915e0e55813f61565e8817df270bd3796b820,0,0,0,0,0,0,0,0,0,0,0,0,0,0,20,20,0,0,0,0,0,0,0,0,0,100
1eaf8c959335e485b964fd659c5ae148152255c1,0,0,0,0,0,0,0,0,0,0,0,0,0,0,21,21,0,0,0,0,0,0,0,0,0,100
672db5a3accb5399e66d768a14d4ca1e427d06ce,1,8,5,3,0,0,0,3,4,72,1,1,0,82,22,22,11,9,2,561,534,27,1,1,0,100
dbc83100cb9fb76d10e6b91ba537dc2e6a3b2338,0,0,0,0,0,0,0,0,0,0,0,0,0,0,23,23,0,0,0,0,0,0,0,0,0,100
f0a4f685320c713fc7131533f6e6d3d07637ac73,3,295,194,101,1,0,1,1,4,102,1,3,0.860550958,570,24,24,113,107,6,4223,3172,1051,29,26,3,99.78586724
b61a6a17af1570a6f0299fb435637b0354e116c7,1,2,0,2,0,0,0,6,11,14,1,1,0,458,25,25,80,80,0,2586,2576,10,25,25,0,100
3c8c97eb4aeeb6464b84650f65e9e8488c5d4fcf,1,4,0,4,0,0,0,2,2,281,1,1,0,119,26,26,14,14,0,1075,1019,56,2,2,0,100
9609e5d82d98ef85f96c1c331926e9360b4be9b5,0,0,0,0,0,0,0,0,0,0,0,0,0,0,3,0,0,0,0,0,0,0,0,0,0,100
4d8b8455b9cf48fb4029c6e708c109daef46f887,0,0,0,0,0,0,0,0,0,0,0,0,0,0,9,9,0,0,0,0,0,0,0,0,0,100
523e121a861b836a2a74c73fc9e5bd4a5bfdaa87,0,0,0,0,0,0,0,0,0,0,0,0,0,0,10,10,0,0,0,0,0,0,0,0,0,100
bec0d392ceefca0e696b37f56d8ad2d5e92ae15b,0,0,0,0,0,0,0,0,0,0,0,0,0,0,11,11,0,0,0,0,0,0,0,0,0,100
eaefa07675c02f394277668ca6d3bd7b0b660521,0,0,0,0,0,0,0,0,0,0,0,0,0,0,12,12,0,0,0,0,0,0,0,0,0,100
6735116a05142e2ad24ec824424707f1736bab03,208,13757,14015,258,0,0,0,2,12,239,1,54,6.890895093,19583,13,10,2580,2580,0,121796,121796,0,892,892,0,100
69d328ce7cfb86235b4d605879ebf6ba7f6e3e34,0,0,0,0,0,0,0,0,0,0,0,0,0,0,14,1,0,0,0,0,0,0,0,0,0,100
d31e074abc9149c7d776da9c5420e9d10b8370e3,0,0,0,0,0,0,0,0,0,0,0,0,0,0,27,0,0,0,0,0,0,0,0,0,0,100
58594d626bb201aa906c9ddbe81b00131ba6f40a,0,0,0,0,0,0,0,0,0,0,0,0,0,0,28,1,0,0,0,0,0,0,0,0,0,100
9409c10daff8f63f4d93138969de54ad9adc0262,0,0,0,0,0,0,0,0,0,0,0,0,0,0,29,2,0,0,0,0,0,0,0,0,0,100
ad0b0dbfaabe35efde115d4dc0d9788c95bb2bd1,1,0,97,97,0,0,0,2,3,47,1,1,0,76,15,1,0,6,6,0,516,516,0,3,3,99.78586724
2a88e95ac7be0d3be3d56d3dfa15e93edfff70f3,1,9,0,9,0,0,0,4,5,47,1,1,0,345,16,2,56,54,2,2613,2585,28,7,7,0,100
b479b29d70d3b4c7c8f889dd4de212829214e40e,2,3,7,4,0,0,0,3,5,46,1,1,0.881290899,187,17,3,30,31,1,984,995,11,13,14,1,100
21209275fc93fe758799a51277b3ad22ee70bac1,2,93,2,91,1,0,1,1,7,24,1,2,0.911117865,422,18,4,91,80,11,3005,2534,471,33,31,2,98.00838574
424b4e49582e69bd28ddfd5746e92b39bcca6404,1,16,10,6,0,0,0,4,8,6,1,1,0,439,19,5,86,85,1,2674,2624,50,32,32,0,100
0b7c264c8d5ad2bd834e052ab04204aa07d94406,1,25,6,19,0,0,0,4,9,0,1,1,0,444,20,6,87,86,1,2749,2674,75,32,32,0,100
f08e2836d667c0e3a13503f0bf6dd22fb71b0157,3,358,175,183,2,0,2,1,5,18,1,2,1.35177391,276,30,3,76,53,23,3300,2007,1293,12,6,6,99.3877551
38a3f68a9194f6fa1fa8a30479b29c22f658468a,0,0,0,0,0,0,0,0,0,0,0,0,0,0,31,4,0,0,0,0,0,0,0,0,0,100
1c6e34fa2e54fcf190c883d3243cfeb35034ce00,0,0,0,0,0,0,0,0,0,0,0,0,0,0,32,5,0,0,0,0,0,0,0,0,0,100
8929f2ffb50919eca20da253bd5db13a03409234,9,183,80,103,2,0,2,1,6,42,1,3,2.718263998,1312,33,6,238,225,13,8806,8319,487,77,71,6,99.19110212
73a7430cbf843948d0047195f5ecac3d0d484166,2,7,0,7,0,0,0,3,6,29,1,1,0.985228136,225,34,7,27,27,0,1484,1371,113,8,8,0,100
218893ca60db834932a7f5bb890ade457eeb3315,0,0,0,0,0,0,0,0,0,0,0,0,0,0,35,8,0,0,0,0,0,0,0,0,0,100
ad37dbc885b67e4ce8bcf66ff42e2ea547e6a5d6,15,862,1,861,14,0,14,1,6,0,1,5,3.594970627,352,36,9,139,56,83,6360,2613,3747,57,7,50,96.88109162
46c974fa2231b45d45184e548994746e6775782f,0,0,0,0,0,0,0,0,0,0,0,0,0,0,37,10,0,0,0,0,0,0,0,0,0,100
5ac3df54606a6d83f37cb3a18755b1a0dc7371e7,2,123,0,123,2,0,2,1,1,0,1,2,0.99995232,0,38,11,12,0,12,647,0,647,7,0,7,99.52963311
0d03c272b7be26444d21a9b053034e00acd9b120,2,25,0,25,0,0,0,4,8,60,1,2,0.795040279,616,39,12,134,130,4,4213,4086,127,38,38,0,100
f00d882d28779ed88c72cdb9ef614c4647b2df23,0,0,0,0,0,0,0,0,0,0,0,0,0,0,40,13,0,0,0,0,0,0,0,0,0,100
3e2473d5a3749be27ba8ab6f5a019011c7bffd8d,0,0,0,0,0,0,0,0,0,0,0,0,0,0,41,14,0,0,0,0,0,0,0,0,0,100
ba21e6156489410381389e86d4de87c9b264befd,1,1,1,0,0,0,0,3,4,60,1,1,0,51,42,15,9,9,0,338,338,0,2,2,0,100
b36a7e282aad81da034fda16d527852402f06a1f,2,10,10,0,0,0,0,4,10,32,1,1,0.468995594,592,43,16,100,100,0,3546,3538,8,35,35,0,100
ef3410c468b160862eca00fdc69d86b4067fed02,1,5,25,20,0,0,0,3,3,60,1,1,0,96,44,17,9,15,6,475,557,82,3,7,4,100
3041cda4168cf91689c4a3937049152113dd5325,11,848,74,774,7,0,7,1,13,15,1,6,2.577684026,836,21,7,217,129,88,8289,4983,3306,87,44,43,98.33948339
7ac502d92ecb32f481dbb491d57d5a7faaa75869,0,0,0,0,0,0,0,0,0,0,0,0,0,0,45,18,0,0,0,0,0,0,0,0,0,100
2e85b3cfb0707d39d715f3d8c670cd7b6584828d,3,548,172,376,1,0,1,1,7,20,1,2,1.544480715,462,46,19,125,76,49,5890,3548,2342,22,9,13,99.54669084
44479498e399d4e34ad0e82b66bfe4cde678e1ae,1,12,2,10,0,0,0,4,4,62,1,1,0,115,47,20,21,19,2,808,747,61,5,5,0,100
7f34e32f4f44b89d3ae5a4ada69bd6c10036d284,0,0,0,0,0,0,0,0,0,0,0,0,0,0,48,21,0,0,0,0,0,0,0,0,0,100
2fc6c7958dd1a00adf86fc4d795a7106c9ed5329,1,3,1,2,0,0,0,4,5,2,1,1,0,428,49,22,92,91,1,2895,2887,8,28,28,0,100
7e78c7fe0a86cb5b19c969b2fb91bcc913e223d2,4,0,21,21,0,0,0,3,5,60,1,2,1.950212065,634,50,23,65,65,0,4659,4767,108,17,17,0,100
645228d8607e6b7931effe3c3424cb1f7d03ed34,1,1,3,2,0,0,0,4,5,0,1,1,0,124,51,24,21,21,0,793,808,15,5,5,0,100
b52314e94424b19ac3e3cc70d0a2b04557fa347f,0,0,0,0,0,0,0,0,0,0,0,0,0,0,52,25,0,0,0,0,0,0,0,0,0,100
669da2f27fcdb92dcc2993915dec6e7ff6b59786,2,224,0,224,2,0,2,1,1,0,1,2,0.9476078,0,53,26,30,0,30,1185,0,1185,9,0,9,99.54954955
4475af8fe9b92807356d479ac33f0366df1bb8a6,8,165,17,148,2,0,2,1,8,28,1,7,1.849810362,1458,54,27,231,216,15,11317,10429,888,40,32,8,99.28762244
62c2facc3072dac4994f340cace9c27bd7d7cd80,0,0,0,0,0,0,0,0,0,0,0,0,0,0,22,8,0,0,0,0,0,0,0,0,0,100
a3e27c410e62e3f0a5709b95b30d7307fa2dba43,2,226,0,226,2,0,2,1,1,0,1,2,0.921217482,0,55,28,24,0,24,1322,0,1322,8,0,8,99.64788732
2739a2be5b3fa32f9c2784f0a87162bbf327152d,0,0,0,0,0,0,0,0,0,0,0,0,0,0,56,29,0,0,0,0,0,0,0,0,0,100
c62ccef000bef7c416fdee6f0ca65c645f87d368,1,2,0,2,0,0,0,4,7,74,1,1,0,301,23,9,35,35,0,1932,1926,6,7,7,0,100
f94e2b2d3a0b3dc8286a125817e2e07d8fc63125,1,195,42,153,0,0,0,2,3,74,1,1,0,103,24,10,36,10,26,1239,596,643,15,7,8,100
efc9fe716c2fe7b6eebd4375af315411ec489b18,1,5,9,4,0,0,0,1,2,12,1,1,0,280,25,11,58,59,1,1645,1667,22,29,29,0,100
b40e05e37601f6ab4554642d9ea43211e66cb28a,1,4,0,4,0,0,0,5,9,77,1,1,0,254,26,12,38,37,1,1456,1440,16,9,9,0,100
e13b44462e90793b807f29cf2b75961b5a520a2d,0,0,0,0,0,0,0,0,0,0,0,0,0,0,57,30,0,0,0,0,0,0,0,0,0,100
d180cc0a01e05a7cc57c6a84e670e1ed4ef3d775,0,0,0,0,0,0,0,0,0,0,0,0,0,0,58,29,0,0,0,0,0,0,0,0,0,100
c4bfc6f9b101c1f8d4ff11b22288d8ba5c5f849b,0,0,0,0,0,0,0,0,0,0,0,0,0,0,59,30,0,0,0,0,0,0,0,0,0,100
d107750682d9a3d74e0a3fd6eb68b91e6f99d34d,1,1,1,0,0,0,0,1,2,28,1,1,0,278,60,30,62,62,0,2176,2176,0,6,6,0,100
10c56757309ca3c002b0aa5e0a2257693f41960d,0,0,0,0,0,0,0,0,0,0,0,0,0,0,61,31,0,0,0,0,0,0,0,0,0,100
a1d6df1b7b899ddd13f854881c7e1b3ab67dc7fe,0,0,0,0,0,0,0,0,0,0,0,0,0,0,62,32,0,0,0,0,0,0,0,0,0,100
b97a0d5a295eb926fb6afe164e6b3e792d66b11a,13,1800,31,1769,6,0,6,1,11,22,1,8,2.463684143,1332,63,33,375,193,182,18394,9281,9113,128,57,71,97.08818636
d45e08be3cf53c8a345a6db9352161d870c14b79,0,0,0,0,0,0,0,0,0,0,0,0,0,0,64,34,0,0,0,0,0,0,0,0,0,100
e8fb9df195fa90a887351751f6ae6764bcfea1c6,0,0,0,0,0,0,0,0,0,0,0,0,0,0,65,35,0,0,0,0,0,0,0,0,0,100
4da2d860241de41888b6a4cb6aa7c538ead02242,11,31,38,7,0,0,0,3,14,29,1,8,3.404130343,2236,66,36,338,338,0,14795,14864,69,98,98,0,99.36204147
71d77ff1b2a80d95f9cd9d04b1cb219ccbd45191,1,28,0,28,1,0,1,1,1,0,1,1,0,0,67,37,6,0,6,126,0,126,4,0,4,99.27652733
3bed4feb55ac8a53691ac7a274f745f6c1333dcf,0,0,0,0,0,0,0,0,0,0,0,0,0,0,68,38,0,0,0,0,0,0,0,0,0,100
118360ee33f50984cb5046fa93be5d6af12ae652,0,0,0,0,0,0,0,0,0,0,0,0,0,0,69,38,0,0,0,0,0,0,0,0,0,100
68484adb4299c061ff33ccc43dfbadbecb0f1e3a,1,4,2,2,0,0,0,1,3,14,1,1,0,278,70,38,62,62,0,2194,2176,18,6,6,0,100
e4eb5f4b310d3645451e0449418bfcd3fbcd672d,1,71,44,27,0,0,0,4,9,34,1,1,0,459,71,39,69,63,6,3741,3526,215,9,8,1,100
82e0c53eff96c010e13255d7c318f49364b28e1e,0,0,0,0,0,0,0,0,0,0,0,0,0,0,72,40,0,0,0,0,0,0,0,0,0,100
fedf00f52a2fd0c2383dfb968331455e4605cc34,2,158,1,157,1,0,1,1,2,20,1,2,0.823502377,196,73,24,62,42,20,2324,1399,925,15,12,3,99.67923015
8ba77f91cd2f6eca3a91e9fb07343050222b95a9,0,0,0,0,0,0,0,0,0,0,0,0,0,0,74,23,0,0,0,0,0,0,0,0,0,100
cfeaf5e5e48759b761cd92fbb9da8bd115c70b04,1,6,3,3,0,0,0,3,4,47,1,1,0,110,75,24,16,15,1,719,705,14,4,4,0,100
12d6fb5949d744daac683ec6f5bb6ed9614d48d0,0,0,0,0,0,0,0,0,0,0,0,0,0,0,76,21,0,0,0,0,0,0,0,0,0,100
55c65564cb44a993357c18fe0d8d87d8342cc94a,0,0,0,0,0,0,0,0,0,0,0,0,0,0,77,22,0,0,0,0,0,0,0,0,0,100
06cf354e0244eb001e3f4f846980dc53269ee973,0,0,0,0,0,0,0,0,0,0,0,0,0,0,78,23,0,0,0,0,0,0,0,0,0,100
24efb7edd1ad86c10baca765d0ed778c72d9f771,1,45,23,22,0,0,0,3,7,50,1,1,0,122,79,24,17,12,5,964,779,185,5,4,1,100
c52e3ac2b9ad6884002022fab480d8694f49e672,5,57,31,26,0,0,0,6,15,72,1,4,1.800745736,954,80,25,166,164,2,5613,5472,141,78,77,1,100
cbaaf451ab032d4d7f249e7ef13f95923ef3b6f2,1,8,17,9,0,0,0,5,9,17,1,1,0,303,81,26,33,35,2,1903,1945,42,7,7,0,100
53bacf5f9aa42fe017d9ff11042619f79919737c,1,1,1,0,0,0,0,6,16,0,1,1,0,442,82,27,79,79,0,2748,2750,2,24,24,0,100
585738bfe2c4285b796a868eedd2a7bfca2768f3,0,0,0,0,0,0,0,0,0,0,0,0,0,0,83,26,0,0,0,0,0,0,0,0,0,100
549fcfe7a84b924895ef639f427c05858da90624,0,0,0,0,0,0,0,0,0,0,0,0,0,0,84,27,0,0,0,0,0,0,0,0,0,100
a8170b658b251abca6731dd0267c5b6d8c151b5b,0,0,0,0,0,0,0,0,0,0,0,0,0,0,85,28,0,0,0,0,0,0,0,0,0,100
5547136c04ba595df98abc38b1c00b9ef39a87c0,0,0,0,0,0,0,0,0,0,0,0,0,0,0,86,29,0,0,0,0,0,0,0,0,0,100
9a562577faf4416a5a2007d48349bfadc720289d,1,19,6,13,0,0,0,5,10,33,1,1,0,258,87,30,42,38,4,1496,1456,40,9,9,0,100
5239d74ff7e2774e78dd735eec476834ab69402f,1,16,6,10,0,0,0,1,2,64,1,1,0,51,88,31,2,2,0,448,391,57,2,2,0,100
d93936e5f09b4840983d8aeed280a5237e4d1ac4,0,0,0,0,0,0,0,0,0,0,0,0,0,0,89,32,0,0,0,0,0,0,0,0,0,100
a863ae87b4673bb370d88e41f3d5e2917ebe1f89,0,0,0,0,0,0,0,0,0,0,0,0,0,0,90,33,0,0,0,0,0,0,0,0,0,100
e90581c11bc9a54f8f224df9eca1d1a210a24abc,0,0,0,0,0,0,0,0,0,0,0,0,0,0,91,34,0,0,0,0,0,0,0,0,0,100
cfadf4136638295086f41c855e3bebda262a3537,2,15,4,11,0,0,0,3,4,118,1,2,0.998000884,301,92,35,59,58,1,1845,1784,61,15,15,0,100
72715e369e6d114c7807915f40b060eb222cf4a6,1,17,6,11,0,0,0,4,5,37,1,1,0,53,93,36,8,6,2,323,257,66,2,2,0,100
1d4029d4d43556eee358f797655542abf34fe5d6,1,55,0,55,1,0,1,1,1,0,1,1,0,0,27,0,2,0,2,292,0,292,1,0,1,99.36204147
076cf0f5cc80c042e9eabab02c9ea749bb9e2b43,0,0,0,0,0,0,0,0,0,0,0,0,0,0,28,1,0,0,0,0,0,0,0,0,0,100
73ba56785c4636c2c542568459a79b991bd58822,1,1,1,0,0,0,0,4,6,0,1,1,0,62,94,36,8,8,0,324,323,1,2,2,0,100
bd4f7bc9c2df697bf210296cc96814a65cc78259,1,20,8,12,0,0,0,1,2,65,1,1,0,33,95,37,10,8,2,300,249,51,5,5,0,100
e13c53717f2773c6dc426fb7b9affe628c77261e,1,3,0,3,0,0,0,3,3,122,1,1,0,69,96,38,6,5,1,439,406,33,3,3,0,100
23479620836a5fd72c7eb9dc59539f8f64fb2fe5,1,4,0,4,0,0,0,1,3,21,1,1,0,224,97,34,53,52,1,1569,1540,29,13,13,0,100
506f7302eec7a6aa947b7cc85b2e573dd51d8ad8,0,0,0,0,0,0,0,0,0,0,0,0,0,0,98,35,0,0,0,0,0,0,0,0,0,100
541e729e786314bc342e87dd1ac22213f039296e,0,0,0,0,0,0,0,0,0,0,0,0,0,0,99,36,0,0,0,0,0,0,0,0,0,100
b2113c57a4dada53e25d910423a8e4c6cb79e616,6,596,1,595,4,0,4,1,8,7,1,3,2.113748398,424,100,37,159,79,80,6793,3158,3635,32,11,21,97.80130293
6431f7ee6a04b50b03df3d2346f0109895555ae3,0,0,0,0,0,0,0,0,0,0,0,0,0,0,101,38,0,0,0,0,0,0,0,0,0,100
19af0c8d445cfbc477fdc52355bf4efd450c9566,0,0,0,0,0,0,0,0,0,0,0,0,0,0,102,39,0,0,0,0,0,0,0,0,0,100
8638cd46ce861bfba75430b5b404f80853d9624e,1,88,0,88,1,0,1,1,1,0,1,1,0,0,103,40,14,0,14,572,0,572,3,0,3,99.50207469
565658deaf3bb9f54ad4585d19f0a73b303791ae,1,1,2,1,0,0,0,4,10,27,1,1,0,485,104,41,69,69,0,3725,3741,16,9,9,0,100
e47c1919db7e66a402c7be842e18f1e2b5bd7de7,0,0,0,0,0,0,0,0,0,0,0,0,0,0,105,42,0,0,0,0,0,0,0,0,0,100
af2248693bdb6caf8d1356157c318d1064c53bd0,0,0,0,0,0,0,0,0,0,0,0,0,0,0,106,43,0,0,0,0,0,0,0,0,0,100
d217e5138ab22388fc1d61c7b02a106c7047684c,0,0,0,0,0,0,0,0,0,0,0,0,0,0,107,43,0,0,0,0,0,0,0,0,0,100
04bd09f3d663cadb36116c83a23cabc358759e71,0,0,0,0,0,0,0,0,0,0,0,0,0,0,108,44,0,0,0,0,0,0,0,0,0,100
21e0469dc7cee60ce2f008c869289a8d3da897a4,0,0,0,0,0,0,0,0,0,0,0,0,0,0,109,45,0,0,0,0,0,0,0,0,0,100
22fd6a0ec62e10ad9385b6e6ca651f39579e95c4,2,0,17,17,0,0,0,4,12,55,1,1,0.873981048,590,110,46,102,105,3,3487,3594,107,35,35,0,100
74f1adf51d329f0619204b2a6e477eec6523b201,0,0,0,0,0,0,0,0,0,0,0,0,0,0,111,47,0,0,0,0,0,0,0,0,0,100
3e8fd74073d895765b6ecce4928b924b215a82e4,1,230,0,230,1,0,1,1,1,0,1,1,0,0,112,48,17,0,17,1155,0,1155,5,0,5,99.58471761
d5486314592fe488ad8c4f11c68bd11f039ac982,0,0,0,0,0,0,0,0,0,0,0,0,0,0,113,49,0,0,0,0,0,0,0,0,0,100
b289ad5538c1b5d8a3923d106d7a2744109b9d20,0,0,0,0,0,0,0,0,0,0,0,0,0,0,114,50,0,0,0,0,0,0,0,0,0,100
d46be9124375a6cea7189dbfce85826a977cc02c,1,1,1,0,0,0,0,1,4,3,1,1,0,227,115,51,54,53,1,1576,1569,7,13,13,0,100
debaaf1e2955baebe3583a984f713f3cd842fe67,0,0,0,0,0,0,0,0,0,0,0,0,0,0,116,52,0,0,0,0,0,0,0,0,0,100
f4ba9ad16447bf07637be5c473465ae956f6b926,0,0,0,0,0,0,0,0,0,0,0,0,0,0,117,53,0,0,0,0,0,0,0,0,0,100
02ad25931375b3c01928b1a88b5de03edd8785be,1,1,6,5,0,0,0,1,5,3,1,1,0,286,118,54,62,63,1,2204,2234,30,6,6,0,100
9e08dd0243d4ff32224265fd5781bb4115c9f452,1,1,1,0,0,0,0,1,5,0,1,1,0,227,119,55,54,54,0,1576,1576,0,13,13,0,100
c63842daf573c8115d052480cd00d05994f243fe,0,0,0,0,0,0,0,0,0,0,0,0,0,0,120,56,0,0,0,0,0,0,0,0,0,100
c872a19602c1c0b952a17b83f369d22f133ef3e6,1,46,5,41,0,0,0,1,6,14,1,1,0,227,121,48,65,54,11,1794,1576,218,15,13,2,100
e3c61c64d2ce0801a0e6e6cf768a66e7d19f03eb,0,0,0,0,0,0,0,0,0,0,0,0,0,0,122,46,0,0,0,0,0,0,0,0,0,100
9e84ee37f4db45bdee3f59aa586a36472246f7bf,0,0,0,0,0,0,0,0,0,0,0,0,0,0,123,47,0,0,0,0,0,0,0,0,0,100
bda6ff73e543895cc8208a2945527cc62f5ea1ed,3,4,59,55,0,0,0,1,6,28,1,2,1.268130104,321,124,43,34,44,10,1733,1712,21,10,12,2,99.33110368
f5c5483412ce3aaaf621999263aab867bee3c107,0,0,0,0,0,0,0,0,0,0,0,0,0,0,125,44,0,0,0,0,0,0,0,0,0,100
fd576a6bd2120f0606bb09a38523eeac45b5b42a,0,0,0,0,0,0,0,0,0,0,0,0,0,0,126,43,0,0,0,0,0,0,0,0,0,100
e43a63952dd6461f20daa7c00b65b36ffacdfbf0,0,0,0,0,0,0,0,0,0,0,0,0,0,0,127,39,0,0,0,0,0,0,0,0,0,100
ae8d7a01dc2c5ccfa146efd4f81f7f7e44950b75,2,149,0,149,2,0,2,1,1,0,1,2,0.968546248,0,128,7,9,0,9,628,0,628,6,0,6,99.58368027
1914a74d1b870a9069c90299e50c8039eb053afa,2,44,9,35,0,0,0,1,4,83,1,2,0.883585086,96,129,8,20,17,3,873,726,147,7,7,0,100
c5cdff5505876633cc643e5b6cb195888a0582b2,1,7,1,6,0,0,0,3,4,173,1,1,0,125,29,0,23,21,2,983,905,78,5,5,0,100
6a9557b1bebb6abdb629d4c932b76b0f2c78f523,2,37,13,24,0,0,0,4,7,116,1,1,0.141440543,730,130,9,120,117,3,4767,4637,130,37,35,2,100
1040a0a14f200f2714b507d993dbcbd977c1b1c2,1,15,5,10,0,0,0,4,11,47,1,1,0,484,131,10,71,69,2,3770,3725,45,9,9,0,100
235136752afc0d609dd901e5b6781e6a7b5865f6,1,9,1,8,0,0,0,3,8,8,1,1,0,416,132,11,67,66,1,2502,2457,45,19,19,0,100
695ada4eacb67aec17e4815879dc589a1e7b5170,1,8,0,8,0,0,0,4,4,185,1,1,0,107,133,12,14,14,0,557,547,10,7,7,0,100
447fcfd3edd1a08c6cdd21ed731c70d048226a19,0,0,0,0,0,0,0,0,0,0,0,0,0,0,134,13,0,0,0,0,0,0,0,0,0,100
dd6435074ef9e4dd151b2ddfe513b1849ce9e6ec,0,0,0,0,0,0,0,0,0,0,0,0,0,0,135,14,0,0,0,0,0,0,0,0,0,100
eb1ba6deb27206caf5b6ee4332214e99298ac355,0,0,0,0,0,0,0,0,0,0,0,0,0,0,136,15,0,0,0,0,0,0,0,0,0,100
45f17594065aa3a97988e99e8195b6714559e263,0,0,0,0,0,0,0,0,0,0,0,0,0,0,137,16,0,0,0,0,0,0,0,0,0,100
9aea531f2c39be51059b9cb0034c68d0507f80fa,0,0,0,0,0,0,0,0,0,0,0,0,0,0,138,17,0,0,0,0,0,0,0,0,0,100
b0d21c16abfe52b5d1d1cffb790ed356e1cd7b02,0,0,0,0,0,0,0,0,0,0,0,0,0,0,139,18,0,0,0,0,0,0,0,0,0,100
5e6f09fc0a9a87310cd6e42e8fdd72785319be68,1,69,0,69,0,0,0,4,5,128,1,1,0,177,140,18,50,43,7,1665,1347,318,16,15,1,100
102c3cc98b5dd6b6dc24df8b038c5760aff8d465,0,0,0,0,0,0,0,0,0,0,0,0,0,0,141,19,0,0,0,0,0,0,0,0,0,100
386f80b96bbcb54addb36e4c347e511b66124363,0,0,0,0,0,0,0,0,0,0,0,0,0,0,142,19,0,0,0,0,0,0,0,0,0,100
9a4eb8c736591afb18190d68cd7ed0066d7dc865,3,166,4,162,1,0,1,1,7,54,1,3,0.939305045,318,143,20,74,55,19,2857,1838,1019,16,11,5,98.85151764
f31396577d5c9f8926089bb9962f10c5b9abcec2,1,13,8,5,0,0,0,1,4,14,1,1,0,76,144,21,14,12,2,457,439,18,5,5,0,100
fb153cfd7971f7257ee752670b508ddca1988ccd,1,2,2,0,0,0,0,3,9,6,1,1,0,424,145,21,69,67,2,2522,2502,20,19,19,0,100
136adbbeb0023b55298d392ed4d409773b8a7b4d,1,19,13,6,0,0,0,3,4,126,1,1,0,113,146,22,20,20,0,1024,974,50,2,2,0,100
7b482276c9dace79a1887d22e16c9d3c29cb7b00,0,0,0,0,0,0,0,0,0,0,0,0,0,0,147,23,0,0,0,0,0,0,0,0,0,100
f5ae54fc06056ef684f74149e56e4cabf6877e24,0,0,0,0,0,0,0,0,0,0,0,0,0,0,148,24,0,0,0,0,0,0,0,0,0,100
98e4ec5bb63fe3a0a582ad91b733f5d773ab09e9,0,0,0,0,0,0,0,0,0,0,0,0,0,0,149,22,0,0,0,0,0,0,0,0,0,100
467ede45da9e4ce00c8affed07d2f0c6a1cdea88,0,0,0,0,0,0,0,0,0,0,0,0,0,0,150,23,0,0,0,0,0,0,0,0,0,100
369df9e4655bd5cf73385b119fe8fed7bd08c3d7,0,0,0,0,0,0,0,0,0,0,0,0,0,0,151,24,0,0,0,0,0,0,0,0,0,100
3583f712a594a84210d35138840e24f42b04c152,0,0,0,0,0,0,0,0,0,0,0,0,0,0,152,25,0,0,0,0,0,0,0,0,0,100
40deab08b57f9ba83325058d8caed3ed6e50f164,0,0,0,0,0,0,0,0,0,0,0,0,0,0,153,26,0,0,0,0,0,0,0,0,0,100
dce5fc8300554a38c344c37339db36eb96285ebb,0,0,0,0,0,0,0,0,0,0,0,0,0,0,154,27,0,0,0,0,0,0,0,0,0,100
de87b01513fbda864768ea3ab9ec66d2d64c0e1f,0,0,0,0,0,0,0,0,0,0,0,0,0,0,30,1,0,0,0,0,0,0,0,0,0,100
ff363f0f58dbacc0492adac23c3e718f08a164c0,1,6,1,5,0,0,0,2,3,113,1,1,0,208,31,2,34,33,1,1518,1486,32,10,10,0,100
408e22a4e327de76226ae7bbe96babfd99ad3f96,0,0,0,0,0,0,0,0,0,0,0,0,0,0,32,3,0,0,0,0,0,0,0,0,0,100
fdf8b10f48f0b7e60dc76cf7f0fc83488e204b3b,0,0,0,0,0,0,0,0,0,0,0,0,0,0,155,27,0,0,0,0,0,0,0,0,0,100
d57160fd392cd6859e7ccfda2fc1c13453528415,0,0,0,0,0,0,0,0,0,0,0,0,0,0,33,4,0,0,0,0,0,0,0,0,0,100
86affeb0a6cd603ec870cd6b73db2087a3f01128,0,0,0,0,0,0,0,0,0,0,0,0,0,0,156,28,0,0,0,0,0,0,0,0,0,100
b042654416abaab8e0f085f2f8f0b668afdb304d,1,46,59,13,0,0,0,4,6,27,1,1,0,233,157,29,43,50,7,1464,1665,201,17,16,1,100
7a90e5bf615fa0ec9ca87999e1e0c8209f4fd466,0,0,0,0,0,0,0,0,0,0,0,0,0,0,158,26,0,0,0,0,0,0,0,0,0,100
fd56d8d183726e2e6a0fe7c4f623172345c4dc6b,1,0,59,59,0,0,0,5,10,116,1,1,0,294,34,4,28,33,5,1592,1903,311,6,7,1,100
193dc87bd37504ec0fab467cc804f882005895af,2,11,10,1,0,0,0,3,7,181,1,2,0.453716339,260,35,5,35,35,0,1626,1603,23,9,9,0,100
1c5e00e8d3faf8e2a17a2c1f9ce3baac5f626135,3,708,0,708,3,0,3,1,1,0,1,2,1.495434075,0,36,6,68,0,68,3598,0,3598,16,0,16,99.43502825
00cd8b122d2bb5c1a309e6872dd1e374ff914071,2,6,4,2,0,0,0,4,10,41,1,1,0.721928095,611,159,12,103,102,1,3694,3680,14,23,23,0,100
5367dc471ef334731cd18b838be27ec46221fb4c,0,0,0,0,0,0,0,0,0,0,0,0,0,0,160,11,0,0,0,0,0,0,0,0,0,100
650f5f99a556d602b0cacb1f330facd4c97d1e1f,4,5,3,2,0,0,0,4,9,95,1,3,1.905639062,743,37,7,119,119,0,4881,4871,10,21,21,0,100
573f281a1cc4508dd1f5b2d9de57d82669255be1,0,0,0,0,0,0,0,0,0,0,0,0,0,0,161,11,0,0,0,0,0,0,0,0,0,100
434e30131ee7f715da40b0275e5607cebe6e9e08,0,0,0,0,0,0,0,0,0,0,0,0,0,0,162,7,0,0,0,0,0,0,0,0,0,100
c17d6bb82d96e209b290377b5329ab8b14ea5efb,1,23,2,21,0,0,0,4,9,189,1,1,0,213,38,5,46,43,3,1434,1326,108,12,10,2,100
b58f7118394eba850b2baca5712fa363280d213a,1,14,2,12,0,0,0,5,11,24,1,1,0,248,39,6,29,28,1,1645,1592,53,7,6,1,100
fbc03f7153cbf31eb1fb62cec4a62a2c9725d70d,4,7,6,1,0,0,0,3,8,165,1,2,1.884313528,686,40,7,77,77,0,5153,5145,8,18,18,0,100
1029a23162527cdc9b3a9ddad41b677e36d47fa4,1,0,15,15,0,0,0,4,7,126,1,1,0,62,41,8,6,8,2,237,324,87,2,2,0,100
91fe6a4f29855402189ffb6a32a182507f0d4777,0,0,0,0,0,0,0,0,0,0,0,0,0,0,163,8,0,0,0,0,0,0,0,0,0,100
6f83b4228110417b768194a75fe9dd3140c605cf,5,227,29,198,3,0,3,1,13,61,1,3,2.12728622,884,164,8,194,178,16,6440,5608,832,65,60,5,99.36153232
9dd81f33d07d0206f69deab59e117625f3c734ab,1,18,2,16,0,0,0,4,10,18,1,1,0,190,165,9,40,34,6,1289,1185,104,4,4,0,100
3088b7f053792adad8e4404d65ac0f731c0dfce5,0,0,0,0,0,0,0,0,0,0,0,0,0,0,166,10,0,0,0,0,0,0,0,0,0,100
3db817c7ae6f85c6183ab815d852c603b24c3250,0,0,0,0,0,0,0,0,0,0,0,0,0,0,167,8,0,0,0,0,0,0,0,0,0,100
6bda94fe012ed6bd946acd00487d5407759391f1,0,0,0,0,0,0,0,0,0,0,0,0,0,0,168,9,0,0,0,0,0,0,0,0,0,100
6c3737cc0c650149105ec54a8f5d7640e575da80,0,0,0,0,0,0,0,0,0,0,0,0,0,0,169,10,0,0,0,0,0,0,0,0,0,100
de8be00e7bcc82d2de47d01fdb94903e3bd4aa88,4,66,11,55,0,0,0,2,7,219,1,4,1.390928806,384,42,5,59,55,4,2451,2125,326,23,22,1,100
d65d6d151c5a3d98cabb397176d90b4c454f5659,1,52,30,22,0,0,0,4,8,43,1,1,0,81,43,6,14,11,3,758,543,215,1,1,0,100
8bc17cd835cc7a11b883dd7cff853dae6fa2b172,12,1431,1,1430,11,0,11,1,3,15,2,5,3.194121105,154,170,11,133,26,107,7927,1038,6889,46,10,36,97.97822706
97060735fc94df8b8293934b8a9a48a1146c4bd5,0,0,0,0,0,0,0,0,0,0,0,0,0,0,171,12,0,0,0,0,0,0,0,0,0,100
17e0481cfc02efcfdeaa9fddbacfa22c87fca0b9,19,191,189,2,0,0,0,2,17,235,1,7,3.479558016,2536,44,7,342,352,10,15649,15970,321,115,124,9,99.61685824
54a4470b53838050b8a8033b96a98cc0e2d6e8db,4,92,2,90,2,0,2,3,5,134,1,3,1.325299043,160,45,8,24,21,3,1058,759,299,19,16,3,99.31245225
44ebe64644169e55bd3e264b7f8291f391c067f5,68,9397,335,9062,64,0,64,1,5,4,1,7,5.693936444,750,172,13,1241,128,1113,42361,4855,37506,1020,26,994,89.21501706
3cf31de1bdac0fd6a572128925c3494028ba1d2e,0,0,0,0,0,0,0,0,0,0,0,0,0,0,173,12,0,0,0,0,0,0,0,0,0,100
9e3e66d2facb5c6475d731e41b628676fc89c540,1,23,6,17,0,0,0,1,2,0,1,1,0,189,174,13,39,35,4,1285,1233,52,7,7,0,100
746a198bd66529c97c8a91651c22a48463ae3c01,11,237,298,61,2,0,2,1,6,106,1,6,2.818238168,1224,175,14,185,137,48,8451,5739,2712,36,36,0,98.56697819
c414bd019758d54a97a2936ddfae289da2ab06c4,0,0,0,0,0,0,0,0,0,0,0,0,0,0,176,15,0,0,0,0,0,0,0,0,0,100
ef9b357d89044bc7dab6a73fdf20349adc067aa7,18,855,75,780,4,0,4,1,18,50,1,9,3.051124268,1851,46,8,397,306,91,14683,10425,4258,153,128,25,98.69727047
26cbe26adf3b99086e6fbbab2cf0092a932dac34,2,375,1,374,1,0,1,1,19,0,1,2,0.047837447,456,177,15,114,82,32,5489,2834,2655,30,26,4,98.5472155
f76db9b129a1464fcd7e150fc940468a8e0804ab,0,0,0,0,0,0,0,0,0,0,0,0,0,0,47,9,0,0,0,0,0,0,0,0,0,100
10d4df5c4539b10220cf2b12d436ff41fada39b7,1,1,1,0,0,0,0,4,9,5,1,1,0,98,48,10,14,14,0,760,758,2,1,1,0,100
89e56e582ae747454f7fc95fc232327cc52c6899,0,0,0,0,0,0,0,0,0,0,0,0,0,0,178,16,0,0,0,0,0,0,0,0,0,100
63fadf23021e9e96062cbd1fddf649a0a959ce65,0,0,0,0,0,0,0,0,0,0,0,0,0,0,49,11,0,0,0,0,0,0,0,0,0,100
1b903756ab421e93ac2844a1467565c31fd7f5e0,2,12,7,5,0,0,0,3,10,5,1,2,0.831474388,208,50,12,35,34,1,1380,1358,22,10,10,0,100
d06db509e79ec0d446219794a22825ddb770cee1,28,252,201,51,0,0,0,2,20,26,1,15,3.623564003,3881,51,13,543,536,7,24839,24607,232,191,187,4,99.88095238
d29f049cae621249f38b2f50d3a02606d15c347d,1,1,1,0,0,0,0,3,8,0,1,1,0,183,52,14,24,24,0,1104,1104,0,8,8,0,100
3a1aed35b6b6228edc28beb6f8230c22c7924dab,2,9,9,0,0,0,0,2,6,4,1,2,0.764204507,197,53,15,28,28,0,1135,1135,0,11,11,0,100
075d020db262999c4c468e842a989a2aa5fa5055,20,259,226,33,2,0,2,1,3,0,1,2,2.458948113,1258,179,17,96,94,2,8097,7808,289,46,46,0,99.46428571
95f415258638419792e88090ceb8dd293f12a4d9,0,0,0,0,0,0,0,0,0,0,0,0,0,0,180,18,0,0,0,0,0,0,0,0,0,100
30b7e985618cc29e1f0d8b0b521382bdd21cc994,0,0,0,0,0,0,0,0,0,0,0,0,0,0,181,19,0,0,0,0,0,0,0,0,0,100
8b11a2edffefdab0ec17454c6db4833af252540d,1,1,0,1,0,0,0,2,7,9,1,1,0,106,54,16,8,8,0,886,877,9,2,2,0,100
c745b015c96d00a778f54befcf971e00f40823f2,0,0,0,0,0,0,0,0,0,0,0,0,0,0,182,19,0,0,0,0,0,0,0,0,0,100
89cdac2ef7f0050bcf06c243b31ccfe136df7517,0,0,0,0,0,0,0,0,0,0,0,0,0,0,183,19,0,0,0,0,0,0,0,0,0,100
058eaac5fa552a8ab3bf1198ae45f7103f67d7fe,4,228,1,227,2,0,2,1,4,6,1,3,1.315803339,99,55,13,24,4,20,1304,374,930,13,4,9,98.98325359
3da923025da11c759b8122d1fe59c2114843ad9b,0,0,0,0,0,0,0,0,0,0,0,0,0,0,184,20,0,0,0,0,0,0,0,0,0,100
211b3bf5cea72fd9697569cfdf708da03cb71a84,1,12,8,4,0,0,0,2,5,14,1,1,0,102,56,14,9,9,0,616,601,15,3,3,0,100
8d67c12924d2cbf35e96b5dcd658922e4d3747f3,0,0,0,0,0,0,0,0,0,0,0,0,0,0,185,18,0,0,0,0,0,0,0,0,0,100
e6443b4857bbfa2fa8d4399520cc4386246e16a0,11,147,96,51,0,0,0,1,10,80,1,5,2.357792366,1596,186,19,214,202,12,11023,10733,290,56,56,0,99.76019185
f008654887539f1a55af5d4b540b8eff066a9261,2,8,2,6,0,0,0,1,7,149,1,2,0.881290899,359,187,20,77,75,2,2637,2578,59,17,17,0,100
3a0d0469f3562eaa4f7597b31698da7b5cb3143f,0,0,0,0,0,0,0,0,0,0,0,0,0,0,188,21,0,0,0,0,0,0,0,0,0,100
be353f2c1d37fb4bceb5919c8ac5ec35878b32d1,1,94,119,25,0,0,0,5,12,48,1,1,0,258,189,22,28,29,1,1459,1645,186,8,7,1,100
2082927241e9885a22a2769c7b06cc394cfe084e,1,1,1,0,0,0,0,1,2,24,1,1,0,540,190,23,81,81,0,4113,4109,4,8,8,0,100
d94ad5b8894a7983a9343029d0b9bf49db8fda1e,0,0,0,0,0,0,0,0,0,0,0,0,0,0,57,15,0,0,0,0,0,0,0,0,0,100
4c5e218878546c603949eac0b2c33023acb47ae6,1,11,10,1,0,0,0,3,5,23,1,1,0,54,58,16,5,5,0,217,207,10,1,1,0,100
42d0e1a4bd1ebc949890f64c47fb0695e4c57fb0,1,1,1,0,0,0,0,1,3,2,1,1,0,540,191,24,82,81,1,4130,4113,17,8,8,0,100
1412e8eec9d1436f57499c031a4175dd5a76559c,3,4,3,1,0,0,0,3,9,103,1,1,1.378783493,630,192,25,79,79,0,4755,4753,2,15,15,0,100
f7a3c6653daa91d331e36a3d430a49666c99cf99,0,0,0,0,0,0,0,0,0,0,0,0,0,0,193,26,0,0,0,0,0,0,0,0,0,100
bf54917e5e554d7c8dd01922ac3f4361197c6703,1,24,4,20,0,0,0,2,2,72,1,1,0,256,194,27,32,30,2,1760,1631,129,8,8,0,100
021dfd95eadd2dfa986af95da801211b27fa6ae2,11,26,0,26,0,0,0,3,8,35,1,4,2.852782025,1229,195,28,114,112,2,8888,8728,160,34,34,0,100
da152c460809612af37c2edf7193ddc07e7cc5a1,0,0,0,0,0,0,0,0,0,0,0,0,0,0,196,29,0,0,0,0,0,0,0,0,0,100
c446665e34cbbddd67d3d17439a519ffb58126ca,0,0,0,0,0,0,0,0,0,0,0,0,0,0,197,30,0,0,0,0,0,0,0,0,0,100
262e4fc876669434ed6b861d6b06a91a39dff5b1,0,0,0,0,0,0,0,0,0,0,0,0,0,0,198,31,0,0,0,0,0,0,0,0,0,100
ef11cda55a973f138003c11743dd724161305826,0,0,0,0,0,0,0,0,0,0,0,0,0,0,199,32,0,0,0,0,0,0,0,0,0,100
bc79bdcde3989a7d33b68983f201418c76a56ec4,1,27,21,6,0,0,0,1,4,8,1,1,0,540,200,31,84,82,2,4159,4130,29,8,8,0,100
ffd3e667e3496b84771490ec39b959ea798321e5,1,0,2,2,0,0,0,3,5,8,1,1,0,208,201,32,28,28,0,1577,1590,13,6,6,0,100
b3e12cba813e1cf23d16fa7deb2dec1af4d4f681,2,13,5,8,0,0,0,1,8,10,1,2,0.918295834,364,202,33,81,77,4,2684,2637,47,17,17,0,100
37d78ce8baafedca429313d6071fbb2cd880c486,2,39,14,25,0,0,0,1,5,36,1,2,0.313812964,208,203,34,31,26,5,1501,1346,155,11,10,1,100
b2b7ace82789e0f946ec3e117ccbc3ac39d63006,1,1,1,0,0,0,0,1,5,0,1,1,0,545,204,35,84,84,0,4159,4159,0,8,8,0,100
7a3a6da91b731932c2913828d0bf9131044ee178,2,104,23,81,1,0,1,1,2,90,1,2,0.976210142,194,205,36,27,17,10,1668,1155,513,10,5,5,99.40191388
f3cc3b4562baa79e29f0593cef1d442df6a6e5a1,0,0,0,0,0,0,0,0,0,0,0,0,0,0,206,37,0,0,0,0,0,0,0,0,0,100
cb12d965f830413ecd1047a460b4b230a416e19b,1,7,3,4,0,0,0,1,6,2,1,1,0,545,207,37,84,84,0,4168,4159,9,8,8,0,100
45b55a21c149b7cb40e02f370f573e49f4611747,0,0,0,0,0,0,0,0,0,0,0,0,0,0,208,38,0,0,0,0,0,0,0,0,0,100
23f3c4a7515dc22253ef68190eddaac26d1ea119,3,180,25,155,1,0,1,4,9,15,1,2,1.470185501,130,59,17,22,11,11,1765,763,1002,11,6,5,99.64028777
78a5479d0127b9bab159fbb7a58ab8904f9dde3d,1,6,0,6,0,0,0,3,5,33,1,1,0,55,60,18,10,8,2,272,230,42,8,7,1,100
37196b09ac3fd65e480f3531dd9c1d750a171b68,1,1,1,0,0,0,0,1,7,2,1,1,0,549,209,36,84,84,0,4168,4168,0,8,8,0,100
7c8ff6114d9d4c6fcbbebf0ebac823da8eed83b9,0,0,0,0,0,0,0,0,0,0,0,0,0,0,61,15,0,0,0,0,0,0,0,0,0,100
c74c834fba4dfe95b7623776bec2ec90dd1a5a26,0,0,0,0,0,0,0,0,0,0,0,0,0,0,210,33,0,0,0,0,0,0,0,0,0,100
0aec1239742612f124fef3e158ec2355e3bfbb55,16,184,122,62,1,0,1,3,21,24,1,10,3.612041235,2744,211,34,462,461,1,16779,16507,272,170,168,2,99.76004799
cbd5f9491df27a1288dc5e2a42fd4e6262bbbe5b,5,15,6,9,0,0,0,2,9,33,1,5,1.831629922,632,212,35,65,65,0,4649,4573,76,21,21,0,100
a94e8ac4a1dbca3ffc91ff248fee80f2a78832e3,1,1,1,0,0,0,0,2,9,17,1,1,0,268,62,8,69,68,1,1838,1831,7,15,15,0,100
9ac802ef8694a4fae26348e6d18695e11b46e6ca,1,8,4,4,0,0,0,1,2,101,1,1,0,152,63,9,26,26,0,917,911,6,6,6,0,100
09831ec37f2ef5de8f52aff04f7f596f6ab567c8,7,199,16,183,1,0,1,1,5,171,1,4,1.711054478,609,64,9,81,70,11,5539,4218,1321,30,25,5,99.64136282
1d148d1db69dc30f14aa505b03f5f6edb2ada026,1,1,1,0,0,0,0,1,2,0,1,1,0,114,65,10,8,8,0,1036,1036,0,4,4,0,100
cb6f2587158801d7cc01a852387153de20127c51,11,19,17,2,0,0,0,1,22,44,1,6,3.291434643,2049,66,4,349,349,0,12025,12033,8,121,121,0,100
0fcd4c06b212b81d4039437f32fa35101595d67d,0,0,0,0,0,0,0,0,0,0,0,0,0,0,67,5,0,0,0,0,0,0,0,0,0,100
b4342889fd3ad4330fa4b1d96de4fe77c8efe526,2,14,0,14,0,0,0,2,2,302,1,2,0.749595257,202,68,5,24,24,0,1430,1322,108,8,8,0,100
60ea58d9b07d3ece72d0b294615f83d0f5ace2f5,3,1342,0,1342,3,0,3,1,1,0,1,2,1.205337879,0,69,6,164,0,164,9021,0,9021,63,0,63,99.58407605
ee3618be98468febd9cf5cc8c58ed6e10b194034,1,794,0,794,1,0,1,1,1,0,1,1,0,0,70,7,87,0,87,5529,0,5529,20,0,20,99.82269504
c0e84963b91c72928be7e8ff661578af7265d10d,9,292,47,245,1,0,1,1,23,96,1,6,1.96220448,1327,71,7,222,201,21,10080,8873,1207,74,67,7,99.6460177
1022d5b7251bbc7b1f458bbeef5c699b325ccc9e,1,1,6,5,0,0,0,1,4,63,1,1,0,103,213,0,13,13,0,805,853,48,2,2,0,100
b5a4c93ed7149bf8d81ada7ae3999bf7f366ce88,4,562,0,562,4,0,4,1,1,0,1,2,1.826046485,0,72,6,46,0,46,3002,0,3002,17,0,17,99.35294118
28a7396f29dfe79f6c588b3d34fa62cf2a76ce62,0,0,0,0,0,0,0,0,0,0,0,0,0,0,73,7,0,0,0,0,0,0,0,0,0,100
890727fe7e6bdc3b282e9390255a862807b827e1,0,0,0,0,0,0,0,0,0,0,0,0,0,0,74,8,0,0,0,0,0,0,0,0,0,100
e5cb1e85551aa9de0b67c1a1e7c9ba169c71142d,2,51,7,44,0,0,0,2,3,47,1,2,0.767651587,193,75,9,30,23,7,1456,1285,171,9,7,2,100
3568981f43c8e890bca4a8e5dfc3696315ae237d,8,351,62,289,2,0,2,1,7,198,1,6,1.698529105,589,76,10,100,65,35,5815,4008,1807,57,46,11,99.6489175
84df07e0d094ef23f327023c599d53983f17cb96,0,0,0,0,0,0,0,0,0,0,0,0,0,0,77,11,0,0,0,0,0,0,0,0,0,100
46b3149e2d249df264cb4717904cf928a8184eab,0,0,0,0,0,0,0,0,0,0,0,0,0,0,78,12,0,0,0,0,0,0,0,0,0,100
4e749b6d29d77b368b6d0874145e10284a071b8d,1,0,0,0,1,0,1,2,4,2,1,1,0,0,79,13,0,0,0,0,0,0,0,0,0,99.88317757
2ba4adc82c59228fdd2921a4d044bb75f526ed74,1,21,27,6,0,0,0,4,10,35,1,1,0,442,80,14,95,95,0,2979,3005,26,29,29,0,100
23d204a6147bd8f5546a7d71626a8c74f4c14cc4,9,527,90,437,2,0,2,1,6,148,1,6,2.021863771,634,81,13,116,73,43,6459,4418,2041,40,21,19,99.70862471
cb64662aa792bae3bb49cee70b5c9d0ca509acf9,1,2,2,0,0,0,0,1,3,0,1,1,0,96,82,14,5,5,0,785,786,1,3,3,0,100
6caecf4f68a90537a8ddf366248920b461f65063,1,0,34,34,0,0,0,2,3,420,1,1,0,28,83,11,0,0,0,0,93,93,0,0,0,98.60627178
70fc5a18ec2befccec98eec79b793f160f08ae42,4,83,37,46,0,0,0,1,9,80,1,4,1.292132241,540,84,12,63,60,3,3610,3343,267,24,23,1,100
f1be6294f83840e6e6fc0790ec6cd67f5ef6b993,5,17,5,12,0,0,0,1,7,60,1,2,2.162644118,488,85,10,47,45,2,3597,3523,74,18,18,0,100
0f17092240f13e3b3a1be65a102f3f056ca6c64c,0,0,0,0,0,0,0,0,0,0,0,0,0,0,86,11,0,0,0,0,0,0,0,0,0,100
e6980c94f875f8c31863f1c45c9c0c0e722feb37,0,0,0,0,0,0,0,0,0,0,0,0,0,0,87,8,0,0,0,0,0,0,0,0,0,100
6abb544a011fb075f328aa9bb224142f8682badd,0,0,0,0,0,0,0,0,0,0,0,0,0,0,88,9,0,0,0,0,0,0,0,0,0,100
977c511c849990e0e1235c6ebde138575a8d897b,1,98,17,81,0,0,0,2,3,435,1,1,0,38,89,10,15,3,12,809,402,407,2,1,1,100
43af7858ef97474ef089673952e20a676118c94f,1,6,9,3,0,0,0,3,8,373,1,1,0,209,90,11,26,26,0,1319,1312,7,11,11,0,100
932c4069462acda55a5de1a72b73c568381833bd,0,0,0,0,0,0,0,0,0,0,0,0,0,0,91,12,0,0,0,0,0,0,0,0,0,100
b40e4308e2393c5643b0b91dbe5cb4748008cbec,9,239,125,114,2,0,2,1,8,81,1,6,2.522882923,829,92,12,145,137,8,5812,5401,411,72,69,3,99.7104806
90e4f03f5fe82272a9b78212fdfe8e0a3992644b,1,4,2,2,0,0,0,1,4,0,1,1,0,160,93,13,32,32,0,1247,1213,34,8,8,0,100
8fa47070b47a2937df336dab81b6304c64fc2075,1,2,0,2,0,0,0,4,9,77,1,1,0,148,94,13,23,23,0,835,824,11,10,10,0,100
f42c954c2c542d1a56b16acd5afa9cca31c9158a,2,3,1,2,0,0,0,1,9,14,1,2,1,268,95,12,48,48,0,1535,1518,17,38,38,0,100
0427123769d42281f55dcc4eab6c70cb1826811e,0,0,0,0,0,0,0,0,0,0,0,0,0,0,96,12,0,0,0,0,0,0,0,0,0,100
3d94a764c4365721bc66bacb5e7cd77b4a964c65,6,104,28,76,1,0,1,1,11,117,1,5,1.929450659,583,97,13,87,77,10,3709,3337,372,36,32,4,99.53917051
1591731f3f42667314b3a8f3205c6849ebf00a30,1,53,0,53,1,0,1,1,1,0,1,1,0,0,98,14,1,0,1,458,0,458,1,0,1,99.65537048
5c65bdf43a55165b8cf7611b8f5adc7c53ec305f,1,3,2,1,0,0,0,1,4,37,1,1,0,131,99,15,23,22,1,903,881,22,6,6,0,100
7843c474dd7d27fc5af3da305e86db99432dd2e6,11,20,20,0,0,0,0,2,24,137,1,7,2.753055907,1934,100,16,307,308,1,10936,10947,11,120,120,0,100
2a08bbbe706c16cb9e187ab08733fb6bf8e698bd,1,1,1,0,0,0,0,1,2,4,1,1,0,62,101,16,2,2,0,396,396,0,1,1,0,100
e30f9df7524d956b0879da1a524157c70609fb3f,0,0,0,0,0,0,0,0,0,0,0,0,0,0,102,17,0,0,0,0,0,0,0,0,0,100
5d6a3a880c15a3dc9314ea837d46cb7bce16c114,4,368,186,182,1,0,1,1,2,75,1,2,1.536117679,377,103,9,92,45,47,3300,2611,689,37,16,21,99.82798165
f7a750bf6c9b1910561b4be33f9b0ff4dcff4335,1,0,0,0,1,0,1,1,3,0,1,1,0,0,104,10,0,0,0,0,0,0,0,0,0,99.8853211
97e80d10228abde88e0e200780e4dba25219d25d,0,0,0,0,0,0,0,0,0,0,0,0,0,0,105,10,0,0,0,0,0,0,0,0,0,100
4516b9962b523e6555f7ef2c197d9ce917fc1258,0,0,0,0,0,0,0,0,0,0,0,0,0,0,106,11,0,0,0,0,0,0,0,0,0,100
bd6a44eaaed526a735f83c85f72fe48ee8699db3,10,73,83,10,0,0,0,3,15,120,1,5,2.939200051,1290,107,12,168,171,3,7519,7609,90,61,62,1,99.71297359
32c7978186c70d79eba1069a72a6e3b71f52e87a,0,0,0,0,0,0,0,0,0,0,0,0,0,0,108,13,0,0,0,0,0,0,0,0,0,100
9487dcd6f882386c6f22de6d35f27c2ca303b9e5,0,0,0,0,0,0,0,0,0,0,0,0,0,0,109,14,0,0,0,0,0,0,0,0,0,100
ea23d2cad28ab2258e4b16a9331df9a190af308d,1,0,0,0,0,0,0,1,1,0,1,1,0,71,110,15,12,12,0,318,318,0,8,8,0,99.77037887
8b9ddfafbc9528e03e767dfb9ebbfe7877b2e8b5,3,30,23,7,0,0,0,2,5,82,1,3,1.252849227,235,111,16,29,28,1,1687,1655,32,10,10,0,100
386af6a7b811e4e450582b400c33afc279d6b33e,7,112,67,45,0,0,0,2,9,175,1,5,1.642578022,931,112,17,109,103,6,6468,6239,229,39,34,5,100
3a4b78ba927aacd991dfde69e09437b2c937f1a2,0,0,0,0,0,0,0,0,0,0,0,0,0,0,214,0,0,0,0,0,0,0,0,0,0,100
68eb76dbc9e82e01ec83a7ae17a91ac353df1270,1,5,0,5,0,0,0,3,12,30,1,1,0,425,215,1,69,69,0,2548,2527,21,19,19,0,100
fcd11ec104fafbc938759eb45de36d4d08f09fb5,5,42,28,14,0,0,0,3,11,214,1,3,1.796948568,679,113,10,103,101,2,4110,4084,26,41,40,1,100
0834e1ff86416f3a3571839bb038345e5f63f656,9,539,57,482,3,0,3,1,13,94,1,6,2.121226347,492,114,11,115,61,54,6075,3253,2822,45,23,22,99.54259577
4ddb24a274da37cf9d741378c34712e0e49d8be3,1,0,0,0,1,0,1,2,5,0,1,1,0,0,115,12,0,0,0,0,0,0,0,0,0,99.88597491
708a4d8f443b94bacb27a8ddff2763bb6dcd1408,1,14,8,6,0,0,0,3,5,344,1,1,0,54,216,2,8,8,0,470,434,36,2,2,0,100
bed4cb09b521de2eab11147eedbbce79effb5b54,2,51,22,29,0,0,0,1,14,20,1,1,0.40985537,362,116,3,68,62,6,2547,2337,210,29,27,2,100
a0f20ccc1577ae43d209c96e80247e0e89d64a1d,1,11,3,8,0,0,0,1,6,28,1,1,0,162,117,4,32,32,0,1341,1247,94,8,8,0,100
cf39bc61e92f8baba382549b2447b187354be6c9,24,1274,158,1116,5,0,5,1,25,158,1,10,3.408488164,2605,118,5,469,341,128,22797,16217,6580,172,123,49,97.38041002
353ae815bfa13e0857a05b744542e765ab957f79,2,76,34,42,0,0,0,3,13,293,1,1,0.62109937,475,217,1,78,76,2,2931,2789,142,23,21,2,100
4e51c8387d406703c56c1bc2c4975e4bb0f713eb,0,0,0,0,0,0,0,0,0,0,0,0,0,0,218,2,0,0,0,0,0,0,0,0,0,100
56142fa4c34a42724e0eab0c3f5ab3a007956d35,12,2478,0,2478,12,0,12,1,1,0,1,2,2.958080302,0,119,2,233,0,233,15661,0,15661,53,0,53,94.74292317
d85741ccf581b688a0dc11131ff4a08f08e9a467,5,261,151,110,1,0,1,4,16,173,1,2,1.508205571,546,120,1,85,74,11,3692,3260,432,30,22,8,99.47214076
24e806b0b4a7727b8d16771c17a1247f4bd144f7,1,65,61,4,0,0,0,5,14,45,1,1,0,249,121,2,32,32,0,1612,1573,39,9,9,0,100
a3e637de373e015f5193df23746f62a5a2123e94,2,256,0,256,2,0,2,1,1,0,1,2,0.942163169,0,122,2,23,0,23,1478,0,1478,7,0,7,99.59136019
f7db45fac182b5611d0d568fecd15b43171b2348,2,11,3,8,0,0,0,1,15,94,1,1,0.371232327,387,123,1,69,68,1,2595,2547,48,29,29,0,100
0b6e2400abb31223d33c0bf0a9e775992b311307,3,29,2,27,0,0,0,1,7,151,1,2,1.398715359,332,124,2,61,57,4,2530,2393,137,20,17,3,100
0f06f9c395144a65d5002cc6f99536a19b48f051,0,0,0,0,0,0,0,0,0,0,0,0,0,0,125,3,0,0,0,0,0,0,0,0,0,100
fcf31b5788043680812462e40092a5331c6e3b71,13,234,111,123,1,0,1,2,26,96,1,8,2.716292416,2230,126,4,316,305,11,15704,14899,805,116,114,2,97.05228031
bf82cc5dd88043d236bed2131b407acc44341196,0,0,0,0,0,0,0,0,0,0,0,0,0,0,127,5,0,0,0,0,0,0,0,0,0,100
b05675b59b9d29fa65e15ee77f4affcb94b6f979,1,4,1,3,0,0,0,2,6,116,1,1,0,91,128,6,9,9,0,625,600,25,3,3,0,100
9561d1691b990af42b0b0ea1e91d7faffddd13b2,1,7,5,2,0,0,0,2,7,12,1,1,0,94,129,6,9,9,0,644,625,19,3,3,0,100
67dd53f8d89971d195982565d71e9a749924e588,0,0,0,0,0,0,0,0,0,0,0,0,0,0,130,6,0,0,0,0,0,0,0,0,0,100
2b5ed0dbdcb907aed038a21baf437f63075b3358,0,0,0,0,0,0,0,0,0,0,0,0,0,0,131,4,0,0,0,0,0,0,0,0,0,100
5378b6e1633189433095977d45a989a4588ff9b7,2,0,0,0,2,0,2,2,4,681,1,2,0,0,132,5,0,0,0,0,0,0,0,0,0,99.78655283
432c0a1968ed65c574a9463ff9d9b1b1374bb507,0,0,0,0,0,0,0,0,0,0,0,0,0,0,133,6,0,0,0,0,0,0,0,0,0,100
e055a848c97752db6160bc1e9bb63de70216f01a,52,869,10,859,0,0,0,2,11,467,2,30,5.699116587,3292,134,7,445,447,2,26023,26055,32,140,141,1,100
75dc8d82166d4673655a81a0816d9f515d28569c,0,0,0,0,0,0,0,0,0,0,0,0,0,0,135,8,0,0,0,0,0,0,0,0,0,100
76f36ef00a73ae74619121f3ead9a14c028e066c,0,0,0,0,0,0,0,0,0,0,0,0,0,0,136,9,0,0,0,0,0,0,0,0,0,100
5cde5527ddcdd2deed8d5715122b89674f36ebe7,0,0,0,0,0,0,0,0,0,0,0,0,0,0,137,10,0,0,0,0,0,0,0,0,0,100
90d0fad0c9c6f3a86840c15613010e67f32cbe8c,0,0,0,0,0,0,0,0,0,0,0,0,0,0,138,11,0,0,0,0,0,0,0,0,0,100
bfcef3bc25f5bf056e21be0da50d95169e23a8d6,1,0,1,1,0,0,0,1,4,187,1,1,0,95,139,12,8,8,0,646,659,13,4,4,0,100
c29545d4b3b5ccc5ccc2cdbf64329f98d5f2e345,2,35,1,34,0,0,0,4,16,273,2,2,0.997772472,615,140,13,134,134,0,3961,3961,0,51,51,0,100
7f376d63163b71160cdf0deda6be2ca236f23f34,0,0,0,0,0,0,0,0,0,0,0,0,0,0,141,13,0,0,0,0,0,0,0,0,0,100
af9580ea3b848c3476bb90ae19ef0d5649aab3ed,1,1,1,0,0,0,0,1,6,152,1,1,0,189,142,14,29,29,0,1069,1069,0,12,12,0,100
a08ab4a4bed5438ccbd4f5196d6aafd642bb5bc5,2,53,14,39,0,0,0,1,7,150,1,2,0.913240161,276,143,13,33,30,3,2178,1815,363,13,13,0,100
6090d1386476315011717889dccf0e91f8d2acc0,1,5,2,3,0,0,0,1,8,2,1,1,0,207,144,14,34,32,2,1254,1236,18,12,12,0,100
af10f155fec83e8526d8d39b39e9542cc8aaedce,2,37,1,36,0,0,0,2,13,358,1,2,0.831474388,337,145,15,57,54,3,2344,2089,255,15,14,1,100
a703b056f4a7a5937b91a732d5d50a99d7f20c7c,2,9,4,5,0,0,0,4,12,377,1,2,0.961236605,257,146,13,38,37,1,1429,1390,39,17,17,0,100
3ca24f4c761fc5b49e18a153732d32b22c7b3bd9,9,17,29,12,0,0,0,2,10,265,1,5,2.359455977,1032,147,14,133,135,2,6792,6829,37,56,58,2,100
9b5ee68ad918beb384a2a161853f74354cad98a7,1,3,3,0,0,0,0,1,2,152,1,1,0,193,148,7,20,20,0,1623,1623,0,2,2,0,100
09980b1f14fc6aa982780898202441a5cc90c1ac,1,2,2,0,0,0,0,3,4,731,1,1,0,104,149,7,14,14,0,633,628,5,4,4,0,100
20324a24788f50060b87b2a0e61f9eb312fd74ac,0,0,0,0,0,0,0,0,0,0,0,0,0,0,150,8,0,0,0,0,0,0,0,0,0,100
1e44eb9a0af3311d2f3175536893ebbedf422fd5,2,6,8,2,0,0,0,3,27,119,1,2,1,611,151,2,93,94,1,3913,3904,9,30,30,0,100
8b2cb6da1b0818baad3a239e1609738573e69e7d,25,2288,8,2280,23,0,23,1,8,25,1,6,4.407919586,114,219,0,320,13,307,14526,546,13980,179,6,173,96.21848739
9c2b28a0076f4bf298446a8a354969d5d9170a17,0,0,0,0,0,0,0,0,0,0,0,0,0,0,220,1,0,0,0,0,0,0,0,0,0,100
bd75467b6591c2fedd4fbd6cf62a14736aa4da89,16,49,37,12,0,0,0,1,28,150,1,9,3.753283503,2405,152,1,287,284,3,16786,16686,100,98,96,2,100
bc010859e6eedd1baee1358d139c67f47c57f32b,1,3,3,0,0,0,0,4,15,8,1,1,0,240,153,2,49,49,0,1535,1535,0,12,12,0,100
87eda65ebdb5ee703285ca9a5725aca017a25906,20,258,113,145,3,0,3,1,29,139,1,8,3.423596861,2105,154,3,270,251,19,14265,13512,753,129,115,14,97.46772592
42080a1bbf37859542651f68bcfb8753389c8edc,1,61,0,61,1,0,1,1,1,0,1,1,0,0,155,4,3,0,3,393,0,393,2,0,2,99.90439771
edbf7bbdada2567b5f4e665193c5fdaf0a7d6c5e,0,0,0,0,0,0,0,0,0,0,0,0,0,0,156,5,0,0,0,0,0,0,0,0,0,100
562aadd731387aca708683e08f424d0dbefac5ca,0,0,0,0,0,0,0,0,0,0,0,0,0,0,157,6,0,0,0,0,0,0,0,0,0,100
10db82b742bc36a13785ef978bb9d8b4a4e23e0b,1,139,0,139,1,0,1,1,1,0,1,1,0,0,221,2,17,0,17,885,0,885,3,0,3,99.28057554
0e5d2b8c7c1e678c5476d0057c8c3b4a41aa0539,0,0,0,0,0,0,0,0,0,0,0,0,0,0,222,3,0,0,0,0,0,0,0,0,0,100
5e7999d5de2ef37c8f92fb3d47020353a63cd283,4,13,7,6,0,0,0,3,17,184,1,4,1.319035274,705,158,6,110,110,0,4185,4132,53,35,35,0,100
7e603f74cf83a4c35fe4f8f432de0c72a98da99c,1,10,6,4,0,0,0,4,16,24,1,1,0,240,159,7,50,49,1,1582,1535,47,12,12,0,100
f0a6f489d4aaeb2d4622d0fd737b0b12d88fec57,1,1,1,0,0,0,0,4,4,830,1,1,0,79,223,2,11,11,0,435,435,0,4,4,0,100
dc74f226cf092455988afb7bc141059a1b97300b,0,0,0,0,0,0,0,0,0,0,0,0,0,0,224,3,0,0,0,0,0,0,0,0,0,100
4b3fe7e5e6d2455ee139375d9dbba4e945ac88c3,0,0,0,0,0,0,0,0,0,0,0,0,0,0,225,4,0,0,0,0,0,0,0,0,0,100
e5a48a671ee2452e6401d55e696eb1ea723d6778,1,19,9,10,0,0,0,1,2,17,1,1,0,126,226,5,26,17,9,1011,885,126,3,3,0,100
dff2be81f0a902d95ea536a2b2c5b7146dbf94bb,0,0,0,0,0,0,0,0,0,0,0,0,0,0,160,5,0,0,0,0,0,0,0,0,0,100
149da135d2994278211502768e891ef763b28faa,2,160,0,160,2,0,2,1,1,0,1,2,0.949707472,0,161,6,14,0,14,706,0,706,9,0,9,99.7597309
c455de21d2b73afa1afd356bf79175fcda4179b2,3,25,11,14,0,0,0,1,9,433,1,1,1.369471138,334,162,7,56,54,2,1866,1823,43,23,22,1,96.61102681
7969856200ab4ca3e571c338b9535c6f8e0c332f,16,309,61,248,2,0,2,3,30,65,1,7,2.573713144,1728,163,5,272,248,24,12106,10617,1489,117,106,11,99.62586852
860a9d2d849a0484a60f09324231de8019983f1b,9,169,20,149,0,0,0,1,18,28,1,3,2.501998828,834,164,6,137,128,9,5471,5063,408,52,49,3,98.00734137
3f52b24fae247c637c8bbc0b66915aa6f480172d,0,0,0,0,0,0,0,0,0,0,0,0,0,0,227,6,0,0,0,0,0,0,0,0,0,100
f80ae2a2b6e347de9084df81e68faa19ef29c977,0,0,0,0,0,0,0,0,0,0,0,0,0,0,228,7,0,0,0,0,0,0,0,0,0,100
656962354f4526276d39cb7a95804900aa5aa17a,0,0,0,0,0,0,0,0,0,0,0,0,0,0,229,8,0,0,0,0,0,0,0,0,0,100
8cd395c5ef910b0aab271c249efb5af01732109e,3,69,11,58,0,0,0,1,2,66,1,2,0.784961835,409,230,9,90,76,14,3310,2937,373,39,35,4,100
35590d22ac92c103695af8616e7b9002ac92dd75,0,0,0,0,0,0,0,0,0,0,0,0,0,0,231,10,0,0,0,0,0,0,0,0,0,100
a4fd7c95c21d94f2f2a0367bf063db30ab5863f0,3,104,9,95,1,0,1,1,17,24,1,3,0.659502856,303,165,7,41,34,7,2316,1876,440,14,11,3,97.77086573
6f7a4bc87390bdf660e18983f73516762fd20c15,1,2,1,1,0,0,0,1,2,76,1,1,0,157,232,9,32,32,0,1086,1076,10,20,20,0,100
716f288a308508e1f3f391a44e60c49dc27b333f,7,521,2,519,5,0,5,1,18,7,1,6,2.253081769,462,233,6,110,66,44,5312,2844,2468,40,21,19,96.02615694
ca622124c1491475cbe90c45cdc4bc58a61e53c4,5,85,0,85,0,0,0,1,2,90,1,1,2.321928095,329,234,7,40,40,0,2702,2702,0,18,18,0,100
46e1066b8d0e8bb1f1a3a349aa09fee06b2d3cd4,0,0,0,0,0,0,0,0,0,0,0,0,0,0,235,8,0,0,0,0,0,0,0,0,0,100
353665b27078167f95cc74cd862997f81ada55c8,2,55,11,44,0,0,0,5,19,15,1,2,0.745517843,328,166,6,43,39,4,2267,2047,220,13,12,1,100
9e337cbb3ed51ae653b0ba557218ef51f91f12fd,1,0,1,1,0,0,0,1,2,10,1,1,0,87,236,9,9,9,0,547,562,15,1,1,0,100
e4de5f97b2ae1df9effa200ab095303fbed060ec,14,48,172,124,0,0,0,1,31,78,1,6,3.564075066,2071,167,4,286,310,24,11732,12061,329,113,131,18,96.33507853
1f7bfe5937d7043923f2fe99c055ad335ccf4a6a,11,46,23,23,0,0,0,2,32,95,1,4,2.865680455,1784,168,5,294,289,5,10367,10250,117,94,92,2,99.95335821
910e54cc399b7c0ffc0cabe133dce963f90d1289,6,16,8,8,0,0,0,1,21,86,1,3,2.479573959,718,169,0,118,117,1,3934,3860,74,35,35,0,100
b9733d8ea1560ddff72ed75b7996e0daad1cc02f,4,260,65,195,2,0,2,1,4,53,1,2,1.824266794,137,170,1,38,16,22,1859,852,1007,15,8,7,97.40980574
24167015776628096dc2e2e70b8d9b4fc00cd20d,1,0,1,1,0,0,0,1,2,0,1,1,0,91,171,2,5,5,0,660,660,0,4,4,0,100
c60abb51f453d461ddf72ed9e96050388383ab2c,1,5,5,0,0,0,0,4,15,47,1,1,0,141,172,3,20,21,1,794,795,1,8,8,0,100
258d4843d385200417610b596fc9186e59b4cddb,4,34,17,17,0,0,0,4,33,81,1,3,1.764522402,988,173,4,181,174,7,6217,6079,138,58,57,1,100
3a3a5be75cbd939c963f828c6f5a751802b15b12,3,36,9,27,0,0,0,3,7,750,1,2,1.214508943,522,237,0,85,81,4,3761,3511,250,30,29,1,99.67904631
6e4e6d5403ea6adafd091be1f4377a9c3b199e1a,2,262,0,262,2,0,2,1,1,0,1,2,0.97356684,0,174,5,17,0,17,1584,0,1584,7,0,7,99.67992684
c32be79a0185045a7c991e53b58ad60a669e1a67,1,4,1,3,0,0,0,1,3,332,1,1,0,89,175,1,8,7,1,663,630,33,4,4,0,100
4aa40f484dcbc570ac143954c3904217d5913fbe,0,0,0,0,0,0,0,0,0,0,0,0,0,0,176,2,0,0,0,0,0,0,0,0,0,100
644a1ca87efebbbf29345426e19b5b566d561204,1,25,7,18,0,0,0,1,8,375,1,1,0,174,177,3,37,33,4,1439,1366,73,11,8,3,100
520ba88bdfbb0874eb14699e8c8b0ee4a59ba8e4,0,0,0,0,0,0,0,0,0,0,0,0,0,0,178,3,0,0,0,0,0,0,0,0,0,100
00dd6c58658cf819692b72288afbcfcf2deeff5e,2,123,24,99,0,0,0,2,10,150,1,2,0.990331037,200,179,4,28,24,4,1750,1149,601,10,9,1,100
2e41cd6d5f3903e4497ac21f4a231c017ac930bf,0,0,0,0,0,0,0,0,0,0,0,0,0,0,180,5,0,0,0,0,0,0,0,0,0,100
67d6c96b5e1d4e57e6abd8512e0e9dd7f95d906c,0,0,0,0,0,0,0,0,0,0,0,0,0,0,238,0,0,0,0,0,0,0,0,0,0,100
1b0cf4be62f1ef6d537aa8d96cb88972f5a1af95,0,0,0,0,0,0,0,0,0,0,0,0,0,0,239,1,0,0,0,0,0,0,0,0,0,100
343e58ad824809d5bdedec6e56c707648dc3a245,1,6,1,5,0,0,0,1,2,75,1,1,0,80,181,6,3,2,1,671,634,37,1,1,0,100
1b8d13b13dff3aa09cbf67ff36f092b098beacd9,1,1,1,0,0,0,0,1,2,170,1,1,0,57,240,2,5,5,0,350,346,4,1,1,0,100
7b70a81bc6b8b27d4d3d38d3ae680e451b870fd6,0,0,0,0,0,0,0,0,0,0,0,0,0,0,241,3,0,0,0,0,0,0,0,0,0,100
cb65e137bc21349dbac77bcf4916420003bc8b73,0,0,0,0,0,0,0,0,0,0,0,0,0,0,242,2,0,0,0,0,0,0,0,0,0,100
2ea4802906565169309a54d56dda7b56b0545c82,1,4,4,0,0,0,0,3,6,782,1,1,0,207,182,0,28,28,0,1577,1577,0,6,6,0,100
38a7d0436cb2ddb102f430ec42fcc0695a9836de,1,1,1,0,0,0,0,5,11,378,1,1,0,206,183,1,43,43,0,1155,1155,0,34,34,0,100
819bfe1bbe73d7065e7cc3e9ffc61eb4487bf89c,1,1,1,0,0,0,0,5,12,2,1,1,0,206,184,2,43,43,0,1155,1155,0,34,34,0,100
b1975208c62d0106e6a2c529c59125620724c788,1,1,1,0,0,0,0,1,7,216,1,1,0,150,185,3,19,19,0,855,855,0,10,10,0,100
d62de2dc96c713ffa3fec58f3bf32a10d1c9da85,0,0,0,0,0,0,0,0,0,0,0,0,0,0,186,4,0,0,0,0,0,0,0,0,0,100
f8aad3d8278a19cb97251a4d03476624ebfbfeb5,1,1,1,0,0,0,0,5,13,18,1,1,0,206,187,5,43,43,0,1155,1155,0,34,34,0,100
b11ea41bbeb11a5579fb494cd732027636918360,3,8,7,1,0,0,0,2,2,324,1,3,1.241946032,263,188,6,35,35,0,1837,1835,2,19,20,1,99.6803653
263ce0b2a1df27f171d45f6cfcb6fe93ab68e11d,3,17,15,2,0,0,0,1,4,215,1,3,0.534954723,282,189,7,24,25,1,1827,1828,1,16,16,0,100
b8d6c293014c0208dd89120c583293c2205fb71b,5,9,9,0,0,0,0,1,6,707,1,4,1.879964949,1245,243,0,173,173,0,8753,8745,8,69,69,0,100
9809301df3cd4170d4baa94f8e38ccf49bb38db8,0,0,0,0,0,0,0,0,0,0,0,0,0,0,244,1,0,0,0,0,0,0,0,0,0,100
eba0e28fddad91bbdb62fa7a73aafe9a0ad5ef47,0,0,0,0,0,0,0,0,0,0,0,0,0,0,190,8,0,0,0,0,0,0,0,0,0,100
4c132ca62db05b3242cc342fb0367e1178df32ba,3,233,2,231,2,0,2,1,12,197,1,3,0.913694641,104,191,9,43,15,28,1985,840,1145,12,1,11,99.77200182
a639406be2d1796d637e3eba97ebf5855f5b3401,0,0,0,0,0,0,0,0,0,0,0,0,0,0,192,7,0,0,0,0,0,0,0,0,0,100
d4090b2f0f72241499ace60673b0d87d8b4e8026,0,0,0,0,0,0,0,0,0,0,0,0,0,0,245,2,0,0,0,0,0,0,0,0,0,100
90a98b9b110508da9301f58fcaa42f1270b5d580,0,0,0,0,0,0,0,0,0,0,0,0,0,0,246,3,0,0,0,0,0,0,0,0,0,100
0792516406b8389411121ee4c272ec8a8ec9b0a1,14,252,0,252,0,0,0,2,3,298,1,2,3.807354922,1318,193,4,244,244,0,9214,9214,0,140,140,0,100
1a206185ee4a66209a160172f45ea16b71437fc4,0,0,0,0,0,0,0,0,0,0,0,0,0,0,247,4,0,0,0,0,0,0,0,0,0,100
77204ebd2dee850325e1ef9fd0227798faf517c2,0,0,0,0,0,0,0,0,0,0,0,0,0,0,248,5,0,0,0,0,0,0,0,0,0,100
0e12f7a78d2a36d8387e551f23f8981fc326a1af,0,0,0,0,0,0,0,0,0,0,0,0,0,0,249,6,0,0,0,0,0,0,0,0,0,100
d8f6337b3e33829e09393640d0724127dc1270c2,1,1,1,0,0,0,0,1,5,398,1,1,0,105,194,1,1,1,0,950,942,8,1,1,0,100
8cf7cc363dc37c15c3a7516ef5d5be8e7f9b8468,1,1,0,1,0,0,0,2,11,310,1,1,0,210,195,2,34,34,0,1261,1255,6,12,12,0,100
c7cd3125df075a4d055085f5892aec7af07ca325,1,1,1,0,0,0,0,1,7,71,1,1,0,181,250,3,31,31,0,1271,1269,2,11,11,0,100
be00020cdd37697737a3577a7e1e2a9c5e383509,0,0,0,0,0,0,0,0,0,0,0,0,0,0,251,4,0,0,0,0,0,0,0,0,0,100
bfa87bd024a862adb00f1131a990a3443d197dbf,7,1000,0,1000,6,0,6,1,4,78,1,3,2.383123227,57,196,2,98,4,94,4470,291,4179,34,2,32,98.15059445
1d960075adf7b373a4461712f044a9289977ba6d,1,8,0,8,0,0,0,4,8,266,1,1,0,194,197,3,23,22,1,1536,1501,35,8,7,1,100
2b024d1d022f288c872c6c51568c243b31255a82,2,267,4,263,1,0,1,1,5,2,1,2,0.978192801,57,252,2,25,4,21,1538,291,1247,15,2,13,99.91474851
55c4da20d1e67666df1feb8f2c4acac3d4df9ec9,7,283,30,253,4,0,4,1,8,37,1,4,2.553832453,436,253,3,78,59,19,4200,3088,1112,28,17,11,99.44868533
5e0ac13759223b5f1eda05614686283ef3f036cc,1,3,2,1,0,0,0,2,6,39,1,1,0,105,254,4,1,1,0,962,950,12,1,1,0,100
53d99fd1de2cf2cf01dbbc75761426ff5ef74abc,0,0,0,0,0,0,0,0,0,0,0,0,0,0,255,5,0,0,0,0,0,0,0,0,0,100
ce054e528eaf5bbba39b4876ea546396b7aa3f7e,0,0,0,0,0,0,0,0,0,0,0,0,0,0,198,2,0,0,0,0,0,0,0,0,0,100
052ecf7b0b4c67c9def1473502ad2f9fec88edc7,1,252,0,252,1,0,1,1,1,0,1,1,0,0,199,3,31,0,31,1138,0,1138,9,0,9,99.91561181
fae6487a1b7ea8177fdd585004409a5d88da99da,1,26,3,23,0,0,0,1,2,272,1,1,0,125,200,4,18,15,3,1086,950,136,6,6,0,100
9433debb20a768edddd6b964862c1c07449c9bd4,6,227,12,215,4,0,4,1,9,208,1,5,2.426555215,258,201,5,37,30,7,2747,1798,949,16,11,5,99.62184874
ba80edd1bde19fb0fc5c25617818aef8d0b59305,2,10,10,0,0,0,0,2,6,14,1,2,0.992774454,232,202,6,26,25,1,1556,1538,18,16,15,1,100
4b31347102384354ba10bf29e470155c49b9ddaa,3,272,12,260,2,0,2,1,3,309,1,3,1.535827967,153,203,7,45,26,19,2431,917,1514,10,6,4,98.60505667
6bb6414850f4400be3a5daaf4523d493b796e890,0,0,0,0,0,0,0,0,0,0,0,0,0,0,204,8,0,0,0,0,0,0,0,0,0,100
d1d2a1ea43164a9c5250ba64685164e7f441bcca,1,5,1,4,0,0,0,4,10,63,1,1,0,204,256,0,23,23,0,1620,1581,39,8,8,0,100
979ab883f6c74d8613c191d447abe9f780561849,1,2,0,2,0,0,0,1,8,1080,1,1,0,549,257,0,85,84,1,4184,4168,16,8,8,0,100
72c2f249518324998311da873494e719502635cc,2,45,0,45,0,0,0,3,7,1197,1,2,0.99964375,317,258,1,67,59,8,2121,1899,222,15,15,0,100
477c3185855934a354862ef6e78bc9fccd49e9ef,0,0,0,0,0,0,0,0,0,0,0,0,0,0,259,2,0,0,0,0,0,0,0,0,0,100
aef4a983b2d22b0c298bdeb5c294f71e8103da4c,0,0,0,0,0,0,0,0,0,0,0,0,0,0,260,0,0,0,0,0,0,0,0,0,0,100
5f8ee534ea4891b06042af11d3d30eb9d2f2793e,0,0,0,0,0,0,0,0,0,0,0,0,0,0,261,1,0,0,0,0,0,0,0,0,0,100
24f766a4160ea9d18c78030c0d8d1e5bf0974228,1,3,3,0,0,0,0,4,7,1253,1,1,0,219,205,0,43,43,0,1464,1464,0,17,17,0,100
a93b0ba9dd2df876bc809ea6ed5f7a276f627c72,0,0,0,0,0,0,0,0,0,0,0,0,0,0,4,0,0,0,0,0,0,0,0,0,0,100
d5e0c125b4d88d7319a1d25643fa0c68b7b4abca,0,0,0,0,0,0,0,0,0,0,0,0,0,0,206,1,0,0,0,0,0,0,0,0,0,100
10e25be585bc6e9691ee54f75394c65c9145fed6,1,3,2,1,0,0,0,3,14,664,1,1,0,234,207,2,30,30,0,1571,1570,1,14,14,0,100
2056338f60a668920cb53b25aca553a1f5816005,4,17,15,2,0,0,0,1,2,264,1,2,1.702819531,644,208,3,89,89,0,3964,3959,5,30,30,0,100
2ccd071111ce0308204d774961ac82118e639113,1,16,11,5,0,0,0,5,20,605,1,1,0,253,209,4,35,33,2,1637,1599,38,10,10,0,100
d2a68bb26c83573215a39dc0044eed69052f40c0,7,386,349,37,2,0,2,2,4,730,1,4,1.981753508,862,210,4,86,82,4,5665,5457,208,31,22,9,99.7277677
7d2427371a8573e48f69bca394cfa2272956a36e,1,29,2,27,0,0,0,3,15,576,1,1,0,227,211,5,46,38,8,1431,1252,179,11,11,0,100
8e152c790d39cc18a7fa92ec5595378249c1bdaf,0,0,0,0,0,0,0,0,0,0,0,0,0,0,212,2,0,0,0,0,0,0,0,0,0,100
e8e68abef25f4e717fad436e68f04678e13690cd,0,0,0,0,0,0,0,0,0,0,0,0,0,0,213,3,0,0,0,0,0,0,0,0,0,100
2943208d30d63e10806577dd2ba70f2c62c3d7f6,1,1,2,1,0,0,0,2,3,76,1,1,0,199,262,0,38,39,1,1164,1172,8,8,8,0,100
89e2ff659389bd204c13f001ec0fe8ac006b5b46,0,0,0,0,0,0,0,0,0,0,0,0,0,0,263,1,0,0,0,0,0,0,0,0,0,100
2c279f771714f497cb54be78c48b876e3c1c5ef6,2,26,1,25,0,0,0,1,3,78,1,2,0.691289869,325,214,2,45,43,2,2206,2069,137,16,15,1,100
dbd23ed80a0ea6288dedf950c29d6a6cbb553832,22,805,23,782,7,0,7,1,10,845,1,6,3.361874395,1850,264,2,355,282,73,17653,13122,4531,102,72,30,98.25347067
92d8e0bed05782fe5073521bb9b1e928a961b6ef,1,48,13,35,0,0,0,3,4,70,1,1,0,198,0,0,47,38,9,1362,1164,198,9,8,1,100
9348f33a279a96e84135e484f0d1af8cf122ba90,0,0,0,0,0,0,0,0,0,0,0,0,0,0,265,0,0,0,0,0,0,0,0,0,0,100
670e398d7f72bd97a42efc540ce8fef7a9a80f11,2,15,2,13,0,0,0,1,9,334,1,2,0.997502546,763,266,1,123,122,1,5777,5724,53,20,20,0,100
9ad913421c852240beefeb2cb2723632d1fedee1,0,0,0,0,0,0,0,0,0,0,0,0,0,0,267,2,0,0,0,0,0,0,0,0,0,100
148faca4f67107b735092554cc2d30c29ba5250f,1,4,2,2,0,0,0,3,5,11,1,1,0,228,1,1,47,47,0,1371,1362,9,9,9,0,100
1bd9156128428f65629b72d6f411eca006c63618,0,0,0,0,0,0,0,0,0,0,0,0,0,0,268,3,0,0,0,0,0,0,0,0,0,100
b20d89df647db092760503dd16d17a29b953bea9,5,1227,4,1223,4,0,4,1,34,145,1,5,2.095723731,501,2,2,217,92,125,8698,3167,5531,98,31,67,99.55908289
755d209dc513fd4dcc8e69dd33fcabe26a357505,3,349,0,349,3,0,3,1,1,0,1,2,1.566882777,0,269,1,21,0,21,2147,0,2147,7,0,7,99.47252747
fa39654d05d0c43f81928340b132f57f55eb091c,2,11,7,4,0,0,0,1,2,108,1,1,0.503258335,246,270,2,35,35,0,1705,1706,1,13,13,0,100
6b7cd604b5c8c68fb30e6b8e5a7de5c1e5bb8a55,0,0,0,0,0,0,0,0,0,0,0,0,0,0,271,3,0,0,0,0,0,0,0,0,0,100
67b9b1f997b611ee06bd726b665406a86a2a2362,0,0,0,0,0,0,0,0,0,0,0,0,0,0,272,4,0,0,0,0,0,0,0,0,0,100
2235e80c06adb5fc7704838b437ad2a584a723d8,0,0,0,0,0,0,0,0,0,0,0,0,0,0,273,5,0,0,0,0,0,0,0,0,0,100
efa28f8ef0cd1b3acda43610cc074e77499424b8,3,41,3,38,0,0,0,4,35,539,1,3,1.584211465,738,215,0,128,124,4,5106,4854,252,39,37,2,100
6ac196941e0586ca0d33ebc78171f63951e981ea,0,0,0,0,0,0,0,0,0,0,0,0,0,0,216,1,0,0,0,0,0,0,0,0,0,100
82127d543e70216a60b3e2d2f0f06ba9f6d3166e,2,113,6,107,1,0,1,2,5,313,1,1,0.569527391,84,274,0,18,10,8,955,407,548,9,5,4,98.35042354
ad5f21367500171f9e5e7d184ec33e907636145f,4,435,23,412,3,0,3,1,14,303,1,4,1.745273652,439,275,1,120,70,50,5746,2648,3098,36,20,16,99.68468468
2b9df02589f7bceecc75e81ef7098aa9979c3d04,1,69,69,0,0,0,0,1,2,170,1,1,0,96,276,2,0,8,8,222,674,452,0,4,4,100
436613ef220937aba88a03102760fe6e530dc7c4,1,66,0,66,1,0,1,1,1,0,1,1,0,0,277,3,2,0,2,284,0,284,2,0,2,98.36283186
837b816d414bd5ff1764804e078827900c9d5815,4,50,23,27,0,0,0,2,10,478,1,3,1.812056127,792,3,0,136,130,6,5573,5423,150,43,43,0,100
2df1b2603401db1b2750f4f06a4c92dfea862d3c,1,8,4,4,0,0,0,2,10,762,1,1,0,110,217,1,18,17,1,610,592,18,7,6,1,100
0c3204875e0a4adcc9e54654caa7dbc5c8e37c0e,2,3,9,6,0,0,0,3,15,649,1,2,0.650022422,407,218,1,55,56,1,2602,2622,20,22,22,0,100
5c23e06f86f75d0f4b130caa8485f5a0af3dfc6a,0,0,0,0,0,0,0,0,0,0,0,0,0,0,278,0,0,0,0,0,0,0,0,0,0,100
14637dff241da98533e86a3abd4bb0e72444c80d,0,0,0,0,0,0,0,0,0,0,0,0,0,0,279,1,0,0,0,0,0,0,0,0,0,100
a9b9ca8a5e4edeb7938f79db2ed206e252a00248,0,0,0,0,0,0,0,0,0,0,0,0,0,0,219,2,0,0,0,0,0,0,0,0,0,100
4e142c114bf80035ce502d5db8f0bd4989dafc08,0,0,0,0,0,0,0,0,0,0,0,0,0,0,220,3,0,0,0,0,0,0,0,0,0,100
53a554cda660028306c53c93a9e66bcefc25feb8,1,2,2,0,0,0,0,4,17,881,1,1,0,144,221,4,22,22,0,832,832,0,8,8,0,100
be528bfc3dfceb18f797c3c03d777b8cf3e8eafd,0,0,0,0,0,0,0,0,0,0,0,0,0,0,222,5,0,0,0,0,0,0,0,0,0,100
073e07477c8072fed6ea6f71eb96fbe1bff828e3,3,209,42,167,1,0,1,4,9,645,1,3,0.99553425,253,223,6,51,26,25,2384,1737,647,16,6,10,99.91289199
0b79057d2fd3e3d7da695be740f2f147ff5c2abd,0,0,0,0,0,0,0,0,0,0,0,0,0,0,224,7,0,0,0,0,0,0,0,0,0,100
c572f078b0a2dc68647af8ac3b44ec361cc867d3,0,0,0,0,0,0,0,0,0,0,0,0,0,0,225,8,0,0,0,0,0,0,0,0,0,100
9ca9b294a1b46069d45ae6bf2f5e2d7f61bade52,0,0,0,0,0,0,0,0,0,0,0,0,0,0,280,2,0,0,0,0,0,0,0,0,0,100
9bb9c3dc7558cf6775b0c7e6fcb25dedda718d6d,0,0,0,0,0,0,0,0,0,0,0,0,0,0,226,6,0,0,0,0,0,0,0,0,0,100
27140aea11a35a5e8089f90f68334ad17c6174d8,8,73,37,36,1,0,1,4,36,641,1,5,1.672268804,1216,281,1,170,169,1,7880,7819,61,64,64,0,99.21807124
11a2a4c6a500e7ca05fa6a18ba94be098f1cda11,0,0,0,0,0,0,0,0,0,0,0,0,0,0,282,2,0,0,0,0,0,0,0,0,0,100
f748e315ed87ff1a71c50a6c83059b4c116a4c0f,0,0,0,0,0,0,0,0,0,0,0,0,0,0,283,3,0,0,0,0,0,0,0,0,0,100
2a77d2c0d588e84fd767906a334e527d3cff37ba,0,0,0,0,0,0,0,0,0,0,0,0,0,0,284,4,0,0,0,0,0,0,0,0,0,100
13e3cbaf22d275c6b078286f88a4a810956665a2,1,3,0,3,0,0,0,2,4,696,1,1,0,226,285,5,34,33,1,1652,1627,25,8,8,0,100
20107254a979eb8031b2d0b75b66d2e5e80cfcdb,0,0,0,0,0,0,0,0,0,0,0,0,0,0,286,6,0,0,0,0,0,0,0,0,0,100
91f837bc572c2d0dd81faa55740d1be92cec7b40,1,1,1,0,0,0,0,6,21,373,1,1,0,259,4,0,35,35,0,1637,1637,0,10,10,0,100
460e3b551a7004e5c4775265d89bfda17be17358,0,0,0,0,0,0,0,0,0,0,0,0,0,0,287,7,0,0,0,0,0,0,0,0,0,100
669e345f51c01140083830fd362cb6410f54bfba,0,0,0,0,0,0,0,0,0,0,0,0,0,0,288,8,0,0,0,0,0,0,0,0,0,100
6834ceca2a20bb09c74b2cbf181b4414a1447ad8,0,0,0,0,0,0,0,0,0,0,0,0,0,0,289,9,0,0,0,0,0,0,0,0,0,100
b15cf01cc09825de23077fe8642a8bb88f09bd6d,2,63,33,30,0,0,0,6,22,535,1,2,0.757878463,447,5,1,67,64,3,2899,2793,106,19,19,0,100
779064cfbdfa17d8da065e95d9f8eb5c02d9594b,1,1,1,0,0,0,0,1,2,1086,1,1,0,59,290,10,4,4,0,313,313,0,3,3,0,100
9a8029d7dc2309f6b7ff322dea65f9f12ffdbdbc,0,0,0,0,0,0,0,0,0,0,0,0,0,0,291,11,0,0,0,0,0,0,0,0,0,100
97d356de399903e76bbb50c6606d0b0343ea3733,1,6,3,3,0,0,0,2,11,88,1,1,0,112,292,12,19,18,1,649,610,39,7,7,0,100
265f8ae69779e1bd18fa553b48a701092b2807cc,0,0,0,0,0,0,0,0,0,0,0,0,0,0,293,13,0,0,0,0,0,0,0,0,0,100
34c0f2b32c723292a434adee03bd86ee6e5cb0d4,1,17,5,12,0,0,0,1,3,183,1,1,0,54,294,14,5,5,0,381,324,57,4,4,0,100
cd1356082d9f2e7024a340210c933381323d9f48,0,0,0,0,0,0,0,0,0,0,0,0,0,0,295,15,0,0,0,0,0,0,0,0,0,100
456b48275367ca0080d77dd0fd84a90722d75f4b,79,154,9470,9316,0,0,0,2,10,1392,1,11,5.748476525,9811,296,11,302,1456,1154,13647,52744,39097,139,1134,995,92.54004577
ccf177feb83a2fcbe7d6978628ef19cb2ed0c72c,1,7,8,1,0,0,0,1,2,144,1,1,0,49,297,12,7,7,0,352,350,2,4,4,0,100
82fa7ce60b5b75bdf24e209a07f5ea19f64963cf,1,22,0,22,0,0,0,4,5,1168,1,1,0,104,298,11,17,14,3,747,633,114,5,4,1,100
5173ba8693414b3d7c565c6c7a46a0c0838a96a0,0,0,0,0,0,0,0,0,0,0,0,0,0,0,299,12,0,0,0,0,0,0,0,0,0,100
e67f8a6a9be1bc42a08511ee0c547a910605f0a7,1,10,6,4,0,0,0,1,3,209,1,1,0,194,300,13,31,30,1,1402,1381,21,9,9,0,100
629597b4546e7d239c73dd464d123231f92c0900,0,0,0,0,0,0,0,0,0,0,0,0,0,0,6,0,0,0,0,0,0,0,0,0,0,100
9b4c010f66c4375186efe3f5a6adb1ab5a540887,2,49,1,48,1,0,1,1,12,22,1,1,0.795040279,115,301,5,21,19,2,725,649,76,9,7,2,99.85479187
304ad6fd4d51c69660415518b318db83ddc3c2b7,0,0,0,0,0,0,0,0,0,0,0,0,0,0,302,6,0,0,0,0,0,0,0,0,0,100
e7b6aaf33f61fc2432bc9b1684de8aaa0f423ec7,0,0,0,0,0,0,0,0,0,0,0,0,0,0,303,7,0,0,0,0,0,0,0,0,0,100
ce486baf6f8a12bf5a9a651b30aa1409a93219bb,3,38,119,81,0,0,0,2,4,1129,1,3,1.241690858,312,304,8,29,40,11,1791,2194,403,10,13,3,99.66035905
ef6459376b4468377663781fbc976d6c303b9b06,1,35,29,6,0,0,0,1,2,270,1,1,0,102,305,2,8,8,0,990,852,138,1,1,0,100
2545b4e419081b6ea9c41be1f53becf8596ad079,0,0,0,0,0,0,0,0,0,0,0,0,0,0,306,3,0,0,0,0,0,0,0,0,0,100
eb3fe876d2197addb2d9fe9347ab7c0cb8776fae,1,71,2,69,0,0,0,1,3,21,1,1,0,107,307,2,21,8,13,1747,990,757,1,1,0,100
52c2fdbca795fb2e17f52aff9e70ffb8593ba301,1,56,21,35,0,0,0,1,2,291,1,1,0,116,308,3,9,6,3,1514,918,596,2,2,0,100
20aba80f6810c96e472188d31bd0bf349b0a9435,0,0,0,0,0,0,0,0,0,0,0,0,0,0,309,4,0,0,0,0,0,0,0,0,0,100
af4ca3879c1f78dd41a51bae28949f7c482093ec,1,26,30,4,0,0,0,4,11,84,1,1,0,101,310,5,12,13,1,588,596,8,3,3,0,100
0b04c6f8e70df468f4a1b52d03a2452840cf3851,1,12,13,1,0,0,0,4,8,133,1,1,0,124,311,6,11,11,0,952,913,39,3,3,0,100
6bf1f0b825ff95d5c8279a3a7f7618b494acf088,0,0,0,0,0,0,0,0,0,0,0,0,0,0,312,0,0,0,0,0,0,0,0,0,0,100
6ed485dddb45cb5d5a711537910ae0d9eb252433,3,66,22,44,0,0,0,1,15,183,1,3,0.935471832,800,313,1,121,117,4,5996,5632,364,34,33,1,100
ca916bfe10c374d8abf45c8636e9d26a55104a11,0,0,0,0,0,0,0,0,0,0,0,0,0,0,314,2,0,0,0,0,0,0,0,0,0,100
5738aa76867b351bb77152ae4f38840691e1e180,1,2,7,5,0,0,0,3,8,922,1,1,0,229,227,0,31,32,1,1720,1755,35,7,7,0,100
8282e072b88af924a03677c3130c7b045fe7d321,0,0,0,0,0,0,0,0,0,0,0,0,0,0,315,0,0,0,0,0,0,0,0,0,0,100
34b89ecc9c6db7b008cc9fe780f5fd3e99b54ad5,0,0,0,0,0,0,0,0,0,0,0,0,0,0,316,1,0,0,0,0,0,0,0,0,0,100
d2e1fcf3cae722286f1ea0a875530af089cc8608,3,35,27,8,0,0,0,1,4,487,1,3,1.309632109,601,317,1,83,83,0,4880,4754,126,23,23,0,100
6381ad09c289094fdaf76efc456c08865a787cb0,2,328,4,324,0,0,0,3,23,1210,1,2,0.707232494,414,7,0,71,49,22,4282,2763,1519,16,12,4,100
88097a6445751ed44c61ec2e40feda31f20a4111,1,5,3,2,0,0,0,1,5,29,1,1,0,221,318,1,28,27,1,1945,1937,8,8,8,0,100
a2b8d437a7680dbdbe8e6017ba900a8eb4b0c7da,2,70,70,0,0,0,0,1,5,395,1,2,0.108023195,237,319,2,39,31,8,2094,1642,452,13,9,4,95.17384536
f489c903d78861e912465dbc6501d5fa26e24231,0,0,0,0,0,0,0,0,0,0,0,0,0,0,320,3,0,0,0,0,0,0,0,0,0,100
39c1e0065214e63d35ade3b349ba53a9c65694fd,1,2,2,0,0,0,0,1,6,35,1,1,0,223,321,3,28,28,0,1949,1945,4,8,8,0,100
982df51b1e408ad4b8b5fa487ac0d76955547dc4,1,4,2,2,0,0,0,4,12,850,1,1,0,167,322,0,25,25,0,1038,1031,7,8,8,0,100
207f8b8e86dce4e48d249edeadefb3b82df84ff7,2,23,1,22,0,0,0,3,12,1535,1,2,0.41381685,181,323,1,22,21,1,1136,1063,73,7,6,1,100
e56b2f473d431dfdddf1c2451aec338226a5aa90,1,6,5,1,0,0,0,1,7,115,1,1,0,223,324,2,28,28,0,1949,1949,0,8,8,0,100
e88f05c46ba9c9933f43f4101b09d505baa920d7,0,0,0,0,0,0,0,0,0,0,0,0,0,0,325,3,0,0,0,0,0,0,0,0,0,100
21cd19e2c8a228a6d45d4ce0388773f7362e5bb7,3,6,2,4,0,0,0,2,37,1206,1,3,1.561278124,913,326,4,149,149,0,6312,6264,48,46,46,0,100
5d66444835319f9f5c046c61412d09aa660f2469,2,193,0,193,1,0,1,1,6,100,1,2,0.04679486,199,327,0,47,31,16,2511,1420,1091,15,9,6,99.88901221
828742125479758c5f8697794849650785b9ce3f,0,0,0,0,0,0,0,0,0,0,0,0,0,0,328,1,0,0,0,0,0,0,0,0,0,100
d2d9573afa47956c487a8934f88fd494d11ade57,0,0,0,0,0,0,0,0,0,0,0,0,0,0,329,0,0,0,0,0,0,0,0,0,0,100
4ec79ec47c778ea3fa83edb59ed3c501fef7623b,392,125,669,544,1,0,1,2,7,13,1,88,2.077745203,43178,330,0,5552,4724,828,278788,174815,103973,1998,791,1207,22.15665236
e72d1b7ba948a6dab4fb6b4436567e926a4aa0db,0,0,0,0,0,0,0,0,0,0,0,0,0,0,331,1,0,0,0,0,0,0,0,0,0,100
0800322b9972f2b21a1b094896184540f82ad60a,0,0,0,0,0,0,0,0,0,0,0,0,0,0,332,2,0,0,0,0,0,0,0,0,0,100
c36ce45d084d298a92bd1d1c31d1ba7217226e4e,1,1,1,0,0,0,0,1,2,8,1,1,0,218,333,3,36,35,1,1562,1558,4,10,10,0,100
ba6e2a356d942fb78f894bf1d765a762f9ce55d2,3,3,3,0,0,0,0,1,2,18,1,3,1.584962501,766,334,4,125,125,0,5210,5207,3,36,36,0,100
7871e69c1a5d22f4b5aa05e16568256800b58f11,0,0,0,0,0,0,0,0,0,0,0,0,0,0,335,5,0,0,0,0,0,0,0,0,0,100
5d4dd27f5e79bf03251f9bfb01be44f3f7f0bedf,2,149,4,145,1,0,1,1,2,10,1,1,0.700513389,123,336,6,23,11,12,1853,952,901,8,3,5,100
3228f0a851f473393ffc0432ccb82309289dd9a5,0,0,0,0,0,0,0,0,0,0,0,0,0,0,337,7,0,0,0,0,0,0,0,0,0,100
384c41f8dcbfe57d5a87104225ed332f71268568,0,0,0,0,0,0,0,0,0,0,0,0,0,0,338,8,0,0,0,0,0,0,0,0,0,100
6e5649864dc54040e722654fab9adee69fc4b909,0,0,0,0,0,0,0,0,0,0,0,0,0,0,339,9,0,0,0,0,0,0,0,0,0,100
cac9c8f7f2cce320122bdf0234ebacab0f12ace0,0,0,0,0,0,0,0,0,0,0,0,0,0,0,340,10,0,0,0,0,0,0,0,0,0,100
19094a71dc9c32b7bad5b31fa3aeb6b0e6cbea80,0,0,0,0,0,0,0,0,0,0,0,0,0,0,341,11,0,0,0,0,0,0,0,0,0,100
be2e3a70494d935edfa8a5901ea1d169d9b71d5a,0,0,0,0,0,0,0,0,0,0,0,0,0,0,342,12,0,0,0,0,0,0,0,0,0,100
fbc7540ce49567db3cebf1f23ec7a75dabca6852,1,2,0,2,0,0,0,1,2,41,1,1,0,77,343,13,8,8,0,484,470,14,2,2,0,100
1aaf9557f873ea5c0b63d5450186077221bf9168,0,0,0,0,0,0,0,0,0,0,0,0,0,0,344,14,0,0,0,0,0,0,0,0,0,100
eeae7f0814d441b079308a41cc45b6994594bdf5,0,0,0,0,0,0,0,0,0,0,0,0,0,0,345,14,0,0,0,0,0,0,0,0,0,100
d15bb6d9bd48b5fa3e098dfc65009e5fbd2300ad,0,0,0,0,0,0,0,0,0,0,0,0,0,0,346,15,0,0,0,0,0,0,0,0,0,100
2658fc6b522d18a15f7f68349f4f52c750dcce69,0,0,0,0,0,0,0,0,0,0,0,0,0,0,347,14,0,0,0,0,0,0,0,0,0,100
08fcfcfb0be5ba47579a1ddd00945f77f2c25c81,2,4,2,2,0,0,0,1,3,49,1,2,0.918295834,141,348,14,11,11,0,956,947,9,4,4,0,100
c4cd7613ea6ad9af2b87786aee04366bf0bea479,0,0,0,0,0,0,0,0,0,0,0,0,0,0,349,12,0,0,0,0,0,0,0,0,0,100
95849255b8f5fa7b37714b3cc27e83f3b16e4ea0,0,0,0,0,0,0,0,0,0,0,0,0,0,0,350,13,0,0,0,0,0,0,0,0,0,100
688fc62e38fe176e807000a2f2006d03c7b62dd3,5,25,0,25,0,0,0,1,3,61,1,2,2.321928095,942,351,13,150,145,5,6249,6114,135,54,49,5,100
a183e04f867f0f7fdce0408e8ea5d86907c13353,5,85,0,85,0,0,0,1,2,80,1,5,2.321928095,1028,352,12,172,172,0,8078,8078,0,64,64,0,100
fbddd8a5d751508bbd669666aef5054784c3e7f2,125,382,751,369,0,0,0,1,3,0,1,45,5.582298384,20529,353,5,3139,3138,1,136356,138530,2174,1022,1025,3,98.45916795
08ab66cc53c770ed4d9e500b32aaef331d5b7d9f,0,0,0,0,0,0,0,0,0,0,0,0,0,0,354,6,0,0,0,0,0,0,0,0,0,100
97937fac0d7a4f477bee52cdb10b4325e945c01f,0,0,0,0,0,0,0,0,0,0,0,0,0,0,355,7,0,0,0,0,0,0,0,0,0,100
a9f8fdec8cb7fcd36cceb89505170b213c4ef3ec,0,0,0,0,0,0,0,0,0,0,0,0,0,0,356,8,0,0,0,0,0,0,0,0,0,100
39f9f866835c0f7491764d32641ba71a26881049,0,0,0,0,0,0,0,0,0,0,0,0,0,0,357,9,0,0,0,0,0,0,0,0,0,100
ff1b75c5e752e7777665232b7b6a69fdda07de73,0,0,0,0,0,0,0,0,0,0,0,0,0,0,358,10,0,0,0,0,0,0,0,0,0,100
0def2d8a68768b2db5a905c3229a957eb56d02fa,0,0,0,0,0,0,0,0,0,0,0,0,0,0,359,11,0,0,0,0,0,0,0,0,0,100
b17fe9bcf64da3517d5084db6b5e0678ff2045e4,0,0,0,0,0,0,0,0,0,0,0,0,0,0,360,12,0,0,0,0,0,0,0,0,0,100
c4fd5b29d4b6b2f4f82e9f1f85cd475813dbd6b9,0,0,0,0,0,0,0,0,0,0,0,0,0,0,361,1,0,0,0,0,0,0,0,0,0,100
f24511c0d8084a3ac2f673253a668d4193cf797a,0,0,0,0,0,0,0,0,0,0,0,0,0,0,362,1,0,0,0,0,0,0,0,0,0,100
71a1b0c4893335ca30c6baef3f0eadb26cf3523d,0,0,0,0,0,0,0,0,0,0,0,0,0,0,363,2,0,0,0,0,0,0,0,0,0,100
7634c21918e359254e081ab2ed3c3731a17b4b4a,0,0,0,0,0,0,0,0,0,0,0,0,0,0,364,3,0,0,0,0,0,0,0,0,0,100
c4a012d0e7eb323656d6c6fbb4cdf30906c68d83,0,0,0,0,0,0,0,0,0,0,0,0,0,0,365,3,0,0,0,0,0,0,0,0,0,100
63efa572ea09af9d313f433db9cdd463c34095ab,0,0,0,0,0,0,0,0,0,0,0,0,0,0,366,0,0,0,0,0,0,0,0,0,0,100
e5027faaf3819753763452b83a38edf1b3af82a2,1,17,17,0,0,0,0,1,2,375,1,1,0,316,367,1,29,29,0,2412,2388,24,4,4,0,100
50fc2ea7610ca0ebff4a24f0957d90eacffb8bcd,0,0,0,0,0,0,0,0,0,0,0,0,0,0,368,2,0,0,0,0,0,0,0,0,0,100
935b7d2ea11a99a9800539928b8200c545985f5c,1,34,34,0,0,0,0,1,3,0,1,1,0,316,369,3,29,29,0,2388,2412,24,4,4,0,100
3ed0259c9061962481523adeeaada2315daf60a8,0,0,0,0,0,0,0,0,0,0,0,0,0,0,370,3,0,0,0,0,0,0,0,0,0,100
7b2c69ec8c95e518d14ae57dbb859727bcd7ed3d,0,0,0,0,0,0,0,0,0,0,0,0,0,0,371,0,0,0,0,0,0,0,0,0,0,100
fc7cfe2cca0609a77cdb7025b6a06303eac30822,1,7,2,5,0,0,0,1,3,421,1,1,0,186,372,0,38,37,1,1440,1405,35,11,11,0,100
78d81df53de14c6009dfa147c3fb48c39e806356,1,4,3,1,0,0,0,1,3,474,1,1,0,436,373,0,95,95,0,2994,2988,6,29,29,0,100
e44f5798117c9c684eabafdfcaaa0ecc2a5df3e5,0,0,0,0,0,0,0,0,0,0,0,0,0,0,374,0,0,0,0,0,0,0,0,0,0,100
6c85a174aff630ad83ebd34b027da4e7049c5828,1,3,4,1,0,0,0,1,4,84,1,1,0,437,375,1,95,95,0,2988,2994,6,29,29,0,100
78b289209b2f954c841f1c9bd31b16a9a0ae91e6,1,1,1,0,0,0,0,1,2,692,1,1,0,96,376,0,8,8,0,676,674,2,4,4,0,100
7d1290cc59b5631a2b75d3683cf6313a46595333,3,51,41,10,0,0,0,1,3,651,1,2,0.433257558,568,377,1,84,84,0,3423,3381,42,27,27,0,100
e8126396d3deab11187beebdc5ccd159227bb1ee,2,6,1,5,0,0,0,2,2,716,1,2,0.591672779,95,228,0,4,3,1,545,488,57,2,2,0,99.8476384
7051d09101dfbfff815b3c92da963da9c4486bbb,0,0,0,0,0,0,0,0,0,0,0,0,0,0,229,1,0,0,0,0,0,0,0,0,0,100
34c5bc3567f7cec76d2f551d86a467bfe7d3c30e,1,8,3,5,0,0,0,2,3,669,1,1,0,321,230,1,62,62,0,2142,2107,35,21,21,0,100
a6a4f8c6a2c9015a3e5738f2f9eaf0cf1cbfaa57,6,185,129,56,0,0,0,2,3,592,1,2,1.90404579,957,231,2,125,122,3,7322,6940,382,29,29,0,100
cbf91f9c32ae3c70cde80e21c0c1f5a29a7425f9,0,0,0,0,0,0,0,0,0,0,0,0,0,0,378,0,0,0,0,0,0,0,0,0,0,100
ff7754b91407d37ce87a744df2bf6fc93a6e8e4d,1,3,0,3,0,0,0,1,4,681,1,1,0,196,379,1,27,25,2,1474,1457,17,6,6,0,100
518c4b5d1fca3bd8988862b6d5bc87ea4c5430e9,1,174,0,174,1,0,1,1,1,0,1,1,0,0,380,2,20,0,20,695,0,695,6,0,6,99.69527679
b80b08ae7f3cc4a6194d25ace2658546ca2bd6b3,0,0,0,0,0,0,0,0,0,0,0,0,0,0,381,3,0,0,0,0,0,0,0,0,0,100
d55104a67f7df6f73133f5542b295126730b1727,2,18,0,18,0,0,0,1,3,726,1,2,0.99107606,327,382,4,31,30,1,3401,3254,147,3,3,0,100
1960cf709c6c18df8ed82f89f0638fcdcb255ef9,0,0,0,0,0,0,0,0,0,0,0,0,0,0,0,0,0,0,0,0,0,0,0,0,0,100
734b8a48a46ae79fa304237aae67ab07478740a2,1,1,1,0,0,0,0,2,3,793,1,1,0,82,1,1,14,14,0,470,469,1,5,5,0,100
837d3118338f27b5b527131d61d74379b7f9fcd6,0,0,0,0,0,0,0,0,0,0,0,0,0,0,2,2,0,0,0,0,0,0,0,0,0,100
88379bf74b78c93331b1a8f10d610f38c73fd0d9,1,19,3,16,0,0,0,1,2,1096,1,1,0,106,383,0,16,12,4,711,659,52,11,7,4,100
ed0c27460eb57906f04932d1ae21ddaf4506d59b,12,176,25,151,0,0,0,1,4,1017,1,9,3.398016385,1864,384,1,283,264,19,13884,12896,988,85,80,5,100
6b1bd0a287b1d9fc30acf183a2c7c88da0633a09,0,0,0,0,0,0,0,0,0,0,0,0,0,0,385,2,0,0,0,0,0,0,0,0,0,100
941c7213e9e63c6247960c22eb7380d982fb352f,3,105,14,91,0,0,0,1,4,802,1,3,1.026595494,1027,386,3,174,164,10,7202,6662,540,60,58,2,100
b58a0520f368438b9857b12db1fe435f2c06d2d7,3,42,3,39,0,0,0,1,4,619,1,2,0.776827918,446,387,4,65,63,2,2910,2691,219,18,17,1,99.74619289
0d1e5c8eff7ae817444339558072af81761c4a41,1,277,0,277,1,0,1,1,1,0,1,1,0,0,388,5,25,0,25,573,0,573,18,0,18,99.50149551
e5086afb977c4950252653e9a5449b4e5784a616,1,1,1,0,0,0,0,2,3,1086,1,1,0,65,232,0,10,10,0,295,295,0,4,4,0,100
a26ff89b6463065151ce575a95faaddc72e571b5,1,9,9,0,0,0,0,2,5,81,1,1,0,595,233,1,103,103,0,3886,3886,0,34,34,0,100
cf73656b49f062f9fc01b31599d672bc85532691,8,1098,0,1098,8,0,8,1,1,0,1,3,2.875957717,0,234,2,63,0,63,6908,0,6908,16,0,16,99.36708861
c333d2d5e27967f3355b1e7742309a4f04896e7d,7,850,0,850,7,0,7,1,1,0,1,3,2.399070633,0,235,3,82,0,82,4101,0,4101,33,0,33,99.18347743
dac18b1dd563218bf1b6c26acb3e477e0cccc5ba,1,18,0,18,0,0,0,1,2,86,1,1,0,129,389,0,25,25,0,573,573,0,18,18,0,100
e6ef506c6941c73555695fbe71050eba1c57c1a1,0,0,0,0,0,0,0,0,0,0,0,0,0,0,390,1,0,0,0,0,0,0,0,0,0,100
87e86df8b1da34887a90f6f8bf04c9fbdc292820,1,17,0,17,0,0,0,2,2,5,1,1,0,42,391,2,3,3,0,325,325,0,2,2,0,100
fdc92fe56b487ffe4c9d8faf9880f108a0944baf,3,61,34,27,0,0,0,1,3,787,1,3,0.660666006,530,392,3,75,69,6,3966,3793,173,25,21,4,100
0e33e1139b44b1b749baf1b2434d541048537bf8,0,0,0,0,0,0,0,0,0,0,0,0,0,0,0,0,0,0,0,0,0,0,0,0,0,100
e138ae2f97ec43ef722d748148512307f2dee990,0,0,0,0,0,0,0,0,0,0,0,0,0,0,393,0,0,0,0,0,0,0,0,0,0,100
7d5c0df04d3c9dfa175c470964c3b2efde9f4d46,2,195,0,195,2,0,2,1,1,0,1,2,0.896402472,0,394,1,12,0,12,850,0,850,8,0,8,99.80970504
644c9cfbe5419b067604af808886063e6c405518,1,17,0,17,0,0,0,1,2,0,1,1,0,83,395,2,8,8,0,644,644,0,7,7,0,100
27200b4a2d2076370d499f0a5f87b51b810eb24a,0,0,0,0,0,0,0,0,0,0,0,0,0,0,1,0,0,0,0,0,0,0,0,0,0,100
d2799168b3630c6bd4057bf73036dd8324a81444,4,123,72,51,0,0,0,1,3,1608,1,3,1.850846079,364,396,0,35,33,2,2863,2491,372,15,13,2,100
9026d77107daedb07a465541d077696c1061efe4,1,12,9,3,0,0,0,1,3,1815,1,1,0,58,397,1,4,2,2,299,309,10,4,2,2,100
386cd76f11709922dcd10d174a524b549e653217,1,5,0,5,0,0,0,1,2,1907,1,1,0,48,398,2,9,8,1,171,159,12,9,8,1,100
bf08fa3c4a2a9c6a6bcab134e6898f0d10405569,0,0,0,0,0,0,0,0,0,0,0,0,0,0,399,3,0,0,0,0,0,0,0,0,0,100
ce8f75d4305119e9e938760edd32ba7537f7afb2,1,22,1,21,0,0,0,1,4,743,1,1,0,218,400,4,40,37,3,1600,1536,64,14,13,1,100
4095f2de2e1a87704b1f0c2af4bcad044a45347a,1,1,1,0,0,0,0,1,2,1931,1,1,0,115,401,5,13,13,0,813,813,0,5,5,0,100
8b6ba133a11d2af0013000c0dd692924fb4aecf0,0,0,0,0,0,0,0,0,0,0,0,0,0,0,402,2,0,0,0,0,0,0,0,0,0,100
40b67fce7c1cec4dcc1fa9f0f56a12ef24d8d8ad,4,250,0,250,3,0,3,1,4,469,1,3,1.917927144,233,403,2,54,28,26,3371,1878,1493,25,8,17,99.66871746
7ca54fb91930f4a51510c053cdff4773072dfe1b,2,36,0,36,0,0,0,1,2,0,1,1,1,73,404,3,13,13,0,395,395,0,13,13,0,100
81cac7eefea97b7e7a2c4949ef73f41b74b27999,0,0,0,0,0,0,0,0,0,0,0,0,0,0,405,0,0,0,0,0,0,0,0,0,0,100
d1d9476a648df567dfa0bd7b368e81bd583ec0cf,0,0,0,0,0,0,0,0,0,0,0,0,0,0,0,0,0,0,0,0,0,0,0,0,0,100
65b03cd41768b716319a4642ee30279ae030e628,2,2,0,2,0,0,0,3,6,2018,1,2,1,750,0,0,131,131,0,4714,4700,14,44,44,0,100
4b75902d126eb482d8f9713353565c31c260da71,0,0,0,0,0,0,0,0,0,0,0,0,0,0,1,1,0,0,0,0,0,0,0,0,0,100
03b1d75fd37859407ec16ab116c3d5daaf6dd561,0,0,0,0,0,0,0,0,0,0,0,0,0,0,2,2,0,0,0,0,0,0,0,0,0,100
dd9fc62a54e7a817255c20f6ce4fdff285e00ea1,0,0,0,0,0,0,0,0,0,0,0,0,0,0,3,3,0,0,0,0,0,0,0,0,0,100
0793f361cfc852065687c6e355a2a9c76486f94b,1,6,0,6,0,0,0,1,3,754,1,1,0,52,406,0,10,9,1,185,171,14,10,9,1,100
b126d4920d01fc5b494eb0091431db1a51ce281f,1,0,5,5,0,0,0,1,4,0,1,1,0,56,407,1,9,10,1,173,185,12,9,10,1,100
b80cd910c535ff19a2c1bf8e6bf6f9f8f96ec34b,0,0,0,0,0,0,0,0,0,0,0,0,0,0,408,0,0,0,0,0,0,0,0,0,0,100
313cca14a3736c45b03a2e18da70d45f58f0e5a6,0,0,0,0,0,0,0,0,0,0,0,0,0,0,409,0,0,0,0,0,0,0,0,0,0,100
2f74fbbfc995f0382d2d300dfa452174cc0e575f,26,426,223,203,1,0,1,1,7,2420,1,18,2.613077536,4626,410,0,631,606,25,34930,33874,1056,224,215,9,98.34280303
827af0cebab9a9a729b295502ccf9d1d7c79f591,2,121,1,120,1,0,1,1,4,102,1,2,0.894869231,156,4,0,43,28,15,1365,821,544,12,10,2,99.81015662
5001f857aee75c92c1cecf469e20c6fe21a787bd,1,1,1,0,0,0,0,2,2,2860,1,1,0,69,5,1,1,1,0,521,517,4,1,1,0,100
e8ab727dbfea21070694e374f7ca9fe183db0d50,5,390,5,385,2,0,2,1,8,1145,1,3,1.709625362,775,6,2,174,128,46,6679,4898,1781,64,45,19,99.38621341
7a30f2d592f824f2f29a3572905e9aac06e5474d,1,5,1,4,0,0,0,1,3,1805,1,1,0,93,411,0,8,7,1,738,723,15,3,2,1,100
0a2f924aba6c8871cc8a5e72fb05fd7157557172,2,22,2,20,0,0,0,1,2,2912,1,2,0.979868757,571,412,1,54,52,2,5026,4849,177,10,10,0,100
7d3c502c364ac9890ec98033141ecf254253babf,10,588,495,93,6,0,6,1,9,465,1,4,2.697612496,1232,413,2,179,189,10,8650,8548,102,83,79,4,99.3919551
e4b13e4ac3798393869e63cadfd306c2cead2be9,0,0,0,0,0,0,0,0,0,0,0,0,0,0,414,3,0,0,0,0,0,0,0,0,0,100
865596312a26726fe2c74573a17bff36bfa20be6,0,0,0,0,0,0,0,0,0,0,0,0,0,0,415,4,0,0,0,0,0,0,0,0,0,100
160b22b99a15f48d7b529905032c9d927df7712b,2,228,0,228,2,0,2,1,1,0,1,2,0.97538179,0,416,5,18,0,18,1127,0,1127,11,0,11,97.92158715
3ae226a3a937f990087fff1cf9e54344d1de6ead,3,246,90,156,0,0,0,2,4,2013,1,3,1.261127264,534,417,6,57,44,13,6024,4879,1145,12,11,1,100
4e7e7e01d1898b93cfc2dfaa50640db1bcdf2dd8,5,417,39,378,4,0,4,1,10,2,1,4,2.107227572,611,418,7,137,106,31,5588,3987,1601,51,35,16,99.52221691
d3f7189f2bf94ff9fb153394c954e9f7ca7be769,1,24,0,24,0,0,0,1,4,67,1,1,0,90,419,8,17,12,5,606,503,103,6,5,1,100
e0aa4c1812ec376f693c1f15762335cddb421fba,2,188,0,188,2,0,2,1,1,0,1,2,0.997059057,0,420,8,16,0,16,989,0,989,7,0,7,99.76269578
77f97405d973e761eebfc7540aa55e3a47de8349,0,0,0,0,0,0,0,0,0,0,0,0,0,0,421,1,0,0,0,0,0,0,0,0,0,100
c43e10c378a2487debdea5b0b9503f577a9dc1fc,1,2,2,0,0,0,0,2,2,119,1,1,0,75,422,2,9,9,0,360,360,0,1,1,0,100
74f23dad5044947e4f94bc695567d3c81224cad6,0,0,0,0,0,0,0,0,0,0,0,0,0,0,423,2,0,0,0,0,0,0,0,0,0,100
5bcfc0b732bdfcfad14470800ffe5ee78fa991c8,0,0,0,0,0,0,0,0,0,0,0,0,0,0,424,3,0,0,0,0,0,0,0,0,0,100
b467068312ed9e361cd54f793c606d7c6b8f4d92,0,0,0,0,0,0,0,0,0,0,0,0,0,0,425,4,0,0,0,0,0,0,0,0,0,100
71bcad35f84ef6a638c91dc655ea7dac33c3fa0f,0,0,0,0,0,0,0,0,0,0,0,0,0,0,426,3,0,0,0,0,0,0,0,0,0,100
6e3e73e9af5fed61a3fd6eae24f4886c1899f7dc,0,0,0,0,0,0,0,0,0,0,0,0,0,0,427,0,0,0,0,0,0,0,0,0,0,100
e4a51b7c4d27f178da04edb3394109b7a1da0bdb,1,0,0,0,1,0,1,3,3,4610,1,1,0,0,2,0,0,0,0,0,0,0,0,0,0,99.90521327
6c6a28123bbb6e2cb5d6230f6291b80df8c4ed0a,0,0,0,0,0,0,0,0,0,0,0,0,0,0,3,1,0,0,0,0,0,0,0,0,0,100
c63f6a96631d411cb4cf2d9d0c4bd38ac5e80c95,0,0,0,0,0,0,0,0,0,0,0,0,0,0,4,2,0,0,0,0,0,0,0,0,0,100
49116b0aa22b01d4271e010301172965db5fce58,0,0,0,0,0,0,0,0,0,0,0,0,0,0,5,3,0,0,0,0,0,0,0,0,0,100
a8d8a62ed56cf9d4c46f0c854515dcbfab3a4b91,1,44,17,27,0,0,0,1,5,1472,1,1,0,309,428,0,40,37,3,2699,2536,163,12,11,1,100
e1fd956b9241260624a6f2f3812d2421e0f94300,2,17,16,1,0,0,0,1,4,3166,1,2,0.799048521,360,429,0,67,64,3,2256,2302,46,22,22,0,100
9d88538ff48f60a839ae7d24f997af5905e1c835,5,364,59,305,3,0,3,1,11,262,1,3,2.158081181,697,7,0,141,113,28,5950,4366,1584,51,40,11,97.76951673
a912d6c66dacf17271c358aa24492b0a4dfe1005,8,598,1,597,7,0,7,2,4,83,1,5,2.525448603,170,8,1,77,13,64,4095,1264,2831,34,10,24,92.56668124
555add1c16110307479dee5ba1ac1850190b56b0,0,0,0,0,0,0,0,0,0,0,0,0,0,0,430,1,0,0,0,0,0,0,0,0,0,100
b9f3c0b13827828de7e767662bc70934ce7b6aa3,2,63,40,23,0,0,0,1,4,3143,1,2,0.236924747,115,431,2,13,15,2,574,572,2,7,6,1,100
021c78c794fd848c3c206f59dad62a84bf8bb8e6,0,0,0,0,0,0,0,0,0,0,0,0,0,0,432,3,0,0,0,0,0,0,0,0,0,100
da6868453da5380d71ab3dd834611fb2a2480379,0,0,0,0,0,0,0,0,0,0,0,0,0,0,433,4,0,0,0,0,0,0,0,0,0,100
5ef725a66baae830815b60bda51065bff4ec7b69,0,0,0,0,0,0,0,0,0,0,0,0,0,0,434,5,0,0,0,0,0,0,0,0,0,100
f01a8943eac429cf49c8f5545b75ace23cc6b6fd,13,13,467,454,0,0,0,1,4,3207,1,11,1.162869775,2065,435,5,211,289,78,11985,14320,2335,63,81,18,98.41070682
fb022bfd21afbdb8d512bf9d0fb68e85078c8486,1,17,0,17,0,0,0,2,2,35,1,1,0,16,436,6,4,4,0,85,85,0,4,4,0,100
7ae68398626b33ac5fc06caf83573e992b766af0,23,416,2004,1588,0,0,0,1,6,3173,1,6,3.910112444,2516,437,0,133,317,184,8407,17153,8746,50,112,62,96.37774903
ecf9b2b699a58ad3d5c2efca071fa28b54a92189,23,22,422,400,0,0,0,1,12,2271,1,18,2.914635633,4139,438,1,577,611,34,24885,26901,2016,168,181,13,99.46164199
6def7b64d294f13ff2ef50e783d32cd0384c949f,0,0,0,0,0,0,0,0,0,0,0,0,0,0,439,2,0,0,0,0,0,0,0,0,0,100
f9dea324bd532478e81ca4a4fece26ec42119b6f,9,755,0,755,9,0,9,1,1,0,1,2,2.967725141,0,440,3,65,0,65,4305,0,4305,32,0,32,98.84083816
16927ce693554c312197ad60d1db5b7f8f4f6702,0,0,0,0,0,0,0,0,0,0,0,0,0,0,441,4,0,0,0,0,0,0,0,0,0,100
a6e0cbad7cd52cc04a5363c04bc0fbd5b78f66be,16,851,426,425,7,0,7,1,7,702,1,8,2.992825427,1480,442,3,215,196,19,11042,10314,728,120,71,49,99.2534036
1c4ed7bcc043e6b391ca5a74edb224a6cdabc1cb,3,187,1,186,2,0,2,1,2,1266,1,3,0.998748855,72,443,0,23,6,17,1278,409,869,17,3,14,99.78232477
4134fc32c095e83570bd36ec571b2f1904348149,1,295,35,260,0,0,0,1,8,41,1,1,0,416,444,1,79,56,23,4792,3407,1385,21,13,8,99.20459567
0f9b5cf3f3956635123f5ab38e29d0e5dce4e6d9,9,21,72,51,1,0,1,1,6,12,1,3,2.411809093,723,445,2,92,49,43,3522,2830,692,69,27,42,98.27662395
dfe84a2c3721521a1007d33e8f7daa15ea99aef2,13,392,30,362,5,0,5,1,9,396,1,7,3.071485161,1391,446,0,202,175,27,12123,10373,1750,90,70,20,99.48051948
b2bcd77b08e2392cc7c202ccd2594be7fa7f64d6,0,0,0,0,0,0,0,0,0,0,0,0,0,0,447,0,0,0,0,0,0,0,0,0,0,100
2d20ab592b0db8abcad09f616e803f085dcb407a,1,43,9,34,0,0,0,1,2,968,1,1,0,81,448,1,13,8,5,772,525,247,4,4,0,100
d26630bff21d561832ac62b8c3aad9b528d96b61,1,149,0,149,1,0,1,1,1,0,1,1,0,0,449,2,8,0,8,756,0,756,3,0,3,98.81355932
88ec3d01180519193f0f85912e404d8816acf6d2,0,0,0,0,0,0,0,0,0,0,0,0,0,0,450,3,0,0,0,0,0,0,0,0,0,100
0cad3aae2355b101c6324a9d46a784cbab00090f,0,0,0,0,0,0,0,0,0,0,0,0,0,0,451,4,0,0,0,0,0,0,0,0,0,100
d8abe979aaa2f107240ea5aeaeca9207eff65332,3,158,58,100,0,0,0,1,10,138,1,3,0.997483931,901,452,5,119,112,7,7664,6945,719,36,35,1,100
e1f0df55dcaadb48398bb680fc85c2983f897279,0,0,0,0,0,0,0,0,0,0,0,0,0,0,453,6,0,0,0,0,0,0,0,0,0,100
df343afef8ce1425b4271717115384a33efd4cf3,2,0,12,12,0,0,0,1,5,608,1,2,0.979868757,182,454,7,22,22,0,1244,1362,118,2,2,0,100
7770e2257275b150f7a42afd939d552410a4ff67,3,2,124,122,0,0,0,1,5,2023,1,3,0.323814475,262,455,8,6,19,13,1303,2120,817,2,4,2,99.03361345
2e7c6feb108153e44a46f32e78bc4e1387f4d01b,0,0,0,0,0,0,0,0,0,0,0,0,0,0,456,9,0,0,0,0,0,0,0,0,0,100
01a72e24b816f93f9a9c97312c4f4b62664a1c68,0,0,0,0,0,0,0,0,0,0,0,0,0,0,457,10,0,0,0,0,0,0,0,0,0,100
c914d3401026c8dbb8b93bba4da52841b704f0f5,14,964,969,5,0,0,0,1,4,2652,1,5,2.655125754,2049,458,11,224,224,0,14461,14440,21,63,63,0,100
be0e0cf1d2ac98bc820abded5dc6e353800df8b6,1,2,2,0,0,0,0,1,11,14,1,1,0,753,459,12,88,88,0,6073,6073,0,24,24,0,100
068b454e149842734e4bfc880e8aad97da0877a0,0,0,0,0,0,0,0,0,0,0,0,0,0,0,460,13,0,0,0,0,0,0,0,0,0,100
f3dfc942025d4f476815df85091d35559e13f72a,1,61,15,46,0,0,0,1,12,2,1,1,0,753,461,14,96,88,8,6333,6073,260,24,24,0,100
384d3449ce18694ac58ab77754f18ec87492ae00,5,77,74,3,0,0,0,1,13,83,1,4,1.767506092,1383,462,15,172,175,3,10536,10334,202,58,58,0,100
e29381f07cb5c122ee43f887c6326e99652548f1,2,21,2,19,0,0,0,1,14,48,1,2,0.258018669,900,463,16,109,106,3,7120,7013,107,32,31,1,100
6012e14f8d96c98439ab7e71001c9266a467da72,82,587,1443,856,0,0,0,1,15,2228,1,34,4.383013781,13062,464,17,1548,1650,102,86544,90979,4435,578,594,16,98.80952381
0961ec169e349beff2c631c785147de581f8599a,2,300,0,300,2,0,2,1,1,0,1,2,0.979868757,0,465,11,31,0,31,1888,0,1888,9,0,9,99.78732454
7f662e8c625b7f14164329ff75ef038456e600ca,138,1311,1008,303,0,0,0,1,6,2008,1,43,6.280220954,21427,466,0,3182,3098,84,147957,146158,1799,1016,968,48,98.45692242
14e823343cfac98a34e2502ffa49c3169e2c8a7f,0,0,0,0,0,0,0,0,0,0,0,0,0,0,467,0,0,0,0,0,0,0,0,0,0,100
dd10a5cf72bdc9b5e4960ac050761070cc62c913,0,0,0,0,0,0,0,0,0,0,0,0,0,0,468,1,0,0,0,0,0,0,0,0,0,100
a311649089d25a8c8ec33902da2a6c06fd155d29,23,31,205,174,0,0,0,1,14,2184,2,16,2.992813772,3856,469,2,486,496,10,26370,27459,1089,156,164,8,99.02697921
112d3bbd652dcdb15b40bdcdc9b01398019e6eff,0,0,0,0,0,0,0,0,0,0,0,0,0,0,470,3,0,0,0,0,0,0,0,0,0,100
253797e830c51e5e542d654987f8e54681636bd1,4,145,4,141,1,0,1,1,16,153,1,4,0.692669756,1099,471,1,156,152,4,9304,8305,999,63,61,2,99.90966576
602b55f962657f35baab7a0c2f42de8947f6fb4b,0,0,0,0,0,0,0,0,0,0,0,0,0,0,472,2,0,0,0,0,0,0,0,0,0,100
666dbb9c12eb1078c345b4a281f3da629298b425,0,0,0,0,0,0,0,0,0,0,0,0,0,0,473,3,0,0,0,0,0,0,0,0,0,100
6e9e7899daa1e1621e754875260357a6c398859e,3,392,33,359,1,0,1,1,17,117,1,2,1.094106314,897,474,3,110,103,7,9323,7075,2248,29,26,3,99.90982867
978656ad9429803e34e175191e050f5d6dc6ef1f,0,0,0,0,0,0,0,0,0,0,0,0,0,0,475,4,0,0,0,0,0,0,0,0,0,100
d3fba3fac8c17b1b2a5a835d74fbf57ac073fde6,0,0,0,0,0,0,0,0,0,0,0,0,0,0,0,0,0,0,0,0,0,0,0,0,0,100
0d9f40360edff12f0ee25aa461aa8a6063cde5fa,0,0,0,0,0,0,0,0,0,0,0,0,0,0,476,2,0,0,0,0,0,0,0,0,0,100
a990fc54a555a409b6716e170d9acb92d56bf2c3,7,357,283,74,1,0,1,1,4,1515,1,6,1.920178906,1221,477,0,140,138,2,8448,8432,16,37,33,4,99.819982
93a1f75c45f7333dcba2980f5ec9ebbdc64bb9d3,2,17,122,105,0,0,0,1,5,0,1,2,0.535942343,270,478,1,20,20,0,2008,2008,0,4,4,0,100
c440a9f901a9f29b60f10047cb67e0b1cb188f89,1,3,0,3,0,0,0,1,5,0,1,1,0,297,479,2,39,38,1,1995,1983,12,11,11,0,100
a13bc5ae09af5b60c52b465792d33bd5fc86ad12,0,0,0,0,0,0,0,0,0,0,0,0,0,0,480,3,0,0,0,0,0,0,0,0,0,100
5e66273f6f5960f01eae97d8b719f50e1e394fd1,6,404,24,380,3,0,3,1,18,146,1,3,2.329757911,1307,481,0,165,138,27,11729,9765,1964,77,61,16,99.50848972
0e518f8d71a3bba3534ab068e6703386e32f4c23,0,0,0,0,0,0,0,0,0,0,0,0,0,0,482,1,0,0,0,0,0,0,0,0,0,100
49384fb15850145f728c62c5d7320881c4909450,2,356,122,234,0,0,0,1,19,286,1,2,0.590125565,1136,483,2,121,108,13,10012,8890,1122,32,29,3,100
aa76d992103168e93b7d1b2c1c92d67fad843567,3,24,14,10,0,0,0,1,20,157,1,3,1.552252438,1406,484,3,161,159,2,10498,10447,51,78,76,2,100
6b70f9e544074bedddb573f3ab4cf45ce0f0eea8,0,0,0,0,0,0,0,0,0,0,0,0,0,0,485,4,0,0,0,0,0,0,0,0,0,100
6e69e543cbb8bac1ca3c4e82f24a28871520269d,0,0,0,0,0,0,0,0,0,0,0,0,0,0,486,5,0,0,0,0,0,0,0,0,0,100
f0f60e2ed6647c44f7fafe35741872fef2ea008c,0,0,0,0,0,0,0,0,0,0,0,0,0,0,487,6,0,0,0,0,0,0,0,0,0,100
d6e09cfac3fa91b5593baf5984de3482f61be758,0,0,0,0,0,0,0,0,0,0,0,0,0,0,488,7,0,0,0,0,0,0,0,0,0,100
83baac244354fe51d25b70110f0f2d3c8202f53a,1,19,3,16,0,0,0,1,3,23,1,1,0,129,489,8,14,11,3,1026,917,109,4,4,0,100
cac335a10c8f9b0ce09cc4dc5bead940e07f78bd,3,826,0,826,3,0,3,1,1,0,1,1,0.775044341,0,490,3,113,0,113,3677,0,3677,83,0,83,99.645861
b9fa3b25ac5d81d4b850f7029a92f370e995f945,0,0,0,0,0,0,0,0,0,0,0,0,0,0,491,4,0,0,0,0,0,0,0,0,0,100
db2e5f8ddb7d6acdbed453a987a8a435fbf4d8f9,0,0,0,0,0,0,0,0,0,0,0,0,0,0,492,2,0,0,0,0,0,0,0,0,0,100
15a2900e2878427b3280fd1a1b7c57e8dd5e644c,0,0,0,0,0,0,0,0,0,0,0,0,0,0,493,3,0,0,0,0,0,0,0,0,0,100
20a6456dd66d3bc782147328ad237c0aecf386fe,0,0,0,0,0,0,0,0,0,0,0,0,0,0,494,4,0,0,0,0,0,0,0,0,0,100
326f05987cab95d3d58c5ead461c2c9360ba73d6,0,0,0,0,0,0,0,0,0,0,0,0,0,0,495,5,0,0,0,0,0,0,0,0,0,100
3f5bb3c3cbc4dccc460f5ead2c132a0108576d47,0,0,0,0,0,0,0,0,0,0,0,0,0,0,496,0,0,0,0,0,0,0,0,0,0,100
fc70665574b7b54de583cd224552f032d8706633,2,19,10,9,0,0,0,1,10,757,1,2,0.957553484,275,497,1,40,36,4,1818,1762,56,15,15,0,100
21b24284255d15fdc359ada9fc68d3a59fb60f7f,2,22,8,14,0,0,0,1,5,1252,1,2,0.2108423,192,498,2,26,23,3,1393,1294,99,7,7,0,100
80bd09e9952c27326254bff0da15d9d116ce61df,0,0,0,0,0,0,0,0,0,0,0,0,0,0,499,3,0,0,0,0,0,0,0,0,0,100
6b2ddcf0c2f94a264edfde2009d928ee5c832852,0,0,0,0,0,0,0,0,0,0,0,0,0,0,500,4,0,0,0,0,0,0,0,0,0,100
7eb11028f2ab146b2598085cf90f5d96809714c8,0,0,0,0,0,0,0,0,0,0,0,0,0,0,501,5,0,0,0,0,0,0,0,0,0,100
7bd52b278fa4a4e35ee1a83d24ca9065c5dd67bd,0,0,0,0,0,0,0,0,0,0,0,0,0,0,502,6,0,0,0,0,0,0,0,0,0,100
8329221c48c9d5846e6792031be7ec148b06fe08,1,2,1,1,0,0,0,2,4,796,1,1,0,60,503,7,3,3,0,339,332,7,2,2,0,100
8011ff1f59b4702d1987281fc90b2ca60f2e3a9b,61,895,589,306,0,0,0,1,21,1911,1,32,3.023645843,11095,504,3,1670,1670,0,76740,76749,9,588,588,0,100
f77266b555d46969bf3e0985f120312603be105a,1,10,13,3,0,0,0,1,6,42,1,1,0,131,505,4,18,18,0,893,924,31,4,4,0,100
84ade82813f0986fed597c3a5e3ccfe1540fc5de,1,12,0,12,0,0,0,1,8,850,1,1,0,141,506,2,15,15,0,1048,1031,17,5,5,0,100
e0bf3c0efd5a60aef21d86578fa74f961045c505,14,1022,457,565,1,0,1,1,22,376,1,3,2.533934234,2498,507,0,245,237,8,19255,17677,1578,115,110,5,99.7794442
6f6e4399eb10f11814b2d478527d88b6ad351a99,1,4,4,0,0,0,0,1,2,18,1,1,0,451,508,1,2,2,0,3267,3267,0,2,2,0,100
6f04f07cd061ff94d212d9b35400d9a036af5d50,0,0,0,0,0,0,0,0,0,0,0,0,0,0,509,2,0,0,0,0,0,0,0,0,0,100
0cce2791af8a7dfe83ae7b6d0f2020a6d1a99420,0,0,0,0,0,0,0,0,0,0,0,0,0,0,510,3,0,0,0,0,0,0,0,0,0,100
d3834147435fa5160014686569d001e74721d940,0,0,0,0,0,0,0,0,0,0,0,0,0,0,511,4,0,0,0,0,0,0,0,0,0,100
750e3190cdebb6b026fd0dcf07702a67c7d1b997,0,0,0,0,0,0,0,0,0,0,0,0,0,0,512,0,0,0,0,0,0,0,0,0,0,100
bc8436849a5a7f0dc4146055be4977f721fc641f,0,0,0,0,0,0,0,0,0,0,0,0,0,0,513,1,0,0,0,0,0,0,0,0,0,100
3a356ddbbc4790684530ecde4d59ef3ee26d14b1,0,0,0,0,0,0,0,0,0,0,0,0,0,0,514,0,0,0,0,0,0,0,0,0,0,100
20be5ae512207de60ef57d596ec0c0fe30d00743,0,0,0,0,0,0,0,0,0,0,0,0,0,0,515,0,0,0,0,0,0,0,0,0,0,100
fcfcc088b61a262f81876e24ecce854e13cbd6c1,0,0,0,0,0,0,0,0,0,0,0,0,0,0,516,0,0,0,0,0,0,0,0,0,0,100
6276ed15c46dd08a21ae9240e4371930d5a5b2d5,0,0,0,0,0,0,0,0,0,0,0,0,0,0,517,1,0,0,0,0,0,0,0,0,0,100
cf722856c14b6132cfb335d1b3aa36709dde14f9,0,0,0,0,0,0,0,0,0,0,0,0,0,0,518,2,0,0,0,0,0,0,0,0,0,100
e0ff0ea8b6237549624f2ddc2f82c088223f8ef0,0,0,0,0,0,0,0,0,0,0,0,0,0,0,519,3,0,0,0,0,0,0,0,0,0,100
384e3a13a82f37b26e9e6e8ff8c8f34d2acabe9e,0,0,0,0,0,0,0,0,0,0,0,0,0,0,520,4,0,0,0,0,0,0,0,0,0,100
ffd0d400ebd911ffa88bb9a46b08a261bc999dd6,1,1,1,0,0,0,0,2,4,1671,1,1,0,180,0,0,34,34,0,1207,1207,0,20,20,0,100
5bf50709d070144bf958616111efa57c6c0475a5,1,1,2,1,0,0,0,1,7,1010,1,1,0,128,521,0,18,18,0,890,893,3,4,4,0,100
971641927fd399143329bcc0480e0f1e6b032a74,5,75,38,37,0,0,0,1,11,2485,1,4,1.514243217,438,522,1,72,63,9,2994,2794,200,25,25,0,100
d1b7ef949c7db832ae3476310a2eeab2b5103b22,1,332,0,332,1,0,1,1,1,0,1,1,0,0,0,0,29,0,29,1973,0,1973,11,0,11,99.86784141
4223cbe1ee8b903bc4df78185842bb3fc31a0b05,3,414,0,414,3,0,3,1,1,0,1,1,1.549809053,0,0,0,47,0,47,2246,0,2246,15,0,15,99.69284774
322119d9884ebf49678c0ed307e946c8c05ebc9e,2,43,22,21,0,0,0,1,2,8,1,1,0.851224335,183,1,1,26,24,2,1291,1160,131,13,11,2,100
c9715241cfb24954f423099e94c053f7cc37ad2a,2,7,8,1,0,0,0,1,3,4,1,1,0.918295834,246,2,2,36,36,0,1644,1648,4,10,10,0,100
ce5d76b37c5f0e4de34529c20e9fa11c684b56f4,1,0,332,332,0,0,0,2,2,26,1,1,0,252,3,3,0,29,29,0,1973,1973,0,11,11,99.86865149
337a0a9743ad01b8357dc557bb3277868f37d333,2,36,0,36,0,0,0,1,3,4,1,1,1,248,4,4,36,36,0,1813,1813,0,11,11,0,100
e90967f94cb2b5251761f45a9a61518db48677c9,0,0,0,0,0,0,0,0,0,0,0,0,0,0,5,5,0,0,0,0,0,0,0,0,0,100
973e11e9de2b6067f2a8431599912b04db49a50a,0,0,0,0,0,0,0,0,0,0,0,0,0,0,523,0,0,0,0,0,0,0,0,0,0,100
1695db7d4f3118ba4a34751196a99ec2e4ea7aa0,0,0,0,0,0,0,0,0,0,0,0,0,0,0,524,1,0,0,0,0,0,0,0,0,0,100
8f8ef253c26ab91cba18d65b073705402600dbde,0,0,0,0,0,0,0,0,0,0,0,0,0,0,0,0,0,0,0,0,0,0,0,0,0,100
65f6972859115a4ddad6def06475465f0971e9ae,0,0,0,0,0,0,0,0,0,0,0,0,0,0,525,0,0,0,0,0,0,0,0,0,0,100
140a58df0852c8f05dc6b2dc9a7e7cf60f67712d,469,0,0,0,0,0,0,1,1,0,1,99,0,51326,525,0,6458,5628,830,330704,205891,124813,2523,938,1585,16.60746004
5514e15861db62ec2ed9956f1984d062b2af9a20,0,0,0,0,0,0,0,0,0,0,0,0,0,0,527,1,0,0,0,0,0,0,0,0,0,100
a7c886930c6437b5617dac5aa743a8de55231687,0,0,0,0,0,0,0,0,0,0,0,0,0,0,528,2,0,0,0,0,0,0,0,0,0,100
c6e70714aba5f7403631a2d0bc2f4b28f47ee63b,0,0,0,0,0,0,0,0,0,0,0,0,0,0,529,3,0,0,0,0,0,0,0,0,0,100
38742d250275529d07c1ff4f912a29b73a5985fb,0,0,0,0,0,0,0,0,0,0,0,0,0,0,530,4,0,0,0,0,0,0,0,0,0,100
